Year,Month,City1,City2,PaxToCity2,PaxFromCity2,Sector,Passengers,Airline
2021,12,ADAMPUR,AHMEDABAD,30,0,ADAMPUR-AHMEDABAD,30,All
2018,5,ADAMPUR,DELHI,2258,2190,ADAMPUR-DELHI,4448,All
2018,6,ADAMPUR,DELHI,1984,1981,ADAMPUR-DELHI,3965,All
2018,7,ADAMPUR,DELHI,2333,2205,ADAMPUR-DELHI,4538,All
2018,8,ADAMPUR,DELHI,2146,1981,ADAMPUR-DELHI,4127,All
2018,9,ADAMPUR,DELHI,2237,2164,ADAMPUR-DELHI,4401,All
2018,10,ADAMPUR,DELHI,2277,2251,ADAMPUR-DELHI,4528,All
2018,11,ADAMPUR,DELHI,2289,2319,ADAMPUR-DELHI,4608,All
2018,12,ADAMPUR,DELHI,2308,2290,ADAMPUR-DELHI,4598,All
2019,1,ADAMPUR,DELHI,2332,2307,ADAMPUR-DELHI,4639,All
2019,2,ADAMPUR,DELHI,2072,2097,ADAMPUR-DELHI,4169,All
2019,3,ADAMPUR,DELHI,2333,2303,ADAMPUR-DELHI,4636,All
2019,4,ADAMPUR,DELHI,2268,2257,ADAMPUR-DELHI,4525,All
2019,5,ADAMPUR,DELHI,1968,1776,ADAMPUR-DELHI,3744,All
2019,6,ADAMPUR,DELHI,2275,2172,ADAMPUR-DELHI,4447,All
2019,7,ADAMPUR,DELHI,2048,2088,ADAMPUR-DELHI,4136,All
2019,8,ADAMPUR,DELHI,2343,2296,ADAMPUR-DELHI,4639,All
2019,9,ADAMPUR,DELHI,2264,2145,ADAMPUR-DELHI,4409,All
2019,10,ADAMPUR,DELHI,2322,2606,ADAMPUR-DELHI,4928,All
2019,11,ADAMPUR,DELHI,2600,2525,ADAMPUR-DELHI,5125,All
2019,12,ADAMPUR,DELHI,2606,2601,ADAMPUR-DELHI,5207,All
2020,1,ADAMPUR,DELHI,2198,2248,ADAMPUR-DELHI,4446,All
2020,2,ADAMPUR,DELHI,2178,2190,ADAMPUR-DELHI,4368,All
2020,3,ADAMPUR,DELHI,1170,1144,ADAMPUR-DELHI,2314,All
2020,5,ADAMPUR,DELHI,59,45,ADAMPUR-DELHI,104,All
2020,11,ADAMPUR,DELHI,257,205,ADAMPUR-DELHI,462,All
2020,12,ADAMPUR,DELHI,939,863,ADAMPUR-DELHI,1802,All
2021,1,ADAMPUR,DELHI,1523,1447,ADAMPUR-DELHI,2970,All
2021,2,ADAMPUR,DELHI,1932,1923,ADAMPUR-DELHI,3855,All
2021,3,ADAMPUR,DELHI,1847,1921,ADAMPUR-DELHI,3768,All
2021,4,ADAMPUR,DELHI,905,872,ADAMPUR-DELHI,1777,All
2023,10,ADAMPUR,DELHI,140,131,ADAMPUR-DELHI,271,All
2021,12,ADAMPUR,GUWAHATI,0,5,ADAMPUR-GUWAHATI,5,All
2024,3,ADAMPUR,HINDON AIRPORT,54,63,ADAMPUR-HINDON AIRPORT,117,All
2024,4,ADAMPUR,HINDON AIRPORT,1724,1559,ADAMPUR-HINDON AIRPORT,3283,All
2024,6,ADAMPUR,HINDON AIRPORT,1661,1424,ADAMPUR-HINDON AIRPORT,3085,All
2024,7,ADAMPUR,HINDON AIRPORT,1280,1214,ADAMPUR-HINDON AIRPORT,2494,All
2024,8,ADAMPUR,HINDON AIRPORT,1063,976,ADAMPUR-HINDON AIRPORT,2039,All
2024,9,ADAMPUR,HINDON AIRPORT,881,817,ADAMPUR-HINDON AIRPORT,1698,All
2024,10,ADAMPUR,HINDON AIRPORT,1561,1578,ADAMPUR-HINDON AIRPORT,3139,All
2024,11,ADAMPUR,HINDON AIRPORT,1670,1528,ADAMPUR-HINDON AIRPORT,3198,All
2024,12,ADAMPUR,HINDON AIRPORT,1709,2018,ADAMPUR-HINDON AIRPORT,3727,All
2025,1,ADAMPUR,HINDON AIRPORT,1431,1317,ADAMPUR-HINDON AIRPORT,2748,All
2025,2,ADAMPUR,HINDON AIRPORT,1686,1653,ADAMPUR-HINDON AIRPORT,3339,All
2025,3,ADAMPUR,HINDON AIRPORT,1902,1839,ADAMPUR-HINDON AIRPORT,3741,All
2021,3,ADAMPUR,JAIPUR,23,22,ADAMPUR-JAIPUR,45,All
2021,4,ADAMPUR,JAIPUR,43,44,ADAMPUR-JAIPUR,87,All
2020,12,ADAMPUR,KANDLA,0,4,ADAMPUR-KANDLA,4,All
2021,1,ADAMPUR,KANDLA,0,2,ADAMPUR-KANDLA,2,All
2020,11,ADAMPUR,MUMBAI,169,72,ADAMPUR-MUMBAI,241,All
2020,12,ADAMPUR,MUMBAI,912,558,ADAMPUR-MUMBAI,1470,All
2021,1,ADAMPUR,MUMBAI,272,159,ADAMPUR-MUMBAI,431,All
2021,3,ADAMPUR,MUMBAI,42,60,ADAMPUR-MUMBAI,102,All
2021,4,ADAMPUR,MUMBAI,143,138,ADAMPUR-MUMBAI,281,All
2021,12,ADAMPUR,PATNA,0,47,ADAMPUR-PATNA,47,All
2021,7,AGARTALA,AHMEDABAD,0,210,AGARTALA-AHMEDABAD,210,All
2021,8,AGARTALA,AHMEDABAD,0,168,AGARTALA-AHMEDABAD,168,All
2021,9,AGARTALA,AHMEDABAD,77,216,AGARTALA-AHMEDABAD,293,All
2021,10,AGARTALA,AHMEDABAD,149,266,AGARTALA-AHMEDABAD,415,All
2021,11,AGARTALA,AHMEDABAD,91,208,AGARTALA-AHMEDABAD,299,All
2021,12,AGARTALA,AHMEDABAD,52,335,AGARTALA-AHMEDABAD,387,All
2022,1,AGARTALA,AHMEDABAD,23,143,AGARTALA-AHMEDABAD,166,All
2022,2,AGARTALA,AHMEDABAD,0,254,AGARTALA-AHMEDABAD,254,All
2022,3,AGARTALA,AHMEDABAD,185,204,AGARTALA-AHMEDABAD,389,All
2022,4,AGARTALA,AHMEDABAD,89,131,AGARTALA-AHMEDABAD,220,All
2022,5,AGARTALA,AHMEDABAD,310,403,AGARTALA-AHMEDABAD,713,All
2022,6,AGARTALA,AHMEDABAD,325,422,AGARTALA-AHMEDABAD,747,All
2022,7,AGARTALA,AHMEDABAD,255,420,AGARTALA-AHMEDABAD,675,All
2022,8,AGARTALA,AHMEDABAD,276,363,AGARTALA-AHMEDABAD,639,All
2022,9,AGARTALA,AHMEDABAD,136,463,AGARTALA-AHMEDABAD,599,All
2022,10,AGARTALA,AHMEDABAD,599,411,AGARTALA-AHMEDABAD,1010,All
2022,11,AGARTALA,AHMEDABAD,341,245,AGARTALA-AHMEDABAD,586,All
2022,12,AGARTALA,AHMEDABAD,499,639,AGARTALA-AHMEDABAD,1138,All
2023,1,AGARTALA,AHMEDABAD,411,415,AGARTALA-AHMEDABAD,826,All
2023,2,AGARTALA,AHMEDABAD,372,332,AGARTALA-AHMEDABAD,704,All
2023,3,AGARTALA,AHMEDABAD,209,387,AGARTALA-AHMEDABAD,596,All
2023,4,AGARTALA,AHMEDABAD,290,322,AGARTALA-AHMEDABAD,612,All
2023,5,AGARTALA,AHMEDABAD,231,212,AGARTALA-AHMEDABAD,443,All
2023,6,AGARTALA,AHMEDABAD,260,268,AGARTALA-AHMEDABAD,528,All
2023,7,AGARTALA,AHMEDABAD,69,125,AGARTALA-AHMEDABAD,194,All
2023,8,AGARTALA,AHMEDABAD,41,76,AGARTALA-AHMEDABAD,117,All
2023,9,AGARTALA,AHMEDABAD,66,90,AGARTALA-AHMEDABAD,156,All
2023,10,AGARTALA,AHMEDABAD,208,486,AGARTALA-AHMEDABAD,694,All
2023,11,AGARTALA,AHMEDABAD,423,303,AGARTALA-AHMEDABAD,726,All
2023,12,AGARTALA,AHMEDABAD,278,357,AGARTALA-AHMEDABAD,635,All
2024,1,AGARTALA,AHMEDABAD,359,147,AGARTALA-AHMEDABAD,506,All
2024,2,AGARTALA,AHMEDABAD,329,284,AGARTALA-AHMEDABAD,613,All
2024,3,AGARTALA,AHMEDABAD,297,244,AGARTALA-AHMEDABAD,541,All
2024,10,AGARTALA,AHMEDABAD,34,24,AGARTALA-AHMEDABAD,58,All
2024,11,AGARTALA,AHMEDABAD,172,155,AGARTALA-AHMEDABAD,327,All
2024,12,AGARTALA,AHMEDABAD,96,368,AGARTALA-AHMEDABAD,464,All
2025,3,AGARTALA,AHMEDABAD,108,167,AGARTALA-AHMEDABAD,275,All
2020,2,AGARTALA,AIZAWL,47,36,AGARTALA-AIZAWL,83,All
2020,3,AGARTALA,AIZAWL,1204,690,AGARTALA-AIZAWL,1894,All
2021,3,AGARTALA,AIZAWL,13,10,AGARTALA-AIZAWL,23,All
2021,4,AGARTALA,AIZAWL,155,154,AGARTALA-AIZAWL,309,All
2021,11,AGARTALA,AIZAWL,308,464,AGARTALA-AIZAWL,772,All
2021,12,AGARTALA,AIZAWL,288,343,AGARTALA-AIZAWL,631,All
2022,1,AGARTALA,AIZAWL,203,199,AGARTALA-AIZAWL,402,All
2022,2,AGARTALA,AIZAWL,193,201,AGARTALA-AIZAWL,394,All
2022,3,AGARTALA,AIZAWL,393,385,AGARTALA-AIZAWL,778,All
2022,4,AGARTALA,AIZAWL,402,299,AGARTALA-AIZAWL,701,All
2022,5,AGARTALA,AIZAWL,580,435,AGARTALA-AIZAWL,1015,All
2022,6,AGARTALA,AIZAWL,525,528,AGARTALA-AIZAWL,1053,All
2022,7,AGARTALA,AIZAWL,467,358,AGARTALA-AIZAWL,825,All
2022,8,AGARTALA,AIZAWL,423,338,AGARTALA-AIZAWL,761,All
2022,9,AGARTALA,AIZAWL,514,489,AGARTALA-AIZAWL,1003,All
2022,10,AGARTALA,AIZAWL,617,596,AGARTALA-AIZAWL,1213,All
2022,11,AGARTALA,AIZAWL,714,735,AGARTALA-AIZAWL,1449,All
2022,12,AGARTALA,AIZAWL,749,681,AGARTALA-AIZAWL,1430,All
2023,1,AGARTALA,AIZAWL,506,579,AGARTALA-AIZAWL,1085,All
2023,2,AGARTALA,AIZAWL,531,406,AGARTALA-AIZAWL,937,All
2023,3,AGARTALA,AIZAWL,921,716,AGARTALA-AIZAWL,1637,All
2023,4,AGARTALA,AIZAWL,763,544,AGARTALA-AIZAWL,1307,All
2023,5,AGARTALA,AIZAWL,998,832,AGARTALA-AIZAWL,1830,All
2024,7,AGARTALA,AIZAWL,176,0,AGARTALA-AIZAWL,176,All
2019,5,AGARTALA,BAGDOGRA,10,0,AGARTALA-BAGDOGRA,10,All
2019,7,AGARTALA,BAGDOGRA,0,9,AGARTALA-BAGDOGRA,9,All
2019,8,AGARTALA,BAGDOGRA,0,186,AGARTALA-BAGDOGRA,186,All
2019,9,AGARTALA,BAGDOGRA,0,167,AGARTALA-BAGDOGRA,167,All
2019,10,AGARTALA,BAGDOGRA,0,141,AGARTALA-BAGDOGRA,141,All
2019,5,AGARTALA,BENGALURU,4774,4129,AGARTALA-BENGALURU,8903,All
2019,6,AGARTALA,BENGALURU,2945,2710,AGARTALA-BENGALURU,5655,All
2019,7,AGARTALA,BENGALURU,3205,3313,AGARTALA-BENGALURU,6518,All
2019,8,AGARTALA,BENGALURU,3710,3754,AGARTALA-BENGALURU,7464,All
2019,9,AGARTALA,BENGALURU,2241,4120,AGARTALA-BENGALURU,6361,All
2019,10,AGARTALA,BENGALURU,3948,4003,AGARTALA-BENGALURU,7951,All
2019,11,AGARTALA,BENGALURU,3690,2854,AGARTALA-BENGALURU,6544,All
2019,12,AGARTALA,BENGALURU,4527,4435,AGARTALA-BENGALURU,8962,All
2020,1,AGARTALA,BENGALURU,4294,4607,AGARTALA-BENGALURU,8901,All
2020,2,AGARTALA,BENGALURU,3517,3554,AGARTALA-BENGALURU,7071,All
2020,3,AGARTALA,BENGALURU,1972,3547,AGARTALA-BENGALURU,5519,All
2020,6,AGARTALA,BENGALURU,401,390,AGARTALA-BENGALURU,791,All
2020,7,AGARTALA,BENGALURU,532,1512,AGARTALA-BENGALURU,2044,All
2020,8,AGARTALA,BENGALURU,724,1502,AGARTALA-BENGALURU,2226,All
2020,9,AGARTALA,BENGALURU,2372,1782,AGARTALA-BENGALURU,4154,All
2020,10,AGARTALA,BENGALURU,4163,2780,AGARTALA-BENGALURU,6943,All
2020,11,AGARTALA,BENGALURU,5096,2831,AGARTALA-BENGALURU,7927,All
2020,12,AGARTALA,BENGALURU,4214,3504,AGARTALA-BENGALURU,7718,All
2021,1,AGARTALA,BENGALURU,3549,2226,AGARTALA-BENGALURU,5775,All
2021,2,AGARTALA,BENGALURU,3483,2173,AGARTALA-BENGALURU,5656,All
2021,3,AGARTALA,BENGALURU,2703,2267,AGARTALA-BENGALURU,4970,All
2021,4,AGARTALA,BENGALURU,2039,4803,AGARTALA-BENGALURU,6842,All
2021,6,AGARTALA,BENGALURU,83,83,AGARTALA-BENGALURU,166,All
2021,7,AGARTALA,BENGALURU,576,237,AGARTALA-BENGALURU,813,All
2021,8,AGARTALA,BENGALURU,1017,660,AGARTALA-BENGALURU,1677,All
2021,9,AGARTALA,BENGALURU,1609,1315,AGARTALA-BENGALURU,2924,All
2021,10,AGARTALA,BENGALURU,1835,1856,AGARTALA-BENGALURU,3691,All
2021,11,AGARTALA,BENGALURU,3100,2666,AGARTALA-BENGALURU,5766,All
2021,12,AGARTALA,BENGALURU,3665,2799,AGARTALA-BENGALURU,6464,All
2022,1,AGARTALA,BENGALURU,1145,2193,AGARTALA-BENGALURU,3338,All
2022,2,AGARTALA,BENGALURU,1528,1499,AGARTALA-BENGALURU,3027,All
2022,3,AGARTALA,BENGALURU,2930,2996,AGARTALA-BENGALURU,5926,All
2022,4,AGARTALA,BENGALURU,3859,3443,AGARTALA-BENGALURU,7302,All
2022,5,AGARTALA,BENGALURU,4516,3540,AGARTALA-BENGALURU,8056,All
2022,6,AGARTALA,BENGALURU,4553,4107,AGARTALA-BENGALURU,8660,All
2022,7,AGARTALA,BENGALURU,4542,4463,AGARTALA-BENGALURU,9005,All
2022,8,AGARTALA,BENGALURU,4867,4643,AGARTALA-BENGALURU,9510,All
2022,9,AGARTALA,BENGALURU,4249,5228,AGARTALA-BENGALURU,9477,All
2022,10,AGARTALA,BENGALURU,5282,4650,AGARTALA-BENGALURU,9932,All
2022,11,AGARTALA,BENGALURU,3165,2716,AGARTALA-BENGALURU,5881,All
2022,12,AGARTALA,BENGALURU,3559,2567,AGARTALA-BENGALURU,6126,All
2023,1,AGARTALA,BENGALURU,4040,3850,AGARTALA-BENGALURU,7890,All
2023,2,AGARTALA,BENGALURU,2794,2270,AGARTALA-BENGALURU,5064,All
2023,3,AGARTALA,BENGALURU,4750,3516,AGARTALA-BENGALURU,8266,All
2023,4,AGARTALA,BENGALURU,6157,5065,AGARTALA-BENGALURU,11222,All
2023,5,AGARTALA,BENGALURU,5663,5562,AGARTALA-BENGALURU,11225,All
2023,6,AGARTALA,BENGALURU,5417,5645,AGARTALA-BENGALURU,11062,All
2023,7,AGARTALA,BENGALURU,3319,3091,AGARTALA-BENGALURU,6410,All
2023,8,AGARTALA,BENGALURU,4580,4069,AGARTALA-BENGALURU,8649,All
2023,9,AGARTALA,BENGALURU,4755,4067,AGARTALA-BENGALURU,8822,All
2023,10,AGARTALA,BENGALURU,4726,5848,AGARTALA-BENGALURU,10574,All
2023,11,AGARTALA,BENGALURU,5281,4958,AGARTALA-BENGALURU,10239,All
2023,12,AGARTALA,BENGALURU,6134,4891,AGARTALA-BENGALURU,11025,All
2024,1,AGARTALA,BENGALURU,4757,5866,AGARTALA-BENGALURU,10623,All
2024,2,AGARTALA,BENGALURU,3919,3978,AGARTALA-BENGALURU,7897,All
2024,3,AGARTALA,BENGALURU,5131,4971,AGARTALA-BENGALURU,10102,All
2024,4,AGARTALA,BENGALURU,3854,4099,AGARTALA-BENGALURU,7953,All
2024,6,AGARTALA,BENGALURU,5413,5022,AGARTALA-BENGALURU,10435,All
2024,7,AGARTALA,BENGALURU,6067,4734,AGARTALA-BENGALURU,10801,All
2024,8,AGARTALA,BENGALURU,4779,4193,AGARTALA-BENGALURU,8972,All
2024,9,AGARTALA,BENGALURU,3692,4454,AGARTALA-BENGALURU,8146,All
2024,10,AGARTALA,BENGALURU,4671,5171,AGARTALA-BENGALURU,9842,All
2024,11,AGARTALA,BENGALURU,4217,4292,AGARTALA-BENGALURU,8509,All
2024,12,AGARTALA,BENGALURU,4029,4297,AGARTALA-BENGALURU,8326,All
2025,1,AGARTALA,BENGALURU,3847,4392,AGARTALA-BENGALURU,8239,All
2025,2,AGARTALA,BENGALURU,3570,3599,AGARTALA-BENGALURU,7169,All
2025,3,AGARTALA,BENGALURU,3903,3978,AGARTALA-BENGALURU,7881,All
2022,5,AGARTALA,BHUBANESWAR,18,0,AGARTALA-BHUBANESWAR,18,All
2022,6,AGARTALA,BHUBANESWAR,0,90,AGARTALA-BHUBANESWAR,90,All
2015,10,AGARTALA,CHENNAI,304,303,AGARTALA-CHENNAI,607,All
2015,11,AGARTALA,CHENNAI,728,594,AGARTALA-CHENNAI,1322,All
2015,12,AGARTALA,CHENNAI,689,567,AGARTALA-CHENNAI,1256,All
2016,1,AGARTALA,CHENNAI,1142,854,AGARTALA-CHENNAI,1996,All
2016,2,AGARTALA,CHENNAI,849,1124,AGARTALA-CHENNAI,1973,All
2016,3,AGARTALA,CHENNAI,774,193,AGARTALA-CHENNAI,967,All
2016,4,AGARTALA,CHENNAI,521,974,AGARTALA-CHENNAI,1495,All
2016,5,AGARTALA,CHENNAI,1017,1347,AGARTALA-CHENNAI,2364,All
2016,6,AGARTALA,CHENNAI,1149,1191,AGARTALA-CHENNAI,2340,All
2016,7,AGARTALA,CHENNAI,508,486,AGARTALA-CHENNAI,994,All
2016,8,AGARTALA,CHENNAI,397,548,AGARTALA-CHENNAI,945,All
2016,9,AGARTALA,CHENNAI,360,441,AGARTALA-CHENNAI,801,All
2016,10,AGARTALA,CHENNAI,384,809,AGARTALA-CHENNAI,1193,All
2016,11,AGARTALA,CHENNAI,723,1215,AGARTALA-CHENNAI,1938,All
2016,12,AGARTALA,CHENNAI,967,996,AGARTALA-CHENNAI,1963,All
2017,1,AGARTALA,CHENNAI,664,1234,AGARTALA-CHENNAI,1898,All
2017,2,AGARTALA,CHENNAI,1021,1289,AGARTALA-CHENNAI,2310,All
2017,3,AGARTALA,CHENNAI,871,998,AGARTALA-CHENNAI,1869,All
2017,4,AGARTALA,CHENNAI,746,694,AGARTALA-CHENNAI,1440,All
2017,5,AGARTALA,CHENNAI,885,766,AGARTALA-CHENNAI,1651,All
2017,6,AGARTALA,CHENNAI,1018,802,AGARTALA-CHENNAI,1820,All
2017,7,AGARTALA,CHENNAI,1185,1073,AGARTALA-CHENNAI,2258,All
2017,8,AGARTALA,CHENNAI,1037,1120,AGARTALA-CHENNAI,2157,All
2017,9,AGARTALA,CHENNAI,1222,1038,AGARTALA-CHENNAI,2260,All
2017,10,AGARTALA,CHENNAI,1260,1068,AGARTALA-CHENNAI,2328,All
2017,11,AGARTALA,CHENNAI,2095,1704,AGARTALA-CHENNAI,3799,All
2017,12,AGARTALA,CHENNAI,2044,1839,AGARTALA-CHENNAI,3883,All
2018,1,AGARTALA,CHENNAI,2934,2819,AGARTALA-CHENNAI,5753,All
2018,2,AGARTALA,CHENNAI,3316,4470,AGARTALA-CHENNAI,7786,All
2018,3,AGARTALA,CHENNAI,4160,4033,AGARTALA-CHENNAI,8193,All
2018,4,AGARTALA,CHENNAI,4578,2643,AGARTALA-CHENNAI,7221,All
2018,5,AGARTALA,CHENNAI,4971,2452,AGARTALA-CHENNAI,7423,All
2018,6,AGARTALA,CHENNAI,4873,2202,AGARTALA-CHENNAI,7075,All
2018,7,AGARTALA,CHENNAI,4189,2004,AGARTALA-CHENNAI,6193,All
2018,8,AGARTALA,CHENNAI,3631,1657,AGARTALA-CHENNAI,5288,All
2018,9,AGARTALA,CHENNAI,2826,1769,AGARTALA-CHENNAI,4595,All
2018,10,AGARTALA,CHENNAI,4064,1791,AGARTALA-CHENNAI,5855,All
2018,11,AGARTALA,CHENNAI,1586,1343,AGARTALA-CHENNAI,2929,All
2018,12,AGARTALA,CHENNAI,1536,1695,AGARTALA-CHENNAI,3231,All
2019,1,AGARTALA,CHENNAI,1363,1637,AGARTALA-CHENNAI,3000,All
2019,2,AGARTALA,CHENNAI,878,1590,AGARTALA-CHENNAI,2468,All
2019,3,AGARTALA,CHENNAI,1392,1733,AGARTALA-CHENNAI,3125,All
2019,4,AGARTALA,CHENNAI,1932,1974,AGARTALA-CHENNAI,3906,All
2019,5,AGARTALA,CHENNAI,2057,2095,AGARTALA-CHENNAI,4152,All
2019,6,AGARTALA,CHENNAI,2125,2002,AGARTALA-CHENNAI,4127,All
2019,7,AGARTALA,CHENNAI,2266,1555,AGARTALA-CHENNAI,3821,All
2019,8,AGARTALA,CHENNAI,3401,2668,AGARTALA-CHENNAI,6069,All
2019,9,AGARTALA,CHENNAI,1895,1742,AGARTALA-CHENNAI,3637,All
2019,10,AGARTALA,CHENNAI,2318,1402,AGARTALA-CHENNAI,3720,All
2019,11,AGARTALA,CHENNAI,2280,1327,AGARTALA-CHENNAI,3607,All
2019,12,AGARTALA,CHENNAI,3382,1729,AGARTALA-CHENNAI,5111,All
2020,1,AGARTALA,CHENNAI,2320,1373,AGARTALA-CHENNAI,3693,All
2020,2,AGARTALA,CHENNAI,1895,1191,AGARTALA-CHENNAI,3086,All
2020,3,AGARTALA,CHENNAI,1244,1121,AGARTALA-CHENNAI,2365,All
2020,8,AGARTALA,CHENNAI,32,35,AGARTALA-CHENNAI,67,All
2020,9,AGARTALA,CHENNAI,333,265,AGARTALA-CHENNAI,598,All
2020,10,AGARTALA,CHENNAI,390,359,AGARTALA-CHENNAI,749,All
2020,11,AGARTALA,CHENNAI,681,787,AGARTALA-CHENNAI,1468,All
2020,12,AGARTALA,CHENNAI,961,1138,AGARTALA-CHENNAI,2099,All
2021,1,AGARTALA,CHENNAI,858,785,AGARTALA-CHENNAI,1643,All
2021,2,AGARTALA,CHENNAI,885,1096,AGARTALA-CHENNAI,1981,All
2021,3,AGARTALA,CHENNAI,469,543,AGARTALA-CHENNAI,1012,All
2021,4,AGARTALA,CHENNAI,1286,2577,AGARTALA-CHENNAI,3863,All
2021,7,AGARTALA,CHENNAI,197,0,AGARTALA-CHENNAI,197,All
2022,2,AGARTALA,CHENNAI,0,312,AGARTALA-CHENNAI,312,All
2022,3,AGARTALA,CHENNAI,0,93,AGARTALA-CHENNAI,93,All
2022,5,AGARTALA,CHENNAI,959,906,AGARTALA-CHENNAI,1865,All
2022,6,AGARTALA,CHENNAI,2004,2039,AGARTALA-CHENNAI,4043,All
2022,7,AGARTALA,CHENNAI,2127,1798,AGARTALA-CHENNAI,3925,All
2022,8,AGARTALA,CHENNAI,2190,1815,AGARTALA-CHENNAI,4005,All
2022,9,AGARTALA,CHENNAI,430,209,AGARTALA-CHENNAI,639,All
2022,10,AGARTALA,CHENNAI,2036,987,AGARTALA-CHENNAI,3023,All
2022,11,AGARTALA,CHENNAI,1931,1026,AGARTALA-CHENNAI,2957,All
2022,12,AGARTALA,CHENNAI,1090,643,AGARTALA-CHENNAI,1733,All
2023,1,AGARTALA,CHENNAI,124,421,AGARTALA-CHENNAI,545,All
2023,2,AGARTALA,CHENNAI,746,371,AGARTALA-CHENNAI,1117,All
2023,3,AGARTALA,CHENNAI,1509,721,AGARTALA-CHENNAI,2230,All
2023,4,AGARTALA,CHENNAI,1804,441,AGARTALA-CHENNAI,2245,All
2023,5,AGARTALA,CHENNAI,1076,410,AGARTALA-CHENNAI,1486,All
2023,6,AGARTALA,CHENNAI,1369,690,AGARTALA-CHENNAI,2059,All
2023,7,AGARTALA,CHENNAI,1557,444,AGARTALA-CHENNAI,2001,All
2023,8,AGARTALA,CHENNAI,1197,281,AGARTALA-CHENNAI,1478,All
2023,9,AGARTALA,CHENNAI,838,347,AGARTALA-CHENNAI,1185,All
2023,10,AGARTALA,CHENNAI,834,642,AGARTALA-CHENNAI,1476,All
2024,6,AGARTALA,CHENNAI,931,501,AGARTALA-CHENNAI,1432,All
2024,7,AGARTALA,CHENNAI,461,176,AGARTALA-CHENNAI,637,All
2024,8,AGARTALA,CHENNAI,710,387,AGARTALA-CHENNAI,1097,All
2024,9,AGARTALA,CHENNAI,464,232,AGARTALA-CHENNAI,696,All
2024,10,AGARTALA,CHENNAI,461,284,AGARTALA-CHENNAI,745,All
2024,11,AGARTALA,CHENNAI,1177,732,AGARTALA-CHENNAI,1909,All
2024,12,AGARTALA,CHENNAI,1032,508,AGARTALA-CHENNAI,1540,All
2025,3,AGARTALA,CHENNAI,1085,523,AGARTALA-CHENNAI,1608,All
2019,5,AGARTALA,COIMBATORE,0,10,AGARTALA-COIMBATORE,10,All
2019,6,AGARTALA,COIMBATORE,0,17,AGARTALA-COIMBATORE,17,All
2019,7,AGARTALA,COIMBATORE,0,18,AGARTALA-COIMBATORE,18,All
2019,8,AGARTALA,COIMBATORE,0,13,AGARTALA-COIMBATORE,13,All
2019,9,AGARTALA,COIMBATORE,0,56,AGARTALA-COIMBATORE,56,All
2019,10,AGARTALA,COIMBATORE,0,18,AGARTALA-COIMBATORE,18,All
2019,11,AGARTALA,COIMBATORE,0,3,AGARTALA-COIMBATORE,3,All
2019,12,AGARTALA,COIMBATORE,0,2,AGARTALA-COIMBATORE,2,All
2020,1,AGARTALA,COIMBATORE,0,5,AGARTALA-COIMBATORE,5,All
2020,2,AGARTALA,COIMBATORE,10,6,AGARTALA-COIMBATORE,16,All
2020,3,AGARTALA,COIMBATORE,13,3,AGARTALA-COIMBATORE,16,All
2021,4,AGARTALA,DABOLIM,0,6,AGARTALA-DABOLIM,6,All
2019,5,AGARTALA,DELHI,2930,3022,AGARTALA-DELHI,5952,All
2019,6,AGARTALA,DELHI,2669,2652,AGARTALA-DELHI,5321,All
2019,7,AGARTALA,DELHI,2021,1214,AGARTALA-DELHI,3235,All
2019,8,AGARTALA,DELHI,4657,3835,AGARTALA-DELHI,8492,All
2019,9,AGARTALA,DELHI,5023,6087,AGARTALA-DELHI,11110,All
2019,10,AGARTALA,DELHI,6933,6178,AGARTALA-DELHI,13111,All
2019,11,AGARTALA,DELHI,5480,5399,AGARTALA-DELHI,10879,All
2019,12,AGARTALA,DELHI,6080,6922,AGARTALA-DELHI,13002,All
2020,1,AGARTALA,DELHI,5467,5823,AGARTALA-DELHI,11290,All
2020,2,AGARTALA,DELHI,6246,5365,AGARTALA-DELHI,11611,All
2020,3,AGARTALA,DELHI,4230,5448,AGARTALA-DELHI,9678,All
2020,6,AGARTALA,DELHI,150,261,AGARTALA-DELHI,411,All
2020,7,AGARTALA,DELHI,2726,3876,AGARTALA-DELHI,6602,All
2020,8,AGARTALA,DELHI,3845,3354,AGARTALA-DELHI,7199,All
2020,9,AGARTALA,DELHI,3738,3337,AGARTALA-DELHI,7075,All
2020,10,AGARTALA,DELHI,3212,3309,AGARTALA-DELHI,6521,All
2020,11,AGARTALA,DELHI,4761,4388,AGARTALA-DELHI,9149,All
2020,12,AGARTALA,DELHI,3916,4923,AGARTALA-DELHI,8839,All
2021,1,AGARTALA,DELHI,4695,4679,AGARTALA-DELHI,9374,All
2021,2,AGARTALA,DELHI,6755,5800,AGARTALA-DELHI,12555,All
2021,3,AGARTALA,DELHI,7524,7265,AGARTALA-DELHI,14789,All
2021,4,AGARTALA,DELHI,5817,7778,AGARTALA-DELHI,13595,All
2021,6,AGARTALA,DELHI,2388,2789,AGARTALA-DELHI,5177,All
2021,7,AGARTALA,DELHI,3733,3418,AGARTALA-DELHI,7151,All
2021,8,AGARTALA,DELHI,4083,3545,AGARTALA-DELHI,7628,All
2021,9,AGARTALA,DELHI,4003,4336,AGARTALA-DELHI,8339,All
2021,10,AGARTALA,DELHI,6813,6645,AGARTALA-DELHI,13458,All
2021,11,AGARTALA,DELHI,6363,6548,AGARTALA-DELHI,12911,All
2021,12,AGARTALA,DELHI,6870,7451,AGARTALA-DELHI,14321,All
2022,1,AGARTALA,DELHI,4058,5423,AGARTALA-DELHI,9481,All
2022,2,AGARTALA,DELHI,5003,4619,AGARTALA-DELHI,9622,All
2022,3,AGARTALA,DELHI,7010,6504,AGARTALA-DELHI,13514,All
2022,4,AGARTALA,DELHI,4660,4634,AGARTALA-DELHI,9294,All
2022,5,AGARTALA,DELHI,5145,4836,AGARTALA-DELHI,9981,All
2022,6,AGARTALA,DELHI,5595,5501,AGARTALA-DELHI,11096,All
2022,7,AGARTALA,DELHI,5382,4825,AGARTALA-DELHI,10207,All
2022,8,AGARTALA,DELHI,4868,4193,AGARTALA-DELHI,9061,All
2022,9,AGARTALA,DELHI,4689,4277,AGARTALA-DELHI,8966,All
2022,10,AGARTALA,DELHI,5422,5028,AGARTALA-DELHI,10450,All
2022,11,AGARTALA,DELHI,5302,5308,AGARTALA-DELHI,10610,All
2022,12,AGARTALA,DELHI,5326,5522,AGARTALA-DELHI,10848,All
2023,1,AGARTALA,DELHI,5416,4769,AGARTALA-DELHI,10185,All
2023,2,AGARTALA,DELHI,4398,3879,AGARTALA-DELHI,8277,All
2023,3,AGARTALA,DELHI,5281,5226,AGARTALA-DELHI,10507,All
2023,4,AGARTALA,DELHI,5584,5547,AGARTALA-DELHI,11131,All
2023,5,AGARTALA,DELHI,5248,5224,AGARTALA-DELHI,10472,All
2023,6,AGARTALA,DELHI,4911,5067,AGARTALA-DELHI,9978,All
2023,7,AGARTALA,DELHI,5143,5080,AGARTALA-DELHI,10223,All
2023,8,AGARTALA,DELHI,5124,5045,AGARTALA-DELHI,10169,All
2023,9,AGARTALA,DELHI,4338,4303,AGARTALA-DELHI,8641,All
2023,10,AGARTALA,DELHI,5147,5382,AGARTALA-DELHI,10529,All
2023,11,AGARTALA,DELHI,6104,6180,AGARTALA-DELHI,12284,All
2023,12,AGARTALA,DELHI,6007,6567,AGARTALA-DELHI,12574,All
2024,1,AGARTALA,DELHI,6142,6425,AGARTALA-DELHI,12567,All
2024,2,AGARTALA,DELHI,5729,5809,AGARTALA-DELHI,11538,All
2024,3,AGARTALA,DELHI,5716,6271,AGARTALA-DELHI,11987,All
2024,4,AGARTALA,DELHI,4617,5055,AGARTALA-DELHI,9672,All
2024,6,AGARTALA,DELHI,4539,5144,AGARTALA-DELHI,9683,All
2024,7,AGARTALA,DELHI,5167,4878,AGARTALA-DELHI,10045,All
2024,8,AGARTALA,DELHI,4505,4594,AGARTALA-DELHI,9099,All
2024,9,AGARTALA,DELHI,3418,4143,AGARTALA-DELHI,7561,All
2024,10,AGARTALA,DELHI,4771,5184,AGARTALA-DELHI,9955,All
2024,11,AGARTALA,DELHI,5053,5145,AGARTALA-DELHI,10198,All
2024,12,AGARTALA,DELHI,4969,5340,AGARTALA-DELHI,10309,All
2025,1,AGARTALA,DELHI,4833,5203,AGARTALA-DELHI,10036,All
2025,2,AGARTALA,DELHI,5569,5879,AGARTALA-DELHI,11448,All
2025,3,AGARTALA,DELHI,6175,6862,AGARTALA-DELHI,13037,All
2021,6,AGARTALA,DIBRUGARH,65,55,AGARTALA-DIBRUGARH,120,All
2021,7,AGARTALA,DIBRUGARH,339,330,AGARTALA-DIBRUGARH,669,All
2021,8,AGARTALA,DIBRUGARH,545,535,AGARTALA-DIBRUGARH,1080,All
2021,9,AGARTALA,DIBRUGARH,506,435,AGARTALA-DIBRUGARH,941,All
2021,10,AGARTALA,DIBRUGARH,838,869,AGARTALA-DIBRUGARH,1707,All
2021,11,AGARTALA,DIBRUGARH,590,705,AGARTALA-DIBRUGARH,1295,All
2021,12,AGARTALA,DIBRUGARH,812,837,AGARTALA-DIBRUGARH,1649,All
2022,1,AGARTALA,DIBRUGARH,538,492,AGARTALA-DIBRUGARH,1030,All
2022,2,AGARTALA,DIBRUGARH,752,854,AGARTALA-DIBRUGARH,1606,All
2022,3,AGARTALA,DIBRUGARH,682,705,AGARTALA-DIBRUGARH,1387,All
2022,4,AGARTALA,DIBRUGARH,862,849,AGARTALA-DIBRUGARH,1711,All
2022,5,AGARTALA,DIBRUGARH,1578,1340,AGARTALA-DIBRUGARH,2918,All
2022,6,AGARTALA,DIBRUGARH,987,1394,AGARTALA-DIBRUGARH,2381,All
2022,7,AGARTALA,DIBRUGARH,1136,1471,AGARTALA-DIBRUGARH,2607,All
2022,8,AGARTALA,DIBRUGARH,1011,1245,AGARTALA-DIBRUGARH,2256,All
2022,9,AGARTALA,DIBRUGARH,961,1144,AGARTALA-DIBRUGARH,2105,All
2022,10,AGARTALA,DIBRUGARH,1470,1533,AGARTALA-DIBRUGARH,3003,All
2022,11,AGARTALA,DIBRUGARH,1190,1604,AGARTALA-DIBRUGARH,2794,All
2022,12,AGARTALA,DIBRUGARH,1269,1600,AGARTALA-DIBRUGARH,2869,All
2023,1,AGARTALA,DIBRUGARH,1025,1339,AGARTALA-DIBRUGARH,2364,All
2023,2,AGARTALA,DIBRUGARH,931,831,AGARTALA-DIBRUGARH,1762,All
2023,3,AGARTALA,DIBRUGARH,846,882,AGARTALA-DIBRUGARH,1728,All
2023,4,AGARTALA,DIBRUGARH,968,1113,AGARTALA-DIBRUGARH,2081,All
2023,5,AGARTALA,DIBRUGARH,923,815,AGARTALA-DIBRUGARH,1738,All
2023,6,AGARTALA,DIBRUGARH,934,1004,AGARTALA-DIBRUGARH,1938,All
2023,7,AGARTALA,DIBRUGARH,1156,968,AGARTALA-DIBRUGARH,2124,All
2023,8,AGARTALA,DIBRUGARH,872,844,AGARTALA-DIBRUGARH,1716,All
2023,9,AGARTALA,DIBRUGARH,423,438,AGARTALA-DIBRUGARH,861,All
2023,10,AGARTALA,DIBRUGARH,239,212,AGARTALA-DIBRUGARH,451,All
2024,1,AGARTALA,DIBRUGARH,65,0,AGARTALA-DIBRUGARH,65,All
2024,10,AGARTALA,DIBRUGARH,39,50,AGARTALA-DIBRUGARH,89,All
2024,11,AGARTALA,DIBRUGARH,535,506,AGARTALA-DIBRUGARH,1041,All
2024,12,AGARTALA,DIBRUGARH,443,424,AGARTALA-DIBRUGARH,867,All
2025,1,AGARTALA,DIBRUGARH,420,511,AGARTALA-DIBRUGARH,931,All
2025,2,AGARTALA,DIBRUGARH,497,374,AGARTALA-DIBRUGARH,871,All
2025,3,AGARTALA,DIBRUGARH,727,450,AGARTALA-DIBRUGARH,1177,All
2023,9,AGARTALA,DIMAPUR,169,0,AGARTALA-DIMAPUR,169,All
2019,5,AGARTALA,GUWAHATI,11338,8861,AGARTALA-GUWAHATI,20199,All
2019,6,AGARTALA,GUWAHATI,10786,10756,AGARTALA-GUWAHATI,21542,All
2019,7,AGARTALA,GUWAHATI,11355,10213,AGARTALA-GUWAHATI,21568,All
2019,8,AGARTALA,GUWAHATI,10927,9164,AGARTALA-GUWAHATI,20091,All
2019,9,AGARTALA,GUWAHATI,9271,9849,AGARTALA-GUWAHATI,19120,All
2019,10,AGARTALA,GUWAHATI,10870,9725,AGARTALA-GUWAHATI,20595,All
2019,11,AGARTALA,GUWAHATI,12164,10833,AGARTALA-GUWAHATI,22997,All
2019,12,AGARTALA,GUWAHATI,8730,8993,AGARTALA-GUWAHATI,17723,All
2020,1,AGARTALA,GUWAHATI,10581,10553,AGARTALA-GUWAHATI,21134,All
2020,2,AGARTALA,GUWAHATI,10522,9090,AGARTALA-GUWAHATI,19612,All
2020,3,AGARTALA,GUWAHATI,6027,6760,AGARTALA-GUWAHATI,12787,All
2020,5,AGARTALA,GUWAHATI,0,0,AGARTALA-GUWAHATI,0,All
2020,6,AGARTALA,GUWAHATI,40,1091,AGARTALA-GUWAHATI,1131,All
2020,7,AGARTALA,GUWAHATI,903,930,AGARTALA-GUWAHATI,1833,All
2020,8,AGARTALA,GUWAHATI,1062,995,AGARTALA-GUWAHATI,2057,All
2020,9,AGARTALA,GUWAHATI,1361,947,AGARTALA-GUWAHATI,2308,All
2020,10,AGARTALA,GUWAHATI,2351,1894,AGARTALA-GUWAHATI,4245,All
2020,11,AGARTALA,GUWAHATI,4267,3318,AGARTALA-GUWAHATI,7585,All
2020,12,AGARTALA,GUWAHATI,4266,4675,AGARTALA-GUWAHATI,8941,All
2021,1,AGARTALA,GUWAHATI,4646,4435,AGARTALA-GUWAHATI,9081,All
2021,2,AGARTALA,GUWAHATI,4316,4150,AGARTALA-GUWAHATI,8466,All
2021,3,AGARTALA,GUWAHATI,4455,4094,AGARTALA-GUWAHATI,8549,All
2021,4,AGARTALA,GUWAHATI,3735,5547,AGARTALA-GUWAHATI,9282,All
2021,6,AGARTALA,GUWAHATI,1244,1459,AGARTALA-GUWAHATI,2703,All
2021,7,AGARTALA,GUWAHATI,1846,1848,AGARTALA-GUWAHATI,3694,All
2021,8,AGARTALA,GUWAHATI,3294,3352,AGARTALA-GUWAHATI,6646,All
2021,9,AGARTALA,GUWAHATI,4000,4482,AGARTALA-GUWAHATI,8482,All
2021,10,AGARTALA,GUWAHATI,4899,5344,AGARTALA-GUWAHATI,10243,All
2021,11,AGARTALA,GUWAHATI,4505,4524,AGARTALA-GUWAHATI,9029,All
2021,12,AGARTALA,GUWAHATI,4507,5381,AGARTALA-GUWAHATI,9888,All
2022,1,AGARTALA,GUWAHATI,2864,4114,AGARTALA-GUWAHATI,6978,All
2022,2,AGARTALA,GUWAHATI,4178,4004,AGARTALA-GUWAHATI,8182,All
2022,3,AGARTALA,GUWAHATI,4628,5090,AGARTALA-GUWAHATI,9718,All
2022,4,AGARTALA,GUWAHATI,4995,5238,AGARTALA-GUWAHATI,10233,All
2022,5,AGARTALA,GUWAHATI,7137,7275,AGARTALA-GUWAHATI,14412,All
2022,6,AGARTALA,GUWAHATI,6375,6485,AGARTALA-GUWAHATI,12860,All
2022,7,AGARTALA,GUWAHATI,6641,6576,AGARTALA-GUWAHATI,13217,All
2022,8,AGARTALA,GUWAHATI,5137,5576,AGARTALA-GUWAHATI,10713,All
2022,9,AGARTALA,GUWAHATI,5221,5903,AGARTALA-GUWAHATI,11124,All
2022,10,AGARTALA,GUWAHATI,7372,7197,AGARTALA-GUWAHATI,14569,All
2022,11,AGARTALA,GUWAHATI,10201,11054,AGARTALA-GUWAHATI,21255,All
2022,12,AGARTALA,GUWAHATI,8355,9348,AGARTALA-GUWAHATI,17703,All
2023,1,AGARTALA,GUWAHATI,8072,8833,AGARTALA-GUWAHATI,16905,All
2023,2,AGARTALA,GUWAHATI,6819,7291,AGARTALA-GUWAHATI,14110,All
2023,3,AGARTALA,GUWAHATI,9041,9520,AGARTALA-GUWAHATI,18561,All
2023,4,AGARTALA,GUWAHATI,10559,9879,AGARTALA-GUWAHATI,20438,All
2023,5,AGARTALA,GUWAHATI,9752,9631,AGARTALA-GUWAHATI,19383,All
2023,6,AGARTALA,GUWAHATI,8544,10390,AGARTALA-GUWAHATI,18934,All
2023,7,AGARTALA,GUWAHATI,7986,9457,AGARTALA-GUWAHATI,17443,All
2023,8,AGARTALA,GUWAHATI,7480,9048,AGARTALA-GUWAHATI,16528,All
2023,9,AGARTALA,GUWAHATI,7118,8303,AGARTALA-GUWAHATI,15421,All
2023,10,AGARTALA,GUWAHATI,8600,9617,AGARTALA-GUWAHATI,18217,All
2023,11,AGARTALA,GUWAHATI,9218,8812,AGARTALA-GUWAHATI,18030,All
2023,12,AGARTALA,GUWAHATI,9365,10601,AGARTALA-GUWAHATI,19966,All
2024,1,AGARTALA,GUWAHATI,9583,11031,AGARTALA-GUWAHATI,20614,All
2024,2,AGARTALA,GUWAHATI,8496,9217,AGARTALA-GUWAHATI,17713,All
2024,3,AGARTALA,GUWAHATI,9299,10314,AGARTALA-GUWAHATI,19613,All
2024,4,AGARTALA,GUWAHATI,9599,10251,AGARTALA-GUWAHATI,19850,All
2024,6,AGARTALA,GUWAHATI,9425,10536,AGARTALA-GUWAHATI,19961,All
2024,7,AGARTALA,GUWAHATI,9893,10666,AGARTALA-GUWAHATI,20559,All
2024,8,AGARTALA,GUWAHATI,8788,9820,AGARTALA-GUWAHATI,18608,All
2024,9,AGARTALA,GUWAHATI,11862,12611,AGARTALA-GUWAHATI,24473,All
2024,10,AGARTALA,GUWAHATI,12500,13341,AGARTALA-GUWAHATI,25841,All
2024,11,AGARTALA,GUWAHATI,13803,14306,AGARTALA-GUWAHATI,28109,All
2024,12,AGARTALA,GUWAHATI,15373,16464,AGARTALA-GUWAHATI,31837,All
2025,1,AGARTALA,GUWAHATI,14041,15957,AGARTALA-GUWAHATI,29998,All
2025,2,AGARTALA,GUWAHATI,13833,14167,AGARTALA-GUWAHATI,28000,All
2025,3,AGARTALA,GUWAHATI,13696,14154,AGARTALA-GUWAHATI,27850,All
2019,5,AGARTALA,HYDERABAD,758,222,AGARTALA-HYDERABAD,980,All
2019,6,AGARTALA,HYDERABAD,486,471,AGARTALA-HYDERABAD,957,All
2021,3,AGARTALA,HYDERABAD,22,17,AGARTALA-HYDERABAD,39,All
2021,4,AGARTALA,HYDERABAD,324,257,AGARTALA-HYDERABAD,581,All
2021,6,AGARTALA,HYDERABAD,134,60,AGARTALA-HYDERABAD,194,All
2021,7,AGARTALA,HYDERABAD,113,103,AGARTALA-HYDERABAD,216,All
2021,8,AGARTALA,HYDERABAD,161,97,AGARTALA-HYDERABAD,258,All
2021,9,AGARTALA,HYDERABAD,135,82,AGARTALA-HYDERABAD,217,All
2021,10,AGARTALA,HYDERABAD,347,408,AGARTALA-HYDERABAD,755,All
2024,9,AGARTALA,HYDERABAD,604,789,AGARTALA-HYDERABAD,1393,All
2024,10,AGARTALA,HYDERABAD,2441,2899,AGARTALA-HYDERABAD,5340,All
2024,11,AGARTALA,HYDERABAD,2601,2826,AGARTALA-HYDERABAD,5427,All
2024,12,AGARTALA,HYDERABAD,2951,3047,AGARTALA-HYDERABAD,5998,All
2025,1,AGARTALA,HYDERABAD,2757,3103,AGARTALA-HYDERABAD,5860,All
2025,2,AGARTALA,HYDERABAD,2577,2606,AGARTALA-HYDERABAD,5183,All
2025,3,AGARTALA,HYDERABAD,2742,2959,AGARTALA-HYDERABAD,5701,All
2019,5,AGARTALA,IMPHAL,824,1336,AGARTALA-IMPHAL,2160,All
2019,6,AGARTALA,IMPHAL,947,1455,AGARTALA-IMPHAL,2402,All
2019,7,AGARTALA,IMPHAL,1060,1401,AGARTALA-IMPHAL,2461,All
2019,8,AGARTALA,IMPHAL,1016,1567,AGARTALA-IMPHAL,2583,All
2019,9,AGARTALA,IMPHAL,624,1070,AGARTALA-IMPHAL,1694,All
2019,10,AGARTALA,IMPHAL,1534,1681,AGARTALA-IMPHAL,3215,All
2019,11,AGARTALA,IMPHAL,2236,2794,AGARTALA-IMPHAL,5030,All
2019,12,AGARTALA,IMPHAL,3573,2275,AGARTALA-IMPHAL,5848,All
2020,1,AGARTALA,IMPHAL,3055,4352,AGARTALA-IMPHAL,7407,All
2020,2,AGARTALA,IMPHAL,2938,3240,AGARTALA-IMPHAL,6178,All
2020,3,AGARTALA,IMPHAL,2718,1983,AGARTALA-IMPHAL,4701,All
2020,9,AGARTALA,IMPHAL,209,182,AGARTALA-IMPHAL,391,All
2020,10,AGARTALA,IMPHAL,1290,1464,AGARTALA-IMPHAL,2754,All
2020,11,AGARTALA,IMPHAL,1195,1910,AGARTALA-IMPHAL,3105,All
2020,12,AGARTALA,IMPHAL,1545,1303,AGARTALA-IMPHAL,2848,All
2021,1,AGARTALA,IMPHAL,1277,2188,AGARTALA-IMPHAL,3465,All
2021,2,AGARTALA,IMPHAL,1490,1968,AGARTALA-IMPHAL,3458,All
2021,3,AGARTALA,IMPHAL,1515,1912,AGARTALA-IMPHAL,3427,All
2021,4,AGARTALA,IMPHAL,1832,1015,AGARTALA-IMPHAL,2847,All
2021,6,AGARTALA,IMPHAL,16,0,AGARTALA-IMPHAL,16,All
2021,8,AGARTALA,IMPHAL,159,184,AGARTALA-IMPHAL,343,All
2021,9,AGARTALA,IMPHAL,703,835,AGARTALA-IMPHAL,1538,All
2021,10,AGARTALA,IMPHAL,968,1082,AGARTALA-IMPHAL,2050,All
2021,11,AGARTALA,IMPHAL,1379,1431,AGARTALA-IMPHAL,2810,All
2021,12,AGARTALA,IMPHAL,1580,1271,AGARTALA-IMPHAL,2851,All
2022,1,AGARTALA,IMPHAL,610,993,AGARTALA-IMPHAL,1603,All
2022,2,AGARTALA,IMPHAL,652,556,AGARTALA-IMPHAL,1208,All
2022,3,AGARTALA,IMPHAL,676,991,AGARTALA-IMPHAL,1667,All
2022,4,AGARTALA,IMPHAL,1234,1551,AGARTALA-IMPHAL,2785,All
2022,5,AGARTALA,IMPHAL,1363,1909,AGARTALA-IMPHAL,3272,All
2022,6,AGARTALA,IMPHAL,1241,1946,AGARTALA-IMPHAL,3187,All
2022,7,AGARTALA,IMPHAL,1116,2027,AGARTALA-IMPHAL,3143,All
2022,8,AGARTALA,IMPHAL,1066,1611,AGARTALA-IMPHAL,2677,All
2022,9,AGARTALA,IMPHAL,956,1544,AGARTALA-IMPHAL,2500,All
2022,10,AGARTALA,IMPHAL,1795,1845,AGARTALA-IMPHAL,3640,All
2022,11,AGARTALA,IMPHAL,1364,1697,AGARTALA-IMPHAL,3061,All
2022,12,AGARTALA,IMPHAL,1427,1437,AGARTALA-IMPHAL,2864,All
2023,1,AGARTALA,IMPHAL,1142,1624,AGARTALA-IMPHAL,2766,All
2023,2,AGARTALA,IMPHAL,881,856,AGARTALA-IMPHAL,1737,All
2023,3,AGARTALA,IMPHAL,1213,1341,AGARTALA-IMPHAL,2554,All
2023,4,AGARTALA,IMPHAL,1685,1880,AGARTALA-IMPHAL,3565,All
2023,5,AGARTALA,IMPHAL,948,3290,AGARTALA-IMPHAL,4238,All
2023,6,AGARTALA,IMPHAL,655,2994,AGARTALA-IMPHAL,3649,All
2023,7,AGARTALA,IMPHAL,995,1584,AGARTALA-IMPHAL,2579,All
2023,8,AGARTALA,IMPHAL,1249,2212,AGARTALA-IMPHAL,3461,All
2023,9,AGARTALA,IMPHAL,1003,1744,AGARTALA-IMPHAL,2747,All
2023,10,AGARTALA,IMPHAL,1261,3021,AGARTALA-IMPHAL,4282,All
2023,11,AGARTALA,IMPHAL,1395,2204,AGARTALA-IMPHAL,3599,All
2023,12,AGARTALA,IMPHAL,2556,1998,AGARTALA-IMPHAL,4554,All
2024,1,AGARTALA,IMPHAL,1386,2863,AGARTALA-IMPHAL,4249,All
2024,2,AGARTALA,IMPHAL,1382,1657,AGARTALA-IMPHAL,3039,All
2024,3,AGARTALA,IMPHAL,1485,2436,AGARTALA-IMPHAL,3921,All
2024,4,AGARTALA,IMPHAL,1186,1484,AGARTALA-IMPHAL,2670,All
2024,6,AGARTALA,IMPHAL,1557,2207,AGARTALA-IMPHAL,3764,All
2024,7,AGARTALA,IMPHAL,1375,1762,AGARTALA-IMPHAL,3137,All
2024,8,AGARTALA,IMPHAL,1258,1762,AGARTALA-IMPHAL,3020,All
2024,9,AGARTALA,IMPHAL,1326,1590,AGARTALA-IMPHAL,2916,All
2024,10,AGARTALA,IMPHAL,1951,2216,AGARTALA-IMPHAL,4167,All
2024,11,AGARTALA,IMPHAL,1218,1691,AGARTALA-IMPHAL,2909,All
2024,12,AGARTALA,IMPHAL,2118,1906,AGARTALA-IMPHAL,4024,All
2025,1,AGARTALA,IMPHAL,1880,2122,AGARTALA-IMPHAL,4002,All
2025,2,AGARTALA,IMPHAL,1245,1765,AGARTALA-IMPHAL,3010,All
2025,3,AGARTALA,IMPHAL,1851,1572,AGARTALA-IMPHAL,3423,All
2019,3,AGARTALA,JAIPUR,0,110,AGARTALA-JAIPUR,110,All
2022,8,AGARTALA,JORHAT,0,2,AGARTALA-JORHAT,2,All
2020,3,AGARTALA,KOCHI,6,0,AGARTALA-KOCHI,6,All
2023,11,AGARTALA,KOCHI,40,34,AGARTALA-KOCHI,74,All
2023,12,AGARTALA,KOCHI,39,75,AGARTALA-KOCHI,114,All
2019,5,AGARTALA,KOLKATA,35951,34401,AGARTALA-KOLKATA,70352,All
2019,6,AGARTALA,KOLKATA,37962,37403,AGARTALA-KOLKATA,75365,All
2019,7,AGARTALA,KOLKATA,40108,37956,AGARTALA-KOLKATA,78064,All
2019,8,AGARTALA,KOLKATA,39618,34960,AGARTALA-KOLKATA,74578,All
2019,9,AGARTALA,KOLKATA,34780,35673,AGARTALA-KOLKATA,70453,All
2019,10,AGARTALA,KOLKATA,38473,34929,AGARTALA-KOLKATA,73402,All
2019,11,AGARTALA,KOLKATA,47474,45092,AGARTALA-KOLKATA,92566,All
2019,12,AGARTALA,KOLKATA,43814,46100,AGARTALA-KOLKATA,89914,All
2020,1,AGARTALA,KOLKATA,41624,44350,AGARTALA-KOLKATA,85974,All
2020,2,AGARTALA,KOLKATA,39620,36551,AGARTALA-KOLKATA,76171,All
2020,3,AGARTALA,KOLKATA,27277,32860,AGARTALA-KOLKATA,60137,All
2020,5,AGARTALA,KOLKATA,486,494,AGARTALA-KOLKATA,980,All
2020,6,AGARTALA,KOLKATA,9803,12288,AGARTALA-KOLKATA,22091,All
2020,7,AGARTALA,KOLKATA,5351,6362,AGARTALA-KOLKATA,11713,All
2020,8,AGARTALA,KOLKATA,4604,7521,AGARTALA-KOLKATA,12125,All
2020,9,AGARTALA,KOLKATA,8089,10318,AGARTALA-KOLKATA,18407,All
2020,10,AGARTALA,KOLKATA,15005,17018,AGARTALA-KOLKATA,32023,All
2020,11,AGARTALA,KOLKATA,22259,18622,AGARTALA-KOLKATA,40881,All
2020,12,AGARTALA,KOLKATA,23824,25224,AGARTALA-KOLKATA,49048,All
2021,1,AGARTALA,KOLKATA,27172,27012,AGARTALA-KOLKATA,54184,All
2021,2,AGARTALA,KOLKATA,27391,25095,AGARTALA-KOLKATA,52486,All
2021,3,AGARTALA,KOLKATA,29387,26332,AGARTALA-KOLKATA,55719,All
2021,4,AGARTALA,KOLKATA,18655,18989,AGARTALA-KOLKATA,37644,All
2021,6,AGARTALA,KOLKATA,8054,8465,AGARTALA-KOLKATA,16519,All
2021,7,AGARTALA,KOLKATA,15980,12985,AGARTALA-KOLKATA,28965,All
2021,8,AGARTALA,KOLKATA,27319,21169,AGARTALA-KOLKATA,48488,All
2021,9,AGARTALA,KOLKATA,30097,26934,AGARTALA-KOLKATA,57031,All
2021,10,AGARTALA,KOLKATA,33611,30458,AGARTALA-KOLKATA,64069,All
2021,11,AGARTALA,KOLKATA,38728,35135,AGARTALA-KOLKATA,73863,All
2021,12,AGARTALA,KOLKATA,39685,37677,AGARTALA-KOLKATA,77362,All
2022,1,AGARTALA,KOLKATA,21159,27310,AGARTALA-KOLKATA,48469,All
2022,2,AGARTALA,KOLKATA,24647,21301,AGARTALA-KOLKATA,45948,All
2022,3,AGARTALA,KOLKATA,36607,31948,AGARTALA-KOLKATA,68555,All
2022,4,AGARTALA,KOLKATA,36691,35131,AGARTALA-KOLKATA,71822,All
2022,5,AGARTALA,KOLKATA,43215,40835,AGARTALA-KOLKATA,84050,All
2022,6,AGARTALA,KOLKATA,34670,35449,AGARTALA-KOLKATA,70119,All
2022,7,AGARTALA,KOLKATA,39576,35266,AGARTALA-KOLKATA,74842,All
2022,8,AGARTALA,KOLKATA,36747,32251,AGARTALA-KOLKATA,68998,All
2022,9,AGARTALA,KOLKATA,35747,36076,AGARTALA-KOLKATA,71823,All
2022,10,AGARTALA,KOLKATA,39460,33042,AGARTALA-KOLKATA,72502,All
2022,11,AGARTALA,KOLKATA,27406,28593,AGARTALA-KOLKATA,55999,All
2022,12,AGARTALA,KOLKATA,33537,35692,AGARTALA-KOLKATA,69229,All
2023,1,AGARTALA,KOLKATA,32722,33706,AGARTALA-KOLKATA,66428,All
2023,2,AGARTALA,KOLKATA,31661,28866,AGARTALA-KOLKATA,60527,All
2023,3,AGARTALA,KOLKATA,37714,38145,AGARTALA-KOLKATA,75859,All
2023,4,AGARTALA,KOLKATA,36408,39663,AGARTALA-KOLKATA,76071,All
2023,5,AGARTALA,KOLKATA,37985,38086,AGARTALA-KOLKATA,76071,All
2023,6,AGARTALA,KOLKATA,34237,36228,AGARTALA-KOLKATA,70465,All
2023,7,AGARTALA,KOLKATA,38432,36228,AGARTALA-KOLKATA,74660,All
2023,8,AGARTALA,KOLKATA,38875,35980,AGARTALA-KOLKATA,74855,All
2023,9,AGARTALA,KOLKATA,36862,36378,AGARTALA-KOLKATA,73240,All
2023,10,AGARTALA,KOLKATA,35815,37808,AGARTALA-KOLKATA,73623,All
2023,11,AGARTALA,KOLKATA,36539,35108,AGARTALA-KOLKATA,71647,All
2023,12,AGARTALA,KOLKATA,34262,36047,AGARTALA-KOLKATA,70309,All
2024,1,AGARTALA,KOLKATA,30666,32561,AGARTALA-KOLKATA,63227,All
2024,2,AGARTALA,KOLKATA,32045,32680,AGARTALA-KOLKATA,64725,All
2024,3,AGARTALA,KOLKATA,37092,36601,AGARTALA-KOLKATA,73693,All
2024,4,AGARTALA,KOLKATA,29983,31739,AGARTALA-KOLKATA,61722,All
2024,6,AGARTALA,KOLKATA,34136,34626,AGARTALA-KOLKATA,68762,All
2024,7,AGARTALA,KOLKATA,35004,33891,AGARTALA-KOLKATA,68895,All
2024,8,AGARTALA,KOLKATA,32172,34199,AGARTALA-KOLKATA,66371,All
2024,9,AGARTALA,KOLKATA,32595,35120,AGARTALA-KOLKATA,67715,All
2024,10,AGARTALA,KOLKATA,33339,33454,AGARTALA-KOLKATA,66793,All
2024,11,AGARTALA,KOLKATA,29721,30661,AGARTALA-KOLKATA,60382,All
2024,12,AGARTALA,KOLKATA,32054,32424,AGARTALA-KOLKATA,64478,All
2025,1,AGARTALA,KOLKATA,29428,29886,AGARTALA-KOLKATA,59314,All
2025,2,AGARTALA,KOLKATA,26757,27357,AGARTALA-KOLKATA,54114,All
2025,3,AGARTALA,KOLKATA,30230,30962,AGARTALA-KOLKATA,61192,All
2022,1,AGARTALA,LUCKNOW,0,37,AGARTALA-LUCKNOW,37,All
2022,2,AGARTALA,LUCKNOW,0,57,AGARTALA-LUCKNOW,57,All
2019,10,AGARTALA,MUMBAI,37,15,AGARTALA-MUMBAI,52,All
2019,11,AGARTALA,MUMBAI,329,237,AGARTALA-MUMBAI,566,All
2019,12,AGARTALA,MUMBAI,910,480,AGARTALA-MUMBAI,1390,All
2020,1,AGARTALA,MUMBAI,721,579,AGARTALA-MUMBAI,1300,All
2020,2,AGARTALA,MUMBAI,497,617,AGARTALA-MUMBAI,1114,All
2020,3,AGARTALA,MUMBAI,269,360,AGARTALA-MUMBAI,629,All
2021,7,AGARTALA,MUMBAI,0,27,AGARTALA-MUMBAI,27,All
2021,8,AGARTALA,MUMBAI,0,89,AGARTALA-MUMBAI,89,All
2021,9,AGARTALA,MUMBAI,0,139,AGARTALA-MUMBAI,139,All
2021,10,AGARTALA,MUMBAI,0,232,AGARTALA-MUMBAI,232,All
2021,11,AGARTALA,MUMBAI,0,107,AGARTALA-MUMBAI,107,All
2021,12,AGARTALA,MUMBAI,0,257,AGARTALA-MUMBAI,257,All
2022,1,AGARTALA,MUMBAI,0,132,AGARTALA-MUMBAI,132,All
2022,2,AGARTALA,MUMBAI,0,106,AGARTALA-MUMBAI,106,All
2022,3,AGARTALA,MUMBAI,0,49,AGARTALA-MUMBAI,49,All
2018,11,AGARTALA,NAGPUR,40,0,AGARTALA-NAGPUR,40,All
2019,10,AGARTALA,NAGPUR,2,0,AGARTALA-NAGPUR,2,All
2019,11,AGARTALA,NAGPUR,17,0,AGARTALA-NAGPUR,17,All
2019,12,AGARTALA,NAGPUR,16,0,AGARTALA-NAGPUR,16,All
2020,1,AGARTALA,NAGPUR,4,0,AGARTALA-NAGPUR,4,All
2020,2,AGARTALA,NAGPUR,6,0,AGARTALA-NAGPUR,6,All
2020,3,AGARTALA,NAGPUR,3,0,AGARTALA-NAGPUR,3,All
2018,2,AGARTALA,PORT BLAIR,0,8,AGARTALA-PORT BLAIR,8,All
2018,3,AGARTALA,PORT BLAIR,0,17,AGARTALA-PORT BLAIR,17,All
2017,6,AGARTALA,PUNE,14,0,AGARTALA-PUNE,14,All
2017,7,AGARTALA,PUNE,125,0,AGARTALA-PUNE,125,All
2017,8,AGARTALA,PUNE,141,0,AGARTALA-PUNE,141,All
2017,9,AGARTALA,PUNE,76,0,AGARTALA-PUNE,76,All
2017,10,AGARTALA,PUNE,136,0,AGARTALA-PUNE,136,All
2017,11,AGARTALA,PUNE,92,0,AGARTALA-PUNE,92,All
2017,12,AGARTALA,PUNE,199,0,AGARTALA-PUNE,199,All
2018,1,AGARTALA,PUNE,107,0,AGARTALA-PUNE,107,All
2018,2,AGARTALA,PUNE,119,0,AGARTALA-PUNE,119,All
2018,3,AGARTALA,PUNE,187,0,AGARTALA-PUNE,187,All
2018,4,AGARTALA,PUNE,227,0,AGARTALA-PUNE,227,All
2018,5,AGARTALA,PUNE,165,0,AGARTALA-PUNE,165,All
2018,6,AGARTALA,PUNE,237,0,AGARTALA-PUNE,237,All
2018,7,AGARTALA,PUNE,146,0,AGARTALA-PUNE,146,All
2018,8,AGARTALA,PUNE,162,0,AGARTALA-PUNE,162,All
2018,9,AGARTALA,PUNE,192,0,AGARTALA-PUNE,192,All
2018,10,AGARTALA,PUNE,405,0,AGARTALA-PUNE,405,All
2018,11,AGARTALA,PUNE,239,0,AGARTALA-PUNE,239,All
2018,12,AGARTALA,PUNE,529,0,AGARTALA-PUNE,529,All
2024,11,AGARTALA,RAIPUR,0,178,AGARTALA-RAIPUR,178,All
2021,6,AGARTALA,RANCHI,2,0,AGARTALA-RANCHI,2,All
2018,5,AGARTALA,SHILLONG,43,27,AGARTALA-SHILLONG,70,All
2021,3,AGARTALA,SHILLONG,5,18,AGARTALA-SHILLONG,23,All
2021,4,AGARTALA,SHILLONG,217,257,AGARTALA-SHILLONG,474,All
2021,7,AGARTALA,SHILLONG,147,141,AGARTALA-SHILLONG,288,All
2021,8,AGARTALA,SHILLONG,286,287,AGARTALA-SHILLONG,573,All
2021,9,AGARTALA,SHILLONG,669,445,AGARTALA-SHILLONG,1114,All
2021,10,AGARTALA,SHILLONG,783,630,AGARTALA-SHILLONG,1413,All
2021,11,AGARTALA,SHILLONG,570,524,AGARTALA-SHILLONG,1094,All
2021,12,AGARTALA,SHILLONG,666,771,AGARTALA-SHILLONG,1437,All
2022,1,AGARTALA,SHILLONG,452,410,AGARTALA-SHILLONG,862,All
2022,2,AGARTALA,SHILLONG,503,335,AGARTALA-SHILLONG,838,All
2022,3,AGARTALA,SHILLONG,905,538,AGARTALA-SHILLONG,1443,All
2022,4,AGARTALA,SHILLONG,716,628,AGARTALA-SHILLONG,1344,All
2022,5,AGARTALA,SHILLONG,785,623,AGARTALA-SHILLONG,1408,All
2022,6,AGARTALA,SHILLONG,739,659,AGARTALA-SHILLONG,1398,All
2022,7,AGARTALA,SHILLONG,844,679,AGARTALA-SHILLONG,1523,All
2022,8,AGARTALA,SHILLONG,823,725,AGARTALA-SHILLONG,1548,All
2022,9,AGARTALA,SHILLONG,639,557,AGARTALA-SHILLONG,1196,All
2022,10,AGARTALA,SHILLONG,701,606,AGARTALA-SHILLONG,1307,All
2022,11,AGARTALA,SHILLONG,582,641,AGARTALA-SHILLONG,1223,All
2022,12,AGARTALA,SHILLONG,555,643,AGARTALA-SHILLONG,1198,All
2023,1,AGARTALA,SHILLONG,573,473,AGARTALA-SHILLONG,1046,All
2023,2,AGARTALA,SHILLONG,628,281,AGARTALA-SHILLONG,909,All
2023,3,AGARTALA,SHILLONG,538,430,AGARTALA-SHILLONG,968,All
2023,4,AGARTALA,SHILLONG,670,589,AGARTALA-SHILLONG,1259,All
2023,5,AGARTALA,SHILLONG,747,614,AGARTALA-SHILLONG,1361,All
2023,6,AGARTALA,SHILLONG,694,676,AGARTALA-SHILLONG,1370,All
2023,7,AGARTALA,SHILLONG,726,599,AGARTALA-SHILLONG,1325,All
2023,8,AGARTALA,SHILLONG,673,587,AGARTALA-SHILLONG,1260,All
2023,9,AGARTALA,SHILLONG,646,632,AGARTALA-SHILLONG,1278,All
2023,10,AGARTALA,SHILLONG,720,687,AGARTALA-SHILLONG,1407,All
2023,11,AGARTALA,SHILLONG,620,527,AGARTALA-SHILLONG,1147,All
2023,12,AGARTALA,SHILLONG,530,624,AGARTALA-SHILLONG,1154,All
2024,1,AGARTALA,SHILLONG,393,420,AGARTALA-SHILLONG,813,All
2024,2,AGARTALA,SHILLONG,590,391,AGARTALA-SHILLONG,981,All
2024,3,AGARTALA,SHILLONG,607,544,AGARTALA-SHILLONG,1151,All
2016,4,AGARTALA,SILCHAR,2,0,AGARTALA-SILCHAR,2,All
2021,4,AGARTALA,TRIVANDRUM,35,0,AGARTALA-TRIVANDRUM,35,All
2016,8,AGARTALA,VISAKHAPATNAM,11,0,AGARTALA-VISAKHAPATNAM,11,All
2016,9,AGARTALA,VISAKHAPATNAM,27,0,AGARTALA-VISAKHAPATNAM,27,All
2016,10,AGARTALA,VISAKHAPATNAM,39,0,AGARTALA-VISAKHAPATNAM,39,All
2016,11,AGARTALA,VISAKHAPATNAM,63,0,AGARTALA-VISAKHAPATNAM,63,All
2016,12,AGARTALA,VISAKHAPATNAM,69,0,AGARTALA-VISAKHAPATNAM,69,All
2017,2,AGARTALA,VISAKHAPATNAM,87,0,AGARTALA-VISAKHAPATNAM,87,All
2017,3,AGARTALA,VISAKHAPATNAM,78,0,AGARTALA-VISAKHAPATNAM,78,All
2017,4,AGARTALA,VISAKHAPATNAM,95,0,AGARTALA-VISAKHAPATNAM,95,All
2017,5,AGARTALA,VISAKHAPATNAM,119,0,AGARTALA-VISAKHAPATNAM,119,All
2017,6,AGARTALA,VISAKHAPATNAM,181,0,AGARTALA-VISAKHAPATNAM,181,All
2017,7,AGARTALA,VISAKHAPATNAM,58,0,AGARTALA-VISAKHAPATNAM,58,All
2017,9,AGARTALA,VISAKHAPATNAM,81,0,AGARTALA-VISAKHAPATNAM,81,All
2017,10,AGARTALA,VISAKHAPATNAM,91,0,AGARTALA-VISAKHAPATNAM,91,All
2017,11,AGARTALA,VISAKHAPATNAM,4,0,AGARTALA-VISAKHAPATNAM,4,All
2018,2,AGARTALA,VISAKHAPATNAM,46,0,AGARTALA-VISAKHAPATNAM,46,All
2018,3,AGARTALA,VISAKHAPATNAM,160,0,AGARTALA-VISAKHAPATNAM,160,All
2018,4,AGARTALA,VISAKHAPATNAM,182,3,AGARTALA-VISAKHAPATNAM,185,All
2018,5,AGARTALA,VISAKHAPATNAM,198,2,AGARTALA-VISAKHAPATNAM,200,All
2018,6,AGARTALA,VISAKHAPATNAM,167,2,AGARTALA-VISAKHAPATNAM,169,All
2018,7,AGARTALA,VISAKHAPATNAM,95,0,AGARTALA-VISAKHAPATNAM,95,All
2018,8,AGARTALA,VISAKHAPATNAM,100,0,AGARTALA-VISAKHAPATNAM,100,All
2018,9,AGARTALA,VISAKHAPATNAM,92,0,AGARTALA-VISAKHAPATNAM,92,All
2018,10,AGARTALA,VISAKHAPATNAM,108,0,AGARTALA-VISAKHAPATNAM,108,All
2019,2,AGARTALA,VISAKHAPATNAM,110,0,AGARTALA-VISAKHAPATNAM,110,All
2019,3,AGARTALA,VISAKHAPATNAM,151,0,AGARTALA-VISAKHAPATNAM,151,All
2022,11,AGARTALA,VISAKHAPATNAM,101,86,AGARTALA-VISAKHAPATNAM,187,All
2022,12,AGARTALA,VISAKHAPATNAM,285,98,AGARTALA-VISAKHAPATNAM,383,All
2023,1,AGARTALA,VISAKHAPATNAM,167,287,AGARTALA-VISAKHAPATNAM,454,All
2023,2,AGARTALA,VISAKHAPATNAM,67,117,AGARTALA-VISAKHAPATNAM,184,All
2023,3,AGARTALA,VISAKHAPATNAM,51,107,AGARTALA-VISAKHAPATNAM,158,All
2024,8,AGARTALA,VISAKHAPATNAM,5,0,AGARTALA-VISAKHAPATNAM,5,All
2015,9,AGATTI ISLAND,BENGALURU,44,47,AGATTI ISLAND-BENGALURU,91,All
2015,12,AGATTI ISLAND,BENGALURU,146,144,AGATTI ISLAND-BENGALURU,290,All
2016,1,AGATTI ISLAND,BENGALURU,182,124,AGATTI ISLAND-BENGALURU,306,All
2016,2,AGATTI ISLAND,BENGALURU,116,79,AGATTI ISLAND-BENGALURU,195,All
2016,3,AGATTI ISLAND,BENGALURU,77,83,AGATTI ISLAND-BENGALURU,160,All
2017,3,AGATTI ISLAND,BENGALURU,0,17,AGATTI ISLAND-BENGALURU,17,All
2018,5,AGATTI ISLAND,BENGALURU,100,106,AGATTI ISLAND-BENGALURU,206,All
2018,6,AGATTI ISLAND,BENGALURU,33,60,AGATTI ISLAND-BENGALURU,93,All
2018,7,AGATTI ISLAND,BENGALURU,60,43,AGATTI ISLAND-BENGALURU,103,All
2018,8,AGATTI ISLAND,BENGALURU,49,37,AGATTI ISLAND-BENGALURU,86,All
2018,9,AGATTI ISLAND,BENGALURU,54,28,AGATTI ISLAND-BENGALURU,82,All
2018,10,AGATTI ISLAND,BENGALURU,2299,2465,AGATTI ISLAND-BENGALURU,4764,All
2019,1,AGATTI ISLAND,BENGALURU,117,127,AGATTI ISLAND-BENGALURU,244,All
2019,3,AGATTI ISLAND,BENGALURU,86,62,AGATTI ISLAND-BENGALURU,148,All
2019,4,AGATTI ISLAND,BENGALURU,60,65,AGATTI ISLAND-BENGALURU,125,All
2019,5,AGATTI ISLAND,BENGALURU,98,61,AGATTI ISLAND-BENGALURU,159,All
2019,6,AGATTI ISLAND,BENGALURU,23,13,AGATTI ISLAND-BENGALURU,36,All
2019,7,AGATTI ISLAND,BENGALURU,20,11,AGATTI ISLAND-BENGALURU,31,All
2019,8,AGATTI ISLAND,BENGALURU,30,19,AGATTI ISLAND-BENGALURU,49,All
2019,9,AGATTI ISLAND,BENGALURU,40,20,AGATTI ISLAND-BENGALURU,60,All
2019,10,AGATTI ISLAND,BENGALURU,57,76,AGATTI ISLAND-BENGALURU,133,All
2019,11,AGATTI ISLAND,BENGALURU,111,85,AGATTI ISLAND-BENGALURU,196,All
2019,12,AGATTI ISLAND,BENGALURU,314,149,AGATTI ISLAND-BENGALURU,463,All
2020,1,AGATTI ISLAND,BENGALURU,377,148,AGATTI ISLAND-BENGALURU,525,All
2020,2,AGATTI ISLAND,BENGALURU,305,88,AGATTI ISLAND-BENGALURU,393,All
2020,3,AGATTI ISLAND,BENGALURU,197,60,AGATTI ISLAND-BENGALURU,257,All
2021,2,AGATTI ISLAND,BENGALURU,26,25,AGATTI ISLAND-BENGALURU,51,All
2021,3,AGATTI ISLAND,BENGALURU,69,67,AGATTI ISLAND-BENGALURU,136,All
2021,4,AGATTI ISLAND,BENGALURU,70,92,AGATTI ISLAND-BENGALURU,162,All
2021,6,AGATTI ISLAND,BENGALURU,2,4,AGATTI ISLAND-BENGALURU,6,All
2021,7,AGATTI ISLAND,BENGALURU,10,7,AGATTI ISLAND-BENGALURU,17,All
2021,8,AGATTI ISLAND,BENGALURU,9,10,AGATTI ISLAND-BENGALURU,19,All
2021,9,AGATTI ISLAND,BENGALURU,22,13,AGATTI ISLAND-BENGALURU,35,All
2021,10,AGATTI ISLAND,BENGALURU,69,90,AGATTI ISLAND-BENGALURU,159,All
2021,11,AGATTI ISLAND,BENGALURU,27,14,AGATTI ISLAND-BENGALURU,41,All
2021,12,AGATTI ISLAND,BENGALURU,27,41,AGATTI ISLAND-BENGALURU,68,All
2022,1,AGATTI ISLAND,BENGALURU,19,18,AGATTI ISLAND-BENGALURU,37,All
2022,2,AGATTI ISLAND,BENGALURU,32,38,AGATTI ISLAND-BENGALURU,70,All
2022,3,AGATTI ISLAND,BENGALURU,26,15,AGATTI ISLAND-BENGALURU,41,All
2022,4,AGATTI ISLAND,BENGALURU,27,14,AGATTI ISLAND-BENGALURU,41,All
2022,5,AGATTI ISLAND,BENGALURU,27,41,AGATTI ISLAND-BENGALURU,68,All
2022,6,AGATTI ISLAND,BENGALURU,27,14,AGATTI ISLAND-BENGALURU,41,All
2022,7,AGATTI ISLAND,BENGALURU,32,38,AGATTI ISLAND-BENGALURU,70,All
2022,8,AGATTI ISLAND,BENGALURU,27,41,AGATTI ISLAND-BENGALURU,68,All
2022,9,AGATTI ISLAND,BENGALURU,27,14,AGATTI ISLAND-BENGALURU,41,All
2022,10,AGATTI ISLAND,BENGALURU,6,5,AGATTI ISLAND-BENGALURU,11,All
2022,11,AGATTI ISLAND,BENGALURU,16,14,AGATTI ISLAND-BENGALURU,30,All
2022,12,AGATTI ISLAND,BENGALURU,13,21,AGATTI ISLAND-BENGALURU,34,All
2023,2,AGATTI ISLAND,BENGALURU,3,1,AGATTI ISLAND-BENGALURU,4,All
2023,3,AGATTI ISLAND,BENGALURU,13,9,AGATTI ISLAND-BENGALURU,22,All
2023,4,AGATTI ISLAND,BENGALURU,45,0,AGATTI ISLAND-BENGALURU,45,All
2024,3,AGATTI ISLAND,BENGALURU,15,23,AGATTI ISLAND-BENGALURU,38,All
2024,4,AGATTI ISLAND,BENGALURU,786,978,AGATTI ISLAND-BENGALURU,1764,All
2024,6,AGATTI ISLAND,BENGALURU,266,157,AGATTI ISLAND-BENGALURU,423,All
2024,7,AGATTI ISLAND,BENGALURU,105,125,AGATTI ISLAND-BENGALURU,230,All
2024,8,AGATTI ISLAND,BENGALURU,410,365,AGATTI ISLAND-BENGALURU,775,All
2024,9,AGATTI ISLAND,BENGALURU,899,1336,AGATTI ISLAND-BENGALURU,2235,All
2024,10,AGATTI ISLAND,BENGALURU,1015,1486,AGATTI ISLAND-BENGALURU,2501,All
2024,11,AGATTI ISLAND,BENGALURU,580,917,AGATTI ISLAND-BENGALURU,1497,All
2024,12,AGATTI ISLAND,BENGALURU,663,1073,AGATTI ISLAND-BENGALURU,1736,All
2025,1,AGATTI ISLAND,BENGALURU,724,857,AGATTI ISLAND-BENGALURU,1581,All
2025,2,AGATTI ISLAND,BENGALURU,435,641,AGATTI ISLAND-BENGALURU,1076,All
2025,3,AGATTI ISLAND,BENGALURU,619,1092,AGATTI ISLAND-BENGALURU,1711,All
2020,1,AGATTI ISLAND,CHENNAI,7,3,AGATTI ISLAND-CHENNAI,10,All
2024,4,AGATTI ISLAND,Goa,239,227,AGATTI ISLAND-Goa,466,All
2024,6,AGATTI ISLAND,Goa,228,195,AGATTI ISLAND-Goa,423,All
2024,7,AGATTI ISLAND,Goa,378,495,AGATTI ISLAND-Goa,873,All
2024,8,AGATTI ISLAND,Goa,187,443,AGATTI ISLAND-Goa,630,All
2024,9,AGATTI ISLAND,Goa,793,1243,AGATTI ISLAND-Goa,2036,All
2024,10,AGATTI ISLAND,Goa,1261,1264,AGATTI ISLAND-Goa,2525,All
2024,11,AGATTI ISLAND,Goa,1208,940,AGATTI ISLAND-Goa,2148,All
2024,12,AGATTI ISLAND,Goa,1299,1633,AGATTI ISLAND-Goa,2932,All
2025,1,AGATTI ISLAND,Goa,1381,1739,AGATTI ISLAND-Goa,3120,All
2025,2,AGATTI ISLAND,Goa,1181,1388,AGATTI ISLAND-Goa,2569,All
2025,3,AGATTI ISLAND,Goa,1134,1045,AGATTI ISLAND-Goa,2179,All
2015,4,AGATTI ISLAND,KOCHI,902,785,AGATTI ISLAND-KOCHI,1687,All
2015,5,AGATTI ISLAND,KOCHI,482,787,AGATTI ISLAND-KOCHI,1269,All
2015,6,AGATTI ISLAND,KOCHI,506,750,AGATTI ISLAND-KOCHI,1256,All
2015,7,AGATTI ISLAND,KOCHI,375,524,AGATTI ISLAND-KOCHI,899,All
2015,8,AGATTI ISLAND,KOCHI,484,430,AGATTI ISLAND-KOCHI,914,All
2015,9,AGATTI ISLAND,KOCHI,475,600,AGATTI ISLAND-KOCHI,1075,All
2015,10,AGATTI ISLAND,KOCHI,607,688,AGATTI ISLAND-KOCHI,1295,All
2015,11,AGATTI ISLAND,KOCHI,860,727,AGATTI ISLAND-KOCHI,1587,All
2015,12,AGATTI ISLAND,KOCHI,720,709,AGATTI ISLAND-KOCHI,1429,All
2016,1,AGATTI ISLAND,KOCHI,778,729,AGATTI ISLAND-KOCHI,1507,All
2016,2,AGATTI ISLAND,KOCHI,754,716,AGATTI ISLAND-KOCHI,1470,All
2016,3,AGATTI ISLAND,KOCHI,851,803,AGATTI ISLAND-KOCHI,1654,All
2016,4,AGATTI ISLAND,KOCHI,1623,0,AGATTI ISLAND-KOCHI,1623,All
2016,5,AGATTI ISLAND,KOCHI,1426,0,AGATTI ISLAND-KOCHI,1426,All
2016,6,AGATTI ISLAND,KOCHI,1119,0,AGATTI ISLAND-KOCHI,1119,All
2016,7,AGATTI ISLAND,KOCHI,1052,0,AGATTI ISLAND-KOCHI,1052,All
2016,8,AGATTI ISLAND,KOCHI,411,465,AGATTI ISLAND-KOCHI,876,All
2016,9,AGATTI ISLAND,KOCHI,448,686,AGATTI ISLAND-KOCHI,1134,All
2016,10,AGATTI ISLAND,KOCHI,1473,0,AGATTI ISLAND-KOCHI,1473,All
2016,11,AGATTI ISLAND,KOCHI,777,828,AGATTI ISLAND-KOCHI,1605,All
2016,12,AGATTI ISLAND,KOCHI,1020,1128,AGATTI ISLAND-KOCHI,2148,All
2017,1,AGATTI ISLAND,KOCHI,1138,1084,AGATTI ISLAND-KOCHI,2222,All
2017,2,AGATTI ISLAND,KOCHI,954,914,AGATTI ISLAND-KOCHI,1868,All
2017,3,AGATTI ISLAND,KOCHI,898,928,AGATTI ISLAND-KOCHI,1826,All
2017,4,AGATTI ISLAND,KOCHI,961,1209,AGATTI ISLAND-KOCHI,2170,All
2017,5,AGATTI ISLAND,KOCHI,1050,1412,AGATTI ISLAND-KOCHI,2462,All
2017,6,AGATTI ISLAND,KOCHI,478,824,AGATTI ISLAND-KOCHI,1302,All
2017,7,AGATTI ISLAND,KOCHI,590,604,AGATTI ISLAND-KOCHI,1194,All
2017,8,AGATTI ISLAND,KOCHI,577,652,AGATTI ISLAND-KOCHI,1229,All
2017,9,AGATTI ISLAND,KOCHI,863,956,AGATTI ISLAND-KOCHI,1819,All
2017,10,AGATTI ISLAND,KOCHI,1035,1167,AGATTI ISLAND-KOCHI,2202,All
2017,11,AGATTI ISLAND,KOCHI,985,1213,AGATTI ISLAND-KOCHI,2198,All
2017,12,AGATTI ISLAND,KOCHI,910,1072,AGATTI ISLAND-KOCHI,1982,All
2018,1,AGATTI ISLAND,KOCHI,1294,1515,AGATTI ISLAND-KOCHI,2809,All
2018,2,AGATTI ISLAND,KOCHI,966,1173,AGATTI ISLAND-KOCHI,2139,All
2018,3,AGATTI ISLAND,KOCHI,1104,1205,AGATTI ISLAND-KOCHI,2309,All
2018,4,AGATTI ISLAND,KOCHI,1270,1451,AGATTI ISLAND-KOCHI,2721,All
2018,5,AGATTI ISLAND,KOCHI,998,1218,AGATTI ISLAND-KOCHI,2216,All
2018,6,AGATTI ISLAND,KOCHI,502,785,AGATTI ISLAND-KOCHI,1287,All
2018,7,AGATTI ISLAND,KOCHI,489,653,AGATTI ISLAND-KOCHI,1142,All
2018,8,AGATTI ISLAND,KOCHI,371,403,AGATTI ISLAND-KOCHI,774,All
2018,9,AGATTI ISLAND,KOCHI,513,617,AGATTI ISLAND-KOCHI,1130,All
2018,10,AGATTI ISLAND,KOCHI,60,39,AGATTI ISLAND-KOCHI,99,All
2018,11,AGATTI ISLAND,KOCHI,2510,42,AGATTI ISLAND-KOCHI,2552,All
2018,12,AGATTI ISLAND,KOCHI,2634,104,AGATTI ISLAND-KOCHI,2738,All
2019,1,AGATTI ISLAND,KOCHI,1561,1622,AGATTI ISLAND-KOCHI,3183,All
2019,2,AGATTI ISLAND,KOCHI,2542,0,AGATTI ISLAND-KOCHI,2542,All
2019,3,AGATTI ISLAND,KOCHI,1076,1255,AGATTI ISLAND-KOCHI,2331,All
2019,4,AGATTI ISLAND,KOCHI,1113,1298,AGATTI ISLAND-KOCHI,2411,All
2019,5,AGATTI ISLAND,KOCHI,823,1312,AGATTI ISLAND-KOCHI,2135,All
2019,6,AGATTI ISLAND,KOCHI,722,1143,AGATTI ISLAND-KOCHI,1865,All
2019,7,AGATTI ISLAND,KOCHI,591,930,AGATTI ISLAND-KOCHI,1521,All
2019,8,AGATTI ISLAND,KOCHI,423,755,AGATTI ISLAND-KOCHI,1178,All
2019,9,AGATTI ISLAND,KOCHI,641,1331,AGATTI ISLAND-KOCHI,1972,All
2019,10,AGATTI ISLAND,KOCHI,1226,1518,AGATTI ISLAND-KOCHI,2744,All
2019,11,AGATTI ISLAND,KOCHI,830,1405,AGATTI ISLAND-KOCHI,2235,All
2019,12,AGATTI ISLAND,KOCHI,0,1511,AGATTI ISLAND-KOCHI,1511,All
2020,1,AGATTI ISLAND,KOCHI,0,1851,AGATTI ISLAND-KOCHI,1851,All
2020,2,AGATTI ISLAND,KOCHI,0,1601,AGATTI ISLAND-KOCHI,1601,All
2020,3,AGATTI ISLAND,KOCHI,0,948,AGATTI ISLAND-KOCHI,948,All
2021,2,AGATTI ISLAND,KOCHI,217,222,AGATTI ISLAND-KOCHI,439,All
2021,3,AGATTI ISLAND,KOCHI,483,510,AGATTI ISLAND-KOCHI,993,All
2021,4,AGATTI ISLAND,KOCHI,632,1198,AGATTI ISLAND-KOCHI,1830,All
2021,6,AGATTI ISLAND,KOCHI,276,244,AGATTI ISLAND-KOCHI,520,All
2021,7,AGATTI ISLAND,KOCHI,352,381,AGATTI ISLAND-KOCHI,733,All
2021,8,AGATTI ISLAND,KOCHI,519,549,AGATTI ISLAND-KOCHI,1068,All
2021,9,AGATTI ISLAND,KOCHI,575,921,AGATTI ISLAND-KOCHI,1496,All
2021,10,AGATTI ISLAND,KOCHI,1030,1097,AGATTI ISLAND-KOCHI,2127,All
2021,11,AGATTI ISLAND,KOCHI,1313,1568,AGATTI ISLAND-KOCHI,2881,All
2021,12,AGATTI ISLAND,KOCHI,1629,2007,AGATTI ISLAND-KOCHI,3636,All
2022,1,AGATTI ISLAND,KOCHI,1240,1679,AGATTI ISLAND-KOCHI,2919,All
2022,2,AGATTI ISLAND,KOCHI,1169,1693,AGATTI ISLAND-KOCHI,2862,All
2022,3,AGATTI ISLAND,KOCHI,1492,1893,AGATTI ISLAND-KOCHI,3385,All
2022,4,AGATTI ISLAND,KOCHI,1313,1568,AGATTI ISLAND-KOCHI,2881,All
2022,5,AGATTI ISLAND,KOCHI,1629,2007,AGATTI ISLAND-KOCHI,3636,All
2022,6,AGATTI ISLAND,KOCHI,1313,1568,AGATTI ISLAND-KOCHI,2881,All
2022,7,AGATTI ISLAND,KOCHI,1169,1693,AGATTI ISLAND-KOCHI,2862,All
2022,8,AGATTI ISLAND,KOCHI,1629,2007,AGATTI ISLAND-KOCHI,3636,All
2022,9,AGATTI ISLAND,KOCHI,1313,1568,AGATTI ISLAND-KOCHI,2881,All
2022,10,AGATTI ISLAND,KOCHI,1848,2023,AGATTI ISLAND-KOCHI,3871,All
2022,11,AGATTI ISLAND,KOCHI,1593,2003,AGATTI ISLAND-KOCHI,3596,All
2022,12,AGATTI ISLAND,KOCHI,1908,2455,AGATTI ISLAND-KOCHI,4363,All
2023,1,AGATTI ISLAND,KOCHI,2023,2315,AGATTI ISLAND-KOCHI,4338,All
2023,2,AGATTI ISLAND,KOCHI,1524,1825,AGATTI ISLAND-KOCHI,3349,All
2023,3,AGATTI ISLAND,KOCHI,1673,1918,AGATTI ISLAND-KOCHI,3591,All
2023,4,AGATTI ISLAND,KOCHI,1440,1877,AGATTI ISLAND-KOCHI,3317,All
2023,5,AGATTI ISLAND,KOCHI,1886,2086,AGATTI ISLAND-KOCHI,3972,All
2023,6,AGATTI ISLAND,KOCHI,745,1269,AGATTI ISLAND-KOCHI,2014,All
2023,7,AGATTI ISLAND,KOCHI,569,714,AGATTI ISLAND-KOCHI,1283,All
2023,8,AGATTI ISLAND,KOCHI,833,1084,AGATTI ISLAND-KOCHI,1917,All
2023,9,AGATTI ISLAND,KOCHI,1281,1955,AGATTI ISLAND-KOCHI,3236,All
2023,10,AGATTI ISLAND,KOCHI,1747,2112,AGATTI ISLAND-KOCHI,3859,All
2023,11,AGATTI ISLAND,KOCHI,1662,2020,AGATTI ISLAND-KOCHI,3682,All
2023,12,AGATTI ISLAND,KOCHI,1728,2253,AGATTI ISLAND-KOCHI,3981,All
2024,1,AGATTI ISLAND,KOCHI,1765,2312,AGATTI ISLAND-KOCHI,4077,All
2024,2,AGATTI ISLAND,KOCHI,1981,2590,AGATTI ISLAND-KOCHI,4571,All
2024,3,AGATTI ISLAND,KOCHI,2117,2627,AGATTI ISLAND-KOCHI,4744,All
2024,4,AGATTI ISLAND,KOCHI,1727,2351,AGATTI ISLAND-KOCHI,4078,All
2024,6,AGATTI ISLAND,KOCHI,1179,1775,AGATTI ISLAND-KOCHI,2954,All
2024,7,AGATTI ISLAND,KOCHI,746,1001,AGATTI ISLAND-KOCHI,1747,All
2024,8,AGATTI ISLAND,KOCHI,880,1243,AGATTI ISLAND-KOCHI,2123,All
2024,9,AGATTI ISLAND,KOCHI,2310,3299,AGATTI ISLAND-KOCHI,5609,All
2024,10,AGATTI ISLAND,KOCHI,2822,3729,AGATTI ISLAND-KOCHI,6551,All
2024,11,AGATTI ISLAND,KOCHI,2888,3812,AGATTI ISLAND-KOCHI,6700,All
2024,12,AGATTI ISLAND,KOCHI,3094,4197,AGATTI ISLAND-KOCHI,7291,All
2025,1,AGATTI ISLAND,KOCHI,3124,4004,AGATTI ISLAND-KOCHI,7128,All
2025,2,AGATTI ISLAND,KOCHI,2987,3862,AGATTI ISLAND-KOCHI,6849,All
2025,3,AGATTI ISLAND,KOCHI,3041,3889,AGATTI ISLAND-KOCHI,6930,All
2019,11,AGATTI ISLAND,KOZHIKODE,294,0,AGATTI ISLAND-KOZHIKODE,294,All
2019,12,AGATTI ISLAND,KOZHIKODE,702,0,AGATTI ISLAND-KOZHIKODE,702,All
2020,1,AGATTI ISLAND,KOZHIKODE,860,0,AGATTI ISLAND-KOZHIKODE,860,All
2020,2,AGATTI ISLAND,KOZHIKODE,909,0,AGATTI ISLAND-KOZHIKODE,909,All
2020,3,AGATTI ISLAND,KOZHIKODE,561,0,AGATTI ISLAND-KOZHIKODE,561,All
2024,6,AGATTI ISLAND,KOZHIKODE,107,155,AGATTI ISLAND-KOZHIKODE,262,All
2024,7,AGATTI ISLAND,KOZHIKODE,132,196,AGATTI ISLAND-KOZHIKODE,328,All
2024,8,AGATTI ISLAND,KOZHIKODE,165,176,AGATTI ISLAND-KOZHIKODE,341,All
2024,9,AGATTI ISLAND,KOZHIKODE,174,252,AGATTI ISLAND-KOZHIKODE,426,All
2024,10,AGATTI ISLAND,KOZHIKODE,111,229,AGATTI ISLAND-KOZHIKODE,340,All
2024,11,AGATTI ISLAND,KOZHIKODE,48,225,AGATTI ISLAND-KOZHIKODE,273,All
2024,12,AGATTI ISLAND,KOZHIKODE,53,145,AGATTI ISLAND-KOZHIKODE,198,All
2025,3,AGATTI ISLAND,KOZHIKODE,27,199,AGATTI ISLAND-KOZHIKODE,226,All
2021,6,AGATTI ISLAND,MYSORE,0,2,AGATTI ISLAND-MYSORE,2,All
2021,7,AGATTI ISLAND,MYSORE,2,2,AGATTI ISLAND-MYSORE,4,All
2021,8,AGATTI ISLAND,MYSORE,8,8,AGATTI ISLAND-MYSORE,16,All
2021,9,AGATTI ISLAND,MYSORE,113,155,AGATTI ISLAND-MYSORE,268,All
2021,10,AGATTI ISLAND,MYSORE,96,146,AGATTI ISLAND-MYSORE,242,All
2021,11,AGATTI ISLAND,MYSORE,42,15,AGATTI ISLAND-MYSORE,57,All
2021,12,AGATTI ISLAND,MYSORE,17,8,AGATTI ISLAND-MYSORE,25,All
2022,1,AGATTI ISLAND,MYSORE,10,6,AGATTI ISLAND-MYSORE,16,All
2022,2,AGATTI ISLAND,MYSORE,11,10,AGATTI ISLAND-MYSORE,21,All
2022,3,AGATTI ISLAND,MYSORE,4,6,AGATTI ISLAND-MYSORE,10,All
2022,4,AGATTI ISLAND,MYSORE,42,15,AGATTI ISLAND-MYSORE,57,All
2022,5,AGATTI ISLAND,MYSORE,17,8,AGATTI ISLAND-MYSORE,25,All
2022,6,AGATTI ISLAND,MYSORE,42,15,AGATTI ISLAND-MYSORE,57,All
2022,7,AGATTI ISLAND,MYSORE,11,10,AGATTI ISLAND-MYSORE,21,All
2022,8,AGATTI ISLAND,MYSORE,17,8,AGATTI ISLAND-MYSORE,25,All
2022,9,AGATTI ISLAND,MYSORE,42,15,AGATTI ISLAND-MYSORE,57,All
2022,10,AGATTI ISLAND,MYSORE,6,9,AGATTI ISLAND-MYSORE,15,All
2021,3,AGRA,AHMEDABAD,108,81,AGRA-AHMEDABAD,189,All
2021,4,AGRA,AHMEDABAD,369,444,AGRA-AHMEDABAD,813,All
2021,7,AGRA,AHMEDABAD,359,322,AGRA-AHMEDABAD,681,All
2021,8,AGRA,AHMEDABAD,799,756,AGRA-AHMEDABAD,1555,All
2021,9,AGRA,AHMEDABAD,798,687,AGRA-AHMEDABAD,1485,All
2021,10,AGRA,AHMEDABAD,1201,1266,AGRA-AHMEDABAD,2467,All
2022,6,AGRA,AHMEDABAD,914,902,AGRA-AHMEDABAD,1816,All
2022,7,AGRA,AHMEDABAD,634,787,AGRA-AHMEDABAD,1421,All
2022,8,AGRA,AHMEDABAD,524,632,AGRA-AHMEDABAD,1156,All
2022,9,AGRA,AHMEDABAD,615,508,AGRA-AHMEDABAD,1123,All
2022,10,AGRA,AHMEDABAD,700,733,AGRA-AHMEDABAD,1433,All
2022,11,AGRA,AHMEDABAD,883,687,AGRA-AHMEDABAD,1570,All
2022,12,AGRA,AHMEDABAD,894,803,AGRA-AHMEDABAD,1697,All
2023,1,AGRA,AHMEDABAD,730,777,AGRA-AHMEDABAD,1507,All
2023,2,AGRA,AHMEDABAD,705,833,AGRA-AHMEDABAD,1538,All
2023,3,AGRA,AHMEDABAD,858,798,AGRA-AHMEDABAD,1656,All
2023,4,AGRA,AHMEDABAD,812,892,AGRA-AHMEDABAD,1704,All
2023,5,AGRA,AHMEDABAD,1159,1281,AGRA-AHMEDABAD,2440,All
2023,10,AGRA,AHMEDABAD,195,191,AGRA-AHMEDABAD,386,All
2023,11,AGRA,AHMEDABAD,1672,1949,AGRA-AHMEDABAD,3621,All
2023,12,AGRA,AHMEDABAD,2187,1951,AGRA-AHMEDABAD,4138,All
2024,1,AGRA,AHMEDABAD,1922,2016,AGRA-AHMEDABAD,3938,All
2024,2,AGRA,AHMEDABAD,1698,1951,AGRA-AHMEDABAD,3649,All
2024,3,AGRA,AHMEDABAD,1831,2039,AGRA-AHMEDABAD,3870,All
2025,1,AGRA,AHMEDABAD,1030,1080,AGRA-AHMEDABAD,2110,All
2025,2,AGRA,AHMEDABAD,1568,1683,AGRA-AHMEDABAD,3251,All
2025,3,AGRA,AHMEDABAD,1817,1879,AGRA-AHMEDABAD,3696,All
2021,3,AGRA,BENGALURU,184,264,AGRA-BENGALURU,448,All
2021,4,AGRA,BENGALURU,1568,2282,AGRA-BENGALURU,3850,All
2021,6,AGRA,BENGALURU,1406,1100,AGRA-BENGALURU,2506,All
2021,7,AGRA,BENGALURU,2300,1846,AGRA-BENGALURU,4146,All
2021,8,AGRA,BENGALURU,2222,2189,AGRA-BENGALURU,4411,All
2021,9,AGRA,BENGALURU,2197,2017,AGRA-BENGALURU,4214,All
2021,10,AGRA,BENGALURU,2273,2829,AGRA-BENGALURU,5102,All
2021,11,AGRA,BENGALURU,2154,2201,AGRA-BENGALURU,4355,All
2021,12,AGRA,BENGALURU,2189,2025,AGRA-BENGALURU,4214,All
2022,1,AGRA,BENGALURU,1517,2003,AGRA-BENGALURU,3520,All
2022,2,AGRA,BENGALURU,1808,1791,AGRA-BENGALURU,3599,All
2022,3,AGRA,BENGALURU,2249,2275,AGRA-BENGALURU,4524,All
2022,4,AGRA,BENGALURU,2703,2673,AGRA-BENGALURU,5376,All
2022,5,AGRA,BENGALURU,2869,2392,AGRA-BENGALURU,5261,All
2022,6,AGRA,BENGALURU,2582,2420,AGRA-BENGALURU,5002,All
2022,7,AGRA,BENGALURU,2679,2564,AGRA-BENGALURU,5243,All
2022,8,AGRA,BENGALURU,2522,2490,AGRA-BENGALURU,5012,All
2022,9,AGRA,BENGALURU,2315,2344,AGRA-BENGALURU,4659,All
2022,10,AGRA,BENGALURU,2657,2907,AGRA-BENGALURU,5564,All
2022,11,AGRA,BENGALURU,2229,2179,AGRA-BENGALURU,4408,All
2022,12,AGRA,BENGALURU,2458,2221,AGRA-BENGALURU,4679,All
2023,1,AGRA,BENGALURU,2349,2201,AGRA-BENGALURU,4550,All
2023,2,AGRA,BENGALURU,2167,2253,AGRA-BENGALURU,4420,All
2023,3,AGRA,BENGALURU,2332,2082,AGRA-BENGALURU,4414,All
2023,4,AGRA,BENGALURU,2292,2319,AGRA-BENGALURU,4611,All
2023,5,AGRA,BENGALURU,2908,2598,AGRA-BENGALURU,5506,All
2023,6,AGRA,BENGALURU,2765,2605,AGRA-BENGALURU,5370,All
2023,7,AGRA,BENGALURU,2598,2611,AGRA-BENGALURU,5209,All
2023,8,AGRA,BENGALURU,2579,2728,AGRA-BENGALURU,5307,All
2023,9,AGRA,BENGALURU,2665,2658,AGRA-BENGALURU,5323,All
2023,10,AGRA,BENGALURU,2762,2896,AGRA-BENGALURU,5658,All
2023,11,AGRA,BENGALURU,2592,2671,AGRA-BENGALURU,5263,All
2023,12,AGRA,BENGALURU,3082,2873,AGRA-BENGALURU,5955,All
2024,1,AGRA,BENGALURU,2927,2952,AGRA-BENGALURU,5879,All
2024,2,AGRA,BENGALURU,2335,2547,AGRA-BENGALURU,4882,All
2024,3,AGRA,BENGALURU,2875,2829,AGRA-BENGALURU,5704,All
2024,4,AGRA,BENGALURU,2695,2762,AGRA-BENGALURU,5457,All
2024,6,AGRA,BENGALURU,2908,2746,AGRA-BENGALURU,5654,All
2024,7,AGRA,BENGALURU,3065,2986,AGRA-BENGALURU,6051,All
2024,8,AGRA,BENGALURU,2725,2700,AGRA-BENGALURU,5425,All
2024,9,AGRA,BENGALURU,2760,2890,AGRA-BENGALURU,5650,All
2024,10,AGRA,BENGALURU,2558,2842,AGRA-BENGALURU,5400,All
2024,11,AGRA,BENGALURU,2989,2700,AGRA-BENGALURU,5689,All
2024,12,AGRA,BENGALURU,2904,2997,AGRA-BENGALURU,5901,All
2025,1,AGRA,BENGALURU,2892,2997,AGRA-BENGALURU,5889,All
2025,2,AGRA,BENGALURU,1915,1916,AGRA-BENGALURU,3831,All
2025,3,AGRA,BENGALURU,2755,2879,AGRA-BENGALURU,5634,All
2021,3,AGRA,BHOPAL,42,30,AGRA-BHOPAL,72,All
2021,4,AGRA,BHOPAL,159,166,AGRA-BHOPAL,325,All
2021,10,AGRA,BHOPAL,168,200,AGRA-BHOPAL,368,All
2021,11,AGRA,BHOPAL,598,744,AGRA-BHOPAL,1342,All
2021,12,AGRA,BHOPAL,401,627,AGRA-BHOPAL,1028,All
2022,1,AGRA,BHOPAL,254,243,AGRA-BHOPAL,497,All
2022,2,AGRA,BHOPAL,226,457,AGRA-BHOPAL,683,All
2022,3,AGRA,BHOPAL,352,533,AGRA-BHOPAL,885,All
2022,4,AGRA,BHOPAL,218,262,AGRA-BHOPAL,480,All
2022,5,AGRA,BHOPAL,232,339,AGRA-BHOPAL,571,All
2022,6,AGRA,BHOPAL,338,357,AGRA-BHOPAL,695,All
2022,7,AGRA,BHOPAL,141,217,AGRA-BHOPAL,358,All
2022,8,AGRA,BHOPAL,122,172,AGRA-BHOPAL,294,All
2022,9,AGRA,BHOPAL,84,158,AGRA-BHOPAL,242,All
2022,10,AGRA,BHOPAL,169,299,AGRA-BHOPAL,468,All
2022,11,AGRA,BHOPAL,243,221,AGRA-BHOPAL,464,All
2022,12,AGRA,BHOPAL,222,381,AGRA-BHOPAL,603,All
2023,1,AGRA,BHOPAL,150,237,AGRA-BHOPAL,387,All
2023,2,AGRA,BHOPAL,240,297,AGRA-BHOPAL,537,All
2023,3,AGRA,BHOPAL,236,303,AGRA-BHOPAL,539,All
2023,4,AGRA,BHOPAL,164,216,AGRA-BHOPAL,380,All
2023,5,AGRA,BHOPAL,232,329,AGRA-BHOPAL,561,All
2023,6,AGRA,BHOPAL,440,429,AGRA-BHOPAL,869,All
2023,7,AGRA,BHOPAL,199,330,AGRA-BHOPAL,529,All
2023,8,AGRA,BHOPAL,157,243,AGRA-BHOPAL,400,All
2023,9,AGRA,BHOPAL,142,195,AGRA-BHOPAL,337,All
2023,10,AGRA,BHOPAL,119,164,AGRA-BHOPAL,283,All
2023,11,AGRA,BHOPAL,267,354,AGRA-BHOPAL,621,All
2023,12,AGRA,BHOPAL,379,312,AGRA-BHOPAL,691,All
2024,1,AGRA,BHOPAL,196,259,AGRA-BHOPAL,455,All
2024,2,AGRA,BHOPAL,304,373,AGRA-BHOPAL,677,All
2024,3,AGRA,BHOPAL,332,421,AGRA-BHOPAL,753,All
2021,1,AGRA,DABOLIM,0,61,AGRA-DABOLIM,61,All
2021,2,AGRA,DABOLIM,0,253,AGRA-DABOLIM,253,All
2015,4,AGRA,DELHI,0,40,AGRA-DELHI,40,All
2015,8,AGRA,DELHI,0,12,AGRA-DELHI,12,All
2015,9,AGRA,DELHI,0,5,AGRA-DELHI,5,All
2015,10,AGRA,DELHI,0,12790,AGRA-DELHI,12790,All
2015,11,AGRA,DELHI,0,42,AGRA-DELHI,42,All
2015,12,AGRA,DELHI,0,66,AGRA-DELHI,66,All
2016,1,AGRA,DELHI,0,64,AGRA-DELHI,64,All
2016,2,AGRA,DELHI,0,52,AGRA-DELHI,52,All
2016,3,AGRA,DELHI,0,54,AGRA-DELHI,54,All
2016,4,AGRA,DELHI,0,54,AGRA-DELHI,54,All
2016,5,AGRA,DELHI,0,2,AGRA-DELHI,2,All
2016,10,AGRA,DELHI,0,66,AGRA-DELHI,66,All
2016,11,AGRA,DELHI,0,28,AGRA-DELHI,28,All
2016,12,AGRA,DELHI,0,41,AGRA-DELHI,41,All
2017,1,AGRA,DELHI,0,49,AGRA-DELHI,49,All
2017,2,AGRA,DELHI,0,15,AGRA-DELHI,15,All
2017,3,AGRA,DELHI,0,9,AGRA-DELHI,9,All
2017,6,AGRA,DELHI,0,45,AGRA-DELHI,45,All
2017,7,AGRA,DELHI,0,94,AGRA-DELHI,94,All
2017,8,AGRA,DELHI,0,54,AGRA-DELHI,54,All
2017,9,AGRA,DELHI,0,57,AGRA-DELHI,57,All
2017,10,AGRA,DELHI,0,55,AGRA-DELHI,55,All
2017,11,AGRA,DELHI,0,31,AGRA-DELHI,31,All
2017,12,AGRA,DELHI,0,31,AGRA-DELHI,31,All
2018,1,AGRA,DELHI,0,56,AGRA-DELHI,56,All
2018,2,AGRA,DELHI,0,29,AGRA-DELHI,29,All
2018,3,AGRA,DELHI,0,46,AGRA-DELHI,46,All
2018,4,AGRA,DELHI,0,43,AGRA-DELHI,43,All
2018,5,AGRA,DELHI,0,42,AGRA-DELHI,42,All
2018,6,AGRA,DELHI,0,67,AGRA-DELHI,67,All
2018,7,AGRA,DELHI,0,88,AGRA-DELHI,88,All
2018,8,AGRA,DELHI,0,41,AGRA-DELHI,41,All
2018,9,AGRA,DELHI,0,74,AGRA-DELHI,74,All
2018,10,AGRA,DELHI,62,117,AGRA-DELHI,179,All
2018,11,AGRA,DELHI,0,17,AGRA-DELHI,17,All
2018,12,AGRA,DELHI,0,68,AGRA-DELHI,68,All
2019,1,AGRA,DELHI,0,30,AGRA-DELHI,30,All
2019,2,AGRA,DELHI,0,14,AGRA-DELHI,14,All
2019,3,AGRA,DELHI,0,23,AGRA-DELHI,23,All
2019,4,AGRA,DELHI,0,40,AGRA-DELHI,40,All
2019,5,AGRA,DELHI,0,48,AGRA-DELHI,48,All
2019,6,AGRA,DELHI,0,5,AGRA-DELHI,5,All
2019,8,AGRA,DELHI,0,25,AGRA-DELHI,25,All
2019,9,AGRA,DELHI,0,53,AGRA-DELHI,53,All
2019,10,AGRA,DELHI,0,23,AGRA-DELHI,23,All
2021,1,AGRA,DELHI,17,0,AGRA-DELHI,17,All
2021,2,AGRA,DELHI,46,1,AGRA-DELHI,47,All
2021,12,AGRA,DELHI,9,0,AGRA-DELHI,9,All
2024,4,AGRA,DELHI,0,122,AGRA-DELHI,122,All
2024,2,AGRA,HYDERABAD,157,0,AGRA-HYDERABAD,157,All
2024,9,AGRA,HYDERABAD,95,159,AGRA-HYDERABAD,254,All
2024,10,AGRA,HYDERABAD,1768,2147,AGRA-HYDERABAD,3915,All
2024,11,AGRA,HYDERABAD,2295,1926,AGRA-HYDERABAD,4221,All
2024,12,AGRA,HYDERABAD,2218,1941,AGRA-HYDERABAD,4159,All
2025,1,AGRA,HYDERABAD,2053,1925,AGRA-HYDERABAD,3978,All
2025,2,AGRA,HYDERABAD,2008,2028,AGRA-HYDERABAD,4036,All
2025,3,AGRA,HYDERABAD,2025,2100,AGRA-HYDERABAD,4125,All
2017,12,AGRA,JAIPUR,475,341,AGRA-JAIPUR,816,All
2018,1,AGRA,JAIPUR,392,265,AGRA-JAIPUR,657,All
2018,2,AGRA,JAIPUR,330,341,AGRA-JAIPUR,671,All
2018,7,AGRA,JAIPUR,22,7,AGRA-JAIPUR,29,All
2018,8,AGRA,JAIPUR,271,245,AGRA-JAIPUR,516,All
2018,9,AGRA,JAIPUR,383,455,AGRA-JAIPUR,838,All
2018,10,AGRA,JAIPUR,442,426,AGRA-JAIPUR,868,All
2018,11,AGRA,JAIPUR,447,147,AGRA-JAIPUR,594,All
2018,12,AGRA,JAIPUR,540,629,AGRA-JAIPUR,1169,All
2019,1,AGRA,JAIPUR,605,717,AGRA-JAIPUR,1322,All
2019,2,AGRA,JAIPUR,643,716,AGRA-JAIPUR,1359,All
2019,3,AGRA,JAIPUR,526,572,AGRA-JAIPUR,1098,All
2019,4,AGRA,JAIPUR,519,588,AGRA-JAIPUR,1107,All
2019,5,AGRA,JAIPUR,407,567,AGRA-JAIPUR,974,All
2019,6,AGRA,JAIPUR,406,410,AGRA-JAIPUR,816,All
2019,7,AGRA,JAIPUR,495,547,AGRA-JAIPUR,1042,All
2019,8,AGRA,JAIPUR,608,609,AGRA-JAIPUR,1217,All
2019,9,AGRA,JAIPUR,513,554,AGRA-JAIPUR,1067,All
2019,10,AGRA,JAIPUR,539,634,AGRA-JAIPUR,1173,All
2019,11,AGRA,JAIPUR,392,351,AGRA-JAIPUR,743,All
2019,12,AGRA,JAIPUR,556,549,AGRA-JAIPUR,1105,All
2020,1,AGRA,JAIPUR,606,657,AGRA-JAIPUR,1263,All
2020,2,AGRA,JAIPUR,340,400,AGRA-JAIPUR,740,All
2020,3,AGRA,JAIPUR,33,55,AGRA-JAIPUR,88,All
2020,6,AGRA,JAIPUR,111,90,AGRA-JAIPUR,201,All
2020,7,AGRA,JAIPUR,67,42,AGRA-JAIPUR,109,All
2020,8,AGRA,JAIPUR,26,31,AGRA-JAIPUR,57,All
2020,10,AGRA,JAIPUR,64,33,AGRA-JAIPUR,97,All
2020,11,AGRA,JAIPUR,63,63,AGRA-JAIPUR,126,All
2020,12,AGRA,JAIPUR,7,4,AGRA-JAIPUR,11,All
2023,10,AGRA,JAIPUR,100,76,AGRA-JAIPUR,176,All
2023,11,AGRA,JAIPUR,1401,1175,AGRA-JAIPUR,2576,All
2023,12,AGRA,JAIPUR,1435,1021,AGRA-JAIPUR,2456,All
2024,1,AGRA,JAIPUR,1091,1041,AGRA-JAIPUR,2132,All
2024,2,AGRA,JAIPUR,1380,1537,AGRA-JAIPUR,2917,All
2024,3,AGRA,JAIPUR,1427,1910,AGRA-JAIPUR,3337,All
2025,2,AGRA,JAIPUR,0,9,AGRA-JAIPUR,9,All
2015,4,AGRA,KHAJURAHO,93,0,AGRA-KHAJURAHO,93,All
2015,7,AGRA,KHAJURAHO,6,0,AGRA-KHAJURAHO,6,All
2015,9,AGRA,KHAJURAHO,31,0,AGRA-KHAJURAHO,31,All
2015,10,AGRA,KHAJURAHO,2168,0,AGRA-KHAJURAHO,2168,All
2015,11,AGRA,KHAJURAHO,270,0,AGRA-KHAJURAHO,270,All
2015,12,AGRA,KHAJURAHO,307,0,AGRA-KHAJURAHO,307,All
2016,1,AGRA,KHAJURAHO,392,0,AGRA-KHAJURAHO,392,All
2016,2,AGRA,KHAJURAHO,426,0,AGRA-KHAJURAHO,426,All
2016,3,AGRA,KHAJURAHO,269,0,AGRA-KHAJURAHO,269,All
2016,4,AGRA,KHAJURAHO,189,0,AGRA-KHAJURAHO,189,All
2016,5,AGRA,KHAJURAHO,7,0,AGRA-KHAJURAHO,7,All
2016,10,AGRA,KHAJURAHO,254,0,AGRA-KHAJURAHO,254,All
2016,11,AGRA,KHAJURAHO,313,0,AGRA-KHAJURAHO,313,All
2016,12,AGRA,KHAJURAHO,275,0,AGRA-KHAJURAHO,275,All
2017,1,AGRA,KHAJURAHO,444,0,AGRA-KHAJURAHO,444,All
2017,2,AGRA,KHAJURAHO,481,0,AGRA-KHAJURAHO,481,All
2017,3,AGRA,KHAJURAHO,93,0,AGRA-KHAJURAHO,93,All
2017,6,AGRA,KHAJURAHO,41,0,AGRA-KHAJURAHO,41,All
2017,7,AGRA,KHAJURAHO,78,0,AGRA-KHAJURAHO,78,All
2017,8,AGRA,KHAJURAHO,93,0,AGRA-KHAJURAHO,93,All
2017,9,AGRA,KHAJURAHO,94,0,AGRA-KHAJURAHO,94,All
2017,10,AGRA,KHAJURAHO,273,0,AGRA-KHAJURAHO,273,All
2017,11,AGRA,KHAJURAHO,236,0,AGRA-KHAJURAHO,236,All
2017,12,AGRA,KHAJURAHO,269,0,AGRA-KHAJURAHO,269,All
2018,1,AGRA,KHAJURAHO,338,0,AGRA-KHAJURAHO,338,All
2018,2,AGRA,KHAJURAHO,522,0,AGRA-KHAJURAHO,522,All
2018,3,AGRA,KHAJURAHO,332,0,AGRA-KHAJURAHO,332,All
2018,4,AGRA,KHAJURAHO,246,0,AGRA-KHAJURAHO,246,All
2018,5,AGRA,KHAJURAHO,96,0,AGRA-KHAJURAHO,96,All
2018,6,AGRA,KHAJURAHO,162,0,AGRA-KHAJURAHO,162,All
2018,7,AGRA,KHAJURAHO,183,0,AGRA-KHAJURAHO,183,All
2018,8,AGRA,KHAJURAHO,185,0,AGRA-KHAJURAHO,185,All
2018,9,AGRA,KHAJURAHO,249,0,AGRA-KHAJURAHO,249,All
2018,10,AGRA,KHAJURAHO,361,0,AGRA-KHAJURAHO,361,All
2018,11,AGRA,KHAJURAHO,330,0,AGRA-KHAJURAHO,330,All
2018,12,AGRA,KHAJURAHO,336,0,AGRA-KHAJURAHO,336,All
2019,1,AGRA,KHAJURAHO,381,0,AGRA-KHAJURAHO,381,All
2019,2,AGRA,KHAJURAHO,397,0,AGRA-KHAJURAHO,397,All
2019,3,AGRA,KHAJURAHO,461,0,AGRA-KHAJURAHO,461,All
2019,4,AGRA,KHAJURAHO,145,0,AGRA-KHAJURAHO,145,All
2019,5,AGRA,KHAJURAHO,143,0,AGRA-KHAJURAHO,143,All
2019,6,AGRA,KHAJURAHO,36,0,AGRA-KHAJURAHO,36,All
2019,8,AGRA,KHAJURAHO,97,0,AGRA-KHAJURAHO,97,All
2019,9,AGRA,KHAJURAHO,133,0,AGRA-KHAJURAHO,133,All
2019,10,AGRA,KHAJURAHO,200,0,AGRA-KHAJURAHO,200,All
2021,7,AGRA,KOLKATA,13,14,AGRA-KOLKATA,27,All
2021,10,AGRA,LUCKNOW,361,530,AGRA-LUCKNOW,891,All
2021,11,AGRA,LUCKNOW,596,577,AGRA-LUCKNOW,1173,All
2021,12,AGRA,LUCKNOW,208,203,AGRA-LUCKNOW,411,All
2022,1,AGRA,LUCKNOW,263,150,AGRA-LUCKNOW,413,All
2022,2,AGRA,LUCKNOW,401,246,AGRA-LUCKNOW,647,All
2022,3,AGRA,LUCKNOW,710,500,AGRA-LUCKNOW,1210,All
2022,4,AGRA,LUCKNOW,440,570,AGRA-LUCKNOW,1010,All
2022,5,AGRA,LUCKNOW,428,512,AGRA-LUCKNOW,940,All
2022,6,AGRA,LUCKNOW,477,746,AGRA-LUCKNOW,1223,All
2022,7,AGRA,LUCKNOW,365,440,AGRA-LUCKNOW,805,All
2022,8,AGRA,LUCKNOW,374,485,AGRA-LUCKNOW,859,All
2022,9,AGRA,LUCKNOW,310,430,AGRA-LUCKNOW,740,All
2022,10,AGRA,LUCKNOW,643,557,AGRA-LUCKNOW,1200,All
2022,11,AGRA,LUCKNOW,487,439,AGRA-LUCKNOW,926,All
2022,12,AGRA,LUCKNOW,647,634,AGRA-LUCKNOW,1281,All
2023,1,AGRA,LUCKNOW,490,379,AGRA-LUCKNOW,869,All
2023,2,AGRA,LUCKNOW,521,483,AGRA-LUCKNOW,1004,All
2023,3,AGRA,LUCKNOW,423,522,AGRA-LUCKNOW,945,All
2023,4,AGRA,LUCKNOW,608,360,AGRA-LUCKNOW,968,All
2023,5,AGRA,LUCKNOW,752,339,AGRA-LUCKNOW,1091,All
2023,6,AGRA,LUCKNOW,592,568,AGRA-LUCKNOW,1160,All
2023,7,AGRA,LUCKNOW,422,528,AGRA-LUCKNOW,950,All
2023,8,AGRA,LUCKNOW,470,607,AGRA-LUCKNOW,1077,All
2023,9,AGRA,LUCKNOW,624,874,AGRA-LUCKNOW,1498,All
2023,10,AGRA,LUCKNOW,740,788,AGRA-LUCKNOW,1528,All
2023,11,AGRA,LUCKNOW,1450,951,AGRA-LUCKNOW,2401,All
2023,12,AGRA,LUCKNOW,1287,1143,AGRA-LUCKNOW,2430,All
2024,1,AGRA,LUCKNOW,777,636,AGRA-LUCKNOW,1413,All
2024,2,AGRA,LUCKNOW,1357,896,AGRA-LUCKNOW,2253,All
2024,3,AGRA,LUCKNOW,1625,1024,AGRA-LUCKNOW,2649,All
2024,4,AGRA,LUCKNOW,1035,696,AGRA-LUCKNOW,1731,All
2024,6,AGRA,LUCKNOW,1098,803,AGRA-LUCKNOW,1901,All
2024,7,AGRA,LUCKNOW,894,653,AGRA-LUCKNOW,1547,All
2024,8,AGRA,LUCKNOW,1232,830,AGRA-LUCKNOW,2062,All
2024,9,AGRA,LUCKNOW,1053,740,AGRA-LUCKNOW,1793,All
2021,3,AGRA,MUMBAI,124,122,AGRA-MUMBAI,246,All
2021,4,AGRA,MUMBAI,463,678,AGRA-MUMBAI,1141,All
2021,7,AGRA,MUMBAI,380,398,AGRA-MUMBAI,778,All
2021,8,AGRA,MUMBAI,136,249,AGRA-MUMBAI,385,All
2021,11,AGRA,MUMBAI,44,170,AGRA-MUMBAI,214,All
2021,12,AGRA,MUMBAI,1537,1267,AGRA-MUMBAI,2804,All
2022,1,AGRA,MUMBAI,416,417,AGRA-MUMBAI,833,All
2022,3,AGRA,MUMBAI,1642,1723,AGRA-MUMBAI,3365,All
2022,5,AGRA,MUMBAI,1543,1451,AGRA-MUMBAI,2994,All
2022,6,AGRA,MUMBAI,2088,1831,AGRA-MUMBAI,3919,All
2022,7,AGRA,MUMBAI,1545,1594,AGRA-MUMBAI,3139,All
2022,8,AGRA,MUMBAI,1795,1847,AGRA-MUMBAI,3642,All
2022,9,AGRA,MUMBAI,1643,1674,AGRA-MUMBAI,3317,All
2022,10,AGRA,MUMBAI,1524,1721,AGRA-MUMBAI,3245,All
2022,11,AGRA,MUMBAI,1435,1204,AGRA-MUMBAI,2639,All
2022,12,AGRA,MUMBAI,1436,1327,AGRA-MUMBAI,2763,All
2023,1,AGRA,MUMBAI,1785,1814,AGRA-MUMBAI,3599,All
2023,2,AGRA,MUMBAI,1733,1869,AGRA-MUMBAI,3602,All
2023,3,AGRA,MUMBAI,1809,1848,AGRA-MUMBAI,3657,All
2023,4,AGRA,MUMBAI,1989,2173,AGRA-MUMBAI,4162,All
2023,5,AGRA,MUMBAI,1979,1981,AGRA-MUMBAI,3960,All
2023,6,AGRA,MUMBAI,2080,1994,AGRA-MUMBAI,4074,All
2023,7,AGRA,MUMBAI,1792,1986,AGRA-MUMBAI,3778,All
2023,8,AGRA,MUMBAI,2063,2133,AGRA-MUMBAI,4196,All
2023,9,AGRA,MUMBAI,2106,2078,AGRA-MUMBAI,4184,All
2023,10,AGRA,MUMBAI,1905,1942,AGRA-MUMBAI,3847,All
2023,11,AGRA,MUMBAI,2055,2160,AGRA-MUMBAI,4215,All
2023,12,AGRA,MUMBAI,2301,2153,AGRA-MUMBAI,4454,All
2024,1,AGRA,MUMBAI,2011,1985,AGRA-MUMBAI,3996,All
2024,2,AGRA,MUMBAI,2052,2058,AGRA-MUMBAI,4110,All
2024,3,AGRA,MUMBAI,2082,2064,AGRA-MUMBAI,4146,All
2024,4,AGRA,MUMBAI,2000,2169,AGRA-MUMBAI,4169,All
2024,6,AGRA,MUMBAI,2065,2020,AGRA-MUMBAI,4085,All
2024,7,AGRA,MUMBAI,1864,2143,AGRA-MUMBAI,4007,All
2024,8,AGRA,MUMBAI,2083,2242,AGRA-MUMBAI,4325,All
2024,9,AGRA,MUMBAI,1796,1963,AGRA-MUMBAI,3759,All
2024,10,AGRA,MUMBAI,1724,2243,AGRA-MUMBAI,3967,All
2024,11,AGRA,MUMBAI,2289,2088,AGRA-MUMBAI,4377,All
2024,12,AGRA,MUMBAI,2210,2192,AGRA-MUMBAI,4402,All
2025,1,AGRA,MUMBAI,2161,2194,AGRA-MUMBAI,4355,All
2025,2,AGRA,MUMBAI,2014,2113,AGRA-MUMBAI,4127,All
2025,3,AGRA,MUMBAI,2141,2190,AGRA-MUMBAI,4331,All
2021,9,AGRA,NAGPUR,2,0,AGRA-NAGPUR,2,All
2015,4,AGRA,VARANASI,0,263,AGRA-VARANASI,263,All
2015,7,AGRA,VARANASI,0,31,AGRA-VARANASI,31,All
2015,8,AGRA,VARANASI,0,76,AGRA-VARANASI,76,All
2015,9,AGRA,VARANASI,0,131,AGRA-VARANASI,131,All
2015,10,AGRA,VARANASI,0,41520,AGRA-VARANASI,41520,All
2015,11,AGRA,VARANASI,0,979,AGRA-VARANASI,979,All
2015,12,AGRA,VARANASI,0,909,AGRA-VARANASI,909,All
2016,1,AGRA,VARANASI,0,1052,AGRA-VARANASI,1052,All
2016,2,AGRA,VARANASI,0,1046,AGRA-VARANASI,1046,All
2016,3,AGRA,VARANASI,0,1059,AGRA-VARANASI,1059,All
2016,4,AGRA,VARANASI,0,530,AGRA-VARANASI,530,All
2016,5,AGRA,VARANASI,0,106,AGRA-VARANASI,106,All
2016,10,AGRA,VARANASI,0,923,AGRA-VARANASI,923,All
2016,11,AGRA,VARANASI,0,1020,AGRA-VARANASI,1020,All
2016,12,AGRA,VARANASI,0,889,AGRA-VARANASI,889,All
2017,1,AGRA,VARANASI,0,1054,AGRA-VARANASI,1054,All
2017,2,AGRA,VARANASI,0,1069,AGRA-VARANASI,1069,All
2017,3,AGRA,VARANASI,0,323,AGRA-VARANASI,323,All
2017,6,AGRA,VARANASI,0,188,AGRA-VARANASI,188,All
2017,7,AGRA,VARANASI,0,408,AGRA-VARANASI,408,All
2017,8,AGRA,VARANASI,0,325,AGRA-VARANASI,325,All
2017,9,AGRA,VARANASI,0,410,AGRA-VARANASI,410,All
2017,10,AGRA,VARANASI,0,927,AGRA-VARANASI,927,All
2017,11,AGRA,VARANASI,0,811,AGRA-VARANASI,811,All
2017,12,AGRA,VARANASI,0,732,AGRA-VARANASI,732,All
2018,1,AGRA,VARANASI,0,965,AGRA-VARANASI,965,All
2018,2,AGRA,VARANASI,0,878,AGRA-VARANASI,878,All
2018,3,AGRA,VARANASI,0,909,AGRA-VARANASI,909,All
2018,4,AGRA,VARANASI,0,591,AGRA-VARANASI,591,All
2018,5,AGRA,VARANASI,0,389,AGRA-VARANASI,389,All
2018,6,AGRA,VARANASI,0,427,AGRA-VARANASI,427,All
2018,7,AGRA,VARANASI,0,534,AGRA-VARANASI,534,All
2018,8,AGRA,VARANASI,0,396,AGRA-VARANASI,396,All
2018,9,AGRA,VARANASI,0,439,AGRA-VARANASI,439,All
2018,10,AGRA,VARANASI,0,815,AGRA-VARANASI,815,All
2018,11,AGRA,VARANASI,0,989,AGRA-VARANASI,989,All
2018,12,AGRA,VARANASI,0,985,AGRA-VARANASI,985,All
2019,1,AGRA,VARANASI,0,988,AGRA-VARANASI,988,All
2019,2,AGRA,VARANASI,0,907,AGRA-VARANASI,907,All
2019,3,AGRA,VARANASI,0,837,AGRA-VARANASI,837,All
2019,4,AGRA,VARANASI,0,540,AGRA-VARANASI,540,All
2019,5,AGRA,VARANASI,0,368,AGRA-VARANASI,368,All
2019,6,AGRA,VARANASI,0,67,AGRA-VARANASI,67,All
2019,8,AGRA,VARANASI,0,308,AGRA-VARANASI,308,All
2019,9,AGRA,VARANASI,0,489,AGRA-VARANASI,489,All
2019,10,AGRA,VARANASI,0,453,AGRA-VARANASI,453,All
2019,4,AHMEDABAD,AJMER,1759,1437,AHMEDABAD-AJMER,3196,All
2019,5,AHMEDABAD,AJMER,1592,1523,AHMEDABAD-AJMER,3115,All
2019,6,AHMEDABAD,AJMER,1084,1251,AHMEDABAD-AJMER,2335,All
2019,7,AHMEDABAD,AJMER,1013,967,AHMEDABAD-AJMER,1980,All
2019,8,AHMEDABAD,AJMER,1568,1345,AHMEDABAD-AJMER,2913,All
2019,9,AHMEDABAD,AJMER,1234,1213,AHMEDABAD-AJMER,2447,All
2019,10,AHMEDABAD,AJMER,1658,1198,AHMEDABAD-AJMER,2856,All
2019,11,AHMEDABAD,AJMER,1384,1647,AHMEDABAD-AJMER,3031,All
2019,12,AHMEDABAD,AJMER,1385,1397,AHMEDABAD-AJMER,2782,All
2020,1,AHMEDABAD,AJMER,1718,1497,AHMEDABAD-AJMER,3215,All
2020,2,AHMEDABAD,AJMER,1801,1470,AHMEDABAD-AJMER,3271,All
2020,3,AHMEDABAD,AJMER,970,938,AHMEDABAD-AJMER,1908,All
2020,5,AHMEDABAD,AJMER,34,16,AHMEDABAD-AJMER,50,All
2020,6,AHMEDABAD,AJMER,255,145,AHMEDABAD-AJMER,400,All
2020,7,AHMEDABAD,AJMER,272,264,AHMEDABAD-AJMER,536,All
2020,8,AHMEDABAD,AJMER,414,451,AHMEDABAD-AJMER,865,All
2020,9,AHMEDABAD,AJMER,504,487,AHMEDABAD-AJMER,991,All
2020,10,AHMEDABAD,AJMER,778,725,AHMEDABAD-AJMER,1503,All
2020,11,AHMEDABAD,AJMER,1628,1309,AHMEDABAD-AJMER,2937,All
2020,12,AHMEDABAD,AJMER,1265,1457,AHMEDABAD-AJMER,2722,All
2021,1,AHMEDABAD,AJMER,1293,1336,AHMEDABAD-AJMER,2629,All
2021,2,AHMEDABAD,AJMER,2064,1882,AHMEDABAD-AJMER,3946,All
2021,3,AHMEDABAD,AJMER,1454,1411,AHMEDABAD-AJMER,2865,All
2021,4,AHMEDABAD,AJMER,321,279,AHMEDABAD-AJMER,600,All
2021,6,AHMEDABAD,AJMER,445,472,AHMEDABAD-AJMER,917,All
2021,7,AHMEDABAD,AJMER,1082,1036,AHMEDABAD-AJMER,2118,All
2021,8,AHMEDABAD,AJMER,943,935,AHMEDABAD-AJMER,1878,All
2021,9,AHMEDABAD,AJMER,732,740,AHMEDABAD-AJMER,1472,All
2021,10,AHMEDABAD,AJMER,962,784,AHMEDABAD-AJMER,1746,All
2021,11,AHMEDABAD,AJMER,608,573,AHMEDABAD-AJMER,1181,All
2021,12,AHMEDABAD,AJMER,712,778,AHMEDABAD-AJMER,1490,All
2022,1,AHMEDABAD,AJMER,225,259,AHMEDABAD-AJMER,484,All
2019,1,AHMEDABAD,ALLAHABAD,703,647,AHMEDABAD-ALLAHABAD,1350,All
2019,2,AHMEDABAD,ALLAHABAD,1065,994,AHMEDABAD-ALLAHABAD,2059,All
2019,3,AHMEDABAD,ALLAHABAD,333,329,AHMEDABAD-ALLAHABAD,662,All
2019,4,AHMEDABAD,ALLAHABAD,9,35,AHMEDABAD-ALLAHABAD,44,All
2019,5,AHMEDABAD,ALLAHABAD,85,53,AHMEDABAD-ALLAHABAD,138,All
2020,2,AHMEDABAD,AMRITSAR,1515,1414,AHMEDABAD-AMRITSAR,2929,All
2020,3,AHMEDABAD,AMRITSAR,1242,1325,AHMEDABAD-AMRITSAR,2567,All
2021,1,AHMEDABAD,AMRITSAR,17,3,AHMEDABAD-AMRITSAR,20,All
2021,2,AHMEDABAD,AMRITSAR,448,445,AHMEDABAD-AMRITSAR,893,All
2021,3,AHMEDABAD,AMRITSAR,1557,1633,AHMEDABAD-AMRITSAR,3190,All
2021,4,AHMEDABAD,AMRITSAR,817,941,AHMEDABAD-AMRITSAR,1758,All
2021,6,AHMEDABAD,AMRITSAR,299,307,AHMEDABAD-AMRITSAR,606,All
2021,8,AHMEDABAD,AMRITSAR,337,275,AHMEDABAD-AMRITSAR,612,All
2021,9,AHMEDABAD,AMRITSAR,915,858,AHMEDABAD-AMRITSAR,1773,All
2021,10,AHMEDABAD,AMRITSAR,1328,1120,AHMEDABAD-AMRITSAR,2448,All
2021,11,AHMEDABAD,AMRITSAR,1680,1550,AHMEDABAD-AMRITSAR,3230,All
2021,12,AHMEDABAD,AMRITSAR,702,828,AHMEDABAD-AMRITSAR,1530,All
2022,3,AHMEDABAD,AMRITSAR,357,386,AHMEDABAD-AMRITSAR,743,All
2022,4,AHMEDABAD,AMRITSAR,2291,2336,AHMEDABAD-AMRITSAR,4627,All
2022,5,AHMEDABAD,AMRITSAR,2301,2255,AHMEDABAD-AMRITSAR,4556,All
2022,6,AHMEDABAD,AMRITSAR,1600,1881,AHMEDABAD-AMRITSAR,3481,All
2022,7,AHMEDABAD,AMRITSAR,988,1063,AHMEDABAD-AMRITSAR,2051,All
2022,8,AHMEDABAD,AMRITSAR,1179,1146,AHMEDABAD-AMRITSAR,2325,All
2022,9,AHMEDABAD,AMRITSAR,503,433,AHMEDABAD-AMRITSAR,936,All
2022,10,AHMEDABAD,AMRITSAR,1215,1108,AHMEDABAD-AMRITSAR,2323,All
2022,11,AHMEDABAD,AMRITSAR,705,646,AHMEDABAD-AMRITSAR,1351,All
2022,12,AHMEDABAD,AMRITSAR,1894,2137,AHMEDABAD-AMRITSAR,4031,All
2023,1,AHMEDABAD,AMRITSAR,3215,3502,AHMEDABAD-AMRITSAR,6717,All
2023,2,AHMEDABAD,AMRITSAR,4071,4064,AHMEDABAD-AMRITSAR,8135,All
2023,3,AHMEDABAD,AMRITSAR,3755,4395,AHMEDABAD-AMRITSAR,8150,All
2023,4,AHMEDABAD,AMRITSAR,2060,1914,AHMEDABAD-AMRITSAR,3974,All
2023,5,AHMEDABAD,AMRITSAR,2237,2159,AHMEDABAD-AMRITSAR,4396,All
2023,6,AHMEDABAD,AMRITSAR,2000,2234,AHMEDABAD-AMRITSAR,4234,All
2023,7,AHMEDABAD,AMRITSAR,1804,1901,AHMEDABAD-AMRITSAR,3705,All
2023,8,AHMEDABAD,AMRITSAR,2020,1895,AHMEDABAD-AMRITSAR,3915,All
2023,9,AHMEDABAD,AMRITSAR,2149,2008,AHMEDABAD-AMRITSAR,4157,All
2023,10,AHMEDABAD,AMRITSAR,2491,2358,AHMEDABAD-AMRITSAR,4849,All
2023,11,AHMEDABAD,AMRITSAR,5259,4490,AHMEDABAD-AMRITSAR,9749,All
2023,12,AHMEDABAD,AMRITSAR,4398,4669,AHMEDABAD-AMRITSAR,9067,All
2024,1,AHMEDABAD,AMRITSAR,5359,5181,AHMEDABAD-AMRITSAR,10540,All
2024,2,AHMEDABAD,AMRITSAR,5177,5016,AHMEDABAD-AMRITSAR,10193,All
2024,3,AHMEDABAD,AMRITSAR,5591,5512,AHMEDABAD-AMRITSAR,11103,All
2024,4,AHMEDABAD,AMRITSAR,2902,2964,AHMEDABAD-AMRITSAR,5866,All
2024,6,AHMEDABAD,AMRITSAR,2988,3272,AHMEDABAD-AMRITSAR,6260,All
2024,7,AHMEDABAD,AMRITSAR,2475,2785,AHMEDABAD-AMRITSAR,5260,All
2024,8,AHMEDABAD,AMRITSAR,2686,2535,AHMEDABAD-AMRITSAR,5221,All
2024,9,AHMEDABAD,AMRITSAR,3395,3418,AHMEDABAD-AMRITSAR,6813,All
2024,10,AHMEDABAD,AMRITSAR,4471,3131,AHMEDABAD-AMRITSAR,7602,All
2024,11,AHMEDABAD,AMRITSAR,4487,4419,AHMEDABAD-AMRITSAR,8906,All
2024,12,AHMEDABAD,AMRITSAR,4493,4663,AHMEDABAD-AMRITSAR,9156,All
2025,1,AHMEDABAD,AMRITSAR,4800,4311,AHMEDABAD-AMRITSAR,9111,All
2025,2,AHMEDABAD,AMRITSAR,4309,3767,AHMEDABAD-AMRITSAR,8076,All
2025,3,AHMEDABAD,AMRITSAR,4510,4731,AHMEDABAD-AMRITSAR,9241,All
2018,5,AHMEDABAD,AURANGABAD,0,23,AHMEDABAD-AURANGABAD,23,All
2019,9,AHMEDABAD,AURANGABAD,579,750,AHMEDABAD-AURANGABAD,1329,All
2019,10,AHMEDABAD,AURANGABAD,511,678,AHMEDABAD-AURANGABAD,1189,All
2019,11,AHMEDABAD,AURANGABAD,1308,1204,AHMEDABAD-AURANGABAD,2512,All
2019,12,AHMEDABAD,AURANGABAD,2075,1518,AHMEDABAD-AURANGABAD,3593,All
2020,1,AHMEDABAD,AURANGABAD,1469,1499,AHMEDABAD-AURANGABAD,2968,All
2020,2,AHMEDABAD,AURANGABAD,1430,1528,AHMEDABAD-AURANGABAD,2958,All
2020,3,AHMEDABAD,AURANGABAD,825,804,AHMEDABAD-AURANGABAD,1629,All
2020,11,AHMEDABAD,AURANGABAD,0,3,AHMEDABAD-AURANGABAD,3,All
2021,2,AHMEDABAD,AURANGABAD,1020,1112,AHMEDABAD-AURANGABAD,2132,All
2021,3,AHMEDABAD,AURANGABAD,766,728,AHMEDABAD-AURANGABAD,1494,All
2021,4,AHMEDABAD,AURANGABAD,243,245,AHMEDABAD-AURANGABAD,488,All
2024,3,AHMEDABAD,AURANGABAD,61,53,AHMEDABAD-AURANGABAD,114,All
2024,4,AHMEDABAD,AURANGABAD,1726,1428,AHMEDABAD-AURANGABAD,3154,All
2024,6,AHMEDABAD,AURANGABAD,1914,1436,AHMEDABAD-AURANGABAD,3350,All
2024,7,AHMEDABAD,AURANGABAD,1933,1444,AHMEDABAD-AURANGABAD,3377,All
2024,8,AHMEDABAD,AURANGABAD,1697,1525,AHMEDABAD-AURANGABAD,3222,All
2024,9,AHMEDABAD,AURANGABAD,1896,1756,AHMEDABAD-AURANGABAD,3652,All
2024,10,AHMEDABAD,AURANGABAD,1916,1625,AHMEDABAD-AURANGABAD,3541,All
2024,11,AHMEDABAD,AURANGABAD,1676,1723,AHMEDABAD-AURANGABAD,3399,All
2024,1,AHMEDABAD,Ayodhya International Airport ,1484,1309,AHMEDABAD-Ayodhya International Airport ,2793,All
2024,2,AHMEDABAD,Ayodhya International Airport ,7032,6531,AHMEDABAD-Ayodhya International Airport ,13563,All
2024,3,AHMEDABAD,Ayodhya International Airport ,7746,7426,AHMEDABAD-Ayodhya International Airport ,15172,All
2024,4,AHMEDABAD,Ayodhya International Airport ,6955,6177,AHMEDABAD-Ayodhya International Airport ,13132,All
2024,6,AHMEDABAD,Ayodhya International Airport ,6795,6911,AHMEDABAD-Ayodhya International Airport ,13706,All
2024,7,AHMEDABAD,Ayodhya International Airport ,5688,5861,AHMEDABAD-Ayodhya International Airport ,11549,All
2024,8,AHMEDABAD,Ayodhya International Airport ,6466,6285,AHMEDABAD-Ayodhya International Airport ,12751,All
2024,9,AHMEDABAD,Ayodhya International Airport ,5819,5864,AHMEDABAD-Ayodhya International Airport ,11683,All
2024,10,AHMEDABAD,Ayodhya International Airport ,3226,2062,AHMEDABAD-Ayodhya International Airport ,5288,All
2024,11,AHMEDABAD,Ayodhya International Airport ,6981,6721,AHMEDABAD-Ayodhya International Airport ,13702,All
2024,12,AHMEDABAD,Ayodhya International Airport ,6009,7116,AHMEDABAD-Ayodhya International Airport ,13125,All
2025,1,AHMEDABAD,Ayodhya International Airport ,7614,7371,AHMEDABAD-Ayodhya International Airport ,14985,All
2025,2,AHMEDABAD,Ayodhya International Airport ,7067,6929,AHMEDABAD-Ayodhya International Airport ,13996,All
2025,3,AHMEDABAD,Ayodhya International Airport ,10373,9255,AHMEDABAD-Ayodhya International Airport ,19628,All
2019,1,AHMEDABAD,BAGDOGRA,1667,1605,AHMEDABAD-BAGDOGRA,3272,All
2019,2,AHMEDABAD,BAGDOGRA,3379,2479,AHMEDABAD-BAGDOGRA,5858,All
2019,4,AHMEDABAD,BAGDOGRA,2457,2202,AHMEDABAD-BAGDOGRA,4659,All
2019,5,AHMEDABAD,BAGDOGRA,5081,4776,AHMEDABAD-BAGDOGRA,9857,All
2019,6,AHMEDABAD,BAGDOGRA,3999,4451,AHMEDABAD-BAGDOGRA,8450,All
2019,7,AHMEDABAD,BAGDOGRA,3845,4548,AHMEDABAD-BAGDOGRA,8393,All
2019,8,AHMEDABAD,BAGDOGRA,4096,3781,AHMEDABAD-BAGDOGRA,7877,All
2019,9,AHMEDABAD,BAGDOGRA,5296,3883,AHMEDABAD-BAGDOGRA,9179,All
2019,10,AHMEDABAD,BAGDOGRA,9998,7050,AHMEDABAD-BAGDOGRA,17048,All
2019,11,AHMEDABAD,BAGDOGRA,8152,8944,AHMEDABAD-BAGDOGRA,17096,All
2019,12,AHMEDABAD,BAGDOGRA,8083,6986,AHMEDABAD-BAGDOGRA,15069,All
2020,1,AHMEDABAD,BAGDOGRA,5420,5116,AHMEDABAD-BAGDOGRA,10536,All
2020,2,AHMEDABAD,BAGDOGRA,4884,3584,AHMEDABAD-BAGDOGRA,8468,All
2020,3,AHMEDABAD,BAGDOGRA,3791,3164,AHMEDABAD-BAGDOGRA,6955,All
2020,9,AHMEDABAD,BAGDOGRA,659,1589,AHMEDABAD-BAGDOGRA,2248,All
2020,10,AHMEDABAD,BAGDOGRA,709,1371,AHMEDABAD-BAGDOGRA,2080,All
2020,11,AHMEDABAD,BAGDOGRA,1628,1932,AHMEDABAD-BAGDOGRA,3560,All
2020,12,AHMEDABAD,BAGDOGRA,1545,1929,AHMEDABAD-BAGDOGRA,3474,All
2021,1,AHMEDABAD,BAGDOGRA,967,1636,AHMEDABAD-BAGDOGRA,2603,All
2021,2,AHMEDABAD,BAGDOGRA,1349,1609,AHMEDABAD-BAGDOGRA,2958,All
2021,3,AHMEDABAD,BAGDOGRA,1539,1558,AHMEDABAD-BAGDOGRA,3097,All
2021,4,AHMEDABAD,BAGDOGRA,620,1404,AHMEDABAD-BAGDOGRA,2024,All
2021,7,AHMEDABAD,BAGDOGRA,481,221,AHMEDABAD-BAGDOGRA,702,All
2021,10,AHMEDABAD,BAGDOGRA,144,43,AHMEDABAD-BAGDOGRA,187,All
2021,11,AHMEDABAD,BAGDOGRA,3390,4233,AHMEDABAD-BAGDOGRA,7623,All
2021,12,AHMEDABAD,BAGDOGRA,2986,3977,AHMEDABAD-BAGDOGRA,6963,All
2022,1,AHMEDABAD,BAGDOGRA,1240,1920,AHMEDABAD-BAGDOGRA,3160,All
2022,2,AHMEDABAD,BAGDOGRA,2977,3298,AHMEDABAD-BAGDOGRA,6275,All
2022,3,AHMEDABAD,BAGDOGRA,4000,3634,AHMEDABAD-BAGDOGRA,7634,All
2022,4,AHMEDABAD,BAGDOGRA,1086,681,AHMEDABAD-BAGDOGRA,1767,All
2022,5,AHMEDABAD,BAGDOGRA,6630,5956,AHMEDABAD-BAGDOGRA,12586,All
2022,6,AHMEDABAD,BAGDOGRA,4896,5775,AHMEDABAD-BAGDOGRA,10671,All
2022,7,AHMEDABAD,BAGDOGRA,1401,1072,AHMEDABAD-BAGDOGRA,2473,All
2022,8,AHMEDABAD,BAGDOGRA,553,247,AHMEDABAD-BAGDOGRA,800,All
2022,9,AHMEDABAD,BAGDOGRA,559,304,AHMEDABAD-BAGDOGRA,863,All
2022,10,AHMEDABAD,BAGDOGRA,5385,3918,AHMEDABAD-BAGDOGRA,9303,All
2022,11,AHMEDABAD,BAGDOGRA,3828,4803,AHMEDABAD-BAGDOGRA,8631,All
2022,12,AHMEDABAD,BAGDOGRA,3935,3971,AHMEDABAD-BAGDOGRA,7906,All
2023,1,AHMEDABAD,BAGDOGRA,2982,2978,AHMEDABAD-BAGDOGRA,5960,All
2023,2,AHMEDABAD,BAGDOGRA,520,188,AHMEDABAD-BAGDOGRA,708,All
2023,3,AHMEDABAD,BAGDOGRA,1348,1120,AHMEDABAD-BAGDOGRA,2468,All
2023,4,AHMEDABAD,BAGDOGRA,5033,3723,AHMEDABAD-BAGDOGRA,8756,All
2023,5,AHMEDABAD,BAGDOGRA,6738,5751,AHMEDABAD-BAGDOGRA,12489,All
2023,6,AHMEDABAD,BAGDOGRA,5072,4699,AHMEDABAD-BAGDOGRA,9771,All
2023,7,AHMEDABAD,BAGDOGRA,209,200,AHMEDABAD-BAGDOGRA,409,All
2023,8,AHMEDABAD,BAGDOGRA,152,142,AHMEDABAD-BAGDOGRA,294,All
2023,9,AHMEDABAD,BAGDOGRA,325,258,AHMEDABAD-BAGDOGRA,583,All
2023,10,AHMEDABAD,BAGDOGRA,749,460,AHMEDABAD-BAGDOGRA,1209,All
2023,11,AHMEDABAD,BAGDOGRA,4544,3338,AHMEDABAD-BAGDOGRA,7882,All
2023,12,AHMEDABAD,BAGDOGRA,4855,4733,AHMEDABAD-BAGDOGRA,9588,All
2024,1,AHMEDABAD,BAGDOGRA,1204,1014,AHMEDABAD-BAGDOGRA,2218,All
2024,2,AHMEDABAD,BAGDOGRA,798,420,AHMEDABAD-BAGDOGRA,1218,All
2024,3,AHMEDABAD,BAGDOGRA,1094,673,AHMEDABAD-BAGDOGRA,1767,All
2024,4,AHMEDABAD,BAGDOGRA,5020,3785,AHMEDABAD-BAGDOGRA,8805,All
2024,6,AHMEDABAD,BAGDOGRA,3409,3616,AHMEDABAD-BAGDOGRA,7025,All
2024,7,AHMEDABAD,BAGDOGRA,509,427,AHMEDABAD-BAGDOGRA,936,All
2024,8,AHMEDABAD,BAGDOGRA,473,279,AHMEDABAD-BAGDOGRA,752,All
2024,9,AHMEDABAD,BAGDOGRA,720,636,AHMEDABAD-BAGDOGRA,1356,All
2024,10,AHMEDABAD,BAGDOGRA,1453,966,AHMEDABAD-BAGDOGRA,2419,All
2024,11,AHMEDABAD,BAGDOGRA,3902,3691,AHMEDABAD-BAGDOGRA,7593,All
2024,12,AHMEDABAD,BAGDOGRA,2661,2712,AHMEDABAD-BAGDOGRA,5373,All
2025,1,AHMEDABAD,BAGDOGRA,2204,2457,AHMEDABAD-BAGDOGRA,4661,All
2025,2,AHMEDABAD,BAGDOGRA,2162,2144,AHMEDABAD-BAGDOGRA,4306,All
2025,3,AHMEDABAD,BAGDOGRA,3663,3236,AHMEDABAD-BAGDOGRA,6899,All
2019,5,AHMEDABAD,BELGAUM,612,431,AHMEDABAD-BELGAUM,1043,All
2019,6,AHMEDABAD,BELGAUM,773,823,AHMEDABAD-BELGAUM,1596,All
2019,7,AHMEDABAD,BELGAUM,690,669,AHMEDABAD-BELGAUM,1359,All
2019,8,AHMEDABAD,BELGAUM,662,709,AHMEDABAD-BELGAUM,1371,All
2019,9,AHMEDABAD,BELGAUM,513,633,AHMEDABAD-BELGAUM,1146,All
2019,10,AHMEDABAD,BELGAUM,716,713,AHMEDABAD-BELGAUM,1429,All
2019,11,AHMEDABAD,BELGAUM,934,1145,AHMEDABAD-BELGAUM,2079,All
2019,12,AHMEDABAD,BELGAUM,1204,1173,AHMEDABAD-BELGAUM,2377,All
2020,1,AHMEDABAD,BELGAUM,1182,1193,AHMEDABAD-BELGAUM,2375,All
2020,2,AHMEDABAD,BELGAUM,1114,1185,AHMEDABAD-BELGAUM,2299,All
2020,3,AHMEDABAD,BELGAUM,803,785,AHMEDABAD-BELGAUM,1588,All
2020,5,AHMEDABAD,BELGAUM,20,9,AHMEDABAD-BELGAUM,29,All
2020,6,AHMEDABAD,BELGAUM,722,625,AHMEDABAD-BELGAUM,1347,All
2020,7,AHMEDABAD,BELGAUM,736,691,AHMEDABAD-BELGAUM,1427,All
2020,8,AHMEDABAD,BELGAUM,763,715,AHMEDABAD-BELGAUM,1478,All
2020,9,AHMEDABAD,BELGAUM,777,731,AHMEDABAD-BELGAUM,1508,All
2020,10,AHMEDABAD,BELGAUM,830,830,AHMEDABAD-BELGAUM,1660,All
2020,11,AHMEDABAD,BELGAUM,744,717,AHMEDABAD-BELGAUM,1461,All
2020,12,AHMEDABAD,BELGAUM,768,724,AHMEDABAD-BELGAUM,1492,All
2021,1,AHMEDABAD,BELGAUM,750,785,AHMEDABAD-BELGAUM,1535,All
2021,2,AHMEDABAD,BELGAUM,698,707,AHMEDABAD-BELGAUM,1405,All
2021,3,AHMEDABAD,BELGAUM,652,687,AHMEDABAD-BELGAUM,1339,All
2021,4,AHMEDABAD,BELGAUM,384,515,AHMEDABAD-BELGAUM,899,All
2021,6,AHMEDABAD,BELGAUM,643,674,AHMEDABAD-BELGAUM,1317,All
2021,7,AHMEDABAD,BELGAUM,779,787,AHMEDABAD-BELGAUM,1566,All
2021,8,AHMEDABAD,BELGAUM,740,776,AHMEDABAD-BELGAUM,1516,All
2021,9,AHMEDABAD,BELGAUM,680,704,AHMEDABAD-BELGAUM,1384,All
2021,10,AHMEDABAD,BELGAUM,748,777,AHMEDABAD-BELGAUM,1525,All
2021,11,AHMEDABAD,BELGAUM,709,714,AHMEDABAD-BELGAUM,1423,All
2021,12,AHMEDABAD,BELGAUM,821,765,AHMEDABAD-BELGAUM,1586,All
2022,1,AHMEDABAD,BELGAUM,651,693,AHMEDABAD-BELGAUM,1344,All
2022,2,AHMEDABAD,BELGAUM,650,682,AHMEDABAD-BELGAUM,1332,All
2022,3,AHMEDABAD,BELGAUM,710,710,AHMEDABAD-BELGAUM,1420,All
2022,4,AHMEDABAD,BELGAUM,735,760,AHMEDABAD-BELGAUM,1495,All
2022,5,AHMEDABAD,BELGAUM,770,712,AHMEDABAD-BELGAUM,1482,All
2022,6,AHMEDABAD,BELGAUM,862,971,AHMEDABAD-BELGAUM,1833,All
2022,7,AHMEDABAD,BELGAUM,836,879,AHMEDABAD-BELGAUM,1715,All
2022,8,AHMEDABAD,BELGAUM,769,843,AHMEDABAD-BELGAUM,1612,All
2022,9,AHMEDABAD,BELGAUM,766,874,AHMEDABAD-BELGAUM,1640,All
2022,10,AHMEDABAD,BELGAUM,826,819,AHMEDABAD-BELGAUM,1645,All
2022,11,AHMEDABAD,BELGAUM,875,903,AHMEDABAD-BELGAUM,1778,All
2022,12,AHMEDABAD,BELGAUM,909,893,AHMEDABAD-BELGAUM,1802,All
2023,1,AHMEDABAD,BELGAUM,888,916,AHMEDABAD-BELGAUM,1804,All
2023,2,AHMEDABAD,BELGAUM,863,835,AHMEDABAD-BELGAUM,1698,All
2023,3,AHMEDABAD,BELGAUM,927,918,AHMEDABAD-BELGAUM,1845,All
2023,4,AHMEDABAD,BELGAUM,1006,1061,AHMEDABAD-BELGAUM,2067,All
2023,5,AHMEDABAD,BELGAUM,1168,1056,AHMEDABAD-BELGAUM,2224,All
2023,6,AHMEDABAD,BELGAUM,1310,1240,AHMEDABAD-BELGAUM,2550,All
2023,7,AHMEDABAD,BELGAUM,1250,1100,AHMEDABAD-BELGAUM,2350,All
2023,8,AHMEDABAD,BELGAUM,1223,1354,AHMEDABAD-BELGAUM,2577,All
2023,9,AHMEDABAD,BELGAUM,980,912,AHMEDABAD-BELGAUM,1892,All
2023,10,AHMEDABAD,BELGAUM,1102,1210,AHMEDABAD-BELGAUM,2312,All
2023,11,AHMEDABAD,BELGAUM,1212,1233,AHMEDABAD-BELGAUM,2445,All
2023,12,AHMEDABAD,BELGAUM,1376,1323,AHMEDABAD-BELGAUM,2699,All
2024,1,AHMEDABAD,BELGAUM,1140,1230,AHMEDABAD-BELGAUM,2370,All
2024,2,AHMEDABAD,BELGAUM,1216,1110,AHMEDABAD-BELGAUM,2326,All
2024,3,AHMEDABAD,BELGAUM,1125,1011,AHMEDABAD-BELGAUM,2136,All
2024,4,AHMEDABAD,BELGAUM,575,584,AHMEDABAD-BELGAUM,1159,All
2024,6,AHMEDABAD,BELGAUM,621,573,AHMEDABAD-BELGAUM,1194,All
2024,7,AHMEDABAD,BELGAUM,497,506,AHMEDABAD-BELGAUM,1003,All
2024,8,AHMEDABAD,BELGAUM,578,593,AHMEDABAD-BELGAUM,1171,All
2024,9,AHMEDABAD,BELGAUM,563,548,AHMEDABAD-BELGAUM,1111,All
2024,10,AHMEDABAD,BELGAUM,491,528,AHMEDABAD-BELGAUM,1019,All
2024,11,AHMEDABAD,BELGAUM,370,393,AHMEDABAD-BELGAUM,763,All
2024,12,AHMEDABAD,BELGAUM,137,133,AHMEDABAD-BELGAUM,270,All
2025,1,AHMEDABAD,BELGAUM,551,544,AHMEDABAD-BELGAUM,1095,All
2025,2,AHMEDABAD,BELGAUM,542,531,AHMEDABAD-BELGAUM,1073,All
2025,3,AHMEDABAD,BELGAUM,511,511,AHMEDABAD-BELGAUM,1022,All
2015,4,AHMEDABAD,BENGALURU,11614,13209,AHMEDABAD-BENGALURU,24823,All
2015,5,AHMEDABAD,BENGALURU,15846,13112,AHMEDABAD-BENGALURU,28958,All
2015,6,AHMEDABAD,BENGALURU,13007,12170,AHMEDABAD-BENGALURU,25177,All
2015,7,AHMEDABAD,BENGALURU,12967,12590,AHMEDABAD-BENGALURU,25557,All
2015,8,AHMEDABAD,BENGALURU,12375,11730,AHMEDABAD-BENGALURU,24105,All
2015,9,AHMEDABAD,BENGALURU,8813,8252,AHMEDABAD-BENGALURU,17065,All
2015,9,AHMEDABAD,BENGALURU,3349,3542,AHMEDABAD-BENGALURU,6891,All
2015,10,AHMEDABAD,BENGALURU,13819,13994,AHMEDABAD-BENGALURU,27813,All
2015,11,AHMEDABAD,BENGALURU,14184,13924,AHMEDABAD-BENGALURU,28108,All
2015,12,AHMEDABAD,BENGALURU,15192,14784,AHMEDABAD-BENGALURU,29976,All
2016,1,AHMEDABAD,BENGALURU,16902,16007,AHMEDABAD-BENGALURU,32909,All
2016,2,AHMEDABAD,BENGALURU,16919,15993,AHMEDABAD-BENGALURU,32912,All
2016,3,AHMEDABAD,BENGALURU,16159,15728,AHMEDABAD-BENGALURU,31887,All
2016,4,AHMEDABAD,BENGALURU,15132,15628,AHMEDABAD-BENGALURU,30760,All
2016,5,AHMEDABAD,BENGALURU,20381,17411,AHMEDABAD-BENGALURU,37792,All
2016,6,AHMEDABAD,BENGALURU,15121,15616,AHMEDABAD-BENGALURU,30737,All
2016,7,AHMEDABAD,BENGALURU,18138,17567,AHMEDABAD-BENGALURU,35705,All
2016,8,AHMEDABAD,BENGALURU,18536,18791,AHMEDABAD-BENGALURU,37327,All
2016,9,AHMEDABAD,BENGALURU,16998,18289,AHMEDABAD-BENGALURU,35287,All
2016,10,AHMEDABAD,BENGALURU,21873,21287,AHMEDABAD-BENGALURU,43160,All
2016,11,AHMEDABAD,BENGALURU,26929,26001,AHMEDABAD-BENGALURU,52930,All
2016,12,AHMEDABAD,BENGALURU,28613,27751,AHMEDABAD-BENGALURU,56364,All
2017,1,AHMEDABAD,BENGALURU,28184,27290,AHMEDABAD-BENGALURU,55474,All
2017,2,AHMEDABAD,BENGALURU,24138,28172,AHMEDABAD-BENGALURU,52310,All
2017,3,AHMEDABAD,BENGALURU,21654,27405,AHMEDABAD-BENGALURU,49059,All
2017,4,AHMEDABAD,BENGALURU,24988,34003,AHMEDABAD-BENGALURU,58991,All
2017,5,AHMEDABAD,BENGALURU,34072,30991,AHMEDABAD-BENGALURU,65063,All
2017,6,AHMEDABAD,BENGALURU,27959,28915,AHMEDABAD-BENGALURU,56874,All
2017,7,AHMEDABAD,BENGALURU,23582,21868,AHMEDABAD-BENGALURU,45450,All
2017,8,AHMEDABAD,BENGALURU,23927,24540,AHMEDABAD-BENGALURU,48467,All
2017,9,AHMEDABAD,BENGALURU,23688,26809,AHMEDABAD-BENGALURU,50497,All
2017,10,AHMEDABAD,BENGALURU,38957,36953,AHMEDABAD-BENGALURU,75910,All
2017,11,AHMEDABAD,BENGALURU,39184,39325,AHMEDABAD-BENGALURU,78509,All
2017,12,AHMEDABAD,BENGALURU,47207,45707,AHMEDABAD-BENGALURU,92914,All
2018,1,AHMEDABAD,BENGALURU,46738,45361,AHMEDABAD-BENGALURU,92099,All
2018,2,AHMEDABAD,BENGALURU,42348,42407,AHMEDABAD-BENGALURU,84755,All
2018,3,AHMEDABAD,BENGALURU,42360,43207,AHMEDABAD-BENGALURU,85567,All
2018,4,AHMEDABAD,BENGALURU,47356,51207,AHMEDABAD-BENGALURU,98563,All
2018,5,AHMEDABAD,BENGALURU,59614,49606,AHMEDABAD-BENGALURU,109220,All
2018,6,AHMEDABAD,BENGALURU,48900,48941,AHMEDABAD-BENGALURU,97841,All
2018,7,AHMEDABAD,BENGALURU,52531,50245,AHMEDABAD-BENGALURU,102776,All
2018,8,AHMEDABAD,BENGALURU,50232,48869,AHMEDABAD-BENGALURU,99101,All
2018,9,AHMEDABAD,BENGALURU,46812,47041,AHMEDABAD-BENGALURU,93853,All
2018,10,AHMEDABAD,BENGALURU,48371,49109,AHMEDABAD-BENGALURU,97480,All
2018,11,AHMEDABAD,BENGALURU,50244,50578,AHMEDABAD-BENGALURU,100822,All
2018,12,AHMEDABAD,BENGALURU,51309,50972,AHMEDABAD-BENGALURU,102281,All
2019,1,AHMEDABAD,BENGALURU,50324,49647,AHMEDABAD-BENGALURU,99971,All
2019,2,AHMEDABAD,BENGALURU,43413,40975,AHMEDABAD-BENGALURU,84388,All
2019,3,AHMEDABAD,BENGALURU,47745,46875,AHMEDABAD-BENGALURU,94620,All
2019,4,AHMEDABAD,BENGALURU,39062,46183,AHMEDABAD-BENGALURU,85245,All
2019,5,AHMEDABAD,BENGALURU,44289,42938,AHMEDABAD-BENGALURU,87227,All
2019,6,AHMEDABAD,BENGALURU,38217,40754,AHMEDABAD-BENGALURU,78971,All
2019,7,AHMEDABAD,BENGALURU,40042,41083,AHMEDABAD-BENGALURU,81125,All
2019,8,AHMEDABAD,BENGALURU,39359,40885,AHMEDABAD-BENGALURU,80244,All
2019,9,AHMEDABAD,BENGALURU,33806,36290,AHMEDABAD-BENGALURU,70096,All
2019,10,AHMEDABAD,BENGALURU,34376,34431,AHMEDABAD-BENGALURU,68807,All
2019,11,AHMEDABAD,BENGALURU,36384,36299,AHMEDABAD-BENGALURU,72683,All
2019,12,AHMEDABAD,BENGALURU,34959,32550,AHMEDABAD-BENGALURU,67509,All
2020,1,AHMEDABAD,BENGALURU,40756,39357,AHMEDABAD-BENGALURU,80113,All
2020,2,AHMEDABAD,BENGALURU,38284,36667,AHMEDABAD-BENGALURU,74951,All
2020,3,AHMEDABAD,BENGALURU,21411,25202,AHMEDABAD-BENGALURU,46613,All
2020,5,AHMEDABAD,BENGALURU,835,1089,AHMEDABAD-BENGALURU,1924,All
2020,6,AHMEDABAD,BENGALURU,7037,7121,AHMEDABAD-BENGALURU,14158,All
2020,7,AHMEDABAD,BENGALURU,8121,9468,AHMEDABAD-BENGALURU,17589,All
2020,8,AHMEDABAD,BENGALURU,18802,14916,AHMEDABAD-BENGALURU,33718,All
2020,9,AHMEDABAD,BENGALURU,20896,14420,AHMEDABAD-BENGALURU,35316,All
2020,10,AHMEDABAD,BENGALURU,20627,19771,AHMEDABAD-BENGALURU,40398,All
2020,11,AHMEDABAD,BENGALURU,20909,23483,AHMEDABAD-BENGALURU,44392,All
2020,12,AHMEDABAD,BENGALURU,26941,21798,AHMEDABAD-BENGALURU,48739,All
2021,1,AHMEDABAD,BENGALURU,22268,19094,AHMEDABAD-BENGALURU,41362,All
2021,2,AHMEDABAD,BENGALURU,23778,23974,AHMEDABAD-BENGALURU,47752,All
2021,3,AHMEDABAD,BENGALURU,23499,23643,AHMEDABAD-BENGALURU,47142,All
2021,4,AHMEDABAD,BENGALURU,14755,27887,AHMEDABAD-BENGALURU,42642,All
2021,6,AHMEDABAD,BENGALURU,17404,12926,AHMEDABAD-BENGALURU,30330,All
2021,7,AHMEDABAD,BENGALURU,19117,17209,AHMEDABAD-BENGALURU,36326,All
2021,8,AHMEDABAD,BENGALURU,22432,20920,AHMEDABAD-BENGALURU,43352,All
2021,9,AHMEDABAD,BENGALURU,23493,22955,AHMEDABAD-BENGALURU,46448,All
2021,10,AHMEDABAD,BENGALURU,26833,26502,AHMEDABAD-BENGALURU,53335,All
2021,11,AHMEDABAD,BENGALURU,35792,34523,AHMEDABAD-BENGALURU,70315,All
2021,12,AHMEDABAD,BENGALURU,36378,32887,AHMEDABAD-BENGALURU,69265,All
2022,1,AHMEDABAD,BENGALURU,22479,22524,AHMEDABAD-BENGALURU,45003,All
2022,2,AHMEDABAD,BENGALURU,26013,25130,AHMEDABAD-BENGALURU,51143,All
2022,3,AHMEDABAD,BENGALURU,31073,28381,AHMEDABAD-BENGALURU,59454,All
2022,4,AHMEDABAD,BENGALURU,29523,29459,AHMEDABAD-BENGALURU,58982,All
2022,5,AHMEDABAD,BENGALURU,38170,33762,AHMEDABAD-BENGALURU,71932,All
2022,6,AHMEDABAD,BENGALURU,27615,28161,AHMEDABAD-BENGALURU,55776,All
2022,7,AHMEDABAD,BENGALURU,24961,25097,AHMEDABAD-BENGALURU,50058,All
2022,8,AHMEDABAD,BENGALURU,29913,31285,AHMEDABAD-BENGALURU,61198,All
2022,9,AHMEDABAD,BENGALURU,37391,40238,AHMEDABAD-BENGALURU,77629,All
2022,10,AHMEDABAD,BENGALURU,46782,44599,AHMEDABAD-BENGALURU,91381,All
2022,11,AHMEDABAD,BENGALURU,45022,45380,AHMEDABAD-BENGALURU,90402,All
2022,12,AHMEDABAD,BENGALURU,46809,45072,AHMEDABAD-BENGALURU,91881,All
2023,1,AHMEDABAD,BENGALURU,47514,47479,AHMEDABAD-BENGALURU,94993,All
2023,2,AHMEDABAD,BENGALURU,47099,46157,AHMEDABAD-BENGALURU,93256,All
2023,3,AHMEDABAD,BENGALURU,47469,47218,AHMEDABAD-BENGALURU,94687,All
2023,4,AHMEDABAD,BENGALURU,44849,47359,AHMEDABAD-BENGALURU,92208,All
2023,5,AHMEDABAD,BENGALURU,47769,45562,AHMEDABAD-BENGALURU,93331,All
2023,6,AHMEDABAD,BENGALURU,44269,44515,AHMEDABAD-BENGALURU,88784,All
2023,7,AHMEDABAD,BENGALURU,38961,35663,AHMEDABAD-BENGALURU,74624,All
2023,8,AHMEDABAD,BENGALURU,32242,32781,AHMEDABAD-BENGALURU,65023,All
2023,9,AHMEDABAD,BENGALURU,29162,29277,AHMEDABAD-BENGALURU,58439,All
2023,10,AHMEDABAD,BENGALURU,32249,34170,AHMEDABAD-BENGALURU,66419,All
2023,11,AHMEDABAD,BENGALURU,33353,33338,AHMEDABAD-BENGALURU,66691,All
2023,12,AHMEDABAD,BENGALURU,33132,32193,AHMEDABAD-BENGALURU,65325,All
2024,1,AHMEDABAD,BENGALURU,34025,33230,AHMEDABAD-BENGALURU,67255,All
2024,2,AHMEDABAD,BENGALURU,30321,29829,AHMEDABAD-BENGALURU,60150,All
2024,3,AHMEDABAD,BENGALURU,33622,35150,AHMEDABAD-BENGALURU,68772,All
2024,4,AHMEDABAD,BENGALURU,36287,41606,AHMEDABAD-BENGALURU,77893,All
2024,6,AHMEDABAD,BENGALURU,33554,33685,AHMEDABAD-BENGALURU,67239,All
2024,7,AHMEDABAD,BENGALURU,35490,36244,AHMEDABAD-BENGALURU,71734,All
2024,8,AHMEDABAD,BENGALURU,37083,40713,AHMEDABAD-BENGALURU,77796,All
2024,9,AHMEDABAD,BENGALURU,36518,39939,AHMEDABAD-BENGALURU,76457,All
2024,10,AHMEDABAD,BENGALURU,39880,43183,AHMEDABAD-BENGALURU,83063,All
2024,11,AHMEDABAD,BENGALURU,45675,45347,AHMEDABAD-BENGALURU,91022,All
2024,12,AHMEDABAD,BENGALURU,47073,45163,AHMEDABAD-BENGALURU,92236,All
2025,1,AHMEDABAD,BENGALURU,48818,46818,AHMEDABAD-BENGALURU,95636,All
2025,2,AHMEDABAD,BENGALURU,41223,41582,AHMEDABAD-BENGALURU,82805,All
2025,3,AHMEDABAD,BENGALURU,43663,42078,AHMEDABAD-BENGALURU,85741,All
2018,4,AHMEDABAD,BHAVNAGAR,28,61,AHMEDABAD-BHAVNAGAR,89,All
2018,5,AHMEDABAD,BHAVNAGAR,56,105,AHMEDABAD-BHAVNAGAR,161,All
2018,8,AHMEDABAD,BHAVNAGAR,41,82,AHMEDABAD-BHAVNAGAR,123,All
2018,9,AHMEDABAD,BHAVNAGAR,37,25,AHMEDABAD-BHAVNAGAR,62,All
2018,10,AHMEDABAD,BHAVNAGAR,6,15,AHMEDABAD-BHAVNAGAR,21,All
2020,1,AHMEDABAD,BHAVNAGAR,5,10,AHMEDABAD-BHAVNAGAR,15,All
2015,4,AHMEDABAD,BHOPAL,208,128,AHMEDABAD-BHOPAL,336,All
2015,5,AHMEDABAD,BHOPAL,1020,720,AHMEDABAD-BHOPAL,1740,All
2015,6,AHMEDABAD,BHOPAL,875,712,AHMEDABAD-BHOPAL,1587,All
2015,7,AHMEDABAD,BHOPAL,916,572,AHMEDABAD-BHOPAL,1488,All
2015,8,AHMEDABAD,BHOPAL,859,568,AHMEDABAD-BHOPAL,1427,All
2015,9,AHMEDABAD,BHOPAL,762,518,AHMEDABAD-BHOPAL,1280,All
2015,10,AHMEDABAD,BHOPAL,696,400,AHMEDABAD-BHOPAL,1096,All
2015,11,AHMEDABAD,BHOPAL,842,588,AHMEDABAD-BHOPAL,1430,All
2015,12,AHMEDABAD,BHOPAL,894,697,AHMEDABAD-BHOPAL,1591,All
2016,1,AHMEDABAD,BHOPAL,724,344,AHMEDABAD-BHOPAL,1068,All
2016,2,AHMEDABAD,BHOPAL,817,424,AHMEDABAD-BHOPAL,1241,All
2016,3,AHMEDABAD,BHOPAL,631,265,AHMEDABAD-BHOPAL,896,All
2019,1,AHMEDABAD,BHOPAL,1380,1343,AHMEDABAD-BHOPAL,2723,All
2019,2,AHMEDABAD,BHOPAL,1467,1400,AHMEDABAD-BHOPAL,2867,All
2019,3,AHMEDABAD,BHOPAL,1196,1175,AHMEDABAD-BHOPAL,2371,All
2019,9,AHMEDABAD,BHOPAL,392,383,AHMEDABAD-BHOPAL,775,All
2019,10,AHMEDABAD,BHOPAL,1920,1825,AHMEDABAD-BHOPAL,3745,All
2019,12,AHMEDABAD,BHOPAL,1171,1166,AHMEDABAD-BHOPAL,2337,All
2020,1,AHMEDABAD,BHOPAL,2129,1968,AHMEDABAD-BHOPAL,4097,All
2020,2,AHMEDABAD,BHOPAL,2150,1988,AHMEDABAD-BHOPAL,4138,All
2020,3,AHMEDABAD,BHOPAL,1381,1168,AHMEDABAD-BHOPAL,2549,All
2020,7,AHMEDABAD,BHOPAL,2,0,AHMEDABAD-BHOPAL,2,All
2021,2,AHMEDABAD,BHOPAL,1328,1333,AHMEDABAD-BHOPAL,2661,All
2021,3,AHMEDABAD,BHOPAL,1309,1188,AHMEDABAD-BHOPAL,2497,All
2021,4,AHMEDABAD,BHOPAL,764,612,AHMEDABAD-BHOPAL,1376,All
2021,9,AHMEDABAD,BHOPAL,44,0,AHMEDABAD-BHOPAL,44,All
2021,10,AHMEDABAD,BHOPAL,696,583,AHMEDABAD-BHOPAL,1279,All
2021,11,AHMEDABAD,BHOPAL,1610,1917,AHMEDABAD-BHOPAL,3527,All
2021,12,AHMEDABAD,BHOPAL,1737,1956,AHMEDABAD-BHOPAL,3693,All
2022,1,AHMEDABAD,BHOPAL,1147,1321,AHMEDABAD-BHOPAL,2468,All
2022,2,AHMEDABAD,BHOPAL,1769,2004,AHMEDABAD-BHOPAL,3773,All
2022,3,AHMEDABAD,BHOPAL,1964,2102,AHMEDABAD-BHOPAL,4066,All
2022,4,AHMEDABAD,BHOPAL,1957,1838,AHMEDABAD-BHOPAL,3795,All
2022,5,AHMEDABAD,BHOPAL,2054,2034,AHMEDABAD-BHOPAL,4088,All
2022,6,AHMEDABAD,BHOPAL,1263,1578,AHMEDABAD-BHOPAL,2841,All
2022,7,AHMEDABAD,BHOPAL,1486,1741,AHMEDABAD-BHOPAL,3227,All
2022,8,AHMEDABAD,BHOPAL,1614,1982,AHMEDABAD-BHOPAL,3596,All
2022,9,AHMEDABAD,BHOPAL,1650,1882,AHMEDABAD-BHOPAL,3532,All
2022,10,AHMEDABAD,BHOPAL,2018,1800,AHMEDABAD-BHOPAL,3818,All
2022,11,AHMEDABAD,BHOPAL,1778,1996,AHMEDABAD-BHOPAL,3774,All
2022,12,AHMEDABAD,BHOPAL,1814,1996,AHMEDABAD-BHOPAL,3810,All
2023,1,AHMEDABAD,BHOPAL,1822,1926,AHMEDABAD-BHOPAL,3748,All
2023,2,AHMEDABAD,BHOPAL,1761,1827,AHMEDABAD-BHOPAL,3588,All
2023,3,AHMEDABAD,BHOPAL,1816,1824,AHMEDABAD-BHOPAL,3640,All
2023,4,AHMEDABAD,BHOPAL,1560,1739,AHMEDABAD-BHOPAL,3299,All
2023,5,AHMEDABAD,BHOPAL,1718,1729,AHMEDABAD-BHOPAL,3447,All
2023,6,AHMEDABAD,BHOPAL,1750,2058,AHMEDABAD-BHOPAL,3808,All
2023,7,AHMEDABAD,BHOPAL,1877,1949,AHMEDABAD-BHOPAL,3826,All
2023,8,AHMEDABAD,BHOPAL,2024,2036,AHMEDABAD-BHOPAL,4060,All
2023,9,AHMEDABAD,BHOPAL,1761,2015,AHMEDABAD-BHOPAL,3776,All
2023,10,AHMEDABAD,BHOPAL,1905,1862,AHMEDABAD-BHOPAL,3767,All
2023,11,AHMEDABAD,BHOPAL,2051,1989,AHMEDABAD-BHOPAL,4040,All
2023,12,AHMEDABAD,BHOPAL,2213,2311,AHMEDABAD-BHOPAL,4524,All
2024,1,AHMEDABAD,BHOPAL,2267,2280,AHMEDABAD-BHOPAL,4547,All
2024,2,AHMEDABAD,BHOPAL,2074,2126,AHMEDABAD-BHOPAL,4200,All
2024,3,AHMEDABAD,BHOPAL,2723,2855,AHMEDABAD-BHOPAL,5578,All
2024,4,AHMEDABAD,BHOPAL,4133,3826,AHMEDABAD-BHOPAL,7959,All
2024,6,AHMEDABAD,BHOPAL,3759,3956,AHMEDABAD-BHOPAL,7715,All
2024,7,AHMEDABAD,BHOPAL,3558,3885,AHMEDABAD-BHOPAL,7443,All
2024,8,AHMEDABAD,BHOPAL,3850,4180,AHMEDABAD-BHOPAL,8030,All
2024,9,AHMEDABAD,BHOPAL,3812,3860,AHMEDABAD-BHOPAL,7672,All
2024,10,AHMEDABAD,BHOPAL,3964,3397,AHMEDABAD-BHOPAL,7361,All
2024,11,AHMEDABAD,BHOPAL,3832,4371,AHMEDABAD-BHOPAL,8203,All
2024,12,AHMEDABAD,BHOPAL,4146,4515,AHMEDABAD-BHOPAL,8661,All
2025,1,AHMEDABAD,BHOPAL,4251,4182,AHMEDABAD-BHOPAL,8433,All
2025,2,AHMEDABAD,BHOPAL,4041,4016,AHMEDABAD-BHOPAL,8057,All
2025,3,AHMEDABAD,BHOPAL,4069,3920,AHMEDABAD-BHOPAL,7989,All
2017,6,AHMEDABAD,BHUBANESWAR,38,0,AHMEDABAD-BHUBANESWAR,38,All
2017,7,AHMEDABAD,BHUBANESWAR,183,0,AHMEDABAD-BHUBANESWAR,183,All
2017,8,AHMEDABAD,BHUBANESWAR,146,0,AHMEDABAD-BHUBANESWAR,146,All
2017,9,AHMEDABAD,BHUBANESWAR,110,0,AHMEDABAD-BHUBANESWAR,110,All
2017,10,AHMEDABAD,BHUBANESWAR,236,0,AHMEDABAD-BHUBANESWAR,236,All
2017,11,AHMEDABAD,BHUBANESWAR,165,0,AHMEDABAD-BHUBANESWAR,165,All
2017,12,AHMEDABAD,BHUBANESWAR,267,0,AHMEDABAD-BHUBANESWAR,267,All
2018,1,AHMEDABAD,BHUBANESWAR,727,0,AHMEDABAD-BHUBANESWAR,727,All
2018,2,AHMEDABAD,BHUBANESWAR,485,0,AHMEDABAD-BHUBANESWAR,485,All
2018,3,AHMEDABAD,BHUBANESWAR,742,0,AHMEDABAD-BHUBANESWAR,742,All
2018,4,AHMEDABAD,BHUBANESWAR,427,0,AHMEDABAD-BHUBANESWAR,427,All
2018,5,AHMEDABAD,BHUBANESWAR,204,0,AHMEDABAD-BHUBANESWAR,204,All
2018,6,AHMEDABAD,BHUBANESWAR,382,0,AHMEDABAD-BHUBANESWAR,382,All
2018,7,AHMEDABAD,BHUBANESWAR,160,0,AHMEDABAD-BHUBANESWAR,160,All
2018,8,AHMEDABAD,BHUBANESWAR,369,0,AHMEDABAD-BHUBANESWAR,369,All
2018,9,AHMEDABAD,BHUBANESWAR,955,937,AHMEDABAD-BHUBANESWAR,1892,All
2018,10,AHMEDABAD,BHUBANESWAR,2064,1366,AHMEDABAD-BHUBANESWAR,3430,All
2018,11,AHMEDABAD,BHUBANESWAR,3838,2816,AHMEDABAD-BHUBANESWAR,6654,All
2018,12,AHMEDABAD,BHUBANESWAR,1052,53,AHMEDABAD-BHUBANESWAR,1105,All
2019,1,AHMEDABAD,BHUBANESWAR,743,0,AHMEDABAD-BHUBANESWAR,743,All
2019,2,AHMEDABAD,BHUBANESWAR,415,0,AHMEDABAD-BHUBANESWAR,415,All
2019,3,AHMEDABAD,BHUBANESWAR,1415,0,AHMEDABAD-BHUBANESWAR,1415,All
2019,4,AHMEDABAD,BHUBANESWAR,1078,0,AHMEDABAD-BHUBANESWAR,1078,All
2019,5,AHMEDABAD,BHUBANESWAR,918,0,AHMEDABAD-BHUBANESWAR,918,All
2019,6,AHMEDABAD,BHUBANESWAR,1203,416,AHMEDABAD-BHUBANESWAR,1619,All
2019,7,AHMEDABAD,BHUBANESWAR,128,20,AHMEDABAD-BHUBANESWAR,148,All
2019,9,AHMEDABAD,BHUBANESWAR,207,194,AHMEDABAD-BHUBANESWAR,401,All
2019,10,AHMEDABAD,BHUBANESWAR,1513,727,AHMEDABAD-BHUBANESWAR,2240,All
2019,11,AHMEDABAD,BHUBANESWAR,4745,4537,AHMEDABAD-BHUBANESWAR,9282,All
2019,12,AHMEDABAD,BHUBANESWAR,4558,4490,AHMEDABAD-BHUBANESWAR,9048,All
2020,1,AHMEDABAD,BHUBANESWAR,4954,4683,AHMEDABAD-BHUBANESWAR,9637,All
2020,2,AHMEDABAD,BHUBANESWAR,4639,4148,AHMEDABAD-BHUBANESWAR,8787,All
2020,3,AHMEDABAD,BHUBANESWAR,2959,2457,AHMEDABAD-BHUBANESWAR,5416,All
2020,8,AHMEDABAD,BHUBANESWAR,339,849,AHMEDABAD-BHUBANESWAR,1188,All
2020,9,AHMEDABAD,BHUBANESWAR,1807,4244,AHMEDABAD-BHUBANESWAR,6051,All
2020,10,AHMEDABAD,BHUBANESWAR,2368,4249,AHMEDABAD-BHUBANESWAR,6617,All
2020,11,AHMEDABAD,BHUBANESWAR,3745,3976,AHMEDABAD-BHUBANESWAR,7721,All
2020,12,AHMEDABAD,BHUBANESWAR,4055,4616,AHMEDABAD-BHUBANESWAR,8671,All
2021,1,AHMEDABAD,BHUBANESWAR,3319,3819,AHMEDABAD-BHUBANESWAR,7138,All
2021,2,AHMEDABAD,BHUBANESWAR,4135,3924,AHMEDABAD-BHUBANESWAR,8059,All
2021,3,AHMEDABAD,BHUBANESWAR,3923,3196,AHMEDABAD-BHUBANESWAR,7119,All
2021,4,AHMEDABAD,BHUBANESWAR,1871,1530,AHMEDABAD-BHUBANESWAR,3401,All
2021,6,AHMEDABAD,BHUBANESWAR,373,456,AHMEDABAD-BHUBANESWAR,829,All
2021,7,AHMEDABAD,BHUBANESWAR,1349,1391,AHMEDABAD-BHUBANESWAR,2740,All
2021,8,AHMEDABAD,BHUBANESWAR,2378,2486,AHMEDABAD-BHUBANESWAR,4864,All
2021,9,AHMEDABAD,BHUBANESWAR,2623,2945,AHMEDABAD-BHUBANESWAR,5568,All
2021,10,AHMEDABAD,BHUBANESWAR,3516,3221,AHMEDABAD-BHUBANESWAR,6737,All
2021,11,AHMEDABAD,BHUBANESWAR,3842,4135,AHMEDABAD-BHUBANESWAR,7977,All
2021,12,AHMEDABAD,BHUBANESWAR,3744,4249,AHMEDABAD-BHUBANESWAR,7993,All
2022,1,AHMEDABAD,BHUBANESWAR,113,0,AHMEDABAD-BHUBANESWAR,113,All
2022,3,AHMEDABAD,BHUBANESWAR,1811,0,AHMEDABAD-BHUBANESWAR,1811,All
2022,6,AHMEDABAD,BHUBANESWAR,3461,3422,AHMEDABAD-BHUBANESWAR,6883,All
2022,7,AHMEDABAD,BHUBANESWAR,1297,1420,AHMEDABAD-BHUBANESWAR,2717,All
2022,9,AHMEDABAD,BHUBANESWAR,1366,1491,AHMEDABAD-BHUBANESWAR,2857,All
2022,10,AHMEDABAD,BHUBANESWAR,3852,3472,AHMEDABAD-BHUBANESWAR,7324,All
2022,11,AHMEDABAD,BHUBANESWAR,2317,2436,AHMEDABAD-BHUBANESWAR,4753,All
2022,12,AHMEDABAD,BHUBANESWAR,2649,2513,AHMEDABAD-BHUBANESWAR,5162,All
2023,1,AHMEDABAD,BHUBANESWAR,3854,3625,AHMEDABAD-BHUBANESWAR,7479,All
2023,2,AHMEDABAD,BHUBANESWAR,4374,4169,AHMEDABAD-BHUBANESWAR,8543,All
2023,3,AHMEDABAD,BHUBANESWAR,4337,4072,AHMEDABAD-BHUBANESWAR,8409,All
2023,4,AHMEDABAD,BHUBANESWAR,2635,2483,AHMEDABAD-BHUBANESWAR,5118,All
2023,5,AHMEDABAD,BHUBANESWAR,2966,2853,AHMEDABAD-BHUBANESWAR,5819,All
2023,6,AHMEDABAD,BHUBANESWAR,2830,2578,AHMEDABAD-BHUBANESWAR,5408,All
2023,7,AHMEDABAD,BHUBANESWAR,2661,2668,AHMEDABAD-BHUBANESWAR,5329,All
2023,8,AHMEDABAD,BHUBANESWAR,2537,2541,AHMEDABAD-BHUBANESWAR,5078,All
2023,9,AHMEDABAD,BHUBANESWAR,2860,2707,AHMEDABAD-BHUBANESWAR,5567,All
2023,10,AHMEDABAD,BHUBANESWAR,2902,2773,AHMEDABAD-BHUBANESWAR,5675,All
2023,11,AHMEDABAD,BHUBANESWAR,2173,2196,AHMEDABAD-BHUBANESWAR,4369,All
2023,12,AHMEDABAD,BHUBANESWAR,2273,2290,AHMEDABAD-BHUBANESWAR,4563,All
2024,1,AHMEDABAD,BHUBANESWAR,2427,2394,AHMEDABAD-BHUBANESWAR,4821,All
2024,2,AHMEDABAD,BHUBANESWAR,2013,1997,AHMEDABAD-BHUBANESWAR,4010,All
2024,3,AHMEDABAD,BHUBANESWAR,2212,2140,AHMEDABAD-BHUBANESWAR,4352,All
2024,4,AHMEDABAD,BHUBANESWAR,2221,2187,AHMEDABAD-BHUBANESWAR,4408,All
2024,6,AHMEDABAD,BHUBANESWAR,2024,1976,AHMEDABAD-BHUBANESWAR,4000,All
2024,7,AHMEDABAD,BHUBANESWAR,2225,2269,AHMEDABAD-BHUBANESWAR,4494,All
2024,8,AHMEDABAD,BHUBANESWAR,2046,2021,AHMEDABAD-BHUBANESWAR,4067,All
2024,9,AHMEDABAD,BHUBANESWAR,3587,3406,AHMEDABAD-BHUBANESWAR,6993,All
2024,10,AHMEDABAD,BHUBANESWAR,5105,4594,AHMEDABAD-BHUBANESWAR,9699,All
2024,11,AHMEDABAD,BHUBANESWAR,5233,5343,AHMEDABAD-BHUBANESWAR,10576,All
2024,12,AHMEDABAD,BHUBANESWAR,5737,5691,AHMEDABAD-BHUBANESWAR,11428,All
2025,1,AHMEDABAD,BHUBANESWAR,5963,5868,AHMEDABAD-BHUBANESWAR,11831,All
2025,2,AHMEDABAD,BHUBANESWAR,5040,5015,AHMEDABAD-BHUBANESWAR,10055,All
2025,3,AHMEDABAD,BHUBANESWAR,6226,6047,AHMEDABAD-BHUBANESWAR,12273,All
2022,6,AHMEDABAD,BHUJ,643,643,AHMEDABAD-BHUJ,1286,All
2022,7,AHMEDABAD,BHUJ,615,553,AHMEDABAD-BHUJ,1168,All
2022,8,AHMEDABAD,BHUJ,568,466,AHMEDABAD-BHUJ,1034,All
2022,9,AHMEDABAD,BHUJ,546,561,AHMEDABAD-BHUJ,1107,All
2022,10,AHMEDABAD,BHUJ,541,549,AHMEDABAD-BHUJ,1090,All
2022,11,AHMEDABAD,BHUJ,737,735,AHMEDABAD-BHUJ,1472,All
2022,12,AHMEDABAD,BHUJ,1000,1033,AHMEDABAD-BHUJ,2033,All
2023,1,AHMEDABAD,BHUJ,886,981,AHMEDABAD-BHUJ,1867,All
2023,2,AHMEDABAD,BHUJ,891,847,AHMEDABAD-BHUJ,1738,All
2023,3,AHMEDABAD,BHUJ,889,867,AHMEDABAD-BHUJ,1756,All
2023,4,AHMEDABAD,BHUJ,1072,979,AHMEDABAD-BHUJ,2051,All
2023,5,AHMEDABAD,BHUJ,870,910,AHMEDABAD-BHUJ,1780,All
2023,6,AHMEDABAD,BHUJ,658,557,AHMEDABAD-BHUJ,1215,All
2023,7,AHMEDABAD,BHUJ,850,874,AHMEDABAD-BHUJ,1724,All
2023,8,AHMEDABAD,BHUJ,1230,1120,AHMEDABAD-BHUJ,2350,All
2023,9,AHMEDABAD,BHUJ,771,701,AHMEDABAD-BHUJ,1472,All
2023,10,AHMEDABAD,BHUJ,959,798,AHMEDABAD-BHUJ,1757,All
2023,11,AHMEDABAD,BHUJ,1128,1055,AHMEDABAD-BHUJ,2183,All
2023,12,AHMEDABAD,BHUJ,1287,1325,AHMEDABAD-BHUJ,2612,All
2024,1,AHMEDABAD,BHUJ,1331,1398,AHMEDABAD-BHUJ,2729,All
2024,2,AHMEDABAD,BHUJ,1268,1327,AHMEDABAD-BHUJ,2595,All
2024,3,AHMEDABAD,BHUJ,1004,964,AHMEDABAD-BHUJ,1968,All
2024,4,AHMEDABAD,BHUJ,952,883,AHMEDABAD-BHUJ,1835,All
2024,6,AHMEDABAD,BHUJ,903,848,AHMEDABAD-BHUJ,1751,All
2024,7,AHMEDABAD,BHUJ,896,811,AHMEDABAD-BHUJ,1707,All
2024,8,AHMEDABAD,BHUJ,1132,967,AHMEDABAD-BHUJ,2099,All
2024,9,AHMEDABAD,BHUJ,1124,971,AHMEDABAD-BHUJ,2095,All
2024,10,AHMEDABAD,BHUJ,1164,1254,AHMEDABAD-BHUJ,2418,All
2024,11,AHMEDABAD,BHUJ,1564,1237,AHMEDABAD-BHUJ,2801,All
2024,12,AHMEDABAD,BHUJ,1850,1718,AHMEDABAD-BHUJ,3568,All
2025,1,AHMEDABAD,BHUJ,1797,1709,AHMEDABAD-BHUJ,3506,All
2025,2,AHMEDABAD,BHUJ,1633,1557,AHMEDABAD-BHUJ,3190,All
2025,3,AHMEDABAD,BHUJ,1336,1247,AHMEDABAD-BHUJ,2583,All
2018,6,AHMEDABAD,CHANDIGARH,4044,3887,AHMEDABAD-CHANDIGARH,7931,All
2018,7,AHMEDABAD,CHANDIGARH,3808,4027,AHMEDABAD-CHANDIGARH,7835,All
2018,8,AHMEDABAD,CHANDIGARH,4107,3991,AHMEDABAD-CHANDIGARH,8098,All
2018,9,AHMEDABAD,CHANDIGARH,4250,4309,AHMEDABAD-CHANDIGARH,8559,All
2018,10,AHMEDABAD,CHANDIGARH,4685,4379,AHMEDABAD-CHANDIGARH,9064,All
2018,11,AHMEDABAD,CHANDIGARH,4479,4124,AHMEDABAD-CHANDIGARH,8603,All
2018,12,AHMEDABAD,CHANDIGARH,4282,4072,AHMEDABAD-CHANDIGARH,8354,All
2019,1,AHMEDABAD,CHANDIGARH,4672,4153,AHMEDABAD-CHANDIGARH,8825,All
2019,2,AHMEDABAD,CHANDIGARH,5823,5610,AHMEDABAD-CHANDIGARH,11433,All
2019,3,AHMEDABAD,CHANDIGARH,6208,6260,AHMEDABAD-CHANDIGARH,12468,All
2019,4,AHMEDABAD,CHANDIGARH,4567,4443,AHMEDABAD-CHANDIGARH,9010,All
2019,5,AHMEDABAD,CHANDIGARH,4698,4600,AHMEDABAD-CHANDIGARH,9298,All
2019,6,AHMEDABAD,CHANDIGARH,4155,4278,AHMEDABAD-CHANDIGARH,8433,All
2019,7,AHMEDABAD,CHANDIGARH,4450,4273,AHMEDABAD-CHANDIGARH,8723,All
2019,8,AHMEDABAD,CHANDIGARH,4186,4520,AHMEDABAD-CHANDIGARH,8706,All
2019,9,AHMEDABAD,CHANDIGARH,3836,3879,AHMEDABAD-CHANDIGARH,7715,All
2019,10,AHMEDABAD,CHANDIGARH,7027,5460,AHMEDABAD-CHANDIGARH,12487,All
2019,11,AHMEDABAD,CHANDIGARH,8650,12646,AHMEDABAD-CHANDIGARH,21296,All
2019,12,AHMEDABAD,CHANDIGARH,10223,11657,AHMEDABAD-CHANDIGARH,21880,All
2020,1,AHMEDABAD,CHANDIGARH,10620,11746,AHMEDABAD-CHANDIGARH,22366,All
2020,2,AHMEDABAD,CHANDIGARH,12041,11165,AHMEDABAD-CHANDIGARH,23206,All
2020,3,AHMEDABAD,CHANDIGARH,7966,7939,AHMEDABAD-CHANDIGARH,15905,All
2020,6,AHMEDABAD,CHANDIGARH,1668,1456,AHMEDABAD-CHANDIGARH,3124,All
2020,7,AHMEDABAD,CHANDIGARH,2168,1696,AHMEDABAD-CHANDIGARH,3864,All
2020,8,AHMEDABAD,CHANDIGARH,1922,1823,AHMEDABAD-CHANDIGARH,3745,All
2020,9,AHMEDABAD,CHANDIGARH,2176,2026,AHMEDABAD-CHANDIGARH,4202,All
2020,10,AHMEDABAD,CHANDIGARH,4842,3674,AHMEDABAD-CHANDIGARH,8516,All
2020,11,AHMEDABAD,CHANDIGARH,6894,6849,AHMEDABAD-CHANDIGARH,13743,All
2020,12,AHMEDABAD,CHANDIGARH,6136,6238,AHMEDABAD-CHANDIGARH,12374,All
2021,1,AHMEDABAD,CHANDIGARH,8655,8722,AHMEDABAD-CHANDIGARH,17377,All
2021,2,AHMEDABAD,CHANDIGARH,10478,9233,AHMEDABAD-CHANDIGARH,19711,All
2021,3,AHMEDABAD,CHANDIGARH,11397,10006,AHMEDABAD-CHANDIGARH,21403,All
2021,4,AHMEDABAD,CHANDIGARH,6663,5849,AHMEDABAD-CHANDIGARH,12512,All
2021,6,AHMEDABAD,CHANDIGARH,5569,4945,AHMEDABAD-CHANDIGARH,10514,All
2021,7,AHMEDABAD,CHANDIGARH,7712,7141,AHMEDABAD-CHANDIGARH,14853,All
2021,8,AHMEDABAD,CHANDIGARH,7884,7808,AHMEDABAD-CHANDIGARH,15692,All
2021,9,AHMEDABAD,CHANDIGARH,7202,7626,AHMEDABAD-CHANDIGARH,14828,All
2021,10,AHMEDABAD,CHANDIGARH,9179,7763,AHMEDABAD-CHANDIGARH,16942,All
2021,11,AHMEDABAD,CHANDIGARH,13604,12346,AHMEDABAD-CHANDIGARH,25950,All
2021,12,AHMEDABAD,CHANDIGARH,13356,12109,AHMEDABAD-CHANDIGARH,25465,All
2022,1,AHMEDABAD,CHANDIGARH,7081,6137,AHMEDABAD-CHANDIGARH,13218,All
2022,2,AHMEDABAD,CHANDIGARH,7023,6408,AHMEDABAD-CHANDIGARH,13431,All
2022,3,AHMEDABAD,CHANDIGARH,9533,9007,AHMEDABAD-CHANDIGARH,18540,All
2022,4,AHMEDABAD,CHANDIGARH,4799,4218,AHMEDABAD-CHANDIGARH,9017,All
2022,5,AHMEDABAD,CHANDIGARH,5800,5305,AHMEDABAD-CHANDIGARH,11105,All
2022,6,AHMEDABAD,CHANDIGARH,8251,8152,AHMEDABAD-CHANDIGARH,16403,All
2022,7,AHMEDABAD,CHANDIGARH,5834,5396,AHMEDABAD-CHANDIGARH,11230,All
2022,8,AHMEDABAD,CHANDIGARH,6242,5393,AHMEDABAD-CHANDIGARH,11635,All
2022,9,AHMEDABAD,CHANDIGARH,7160,6431,AHMEDABAD-CHANDIGARH,13591,All
2022,10,AHMEDABAD,CHANDIGARH,12871,9423,AHMEDABAD-CHANDIGARH,22294,All
2022,11,AHMEDABAD,CHANDIGARH,9341,10153,AHMEDABAD-CHANDIGARH,19494,All
2022,12,AHMEDABAD,CHANDIGARH,13828,14275,AHMEDABAD-CHANDIGARH,28103,All
2023,1,AHMEDABAD,CHANDIGARH,12612,12085,AHMEDABAD-CHANDIGARH,24697,All
2023,2,AHMEDABAD,CHANDIGARH,11503,9783,AHMEDABAD-CHANDIGARH,21286,All
2023,3,AHMEDABAD,CHANDIGARH,10763,10770,AHMEDABAD-CHANDIGARH,21533,All
2023,4,AHMEDABAD,CHANDIGARH,11441,10516,AHMEDABAD-CHANDIGARH,21957,All
2023,5,AHMEDABAD,CHANDIGARH,11645,10435,AHMEDABAD-CHANDIGARH,22080,All
2023,6,AHMEDABAD,CHANDIGARH,10793,10625,AHMEDABAD-CHANDIGARH,21418,All
2023,7,AHMEDABAD,CHANDIGARH,9099,8198,AHMEDABAD-CHANDIGARH,17297,All
2023,8,AHMEDABAD,CHANDIGARH,9294,8295,AHMEDABAD-CHANDIGARH,17589,All
2023,9,AHMEDABAD,CHANDIGARH,9883,8453,AHMEDABAD-CHANDIGARH,18336,All
2023,10,AHMEDABAD,CHANDIGARH,9967,9346,AHMEDABAD-CHANDIGARH,19313,All
2023,11,AHMEDABAD,CHANDIGARH,9510,8177,AHMEDABAD-CHANDIGARH,17687,All
2023,12,AHMEDABAD,CHANDIGARH,8609,8652,AHMEDABAD-CHANDIGARH,17261,All
2024,1,AHMEDABAD,CHANDIGARH,4716,4535,AHMEDABAD-CHANDIGARH,9251,All
2024,2,AHMEDABAD,CHANDIGARH,7206,6218,AHMEDABAD-CHANDIGARH,13424,All
2024,3,AHMEDABAD,CHANDIGARH,7495,6812,AHMEDABAD-CHANDIGARH,14307,All
2024,4,AHMEDABAD,CHANDIGARH,9413,8341,AHMEDABAD-CHANDIGARH,17754,All
2024,6,AHMEDABAD,CHANDIGARH,8825,8727,AHMEDABAD-CHANDIGARH,17552,All
2024,7,AHMEDABAD,CHANDIGARH,7544,7526,AHMEDABAD-CHANDIGARH,15070,All
2024,8,AHMEDABAD,CHANDIGARH,7565,7014,AHMEDABAD-CHANDIGARH,14579,All
2024,9,AHMEDABAD,CHANDIGARH,7343,6640,AHMEDABAD-CHANDIGARH,13983,All
2024,10,AHMEDABAD,CHANDIGARH,9451,7397,AHMEDABAD-CHANDIGARH,16848,All
2024,11,AHMEDABAD,CHANDIGARH,10042,10206,AHMEDABAD-CHANDIGARH,20248,All
2024,12,AHMEDABAD,CHANDIGARH,10765,11237,AHMEDABAD-CHANDIGARH,22002,All
2025,1,AHMEDABAD,CHANDIGARH,9639,9555,AHMEDABAD-CHANDIGARH,19194,All
2025,2,AHMEDABAD,CHANDIGARH,10048,9458,AHMEDABAD-CHANDIGARH,19506,All
2025,3,AHMEDABAD,CHANDIGARH,11517,10949,AHMEDABAD-CHANDIGARH,22466,All
2015,4,AHMEDABAD,CHENNAI,12616,14905,AHMEDABAD-CHENNAI,27521,All
2015,5,AHMEDABAD,CHENNAI,16090,14762,AHMEDABAD-CHENNAI,30852,All
2015,6,AHMEDABAD,CHENNAI,13855,12988,AHMEDABAD-CHENNAI,26843,All
2015,7,AHMEDABAD,CHENNAI,14157,13514,AHMEDABAD-CHENNAI,27671,All
2015,8,AHMEDABAD,CHENNAI,12809,13063,AHMEDABAD-CHENNAI,25872,All
2015,9,AHMEDABAD,CHENNAI,12636,13147,AHMEDABAD-CHENNAI,25783,All
2015,10,AHMEDABAD,CHENNAI,16672,15771,AHMEDABAD-CHENNAI,32443,All
2015,11,AHMEDABAD,CHENNAI,12151,12541,AHMEDABAD-CHENNAI,24692,All
2015,12,AHMEDABAD,CHENNAI,9302,9246,AHMEDABAD-CHENNAI,18548,All
2016,1,AHMEDABAD,CHENNAI,12666,12260,AHMEDABAD-CHENNAI,24926,All
2016,2,AHMEDABAD,CHENNAI,12121,11551,AHMEDABAD-CHENNAI,23672,All
2016,3,AHMEDABAD,CHENNAI,12079,12219,AHMEDABAD-CHENNAI,24298,All
2016,4,AHMEDABAD,CHENNAI,12779,13207,AHMEDABAD-CHENNAI,25986,All
2016,5,AHMEDABAD,CHENNAI,13939,13997,AHMEDABAD-CHENNAI,27936,All
2016,6,AHMEDABAD,CHENNAI,12596,12319,AHMEDABAD-CHENNAI,24915,All
2016,7,AHMEDABAD,CHENNAI,14057,13683,AHMEDABAD-CHENNAI,27740,All
2016,8,AHMEDABAD,CHENNAI,13234,13644,AHMEDABAD-CHENNAI,26878,All
2016,9,AHMEDABAD,CHENNAI,12454,13523,AHMEDABAD-CHENNAI,25977,All
2016,10,AHMEDABAD,CHENNAI,12661,12479,AHMEDABAD-CHENNAI,25140,All
2016,11,AHMEDABAD,CHENNAI,14665,18906,AHMEDABAD-CHENNAI,33571,All
2016,12,AHMEDABAD,CHENNAI,20286,21170,AHMEDABAD-CHENNAI,41456,All
2017,1,AHMEDABAD,CHENNAI,21825,22674,AHMEDABAD-CHENNAI,44499,All
2017,2,AHMEDABAD,CHENNAI,18944,18272,AHMEDABAD-CHENNAI,37216,All
2017,3,AHMEDABAD,CHENNAI,17259,17356,AHMEDABAD-CHENNAI,34615,All
2017,4,AHMEDABAD,CHENNAI,16614,18328,AHMEDABAD-CHENNAI,34942,All
2017,5,AHMEDABAD,CHENNAI,19977,17955,AHMEDABAD-CHENNAI,37932,All
2017,6,AHMEDABAD,CHENNAI,17530,16798,AHMEDABAD-CHENNAI,34328,All
2017,7,AHMEDABAD,CHENNAI,18656,17895,AHMEDABAD-CHENNAI,36551,All
2017,8,AHMEDABAD,CHENNAI,18231,17727,AHMEDABAD-CHENNAI,35958,All
2017,9,AHMEDABAD,CHENNAI,18945,19588,AHMEDABAD-CHENNAI,38533,All
2017,10,AHMEDABAD,CHENNAI,21051,19559,AHMEDABAD-CHENNAI,40610,All
2017,11,AHMEDABAD,CHENNAI,19704,20751,AHMEDABAD-CHENNAI,40455,All
2017,12,AHMEDABAD,CHENNAI,21281,20484,AHMEDABAD-CHENNAI,41765,All
2018,1,AHMEDABAD,CHENNAI,21907,21460,AHMEDABAD-CHENNAI,43367,All
2018,2,AHMEDABAD,CHENNAI,20187,19809,AHMEDABAD-CHENNAI,39996,All
2018,3,AHMEDABAD,CHENNAI,21210,22106,AHMEDABAD-CHENNAI,43316,All
2018,4,AHMEDABAD,CHENNAI,20380,20873,AHMEDABAD-CHENNAI,41253,All
2018,5,AHMEDABAD,CHENNAI,21828,20021,AHMEDABAD-CHENNAI,41849,All
2018,6,AHMEDABAD,CHENNAI,23216,22374,AHMEDABAD-CHENNAI,45590,All
2018,7,AHMEDABAD,CHENNAI,25126,24860,AHMEDABAD-CHENNAI,49986,All
2018,8,AHMEDABAD,CHENNAI,24205,24565,AHMEDABAD-CHENNAI,48770,All
2018,9,AHMEDABAD,CHENNAI,25545,26351,AHMEDABAD-CHENNAI,51896,All
2018,10,AHMEDABAD,CHENNAI,23796,22763,AHMEDABAD-CHENNAI,46559,All
2018,11,AHMEDABAD,CHENNAI,24087,23051,AHMEDABAD-CHENNAI,47138,All
2018,12,AHMEDABAD,CHENNAI,27423,25976,AHMEDABAD-CHENNAI,53399,All
2019,1,AHMEDABAD,CHENNAI,30877,28119,AHMEDABAD-CHENNAI,58996,All
2019,2,AHMEDABAD,CHENNAI,29365,26207,AHMEDABAD-CHENNAI,55572,All
2019,3,AHMEDABAD,CHENNAI,24588,22083,AHMEDABAD-CHENNAI,46671,All
2019,4,AHMEDABAD,CHENNAI,21286,21110,AHMEDABAD-CHENNAI,42396,All
2019,5,AHMEDABAD,CHENNAI,22216,21135,AHMEDABAD-CHENNAI,43351,All
2019,6,AHMEDABAD,CHENNAI,24116,23136,AHMEDABAD-CHENNAI,47252,All
2019,7,AHMEDABAD,CHENNAI,26585,24799,AHMEDABAD-CHENNAI,51384,All
2019,8,AHMEDABAD,CHENNAI,26662,26255,AHMEDABAD-CHENNAI,52917,All
2019,9,AHMEDABAD,CHENNAI,25540,26378,AHMEDABAD-CHENNAI,51918,All
2019,10,AHMEDABAD,CHENNAI,27559,24427,AHMEDABAD-CHENNAI,51986,All
2019,11,AHMEDABAD,CHENNAI,31922,33040,AHMEDABAD-CHENNAI,64962,All
2019,12,AHMEDABAD,CHENNAI,34103,33019,AHMEDABAD-CHENNAI,67122,All
2020,1,AHMEDABAD,CHENNAI,34793,33004,AHMEDABAD-CHENNAI,67797,All
2020,2,AHMEDABAD,CHENNAI,30455,29479,AHMEDABAD-CHENNAI,59934,All
2020,3,AHMEDABAD,CHENNAI,17740,18635,AHMEDABAD-CHENNAI,36375,All
2020,5,AHMEDABAD,CHENNAI,0,0,AHMEDABAD-CHENNAI,0,All
2020,6,AHMEDABAD,CHENNAI,0,156,AHMEDABAD-CHENNAI,156,All
2020,7,AHMEDABAD,CHENNAI,0,1710,AHMEDABAD-CHENNAI,1710,All
2020,8,AHMEDABAD,CHENNAI,0,1448,AHMEDABAD-CHENNAI,1448,All
2020,9,AHMEDABAD,CHENNAI,3864,4038,AHMEDABAD-CHENNAI,7902,All
2020,10,AHMEDABAD,CHENNAI,9546,7507,AHMEDABAD-CHENNAI,17053,All
2020,11,AHMEDABAD,CHENNAI,11427,15494,AHMEDABAD-CHENNAI,26921,All
2020,12,AHMEDABAD,CHENNAI,14166,10471,AHMEDABAD-CHENNAI,24637,All
2021,1,AHMEDABAD,CHENNAI,13161,12200,AHMEDABAD-CHENNAI,25361,All
2021,2,AHMEDABAD,CHENNAI,11283,11907,AHMEDABAD-CHENNAI,23190,All
2021,3,AHMEDABAD,CHENNAI,12038,11687,AHMEDABAD-CHENNAI,23725,All
2021,4,AHMEDABAD,CHENNAI,7217,11001,AHMEDABAD-CHENNAI,18218,All
2021,6,AHMEDABAD,CHENNAI,4148,3428,AHMEDABAD-CHENNAI,7576,All
2021,7,AHMEDABAD,CHENNAI,6931,6493,AHMEDABAD-CHENNAI,13424,All
2021,8,AHMEDABAD,CHENNAI,8892,8603,AHMEDABAD-CHENNAI,17495,All
2021,9,AHMEDABAD,CHENNAI,10110,10729,AHMEDABAD-CHENNAI,20839,All
2021,10,AHMEDABAD,CHENNAI,12796,12367,AHMEDABAD-CHENNAI,25163,All
2021,11,AHMEDABAD,CHENNAI,15386,18096,AHMEDABAD-CHENNAI,33482,All
2021,12,AHMEDABAD,CHENNAI,15580,14627,AHMEDABAD-CHENNAI,30207,All
2022,1,AHMEDABAD,CHENNAI,9099,8786,AHMEDABAD-CHENNAI,17885,All
2022,2,AHMEDABAD,CHENNAI,8730,8324,AHMEDABAD-CHENNAI,17054,All
2022,3,AHMEDABAD,CHENNAI,10669,10003,AHMEDABAD-CHENNAI,20672,All
2022,4,AHMEDABAD,CHENNAI,10802,10630,AHMEDABAD-CHENNAI,21432,All
2022,5,AHMEDABAD,CHENNAI,14941,13123,AHMEDABAD-CHENNAI,28064,All
2022,6,AHMEDABAD,CHENNAI,12406,12550,AHMEDABAD-CHENNAI,24956,All
2022,7,AHMEDABAD,CHENNAI,12369,12116,AHMEDABAD-CHENNAI,24485,All
2022,8,AHMEDABAD,CHENNAI,12203,11785,AHMEDABAD-CHENNAI,23988,All
2022,9,AHMEDABAD,CHENNAI,9659,10680,AHMEDABAD-CHENNAI,20339,All
2022,10,AHMEDABAD,CHENNAI,11868,10445,AHMEDABAD-CHENNAI,22313,All
2022,11,AHMEDABAD,CHENNAI,13442,14380,AHMEDABAD-CHENNAI,27822,All
2022,12,AHMEDABAD,CHENNAI,13712,12980,AHMEDABAD-CHENNAI,26692,All
2023,1,AHMEDABAD,CHENNAI,14699,13454,AHMEDABAD-CHENNAI,28153,All
2023,2,AHMEDABAD,CHENNAI,13322,12266,AHMEDABAD-CHENNAI,25588,All
2023,3,AHMEDABAD,CHENNAI,13226,12539,AHMEDABAD-CHENNAI,25765,All
2023,4,AHMEDABAD,CHENNAI,13559,14727,AHMEDABAD-CHENNAI,28286,All
2023,5,AHMEDABAD,CHENNAI,15038,13417,AHMEDABAD-CHENNAI,28455,All
2023,6,AHMEDABAD,CHENNAI,13779,13470,AHMEDABAD-CHENNAI,27249,All
2023,7,AHMEDABAD,CHENNAI,13985,12754,AHMEDABAD-CHENNAI,26739,All
2023,8,AHMEDABAD,CHENNAI,14302,14636,AHMEDABAD-CHENNAI,28938,All
2023,9,AHMEDABAD,CHENNAI,14564,14273,AHMEDABAD-CHENNAI,28837,All
2023,10,AHMEDABAD,CHENNAI,14935,14184,AHMEDABAD-CHENNAI,29119,All
2023,11,AHMEDABAD,CHENNAI,18378,18567,AHMEDABAD-CHENNAI,36945,All
2023,12,AHMEDABAD,CHENNAI,20432,20799,AHMEDABAD-CHENNAI,41231,All
2024,1,AHMEDABAD,CHENNAI,19301,19523,AHMEDABAD-CHENNAI,38824,All
2024,2,AHMEDABAD,CHENNAI,19138,18379,AHMEDABAD-CHENNAI,37517,All
2024,3,AHMEDABAD,CHENNAI,20987,20958,AHMEDABAD-CHENNAI,41945,All
2024,4,AHMEDABAD,CHENNAI,16678,18270,AHMEDABAD-CHENNAI,34948,All
2024,6,AHMEDABAD,CHENNAI,16908,16540,AHMEDABAD-CHENNAI,33448,All
2024,7,AHMEDABAD,CHENNAI,18631,17979,AHMEDABAD-CHENNAI,36610,All
2024,8,AHMEDABAD,CHENNAI,17553,18102,AHMEDABAD-CHENNAI,35655,All
2024,9,AHMEDABAD,CHENNAI,16814,17855,AHMEDABAD-CHENNAI,34669,All
2024,10,AHMEDABAD,CHENNAI,20446,20260,AHMEDABAD-CHENNAI,40706,All
2024,11,AHMEDABAD,CHENNAI,17826,18682,AHMEDABAD-CHENNAI,36508,All
2024,12,AHMEDABAD,CHENNAI,22229,21912,AHMEDABAD-CHENNAI,44141,All
2025,1,AHMEDABAD,CHENNAI,21698,20800,AHMEDABAD-CHENNAI,42498,All
2025,2,AHMEDABAD,CHENNAI,18714,18500,AHMEDABAD-CHENNAI,37214,All
2025,3,AHMEDABAD,CHENNAI,17867,18125,AHMEDABAD-CHENNAI,35992,All
2015,4,AHMEDABAD,COIMBATORE,540,498,AHMEDABAD-COIMBATORE,1038,All
2015,5,AHMEDABAD,COIMBATORE,946,1204,AHMEDABAD-COIMBATORE,2150,All
2015,6,AHMEDABAD,COIMBATORE,790,1245,AHMEDABAD-COIMBATORE,2035,All
2015,10,AHMEDABAD,COIMBATORE,199,325,AHMEDABAD-COIMBATORE,524,All
2015,11,AHMEDABAD,COIMBATORE,779,809,AHMEDABAD-COIMBATORE,1588,All
2015,12,AHMEDABAD,COIMBATORE,987,887,AHMEDABAD-COIMBATORE,1874,All
2016,1,AHMEDABAD,COIMBATORE,1188,1289,AHMEDABAD-COIMBATORE,2477,All
2016,2,AHMEDABAD,COIMBATORE,817,989,AHMEDABAD-COIMBATORE,1806,All
2016,3,AHMEDABAD,COIMBATORE,1004,1024,AHMEDABAD-COIMBATORE,2028,All
2016,4,AHMEDABAD,COIMBATORE,831,408,AHMEDABAD-COIMBATORE,1239,All
2016,5,AHMEDABAD,COIMBATORE,752,0,AHMEDABAD-COIMBATORE,752,All
2016,6,AHMEDABAD,COIMBATORE,917,0,AHMEDABAD-COIMBATORE,917,All
2016,7,AHMEDABAD,COIMBATORE,830,0,AHMEDABAD-COIMBATORE,830,All
2016,8,AHMEDABAD,COIMBATORE,764,0,AHMEDABAD-COIMBATORE,764,All
2016,9,AHMEDABAD,COIMBATORE,531,0,AHMEDABAD-COIMBATORE,531,All
2016,10,AHMEDABAD,COIMBATORE,834,0,AHMEDABAD-COIMBATORE,834,All
2016,11,AHMEDABAD,COIMBATORE,962,0,AHMEDABAD-COIMBATORE,962,All
2016,12,AHMEDABAD,COIMBATORE,1130,0,AHMEDABAD-COIMBATORE,1130,All
2017,1,AHMEDABAD,COIMBATORE,1146,0,AHMEDABAD-COIMBATORE,1146,All
2017,2,AHMEDABAD,COIMBATORE,944,0,AHMEDABAD-COIMBATORE,944,All
2017,3,AHMEDABAD,COIMBATORE,950,205,AHMEDABAD-COIMBATORE,1155,All
2017,4,AHMEDABAD,COIMBATORE,982,776,AHMEDABAD-COIMBATORE,1758,All
2017,5,AHMEDABAD,COIMBATORE,775,896,AHMEDABAD-COIMBATORE,1671,All
2017,6,AHMEDABAD,COIMBATORE,675,798,AHMEDABAD-COIMBATORE,1473,All
2017,7,AHMEDABAD,COIMBATORE,711,644,AHMEDABAD-COIMBATORE,1355,All
2017,8,AHMEDABAD,COIMBATORE,758,826,AHMEDABAD-COIMBATORE,1584,All
2017,9,AHMEDABAD,COIMBATORE,566,723,AHMEDABAD-COIMBATORE,1289,All
2017,10,AHMEDABAD,COIMBATORE,813,905,AHMEDABAD-COIMBATORE,1718,All
2017,11,AHMEDABAD,COIMBATORE,799,973,AHMEDABAD-COIMBATORE,1772,All
2017,12,AHMEDABAD,COIMBATORE,878,1041,AHMEDABAD-COIMBATORE,1919,All
2018,1,AHMEDABAD,COIMBATORE,810,792,AHMEDABAD-COIMBATORE,1602,All
2018,2,AHMEDABAD,COIMBATORE,701,866,AHMEDABAD-COIMBATORE,1567,All
2018,3,AHMEDABAD,COIMBATORE,676,61,AHMEDABAD-COIMBATORE,737,All
2018,4,AHMEDABAD,COIMBATORE,793,330,AHMEDABAD-COIMBATORE,1123,All
2018,5,AHMEDABAD,COIMBATORE,879,888,AHMEDABAD-COIMBATORE,1767,All
2018,6,AHMEDABAD,COIMBATORE,590,631,AHMEDABAD-COIMBATORE,1221,All
2018,7,AHMEDABAD,COIMBATORE,708,732,AHMEDABAD-COIMBATORE,1440,All
2018,8,AHMEDABAD,COIMBATORE,791,755,AHMEDABAD-COIMBATORE,1546,All
2018,9,AHMEDABAD,COIMBATORE,559,500,AHMEDABAD-COIMBATORE,1059,All
2018,10,AHMEDABAD,COIMBATORE,935,874,AHMEDABAD-COIMBATORE,1809,All
2018,11,AHMEDABAD,COIMBATORE,1126,1043,AHMEDABAD-COIMBATORE,2169,All
2018,12,AHMEDABAD,COIMBATORE,1093,1050,AHMEDABAD-COIMBATORE,2143,All
2019,1,AHMEDABAD,COIMBATORE,915,928,AHMEDABAD-COIMBATORE,1843,All
2019,2,AHMEDABAD,COIMBATORE,1024,963,AHMEDABAD-COIMBATORE,1987,All
2019,3,AHMEDABAD,COIMBATORE,485,555,AHMEDABAD-COIMBATORE,1040,All
2019,4,AHMEDABAD,COIMBATORE,137,106,AHMEDABAD-COIMBATORE,243,All
2019,5,AHMEDABAD,COIMBATORE,86,67,AHMEDABAD-COIMBATORE,153,All
2019,6,AHMEDABAD,COIMBATORE,89,73,AHMEDABAD-COIMBATORE,162,All
2019,7,AHMEDABAD,COIMBATORE,15,61,AHMEDABAD-COIMBATORE,76,All
2019,8,AHMEDABAD,COIMBATORE,22,37,AHMEDABAD-COIMBATORE,59,All
2019,10,AHMEDABAD,COIMBATORE,53,93,AHMEDABAD-COIMBATORE,146,All
2019,11,AHMEDABAD,COIMBATORE,1057,806,AHMEDABAD-COIMBATORE,1863,All
2019,12,AHMEDABAD,COIMBATORE,1185,1525,AHMEDABAD-COIMBATORE,2710,All
2020,1,AHMEDABAD,COIMBATORE,904,1036,AHMEDABAD-COIMBATORE,1940,All
2020,2,AHMEDABAD,COIMBATORE,929,1094,AHMEDABAD-COIMBATORE,2023,All
2020,3,AHMEDABAD,COIMBATORE,682,684,AHMEDABAD-COIMBATORE,1366,All
2020,8,AHMEDABAD,COIMBATORE,515,166,AHMEDABAD-COIMBATORE,681,All
2020,9,AHMEDABAD,COIMBATORE,2485,708,AHMEDABAD-COIMBATORE,3193,All
2020,10,AHMEDABAD,COIMBATORE,3230,1686,AHMEDABAD-COIMBATORE,4916,All
2020,11,AHMEDABAD,COIMBATORE,2616,3587,AHMEDABAD-COIMBATORE,6203,All
2020,12,AHMEDABAD,COIMBATORE,2986,2286,AHMEDABAD-COIMBATORE,5272,All
2021,1,AHMEDABAD,COIMBATORE,1992,1978,AHMEDABAD-COIMBATORE,3970,All
2021,2,AHMEDABAD,COIMBATORE,1420,1590,AHMEDABAD-COIMBATORE,3010,All
2021,3,AHMEDABAD,COIMBATORE,1136,916,AHMEDABAD-COIMBATORE,2052,All
2021,4,AHMEDABAD,COIMBATORE,487,729,AHMEDABAD-COIMBATORE,1216,All
2021,6,AHMEDABAD,COIMBATORE,0,167,AHMEDABAD-COIMBATORE,167,All
2021,7,AHMEDABAD,COIMBATORE,0,742,AHMEDABAD-COIMBATORE,742,All
2021,8,AHMEDABAD,COIMBATORE,229,485,AHMEDABAD-COIMBATORE,714,All
2021,9,AHMEDABAD,COIMBATORE,609,712,AHMEDABAD-COIMBATORE,1321,All
2021,10,AHMEDABAD,COIMBATORE,607,663,AHMEDABAD-COIMBATORE,1270,All
2021,11,AHMEDABAD,COIMBATORE,1132,484,AHMEDABAD-COIMBATORE,1616,All
2021,12,AHMEDABAD,COIMBATORE,1432,578,AHMEDABAD-COIMBATORE,2010,All
2022,1,AHMEDABAD,COIMBATORE,669,480,AHMEDABAD-COIMBATORE,1149,All
2022,2,AHMEDABAD,COIMBATORE,0,204,AHMEDABAD-COIMBATORE,204,All
2022,3,AHMEDABAD,COIMBATORE,321,255,AHMEDABAD-COIMBATORE,576,All
2022,4,AHMEDABAD,COIMBATORE,434,0,AHMEDABAD-COIMBATORE,434,All
2022,5,AHMEDABAD,COIMBATORE,609,0,AHMEDABAD-COIMBATORE,609,All
2022,6,AHMEDABAD,COIMBATORE,1409,961,AHMEDABAD-COIMBATORE,2370,All
2022,7,AHMEDABAD,COIMBATORE,1164,763,AHMEDABAD-COIMBATORE,1927,All
2022,8,AHMEDABAD,COIMBATORE,1027,699,AHMEDABAD-COIMBATORE,1726,All
2022,9,AHMEDABAD,COIMBATORE,877,611,AHMEDABAD-COIMBATORE,1488,All
2022,10,AHMEDABAD,COIMBATORE,1120,633,AHMEDABAD-COIMBATORE,1753,All
2022,11,AHMEDABAD,COIMBATORE,931,1032,AHMEDABAD-COIMBATORE,1963,All
2022,12,AHMEDABAD,COIMBATORE,1489,1457,AHMEDABAD-COIMBATORE,2946,All
2023,1,AHMEDABAD,COIMBATORE,1259,1671,AHMEDABAD-COIMBATORE,2930,All
2023,2,AHMEDABAD,COIMBATORE,1156,1490,AHMEDABAD-COIMBATORE,2646,All
2023,3,AHMEDABAD,COIMBATORE,791,1243,AHMEDABAD-COIMBATORE,2034,All
2023,4,AHMEDABAD,COIMBATORE,909,1149,AHMEDABAD-COIMBATORE,2058,All
2023,5,AHMEDABAD,COIMBATORE,1048,833,AHMEDABAD-COIMBATORE,1881,All
2023,6,AHMEDABAD,COIMBATORE,730,647,AHMEDABAD-COIMBATORE,1377,All
2023,7,AHMEDABAD,COIMBATORE,518,432,AHMEDABAD-COIMBATORE,950,All
2023,8,AHMEDABAD,COIMBATORE,424,436,AHMEDABAD-COIMBATORE,860,All
2023,9,AHMEDABAD,COIMBATORE,600,549,AHMEDABAD-COIMBATORE,1149,All
2023,10,AHMEDABAD,COIMBATORE,874,790,AHMEDABAD-COIMBATORE,1664,All
2023,11,AHMEDABAD,COIMBATORE,1291,1312,AHMEDABAD-COIMBATORE,2603,All
2023,12,AHMEDABAD,COIMBATORE,1762,1413,AHMEDABAD-COIMBATORE,3175,All
2024,1,AHMEDABAD,COIMBATORE,954,771,AHMEDABAD-COIMBATORE,1725,All
2024,2,AHMEDABAD,COIMBATORE,1200,813,AHMEDABAD-COIMBATORE,2013,All
2024,3,AHMEDABAD,COIMBATORE,1430,877,AHMEDABAD-COIMBATORE,2307,All
2024,4,AHMEDABAD,COIMBATORE,535,373,AHMEDABAD-COIMBATORE,908,All
2024,6,AHMEDABAD,COIMBATORE,837,605,AHMEDABAD-COIMBATORE,1442,All
2024,7,AHMEDABAD,COIMBATORE,541,427,AHMEDABAD-COIMBATORE,968,All
2024,8,AHMEDABAD,COIMBATORE,676,372,AHMEDABAD-COIMBATORE,1048,All
2024,9,AHMEDABAD,COIMBATORE,640,357,AHMEDABAD-COIMBATORE,997,All
2024,10,AHMEDABAD,COIMBATORE,963,680,AHMEDABAD-COIMBATORE,1643,All
2024,11,AHMEDABAD,COIMBATORE,1552,1162,AHMEDABAD-COIMBATORE,2714,All
2024,12,AHMEDABAD,COIMBATORE,1936,1618,AHMEDABAD-COIMBATORE,3554,All
2025,3,AHMEDABAD,COIMBATORE,1280,1196,AHMEDABAD-COIMBATORE,2476,All
2019,1,AHMEDABAD,DABOLIM,15226,18039,AHMEDABAD-DABOLIM,33265,All
2019,2,AHMEDABAD,DABOLIM,16976,18447,AHMEDABAD-DABOLIM,35423,All
2019,3,AHMEDABAD,DABOLIM,15655,17207,AHMEDABAD-DABOLIM,32862,All
2019,4,AHMEDABAD,DABOLIM,15701,16055,AHMEDABAD-DABOLIM,31756,All
2019,5,AHMEDABAD,DABOLIM,17380,17577,AHMEDABAD-DABOLIM,34957,All
2019,6,AHMEDABAD,DABOLIM,14897,17218,AHMEDABAD-DABOLIM,32115,All
2019,7,AHMEDABAD,DABOLIM,14887,15376,AHMEDABAD-DABOLIM,30263,All
2019,8,AHMEDABAD,DABOLIM,15277,15701,AHMEDABAD-DABOLIM,30978,All
2019,9,AHMEDABAD,DABOLIM,14110,15277,AHMEDABAD-DABOLIM,29387,All
2019,10,AHMEDABAD,DABOLIM,16047,16612,AHMEDABAD-DABOLIM,32659,All
2019,11,AHMEDABAD,DABOLIM,18241,19027,AHMEDABAD-DABOLIM,37268,All
2019,12,AHMEDABAD,DABOLIM,17361,17087,AHMEDABAD-DABOLIM,34448,All
2020,1,AHMEDABAD,DABOLIM,16862,18841,AHMEDABAD-DABOLIM,35703,All
2020,2,AHMEDABAD,DABOLIM,15767,15785,AHMEDABAD-DABOLIM,31552,All
2020,3,AHMEDABAD,DABOLIM,8551,11180,AHMEDABAD-DABOLIM,19731,All
2020,7,AHMEDABAD,DABOLIM,93,98,AHMEDABAD-DABOLIM,191,All
2020,8,AHMEDABAD,DABOLIM,253,159,AHMEDABAD-DABOLIM,412,All
2020,9,AHMEDABAD,DABOLIM,1984,1471,AHMEDABAD-DABOLIM,3455,All
2020,10,AHMEDABAD,DABOLIM,3984,3415,AHMEDABAD-DABOLIM,7399,All
2020,11,AHMEDABAD,DABOLIM,10710,10705,AHMEDABAD-DABOLIM,21415,All
2020,12,AHMEDABAD,DABOLIM,15446,11817,AHMEDABAD-DABOLIM,27263,All
2021,1,AHMEDABAD,DABOLIM,20304,21799,AHMEDABAD-DABOLIM,42103,All
2021,2,AHMEDABAD,DABOLIM,19517,20016,AHMEDABAD-DABOLIM,39533,All
2021,3,AHMEDABAD,DABOLIM,22123,22698,AHMEDABAD-DABOLIM,44821,All
2021,4,AHMEDABAD,DABOLIM,7546,11562,AHMEDABAD-DABOLIM,19108,All
2021,6,AHMEDABAD,DABOLIM,797,727,AHMEDABAD-DABOLIM,1524,All
2021,7,AHMEDABAD,DABOLIM,5939,5241,AHMEDABAD-DABOLIM,11180,All
2021,8,AHMEDABAD,DABOLIM,12471,11406,AHMEDABAD-DABOLIM,23877,All
2021,9,AHMEDABAD,DABOLIM,15405,16082,AHMEDABAD-DABOLIM,31487,All
2021,10,AHMEDABAD,DABOLIM,19633,20841,AHMEDABAD-DABOLIM,40474,All
2021,11,AHMEDABAD,DABOLIM,21069,22541,AHMEDABAD-DABOLIM,43610,All
2021,12,AHMEDABAD,DABOLIM,22285,19942,AHMEDABAD-DABOLIM,42227,All
2022,1,AHMEDABAD,DABOLIM,10523,14134,AHMEDABAD-DABOLIM,24657,All
2022,2,AHMEDABAD,DABOLIM,12662,12975,AHMEDABAD-DABOLIM,25637,All
2022,3,AHMEDABAD,DABOLIM,20586,21482,AHMEDABAD-DABOLIM,42068,All
2022,4,AHMEDABAD,DABOLIM,13888,14642,AHMEDABAD-DABOLIM,28530,All
2022,5,AHMEDABAD,DABOLIM,20461,20164,AHMEDABAD-DABOLIM,40625,All
2022,6,AHMEDABAD,DABOLIM,17065,20057,AHMEDABAD-DABOLIM,37122,All
2022,7,AHMEDABAD,DABOLIM,12541,13775,AHMEDABAD-DABOLIM,26316,All
2022,8,AHMEDABAD,DABOLIM,16442,17133,AHMEDABAD-DABOLIM,33575,All
2022,9,AHMEDABAD,DABOLIM,15851,17958,AHMEDABAD-DABOLIM,33809,All
2022,10,AHMEDABAD,DABOLIM,19424,17396,AHMEDABAD-DABOLIM,36820,All
2022,11,AHMEDABAD,DABOLIM,17270,18290,AHMEDABAD-DABOLIM,35560,All
2022,12,AHMEDABAD,DABOLIM,23062,22499,AHMEDABAD-DABOLIM,45561,All
2023,1,AHMEDABAD,DABOLIM,20419,21684,AHMEDABAD-DABOLIM,42103,All
2023,2,AHMEDABAD,DABOLIM,15351,15200,AHMEDABAD-DABOLIM,30551,All
2023,3,AHMEDABAD,DABOLIM,15966,16388,AHMEDABAD-DABOLIM,32354,All
2023,4,AHMEDABAD,DABOLIM,9223,9507,AHMEDABAD-DABOLIM,18730,All
2023,5,AHMEDABAD,DABOLIM,4677,4478,AHMEDABAD-DABOLIM,9155,All
2023,6,AHMEDABAD,DABOLIM,4325,4223,AHMEDABAD-DABOLIM,8548,All
2023,7,AHMEDABAD,DABOLIM,4260,4230,AHMEDABAD-DABOLIM,8490,All
2023,8,AHMEDABAD,DABOLIM,4252,4331,AHMEDABAD-DABOLIM,8583,All
2023,9,AHMEDABAD,DABOLIM,4392,4292,AHMEDABAD-DABOLIM,8684,All
2023,10,AHMEDABAD,DABOLIM,3921,4363,AHMEDABAD-DABOLIM,8284,All
2023,11,AHMEDABAD,DABOLIM,9993,9540,AHMEDABAD-DABOLIM,19533,All
2023,12,AHMEDABAD,DABOLIM,11438,10986,AHMEDABAD-DABOLIM,22424,All
2024,1,AHMEDABAD,DABOLIM,11304,10906,AHMEDABAD-DABOLIM,22210,All
2024,2,AHMEDABAD,DABOLIM,10678,10445,AHMEDABAD-DABOLIM,21123,All
2024,3,AHMEDABAD,DABOLIM,11183,10849,AHMEDABAD-DABOLIM,22032,All
2024,4,AHMEDABAD,DABOLIM,13049,14431,AHMEDABAD-DABOLIM,27480,All
2024,6,AHMEDABAD,DABOLIM,14820,15203,AHMEDABAD-DABOLIM,30023,All
2024,7,AHMEDABAD,DABOLIM,13596,13121,AHMEDABAD-DABOLIM,26717,All
2024,8,AHMEDABAD,DABOLIM,15159,13383,AHMEDABAD-DABOLIM,28542,All
2024,9,AHMEDABAD,DABOLIM,19989,18881,AHMEDABAD-DABOLIM,38870,All
2024,10,AHMEDABAD,DABOLIM,18371,19358,AHMEDABAD-DABOLIM,37729,All
2024,11,AHMEDABAD,DABOLIM,21191,20480,AHMEDABAD-DABOLIM,41671,All
2024,12,AHMEDABAD,DABOLIM,21814,20728,AHMEDABAD-DABOLIM,42542,All
2025,1,AHMEDABAD,DABOLIM,15798,15980,AHMEDABAD-DABOLIM,31778,All
2025,2,AHMEDABAD,DABOLIM,10001,9609,AHMEDABAD-DABOLIM,19610,All
2025,3,AHMEDABAD,DABOLIM,10692,10679,AHMEDABAD-DABOLIM,21371,All
2021,1,AHMEDABAD,DARBHANGA,392,938,AHMEDABAD-DARBHANGA,1330,All
2021,2,AHMEDABAD,DARBHANGA,835,591,AHMEDABAD-DARBHANGA,1426,All
2021,3,AHMEDABAD,DARBHANGA,1604,807,AHMEDABAD-DARBHANGA,2411,All
2021,4,AHMEDABAD,DARBHANGA,2064,917,AHMEDABAD-DARBHANGA,2981,All
2021,6,AHMEDABAD,DARBHANGA,1729,3631,AHMEDABAD-DARBHANGA,5360,All
2021,7,AHMEDABAD,DARBHANGA,1652,2215,AHMEDABAD-DARBHANGA,3867,All
2021,8,AHMEDABAD,DARBHANGA,416,539,AHMEDABAD-DARBHANGA,955,All
2021,9,AHMEDABAD,DARBHANGA,185,212,AHMEDABAD-DARBHANGA,397,All
2021,10,AHMEDABAD,DARBHANGA,152,102,AHMEDABAD-DARBHANGA,254,All
2018,10,AHMEDABAD,DEHRA DUN,78,62,AHMEDABAD-DEHRA DUN,140,All
2018,11,AHMEDABAD,DEHRA DUN,2163,2220,AHMEDABAD-DEHRA DUN,4383,All
2018,12,AHMEDABAD,DEHRA DUN,2023,2381,AHMEDABAD-DEHRA DUN,4404,All
2019,1,AHMEDABAD,DEHRA DUN,2080,2285,AHMEDABAD-DEHRA DUN,4365,All
2019,2,AHMEDABAD,DEHRA DUN,1990,2024,AHMEDABAD-DEHRA DUN,4014,All
2019,3,AHMEDABAD,DEHRA DUN,2370,2373,AHMEDABAD-DEHRA DUN,4743,All
2019,4,AHMEDABAD,DEHRA DUN,2317,2313,AHMEDABAD-DEHRA DUN,4630,All
2019,5,AHMEDABAD,DEHRA DUN,2342,2311,AHMEDABAD-DEHRA DUN,4653,All
2019,6,AHMEDABAD,DEHRA DUN,2184,2268,AHMEDABAD-DEHRA DUN,4452,All
2019,7,AHMEDABAD,DEHRA DUN,1772,2192,AHMEDABAD-DEHRA DUN,3964,All
2019,8,AHMEDABAD,DEHRA DUN,2295,2431,AHMEDABAD-DEHRA DUN,4726,All
2019,9,AHMEDABAD,DEHRA DUN,2338,2514,AHMEDABAD-DEHRA DUN,4852,All
2019,10,AHMEDABAD,DEHRA DUN,2376,2325,AHMEDABAD-DEHRA DUN,4701,All
2019,11,AHMEDABAD,DEHRA DUN,2298,2583,AHMEDABAD-DEHRA DUN,4881,All
2019,12,AHMEDABAD,DEHRA DUN,2101,2254,AHMEDABAD-DEHRA DUN,4355,All
2020,1,AHMEDABAD,DEHRA DUN,2267,2359,AHMEDABAD-DEHRA DUN,4626,All
2020,2,AHMEDABAD,DEHRA DUN,2209,2289,AHMEDABAD-DEHRA DUN,4498,All
2020,3,AHMEDABAD,DEHRA DUN,1729,1940,AHMEDABAD-DEHRA DUN,3669,All
2020,9,AHMEDABAD,DEHRA DUN,524,381,AHMEDABAD-DEHRA DUN,905,All
2020,10,AHMEDABAD,DEHRA DUN,2008,1475,AHMEDABAD-DEHRA DUN,3483,All
2020,11,AHMEDABAD,DEHRA DUN,3769,3652,AHMEDABAD-DEHRA DUN,7421,All
2020,12,AHMEDABAD,DEHRA DUN,3467,3990,AHMEDABAD-DEHRA DUN,7457,All
2021,1,AHMEDABAD,DEHRA DUN,3962,4635,AHMEDABAD-DEHRA DUN,8597,All
2021,2,AHMEDABAD,DEHRA DUN,4196,4382,AHMEDABAD-DEHRA DUN,8578,All
2021,3,AHMEDABAD,DEHRA DUN,4666,4973,AHMEDABAD-DEHRA DUN,9639,All
2021,4,AHMEDABAD,DEHRA DUN,2628,3039,AHMEDABAD-DEHRA DUN,5667,All
2021,6,AHMEDABAD,DEHRA DUN,1472,1631,AHMEDABAD-DEHRA DUN,3103,All
2021,7,AHMEDABAD,DEHRA DUN,3478,3645,AHMEDABAD-DEHRA DUN,7123,All
2021,8,AHMEDABAD,DEHRA DUN,3647,3409,AHMEDABAD-DEHRA DUN,7056,All
2021,9,AHMEDABAD,DEHRA DUN,4458,4389,AHMEDABAD-DEHRA DUN,8847,All
2021,10,AHMEDABAD,DEHRA DUN,5865,5830,AHMEDABAD-DEHRA DUN,11695,All
2021,11,AHMEDABAD,DEHRA DUN,4869,4728,AHMEDABAD-DEHRA DUN,9597,All
2021,12,AHMEDABAD,DEHRA DUN,4291,4152,AHMEDABAD-DEHRA DUN,8443,All
2022,1,AHMEDABAD,DEHRA DUN,2423,2648,AHMEDABAD-DEHRA DUN,5071,All
2022,2,AHMEDABAD,DEHRA DUN,2365,2281,AHMEDABAD-DEHRA DUN,4646,All
2022,3,AHMEDABAD,DEHRA DUN,2639,2590,AHMEDABAD-DEHRA DUN,5229,All
2022,4,AHMEDABAD,DEHRA DUN,2482,2358,AHMEDABAD-DEHRA DUN,4840,All
2022,5,AHMEDABAD,DEHRA DUN,3385,3335,AHMEDABAD-DEHRA DUN,6720,All
2022,6,AHMEDABAD,DEHRA DUN,6518,7725,AHMEDABAD-DEHRA DUN,14243,All
2022,7,AHMEDABAD,DEHRA DUN,5032,5703,AHMEDABAD-DEHRA DUN,10735,All
2022,8,AHMEDABAD,DEHRA DUN,6505,6264,AHMEDABAD-DEHRA DUN,12769,All
2022,9,AHMEDABAD,DEHRA DUN,6457,6153,AHMEDABAD-DEHRA DUN,12610,All
2022,10,AHMEDABAD,DEHRA DUN,6399,5820,AHMEDABAD-DEHRA DUN,12219,All
2022,11,AHMEDABAD,DEHRA DUN,4155,3867,AHMEDABAD-DEHRA DUN,8022,All
2022,12,AHMEDABAD,DEHRA DUN,4560,4402,AHMEDABAD-DEHRA DUN,8962,All
2023,2,AHMEDABAD,DEHRA DUN,4452,3684,AHMEDABAD-DEHRA DUN,8136,All
2023,3,AHMEDABAD,DEHRA DUN,4853,4265,AHMEDABAD-DEHRA DUN,9118,All
2023,4,AHMEDABAD,DEHRA DUN,4622,4034,AHMEDABAD-DEHRA DUN,8656,All
2023,5,AHMEDABAD,DEHRA DUN,5205,4763,AHMEDABAD-DEHRA DUN,9968,All
2015,4,AHMEDABAD,DELHI,55343,50526,AHMEDABAD-DELHI,105869,All
2015,5,AHMEDABAD,DELHI,59949,55634,AHMEDABAD-DELHI,115583,All
2015,6,AHMEDABAD,DELHI,44645,52724,AHMEDABAD-DELHI,97369,All
2015,7,AHMEDABAD,DELHI,46875,47903,AHMEDABAD-DELHI,94778,All
2015,8,AHMEDABAD,DELHI,47109,46632,AHMEDABAD-DELHI,93741,All
2015,9,AHMEDABAD,DELHI,50416,49477,AHMEDABAD-DELHI,99893,All
2015,10,AHMEDABAD,DELHI,42997,39980,AHMEDABAD-DELHI,82977,All
2015,11,AHMEDABAD,DELHI,65040,60975,AHMEDABAD-DELHI,126015,All
2015,12,AHMEDABAD,DELHI,63558,72522,AHMEDABAD-DELHI,136080,All
2016,1,AHMEDABAD,DELHI,71759,67813,AHMEDABAD-DELHI,139572,All
2016,2,AHMEDABAD,DELHI,69296,65215,AHMEDABAD-DELHI,134511,All
2016,3,AHMEDABAD,DELHI,70121,67286,AHMEDABAD-DELHI,137407,All
2016,4,AHMEDABAD,DELHI,74176,65564,AHMEDABAD-DELHI,139740,All
2016,5,AHMEDABAD,DELHI,80500,79099,AHMEDABAD-DELHI,159599,All
2016,6,AHMEDABAD,DELHI,65813,80980,AHMEDABAD-DELHI,146793,All
2016,7,AHMEDABAD,DELHI,73488,75424,AHMEDABAD-DELHI,148912,All
2016,8,AHMEDABAD,DELHI,74196,75662,AHMEDABAD-DELHI,149858,All
2016,9,AHMEDABAD,DELHI,71470,72291,AHMEDABAD-DELHI,143761,All
2016,10,AHMEDABAD,DELHI,77542,66220,AHMEDABAD-DELHI,143762,All
2016,11,AHMEDABAD,DELHI,78241,88730,AHMEDABAD-DELHI,166971,All
2016,12,AHMEDABAD,DELHI,76938,86546,AHMEDABAD-DELHI,163484,All
2017,1,AHMEDABAD,DELHI,81989,81766,AHMEDABAD-DELHI,163755,All
2017,2,AHMEDABAD,DELHI,76304,70386,AHMEDABAD-DELHI,146690,All
2017,3,AHMEDABAD,DELHI,77122,77984,AHMEDABAD-DELHI,155106,All
2017,4,AHMEDABAD,DELHI,81527,74332,AHMEDABAD-DELHI,155859,All
2017,5,AHMEDABAD,DELHI,95277,91907,AHMEDABAD-DELHI,187184,All
2017,6,AHMEDABAD,DELHI,74345,88079,AHMEDABAD-DELHI,162424,All
2017,7,AHMEDABAD,DELHI,75496,80272,AHMEDABAD-DELHI,155768,All
2017,8,AHMEDABAD,DELHI,84251,86645,AHMEDABAD-DELHI,170896,All
2017,9,AHMEDABAD,DELHI,86313,89297,AHMEDABAD-DELHI,175610,All
2017,10,AHMEDABAD,DELHI,105500,96905,AHMEDABAD-DELHI,202405,All
2017,11,AHMEDABAD,DELHI,92664,97574,AHMEDABAD-DELHI,190238,All
2017,12,AHMEDABAD,DELHI,99700,105397,AHMEDABAD-DELHI,205097,All
2018,1,AHMEDABAD,DELHI,105956,104837,AHMEDABAD-DELHI,210793,All
2018,2,AHMEDABAD,DELHI,98231,95450,AHMEDABAD-DELHI,193681,All
2018,3,AHMEDABAD,DELHI,89291,89180,AHMEDABAD-DELHI,178471,All
2018,4,AHMEDABAD,DELHI,97870,91553,AHMEDABAD-DELHI,189423,All
2018,5,AHMEDABAD,DELHI,111627,104833,AHMEDABAD-DELHI,216460,All
2018,6,AHMEDABAD,DELHI,90666,100685,AHMEDABAD-DELHI,191351,All
2018,7,AHMEDABAD,DELHI,100322,102807,AHMEDABAD-DELHI,203129,All
2018,8,AHMEDABAD,DELHI,105422,100199,AHMEDABAD-DELHI,205621,All
2018,9,AHMEDABAD,DELHI,102068,101082,AHMEDABAD-DELHI,203150,All
2018,10,AHMEDABAD,DELHI,99188,94617,AHMEDABAD-DELHI,193805,All
2018,11,AHMEDABAD,DELHI,93874,92104,AHMEDABAD-DELHI,185978,All
2018,12,AHMEDABAD,DELHI,100444,107548,AHMEDABAD-DELHI,207992,All
2019,1,AHMEDABAD,DELHI,106018,101855,AHMEDABAD-DELHI,207873,All
2019,2,AHMEDABAD,DELHI,99702,89999,AHMEDABAD-DELHI,189701,All
2019,3,AHMEDABAD,DELHI,93040,90241,AHMEDABAD-DELHI,183281,All
2019,4,AHMEDABAD,DELHI,87445,79002,AHMEDABAD-DELHI,166447,All
2019,5,AHMEDABAD,DELHI,95670,92075,AHMEDABAD-DELHI,187745,All
2019,6,AHMEDABAD,DELHI,81849,92386,AHMEDABAD-DELHI,174235,All
2019,7,AHMEDABAD,DELHI,92326,92308,AHMEDABAD-DELHI,184634,All
2019,8,AHMEDABAD,DELHI,93760,91197,AHMEDABAD-DELHI,184957,All
2019,9,AHMEDABAD,DELHI,89930,90325,AHMEDABAD-DELHI,180255,All
2019,10,AHMEDABAD,DELHI,98559,81969,AHMEDABAD-DELHI,180528,All
2019,11,AHMEDABAD,DELHI,97994,106933,AHMEDABAD-DELHI,204927,All
2019,12,AHMEDABAD,DELHI,91375,103762,AHMEDABAD-DELHI,195137,All
2020,1,AHMEDABAD,DELHI,105861,103677,AHMEDABAD-DELHI,209538,All
2020,2,AHMEDABAD,DELHI,106527,96027,AHMEDABAD-DELHI,202554,All
2020,3,AHMEDABAD,DELHI,56714,56519,AHMEDABAD-DELHI,113233,All
2020,5,AHMEDABAD,DELHI,2893,3299,AHMEDABAD-DELHI,6192,All
2020,6,AHMEDABAD,DELHI,16563,12171,AHMEDABAD-DELHI,28734,All
2020,7,AHMEDABAD,DELHI,17551,14855,AHMEDABAD-DELHI,32406,All
2020,8,AHMEDABAD,DELHI,25242,25361,AHMEDABAD-DELHI,50603,All
2020,9,AHMEDABAD,DELHI,27304,30194,AHMEDABAD-DELHI,57498,All
2020,10,AHMEDABAD,DELHI,35547,34131,AHMEDABAD-DELHI,69678,All
2020,11,AHMEDABAD,DELHI,42102,39328,AHMEDABAD-DELHI,81430,All
2020,12,AHMEDABAD,DELHI,35262,42319,AHMEDABAD-DELHI,77581,All
2021,1,AHMEDABAD,DELHI,44902,49391,AHMEDABAD-DELHI,94293,All
2021,2,AHMEDABAD,DELHI,51501,50585,AHMEDABAD-DELHI,102086,All
2021,3,AHMEDABAD,DELHI,58472,52717,AHMEDABAD-DELHI,111189,All
2021,4,AHMEDABAD,DELHI,40685,29531,AHMEDABAD-DELHI,70216,All
2021,6,AHMEDABAD,DELHI,29909,28467,AHMEDABAD-DELHI,58376,All
2021,7,AHMEDABAD,DELHI,42162,41206,AHMEDABAD-DELHI,83368,All
2021,8,AHMEDABAD,DELHI,51506,49453,AHMEDABAD-DELHI,100959,All
2021,9,AHMEDABAD,DELHI,50789,49536,AHMEDABAD-DELHI,100325,All
2021,10,AHMEDABAD,DELHI,60055,53095,AHMEDABAD-DELHI,113150,All
2021,11,AHMEDABAD,DELHI,78046,83588,AHMEDABAD-DELHI,161634,All
2021,12,AHMEDABAD,DELHI,76332,82172,AHMEDABAD-DELHI,158504,All
2022,1,AHMEDABAD,DELHI,50723,50795,AHMEDABAD-DELHI,101518,All
2022,2,AHMEDABAD,DELHI,65702,57359,AHMEDABAD-DELHI,123061,All
2022,3,AHMEDABAD,DELHI,76759,73712,AHMEDABAD-DELHI,150471,All
2022,4,AHMEDABAD,DELHI,76376,69201,AHMEDABAD-DELHI,145577,All
2022,5,AHMEDABAD,DELHI,93291,87399,AHMEDABAD-DELHI,180690,All
2022,6,AHMEDABAD,DELHI,62593,77576,AHMEDABAD-DELHI,140169,All
2022,7,AHMEDABAD,DELHI,60981,61652,AHMEDABAD-DELHI,122633,All
2022,8,AHMEDABAD,DELHI,70771,74000,AHMEDABAD-DELHI,144771,All
2022,9,AHMEDABAD,DELHI,80115,83292,AHMEDABAD-DELHI,163407,All
2022,10,AHMEDABAD,DELHI,97758,85586,AHMEDABAD-DELHI,183344,All
2022,11,AHMEDABAD,DELHI,94535,102905,AHMEDABAD-DELHI,197440,All
2022,12,AHMEDABAD,DELHI,101909,106798,AHMEDABAD-DELHI,208707,All
2023,1,AHMEDABAD,DELHI,104853,104716,AHMEDABAD-DELHI,209569,All
2023,2,AHMEDABAD,DELHI,96915,93836,AHMEDABAD-DELHI,190751,All
2023,3,AHMEDABAD,DELHI,100090,102490,AHMEDABAD-DELHI,202580,All
2023,4,AHMEDABAD,DELHI,105871,102597,AHMEDABAD-DELHI,208468,All
2023,5,AHMEDABAD,DELHI,98538,98821,AHMEDABAD-DELHI,197359,All
2023,6,AHMEDABAD,DELHI,90085,97230,AHMEDABAD-DELHI,187315,All
2023,7,AHMEDABAD,DELHI,98377,100567,AHMEDABAD-DELHI,198944,All
2023,8,AHMEDABAD,DELHI,104769,105246,AHMEDABAD-DELHI,210015,All
2023,9,AHMEDABAD,DELHI,101886,103525,AHMEDABAD-DELHI,205411,All
2023,10,AHMEDABAD,DELHI,90301,87634,AHMEDABAD-DELHI,177935,All
2023,11,AHMEDABAD,DELHI,100935,96383,AHMEDABAD-DELHI,197318,All
2023,12,AHMEDABAD,DELHI,101064,111445,AHMEDABAD-DELHI,212509,All
2024,1,AHMEDABAD,DELHI,103380,101995,AHMEDABAD-DELHI,205375,All
2024,2,AHMEDABAD,DELHI,100290,96690,AHMEDABAD-DELHI,196980,All
2024,3,AHMEDABAD,DELHI,103625,100916,AHMEDABAD-DELHI,204541,All
2024,4,AHMEDABAD,DELHI,99232,89403,AHMEDABAD-DELHI,188635,All
2024,6,AHMEDABAD,DELHI,88880,107715,AHMEDABAD-DELHI,196595,All
2024,7,AHMEDABAD,DELHI,100492,105290,AHMEDABAD-DELHI,205782,All
2024,8,AHMEDABAD,DELHI,108574,109233,AHMEDABAD-DELHI,217807,All
2024,9,AHMEDABAD,DELHI,107966,108505,AHMEDABAD-DELHI,216471,All
2024,10,AHMEDABAD,DELHI,114835,102872,AHMEDABAD-DELHI,217707,All
2024,11,AHMEDABAD,DELHI,100450,110857,AHMEDABAD-DELHI,211307,All
2024,12,AHMEDABAD,DELHI,103569,116025,AHMEDABAD-DELHI,219594,All
2025,1,AHMEDABAD,DELHI,114735,114058,AHMEDABAD-DELHI,228793,All
2025,2,AHMEDABAD,DELHI,108007,103177,AHMEDABAD-DELHI,211184,All
2025,3,AHMEDABAD,DELHI,109326,105085,AHMEDABAD-DELHI,214411,All
2015,4,AHMEDABAD,DIBRUGARH,418,386,AHMEDABAD-DIBRUGARH,804,All
2015,5,AHMEDABAD,DIBRUGARH,336,302,AHMEDABAD-DIBRUGARH,638,All
2015,6,AHMEDABAD,DIBRUGARH,343,429,AHMEDABAD-DIBRUGARH,772,All
2015,7,AHMEDABAD,DIBRUGARH,308,345,AHMEDABAD-DIBRUGARH,653,All
2015,8,AHMEDABAD,DIBRUGARH,293,292,AHMEDABAD-DIBRUGARH,585,All
2015,9,AHMEDABAD,DIBRUGARH,221,262,AHMEDABAD-DIBRUGARH,483,All
2015,10,AHMEDABAD,DIBRUGARH,297,288,AHMEDABAD-DIBRUGARH,585,All
2015,11,AHMEDABAD,DIBRUGARH,318,356,AHMEDABAD-DIBRUGARH,674,All
2015,12,AHMEDABAD,DIBRUGARH,339,395,AHMEDABAD-DIBRUGARH,734,All
2016,1,AHMEDABAD,DIBRUGARH,474,423,AHMEDABAD-DIBRUGARH,897,All
2016,2,AHMEDABAD,DIBRUGARH,339,318,AHMEDABAD-DIBRUGARH,657,All
2016,3,AHMEDABAD,DIBRUGARH,250,189,AHMEDABAD-DIBRUGARH,439,All
2024,12,AHMEDABAD,DIMAPUR,177,98,AHMEDABAD-DIMAPUR,275,All
2025,3,AHMEDABAD,DIMAPUR,132,84,AHMEDABAD-DIMAPUR,216,All
2018,2,AHMEDABAD,DIU,4,7,AHMEDABAD-DIU,11,All
2018,4,AHMEDABAD,DIU,10,8,AHMEDABAD-DIU,18,All
2018,5,AHMEDABAD,DIU,107,95,AHMEDABAD-DIU,202,All
2020,1,AHMEDABAD,DIU,92,114,AHMEDABAD-DIU,206,All
2020,3,AHMEDABAD,DIU,22,10,AHMEDABAD-DIU,32,All
2023,10,AHMEDABAD,DIU,52,102,AHMEDABAD-DIU,154,All
2023,11,AHMEDABAD,DIU,1215,1060,AHMEDABAD-DIU,2275,All
2023,12,AHMEDABAD,DIU,1500,1323,AHMEDABAD-DIU,2823,All
2024,1,AHMEDABAD,DIU,1576,1687,AHMEDABAD-DIU,3263,All
2024,2,AHMEDABAD,DIU,1306,1320,AHMEDABAD-DIU,2626,All
2024,3,AHMEDABAD,DIU,1667,1903,AHMEDABAD-DIU,3570,All
2024,4,AHMEDABAD,DIU,1231,1252,AHMEDABAD-DIU,2483,All
2024,6,AHMEDABAD,DIU,1430,1302,AHMEDABAD-DIU,2732,All
2024,7,AHMEDABAD,DIU,735,579,AHMEDABAD-DIU,1314,All
2024,8,AHMEDABAD,DIU,1713,1378,AHMEDABAD-DIU,3091,All
2024,9,AHMEDABAD,DIU,1542,1402,AHMEDABAD-DIU,2944,All
2024,10,AHMEDABAD,DIU,1840,1775,AHMEDABAD-DIU,3615,All
2024,11,AHMEDABAD,DIU,2027,1896,AHMEDABAD-DIU,3923,All
2024,12,AHMEDABAD,DIU,2051,1824,AHMEDABAD-DIU,3875,All
2025,1,AHMEDABAD,DIU,2087,2144,AHMEDABAD-DIU,4231,All
2025,2,AHMEDABAD,DIU,1828,1865,AHMEDABAD-DIU,3693,All
2025,3,AHMEDABAD,DIU,2082,2121,AHMEDABAD-DIU,4203,All
2022,3,AHMEDABAD,DURGAPUR,0,13,AHMEDABAD-DURGAPUR,13,All
2022,4,AHMEDABAD,DURGAPUR,46,193,AHMEDABAD-DURGAPUR,239,All
2022,5,AHMEDABAD,DURGAPUR,189,295,AHMEDABAD-DURGAPUR,484,All
2022,6,AHMEDABAD,DURGAPUR,167,328,AHMEDABAD-DURGAPUR,495,All
2022,7,AHMEDABAD,DURGAPUR,156,278,AHMEDABAD-DURGAPUR,434,All
2022,8,AHMEDABAD,DURGAPUR,114,178,AHMEDABAD-DURGAPUR,292,All
2022,9,AHMEDABAD,DURGAPUR,224,206,AHMEDABAD-DURGAPUR,430,All
2022,10,AHMEDABAD,DURGAPUR,291,275,AHMEDABAD-DURGAPUR,566,All
2022,11,AHMEDABAD,DURGAPUR,130,176,AHMEDABAD-DURGAPUR,306,All
2022,12,AHMEDABAD,DURGAPUR,124,130,AHMEDABAD-DURGAPUR,254,All
2023,1,AHMEDABAD,DURGAPUR,209,239,AHMEDABAD-DURGAPUR,448,All
2023,2,AHMEDABAD,DURGAPUR,146,179,AHMEDABAD-DURGAPUR,325,All
2023,3,AHMEDABAD,DURGAPUR,183,114,AHMEDABAD-DURGAPUR,297,All
2023,4,AHMEDABAD,DURGAPUR,202,112,AHMEDABAD-DURGAPUR,314,All
2023,5,AHMEDABAD,DURGAPUR,174,155,AHMEDABAD-DURGAPUR,329,All
2023,6,AHMEDABAD,DURGAPUR,147,195,AHMEDABAD-DURGAPUR,342,All
2023,7,AHMEDABAD,DURGAPUR,62,76,AHMEDABAD-DURGAPUR,138,All
2023,8,AHMEDABAD,DURGAPUR,57,68,AHMEDABAD-DURGAPUR,125,All
2023,9,AHMEDABAD,DURGAPUR,60,59,AHMEDABAD-DURGAPUR,119,All
2023,10,AHMEDABAD,DURGAPUR,169,131,AHMEDABAD-DURGAPUR,300,All
2023,11,AHMEDABAD,DURGAPUR,155,163,AHMEDABAD-DURGAPUR,318,All
2023,12,AHMEDABAD,DURGAPUR,187,376,AHMEDABAD-DURGAPUR,563,All
2024,1,AHMEDABAD,DURGAPUR,292,253,AHMEDABAD-DURGAPUR,545,All
2024,2,AHMEDABAD,DURGAPUR,391,312,AHMEDABAD-DURGAPUR,703,All
2024,3,AHMEDABAD,DURGAPUR,269,211,AHMEDABAD-DURGAPUR,480,All
2024,6,AHMEDABAD,DURGAPUR,131,158,AHMEDABAD-DURGAPUR,289,All
2024,7,AHMEDABAD,DURGAPUR,135,203,AHMEDABAD-DURGAPUR,338,All
2024,8,AHMEDABAD,DURGAPUR,123,112,AHMEDABAD-DURGAPUR,235,All
2024,9,AHMEDABAD,DURGAPUR,141,135,AHMEDABAD-DURGAPUR,276,All
2024,10,AHMEDABAD,DURGAPUR,183,279,AHMEDABAD-DURGAPUR,462,All
2024,11,AHMEDABAD,DURGAPUR,95,149,AHMEDABAD-DURGAPUR,244,All
2024,12,AHMEDABAD,DURGAPUR,99,181,AHMEDABAD-DURGAPUR,280,All
2025,3,AHMEDABAD,DURGAPUR,206,104,AHMEDABAD-DURGAPUR,310,All
2023,1,AHMEDABAD,DehraDun,4329,3932,AHMEDABAD-DehraDun,8261,All
2023,6,AHMEDABAD,DehraDun,4569,4804,AHMEDABAD-DehraDun,9373,All
2023,7,AHMEDABAD,DehraDun,4562,4139,AHMEDABAD-DehraDun,8701,All
2023,8,AHMEDABAD,DehraDun,4870,4443,AHMEDABAD-DehraDun,9313,All
2023,9,AHMEDABAD,DehraDun,4969,4783,AHMEDABAD-DehraDun,9752,All
2023,10,AHMEDABAD,DehraDun,5410,4930,AHMEDABAD-DehraDun,10340,All
2023,11,AHMEDABAD,DehraDun,5146,4116,AHMEDABAD-DehraDun,9262,All
2023,12,AHMEDABAD,DehraDun,5130,4585,AHMEDABAD-DehraDun,9715,All
2024,1,AHMEDABAD,DehraDun,5178,4070,AHMEDABAD-DehraDun,9248,All
2024,2,AHMEDABAD,DehraDun,4854,3795,AHMEDABAD-DehraDun,8649,All
2024,3,AHMEDABAD,DehraDun,5126,4165,AHMEDABAD-DehraDun,9291,All
2024,4,AHMEDABAD,DehraDun,5107,4141,AHMEDABAD-DehraDun,9248,All
2024,6,AHMEDABAD,DehraDun,5018,4517,AHMEDABAD-DehraDun,9535,All
2024,7,AHMEDABAD,DehraDun,4963,4019,AHMEDABAD-DehraDun,8982,All
2024,8,AHMEDABAD,DehraDun,5223,4047,AHMEDABAD-DehraDun,9270,All
2024,9,AHMEDABAD,DehraDun,5086,4218,AHMEDABAD-DehraDun,9304,All
2024,10,AHMEDABAD,DehraDun,4998,3859,AHMEDABAD-DehraDun,8857,All
2024,11,AHMEDABAD,DehraDun,5177,5163,AHMEDABAD-DehraDun,10340,All
2024,12,AHMEDABAD,DehraDun,5104,5026,AHMEDABAD-DehraDun,10130,All
2025,1,AHMEDABAD,DehraDun,5362,4628,AHMEDABAD-DehraDun,9990,All
2025,2,AHMEDABAD,DehraDun,4972,4171,AHMEDABAD-DehraDun,9143,All
2025,3,AHMEDABAD,DehraDun,5510,5144,AHMEDABAD-DehraDun,10654,All
2015,4,AHMEDABAD,GOA,4383,4549,AHMEDABAD-GOA,8932,All
2015,5,AHMEDABAD,GOA,5212,5230,AHMEDABAD-GOA,10442,All
2015,6,AHMEDABAD,GOA,4120,4576,AHMEDABAD-GOA,8696,All
2015,7,AHMEDABAD,GOA,4415,4414,AHMEDABAD-GOA,8829,All
2015,8,AHMEDABAD,GOA,4395,4412,AHMEDABAD-GOA,8807,All
2015,9,AHMEDABAD,GOA,4498,4414,AHMEDABAD-GOA,8912,All
2015,10,AHMEDABAD,GOA,4785,4835,AHMEDABAD-GOA,9620,All
2015,11,AHMEDABAD,GOA,8940,9094,AHMEDABAD-GOA,18034,All
2015,12,AHMEDABAD,GOA,9834,9164,AHMEDABAD-GOA,18998,All
2016,1,AHMEDABAD,GOA,9575,9379,AHMEDABAD-GOA,18954,All
2016,2,AHMEDABAD,GOA,8858,8850,AHMEDABAD-GOA,17708,All
2016,3,AHMEDABAD,GOA,8907,8790,AHMEDABAD-GOA,17697,All
2016,4,AHMEDABAD,GOA,6699,6557,AHMEDABAD-GOA,13256,All
2016,5,AHMEDABAD,GOA,4528,4195,AHMEDABAD-GOA,8723,All
2016,6,AHMEDABAD,GOA,2999,3543,AHMEDABAD-GOA,6542,All
2016,7,AHMEDABAD,GOA,3069,3143,AHMEDABAD-GOA,6212,All
2016,8,AHMEDABAD,GOA,3587,3554,AHMEDABAD-GOA,7141,All
2016,9,AHMEDABAD,GOA,3886,3826,AHMEDABAD-GOA,7712,All
2016,10,AHMEDABAD,GOA,6324,5874,AHMEDABAD-GOA,12198,All
2016,11,AHMEDABAD,GOA,10385,10833,AHMEDABAD-GOA,21218,All
2016,12,AHMEDABAD,GOA,13044,12884,AHMEDABAD-GOA,25928,All
2017,1,AHMEDABAD,GOA,13074,13802,AHMEDABAD-GOA,26876,All
2017,2,AHMEDABAD,GOA,11974,12219,AHMEDABAD-GOA,24193,All
2017,3,AHMEDABAD,GOA,13087,14137,AHMEDABAD-GOA,27224,All
2017,4,AHMEDABAD,GOA,12504,13917,AHMEDABAD-GOA,26421,All
2017,5,AHMEDABAD,GOA,15244,15484,AHMEDABAD-GOA,30728,All
2017,6,AHMEDABAD,GOA,12982,14883,AHMEDABAD-GOA,27865,All
2017,7,AHMEDABAD,GOA,13278,14597,AHMEDABAD-GOA,27875,All
2017,8,AHMEDABAD,GOA,13432,14117,AHMEDABAD-GOA,27549,All
2017,9,AHMEDABAD,GOA,12250,13363,AHMEDABAD-GOA,25613,All
2017,10,AHMEDABAD,GOA,13641,14421,AHMEDABAD-GOA,28062,All
2017,11,AHMEDABAD,GOA,12373,14008,AHMEDABAD-GOA,26381,All
2017,12,AHMEDABAD,GOA,13552,14122,AHMEDABAD-GOA,27674,All
2018,1,AHMEDABAD,GOA,14232,14969,AHMEDABAD-GOA,29201,All
2018,2,AHMEDABAD,GOA,13502,14336,AHMEDABAD-GOA,27838,All
2018,3,AHMEDABAD,GOA,11067,10589,AHMEDABAD-GOA,21656,All
2018,4,AHMEDABAD,GOA,12786,13199,AHMEDABAD-GOA,25985,All
2018,5,AHMEDABAD,GOA,15874,16138,AHMEDABAD-GOA,32012,All
2018,6,AHMEDABAD,GOA,17825,19229,AHMEDABAD-GOA,37054,All
2018,7,AHMEDABAD,GOA,18801,19645,AHMEDABAD-GOA,38446,All
2018,8,AHMEDABAD,GOA,17611,19338,AHMEDABAD-GOA,36949,All
2018,9,AHMEDABAD,GOA,17534,18656,AHMEDABAD-GOA,36190,All
2018,10,AHMEDABAD,GOA,14613,16280,AHMEDABAD-GOA,30893,All
2018,11,AHMEDABAD,GOA,17603,18091,AHMEDABAD-GOA,35694,All
2018,12,AHMEDABAD,GOA,17048,17527,AHMEDABAD-GOA,34575,All
2021,4,AHMEDABAD,GORAKHPUR,514,189,AHMEDABAD-GORAKHPUR,703,All
2021,10,AHMEDABAD,GORAKHPUR,1169,761,AHMEDABAD-GORAKHPUR,1930,All
2025,1,AHMEDABAD,GORAKHPUR,95,0,AHMEDABAD-GORAKHPUR,95,All
2015,4,AHMEDABAD,GUWAHATI,850,843,AHMEDABAD-GUWAHATI,1693,All
2015,5,AHMEDABAD,GUWAHATI,776,861,AHMEDABAD-GUWAHATI,1637,All
2015,6,AHMEDABAD,GUWAHATI,998,1025,AHMEDABAD-GUWAHATI,2023,All
2015,7,AHMEDABAD,GUWAHATI,1161,1340,AHMEDABAD-GUWAHATI,2501,All
2015,8,AHMEDABAD,GUWAHATI,955,1005,AHMEDABAD-GUWAHATI,1960,All
2015,9,AHMEDABAD,GUWAHATI,964,884,AHMEDABAD-GUWAHATI,1848,All
2015,10,AHMEDABAD,GUWAHATI,1016,1151,AHMEDABAD-GUWAHATI,2167,All
2015,11,AHMEDABAD,GUWAHATI,977,1040,AHMEDABAD-GUWAHATI,2017,All
2015,12,AHMEDABAD,GUWAHATI,859,948,AHMEDABAD-GUWAHATI,1807,All
2016,1,AHMEDABAD,GUWAHATI,952,1044,AHMEDABAD-GUWAHATI,1996,All
2016,2,AHMEDABAD,GUWAHATI,890,971,AHMEDABAD-GUWAHATI,1861,All
2016,3,AHMEDABAD,GUWAHATI,703,834,AHMEDABAD-GUWAHATI,1537,All
2016,4,AHMEDABAD,GUWAHATI,692,885,AHMEDABAD-GUWAHATI,1577,All
2016,5,AHMEDABAD,GUWAHATI,615,860,AHMEDABAD-GUWAHATI,1475,All
2016,6,AHMEDABAD,GUWAHATI,542,1120,AHMEDABAD-GUWAHATI,1662,All
2016,7,AHMEDABAD,GUWAHATI,535,591,AHMEDABAD-GUWAHATI,1126,All
2016,8,AHMEDABAD,GUWAHATI,391,287,AHMEDABAD-GUWAHATI,678,All
2016,9,AHMEDABAD,GUWAHATI,609,349,AHMEDABAD-GUWAHATI,958,All
2016,10,AHMEDABAD,GUWAHATI,762,228,AHMEDABAD-GUWAHATI,990,All
2016,11,AHMEDABAD,GUWAHATI,505,524,AHMEDABAD-GUWAHATI,1029,All
2016,12,AHMEDABAD,GUWAHATI,694,437,AHMEDABAD-GUWAHATI,1131,All
2017,1,AHMEDABAD,GUWAHATI,1188,846,AHMEDABAD-GUWAHATI,2034,All
2017,2,AHMEDABAD,GUWAHATI,967,734,AHMEDABAD-GUWAHATI,1701,All
2017,3,AHMEDABAD,GUWAHATI,1233,1136,AHMEDABAD-GUWAHATI,2369,All
2017,4,AHMEDABAD,GUWAHATI,1271,1072,AHMEDABAD-GUWAHATI,2343,All
2017,5,AHMEDABAD,GUWAHATI,1427,1275,AHMEDABAD-GUWAHATI,2702,All
2017,6,AHMEDABAD,GUWAHATI,1383,1463,AHMEDABAD-GUWAHATI,2846,All
2017,7,AHMEDABAD,GUWAHATI,939,872,AHMEDABAD-GUWAHATI,1811,All
2017,8,AHMEDABAD,GUWAHATI,621,827,AHMEDABAD-GUWAHATI,1448,All
2017,9,AHMEDABAD,GUWAHATI,670,747,AHMEDABAD-GUWAHATI,1417,All
2017,10,AHMEDABAD,GUWAHATI,1155,781,AHMEDABAD-GUWAHATI,1936,All
2017,11,AHMEDABAD,GUWAHATI,493,531,AHMEDABAD-GUWAHATI,1024,All
2017,12,AHMEDABAD,GUWAHATI,445,344,AHMEDABAD-GUWAHATI,789,All
2018,1,AHMEDABAD,GUWAHATI,394,125,AHMEDABAD-GUWAHATI,519,All
2018,2,AHMEDABAD,GUWAHATI,403,261,AHMEDABAD-GUWAHATI,664,All
2018,3,AHMEDABAD,GUWAHATI,552,376,AHMEDABAD-GUWAHATI,928,All
2018,12,AHMEDABAD,GUWAHATI,1661,1171,AHMEDABAD-GUWAHATI,2832,All
2019,1,AHMEDABAD,GUWAHATI,3382,3611,AHMEDABAD-GUWAHATI,6993,All
2019,2,AHMEDABAD,GUWAHATI,3293,3006,AHMEDABAD-GUWAHATI,6299,All
2019,3,AHMEDABAD,GUWAHATI,2023,1700,AHMEDABAD-GUWAHATI,3723,All
2019,7,AHMEDABAD,GUWAHATI,2587,3137,AHMEDABAD-GUWAHATI,5724,All
2019,8,AHMEDABAD,GUWAHATI,3135,3304,AHMEDABAD-GUWAHATI,6439,All
2019,9,AHMEDABAD,GUWAHATI,3508,3378,AHMEDABAD-GUWAHATI,6886,All
2019,10,AHMEDABAD,GUWAHATI,4508,3887,AHMEDABAD-GUWAHATI,8395,All
2019,11,AHMEDABAD,GUWAHATI,3474,3555,AHMEDABAD-GUWAHATI,7029,All
2019,12,AHMEDABAD,GUWAHATI,4485,3260,AHMEDABAD-GUWAHATI,7745,All
2020,1,AHMEDABAD,GUWAHATI,4835,4075,AHMEDABAD-GUWAHATI,8910,All
2020,2,AHMEDABAD,GUWAHATI,4023,3019,AHMEDABAD-GUWAHATI,7042,All
2020,3,AHMEDABAD,GUWAHATI,3918,2139,AHMEDABAD-GUWAHATI,6057,All
2020,12,AHMEDABAD,GUWAHATI,980,956,AHMEDABAD-GUWAHATI,1936,All
2021,1,AHMEDABAD,GUWAHATI,1342,1492,AHMEDABAD-GUWAHATI,2834,All
2021,2,AHMEDABAD,GUWAHATI,1466,1842,AHMEDABAD-GUWAHATI,3308,All
2021,3,AHMEDABAD,GUWAHATI,2302,1602,AHMEDABAD-GUWAHATI,3904,All
2021,4,AHMEDABAD,GUWAHATI,2369,1510,AHMEDABAD-GUWAHATI,3879,All
2021,6,AHMEDABAD,GUWAHATI,623,998,AHMEDABAD-GUWAHATI,1621,All
2021,7,AHMEDABAD,GUWAHATI,567,810,AHMEDABAD-GUWAHATI,1377,All
2021,8,AHMEDABAD,GUWAHATI,392,665,AHMEDABAD-GUWAHATI,1057,All
2021,9,AHMEDABAD,GUWAHATI,456,569,AHMEDABAD-GUWAHATI,1025,All
2021,10,AHMEDABAD,GUWAHATI,706,722,AHMEDABAD-GUWAHATI,1428,All
2021,11,AHMEDABAD,GUWAHATI,0,1050,AHMEDABAD-GUWAHATI,1050,All
2021,12,AHMEDABAD,GUWAHATI,0,1333,AHMEDABAD-GUWAHATI,1333,All
2022,1,AHMEDABAD,GUWAHATI,0,362,AHMEDABAD-GUWAHATI,362,All
2022,4,AHMEDABAD,GUWAHATI,177,209,AHMEDABAD-GUWAHATI,386,All
2022,5,AHMEDABAD,GUWAHATI,1193,967,AHMEDABAD-GUWAHATI,2160,All
2022,6,AHMEDABAD,GUWAHATI,852,828,AHMEDABAD-GUWAHATI,1680,All
2022,7,AHMEDABAD,GUWAHATI,705,675,AHMEDABAD-GUWAHATI,1380,All
2022,8,AHMEDABAD,GUWAHATI,866,904,AHMEDABAD-GUWAHATI,1770,All
2022,9,AHMEDABAD,GUWAHATI,714,632,AHMEDABAD-GUWAHATI,1346,All
2022,10,AHMEDABAD,GUWAHATI,575,712,AHMEDABAD-GUWAHATI,1287,All
2024,2,AHMEDABAD,GUWAHATI,0,0,AHMEDABAD-GUWAHATI,0,All
2024,12,AHMEDABAD,GUWAHATI,3710,3501,AHMEDABAD-GUWAHATI,7211,All
2025,1,AHMEDABAD,GUWAHATI,5178,5061,AHMEDABAD-GUWAHATI,10239,All
2025,2,AHMEDABAD,GUWAHATI,4752,4484,AHMEDABAD-GUWAHATI,9236,All
2025,3,AHMEDABAD,GUWAHATI,5241,4850,AHMEDABAD-GUWAHATI,10091,All
2020,12,AHMEDABAD,GWALIOR,190,258,AHMEDABAD-GWALIOR,448,All
2021,1,AHMEDABAD,GWALIOR,676,873,AHMEDABAD-GWALIOR,1549,All
2021,2,AHMEDABAD,GWALIOR,833,868,AHMEDABAD-GWALIOR,1701,All
2021,3,AHMEDABAD,GWALIOR,751,660,AHMEDABAD-GWALIOR,1411,All
2021,7,AHMEDABAD,GWALIOR,519,506,AHMEDABAD-GWALIOR,1025,All
2021,8,AHMEDABAD,GWALIOR,1303,1190,AHMEDABAD-GWALIOR,2493,All
2021,9,AHMEDABAD,GWALIOR,971,928,AHMEDABAD-GWALIOR,1899,All
2021,10,AHMEDABAD,GWALIOR,1264,879,AHMEDABAD-GWALIOR,2143,All
2021,11,AHMEDABAD,GWALIOR,2068,1947,AHMEDABAD-GWALIOR,4015,All
2021,12,AHMEDABAD,GWALIOR,2000,2165,AHMEDABAD-GWALIOR,4165,All
2022,1,AHMEDABAD,GWALIOR,1192,1044,AHMEDABAD-GWALIOR,2236,All
2022,2,AHMEDABAD,GWALIOR,1600,1502,AHMEDABAD-GWALIOR,3102,All
2022,3,AHMEDABAD,GWALIOR,1586,1567,AHMEDABAD-GWALIOR,3153,All
2022,4,AHMEDABAD,GWALIOR,1856,1826,AHMEDABAD-GWALIOR,3682,All
2022,5,AHMEDABAD,GWALIOR,1214,1240,AHMEDABAD-GWALIOR,2454,All
2022,6,AHMEDABAD,GWALIOR,853,1095,AHMEDABAD-GWALIOR,1948,All
2022,7,AHMEDABAD,GWALIOR,933,924,AHMEDABAD-GWALIOR,1857,All
2022,8,AHMEDABAD,GWALIOR,743,762,AHMEDABAD-GWALIOR,1505,All
2024,2,AHMEDABAD,GWALIOR,472,389,AHMEDABAD-GWALIOR,861,All
2024,3,AHMEDABAD,GWALIOR,581,463,AHMEDABAD-GWALIOR,1044,All
2024,4,AHMEDABAD,GWALIOR,692,627,AHMEDABAD-GWALIOR,1319,All
2024,6,AHMEDABAD,GWALIOR,281,455,AHMEDABAD-GWALIOR,736,All
2024,7,AHMEDABAD,GWALIOR,501,482,AHMEDABAD-GWALIOR,983,All
2024,8,AHMEDABAD,GWALIOR,104,64,AHMEDABAD-GWALIOR,168,All
2024,10,AHMEDABAD,GWALIOR,162,17,AHMEDABAD-GWALIOR,179,All
2024,11,AHMEDABAD,GWALIOR,603,707,AHMEDABAD-GWALIOR,1310,All
2024,12,AHMEDABAD,GWALIOR,787,828,AHMEDABAD-GWALIOR,1615,All
2025,1,AHMEDABAD,GWALIOR,363,325,AHMEDABAD-GWALIOR,688,All
2023,11,AHMEDABAD,Goa,13445,12127,AHMEDABAD-Goa,25572,All
2023,12,AHMEDABAD,Goa,14664,13083,AHMEDABAD-Goa,27747,All
2024,1,AHMEDABAD,Goa,14827,15679,AHMEDABAD-Goa,30506,All
2024,2,AHMEDABAD,Goa,8342,8151,AHMEDABAD-Goa,16493,All
2024,3,AHMEDABAD,Goa,11720,10955,AHMEDABAD-Goa,22675,All
2024,4,AHMEDABAD,Goa,11863,10808,AHMEDABAD-Goa,22671,All
2024,6,AHMEDABAD,Goa,13551,14090,AHMEDABAD-Goa,27641,All
2024,7,AHMEDABAD,Goa,12308,12751,AHMEDABAD-Goa,25059,All
2024,8,AHMEDABAD,Goa,12779,12541,AHMEDABAD-Goa,25320,All
2024,9,AHMEDABAD,Goa,4441,4237,AHMEDABAD-Goa,8678,All
2024,10,AHMEDABAD,Goa,4951,4701,AHMEDABAD-Goa,9652,All
2024,11,AHMEDABAD,Goa,11470,10899,AHMEDABAD-Goa,22369,All
2024,12,AHMEDABAD,Goa,10532,9254,AHMEDABAD-Goa,19786,All
2025,1,AHMEDABAD,Goa,16124,16496,AHMEDABAD-Goa,32620,All
2025,2,AHMEDABAD,Goa,15273,14690,AHMEDABAD-Goa,29963,All
2025,3,AHMEDABAD,Goa,19677,18238,AHMEDABAD-Goa,37915,All
2018,7,AHMEDABAD,HUBLI,2411,2627,AHMEDABAD-HUBLI,5038,All
2018,8,AHMEDABAD,HUBLI,2176,2370,AHMEDABAD-HUBLI,4546,All
2018,9,AHMEDABAD,HUBLI,2156,2432,AHMEDABAD-HUBLI,4588,All
2018,10,AHMEDABAD,HUBLI,2832,2973,AHMEDABAD-HUBLI,5805,All
2018,11,AHMEDABAD,HUBLI,4369,4114,AHMEDABAD-HUBLI,8483,All
2018,12,AHMEDABAD,HUBLI,4503,4342,AHMEDABAD-HUBLI,8845,All
2019,1,AHMEDABAD,HUBLI,4617,4786,AHMEDABAD-HUBLI,9403,All
2019,2,AHMEDABAD,HUBLI,4657,4648,AHMEDABAD-HUBLI,9305,All
2019,3,AHMEDABAD,HUBLI,4724,4822,AHMEDABAD-HUBLI,9546,All
2019,4,AHMEDABAD,HUBLI,4283,4929,AHMEDABAD-HUBLI,9212,All
2019,5,AHMEDABAD,HUBLI,5268,4482,AHMEDABAD-HUBLI,9750,All
2019,6,AHMEDABAD,HUBLI,4334,4122,AHMEDABAD-HUBLI,8456,All
2019,7,AHMEDABAD,HUBLI,3424,3418,AHMEDABAD-HUBLI,6842,All
2019,9,AHMEDABAD,HUBLI,2926,3628,AHMEDABAD-HUBLI,6554,All
2019,10,AHMEDABAD,HUBLI,4604,3813,AHMEDABAD-HUBLI,8417,All
2019,11,AHMEDABAD,HUBLI,4209,5256,AHMEDABAD-HUBLI,9465,All
2019,12,AHMEDABAD,HUBLI,5275,4474,AHMEDABAD-HUBLI,9749,All
2020,1,AHMEDABAD,HUBLI,5109,5041,AHMEDABAD-HUBLI,10150,All
2020,2,AHMEDABAD,HUBLI,4613,4802,AHMEDABAD-HUBLI,9415,All
2020,3,AHMEDABAD,HUBLI,3453,3351,AHMEDABAD-HUBLI,6804,All
2021,1,AHMEDABAD,HUBLI,901,1132,AHMEDABAD-HUBLI,2033,All
2021,2,AHMEDABAD,HUBLI,1492,1645,AHMEDABAD-HUBLI,3137,All
2021,3,AHMEDABAD,HUBLI,1594,1517,AHMEDABAD-HUBLI,3111,All
2021,4,AHMEDABAD,HUBLI,482,682,AHMEDABAD-HUBLI,1164,All
2015,4,AHMEDABAD,HYDERABAD,9474,8894,AHMEDABAD-HYDERABAD,18368,All
2015,5,AHMEDABAD,HYDERABAD,9959,8793,AHMEDABAD-HYDERABAD,18752,All
2015,6,AHMEDABAD,HYDERABAD,8027,7370,AHMEDABAD-HYDERABAD,15397,All
2015,7,AHMEDABAD,HYDERABAD,11018,10069,AHMEDABAD-HYDERABAD,21087,All
2015,8,AHMEDABAD,HYDERABAD,11123,10966,AHMEDABAD-HYDERABAD,22089,All
2015,9,AHMEDABAD,HYDERABAD,10844,11075,AHMEDABAD-HYDERABAD,21919,All
2015,10,AHMEDABAD,HYDERABAD,10818,10643,AHMEDABAD-HYDERABAD,21461,All
2015,11,AHMEDABAD,HYDERABAD,9818,9588,AHMEDABAD-HYDERABAD,19406,All
2015,12,AHMEDABAD,HYDERABAD,9854,9202,AHMEDABAD-HYDERABAD,19056,All
2016,1,AHMEDABAD,HYDERABAD,9736,9100,AHMEDABAD-HYDERABAD,18836,All
2016,2,AHMEDABAD,HYDERABAD,9323,8696,AHMEDABAD-HYDERABAD,18019,All
2016,3,AHMEDABAD,HYDERABAD,9619,9435,AHMEDABAD-HYDERABAD,19054,All
2016,4,AHMEDABAD,HYDERABAD,9487,9191,AHMEDABAD-HYDERABAD,18678,All
2016,5,AHMEDABAD,HYDERABAD,11066,10641,AHMEDABAD-HYDERABAD,21707,All
2016,6,AHMEDABAD,HYDERABAD,14653,13647,AHMEDABAD-HYDERABAD,28300,All
2016,7,AHMEDABAD,HYDERABAD,16134,14819,AHMEDABAD-HYDERABAD,30953,All
2016,8,AHMEDABAD,HYDERABAD,18698,18447,AHMEDABAD-HYDERABAD,37145,All
2016,9,AHMEDABAD,HYDERABAD,16103,15500,AHMEDABAD-HYDERABAD,31603,All
2016,10,AHMEDABAD,HYDERABAD,18536,16662,AHMEDABAD-HYDERABAD,35198,All
2016,11,AHMEDABAD,HYDERABAD,19201,21337,AHMEDABAD-HYDERABAD,40538,All
2016,12,AHMEDABAD,HYDERABAD,19167,19221,AHMEDABAD-HYDERABAD,38388,All
2017,1,AHMEDABAD,HYDERABAD,14646,14388,AHMEDABAD-HYDERABAD,29034,All
2017,2,AHMEDABAD,HYDERABAD,15631,18098,AHMEDABAD-HYDERABAD,33729,All
2017,3,AHMEDABAD,HYDERABAD,17335,17221,AHMEDABAD-HYDERABAD,34556,All
2017,4,AHMEDABAD,HYDERABAD,19360,21679,AHMEDABAD-HYDERABAD,41039,All
2017,5,AHMEDABAD,HYDERABAD,20691,18898,AHMEDABAD-HYDERABAD,39589,All
2017,6,AHMEDABAD,HYDERABAD,18131,17519,AHMEDABAD-HYDERABAD,35650,All
2017,7,AHMEDABAD,HYDERABAD,17824,15948,AHMEDABAD-HYDERABAD,33772,All
2017,8,AHMEDABAD,HYDERABAD,17978,17762,AHMEDABAD-HYDERABAD,35740,All
2017,9,AHMEDABAD,HYDERABAD,16270,17570,AHMEDABAD-HYDERABAD,33840,All
2017,10,AHMEDABAD,HYDERABAD,19252,17868,AHMEDABAD-HYDERABAD,37120,All
2017,11,AHMEDABAD,HYDERABAD,18371,18285,AHMEDABAD-HYDERABAD,36656,All
2017,12,AHMEDABAD,HYDERABAD,27506,26698,AHMEDABAD-HYDERABAD,54204,All
2018,1,AHMEDABAD,HYDERABAD,26720,26032,AHMEDABAD-HYDERABAD,52752,All
2018,2,AHMEDABAD,HYDERABAD,24853,24323,AHMEDABAD-HYDERABAD,49176,All
2018,3,AHMEDABAD,HYDERABAD,19305,19137,AHMEDABAD-HYDERABAD,38442,All
2018,4,AHMEDABAD,HYDERABAD,23559,24707,AHMEDABAD-HYDERABAD,48266,All
2018,5,AHMEDABAD,HYDERABAD,29989,26905,AHMEDABAD-HYDERABAD,56894,All
2018,6,AHMEDABAD,HYDERABAD,29831,30014,AHMEDABAD-HYDERABAD,59845,All
2018,7,AHMEDABAD,HYDERABAD,30581,30326,AHMEDABAD-HYDERABAD,60907,All
2018,8,AHMEDABAD,HYDERABAD,28392,29490,AHMEDABAD-HYDERABAD,57882,All
2018,9,AHMEDABAD,HYDERABAD,31824,33012,AHMEDABAD-HYDERABAD,64836,All
2018,10,AHMEDABAD,HYDERABAD,28227,30486,AHMEDABAD-HYDERABAD,58713,All
2018,11,AHMEDABAD,HYDERABAD,28293,31085,AHMEDABAD-HYDERABAD,59378,All
2018,12,AHMEDABAD,HYDERABAD,33568,33410,AHMEDABAD-HYDERABAD,66978,All
2019,1,AHMEDABAD,HYDERABAD,35967,36151,AHMEDABAD-HYDERABAD,72118,All
2019,2,AHMEDABAD,HYDERABAD,31931,32377,AHMEDABAD-HYDERABAD,64308,All
2019,3,AHMEDABAD,HYDERABAD,33528,34003,AHMEDABAD-HYDERABAD,67531,All
2019,4,AHMEDABAD,HYDERABAD,27757,30550,AHMEDABAD-HYDERABAD,58307,All
2019,5,AHMEDABAD,HYDERABAD,28957,27345,AHMEDABAD-HYDERABAD,56302,All
2019,6,AHMEDABAD,HYDERABAD,27714,25925,AHMEDABAD-HYDERABAD,53639,All
2019,7,AHMEDABAD,HYDERABAD,28453,27969,AHMEDABAD-HYDERABAD,56422,All
2019,8,AHMEDABAD,HYDERABAD,27681,28157,AHMEDABAD-HYDERABAD,55838,All
2019,9,AHMEDABAD,HYDERABAD,24537,21818,AHMEDABAD-HYDERABAD,46355,All
2019,10,AHMEDABAD,HYDERABAD,28340,27093,AHMEDABAD-HYDERABAD,55433,All
2019,11,AHMEDABAD,HYDERABAD,28655,32446,AHMEDABAD-HYDERABAD,61101,All
2019,12,AHMEDABAD,HYDERABAD,26330,30560,AHMEDABAD-HYDERABAD,56890,All
2020,1,AHMEDABAD,HYDERABAD,28265,30273,AHMEDABAD-HYDERABAD,58538,All
2020,2,AHMEDABAD,HYDERABAD,20605,24969,AHMEDABAD-HYDERABAD,45574,All
2020,3,AHMEDABAD,HYDERABAD,18528,20915,AHMEDABAD-HYDERABAD,39443,All
2020,5,AHMEDABAD,HYDERABAD,834,448,AHMEDABAD-HYDERABAD,1282,All
2020,6,AHMEDABAD,HYDERABAD,8588,7626,AHMEDABAD-HYDERABAD,16214,All
2020,7,AHMEDABAD,HYDERABAD,9773,10382,AHMEDABAD-HYDERABAD,20155,All
2020,8,AHMEDABAD,HYDERABAD,11518,12896,AHMEDABAD-HYDERABAD,24414,All
2020,9,AHMEDABAD,HYDERABAD,14652,13413,AHMEDABAD-HYDERABAD,28065,All
2020,10,AHMEDABAD,HYDERABAD,16266,14595,AHMEDABAD-HYDERABAD,30861,All
2020,11,AHMEDABAD,HYDERABAD,15869,18462,AHMEDABAD-HYDERABAD,34331,All
2020,12,AHMEDABAD,HYDERABAD,17451,16766,AHMEDABAD-HYDERABAD,34217,All
2021,1,AHMEDABAD,HYDERABAD,16259,16139,AHMEDABAD-HYDERABAD,32398,All
2021,2,AHMEDABAD,HYDERABAD,17300,16036,AHMEDABAD-HYDERABAD,33336,All
2021,3,AHMEDABAD,HYDERABAD,15845,14757,AHMEDABAD-HYDERABAD,30602,All
2021,4,AHMEDABAD,HYDERABAD,7604,9836,AHMEDABAD-HYDERABAD,17440,All
2021,6,AHMEDABAD,HYDERABAD,9681,9687,AHMEDABAD-HYDERABAD,19368,All
2021,7,AHMEDABAD,HYDERABAD,10541,11474,AHMEDABAD-HYDERABAD,22015,All
2021,8,AHMEDABAD,HYDERABAD,11581,11243,AHMEDABAD-HYDERABAD,22824,All
2021,9,AHMEDABAD,HYDERABAD,11859,11437,AHMEDABAD-HYDERABAD,23296,All
2021,10,AHMEDABAD,HYDERABAD,15087,13062,AHMEDABAD-HYDERABAD,28149,All
2021,11,AHMEDABAD,HYDERABAD,15735,15798,AHMEDABAD-HYDERABAD,31533,All
2021,12,AHMEDABAD,HYDERABAD,16275,16238,AHMEDABAD-HYDERABAD,32513,All
2022,1,AHMEDABAD,HYDERABAD,12050,12707,AHMEDABAD-HYDERABAD,24757,All
2022,2,AHMEDABAD,HYDERABAD,13507,13245,AHMEDABAD-HYDERABAD,26752,All
2022,3,AHMEDABAD,HYDERABAD,16442,16362,AHMEDABAD-HYDERABAD,32804,All
2022,4,AHMEDABAD,HYDERABAD,16018,15616,AHMEDABAD-HYDERABAD,31634,All
2022,5,AHMEDABAD,HYDERABAD,16814,15196,AHMEDABAD-HYDERABAD,32010,All
2022,6,AHMEDABAD,HYDERABAD,14151,14061,AHMEDABAD-HYDERABAD,28212,All
2022,7,AHMEDABAD,HYDERABAD,12759,12132,AHMEDABAD-HYDERABAD,24891,All
2022,8,AHMEDABAD,HYDERABAD,13836,13757,AHMEDABAD-HYDERABAD,27593,All
2022,9,AHMEDABAD,HYDERABAD,13266,14265,AHMEDABAD-HYDERABAD,27531,All
2022,10,AHMEDABAD,HYDERABAD,16815,14355,AHMEDABAD-HYDERABAD,31170,All
2022,11,AHMEDABAD,HYDERABAD,19827,21808,AHMEDABAD-HYDERABAD,41635,All
2022,12,AHMEDABAD,HYDERABAD,20088,18920,AHMEDABAD-HYDERABAD,39008,All
2023,1,AHMEDABAD,HYDERABAD,22172,21117,AHMEDABAD-HYDERABAD,43289,All
2023,2,AHMEDABAD,HYDERABAD,24061,22508,AHMEDABAD-HYDERABAD,46569,All
2023,3,AHMEDABAD,HYDERABAD,23307,22042,AHMEDABAD-HYDERABAD,45349,All
2023,4,AHMEDABAD,HYDERABAD,24616,26114,AHMEDABAD-HYDERABAD,50730,All
2023,5,AHMEDABAD,HYDERABAD,33343,30394,AHMEDABAD-HYDERABAD,63737,All
2023,6,AHMEDABAD,HYDERABAD,19429,18479,AHMEDABAD-HYDERABAD,37908,All
2023,7,AHMEDABAD,HYDERABAD,16404,16473,AHMEDABAD-HYDERABAD,32877,All
2023,8,AHMEDABAD,HYDERABAD,16400,16787,AHMEDABAD-HYDERABAD,33187,All
2023,9,AHMEDABAD,HYDERABAD,19701,19986,AHMEDABAD-HYDERABAD,39687,All
2023,10,AHMEDABAD,HYDERABAD,17711,17448,AHMEDABAD-HYDERABAD,35159,All
2023,11,AHMEDABAD,HYDERABAD,19051,18075,AHMEDABAD-HYDERABAD,37126,All
2023,12,AHMEDABAD,HYDERABAD,19970,19247,AHMEDABAD-HYDERABAD,39217,All
2024,1,AHMEDABAD,HYDERABAD,17950,17622,AHMEDABAD-HYDERABAD,35572,All
2024,2,AHMEDABAD,HYDERABAD,17189,16486,AHMEDABAD-HYDERABAD,33675,All
2024,3,AHMEDABAD,HYDERABAD,18741,17985,AHMEDABAD-HYDERABAD,36726,All
2024,4,AHMEDABAD,HYDERABAD,16928,17751,AHMEDABAD-HYDERABAD,34679,All
2024,6,AHMEDABAD,HYDERABAD,17964,15920,AHMEDABAD-HYDERABAD,33884,All
2024,7,AHMEDABAD,HYDERABAD,18363,17816,AHMEDABAD-HYDERABAD,36179,All
2024,8,AHMEDABAD,HYDERABAD,19710,19178,AHMEDABAD-HYDERABAD,38888,All
2024,9,AHMEDABAD,HYDERABAD,17912,18374,AHMEDABAD-HYDERABAD,36286,All
2024,10,AHMEDABAD,HYDERABAD,24823,21027,AHMEDABAD-HYDERABAD,45850,All
2024,11,AHMEDABAD,HYDERABAD,23752,23251,AHMEDABAD-HYDERABAD,47003,All
2024,12,AHMEDABAD,HYDERABAD,25527,22805,AHMEDABAD-HYDERABAD,48332,All
2025,1,AHMEDABAD,HYDERABAD,27134,24046,AHMEDABAD-HYDERABAD,51180,All
2025,2,AHMEDABAD,HYDERABAD,24219,21570,AHMEDABAD-HYDERABAD,45789,All
2025,3,AHMEDABAD,HYDERABAD,26053,24094,AHMEDABAD-HYDERABAD,50147,All
2015,4,AHMEDABAD,IMPHAL,0,21,AHMEDABAD-IMPHAL,21,All
2015,5,AHMEDABAD,IMPHAL,0,96,AHMEDABAD-IMPHAL,96,All
2015,6,AHMEDABAD,IMPHAL,0,99,AHMEDABAD-IMPHAL,99,All
2015,7,AHMEDABAD,IMPHAL,0,113,AHMEDABAD-IMPHAL,113,All
2015,8,AHMEDABAD,IMPHAL,0,77,AHMEDABAD-IMPHAL,77,All
2015,9,AHMEDABAD,IMPHAL,0,70,AHMEDABAD-IMPHAL,70,All
2015,10,AHMEDABAD,IMPHAL,0,48,AHMEDABAD-IMPHAL,48,All
2015,11,AHMEDABAD,IMPHAL,0,82,AHMEDABAD-IMPHAL,82,All
2015,12,AHMEDABAD,IMPHAL,0,116,AHMEDABAD-IMPHAL,116,All
2016,1,AHMEDABAD,IMPHAL,0,102,AHMEDABAD-IMPHAL,102,All
2016,2,AHMEDABAD,IMPHAL,0,91,AHMEDABAD-IMPHAL,91,All
2016,3,AHMEDABAD,IMPHAL,0,70,AHMEDABAD-IMPHAL,70,All
2016,4,AHMEDABAD,IMPHAL,0,56,AHMEDABAD-IMPHAL,56,All
2017,5,AHMEDABAD,IMPHAL,0,5,AHMEDABAD-IMPHAL,5,All
2017,6,AHMEDABAD,IMPHAL,0,35,AHMEDABAD-IMPHAL,35,All
2017,7,AHMEDABAD,IMPHAL,0,22,AHMEDABAD-IMPHAL,22,All
2017,8,AHMEDABAD,IMPHAL,0,66,AHMEDABAD-IMPHAL,66,All
2017,9,AHMEDABAD,IMPHAL,0,45,AHMEDABAD-IMPHAL,45,All
2017,10,AHMEDABAD,IMPHAL,0,55,AHMEDABAD-IMPHAL,55,All
2017,11,AHMEDABAD,IMPHAL,0,41,AHMEDABAD-IMPHAL,41,All
2017,12,AHMEDABAD,IMPHAL,0,63,AHMEDABAD-IMPHAL,63,All
2018,1,AHMEDABAD,IMPHAL,0,70,AHMEDABAD-IMPHAL,70,All
2018,2,AHMEDABAD,IMPHAL,0,61,AHMEDABAD-IMPHAL,61,All
2018,4,AHMEDABAD,IMPHAL,0,20,AHMEDABAD-IMPHAL,20,All
2018,5,AHMEDABAD,IMPHAL,0,90,AHMEDABAD-IMPHAL,90,All
2018,6,AHMEDABAD,IMPHAL,0,265,AHMEDABAD-IMPHAL,265,All
2018,7,AHMEDABAD,IMPHAL,0,137,AHMEDABAD-IMPHAL,137,All
2018,8,AHMEDABAD,IMPHAL,0,67,AHMEDABAD-IMPHAL,67,All
2018,9,AHMEDABAD,IMPHAL,0,70,AHMEDABAD-IMPHAL,70,All
2018,10,AHMEDABAD,IMPHAL,0,122,AHMEDABAD-IMPHAL,122,All
2018,11,AHMEDABAD,IMPHAL,0,121,AHMEDABAD-IMPHAL,121,All
2018,12,AHMEDABAD,IMPHAL,0,184,AHMEDABAD-IMPHAL,184,All
2019,1,AHMEDABAD,IMPHAL,0,165,AHMEDABAD-IMPHAL,165,All
2019,2,AHMEDABAD,IMPHAL,0,120,AHMEDABAD-IMPHAL,120,All
2019,3,AHMEDABAD,IMPHAL,0,135,AHMEDABAD-IMPHAL,135,All
2019,4,AHMEDABAD,IMPHAL,0,176,AHMEDABAD-IMPHAL,176,All
2019,5,AHMEDABAD,IMPHAL,0,129,AHMEDABAD-IMPHAL,129,All
2019,6,AHMEDABAD,IMPHAL,0,413,AHMEDABAD-IMPHAL,413,All
2019,7,AHMEDABAD,IMPHAL,0,114,AHMEDABAD-IMPHAL,114,All
2019,8,AHMEDABAD,IMPHAL,0,125,AHMEDABAD-IMPHAL,125,All
2019,9,AHMEDABAD,IMPHAL,0,145,AHMEDABAD-IMPHAL,145,All
2019,10,AHMEDABAD,IMPHAL,0,172,AHMEDABAD-IMPHAL,172,All
2019,11,AHMEDABAD,IMPHAL,0,183,AHMEDABAD-IMPHAL,183,All
2019,12,AHMEDABAD,IMPHAL,0,210,AHMEDABAD-IMPHAL,210,All
2020,1,AHMEDABAD,IMPHAL,0,207,AHMEDABAD-IMPHAL,207,All
2020,2,AHMEDABAD,IMPHAL,0,188,AHMEDABAD-IMPHAL,188,All
2020,3,AHMEDABAD,IMPHAL,0,73,AHMEDABAD-IMPHAL,73,All
2015,4,AHMEDABAD,INDORE,103,167,AHMEDABAD-INDORE,270,All
2015,5,AHMEDABAD,INDORE,537,737,AHMEDABAD-INDORE,1274,All
2015,6,AHMEDABAD,INDORE,434,661,AHMEDABAD-INDORE,1095,All
2015,7,AHMEDABAD,INDORE,436,674,AHMEDABAD-INDORE,1110,All
2015,8,AHMEDABAD,INDORE,549,768,AHMEDABAD-INDORE,1317,All
2015,9,AHMEDABAD,INDORE,439,648,AHMEDABAD-INDORE,1087,All
2015,10,AHMEDABAD,INDORE,807,947,AHMEDABAD-INDORE,1754,All
2015,11,AHMEDABAD,INDORE,2017,2409,AHMEDABAD-INDORE,4426,All
2015,12,AHMEDABAD,INDORE,2880,3420,AHMEDABAD-INDORE,6300,All
2016,1,AHMEDABAD,INDORE,2901,3470,AHMEDABAD-INDORE,6371,All
2016,2,AHMEDABAD,INDORE,2652,3102,AHMEDABAD-INDORE,5754,All
2016,3,AHMEDABAD,INDORE,2468,2870,AHMEDABAD-INDORE,5338,All
2016,4,AHMEDABAD,INDORE,1212,1273,AHMEDABAD-INDORE,2485,All
2017,7,AHMEDABAD,INDORE,526,486,AHMEDABAD-INDORE,1012,All
2017,8,AHMEDABAD,INDORE,1217,1212,AHMEDABAD-INDORE,2429,All
2017,9,AHMEDABAD,INDORE,1041,959,AHMEDABAD-INDORE,2000,All
2017,10,AHMEDABAD,INDORE,1207,1049,AHMEDABAD-INDORE,2256,All
2017,11,AHMEDABAD,INDORE,1502,1439,AHMEDABAD-INDORE,2941,All
2017,12,AHMEDABAD,INDORE,1632,1642,AHMEDABAD-INDORE,3274,All
2018,1,AHMEDABAD,INDORE,1467,1474,AHMEDABAD-INDORE,2941,All
2018,2,AHMEDABAD,INDORE,1463,1433,AHMEDABAD-INDORE,2896,All
2018,3,AHMEDABAD,INDORE,1626,1562,AHMEDABAD-INDORE,3188,All
2018,4,AHMEDABAD,INDORE,1647,1493,AHMEDABAD-INDORE,3140,All
2018,5,AHMEDABAD,INDORE,1624,1589,AHMEDABAD-INDORE,3213,All
2018,6,AHMEDABAD,INDORE,1466,1367,AHMEDABAD-INDORE,2833,All
2018,7,AHMEDABAD,INDORE,1454,1385,AHMEDABAD-INDORE,2839,All
2018,8,AHMEDABAD,INDORE,1482,1337,AHMEDABAD-INDORE,2819,All
2018,9,AHMEDABAD,INDORE,1909,1783,AHMEDABAD-INDORE,3692,All
2018,10,AHMEDABAD,INDORE,1992,1944,AHMEDABAD-INDORE,3936,All
2018,11,AHMEDABAD,INDORE,2501,2722,AHMEDABAD-INDORE,5223,All
2018,12,AHMEDABAD,INDORE,2299,2411,AHMEDABAD-INDORE,4710,All
2019,1,AHMEDABAD,INDORE,2470,2300,AHMEDABAD-INDORE,4770,All
2019,2,AHMEDABAD,INDORE,3218,3266,AHMEDABAD-INDORE,6484,All
2019,3,AHMEDABAD,INDORE,3935,4052,AHMEDABAD-INDORE,7987,All
2019,4,AHMEDABAD,INDORE,1337,1363,AHMEDABAD-INDORE,2700,All
2019,5,AHMEDABAD,INDORE,1497,1416,AHMEDABAD-INDORE,2913,All
2019,6,AHMEDABAD,INDORE,1366,1370,AHMEDABAD-INDORE,2736,All
2019,7,AHMEDABAD,INDORE,1360,1307,AHMEDABAD-INDORE,2667,All
2019,8,AHMEDABAD,INDORE,1507,1204,AHMEDABAD-INDORE,2711,All
2019,9,AHMEDABAD,INDORE,2688,2646,AHMEDABAD-INDORE,5334,All
2019,10,AHMEDABAD,INDORE,2777,2664,AHMEDABAD-INDORE,5441,All
2019,11,AHMEDABAD,INDORE,4342,5840,AHMEDABAD-INDORE,10182,All
2019,12,AHMEDABAD,INDORE,6802,7677,AHMEDABAD-INDORE,14479,All
2020,1,AHMEDABAD,INDORE,8651,9021,AHMEDABAD-INDORE,17672,All
2020,2,AHMEDABAD,INDORE,10182,10530,AHMEDABAD-INDORE,20712,All
2020,3,AHMEDABAD,INDORE,6530,6330,AHMEDABAD-INDORE,12860,All
2020,6,AHMEDABAD,INDORE,112,121,AHMEDABAD-INDORE,233,All
2020,7,AHMEDABAD,INDORE,227,237,AHMEDABAD-INDORE,464,All
2020,8,AHMEDABAD,INDORE,185,180,AHMEDABAD-INDORE,365,All
2020,9,AHMEDABAD,INDORE,805,876,AHMEDABAD-INDORE,1681,All
2020,10,AHMEDABAD,INDORE,857,1083,AHMEDABAD-INDORE,1940,All
2020,11,AHMEDABAD,INDORE,1369,1243,AHMEDABAD-INDORE,2612,All
2020,12,AHMEDABAD,INDORE,1878,6661,AHMEDABAD-INDORE,8539,All
2021,1,AHMEDABAD,INDORE,4107,3864,AHMEDABAD-INDORE,7971,All
2021,2,AHMEDABAD,INDORE,3309,4224,AHMEDABAD-INDORE,7533,All
2021,3,AHMEDABAD,INDORE,2819,4498,AHMEDABAD-INDORE,7317,All
2021,4,AHMEDABAD,INDORE,525,581,AHMEDABAD-INDORE,1106,All
2021,7,AHMEDABAD,INDORE,1035,762,AHMEDABAD-INDORE,1797,All
2021,8,AHMEDABAD,INDORE,2247,2103,AHMEDABAD-INDORE,4350,All
2021,9,AHMEDABAD,INDORE,2989,2957,AHMEDABAD-INDORE,5946,All
2021,10,AHMEDABAD,INDORE,3909,3609,AHMEDABAD-INDORE,7518,All
2021,11,AHMEDABAD,INDORE,3747,3761,AHMEDABAD-INDORE,7508,All
2021,12,AHMEDABAD,INDORE,3978,3882,AHMEDABAD-INDORE,7860,All
2022,1,AHMEDABAD,INDORE,1621,1563,AHMEDABAD-INDORE,3184,All
2022,2,AHMEDABAD,INDORE,1462,1457,AHMEDABAD-INDORE,2919,All
2022,3,AHMEDABAD,INDORE,3450,3309,AHMEDABAD-INDORE,6759,All
2022,4,AHMEDABAD,INDORE,2152,1919,AHMEDABAD-INDORE,4071,All
2022,5,AHMEDABAD,INDORE,2259,2063,AHMEDABAD-INDORE,4322,All
2022,6,AHMEDABAD,INDORE,1542,1551,AHMEDABAD-INDORE,3093,All
2022,7,AHMEDABAD,INDORE,2045,2143,AHMEDABAD-INDORE,4188,All
2022,8,AHMEDABAD,INDORE,2008,2119,AHMEDABAD-INDORE,4127,All
2022,9,AHMEDABAD,INDORE,1782,1920,AHMEDABAD-INDORE,3702,All
2022,10,AHMEDABAD,INDORE,2173,2171,AHMEDABAD-INDORE,4344,All
2022,11,AHMEDABAD,INDORE,2189,2515,AHMEDABAD-INDORE,4704,All
2022,12,AHMEDABAD,INDORE,2754,2816,AHMEDABAD-INDORE,5570,All
2023,1,AHMEDABAD,INDORE,3613,4092,AHMEDABAD-INDORE,7705,All
2023,2,AHMEDABAD,INDORE,4930,4773,AHMEDABAD-INDORE,9703,All
2023,3,AHMEDABAD,INDORE,5074,5187,AHMEDABAD-INDORE,10261,All
2023,4,AHMEDABAD,INDORE,5660,5792,AHMEDABAD-INDORE,11452,All
2023,5,AHMEDABAD,INDORE,6632,6145,AHMEDABAD-INDORE,12777,All
2023,6,AHMEDABAD,INDORE,5759,6339,AHMEDABAD-INDORE,12098,All
2023,7,AHMEDABAD,INDORE,5800,6184,AHMEDABAD-INDORE,11984,All
2023,8,AHMEDABAD,INDORE,5781,5985,AHMEDABAD-INDORE,11766,All
2023,9,AHMEDABAD,INDORE,5834,6335,AHMEDABAD-INDORE,12169,All
2023,10,AHMEDABAD,INDORE,6047,6359,AHMEDABAD-INDORE,12406,All
2023,11,AHMEDABAD,INDORE,6416,6069,AHMEDABAD-INDORE,12485,All
2023,12,AHMEDABAD,INDORE,6329,6502,AHMEDABAD-INDORE,12831,All
2024,1,AHMEDABAD,INDORE,6507,6369,AHMEDABAD-INDORE,12876,All
2024,2,AHMEDABAD,INDORE,6040,5920,AHMEDABAD-INDORE,11960,All
2024,3,AHMEDABAD,INDORE,6271,6477,AHMEDABAD-INDORE,12748,All
2024,4,AHMEDABAD,INDORE,5410,5790,AHMEDABAD-INDORE,11200,All
2024,6,AHMEDABAD,INDORE,4771,5488,AHMEDABAD-INDORE,10259,All
2024,7,AHMEDABAD,INDORE,4850,5257,AHMEDABAD-INDORE,10107,All
2024,8,AHMEDABAD,INDORE,4849,5252,AHMEDABAD-INDORE,10101,All
2024,9,AHMEDABAD,INDORE,4949,5676,AHMEDABAD-INDORE,10625,All
2024,10,AHMEDABAD,INDORE,5661,5118,AHMEDABAD-INDORE,10779,All
2024,11,AHMEDABAD,INDORE,5838,6415,AHMEDABAD-INDORE,12253,All
2024,12,AHMEDABAD,INDORE,6173,6665,AHMEDABAD-INDORE,12838,All
2025,1,AHMEDABAD,INDORE,6755,6808,AHMEDABAD-INDORE,13563,All
2025,2,AHMEDABAD,INDORE,5598,5487,AHMEDABAD-INDORE,11085,All
2025,3,AHMEDABAD,INDORE,5715,5873,AHMEDABAD-INDORE,11588,All
2018,10,AHMEDABAD,JABALPUR,77,32,AHMEDABAD-JABALPUR,109,All
2018,11,AHMEDABAD,JABALPUR,1581,1575,AHMEDABAD-JABALPUR,3156,All
2018,12,AHMEDABAD,JABALPUR,1754,1845,AHMEDABAD-JABALPUR,3599,All
2019,1,AHMEDABAD,JABALPUR,1756,1678,AHMEDABAD-JABALPUR,3434,All
2019,2,AHMEDABAD,JABALPUR,1480,1437,AHMEDABAD-JABALPUR,2917,All
2019,3,AHMEDABAD,JABALPUR,1632,1505,AHMEDABAD-JABALPUR,3137,All
2019,4,AHMEDABAD,JABALPUR,1817,1621,AHMEDABAD-JABALPUR,3438,All
2019,5,AHMEDABAD,JABALPUR,1901,1689,AHMEDABAD-JABALPUR,3590,All
2019,6,AHMEDABAD,JABALPUR,1462,1606,AHMEDABAD-JABALPUR,3068,All
2019,7,AHMEDABAD,JABALPUR,1336,1193,AHMEDABAD-JABALPUR,2529,All
2019,9,AHMEDABAD,JABALPUR,234,228,AHMEDABAD-JABALPUR,462,All
2019,10,AHMEDABAD,JABALPUR,1763,1299,AHMEDABAD-JABALPUR,3062,All
2019,11,AHMEDABAD,JABALPUR,1751,1950,AHMEDABAD-JABALPUR,3701,All
2019,12,AHMEDABAD,JABALPUR,1439,1592,AHMEDABAD-JABALPUR,3031,All
2020,1,AHMEDABAD,JABALPUR,1630,1444,AHMEDABAD-JABALPUR,3074,All
2020,2,AHMEDABAD,JABALPUR,397,360,AHMEDABAD-JABALPUR,757,All
2024,3,AHMEDABAD,JABALPUR,28,31,AHMEDABAD-JABALPUR,59,All
2024,4,AHMEDABAD,JABALPUR,9,15,AHMEDABAD-JABALPUR,24,All
2024,6,AHMEDABAD,JABALPUR,21,41,AHMEDABAD-JABALPUR,62,All
2024,7,AHMEDABAD,JABALPUR,11,12,AHMEDABAD-JABALPUR,23,All
2024,8,AHMEDABAD,JABALPUR,13,9,AHMEDABAD-JABALPUR,22,All
2015,4,AHMEDABAD,JAIPUR,3373,2852,AHMEDABAD-JAIPUR,6225,All
2015,5,AHMEDABAD,JAIPUR,3824,3776,AHMEDABAD-JAIPUR,7600,All
2015,6,AHMEDABAD,JAIPUR,3341,3566,AHMEDABAD-JAIPUR,6907,All
2015,7,AHMEDABAD,JAIPUR,3079,2856,AHMEDABAD-JAIPUR,5935,All
2015,8,AHMEDABAD,JAIPUR,3109,2880,AHMEDABAD-JAIPUR,5989,All
2015,9,AHMEDABAD,JAIPUR,2759,2842,AHMEDABAD-JAIPUR,5601,All
2015,10,AHMEDABAD,JAIPUR,3036,3147,AHMEDABAD-JAIPUR,6183,All
2015,11,AHMEDABAD,JAIPUR,4177,3424,AHMEDABAD-JAIPUR,7601,All
2015,12,AHMEDABAD,JAIPUR,4358,4343,AHMEDABAD-JAIPUR,8701,All
2016,1,AHMEDABAD,JAIPUR,3966,3946,AHMEDABAD-JAIPUR,7912,All
2016,2,AHMEDABAD,JAIPUR,3681,3529,AHMEDABAD-JAIPUR,7210,All
2016,3,AHMEDABAD,JAIPUR,3564,3447,AHMEDABAD-JAIPUR,7011,All
2016,4,AHMEDABAD,JAIPUR,3443,3168,AHMEDABAD-JAIPUR,6611,All
2016,5,AHMEDABAD,JAIPUR,2559,2751,AHMEDABAD-JAIPUR,5310,All
2016,6,AHMEDABAD,JAIPUR,2427,2487,AHMEDABAD-JAIPUR,4914,All
2016,7,AHMEDABAD,JAIPUR,3075,3010,AHMEDABAD-JAIPUR,6085,All
2016,8,AHMEDABAD,JAIPUR,3258,3368,AHMEDABAD-JAIPUR,6626,All
2016,9,AHMEDABAD,JAIPUR,3109,2914,AHMEDABAD-JAIPUR,6023,All
2016,10,AHMEDABAD,JAIPUR,3283,2948,AHMEDABAD-JAIPUR,6231,All
2016,11,AHMEDABAD,JAIPUR,4155,3852,AHMEDABAD-JAIPUR,8007,All
2016,12,AHMEDABAD,JAIPUR,4074,4282,AHMEDABAD-JAIPUR,8356,All
2017,1,AHMEDABAD,JAIPUR,4095,4018,AHMEDABAD-JAIPUR,8113,All
2017,2,AHMEDABAD,JAIPUR,5624,5432,AHMEDABAD-JAIPUR,11056,All
2017,3,AHMEDABAD,JAIPUR,9149,7554,AHMEDABAD-JAIPUR,16703,All
2017,4,AHMEDABAD,JAIPUR,12772,11269,AHMEDABAD-JAIPUR,24041,All
2017,5,AHMEDABAD,JAIPUR,13462,12048,AHMEDABAD-JAIPUR,25510,All
2017,6,AHMEDABAD,JAIPUR,12210,11018,AHMEDABAD-JAIPUR,23228,All
2017,7,AHMEDABAD,JAIPUR,11405,10048,AHMEDABAD-JAIPUR,21453,All
2017,8,AHMEDABAD,JAIPUR,12129,10279,AHMEDABAD-JAIPUR,22408,All
2017,9,AHMEDABAD,JAIPUR,12599,10493,AHMEDABAD-JAIPUR,23092,All
2017,10,AHMEDABAD,JAIPUR,13218,10460,AHMEDABAD-JAIPUR,23678,All
2017,11,AHMEDABAD,JAIPUR,13605,12948,AHMEDABAD-JAIPUR,26553,All
2017,12,AHMEDABAD,JAIPUR,13312,12951,AHMEDABAD-JAIPUR,26263,All
2018,1,AHMEDABAD,JAIPUR,15023,13507,AHMEDABAD-JAIPUR,28530,All
2018,2,AHMEDABAD,JAIPUR,13034,11892,AHMEDABAD-JAIPUR,24926,All
2018,3,AHMEDABAD,JAIPUR,3689,3801,AHMEDABAD-JAIPUR,7490,All
2018,4,AHMEDABAD,JAIPUR,8088,7773,AHMEDABAD-JAIPUR,15861,All
2018,5,AHMEDABAD,JAIPUR,13059,11473,AHMEDABAD-JAIPUR,24532,All
2018,6,AHMEDABAD,JAIPUR,12869,12177,AHMEDABAD-JAIPUR,25046,All
2018,7,AHMEDABAD,JAIPUR,15359,14089,AHMEDABAD-JAIPUR,29448,All
2018,8,AHMEDABAD,JAIPUR,15115,13282,AHMEDABAD-JAIPUR,28397,All
2018,9,AHMEDABAD,JAIPUR,15956,14641,AHMEDABAD-JAIPUR,30597,All
2018,10,AHMEDABAD,JAIPUR,15027,13081,AHMEDABAD-JAIPUR,28108,All
2018,11,AHMEDABAD,JAIPUR,14152,14164,AHMEDABAD-JAIPUR,28316,All
2018,12,AHMEDABAD,JAIPUR,15400,14225,AHMEDABAD-JAIPUR,29625,All
2019,1,AHMEDABAD,JAIPUR,16524,13861,AHMEDABAD-JAIPUR,30385,All
2019,2,AHMEDABAD,JAIPUR,15104,12863,AHMEDABAD-JAIPUR,27967,All
2019,3,AHMEDABAD,JAIPUR,14826,12502,AHMEDABAD-JAIPUR,27328,All
2019,4,AHMEDABAD,JAIPUR,13388,11512,AHMEDABAD-JAIPUR,24900,All
2019,5,AHMEDABAD,JAIPUR,13862,12479,AHMEDABAD-JAIPUR,26341,All
2019,6,AHMEDABAD,JAIPUR,14568,13689,AHMEDABAD-JAIPUR,28257,All
2019,7,AHMEDABAD,JAIPUR,12446,11503,AHMEDABAD-JAIPUR,23949,All
2019,8,AHMEDABAD,JAIPUR,13205,12318,AHMEDABAD-JAIPUR,25523,All
2019,9,AHMEDABAD,JAIPUR,9749,8748,AHMEDABAD-JAIPUR,18497,All
2019,10,AHMEDABAD,JAIPUR,14022,10882,AHMEDABAD-JAIPUR,24904,All
2019,11,AHMEDABAD,JAIPUR,16604,19909,AHMEDABAD-JAIPUR,36513,All
2019,12,AHMEDABAD,JAIPUR,16802,19068,AHMEDABAD-JAIPUR,35870,All
2020,1,AHMEDABAD,JAIPUR,17280,17675,AHMEDABAD-JAIPUR,34955,All
2020,2,AHMEDABAD,JAIPUR,13357,12546,AHMEDABAD-JAIPUR,25903,All
2020,3,AHMEDABAD,JAIPUR,7814,8080,AHMEDABAD-JAIPUR,15894,All
2020,6,AHMEDABAD,JAIPUR,126,97,AHMEDABAD-JAIPUR,223,All
2020,7,AHMEDABAD,JAIPUR,1202,983,AHMEDABAD-JAIPUR,2185,All
2020,8,AHMEDABAD,JAIPUR,1863,2019,AHMEDABAD-JAIPUR,3882,All
2020,9,AHMEDABAD,JAIPUR,1978,2572,AHMEDABAD-JAIPUR,4550,All
2020,10,AHMEDABAD,JAIPUR,2306,3123,AHMEDABAD-JAIPUR,5429,All
2020,11,AHMEDABAD,JAIPUR,4949,5297,AHMEDABAD-JAIPUR,10246,All
2020,12,AHMEDABAD,JAIPUR,11125,7900,AHMEDABAD-JAIPUR,19025,All
2021,1,AHMEDABAD,JAIPUR,8544,7665,AHMEDABAD-JAIPUR,16209,All
2021,2,AHMEDABAD,JAIPUR,8175,7234,AHMEDABAD-JAIPUR,15409,All
2021,3,AHMEDABAD,JAIPUR,7825,7166,AHMEDABAD-JAIPUR,14991,All
2021,4,AHMEDABAD,JAIPUR,3296,2269,AHMEDABAD-JAIPUR,5565,All
2021,6,AHMEDABAD,JAIPUR,2469,2238,AHMEDABAD-JAIPUR,4707,All
2021,7,AHMEDABAD,JAIPUR,5789,4966,AHMEDABAD-JAIPUR,10755,All
2021,8,AHMEDABAD,JAIPUR,6659,6398,AHMEDABAD-JAIPUR,13057,All
2021,9,AHMEDABAD,JAIPUR,6564,6578,AHMEDABAD-JAIPUR,13142,All
2021,10,AHMEDABAD,JAIPUR,11061,8681,AHMEDABAD-JAIPUR,19742,All
2021,11,AHMEDABAD,JAIPUR,9240,9078,AHMEDABAD-JAIPUR,18318,All
2021,12,AHMEDABAD,JAIPUR,9106,9684,AHMEDABAD-JAIPUR,18790,All
2022,1,AHMEDABAD,JAIPUR,4715,4372,AHMEDABAD-JAIPUR,9087,All
2022,2,AHMEDABAD,JAIPUR,3139,2948,AHMEDABAD-JAIPUR,6087,All
2022,3,AHMEDABAD,JAIPUR,4766,4784,AHMEDABAD-JAIPUR,9550,All
2022,4,AHMEDABAD,JAIPUR,7501,7271,AHMEDABAD-JAIPUR,14772,All
2022,5,AHMEDABAD,JAIPUR,8330,7304,AHMEDABAD-JAIPUR,15634,All
2022,6,AHMEDABAD,JAIPUR,5318,5613,AHMEDABAD-JAIPUR,10931,All
2022,7,AHMEDABAD,JAIPUR,5455,5588,AHMEDABAD-JAIPUR,11043,All
2022,8,AHMEDABAD,JAIPUR,7343,6888,AHMEDABAD-JAIPUR,14231,All
2022,9,AHMEDABAD,JAIPUR,7165,6441,AHMEDABAD-JAIPUR,13606,All
2022,10,AHMEDABAD,JAIPUR,9594,7291,AHMEDABAD-JAIPUR,16885,All
2022,11,AHMEDABAD,JAIPUR,10391,11686,AHMEDABAD-JAIPUR,22077,All
2022,12,AHMEDABAD,JAIPUR,12909,13645,AHMEDABAD-JAIPUR,26554,All
2023,1,AHMEDABAD,JAIPUR,10575,10224,AHMEDABAD-JAIPUR,20799,All
2023,2,AHMEDABAD,JAIPUR,9800,9444,AHMEDABAD-JAIPUR,19244,All
2023,3,AHMEDABAD,JAIPUR,8976,9309,AHMEDABAD-JAIPUR,18285,All
2023,4,AHMEDABAD,JAIPUR,7841,7522,AHMEDABAD-JAIPUR,15363,All
2023,5,AHMEDABAD,JAIPUR,8808,8858,AHMEDABAD-JAIPUR,17666,All
2023,6,AHMEDABAD,JAIPUR,8282,8421,AHMEDABAD-JAIPUR,16703,All
2023,7,AHMEDABAD,JAIPUR,6961,6691,AHMEDABAD-JAIPUR,13652,All
2023,8,AHMEDABAD,JAIPUR,6227,5983,AHMEDABAD-JAIPUR,12210,All
2023,9,AHMEDABAD,JAIPUR,6088,6052,AHMEDABAD-JAIPUR,12140,All
2023,10,AHMEDABAD,JAIPUR,6248,5879,AHMEDABAD-JAIPUR,12127,All
2023,11,AHMEDABAD,JAIPUR,7568,6594,AHMEDABAD-JAIPUR,14162,All
2023,12,AHMEDABAD,JAIPUR,8342,8484,AHMEDABAD-JAIPUR,16826,All
2024,1,AHMEDABAD,JAIPUR,8201,7890,AHMEDABAD-JAIPUR,16091,All
2024,2,AHMEDABAD,JAIPUR,9731,9078,AHMEDABAD-JAIPUR,18809,All
2024,3,AHMEDABAD,JAIPUR,9939,8984,AHMEDABAD-JAIPUR,18923,All
2024,4,AHMEDABAD,JAIPUR,8819,8232,AHMEDABAD-JAIPUR,17051,All
2024,6,AHMEDABAD,JAIPUR,7975,8429,AHMEDABAD-JAIPUR,16404,All
2024,7,AHMEDABAD,JAIPUR,8055,8381,AHMEDABAD-JAIPUR,16436,All
2024,8,AHMEDABAD,JAIPUR,7940,7742,AHMEDABAD-JAIPUR,15682,All
2024,9,AHMEDABAD,JAIPUR,7562,7866,AHMEDABAD-JAIPUR,15428,All
2024,10,AHMEDABAD,JAIPUR,8670,7744,AHMEDABAD-JAIPUR,16414,All
2024,11,AHMEDABAD,JAIPUR,9014,8987,AHMEDABAD-JAIPUR,18001,All
2024,12,AHMEDABAD,JAIPUR,11649,12302,AHMEDABAD-JAIPUR,23951,All
2025,1,AHMEDABAD,JAIPUR,13667,12850,AHMEDABAD-JAIPUR,26517,All
2025,2,AHMEDABAD,JAIPUR,12750,11049,AHMEDABAD-JAIPUR,23799,All
2025,3,AHMEDABAD,JAIPUR,11347,10927,AHMEDABAD-JAIPUR,22274,All
2018,6,AHMEDABAD,JAISALMER,0,1,AHMEDABAD-JAISALMER,1,All
2018,7,AHMEDABAD,JAISALMER,0,12,AHMEDABAD-JAISALMER,12,All
2018,8,AHMEDABAD,JAISALMER,0,44,AHMEDABAD-JAISALMER,44,All
2018,9,AHMEDABAD,JAISALMER,0,58,AHMEDABAD-JAISALMER,58,All
2018,10,AHMEDABAD,JAISALMER,55,34,AHMEDABAD-JAISALMER,89,All
2018,11,AHMEDABAD,JAISALMER,1699,1651,AHMEDABAD-JAISALMER,3350,All
2018,12,AHMEDABAD,JAISALMER,2146,1965,AHMEDABAD-JAISALMER,4111,All
2019,1,AHMEDABAD,JAISALMER,2495,2579,AHMEDABAD-JAISALMER,5074,All
2019,2,AHMEDABAD,JAISALMER,2389,2285,AHMEDABAD-JAISALMER,4674,All
2019,3,AHMEDABAD,JAISALMER,2387,2227,AHMEDABAD-JAISALMER,4614,All
2019,4,AHMEDABAD,JAISALMER,1479,1463,AHMEDABAD-JAISALMER,2942,All
2019,5,AHMEDABAD,JAISALMER,1743,2068,AHMEDABAD-JAISALMER,3811,All
2019,6,AHMEDABAD,JAISALMER,2423,2422,AHMEDABAD-JAISALMER,4845,All
2019,7,AHMEDABAD,JAISALMER,2995,3076,AHMEDABAD-JAISALMER,6071,All
2019,8,AHMEDABAD,JAISALMER,3359,3255,AHMEDABAD-JAISALMER,6614,All
2019,9,AHMEDABAD,JAISALMER,2898,2796,AHMEDABAD-JAISALMER,5694,All
2019,10,AHMEDABAD,JAISALMER,3075,2816,AHMEDABAD-JAISALMER,5891,All
2019,11,AHMEDABAD,JAISALMER,2635,2773,AHMEDABAD-JAISALMER,5408,All
2019,12,AHMEDABAD,JAISALMER,3221,2947,AHMEDABAD-JAISALMER,6168,All
2020,1,AHMEDABAD,JAISALMER,2938,2897,AHMEDABAD-JAISALMER,5835,All
2020,2,AHMEDABAD,JAISALMER,3295,2893,AHMEDABAD-JAISALMER,6188,All
2020,3,AHMEDABAD,JAISALMER,2238,2195,AHMEDABAD-JAISALMER,4433,All
2020,5,AHMEDABAD,JAISALMER,54,63,AHMEDABAD-JAISALMER,117,All
2020,6,AHMEDABAD,JAISALMER,600,642,AHMEDABAD-JAISALMER,1242,All
2020,7,AHMEDABAD,JAISALMER,149,280,AHMEDABAD-JAISALMER,429,All
2020,9,AHMEDABAD,JAISALMER,500,452,AHMEDABAD-JAISALMER,952,All
2020,10,AHMEDABAD,JAISALMER,955,813,AHMEDABAD-JAISALMER,1768,All
2020,11,AHMEDABAD,JAISALMER,2172,1939,AHMEDABAD-JAISALMER,4111,All
2020,12,AHMEDABAD,JAISALMER,2628,2264,AHMEDABAD-JAISALMER,4892,All
2021,1,AHMEDABAD,JAISALMER,2408,2531,AHMEDABAD-JAISALMER,4939,All
2021,2,AHMEDABAD,JAISALMER,2083,1745,AHMEDABAD-JAISALMER,3828,All
2021,3,AHMEDABAD,JAISALMER,1816,1671,AHMEDABAD-JAISALMER,3487,All
2021,4,AHMEDABAD,JAISALMER,484,444,AHMEDABAD-JAISALMER,928,All
2021,6,AHMEDABAD,JAISALMER,258,206,AHMEDABAD-JAISALMER,464,All
2021,7,AHMEDABAD,JAISALMER,438,386,AHMEDABAD-JAISALMER,824,All
2021,8,AHMEDABAD,JAISALMER,1317,1135,AHMEDABAD-JAISALMER,2452,All
2021,9,AHMEDABAD,JAISALMER,1241,1146,AHMEDABAD-JAISALMER,2387,All
2021,10,AHMEDABAD,JAISALMER,1486,1319,AHMEDABAD-JAISALMER,2805,All
2021,11,AHMEDABAD,JAISALMER,1053,920,AHMEDABAD-JAISALMER,1973,All
2021,12,AHMEDABAD,JAISALMER,1263,1177,AHMEDABAD-JAISALMER,2440,All
2022,1,AHMEDABAD,JAISALMER,446,392,AHMEDABAD-JAISALMER,838,All
2022,2,AHMEDABAD,JAISALMER,65,0,AHMEDABAD-JAISALMER,65,All
2022,3,AHMEDABAD,JAISALMER,34,0,AHMEDABAD-JAISALMER,34,All
2022,10,AHMEDABAD,JAISALMER,35,60,AHMEDABAD-JAISALMER,95,All
2022,11,AHMEDABAD,JAISALMER,825,948,AHMEDABAD-JAISALMER,1773,All
2022,12,AHMEDABAD,JAISALMER,1222,1498,AHMEDABAD-JAISALMER,2720,All
2023,1,AHMEDABAD,JAISALMER,758,1078,AHMEDABAD-JAISALMER,1836,All
2023,10,AHMEDABAD,JAISALMER,61,98,AHMEDABAD-JAISALMER,159,All
2023,11,AHMEDABAD,JAISALMER,1015,1467,AHMEDABAD-JAISALMER,2482,All
2023,12,AHMEDABAD,JAISALMER,1319,1973,AHMEDABAD-JAISALMER,3292,All
2024,1,AHMEDABAD,JAISALMER,1409,1911,AHMEDABAD-JAISALMER,3320,All
2024,2,AHMEDABAD,JAISALMER,1369,1805,AHMEDABAD-JAISALMER,3174,All
2024,3,AHMEDABAD,JAISALMER,387,619,AHMEDABAD-JAISALMER,1006,All
2025,2,AHMEDABAD,JAISALMER,37,0,AHMEDABAD-JAISALMER,37,All
2019,9,AHMEDABAD,JALGAON,908,705,AHMEDABAD-JALGAON,1613,All
2019,10,AHMEDABAD,JALGAON,823,659,AHMEDABAD-JALGAON,1482,All
2019,11,AHMEDABAD,JALGAON,1053,643,AHMEDABAD-JALGAON,1696,All
2019,12,AHMEDABAD,JALGAON,798,922,AHMEDABAD-JALGAON,1720,All
2020,1,AHMEDABAD,JALGAON,721,1102,AHMEDABAD-JALGAON,1823,All
2020,2,AHMEDABAD,JALGAON,1009,1082,AHMEDABAD-JALGAON,2091,All
2020,3,AHMEDABAD,JALGAON,452,508,AHMEDABAD-JALGAON,960,All
2020,6,AHMEDABAD,JALGAON,157,153,AHMEDABAD-JALGAON,310,All
2020,7,AHMEDABAD,JALGAON,47,65,AHMEDABAD-JALGAON,112,All
2020,9,AHMEDABAD,JALGAON,181,205,AHMEDABAD-JALGAON,386,All
2020,10,AHMEDABAD,JALGAON,275,348,AHMEDABAD-JALGAON,623,All
2020,11,AHMEDABAD,JALGAON,384,401,AHMEDABAD-JALGAON,785,All
2020,12,AHMEDABAD,JALGAON,302,416,AHMEDABAD-JALGAON,718,All
2021,1,AHMEDABAD,JALGAON,330,423,AHMEDABAD-JALGAON,753,All
2021,2,AHMEDABAD,JALGAON,416,448,AHMEDABAD-JALGAON,864,All
2021,3,AHMEDABAD,JALGAON,284,351,AHMEDABAD-JALGAON,635,All
2021,4,AHMEDABAD,JALGAON,65,68,AHMEDABAD-JALGAON,133,All
2021,6,AHMEDABAD,JALGAON,130,107,AHMEDABAD-JALGAON,237,All
2021,7,AHMEDABAD,JALGAON,191,202,AHMEDABAD-JALGAON,393,All
2021,8,AHMEDABAD,JALGAON,311,406,AHMEDABAD-JALGAON,717,All
2021,9,AHMEDABAD,JALGAON,198,247,AHMEDABAD-JALGAON,445,All
2021,10,AHMEDABAD,JALGAON,316,309,AHMEDABAD-JALGAON,625,All
2021,11,AHMEDABAD,JALGAON,304,367,AHMEDABAD-JALGAON,671,All
2021,12,AHMEDABAD,JALGAON,401,420,AHMEDABAD-JALGAON,821,All
2022,1,AHMEDABAD,JALGAON,319,341,AHMEDABAD-JALGAON,660,All
2022,2,AHMEDABAD,JALGAON,57,44,AHMEDABAD-JALGAON,101,All
2024,10,AHMEDABAD,JALGAON,84,8,AHMEDABAD-JALGAON,92,All
2024,11,AHMEDABAD,JALGAON,493,603,AHMEDABAD-JALGAON,1096,All
2024,12,AHMEDABAD,JALGAON,517,596,AHMEDABAD-JALGAON,1113,All
2025,1,AHMEDABAD,JALGAON,405,434,AHMEDABAD-JALGAON,839,All
2025,2,AHMEDABAD,JALGAON,446,443,AHMEDABAD-JALGAON,889,All
2025,3,AHMEDABAD,JALGAON,353,268,AHMEDABAD-JALGAON,621,All
2018,12,AHMEDABAD,JAMMU,1419,507,AHMEDABAD-JAMMU,1926,All
2019,1,AHMEDABAD,JAMMU,3202,1192,AHMEDABAD-JAMMU,4394,All
2019,2,AHMEDABAD,JAMMU,3153,490,AHMEDABAD-JAMMU,3643,All
2019,3,AHMEDABAD,JAMMU,1057,220,AHMEDABAD-JAMMU,1277,All
2020,7,AHMEDABAD,JAMMU,17,12,AHMEDABAD-JAMMU,29,All
2020,8,AHMEDABAD,JAMMU,361,100,AHMEDABAD-JAMMU,461,All
2020,9,AHMEDABAD,JAMMU,470,316,AHMEDABAD-JAMMU,786,All
2020,10,AHMEDABAD,JAMMU,434,240,AHMEDABAD-JAMMU,674,All
2020,11,AHMEDABAD,JAMMU,653,353,AHMEDABAD-JAMMU,1006,All
2020,12,AHMEDABAD,JAMMU,1267,1113,AHMEDABAD-JAMMU,2380,All
2021,1,AHMEDABAD,JAMMU,636,964,AHMEDABAD-JAMMU,1600,All
2021,2,AHMEDABAD,JAMMU,444,334,AHMEDABAD-JAMMU,778,All
2021,3,AHMEDABAD,JAMMU,816,388,AHMEDABAD-JAMMU,1204,All
2021,4,AHMEDABAD,JAMMU,701,620,AHMEDABAD-JAMMU,1321,All
2021,10,AHMEDABAD,JAMMU,0,198,AHMEDABAD-JAMMU,198,All
2022,10,AHMEDABAD,JAMMU,141,177,AHMEDABAD-JAMMU,318,All
2022,11,AHMEDABAD,JAMMU,1725,2318,AHMEDABAD-JAMMU,4043,All
2022,12,AHMEDABAD,JAMMU,2644,2532,AHMEDABAD-JAMMU,5176,All
2023,1,AHMEDABAD,JAMMU,2741,2428,AHMEDABAD-JAMMU,5169,All
2023,2,AHMEDABAD,JAMMU,2667,2216,AHMEDABAD-JAMMU,4883,All
2023,3,AHMEDABAD,JAMMU,2880,2605,AHMEDABAD-JAMMU,5485,All
2023,4,AHMEDABAD,JAMMU,3063,2920,AHMEDABAD-JAMMU,5983,All
2023,5,AHMEDABAD,JAMMU,3052,2980,AHMEDABAD-JAMMU,6032,All
2023,6,AHMEDABAD,JAMMU,2757,2888,AHMEDABAD-JAMMU,5645,All
2023,7,AHMEDABAD,JAMMU,2792,3004,AHMEDABAD-JAMMU,5796,All
2023,8,AHMEDABAD,JAMMU,2774,2634,AHMEDABAD-JAMMU,5408,All
2023,9,AHMEDABAD,JAMMU,2412,2244,AHMEDABAD-JAMMU,4656,All
2023,10,AHMEDABAD,JAMMU,2672,2429,AHMEDABAD-JAMMU,5101,All
2023,11,AHMEDABAD,JAMMU,2752,2326,AHMEDABAD-JAMMU,5078,All
2023,12,AHMEDABAD,JAMMU,2938,2968,AHMEDABAD-JAMMU,5906,All
2024,1,AHMEDABAD,JAMMU,2791,2802,AHMEDABAD-JAMMU,5593,All
2024,2,AHMEDABAD,JAMMU,2831,2298,AHMEDABAD-JAMMU,5129,All
2024,3,AHMEDABAD,JAMMU,2883,2770,AHMEDABAD-JAMMU,5653,All
2024,4,AHMEDABAD,JAMMU,2826,2055,AHMEDABAD-JAMMU,4881,All
2024,6,AHMEDABAD,JAMMU,2452,1938,AHMEDABAD-JAMMU,4390,All
2024,7,AHMEDABAD,JAMMU,2390,1737,AHMEDABAD-JAMMU,4127,All
2024,8,AHMEDABAD,JAMMU,2374,1563,AHMEDABAD-JAMMU,3937,All
2024,9,AHMEDABAD,JAMMU,2608,1583,AHMEDABAD-JAMMU,4191,All
2024,10,AHMEDABAD,JAMMU,2517,1219,AHMEDABAD-JAMMU,3736,All
2024,11,AHMEDABAD,JAMMU,2734,2849,AHMEDABAD-JAMMU,5583,All
2024,12,AHMEDABAD,JAMMU,2983,3106,AHMEDABAD-JAMMU,6089,All
2025,1,AHMEDABAD,JAMMU,2749,2721,AHMEDABAD-JAMMU,5470,All
2025,2,AHMEDABAD,JAMMU,2740,2374,AHMEDABAD-JAMMU,5114,All
2025,3,AHMEDABAD,JAMMU,4524,3995,AHMEDABAD-JAMMU,8519,All
2018,2,AHMEDABAD,JAMNAGAR,1,0,AHMEDABAD-JAMNAGAR,1,All
2018,5,AHMEDABAD,JAMNAGAR,10,13,AHMEDABAD-JAMNAGAR,23,All
2020,10,AHMEDABAD,JAMNAGAR,0,6,AHMEDABAD-JAMNAGAR,6,All
2020,11,AHMEDABAD,JAMNAGAR,0,1,AHMEDABAD-JAMNAGAR,1,All
2018,9,AHMEDABAD,JODHPUR,1292,1455,AHMEDABAD-JODHPUR,2747,All
2018,10,AHMEDABAD,JODHPUR,1812,1820,AHMEDABAD-JODHPUR,3632,All
2018,11,AHMEDABAD,JODHPUR,2719,3123,AHMEDABAD-JODHPUR,5842,All
2018,12,AHMEDABAD,JODHPUR,3221,3575,AHMEDABAD-JODHPUR,6796,All
2019,1,AHMEDABAD,JODHPUR,3670,3545,AHMEDABAD-JODHPUR,7215,All
2019,2,AHMEDABAD,JODHPUR,3521,3379,AHMEDABAD-JODHPUR,6900,All
2019,3,AHMEDABAD,JODHPUR,3282,3397,AHMEDABAD-JODHPUR,6679,All
2019,9,AHMEDABAD,JODHPUR,3443,3272,AHMEDABAD-JODHPUR,6715,All
2019,10,AHMEDABAD,JODHPUR,4387,3419,AHMEDABAD-JODHPUR,7806,All
2019,11,AHMEDABAD,JODHPUR,3300,5213,AHMEDABAD-JODHPUR,8513,All
2019,12,AHMEDABAD,JODHPUR,4239,4790,AHMEDABAD-JODHPUR,9029,All
2020,1,AHMEDABAD,JODHPUR,3816,4395,AHMEDABAD-JODHPUR,8211,All
2020,2,AHMEDABAD,JODHPUR,3648,3729,AHMEDABAD-JODHPUR,7377,All
2020,3,AHMEDABAD,JODHPUR,1861,1937,AHMEDABAD-JODHPUR,3798,All
2021,7,AHMEDABAD,JODHPUR,365,404,AHMEDABAD-JODHPUR,769,All
2021,8,AHMEDABAD,JODHPUR,270,266,AHMEDABAD-JODHPUR,536,All
2021,10,AHMEDABAD,JODHPUR,43,116,AHMEDABAD-JODHPUR,159,All
2021,11,AHMEDABAD,JODHPUR,1808,1475,AHMEDABAD-JODHPUR,3283,All
2021,12,AHMEDABAD,JODHPUR,1827,1775,AHMEDABAD-JODHPUR,3602,All
2022,1,AHMEDABAD,JODHPUR,460,478,AHMEDABAD-JODHPUR,938,All
2022,6,AHMEDABAD,JODHPUR,1520,1477,AHMEDABAD-JODHPUR,2997,All
2022,7,AHMEDABAD,JODHPUR,1624,1429,AHMEDABAD-JODHPUR,3053,All
2022,8,AHMEDABAD,JODHPUR,1647,1568,AHMEDABAD-JODHPUR,3215,All
2022,9,AHMEDABAD,JODHPUR,1919,1686,AHMEDABAD-JODHPUR,3605,All
2022,10,AHMEDABAD,JODHPUR,1990,1521,AHMEDABAD-JODHPUR,3511,All
2022,11,AHMEDABAD,JODHPUR,1579,1715,AHMEDABAD-JODHPUR,3294,All
2022,12,AHMEDABAD,JODHPUR,1634,1678,AHMEDABAD-JODHPUR,3312,All
2023,1,AHMEDABAD,JODHPUR,1740,1549,AHMEDABAD-JODHPUR,3289,All
2023,2,AHMEDABAD,JODHPUR,1669,1541,AHMEDABAD-JODHPUR,3210,All
2023,3,AHMEDABAD,JODHPUR,1644,1541,AHMEDABAD-JODHPUR,3185,All
2023,4,AHMEDABAD,JODHPUR,1843,1729,AHMEDABAD-JODHPUR,3572,All
2023,5,AHMEDABAD,JODHPUR,1909,1888,AHMEDABAD-JODHPUR,3797,All
2023,6,AHMEDABAD,JODHPUR,1825,2017,AHMEDABAD-JODHPUR,3842,All
2023,7,AHMEDABAD,JODHPUR,1678,1609,AHMEDABAD-JODHPUR,3287,All
2023,8,AHMEDABAD,JODHPUR,1531,1334,AHMEDABAD-JODHPUR,2865,All
2023,9,AHMEDABAD,JODHPUR,1783,1708,AHMEDABAD-JODHPUR,3491,All
2023,10,AHMEDABAD,JODHPUR,1794,1801,AHMEDABAD-JODHPUR,3595,All
2023,11,AHMEDABAD,JODHPUR,2023,1690,AHMEDABAD-JODHPUR,3713,All
2023,12,AHMEDABAD,JODHPUR,2081,2142,AHMEDABAD-JODHPUR,4223,All
2024,1,AHMEDABAD,JODHPUR,2178,2010,AHMEDABAD-JODHPUR,4188,All
2024,2,AHMEDABAD,JODHPUR,1997,1730,AHMEDABAD-JODHPUR,3727,All
2024,3,AHMEDABAD,JODHPUR,2077,1647,AHMEDABAD-JODHPUR,3724,All
2024,4,AHMEDABAD,JODHPUR,2076,1733,AHMEDABAD-JODHPUR,3809,All
2024,6,AHMEDABAD,JODHPUR,1838,1528,AHMEDABAD-JODHPUR,3366,All
2024,7,AHMEDABAD,JODHPUR,1966,1631,AHMEDABAD-JODHPUR,3597,All
2024,8,AHMEDABAD,JODHPUR,1978,1765,AHMEDABAD-JODHPUR,3743,All
2024,9,AHMEDABAD,JODHPUR,2091,1912,AHMEDABAD-JODHPUR,4003,All
2024,10,AHMEDABAD,JODHPUR,2138,1705,AHMEDABAD-JODHPUR,3843,All
2024,11,AHMEDABAD,JODHPUR,2032,2087,AHMEDABAD-JODHPUR,4119,All
2024,12,AHMEDABAD,JODHPUR,2089,2027,AHMEDABAD-JODHPUR,4116,All
2025,1,AHMEDABAD,JODHPUR,2143,2174,AHMEDABAD-JODHPUR,4317,All
2025,2,AHMEDABAD,JODHPUR,2093,1811,AHMEDABAD-JODHPUR,3904,All
2025,3,AHMEDABAD,JODHPUR,2015,1994,AHMEDABAD-JODHPUR,4009,All
2017,2,AHMEDABAD,JORHAT,7,11,AHMEDABAD-JORHAT,18,All
2017,3,AHMEDABAD,JORHAT,9,25,AHMEDABAD-JORHAT,34,All
2017,6,AHMEDABAD,JORHAT,28,29,AHMEDABAD-JORHAT,57,All
2019,5,AHMEDABAD,KANDLA,690,858,AHMEDABAD-KANDLA,1548,All
2019,6,AHMEDABAD,KANDLA,897,1244,AHMEDABAD-KANDLA,2141,All
2019,7,AHMEDABAD,KANDLA,1408,1450,AHMEDABAD-KANDLA,2858,All
2019,8,AHMEDABAD,KANDLA,1364,1458,AHMEDABAD-KANDLA,2822,All
2019,9,AHMEDABAD,KANDLA,1336,1644,AHMEDABAD-KANDLA,2980,All
2019,10,AHMEDABAD,KANDLA,1615,1832,AHMEDABAD-KANDLA,3447,All
2019,11,AHMEDABAD,KANDLA,2187,2249,AHMEDABAD-KANDLA,4436,All
2019,12,AHMEDABAD,KANDLA,2842,2869,AHMEDABAD-KANDLA,5711,All
2020,1,AHMEDABAD,KANDLA,2577,2732,AHMEDABAD-KANDLA,5309,All
2020,2,AHMEDABAD,KANDLA,2282,2289,AHMEDABAD-KANDLA,4571,All
2020,3,AHMEDABAD,KANDLA,1512,1582,AHMEDABAD-KANDLA,3094,All
2020,5,AHMEDABAD,KANDLA,75,60,AHMEDABAD-KANDLA,135,All
2020,6,AHMEDABAD,KANDLA,435,337,AHMEDABAD-KANDLA,772,All
2020,7,AHMEDABAD,KANDLA,375,342,AHMEDABAD-KANDLA,717,All
2020,8,AHMEDABAD,KANDLA,392,401,AHMEDABAD-KANDLA,793,All
2020,9,AHMEDABAD,KANDLA,669,781,AHMEDABAD-KANDLA,1450,All
2020,10,AHMEDABAD,KANDLA,937,920,AHMEDABAD-KANDLA,1857,All
2020,11,AHMEDABAD,KANDLA,1361,1300,AHMEDABAD-KANDLA,2661,All
2020,12,AHMEDABAD,KANDLA,1347,1448,AHMEDABAD-KANDLA,2795,All
2021,1,AHMEDABAD,KANDLA,1529,1660,AHMEDABAD-KANDLA,3189,All
2021,2,AHMEDABAD,KANDLA,1663,1724,AHMEDABAD-KANDLA,3387,All
2021,3,AHMEDABAD,KANDLA,1640,1744,AHMEDABAD-KANDLA,3384,All
2021,4,AHMEDABAD,KANDLA,767,694,AHMEDABAD-KANDLA,1461,All
2021,6,AHMEDABAD,KANDLA,89,136,AHMEDABAD-KANDLA,225,All
2021,7,AHMEDABAD,KANDLA,152,233,AHMEDABAD-KANDLA,385,All
2021,8,AHMEDABAD,KANDLA,603,608,AHMEDABAD-KANDLA,1211,All
2021,9,AHMEDABAD,KANDLA,566,791,AHMEDABAD-KANDLA,1357,All
2021,10,AHMEDABAD,KANDLA,712,810,AHMEDABAD-KANDLA,1522,All
2021,11,AHMEDABAD,KANDLA,536,593,AHMEDABAD-KANDLA,1129,All
2021,12,AHMEDABAD,KANDLA,483,718,AHMEDABAD-KANDLA,1201,All
2022,1,AHMEDABAD,KANDLA,162,148,AHMEDABAD-KANDLA,310,All
2019,9,AHMEDABAD,KANPUR,166,178,AHMEDABAD-KANPUR,344,All
2019,10,AHMEDABAD,KANPUR,1295,1005,AHMEDABAD-KANPUR,2300,All
2019,12,AHMEDABAD,KANPUR,874,908,AHMEDABAD-KANPUR,1782,All
2020,1,AHMEDABAD,KANPUR,1891,1834,AHMEDABAD-KANPUR,3725,All
2020,2,AHMEDABAD,KANPUR,1948,1931,AHMEDABAD-KANPUR,3879,All
2020,3,AHMEDABAD,KANPUR,1460,1411,AHMEDABAD-KANPUR,2871,All
2020,10,AHMEDABAD,KANPUR,319,261,AHMEDABAD-KANPUR,580,All
2020,11,AHMEDABAD,KANPUR,2107,1511,AHMEDABAD-KANPUR,3618,All
2020,12,AHMEDABAD,KANPUR,1560,2162,AHMEDABAD-KANPUR,3722,All
2021,1,AHMEDABAD,KANPUR,1031,1156,AHMEDABAD-KANPUR,2187,All
2021,2,AHMEDABAD,KANPUR,419,472,AHMEDABAD-KANPUR,891,All
2024,10,AHMEDABAD,KESHOD,99,70,AHMEDABAD-KESHOD,169,All
2024,11,AHMEDABAD,KESHOD,690,676,AHMEDABAD-KESHOD,1366,All
2024,12,AHMEDABAD,KESHOD,410,284,AHMEDABAD-KESHOD,694,All
2025,1,AHMEDABAD,KESHOD,441,332,AHMEDABAD-KESHOD,773,All
2025,2,AHMEDABAD,KESHOD,455,325,AHMEDABAD-KESHOD,780,All
2025,3,AHMEDABAD,KESHOD,378,180,AHMEDABAD-KESHOD,558,All
2015,4,AHMEDABAD,KOCHI,1266,1117,AHMEDABAD-KOCHI,2383,All
2015,5,AHMEDABAD,KOCHI,2495,2027,AHMEDABAD-KOCHI,4522,All
2015,6,AHMEDABAD,KOCHI,800,1346,AHMEDABAD-KOCHI,2146,All
2015,7,AHMEDABAD,KOCHI,574,562,AHMEDABAD-KOCHI,1136,All
2015,8,AHMEDABAD,KOCHI,1106,1121,AHMEDABAD-KOCHI,2227,All
2015,9,AHMEDABAD,KOCHI,1621,1948,AHMEDABAD-KOCHI,3569,All
2015,10,AHMEDABAD,KOCHI,1470,1730,AHMEDABAD-KOCHI,3200,All
2015,11,AHMEDABAD,KOCHI,2651,2629,AHMEDABAD-KOCHI,5280,All
2015,12,AHMEDABAD,KOCHI,2305,2396,AHMEDABAD-KOCHI,4701,All
2016,1,AHMEDABAD,KOCHI,2468,2358,AHMEDABAD-KOCHI,4826,All
2016,2,AHMEDABAD,KOCHI,1868,2149,AHMEDABAD-KOCHI,4017,All
2016,3,AHMEDABAD,KOCHI,1299,1442,AHMEDABAD-KOCHI,2741,All
2016,4,AHMEDABAD,KOCHI,1633,1688,AHMEDABAD-KOCHI,3321,All
2016,5,AHMEDABAD,KOCHI,2955,2525,AHMEDABAD-KOCHI,5480,All
2016,6,AHMEDABAD,KOCHI,991,1508,AHMEDABAD-KOCHI,2499,All
2016,7,AHMEDABAD,KOCHI,1083,871,AHMEDABAD-KOCHI,1954,All
2016,8,AHMEDABAD,KOCHI,1414,1381,AHMEDABAD-KOCHI,2795,All
2016,9,AHMEDABAD,KOCHI,932,1222,AHMEDABAD-KOCHI,2154,All
2016,10,AHMEDABAD,KOCHI,1690,1094,AHMEDABAD-KOCHI,2784,All
2016,11,AHMEDABAD,KOCHI,1559,2168,AHMEDABAD-KOCHI,3727,All
2016,12,AHMEDABAD,KOCHI,1757,1751,AHMEDABAD-KOCHI,3508,All
2017,1,AHMEDABAD,KOCHI,1994,1679,AHMEDABAD-KOCHI,3673,All
2017,2,AHMEDABAD,KOCHI,3719,3091,AHMEDABAD-KOCHI,6810,All
2017,3,AHMEDABAD,KOCHI,5046,4743,AHMEDABAD-KOCHI,9789,All
2017,4,AHMEDABAD,KOCHI,5064,5200,AHMEDABAD-KOCHI,10264,All
2017,5,AHMEDABAD,KOCHI,6965,6744,AHMEDABAD-KOCHI,13709,All
2017,6,AHMEDABAD,KOCHI,5574,6248,AHMEDABAD-KOCHI,11822,All
2017,7,AHMEDABAD,KOCHI,5131,5887,AHMEDABAD-KOCHI,11018,All
2017,8,AHMEDABAD,KOCHI,5918,6235,AHMEDABAD-KOCHI,12153,All
2017,9,AHMEDABAD,KOCHI,4729,5451,AHMEDABAD-KOCHI,10180,All
2017,10,AHMEDABAD,KOCHI,6243,6398,AHMEDABAD-KOCHI,12641,All
2017,11,AHMEDABAD,KOCHI,5300,6580,AHMEDABAD-KOCHI,11880,All
2017,12,AHMEDABAD,KOCHI,5152,5636,AHMEDABAD-KOCHI,10788,All
2018,1,AHMEDABAD,KOCHI,5608,6003,AHMEDABAD-KOCHI,11611,All
2018,2,AHMEDABAD,KOCHI,5057,5545,AHMEDABAD-KOCHI,10602,All
2018,3,AHMEDABAD,KOCHI,1739,1450,AHMEDABAD-KOCHI,3189,All
2018,4,AHMEDABAD,KOCHI,3681,3134,AHMEDABAD-KOCHI,6815,All
2018,5,AHMEDABAD,KOCHI,8117,8948,AHMEDABAD-KOCHI,17065,All
2018,6,AHMEDABAD,KOCHI,9005,10967,AHMEDABAD-KOCHI,19972,All
2018,7,AHMEDABAD,KOCHI,9151,9820,AHMEDABAD-KOCHI,18971,All
2018,8,AHMEDABAD,KOCHI,4588,4710,AHMEDABAD-KOCHI,9298,All
2018,9,AHMEDABAD,KOCHI,8370,10815,AHMEDABAD-KOCHI,19185,All
2018,10,AHMEDABAD,KOCHI,9122,9894,AHMEDABAD-KOCHI,19016,All
2018,11,AHMEDABAD,KOCHI,10487,11110,AHMEDABAD-KOCHI,21597,All
2018,12,AHMEDABAD,KOCHI,12490,11323,AHMEDABAD-KOCHI,23813,All
2019,1,AHMEDABAD,KOCHI,10309,11690,AHMEDABAD-KOCHI,21999,All
2019,2,AHMEDABAD,KOCHI,9801,10014,AHMEDABAD-KOCHI,19815,All
2019,3,AHMEDABAD,KOCHI,10681,11064,AHMEDABAD-KOCHI,21745,All
2019,4,AHMEDABAD,KOCHI,13467,12036,AHMEDABAD-KOCHI,25503,All
2019,5,AHMEDABAD,KOCHI,15617,14439,AHMEDABAD-KOCHI,30056,All
2019,6,AHMEDABAD,KOCHI,12842,14294,AHMEDABAD-KOCHI,27136,All
2019,7,AHMEDABAD,KOCHI,9309,10202,AHMEDABAD-KOCHI,19511,All
2019,8,AHMEDABAD,KOCHI,8681,9774,AHMEDABAD-KOCHI,18455,All
2019,9,AHMEDABAD,KOCHI,8024,11037,AHMEDABAD-KOCHI,19061,All
2019,10,AHMEDABAD,KOCHI,8863,9691,AHMEDABAD-KOCHI,18554,All
2019,11,AHMEDABAD,KOCHI,7765,9522,AHMEDABAD-KOCHI,17287,All
2019,12,AHMEDABAD,KOCHI,5329,5576,AHMEDABAD-KOCHI,10905,All
2020,1,AHMEDABAD,KOCHI,5243,5895,AHMEDABAD-KOCHI,11138,All
2020,2,AHMEDABAD,KOCHI,4859,5349,AHMEDABAD-KOCHI,10208,All
2020,3,AHMEDABAD,KOCHI,2685,3037,AHMEDABAD-KOCHI,5722,All
2020,7,AHMEDABAD,KOCHI,733,269,AHMEDABAD-KOCHI,1002,All
2020,8,AHMEDABAD,KOCHI,891,649,AHMEDABAD-KOCHI,1540,All
2020,9,AHMEDABAD,KOCHI,1582,1416,AHMEDABAD-KOCHI,2998,All
2020,10,AHMEDABAD,KOCHI,1119,1082,AHMEDABAD-KOCHI,2201,All
2020,11,AHMEDABAD,KOCHI,2731,2535,AHMEDABAD-KOCHI,5266,All
2020,12,AHMEDABAD,KOCHI,4019,2536,AHMEDABAD-KOCHI,6555,All
2021,1,AHMEDABAD,KOCHI,5089,4167,AHMEDABAD-KOCHI,9256,All
2021,2,AHMEDABAD,KOCHI,4194,3657,AHMEDABAD-KOCHI,7851,All
2021,3,AHMEDABAD,KOCHI,3963,3576,AHMEDABAD-KOCHI,7539,All
2021,4,AHMEDABAD,KOCHI,3661,2760,AHMEDABAD-KOCHI,6421,All
2021,6,AHMEDABAD,KOCHI,483,359,AHMEDABAD-KOCHI,842,All
2021,7,AHMEDABAD,KOCHI,1738,1236,AHMEDABAD-KOCHI,2974,All
2021,8,AHMEDABAD,KOCHI,2576,2014,AHMEDABAD-KOCHI,4590,All
2021,9,AHMEDABAD,KOCHI,1232,1445,AHMEDABAD-KOCHI,2677,All
2021,10,AHMEDABAD,KOCHI,2244,1846,AHMEDABAD-KOCHI,4090,All
2021,11,AHMEDABAD,KOCHI,6544,6025,AHMEDABAD-KOCHI,12569,All
2021,12,AHMEDABAD,KOCHI,5307,4018,AHMEDABAD-KOCHI,9325,All
2022,1,AHMEDABAD,KOCHI,2888,2656,AHMEDABAD-KOCHI,5544,All
2022,2,AHMEDABAD,KOCHI,674,642,AHMEDABAD-KOCHI,1316,All
2022,3,AHMEDABAD,KOCHI,1047,842,AHMEDABAD-KOCHI,1889,All
2022,6,AHMEDABAD,KOCHI,3889,3583,AHMEDABAD-KOCHI,7472,All
2022,7,AHMEDABAD,KOCHI,3420,2883,AHMEDABAD-KOCHI,6303,All
2022,8,AHMEDABAD,KOCHI,3445,2885,AHMEDABAD-KOCHI,6330,All
2022,9,AHMEDABAD,KOCHI,3034,3289,AHMEDABAD-KOCHI,6323,All
2022,10,AHMEDABAD,KOCHI,3862,3357,AHMEDABAD-KOCHI,7219,All
2022,11,AHMEDABAD,KOCHI,4889,4853,AHMEDABAD-KOCHI,9742,All
2022,12,AHMEDABAD,KOCHI,5193,4296,AHMEDABAD-KOCHI,9489,All
2023,1,AHMEDABAD,KOCHI,4811,4751,AHMEDABAD-KOCHI,9562,All
2023,2,AHMEDABAD,KOCHI,4678,4439,AHMEDABAD-KOCHI,9117,All
2023,3,AHMEDABAD,KOCHI,4216,4213,AHMEDABAD-KOCHI,8429,All
2023,4,AHMEDABAD,KOCHI,4033,4673,AHMEDABAD-KOCHI,8706,All
2023,5,AHMEDABAD,KOCHI,5422,4671,AHMEDABAD-KOCHI,10093,All
2023,6,AHMEDABAD,KOCHI,6591,6045,AHMEDABAD-KOCHI,12636,All
2023,7,AHMEDABAD,KOCHI,5974,5172,AHMEDABAD-KOCHI,11146,All
2023,8,AHMEDABAD,KOCHI,5151,5010,AHMEDABAD-KOCHI,10161,All
2023,9,AHMEDABAD,KOCHI,4704,5066,AHMEDABAD-KOCHI,9770,All
2023,10,AHMEDABAD,KOCHI,4812,4907,AHMEDABAD-KOCHI,9719,All
2023,11,AHMEDABAD,KOCHI,5222,5176,AHMEDABAD-KOCHI,10398,All
2023,12,AHMEDABAD,KOCHI,5442,5279,AHMEDABAD-KOCHI,10721,All
2024,1,AHMEDABAD,KOCHI,5279,5320,AHMEDABAD-KOCHI,10599,All
2024,2,AHMEDABAD,KOCHI,4953,4806,AHMEDABAD-KOCHI,9759,All
2024,3,AHMEDABAD,KOCHI,5235,4782,AHMEDABAD-KOCHI,10017,All
2024,4,AHMEDABAD,KOCHI,4984,5047,AHMEDABAD-KOCHI,10031,All
2024,6,AHMEDABAD,KOCHI,5150,5013,AHMEDABAD-KOCHI,10163,All
2024,7,AHMEDABAD,KOCHI,5090,4477,AHMEDABAD-KOCHI,9567,All
2024,8,AHMEDABAD,KOCHI,4609,4906,AHMEDABAD-KOCHI,9515,All
2024,9,AHMEDABAD,KOCHI,4784,4682,AHMEDABAD-KOCHI,9466,All
2024,10,AHMEDABAD,KOCHI,5828,5184,AHMEDABAD-KOCHI,11012,All
2024,11,AHMEDABAD,KOCHI,7008,7162,AHMEDABAD-KOCHI,14170,All
2024,12,AHMEDABAD,KOCHI,7247,6713,AHMEDABAD-KOCHI,13960,All
2025,1,AHMEDABAD,KOCHI,7820,7820,AHMEDABAD-KOCHI,15640,All
2025,2,AHMEDABAD,KOCHI,6395,6434,AHMEDABAD-KOCHI,12829,All
2025,3,AHMEDABAD,KOCHI,6332,5991,AHMEDABAD-KOCHI,12323,All
2021,2,AHMEDABAD,KOLHAPUR,165,163,AHMEDABAD-KOLHAPUR,328,All
2021,3,AHMEDABAD,KOLHAPUR,595,532,AHMEDABAD-KOLHAPUR,1127,All
2021,4,AHMEDABAD,KOLHAPUR,192,245,AHMEDABAD-KOLHAPUR,437,All
2021,7,AHMEDABAD,KOLHAPUR,181,274,AHMEDABAD-KOLHAPUR,455,All
2021,8,AHMEDABAD,KOLHAPUR,644,610,AHMEDABAD-KOLHAPUR,1254,All
2021,9,AHMEDABAD,KOLHAPUR,681,638,AHMEDABAD-KOLHAPUR,1319,All
2021,10,AHMEDABAD,KOLHAPUR,667,550,AHMEDABAD-KOLHAPUR,1217,All
2022,6,AHMEDABAD,KOLHAPUR,693,613,AHMEDABAD-KOLHAPUR,1306,All
2022,7,AHMEDABAD,KOLHAPUR,701,681,AHMEDABAD-KOLHAPUR,1382,All
2022,8,AHMEDABAD,KOLHAPUR,623,614,AHMEDABAD-KOLHAPUR,1237,All
2022,9,AHMEDABAD,KOLHAPUR,628,514,AHMEDABAD-KOLHAPUR,1142,All
2022,10,AHMEDABAD,KOLHAPUR,665,441,AHMEDABAD-KOLHAPUR,1106,All
2022,11,AHMEDABAD,KOLHAPUR,988,773,AHMEDABAD-KOLHAPUR,1761,All
2022,12,AHMEDABAD,KOLHAPUR,1000,709,AHMEDABAD-KOLHAPUR,1709,All
2023,1,AHMEDABAD,KOLHAPUR,1011,854,AHMEDABAD-KOLHAPUR,1865,All
2023,2,AHMEDABAD,KOLHAPUR,971,952,AHMEDABAD-KOLHAPUR,1923,All
2023,3,AHMEDABAD,KOLHAPUR,894,744,AHMEDABAD-KOLHAPUR,1638,All
2023,4,AHMEDABAD,KOLHAPUR,714,612,AHMEDABAD-KOLHAPUR,1326,All
2023,5,AHMEDABAD,KOLHAPUR,944,654,AHMEDABAD-KOLHAPUR,1598,All
2024,10,AHMEDABAD,KOLHAPUR,97,82,AHMEDABAD-KOLHAPUR,179,All
2024,11,AHMEDABAD,KOLHAPUR,598,607,AHMEDABAD-KOLHAPUR,1205,All
2024,12,AHMEDABAD,KOLHAPUR,480,473,AHMEDABAD-KOLHAPUR,953,All
2025,1,AHMEDABAD,KOLHAPUR,789,696,AHMEDABAD-KOLHAPUR,1485,All
2025,2,AHMEDABAD,KOLHAPUR,668,612,AHMEDABAD-KOLHAPUR,1280,All
2025,3,AHMEDABAD,KOLHAPUR,775,677,AHMEDABAD-KOLHAPUR,1452,All
2015,4,AHMEDABAD,KOLKATA,11814,9387,AHMEDABAD-KOLKATA,21201,All
2015,5,AHMEDABAD,KOLKATA,15614,13532,AHMEDABAD-KOLKATA,29146,All
2015,6,AHMEDABAD,KOLKATA,10372,12691,AHMEDABAD-KOLKATA,23063,All
2015,7,AHMEDABAD,KOLKATA,11000,10322,AHMEDABAD-KOLKATA,21322,All
2015,8,AHMEDABAD,KOLKATA,9813,10233,AHMEDABAD-KOLKATA,20046,All
2015,9,AHMEDABAD,KOLKATA,10777,9785,AHMEDABAD-KOLKATA,20562,All
2015,10,AHMEDABAD,KOLKATA,11531,11192,AHMEDABAD-KOLKATA,22723,All
2015,11,AHMEDABAD,KOLKATA,13271,11882,AHMEDABAD-KOLKATA,25153,All
2015,12,AHMEDABAD,KOLKATA,13214,14235,AHMEDABAD-KOLKATA,27449,All
2016,1,AHMEDABAD,KOLKATA,13549,13190,AHMEDABAD-KOLKATA,26739,All
2016,2,AHMEDABAD,KOLKATA,13354,12753,AHMEDABAD-KOLKATA,26107,All
2016,3,AHMEDABAD,KOLKATA,14054,12915,AHMEDABAD-KOLKATA,26969,All
2016,4,AHMEDABAD,KOLKATA,12982,11701,AHMEDABAD-KOLKATA,24683,All
2016,5,AHMEDABAD,KOLKATA,12916,12312,AHMEDABAD-KOLKATA,25228,All
2016,6,AHMEDABAD,KOLKATA,10987,11356,AHMEDABAD-KOLKATA,22343,All
2016,7,AHMEDABAD,KOLKATA,10822,11230,AHMEDABAD-KOLKATA,22052,All
2016,8,AHMEDABAD,KOLKATA,10772,10658,AHMEDABAD-KOLKATA,21430,All
2016,9,AHMEDABAD,KOLKATA,10898,10307,AHMEDABAD-KOLKATA,21205,All
2016,10,AHMEDABAD,KOLKATA,14357,11473,AHMEDABAD-KOLKATA,25830,All
2016,11,AHMEDABAD,KOLKATA,13456,14512,AHMEDABAD-KOLKATA,27968,All
2016,12,AHMEDABAD,KOLKATA,14887,14452,AHMEDABAD-KOLKATA,29339,All
2017,1,AHMEDABAD,KOLKATA,14920,14545,AHMEDABAD-KOLKATA,29465,All
2017,2,AHMEDABAD,KOLKATA,12966,12500,AHMEDABAD-KOLKATA,25466,All
2017,3,AHMEDABAD,KOLKATA,12217,12597,AHMEDABAD-KOLKATA,24814,All
2017,4,AHMEDABAD,KOLKATA,13698,12540,AHMEDABAD-KOLKATA,26238,All
2017,5,AHMEDABAD,KOLKATA,16129,15340,AHMEDABAD-KOLKATA,31469,All
2017,6,AHMEDABAD,KOLKATA,13062,13968,AHMEDABAD-KOLKATA,27030,All
2017,7,AHMEDABAD,KOLKATA,11602,12326,AHMEDABAD-KOLKATA,23928,All
2017,8,AHMEDABAD,KOLKATA,12475,11339,AHMEDABAD-KOLKATA,23814,All
2017,9,AHMEDABAD,KOLKATA,15379,15419,AHMEDABAD-KOLKATA,30798,All
2017,10,AHMEDABAD,KOLKATA,19859,17505,AHMEDABAD-KOLKATA,37364,All
2017,11,AHMEDABAD,KOLKATA,18359,19471,AHMEDABAD-KOLKATA,37830,All
2017,12,AHMEDABAD,KOLKATA,18677,19129,AHMEDABAD-KOLKATA,37806,All
2018,1,AHMEDABAD,KOLKATA,20517,19270,AHMEDABAD-KOLKATA,39787,All
2018,2,AHMEDABAD,KOLKATA,19232,18343,AHMEDABAD-KOLKATA,37575,All
2018,3,AHMEDABAD,KOLKATA,16506,15272,AHMEDABAD-KOLKATA,31778,All
2018,4,AHMEDABAD,KOLKATA,19010,16464,AHMEDABAD-KOLKATA,35474,All
2018,5,AHMEDABAD,KOLKATA,21281,19856,AHMEDABAD-KOLKATA,41137,All
2018,6,AHMEDABAD,KOLKATA,19464,18983,AHMEDABAD-KOLKATA,38447,All
2018,7,AHMEDABAD,KOLKATA,18298,19086,AHMEDABAD-KOLKATA,37384,All
2018,8,AHMEDABAD,KOLKATA,18263,16678,AHMEDABAD-KOLKATA,34941,All
2018,9,AHMEDABAD,KOLKATA,22258,20911,AHMEDABAD-KOLKATA,43169,All
2018,10,AHMEDABAD,KOLKATA,25951,22190,AHMEDABAD-KOLKATA,48141,All
2018,11,AHMEDABAD,KOLKATA,24736,22063,AHMEDABAD-KOLKATA,46799,All
2018,12,AHMEDABAD,KOLKATA,23092,20987,AHMEDABAD-KOLKATA,44079,All
2019,1,AHMEDABAD,KOLKATA,24482,21119,AHMEDABAD-KOLKATA,45601,All
2019,2,AHMEDABAD,KOLKATA,21965,19168,AHMEDABAD-KOLKATA,41133,All
2019,3,AHMEDABAD,KOLKATA,21322,20612,AHMEDABAD-KOLKATA,41934,All
2019,4,AHMEDABAD,KOLKATA,20764,18127,AHMEDABAD-KOLKATA,38891,All
2019,5,AHMEDABAD,KOLKATA,21526,20288,AHMEDABAD-KOLKATA,41814,All
2019,6,AHMEDABAD,KOLKATA,19553,19432,AHMEDABAD-KOLKATA,38985,All
2019,7,AHMEDABAD,KOLKATA,18596,18155,AHMEDABAD-KOLKATA,36751,All
2019,8,AHMEDABAD,KOLKATA,18646,16880,AHMEDABAD-KOLKATA,35526,All
2019,9,AHMEDABAD,KOLKATA,18837,17494,AHMEDABAD-KOLKATA,36331,All
2019,10,AHMEDABAD,KOLKATA,26882,21252,AHMEDABAD-KOLKATA,48134,All
2019,11,AHMEDABAD,KOLKATA,25357,26379,AHMEDABAD-KOLKATA,51736,All
2019,12,AHMEDABAD,KOLKATA,25426,24437,AHMEDABAD-KOLKATA,49863,All
2020,1,AHMEDABAD,KOLKATA,26248,24067,AHMEDABAD-KOLKATA,50315,All
2020,2,AHMEDABAD,KOLKATA,23209,22282,AHMEDABAD-KOLKATA,45491,All
2020,3,AHMEDABAD,KOLKATA,15029,13305,AHMEDABAD-KOLKATA,28334,All
2020,5,AHMEDABAD,KOLKATA,0,0,AHMEDABAD-KOLKATA,0,All
2020,6,AHMEDABAD,KOLKATA,6712,3605,AHMEDABAD-KOLKATA,10317,All
2020,7,AHMEDABAD,KOLKATA,1685,978,AHMEDABAD-KOLKATA,2663,All
2020,8,AHMEDABAD,KOLKATA,0,80,AHMEDABAD-KOLKATA,80,All
2020,9,AHMEDABAD,KOLKATA,5971,6732,AHMEDABAD-KOLKATA,12703,All
2020,10,AHMEDABAD,KOLKATA,7663,10266,AHMEDABAD-KOLKATA,17929,All
2020,11,AHMEDABAD,KOLKATA,9597,11336,AHMEDABAD-KOLKATA,20933,All
2020,12,AHMEDABAD,KOLKATA,11435,10367,AHMEDABAD-KOLKATA,21802,All
2021,1,AHMEDABAD,KOLKATA,10282,12005,AHMEDABAD-KOLKATA,22287,All
2021,2,AHMEDABAD,KOLKATA,9913,11259,AHMEDABAD-KOLKATA,21172,All
2021,3,AHMEDABAD,KOLKATA,10856,11496,AHMEDABAD-KOLKATA,22352,All
2021,4,AHMEDABAD,KOLKATA,6633,6582,AHMEDABAD-KOLKATA,13215,All
2021,6,AHMEDABAD,KOLKATA,3587,7215,AHMEDABAD-KOLKATA,10802,All
2021,7,AHMEDABAD,KOLKATA,6516,9430,AHMEDABAD-KOLKATA,15946,All
2021,8,AHMEDABAD,KOLKATA,7865,12305,AHMEDABAD-KOLKATA,20170,All
2021,9,AHMEDABAD,KOLKATA,7889,10767,AHMEDABAD-KOLKATA,18656,All
2021,10,AHMEDABAD,KOLKATA,10940,12422,AHMEDABAD-KOLKATA,23362,All
2021,11,AHMEDABAD,KOLKATA,11506,13636,AHMEDABAD-KOLKATA,25142,All
2021,12,AHMEDABAD,KOLKATA,12377,14475,AHMEDABAD-KOLKATA,26852,All
2022,1,AHMEDABAD,KOLKATA,8286,10191,AHMEDABAD-KOLKATA,18477,All
2022,2,AHMEDABAD,KOLKATA,15492,15263,AHMEDABAD-KOLKATA,30755,All
2022,3,AHMEDABAD,KOLKATA,17003,15975,AHMEDABAD-KOLKATA,32978,All
2022,4,AHMEDABAD,KOLKATA,19397,15770,AHMEDABAD-KOLKATA,35167,All
2022,5,AHMEDABAD,KOLKATA,20590,17939,AHMEDABAD-KOLKATA,38529,All
2022,6,AHMEDABAD,KOLKATA,14909,16903,AHMEDABAD-KOLKATA,31812,All
2022,7,AHMEDABAD,KOLKATA,15402,15948,AHMEDABAD-KOLKATA,31350,All
2022,8,AHMEDABAD,KOLKATA,14599,16007,AHMEDABAD-KOLKATA,30606,All
2022,9,AHMEDABAD,KOLKATA,15613,14704,AHMEDABAD-KOLKATA,30317,All
2022,10,AHMEDABAD,KOLKATA,20884,15965,AHMEDABAD-KOLKATA,36849,All
2022,11,AHMEDABAD,KOLKATA,16539,20237,AHMEDABAD-KOLKATA,36776,All
2022,12,AHMEDABAD,KOLKATA,20844,20741,AHMEDABAD-KOLKATA,41585,All
2023,1,AHMEDABAD,KOLKATA,23812,21647,AHMEDABAD-KOLKATA,45459,All
2023,2,AHMEDABAD,KOLKATA,22283,21296,AHMEDABAD-KOLKATA,43579,All
2023,3,AHMEDABAD,KOLKATA,19446,19058,AHMEDABAD-KOLKATA,38504,All
2023,4,AHMEDABAD,KOLKATA,14710,12879,AHMEDABAD-KOLKATA,27589,All
2023,5,AHMEDABAD,KOLKATA,14782,15125,AHMEDABAD-KOLKATA,29907,All
2023,6,AHMEDABAD,KOLKATA,13419,13463,AHMEDABAD-KOLKATA,26882,All
2023,7,AHMEDABAD,KOLKATA,13236,14457,AHMEDABAD-KOLKATA,27693,All
2023,8,AHMEDABAD,KOLKATA,14344,14735,AHMEDABAD-KOLKATA,29079,All
2023,9,AHMEDABAD,KOLKATA,15553,16407,AHMEDABAD-KOLKATA,31960,All
2023,10,AHMEDABAD,KOLKATA,17748,16193,AHMEDABAD-KOLKATA,33941,All
2023,11,AHMEDABAD,KOLKATA,20482,17563,AHMEDABAD-KOLKATA,38045,All
2023,12,AHMEDABAD,KOLKATA,17582,17916,AHMEDABAD-KOLKATA,35498,All
2024,1,AHMEDABAD,KOLKATA,15798,15237,AHMEDABAD-KOLKATA,31035,All
2024,2,AHMEDABAD,KOLKATA,13597,13516,AHMEDABAD-KOLKATA,27113,All
2024,3,AHMEDABAD,KOLKATA,14715,13608,AHMEDABAD-KOLKATA,28323,All
2024,4,AHMEDABAD,KOLKATA,15881,14141,AHMEDABAD-KOLKATA,30022,All
2024,6,AHMEDABAD,KOLKATA,14216,14021,AHMEDABAD-KOLKATA,28237,All
2024,7,AHMEDABAD,KOLKATA,13484,14928,AHMEDABAD-KOLKATA,28412,All
2024,8,AHMEDABAD,KOLKATA,13697,13608,AHMEDABAD-KOLKATA,27305,All
2024,9,AHMEDABAD,KOLKATA,14764,13656,AHMEDABAD-KOLKATA,28420,All
2024,10,AHMEDABAD,KOLKATA,17921,15261,AHMEDABAD-KOLKATA,33182,All
2024,11,AHMEDABAD,KOLKATA,17400,18446,AHMEDABAD-KOLKATA,35846,All
2024,12,AHMEDABAD,KOLKATA,23575,23563,AHMEDABAD-KOLKATA,47138,All
2025,1,AHMEDABAD,KOLKATA,24629,24149,AHMEDABAD-KOLKATA,48778,All
2025,2,AHMEDABAD,KOLKATA,23769,22682,AHMEDABAD-KOLKATA,46451,All
2025,3,AHMEDABAD,KOLKATA,24131,20763,AHMEDABAD-KOLKATA,44894,All
2017,3,AHMEDABAD,KOZHIKODE,276,243,AHMEDABAD-KOZHIKODE,519,All
2017,4,AHMEDABAD,KOZHIKODE,382,201,AHMEDABAD-KOZHIKODE,583,All
2018,4,AHMEDABAD,KOZHIKODE,79,32,AHMEDABAD-KOZHIKODE,111,All
2018,5,AHMEDABAD,KOZHIKODE,248,236,AHMEDABAD-KOZHIKODE,484,All
2018,6,AHMEDABAD,KOZHIKODE,25,132,AHMEDABAD-KOZHIKODE,157,All
2025,3,AHMEDABAD,Kishangarh,1427,1352,AHMEDABAD-Kishangarh,2779,All
2015,4,AHMEDABAD,LUCKNOW,1720,1408,AHMEDABAD-LUCKNOW,3128,All
2015,5,AHMEDABAD,LUCKNOW,1628,1370,AHMEDABAD-LUCKNOW,2998,All
2015,6,AHMEDABAD,LUCKNOW,1477,1511,AHMEDABAD-LUCKNOW,2988,All
2015,7,AHMEDABAD,LUCKNOW,1316,1425,AHMEDABAD-LUCKNOW,2741,All
2015,8,AHMEDABAD,LUCKNOW,1330,1173,AHMEDABAD-LUCKNOW,2503,All
2015,9,AHMEDABAD,LUCKNOW,1028,888,AHMEDABAD-LUCKNOW,1916,All
2015,10,AHMEDABAD,LUCKNOW,1135,1147,AHMEDABAD-LUCKNOW,2282,All
2015,11,AHMEDABAD,LUCKNOW,1265,898,AHMEDABAD-LUCKNOW,2163,All
2015,12,AHMEDABAD,LUCKNOW,1265,1013,AHMEDABAD-LUCKNOW,2278,All
2016,1,AHMEDABAD,LUCKNOW,1569,1306,AHMEDABAD-LUCKNOW,2875,All
2016,2,AHMEDABAD,LUCKNOW,878,983,AHMEDABAD-LUCKNOW,1861,All
2016,3,AHMEDABAD,LUCKNOW,837,749,AHMEDABAD-LUCKNOW,1586,All
2016,10,AHMEDABAD,LUCKNOW,0,6,AHMEDABAD-LUCKNOW,6,All
2016,11,AHMEDABAD,LUCKNOW,3592,3337,AHMEDABAD-LUCKNOW,6929,All
2016,12,AHMEDABAD,LUCKNOW,4798,4724,AHMEDABAD-LUCKNOW,9522,All
2017,1,AHMEDABAD,LUCKNOW,5129,4521,AHMEDABAD-LUCKNOW,9650,All
2017,2,AHMEDABAD,LUCKNOW,4442,4040,AHMEDABAD-LUCKNOW,8482,All
2017,3,AHMEDABAD,LUCKNOW,4681,4423,AHMEDABAD-LUCKNOW,9104,All
2017,4,AHMEDABAD,LUCKNOW,4741,3771,AHMEDABAD-LUCKNOW,8512,All
2017,5,AHMEDABAD,LUCKNOW,5155,4651,AHMEDABAD-LUCKNOW,9806,All
2017,6,AHMEDABAD,LUCKNOW,4242,4390,AHMEDABAD-LUCKNOW,8632,All
2017,7,AHMEDABAD,LUCKNOW,3683,3596,AHMEDABAD-LUCKNOW,7279,All
2017,8,AHMEDABAD,LUCKNOW,4272,4096,AHMEDABAD-LUCKNOW,8368,All
2017,9,AHMEDABAD,LUCKNOW,4070,4043,AHMEDABAD-LUCKNOW,8113,All
2017,10,AHMEDABAD,LUCKNOW,5448,4491,AHMEDABAD-LUCKNOW,9939,All
2017,11,AHMEDABAD,LUCKNOW,5670,5759,AHMEDABAD-LUCKNOW,11429,All
2017,12,AHMEDABAD,LUCKNOW,5393,5922,AHMEDABAD-LUCKNOW,11315,All
2018,1,AHMEDABAD,LUCKNOW,5715,5418,AHMEDABAD-LUCKNOW,11133,All
2018,2,AHMEDABAD,LUCKNOW,5405,5027,AHMEDABAD-LUCKNOW,10432,All
2018,3,AHMEDABAD,LUCKNOW,4903,5145,AHMEDABAD-LUCKNOW,10048,All
2018,4,AHMEDABAD,LUCKNOW,5115,3806,AHMEDABAD-LUCKNOW,8921,All
2018,5,AHMEDABAD,LUCKNOW,4912,5593,AHMEDABAD-LUCKNOW,10505,All
2018,6,AHMEDABAD,LUCKNOW,4589,5457,AHMEDABAD-LUCKNOW,10046,All
2018,7,AHMEDABAD,LUCKNOW,3098,3219,AHMEDABAD-LUCKNOW,6317,All
2018,8,AHMEDABAD,LUCKNOW,2930,2263,AHMEDABAD-LUCKNOW,5193,All
2018,9,AHMEDABAD,LUCKNOW,4208,4437,AHMEDABAD-LUCKNOW,8645,All
2018,10,AHMEDABAD,LUCKNOW,7530,6236,AHMEDABAD-LUCKNOW,13766,All
2018,11,AHMEDABAD,LUCKNOW,3669,4944,AHMEDABAD-LUCKNOW,8613,All
2018,12,AHMEDABAD,LUCKNOW,4167,5771,AHMEDABAD-LUCKNOW,9938,All
2019,1,AHMEDABAD,LUCKNOW,4083,5459,AHMEDABAD-LUCKNOW,9542,All
2019,2,AHMEDABAD,LUCKNOW,9388,9846,AHMEDABAD-LUCKNOW,19234,All
2019,3,AHMEDABAD,LUCKNOW,6514,8705,AHMEDABAD-LUCKNOW,15219,All
2019,4,AHMEDABAD,LUCKNOW,9430,8811,AHMEDABAD-LUCKNOW,18241,All
2019,5,AHMEDABAD,LUCKNOW,10219,9597,AHMEDABAD-LUCKNOW,19816,All
2019,6,AHMEDABAD,LUCKNOW,8216,10145,AHMEDABAD-LUCKNOW,18361,All
2019,7,AHMEDABAD,LUCKNOW,6833,8663,AHMEDABAD-LUCKNOW,15496,All
2019,8,AHMEDABAD,LUCKNOW,8764,9209,AHMEDABAD-LUCKNOW,17973,All
2019,9,AHMEDABAD,LUCKNOW,7625,8184,AHMEDABAD-LUCKNOW,15809,All
2019,10,AHMEDABAD,LUCKNOW,12849,9522,AHMEDABAD-LUCKNOW,22371,All
2019,11,AHMEDABAD,LUCKNOW,13554,14446,AHMEDABAD-LUCKNOW,28000,All
2019,12,AHMEDABAD,LUCKNOW,11436,13097,AHMEDABAD-LUCKNOW,24533,All
2020,1,AHMEDABAD,LUCKNOW,10946,10817,AHMEDABAD-LUCKNOW,21763,All
2020,2,AHMEDABAD,LUCKNOW,13414,11841,AHMEDABAD-LUCKNOW,25255,All
2020,3,AHMEDABAD,LUCKNOW,9240,8144,AHMEDABAD-LUCKNOW,17384,All
2020,5,AHMEDABAD,LUCKNOW,766,294,AHMEDABAD-LUCKNOW,1060,All
2020,6,AHMEDABAD,LUCKNOW,4810,3151,AHMEDABAD-LUCKNOW,7961,All
2020,7,AHMEDABAD,LUCKNOW,3354,3617,AHMEDABAD-LUCKNOW,6971,All
2020,8,AHMEDABAD,LUCKNOW,4408,9093,AHMEDABAD-LUCKNOW,13501,All
2020,9,AHMEDABAD,LUCKNOW,5046,12060,AHMEDABAD-LUCKNOW,17106,All
2020,10,AHMEDABAD,LUCKNOW,10440,10048,AHMEDABAD-LUCKNOW,20488,All
2020,11,AHMEDABAD,LUCKNOW,16199,9730,AHMEDABAD-LUCKNOW,25929,All
2020,12,AHMEDABAD,LUCKNOW,13499,13431,AHMEDABAD-LUCKNOW,26930,All
2021,1,AHMEDABAD,LUCKNOW,9151,11549,AHMEDABAD-LUCKNOW,20700,All
2021,2,AHMEDABAD,LUCKNOW,10426,10271,AHMEDABAD-LUCKNOW,20697,All
2021,3,AHMEDABAD,LUCKNOW,14806,10787,AHMEDABAD-LUCKNOW,25593,All
2021,4,AHMEDABAD,LUCKNOW,14253,6360,AHMEDABAD-LUCKNOW,20613,All
2021,6,AHMEDABAD,LUCKNOW,5413,5613,AHMEDABAD-LUCKNOW,11026,All
2021,7,AHMEDABAD,LUCKNOW,9069,6993,AHMEDABAD-LUCKNOW,16062,All
2021,8,AHMEDABAD,LUCKNOW,9581,6770,AHMEDABAD-LUCKNOW,16351,All
2021,9,AHMEDABAD,LUCKNOW,8423,6276,AHMEDABAD-LUCKNOW,14699,All
2021,10,AHMEDABAD,LUCKNOW,10714,6726,AHMEDABAD-LUCKNOW,17440,All
2021,11,AHMEDABAD,LUCKNOW,13976,10897,AHMEDABAD-LUCKNOW,24873,All
2021,12,AHMEDABAD,LUCKNOW,12115,11903,AHMEDABAD-LUCKNOW,24018,All
2022,1,AHMEDABAD,LUCKNOW,9386,5556,AHMEDABAD-LUCKNOW,14942,All
2022,2,AHMEDABAD,LUCKNOW,7367,5998,AHMEDABAD-LUCKNOW,13365,All
2022,3,AHMEDABAD,LUCKNOW,9410,8411,AHMEDABAD-LUCKNOW,17821,All
2022,4,AHMEDABAD,LUCKNOW,9212,7534,AHMEDABAD-LUCKNOW,16746,All
2022,5,AHMEDABAD,LUCKNOW,10406,9474,AHMEDABAD-LUCKNOW,19880,All
2022,6,AHMEDABAD,LUCKNOW,8386,9655,AHMEDABAD-LUCKNOW,18041,All
2022,7,AHMEDABAD,LUCKNOW,6918,7316,AHMEDABAD-LUCKNOW,14234,All
2022,8,AHMEDABAD,LUCKNOW,6912,6727,AHMEDABAD-LUCKNOW,13639,All
2022,9,AHMEDABAD,LUCKNOW,6638,6143,AHMEDABAD-LUCKNOW,12781,All
2022,10,AHMEDABAD,LUCKNOW,9779,7149,AHMEDABAD-LUCKNOW,16928,All
2022,11,AHMEDABAD,LUCKNOW,9179,11502,AHMEDABAD-LUCKNOW,20681,All
2022,12,AHMEDABAD,LUCKNOW,8755,10062,AHMEDABAD-LUCKNOW,18817,All
2023,1,AHMEDABAD,LUCKNOW,9509,8178,AHMEDABAD-LUCKNOW,17687,All
2023,2,AHMEDABAD,LUCKNOW,9267,8149,AHMEDABAD-LUCKNOW,17416,All
2023,3,AHMEDABAD,LUCKNOW,9920,10394,AHMEDABAD-LUCKNOW,20314,All
2023,4,AHMEDABAD,LUCKNOW,15545,12742,AHMEDABAD-LUCKNOW,28287,All
2023,5,AHMEDABAD,LUCKNOW,14185,13734,AHMEDABAD-LUCKNOW,27919,All
2023,6,AHMEDABAD,LUCKNOW,12940,14483,AHMEDABAD-LUCKNOW,27423,All
2023,7,AHMEDABAD,LUCKNOW,10349,11776,AHMEDABAD-LUCKNOW,22125,All
2023,8,AHMEDABAD,LUCKNOW,11145,10510,AHMEDABAD-LUCKNOW,21655,All
2023,9,AHMEDABAD,LUCKNOW,11169,11457,AHMEDABAD-LUCKNOW,22626,All
2023,10,AHMEDABAD,LUCKNOW,13186,11016,AHMEDABAD-LUCKNOW,24202,All
2023,11,AHMEDABAD,LUCKNOW,13758,11192,AHMEDABAD-LUCKNOW,24950,All
2023,12,AHMEDABAD,LUCKNOW,13021,15223,AHMEDABAD-LUCKNOW,28244,All
2024,1,AHMEDABAD,LUCKNOW,12447,12600,AHMEDABAD-LUCKNOW,25047,All
2024,2,AHMEDABAD,LUCKNOW,13396,11534,AHMEDABAD-LUCKNOW,24930,All
2024,3,AHMEDABAD,LUCKNOW,13949,12941,AHMEDABAD-LUCKNOW,26890,All
2024,4,AHMEDABAD,LUCKNOW,14447,11384,AHMEDABAD-LUCKNOW,25831,All
2024,6,AHMEDABAD,LUCKNOW,12271,13596,AHMEDABAD-LUCKNOW,25867,All
2024,7,AHMEDABAD,LUCKNOW,10548,11750,AHMEDABAD-LUCKNOW,22298,All
2024,8,AHMEDABAD,LUCKNOW,10391,12368,AHMEDABAD-LUCKNOW,22759,All
2024,9,AHMEDABAD,LUCKNOW,10808,12002,AHMEDABAD-LUCKNOW,22810,All
2024,10,AHMEDABAD,LUCKNOW,14025,11363,AHMEDABAD-LUCKNOW,25388,All
2024,11,AHMEDABAD,LUCKNOW,14593,15565,AHMEDABAD-LUCKNOW,30158,All
2024,12,AHMEDABAD,LUCKNOW,12642,16327,AHMEDABAD-LUCKNOW,28969,All
2025,1,AHMEDABAD,LUCKNOW,14723,14174,AHMEDABAD-LUCKNOW,28897,All
2025,2,AHMEDABAD,LUCKNOW,12765,12895,AHMEDABAD-LUCKNOW,25660,All
2025,3,AHMEDABAD,LUCKNOW,9909,9515,AHMEDABAD-LUCKNOW,19424,All
2021,10,AHMEDABAD,MADURAI,179,122,AHMEDABAD-MADURAI,301,All
2021,11,AHMEDABAD,MADURAI,0,162,AHMEDABAD-MADURAI,162,All
2017,10,AHMEDABAD,MANGALORE,4,58,AHMEDABAD-MANGALORE,62,All
2017,11,AHMEDABAD,MANGALORE,27,198,AHMEDABAD-MANGALORE,225,All
2017,12,AHMEDABAD,MANGALORE,40,247,AHMEDABAD-MANGALORE,287,All
2018,1,AHMEDABAD,MANGALORE,28,201,AHMEDABAD-MANGALORE,229,All
2018,2,AHMEDABAD,MANGALORE,0,148,AHMEDABAD-MANGALORE,148,All
2018,3,AHMEDABAD,MANGALORE,0,136,AHMEDABAD-MANGALORE,136,All
2019,2,AHMEDABAD,MANGALORE,0,135,AHMEDABAD-MANGALORE,135,All
2019,3,AHMEDABAD,MANGALORE,0,285,AHMEDABAD-MANGALORE,285,All
2019,4,AHMEDABAD,MANGALORE,0,172,AHMEDABAD-MANGALORE,172,All
2019,5,AHMEDABAD,MANGALORE,0,505,AHMEDABAD-MANGALORE,505,All
2019,6,AHMEDABAD,MANGALORE,0,268,AHMEDABAD-MANGALORE,268,All
2019,7,AHMEDABAD,MANGALORE,0,168,AHMEDABAD-MANGALORE,168,All
2019,8,AHMEDABAD,MANGALORE,0,261,AHMEDABAD-MANGALORE,261,All
2015,4,AHMEDABAD,MUMBAI,85411,87535,AHMEDABAD-MUMBAI,172946,All
2015,5,AHMEDABAD,MUMBAI,97812,88167,AHMEDABAD-MUMBAI,185979,All
2015,6,AHMEDABAD,MUMBAI,81105,77858,AHMEDABAD-MUMBAI,158963,All
2015,7,AHMEDABAD,MUMBAI,77364,76263,AHMEDABAD-MUMBAI,153627,All
2015,8,AHMEDABAD,MUMBAI,84453,79857,AHMEDABAD-MUMBAI,164310,All
2015,9,AHMEDABAD,MUMBAI,84257,82079,AHMEDABAD-MUMBAI,166336,All
2015,10,AHMEDABAD,MUMBAI,72612,75662,AHMEDABAD-MUMBAI,148274,All
2015,11,AHMEDABAD,MUMBAI,89493,92810,AHMEDABAD-MUMBAI,182303,All
2015,12,AHMEDABAD,MUMBAI,100086,101057,AHMEDABAD-MUMBAI,201143,All
2016,1,AHMEDABAD,MUMBAI,100470,100773,AHMEDABAD-MUMBAI,201243,All
2016,2,AHMEDABAD,MUMBAI,96229,91367,AHMEDABAD-MUMBAI,187596,All
2016,3,AHMEDABAD,MUMBAI,97949,88113,AHMEDABAD-MUMBAI,186062,All
2016,4,AHMEDABAD,MUMBAI,88155,86931,AHMEDABAD-MUMBAI,175086,All
2016,5,AHMEDABAD,MUMBAI,94026,86785,AHMEDABAD-MUMBAI,180811,All
2016,6,AHMEDABAD,MUMBAI,80183,81666,AHMEDABAD-MUMBAI,161849,All
2016,7,AHMEDABAD,MUMBAI,91377,90256,AHMEDABAD-MUMBAI,181633,All
2016,8,AHMEDABAD,MUMBAI,91865,89163,AHMEDABAD-MUMBAI,181028,All
2016,9,AHMEDABAD,MUMBAI,87216,85592,AHMEDABAD-MUMBAI,172808,All
2016,10,AHMEDABAD,MUMBAI,81746,81324,AHMEDABAD-MUMBAI,163070,All
2016,11,AHMEDABAD,MUMBAI,83805,87309,AHMEDABAD-MUMBAI,171114,All
2016,12,AHMEDABAD,MUMBAI,88857,88115,AHMEDABAD-MUMBAI,176972,All
2017,1,AHMEDABAD,MUMBAI,89553,89725,AHMEDABAD-MUMBAI,179278,All
2017,2,AHMEDABAD,MUMBAI,85360,70811,AHMEDABAD-MUMBAI,156171,All
2017,3,AHMEDABAD,MUMBAI,83349,69435,AHMEDABAD-MUMBAI,152784,All
2017,4,AHMEDABAD,MUMBAI,80822,75543,AHMEDABAD-MUMBAI,156365,All
2017,5,AHMEDABAD,MUMBAI,98873,81642,AHMEDABAD-MUMBAI,180515,All
2017,6,AHMEDABAD,MUMBAI,81883,85113,AHMEDABAD-MUMBAI,166996,All
2017,7,AHMEDABAD,MUMBAI,81526,79738,AHMEDABAD-MUMBAI,161264,All
2017,8,AHMEDABAD,MUMBAI,85329,83637,AHMEDABAD-MUMBAI,168966,All
2017,9,AHMEDABAD,MUMBAI,80650,81013,AHMEDABAD-MUMBAI,161663,All
2017,10,AHMEDABAD,MUMBAI,90379,89178,AHMEDABAD-MUMBAI,179557,All
2017,11,AHMEDABAD,MUMBAI,91850,96141,AHMEDABAD-MUMBAI,187991,All
2017,12,AHMEDABAD,MUMBAI,94061,94919,AHMEDABAD-MUMBAI,188980,All
2018,1,AHMEDABAD,MUMBAI,98504,96427,AHMEDABAD-MUMBAI,194931,All
2018,2,AHMEDABAD,MUMBAI,90437,86821,AHMEDABAD-MUMBAI,177258,All
2018,3,AHMEDABAD,MUMBAI,91672,87223,AHMEDABAD-MUMBAI,178895,All
2018,4,AHMEDABAD,MUMBAI,86764,85397,AHMEDABAD-MUMBAI,172161,All
2018,5,AHMEDABAD,MUMBAI,92209,79812,AHMEDABAD-MUMBAI,172021,All
2018,6,AHMEDABAD,MUMBAI,80377,85074,AHMEDABAD-MUMBAI,165451,All
2018,7,AHMEDABAD,MUMBAI,91280,92437,AHMEDABAD-MUMBAI,183717,All
2018,8,AHMEDABAD,MUMBAI,90022,86394,AHMEDABAD-MUMBAI,176416,All
2018,9,AHMEDABAD,MUMBAI,89159,90106,AHMEDABAD-MUMBAI,179265,All
2018,10,AHMEDABAD,MUMBAI,86071,88068,AHMEDABAD-MUMBAI,174139,All
2018,11,AHMEDABAD,MUMBAI,90769,92206,AHMEDABAD-MUMBAI,182975,All
2018,12,AHMEDABAD,MUMBAI,95661,95325,AHMEDABAD-MUMBAI,190986,All
2019,1,AHMEDABAD,MUMBAI,96614,95923,AHMEDABAD-MUMBAI,192537,All
2019,2,AHMEDABAD,MUMBAI,84061,80235,AHMEDABAD-MUMBAI,164296,All
2019,3,AHMEDABAD,MUMBAI,81669,74247,AHMEDABAD-MUMBAI,155916,All
2019,4,AHMEDABAD,MUMBAI,73004,69813,AHMEDABAD-MUMBAI,142817,All
2019,5,AHMEDABAD,MUMBAI,85752,79103,AHMEDABAD-MUMBAI,164855,All
2019,6,AHMEDABAD,MUMBAI,81757,81802,AHMEDABAD-MUMBAI,163559,All
2019,7,AHMEDABAD,MUMBAI,89633,93260,AHMEDABAD-MUMBAI,182893,All
2019,8,AHMEDABAD,MUMBAI,89582,89009,AHMEDABAD-MUMBAI,178591,All
2019,9,AHMEDABAD,MUMBAI,81565,82013,AHMEDABAD-MUMBAI,163578,All
2019,10,AHMEDABAD,MUMBAI,75092,74207,AHMEDABAD-MUMBAI,149299,All
2019,11,AHMEDABAD,MUMBAI,75404,71601,AHMEDABAD-MUMBAI,147005,All
2019,12,AHMEDABAD,MUMBAI,77695,73681,AHMEDABAD-MUMBAI,151376,All
2020,1,AHMEDABAD,MUMBAI,78289,74735,AHMEDABAD-MUMBAI,153024,All
2020,2,AHMEDABAD,MUMBAI,73349,67615,AHMEDABAD-MUMBAI,140964,All
2020,3,AHMEDABAD,MUMBAI,40371,36180,AHMEDABAD-MUMBAI,76551,All
2020,5,AHMEDABAD,MUMBAI,124,919,AHMEDABAD-MUMBAI,1043,All
2020,6,AHMEDABAD,MUMBAI,778,1825,AHMEDABAD-MUMBAI,2603,All
2020,7,AHMEDABAD,MUMBAI,3482,4644,AHMEDABAD-MUMBAI,8126,All
2020,8,AHMEDABAD,MUMBAI,6103,5611,AHMEDABAD-MUMBAI,11714,All
2020,9,AHMEDABAD,MUMBAI,13706,10988,AHMEDABAD-MUMBAI,24694,All
2020,10,AHMEDABAD,MUMBAI,20981,18315,AHMEDABAD-MUMBAI,39296,All
2020,11,AHMEDABAD,MUMBAI,23643,25009,AHMEDABAD-MUMBAI,48652,All
2020,12,AHMEDABAD,MUMBAI,19398,17996,AHMEDABAD-MUMBAI,37394,All
2021,1,AHMEDABAD,MUMBAI,26342,29268,AHMEDABAD-MUMBAI,55610,All
2021,2,AHMEDABAD,MUMBAI,30864,36187,AHMEDABAD-MUMBAI,67051,All
2021,3,AHMEDABAD,MUMBAI,26095,29223,AHMEDABAD-MUMBAI,55318,All
2021,4,AHMEDABAD,MUMBAI,13013,16208,AHMEDABAD-MUMBAI,29221,All
2021,6,AHMEDABAD,MUMBAI,20024,16827,AHMEDABAD-MUMBAI,36851,All
2021,7,AHMEDABAD,MUMBAI,28211,26316,AHMEDABAD-MUMBAI,54527,All
2021,8,AHMEDABAD,MUMBAI,37330,35104,AHMEDABAD-MUMBAI,72434,All
2021,9,AHMEDABAD,MUMBAI,35083,34382,AHMEDABAD-MUMBAI,69465,All
2021,10,AHMEDABAD,MUMBAI,41625,42575,AHMEDABAD-MUMBAI,84200,All
2021,11,AHMEDABAD,MUMBAI,49708,51679,AHMEDABAD-MUMBAI,101387,All
2021,12,AHMEDABAD,MUMBAI,49586,48693,AHMEDABAD-MUMBAI,98279,All
2022,1,AHMEDABAD,MUMBAI,25464,24957,AHMEDABAD-MUMBAI,50421,All
2022,2,AHMEDABAD,MUMBAI,37948,37533,AHMEDABAD-MUMBAI,75481,All
2022,3,AHMEDABAD,MUMBAI,49231,49041,AHMEDABAD-MUMBAI,98272,All
2022,4,AHMEDABAD,MUMBAI,48715,48863,AHMEDABAD-MUMBAI,97578,All
2022,5,AHMEDABAD,MUMBAI,58395,51631,AHMEDABAD-MUMBAI,110026,All
2022,6,AHMEDABAD,MUMBAI,48280,47682,AHMEDABAD-MUMBAI,95962,All
2022,7,AHMEDABAD,MUMBAI,47390,44258,AHMEDABAD-MUMBAI,91648,All
2022,8,AHMEDABAD,MUMBAI,70629,64671,AHMEDABAD-MUMBAI,135300,All
2022,9,AHMEDABAD,MUMBAI,85802,86828,AHMEDABAD-MUMBAI,172630,All
2022,10,AHMEDABAD,MUMBAI,84406,83793,AHMEDABAD-MUMBAI,168199,All
2022,11,AHMEDABAD,MUMBAI,91430,92530,AHMEDABAD-MUMBAI,183960,All
2022,12,AHMEDABAD,MUMBAI,97932,96787,AHMEDABAD-MUMBAI,194719,All
2023,1,AHMEDABAD,MUMBAI,104113,103244,AHMEDABAD-MUMBAI,207357,All
2023,2,AHMEDABAD,MUMBAI,94436,92201,AHMEDABAD-MUMBAI,186637,All
2023,3,AHMEDABAD,MUMBAI,96030,93687,AHMEDABAD-MUMBAI,189717,All
2023,4,AHMEDABAD,MUMBAI,80432,81595,AHMEDABAD-MUMBAI,162027,All
2023,5,AHMEDABAD,MUMBAI,80887,77932,AHMEDABAD-MUMBAI,158819,All
2023,6,AHMEDABAD,MUMBAI,81066,81666,AHMEDABAD-MUMBAI,162732,All
2023,7,AHMEDABAD,MUMBAI,85179,83163,AHMEDABAD-MUMBAI,168342,All
2023,8,AHMEDABAD,MUMBAI,91588,89544,AHMEDABAD-MUMBAI,181132,All
2023,9,AHMEDABAD,MUMBAI,87701,86671,AHMEDABAD-MUMBAI,174372,All
2023,10,AHMEDABAD,MUMBAI,84484,87107,AHMEDABAD-MUMBAI,171591,All
2023,11,AHMEDABAD,MUMBAI,84511,87791,AHMEDABAD-MUMBAI,172302,All
2023,12,AHMEDABAD,MUMBAI,94190,92743,AHMEDABAD-MUMBAI,186933,All
2024,1,AHMEDABAD,MUMBAI,98595,98882,AHMEDABAD-MUMBAI,197477,All
2024,2,AHMEDABAD,MUMBAI,94448,93917,AHMEDABAD-MUMBAI,188365,All
2024,3,AHMEDABAD,MUMBAI,93952,90606,AHMEDABAD-MUMBAI,184558,All
2024,4,AHMEDABAD,MUMBAI,82317,89442,AHMEDABAD-MUMBAI,171759,All
2024,6,AHMEDABAD,MUMBAI,81345,88590,AHMEDABAD-MUMBAI,169935,All
2024,7,AHMEDABAD,MUMBAI,82645,87307,AHMEDABAD-MUMBAI,169952,All
2024,8,AHMEDABAD,MUMBAI,87703,86884,AHMEDABAD-MUMBAI,174587,All
2024,9,AHMEDABAD,MUMBAI,85902,85959,AHMEDABAD-MUMBAI,171861,All
2024,10,AHMEDABAD,MUMBAI,78060,85578,AHMEDABAD-MUMBAI,163638,All
2024,11,AHMEDABAD,MUMBAI,90248,89621,AHMEDABAD-MUMBAI,179869,All
2024,12,AHMEDABAD,MUMBAI,92420,92243,AHMEDABAD-MUMBAI,184663,All
2025,1,AHMEDABAD,MUMBAI,93727,91979,AHMEDABAD-MUMBAI,185706,All
2025,2,AHMEDABAD,MUMBAI,85128,83853,AHMEDABAD-MUMBAI,168981,All
2025,3,AHMEDABAD,MUMBAI,87364,81969,AHMEDABAD-MUMBAI,169333,All
2018,2,AHMEDABAD,MUNDRA,17,13,AHMEDABAD-MUNDRA,30,All
2018,3,AHMEDABAD,MUNDRA,42,33,AHMEDABAD-MUNDRA,75,All
2018,4,AHMEDABAD,MUNDRA,164,154,AHMEDABAD-MUNDRA,318,All
2018,5,AHMEDABAD,MUNDRA,114,114,AHMEDABAD-MUNDRA,228,All
2018,8,AHMEDABAD,MUNDRA,138,119,AHMEDABAD-MUNDRA,257,All
2018,9,AHMEDABAD,MUNDRA,141,130,AHMEDABAD-MUNDRA,271,All
2018,10,AHMEDABAD,MUNDRA,85,65,AHMEDABAD-MUNDRA,150,All
2020,1,AHMEDABAD,MUNDRA,122,122,AHMEDABAD-MUNDRA,244,All
2020,3,AHMEDABAD,MUNDRA,16,10,AHMEDABAD-MUNDRA,26,All
2015,4,AHMEDABAD,NAGPUR,980,1197,AHMEDABAD-NAGPUR,2177,All
2015,5,AHMEDABAD,NAGPUR,1372,1349,AHMEDABAD-NAGPUR,2721,All
2015,6,AHMEDABAD,NAGPUR,1152,1314,AHMEDABAD-NAGPUR,2466,All
2015,7,AHMEDABAD,NAGPUR,712,797,AHMEDABAD-NAGPUR,1509,All
2015,8,AHMEDABAD,NAGPUR,921,909,AHMEDABAD-NAGPUR,1830,All
2015,9,AHMEDABAD,NAGPUR,967,1071,AHMEDABAD-NAGPUR,2038,All
2015,10,AHMEDABAD,NAGPUR,1141,1004,AHMEDABAD-NAGPUR,2145,All
2015,11,AHMEDABAD,NAGPUR,1234,1066,AHMEDABAD-NAGPUR,2300,All
2015,12,AHMEDABAD,NAGPUR,1405,1362,AHMEDABAD-NAGPUR,2767,All
2016,1,AHMEDABAD,NAGPUR,1342,1336,AHMEDABAD-NAGPUR,2678,All
2016,2,AHMEDABAD,NAGPUR,1349,1295,AHMEDABAD-NAGPUR,2644,All
2016,3,AHMEDABAD,NAGPUR,1446,1226,AHMEDABAD-NAGPUR,2672,All
2016,4,AHMEDABAD,NAGPUR,649,611,AHMEDABAD-NAGPUR,1260,All
2016,12,AHMEDABAD,NAGPUR,24,25,AHMEDABAD-NAGPUR,49,All
2017,1,AHMEDABAD,NAGPUR,393,329,AHMEDABAD-NAGPUR,722,All
2017,2,AHMEDABAD,NAGPUR,460,610,AHMEDABAD-NAGPUR,1070,All
2017,3,AHMEDABAD,NAGPUR,463,522,AHMEDABAD-NAGPUR,985,All
2017,4,AHMEDABAD,NAGPUR,465,647,AHMEDABAD-NAGPUR,1112,All
2017,5,AHMEDABAD,NAGPUR,557,610,AHMEDABAD-NAGPUR,1167,All
2017,6,AHMEDABAD,NAGPUR,551,555,AHMEDABAD-NAGPUR,1106,All
2017,7,AHMEDABAD,NAGPUR,487,449,AHMEDABAD-NAGPUR,936,All
2017,8,AHMEDABAD,NAGPUR,417,592,AHMEDABAD-NAGPUR,1009,All
2017,9,AHMEDABAD,NAGPUR,459,366,AHMEDABAD-NAGPUR,825,All
2017,10,AHMEDABAD,NAGPUR,283,267,AHMEDABAD-NAGPUR,550,All
2017,11,AHMEDABAD,NAGPUR,407,366,AHMEDABAD-NAGPUR,773,All
2017,12,AHMEDABAD,NAGPUR,353,267,AHMEDABAD-NAGPUR,620,All
2018,1,AHMEDABAD,NAGPUR,433,282,AHMEDABAD-NAGPUR,715,All
2018,2,AHMEDABAD,NAGPUR,461,366,AHMEDABAD-NAGPUR,827,All
2018,4,AHMEDABAD,NAGPUR,133,82,AHMEDABAD-NAGPUR,215,All
2018,5,AHMEDABAD,NAGPUR,431,318,AHMEDABAD-NAGPUR,749,All
2018,6,AHMEDABAD,NAGPUR,486,379,AHMEDABAD-NAGPUR,865,All
2018,7,AHMEDABAD,NAGPUR,342,258,AHMEDABAD-NAGPUR,600,All
2018,8,AHMEDABAD,NAGPUR,282,272,AHMEDABAD-NAGPUR,554,All
2018,9,AHMEDABAD,NAGPUR,354,264,AHMEDABAD-NAGPUR,618,All
2018,10,AHMEDABAD,NAGPUR,607,377,AHMEDABAD-NAGPUR,984,All
2018,11,AHMEDABAD,NAGPUR,621,694,AHMEDABAD-NAGPUR,1315,All
2018,12,AHMEDABAD,NAGPUR,552,326,AHMEDABAD-NAGPUR,878,All
2019,1,AHMEDABAD,NAGPUR,832,470,AHMEDABAD-NAGPUR,1302,All
2019,2,AHMEDABAD,NAGPUR,439,273,AHMEDABAD-NAGPUR,712,All
2019,3,AHMEDABAD,NAGPUR,572,431,AHMEDABAD-NAGPUR,1003,All
2019,4,AHMEDABAD,NAGPUR,882,521,AHMEDABAD-NAGPUR,1403,All
2019,5,AHMEDABAD,NAGPUR,1248,563,AHMEDABAD-NAGPUR,1811,All
2019,6,AHMEDABAD,NAGPUR,857,389,AHMEDABAD-NAGPUR,1246,All
2019,7,AHMEDABAD,NAGPUR,529,205,AHMEDABAD-NAGPUR,734,All
2019,8,AHMEDABAD,NAGPUR,5341,4901,AHMEDABAD-NAGPUR,10242,All
2019,9,AHMEDABAD,NAGPUR,5577,5782,AHMEDABAD-NAGPUR,11359,All
2019,10,AHMEDABAD,NAGPUR,6547,5385,AHMEDABAD-NAGPUR,11932,All
2019,11,AHMEDABAD,NAGPUR,4203,4431,AHMEDABAD-NAGPUR,8634,All
2019,12,AHMEDABAD,NAGPUR,4354,4434,AHMEDABAD-NAGPUR,8788,All
2020,1,AHMEDABAD,NAGPUR,4581,4514,AHMEDABAD-NAGPUR,9095,All
2020,2,AHMEDABAD,NAGPUR,4323,4198,AHMEDABAD-NAGPUR,8521,All
2020,3,AHMEDABAD,NAGPUR,2978,2810,AHMEDABAD-NAGPUR,5788,All
2020,6,AHMEDABAD,NAGPUR,341,205,AHMEDABAD-NAGPUR,546,All
2020,7,AHMEDABAD,NAGPUR,24,2,AHMEDABAD-NAGPUR,26,All
2020,8,AHMEDABAD,NAGPUR,673,516,AHMEDABAD-NAGPUR,1189,All
2020,9,AHMEDABAD,NAGPUR,1836,1469,AHMEDABAD-NAGPUR,3305,All
2020,10,AHMEDABAD,NAGPUR,1633,1826,AHMEDABAD-NAGPUR,3459,All
2020,11,AHMEDABAD,NAGPUR,2680,2318,AHMEDABAD-NAGPUR,4998,All
2020,12,AHMEDABAD,NAGPUR,3408,1847,AHMEDABAD-NAGPUR,5255,All
2021,1,AHMEDABAD,NAGPUR,3154,4006,AHMEDABAD-NAGPUR,7160,All
2021,2,AHMEDABAD,NAGPUR,2862,3303,AHMEDABAD-NAGPUR,6165,All
2021,3,AHMEDABAD,NAGPUR,1973,1939,AHMEDABAD-NAGPUR,3912,All
2021,4,AHMEDABAD,NAGPUR,33,24,AHMEDABAD-NAGPUR,57,All
2021,7,AHMEDABAD,NAGPUR,737,858,AHMEDABAD-NAGPUR,1595,All
2021,8,AHMEDABAD,NAGPUR,1970,2053,AHMEDABAD-NAGPUR,4023,All
2021,9,AHMEDABAD,NAGPUR,1796,1893,AHMEDABAD-NAGPUR,3689,All
2021,10,AHMEDABAD,NAGPUR,2809,2595,AHMEDABAD-NAGPUR,5404,All
2021,11,AHMEDABAD,NAGPUR,3715,3934,AHMEDABAD-NAGPUR,7649,All
2021,12,AHMEDABAD,NAGPUR,3511,3550,AHMEDABAD-NAGPUR,7061,All
2022,1,AHMEDABAD,NAGPUR,1838,1807,AHMEDABAD-NAGPUR,3645,All
2022,2,AHMEDABAD,NAGPUR,1914,1778,AHMEDABAD-NAGPUR,3692,All
2022,3,AHMEDABAD,NAGPUR,2092,2053,AHMEDABAD-NAGPUR,4145,All
2022,4,AHMEDABAD,NAGPUR,2111,2115,AHMEDABAD-NAGPUR,4226,All
2022,5,AHMEDABAD,NAGPUR,2286,2259,AHMEDABAD-NAGPUR,4545,All
2022,6,AHMEDABAD,NAGPUR,2848,3026,AHMEDABAD-NAGPUR,5874,All
2022,7,AHMEDABAD,NAGPUR,2843,2878,AHMEDABAD-NAGPUR,5721,All
2022,8,AHMEDABAD,NAGPUR,2835,2569,AHMEDABAD-NAGPUR,5404,All
2022,9,AHMEDABAD,NAGPUR,3299,3347,AHMEDABAD-NAGPUR,6646,All
2022,10,AHMEDABAD,NAGPUR,4192,3821,AHMEDABAD-NAGPUR,8013,All
2022,11,AHMEDABAD,NAGPUR,4180,4375,AHMEDABAD-NAGPUR,8555,All
2022,12,AHMEDABAD,NAGPUR,4134,4105,AHMEDABAD-NAGPUR,8239,All
2023,1,AHMEDABAD,NAGPUR,3848,3868,AHMEDABAD-NAGPUR,7716,All
2023,2,AHMEDABAD,NAGPUR,3694,3685,AHMEDABAD-NAGPUR,7379,All
2023,3,AHMEDABAD,NAGPUR,3848,3824,AHMEDABAD-NAGPUR,7672,All
2023,4,AHMEDABAD,NAGPUR,3897,4048,AHMEDABAD-NAGPUR,7945,All
2023,5,AHMEDABAD,NAGPUR,4549,4354,AHMEDABAD-NAGPUR,8903,All
2023,6,AHMEDABAD,NAGPUR,4054,4107,AHMEDABAD-NAGPUR,8161,All
2023,7,AHMEDABAD,NAGPUR,3811,3994,AHMEDABAD-NAGPUR,7805,All
2023,8,AHMEDABAD,NAGPUR,3739,3921,AHMEDABAD-NAGPUR,7660,All
2023,9,AHMEDABAD,NAGPUR,3971,3986,AHMEDABAD-NAGPUR,7957,All
2023,10,AHMEDABAD,NAGPUR,4073,3972,AHMEDABAD-NAGPUR,8045,All
2023,11,AHMEDABAD,NAGPUR,4309,4161,AHMEDABAD-NAGPUR,8470,All
2023,12,AHMEDABAD,NAGPUR,4458,4400,AHMEDABAD-NAGPUR,8858,All
2024,1,AHMEDABAD,NAGPUR,4403,4380,AHMEDABAD-NAGPUR,8783,All
2024,2,AHMEDABAD,NAGPUR,4064,4000,AHMEDABAD-NAGPUR,8064,All
2024,3,AHMEDABAD,NAGPUR,4430,4402,AHMEDABAD-NAGPUR,8832,All
2024,4,AHMEDABAD,NAGPUR,4190,4203,AHMEDABAD-NAGPUR,8393,All
2024,6,AHMEDABAD,NAGPUR,4319,4177,AHMEDABAD-NAGPUR,8496,All
2024,7,AHMEDABAD,NAGPUR,4186,4379,AHMEDABAD-NAGPUR,8565,All
2024,8,AHMEDABAD,NAGPUR,4354,4391,AHMEDABAD-NAGPUR,8745,All
2024,9,AHMEDABAD,NAGPUR,3963,4045,AHMEDABAD-NAGPUR,8008,All
2024,10,AHMEDABAD,NAGPUR,4117,3905,AHMEDABAD-NAGPUR,8022,All
2024,11,AHMEDABAD,NAGPUR,4130,4156,AHMEDABAD-NAGPUR,8286,All
2024,12,AHMEDABAD,NAGPUR,4557,4481,AHMEDABAD-NAGPUR,9038,All
2025,1,AHMEDABAD,NAGPUR,4541,4424,AHMEDABAD-NAGPUR,8965,All
2025,2,AHMEDABAD,NAGPUR,4121,4037,AHMEDABAD-NAGPUR,8158,All
2025,3,AHMEDABAD,NAGPUR,4387,4306,AHMEDABAD-NAGPUR,8693,All
2024,3,AHMEDABAD,NANDED,41,35,AHMEDABAD-NANDED,76,All
2024,4,AHMEDABAD,NANDED,901,1066,AHMEDABAD-NANDED,1967,All
2024,6,AHMEDABAD,NANDED,912,867,AHMEDABAD-NANDED,1779,All
2024,7,AHMEDABAD,NANDED,646,765,AHMEDABAD-NANDED,1411,All
2024,8,AHMEDABAD,NANDED,897,964,AHMEDABAD-NANDED,1861,All
2024,9,AHMEDABAD,NANDED,771,925,AHMEDABAD-NANDED,1696,All
2024,10,AHMEDABAD,NANDED,923,764,AHMEDABAD-NANDED,1687,All
2024,11,AHMEDABAD,NANDED,905,1078,AHMEDABAD-NANDED,1983,All
2024,12,AHMEDABAD,NANDED,1077,1191,AHMEDABAD-NANDED,2268,All
2025,1,AHMEDABAD,NANDED,985,949,AHMEDABAD-NANDED,1934,All
2025,2,AHMEDABAD,NANDED,897,916,AHMEDABAD-NANDED,1813,All
2025,3,AHMEDABAD,NANDED,928,1112,AHMEDABAD-NANDED,2040,All
2019,2,AHMEDABAD,NASIK,2503,447,AHMEDABAD-NASIK,2950,All
2019,3,AHMEDABAD,NASIK,2047,1890,AHMEDABAD-NASIK,3937,All
2019,4,AHMEDABAD,NASIK,2394,2354,AHMEDABAD-NASIK,4748,All
2019,5,AHMEDABAD,NASIK,2723,2546,AHMEDABAD-NASIK,5269,All
2019,6,AHMEDABAD,NASIK,2259,2298,AHMEDABAD-NASIK,4557,All
2019,7,AHMEDABAD,NASIK,2480,2432,AHMEDABAD-NASIK,4912,All
2019,8,AHMEDABAD,NASIK,2648,2605,AHMEDABAD-NASIK,5253,All
2019,9,AHMEDABAD,NASIK,2149,2239,AHMEDABAD-NASIK,4388,All
2019,10,AHMEDABAD,NASIK,2786,2628,AHMEDABAD-NASIK,5414,All
2019,11,AHMEDABAD,NASIK,3189,3127,AHMEDABAD-NASIK,6316,All
2019,12,AHMEDABAD,NASIK,3608,3365,AHMEDABAD-NASIK,6973,All
2020,1,AHMEDABAD,NASIK,3487,3127,AHMEDABAD-NASIK,6614,All
2020,2,AHMEDABAD,NASIK,3278,3154,AHMEDABAD-NASIK,6432,All
2020,3,AHMEDABAD,NASIK,2312,1934,AHMEDABAD-NASIK,4246,All
2020,5,AHMEDABAD,NASIK,34,30,AHMEDABAD-NASIK,64,All
2020,6,AHMEDABAD,NASIK,1028,724,AHMEDABAD-NASIK,1752,All
2020,7,AHMEDABAD,NASIK,984,884,AHMEDABAD-NASIK,1868,All
2020,8,AHMEDABAD,NASIK,858,858,AHMEDABAD-NASIK,1716,All
2020,9,AHMEDABAD,NASIK,964,932,AHMEDABAD-NASIK,1896,All
2020,10,AHMEDABAD,NASIK,1327,1245,AHMEDABAD-NASIK,2572,All
2020,11,AHMEDABAD,NASIK,1868,1806,AHMEDABAD-NASIK,3674,All
2020,12,AHMEDABAD,NASIK,1553,1559,AHMEDABAD-NASIK,3112,All
2021,1,AHMEDABAD,NASIK,2042,2314,AHMEDABAD-NASIK,4356,All
2021,2,AHMEDABAD,NASIK,2070,2300,AHMEDABAD-NASIK,4370,All
2021,3,AHMEDABAD,NASIK,1559,1476,AHMEDABAD-NASIK,3035,All
2021,4,AHMEDABAD,NASIK,740,701,AHMEDABAD-NASIK,1441,All
2021,6,AHMEDABAD,NASIK,257,181,AHMEDABAD-NASIK,438,All
2021,7,AHMEDABAD,NASIK,924,998,AHMEDABAD-NASIK,1922,All
2021,8,AHMEDABAD,NASIK,1786,1620,AHMEDABAD-NASIK,3406,All
2021,9,AHMEDABAD,NASIK,1673,1610,AHMEDABAD-NASIK,3283,All
2021,10,AHMEDABAD,NASIK,1932,1769,AHMEDABAD-NASIK,3701,All
2021,11,AHMEDABAD,NASIK,1698,1587,AHMEDABAD-NASIK,3285,All
2021,12,AHMEDABAD,NASIK,1838,1666,AHMEDABAD-NASIK,3504,All
2022,1,AHMEDABAD,NASIK,1260,1057,AHMEDABAD-NASIK,2317,All
2022,2,AHMEDABAD,NASIK,635,622,AHMEDABAD-NASIK,1257,All
2022,3,AHMEDABAD,NASIK,734,720,AHMEDABAD-NASIK,1454,All
2022,4,AHMEDABAD,NASIK,993,930,AHMEDABAD-NASIK,1923,All
2022,5,AHMEDABAD,NASIK,829,753,AHMEDABAD-NASIK,1582,All
2022,6,AHMEDABAD,NASIK,993,930,AHMEDABAD-NASIK,1923,All
2022,7,AHMEDABAD,NASIK,619,598,AHMEDABAD-NASIK,1217,All
2022,8,AHMEDABAD,NASIK,829,753,AHMEDABAD-NASIK,1582,All
2022,9,AHMEDABAD,NASIK,993,930,AHMEDABAD-NASIK,1923,All
2022,10,AHMEDABAD,NASIK,932,909,AHMEDABAD-NASIK,1841,All
2023,3,AHMEDABAD,NASIK,1120,1143,AHMEDABAD-NASIK,2263,All
2023,4,AHMEDABAD,NASIK,1940,2023,AHMEDABAD-NASIK,3963,All
2023,5,AHMEDABAD,NASIK,2098,1866,AHMEDABAD-NASIK,3964,All
2023,6,AHMEDABAD,NASIK,3507,3022,AHMEDABAD-NASIK,6529,All
2023,7,AHMEDABAD,NASIK,3936,3819,AHMEDABAD-NASIK,7755,All
2023,8,AHMEDABAD,NASIK,3628,3510,AHMEDABAD-NASIK,7138,All
2023,9,AHMEDABAD,NASIK,3525,3264,AHMEDABAD-NASIK,6789,All
2023,10,AHMEDABAD,NASIK,3710,3475,AHMEDABAD-NASIK,7185,All
2023,11,AHMEDABAD,NASIK,3630,3178,AHMEDABAD-NASIK,6808,All
2023,12,AHMEDABAD,NASIK,4166,3977,AHMEDABAD-NASIK,8143,All
2024,1,AHMEDABAD,NASIK,3762,3741,AHMEDABAD-NASIK,7503,All
2024,2,AHMEDABAD,NASIK,3661,3580,AHMEDABAD-NASIK,7241,All
2024,3,AHMEDABAD,NASIK,3764,3565,AHMEDABAD-NASIK,7329,All
2024,4,AHMEDABAD,NASIK,1896,1782,AHMEDABAD-NASIK,3678,All
2024,6,AHMEDABAD,NASIK,1805,1675,AHMEDABAD-NASIK,3480,All
2024,7,AHMEDABAD,NASIK,1701,1687,AHMEDABAD-NASIK,3388,All
2024,8,AHMEDABAD,NASIK,1838,1812,AHMEDABAD-NASIK,3650,All
2024,9,AHMEDABAD,NASIK,1804,1708,AHMEDABAD-NASIK,3512,All
2024,10,AHMEDABAD,NASIK,1703,1610,AHMEDABAD-NASIK,3313,All
2024,11,AHMEDABAD,NASIK,1998,2104,AHMEDABAD-NASIK,4102,All
2024,12,AHMEDABAD,NASIK,2231,2148,AHMEDABAD-NASIK,4379,All
2025,1,AHMEDABAD,NASIK,2198,2066,AHMEDABAD-NASIK,4264,All
2025,2,AHMEDABAD,NASIK,1988,2021,AHMEDABAD-NASIK,4009,All
2025,3,AHMEDABAD,NASIK,2134,2114,AHMEDABAD-NASIK,4248,All
2023,3,AHMEDABAD,PANTNAGAR,8,18,AHMEDABAD-PANTNAGAR,26,All
2023,4,AHMEDABAD,PANTNAGAR,216,191,AHMEDABAD-PANTNAGAR,407,All
2023,5,AHMEDABAD,PANTNAGAR,395,521,AHMEDABAD-PANTNAGAR,916,All
2023,6,AHMEDABAD,PANTNAGAR,221,338,AHMEDABAD-PANTNAGAR,559,All
2023,7,AHMEDABAD,PANTNAGAR,31,77,AHMEDABAD-PANTNAGAR,108,All
2023,8,AHMEDABAD,PANTNAGAR,55,82,AHMEDABAD-PANTNAGAR,137,All
2023,9,AHMEDABAD,PANTNAGAR,80,110,AHMEDABAD-PANTNAGAR,190,All
2023,10,AHMEDABAD,PANTNAGAR,124,188,AHMEDABAD-PANTNAGAR,312,All
2017,9,AHMEDABAD,PATNA,0,33,AHMEDABAD-PATNA,33,All
2018,10,AHMEDABAD,PATNA,567,550,AHMEDABAD-PATNA,1117,All
2018,11,AHMEDABAD,PATNA,4833,4583,AHMEDABAD-PATNA,9416,All
2018,12,AHMEDABAD,PATNA,4649,4679,AHMEDABAD-PATNA,9328,All
2019,1,AHMEDABAD,PATNA,4965,4493,AHMEDABAD-PATNA,9458,All
2019,2,AHMEDABAD,PATNA,4526,4396,AHMEDABAD-PATNA,8922,All
2019,3,AHMEDABAD,PATNA,4888,4621,AHMEDABAD-PATNA,9509,All
2019,4,AHMEDABAD,PATNA,4906,4798,AHMEDABAD-PATNA,9704,All
2019,5,AHMEDABAD,PATNA,4835,4117,AHMEDABAD-PATNA,8952,All
2019,6,AHMEDABAD,PATNA,4614,4542,AHMEDABAD-PATNA,9156,All
2019,7,AHMEDABAD,PATNA,4536,4554,AHMEDABAD-PATNA,9090,All
2019,8,AHMEDABAD,PATNA,4464,4490,AHMEDABAD-PATNA,8954,All
2019,9,AHMEDABAD,PATNA,4013,4134,AHMEDABAD-PATNA,8147,All
2019,10,AHMEDABAD,PATNA,5006,4694,AHMEDABAD-PATNA,9700,All
2019,11,AHMEDABAD,PATNA,4782,4771,AHMEDABAD-PATNA,9553,All
2019,12,AHMEDABAD,PATNA,4827,4836,AHMEDABAD-PATNA,9663,All
2020,1,AHMEDABAD,PATNA,5022,4965,AHMEDABAD-PATNA,9987,All
2020,2,AHMEDABAD,PATNA,4459,4328,AHMEDABAD-PATNA,8787,All
2020,3,AHMEDABAD,PATNA,3693,3432,AHMEDABAD-PATNA,7125,All
2020,7,AHMEDABAD,PATNA,1735,1269,AHMEDABAD-PATNA,3004,All
2020,8,AHMEDABAD,PATNA,3842,7429,AHMEDABAD-PATNA,11271,All
2020,9,AHMEDABAD,PATNA,4148,8725,AHMEDABAD-PATNA,12873,All
2020,10,AHMEDABAD,PATNA,7852,9312,AHMEDABAD-PATNA,17164,All
2020,11,AHMEDABAD,PATNA,9846,7233,AHMEDABAD-PATNA,17079,All
2020,12,AHMEDABAD,PATNA,7489,10356,AHMEDABAD-PATNA,17845,All
2021,1,AHMEDABAD,PATNA,5687,8344,AHMEDABAD-PATNA,14031,All
2021,2,AHMEDABAD,PATNA,5333,5388,AHMEDABAD-PATNA,10721,All
2021,3,AHMEDABAD,PATNA,6467,4897,AHMEDABAD-PATNA,11364,All
2021,4,AHMEDABAD,PATNA,7107,4129,AHMEDABAD-PATNA,11236,All
2021,6,AHMEDABAD,PATNA,4317,7571,AHMEDABAD-PATNA,11888,All
2021,7,AHMEDABAD,PATNA,5151,6076,AHMEDABAD-PATNA,11227,All
2021,8,AHMEDABAD,PATNA,4238,4514,AHMEDABAD-PATNA,8752,All
2021,9,AHMEDABAD,PATNA,3411,3284,AHMEDABAD-PATNA,6695,All
2021,10,AHMEDABAD,PATNA,5018,4021,AHMEDABAD-PATNA,9039,All
2021,11,AHMEDABAD,PATNA,10246,8215,AHMEDABAD-PATNA,18461,All
2021,12,AHMEDABAD,PATNA,7163,9543,AHMEDABAD-PATNA,16706,All
2022,1,AHMEDABAD,PATNA,3633,3029,AHMEDABAD-PATNA,6662,All
2022,2,AHMEDABAD,PATNA,3849,4021,AHMEDABAD-PATNA,7870,All
2022,3,AHMEDABAD,PATNA,4978,4669,AHMEDABAD-PATNA,9647,All
2022,4,AHMEDABAD,PATNA,5398,5227,AHMEDABAD-PATNA,10625,All
2022,5,AHMEDABAD,PATNA,8097,8122,AHMEDABAD-PATNA,16219,All
2022,6,AHMEDABAD,PATNA,5505,7298,AHMEDABAD-PATNA,12803,All
2022,7,AHMEDABAD,PATNA,4954,5245,AHMEDABAD-PATNA,10199,All
2022,8,AHMEDABAD,PATNA,5481,5865,AHMEDABAD-PATNA,11346,All
2022,9,AHMEDABAD,PATNA,5384,5113,AHMEDABAD-PATNA,10497,All
2022,10,AHMEDABAD,PATNA,9794,6410,AHMEDABAD-PATNA,16204,All
2022,11,AHMEDABAD,PATNA,4862,6275,AHMEDABAD-PATNA,11137,All
2022,12,AHMEDABAD,PATNA,5111,5321,AHMEDABAD-PATNA,10432,All
2023,1,AHMEDABAD,PATNA,5027,4325,AHMEDABAD-PATNA,9352,All
2023,2,AHMEDABAD,PATNA,4896,3816,AHMEDABAD-PATNA,8712,All
2023,3,AHMEDABAD,PATNA,4967,5357,AHMEDABAD-PATNA,10324,All
2023,4,AHMEDABAD,PATNA,4932,4158,AHMEDABAD-PATNA,9090,All
2023,5,AHMEDABAD,PATNA,5323,5064,AHMEDABAD-PATNA,10387,All
2023,6,AHMEDABAD,PATNA,4977,5022,AHMEDABAD-PATNA,9999,All
2023,7,AHMEDABAD,PATNA,4002,5000,AHMEDABAD-PATNA,9002,All
2023,8,AHMEDABAD,PATNA,4191,4709,AHMEDABAD-PATNA,8900,All
2023,9,AHMEDABAD,PATNA,4560,4656,AHMEDABAD-PATNA,9216,All
2023,10,AHMEDABAD,PATNA,5257,4454,AHMEDABAD-PATNA,9711,All
2023,11,AHMEDABAD,PATNA,5239,4435,AHMEDABAD-PATNA,9674,All
2023,12,AHMEDABAD,PATNA,5914,5601,AHMEDABAD-PATNA,11515,All
2024,1,AHMEDABAD,PATNA,5552,5406,AHMEDABAD-PATNA,10958,All
2024,2,AHMEDABAD,PATNA,5019,4748,AHMEDABAD-PATNA,9767,All
2024,3,AHMEDABAD,PATNA,5184,4841,AHMEDABAD-PATNA,10025,All
2024,4,AHMEDABAD,PATNA,5277,4726,AHMEDABAD-PATNA,10003,All
2024,6,AHMEDABAD,PATNA,5102,5192,AHMEDABAD-PATNA,10294,All
2024,7,AHMEDABAD,PATNA,4611,5063,AHMEDABAD-PATNA,9674,All
2024,8,AHMEDABAD,PATNA,4519,4955,AHMEDABAD-PATNA,9474,All
2024,9,AHMEDABAD,PATNA,4329,3957,AHMEDABAD-PATNA,8286,All
2024,10,AHMEDABAD,PATNA,6729,4296,AHMEDABAD-PATNA,11025,All
2024,11,AHMEDABAD,PATNA,9186,8688,AHMEDABAD-PATNA,17874,All
2024,12,AHMEDABAD,PATNA,8719,9419,AHMEDABAD-PATNA,18138,All
2025,1,AHMEDABAD,PATNA,9296,9319,AHMEDABAD-PATNA,18615,All
2025,2,AHMEDABAD,PATNA,8194,7887,AHMEDABAD-PATNA,16081,All
2025,3,AHMEDABAD,PATNA,9106,8684,AHMEDABAD-PATNA,17790,All
2018,12,AHMEDABAD,PORBANDAR,316,373,AHMEDABAD-PORBANDAR,689,All
2019,1,AHMEDABAD,PORBANDAR,839,900,AHMEDABAD-PORBANDAR,1739,All
2019,2,AHMEDABAD,PORBANDAR,728,722,AHMEDABAD-PORBANDAR,1450,All
2019,3,AHMEDABAD,PORBANDAR,942,991,AHMEDABAD-PORBANDAR,1933,All
2019,4,AHMEDABAD,PORBANDAR,870,880,AHMEDABAD-PORBANDAR,1750,All
2019,5,AHMEDABAD,PORBANDAR,1179,1192,AHMEDABAD-PORBANDAR,2371,All
2019,6,AHMEDABAD,PORBANDAR,1129,966,AHMEDABAD-PORBANDAR,2095,All
2019,7,AHMEDABAD,PORBANDAR,1252,1357,AHMEDABAD-PORBANDAR,2609,All
2019,8,AHMEDABAD,PORBANDAR,1208,1224,AHMEDABAD-PORBANDAR,2432,All
2019,9,AHMEDABAD,PORBANDAR,944,956,AHMEDABAD-PORBANDAR,1900,All
2019,10,AHMEDABAD,PORBANDAR,1543,1528,AHMEDABAD-PORBANDAR,3071,All
2019,11,AHMEDABAD,PORBANDAR,1488,1560,AHMEDABAD-PORBANDAR,3048,All
2019,12,AHMEDABAD,PORBANDAR,1802,1627,AHMEDABAD-PORBANDAR,3429,All
2020,1,AHMEDABAD,PORBANDAR,1669,1588,AHMEDABAD-PORBANDAR,3257,All
2020,2,AHMEDABAD,PORBANDAR,1653,1744,AHMEDABAD-PORBANDAR,3397,All
2020,3,AHMEDABAD,PORBANDAR,1154,1279,AHMEDABAD-PORBANDAR,2433,All
2020,5,AHMEDABAD,PORBANDAR,42,44,AHMEDABAD-PORBANDAR,86,All
2020,6,AHMEDABAD,PORBANDAR,301,370,AHMEDABAD-PORBANDAR,671,All
2020,7,AHMEDABAD,PORBANDAR,73,84,AHMEDABAD-PORBANDAR,157,All
2020,9,AHMEDABAD,PORBANDAR,267,359,AHMEDABAD-PORBANDAR,626,All
2020,10,AHMEDABAD,PORBANDAR,478,661,AHMEDABAD-PORBANDAR,1139,All
2020,11,AHMEDABAD,PORBANDAR,609,652,AHMEDABAD-PORBANDAR,1261,All
2020,12,AHMEDABAD,PORBANDAR,639,842,AHMEDABAD-PORBANDAR,1481,All
2021,1,AHMEDABAD,PORBANDAR,998,1074,AHMEDABAD-PORBANDAR,2072,All
2021,2,AHMEDABAD,PORBANDAR,1074,1192,AHMEDABAD-PORBANDAR,2266,All
2021,3,AHMEDABAD,PORBANDAR,1162,1268,AHMEDABAD-PORBANDAR,2430,All
2021,4,AHMEDABAD,PORBANDAR,425,520,AHMEDABAD-PORBANDAR,945,All
2021,6,AHMEDABAD,PORBANDAR,124,145,AHMEDABAD-PORBANDAR,269,All
2021,7,AHMEDABAD,PORBANDAR,368,515,AHMEDABAD-PORBANDAR,883,All
2021,8,AHMEDABAD,PORBANDAR,1005,1135,AHMEDABAD-PORBANDAR,2140,All
2021,9,AHMEDABAD,PORBANDAR,974,1165,AHMEDABAD-PORBANDAR,2139,All
2021,10,AHMEDABAD,PORBANDAR,1344,1403,AHMEDABAD-PORBANDAR,2747,All
2021,11,AHMEDABAD,PORBANDAR,991,872,AHMEDABAD-PORBANDAR,1863,All
2021,12,AHMEDABAD,PORBANDAR,1286,1169,AHMEDABAD-PORBANDAR,2455,All
2022,1,AHMEDABAD,PORBANDAR,555,468,AHMEDABAD-PORBANDAR,1023,All
2020,7,AHMEDABAD,PORT BLAIR,0,7,AHMEDABAD-PORT BLAIR,7,All
2020,8,AHMEDABAD,PORT BLAIR,0,8,AHMEDABAD-PORT BLAIR,8,All
2020,9,AHMEDABAD,PORT BLAIR,0,10,AHMEDABAD-PORT BLAIR,10,All
2020,10,AHMEDABAD,PORT BLAIR,0,1,AHMEDABAD-PORT BLAIR,1,All
2022,10,AHMEDABAD,PORT BLAIR,160,92,AHMEDABAD-PORT BLAIR,252,All
2022,11,AHMEDABAD,PORT BLAIR,45,0,AHMEDABAD-PORT BLAIR,45,All
2022,12,AHMEDABAD,PORT BLAIR,102,0,AHMEDABAD-PORT BLAIR,102,All
2023,1,AHMEDABAD,PORT BLAIR,73,0,AHMEDABAD-PORT BLAIR,73,All
2023,2,AHMEDABAD,PORT BLAIR,83,0,AHMEDABAD-PORT BLAIR,83,All
2023,11,AHMEDABAD,PORT BLAIR,494,0,AHMEDABAD-PORT BLAIR,494,All
2023,12,AHMEDABAD,PORT BLAIR,334,0,AHMEDABAD-PORT BLAIR,334,All
2024,1,AHMEDABAD,PORT BLAIR,396,0,AHMEDABAD-PORT BLAIR,396,All
2024,2,AHMEDABAD,PORT BLAIR,16,0,AHMEDABAD-PORT BLAIR,16,All
2025,2,AHMEDABAD,PRAYAGRAJ,23529,23077,AHMEDABAD-PRAYAGRAJ,46606,All
2025,1,AHMEDABAD,PRAYAGRAJ ,5405,4918,AHMEDABAD-PRAYAGRAJ ,10323,All
2015,4,AHMEDABAD,PUNE,7768,8021,AHMEDABAD-PUNE,15789,All
2015,5,AHMEDABAD,PUNE,7002,7139,AHMEDABAD-PUNE,14141,All
2015,6,AHMEDABAD,PUNE,6958,7358,AHMEDABAD-PUNE,14316,All
2015,7,AHMEDABAD,PUNE,8331,8695,AHMEDABAD-PUNE,17026,All
2015,8,AHMEDABAD,PUNE,10471,11033,AHMEDABAD-PUNE,21504,All
2015,9,AHMEDABAD,PUNE,13292,13682,AHMEDABAD-PUNE,26974,All
2015,10,AHMEDABAD,PUNE,15218,14912,AHMEDABAD-PUNE,30130,All
2015,11,AHMEDABAD,PUNE,15279,16115,AHMEDABAD-PUNE,31394,All
2015,12,AHMEDABAD,PUNE,17111,16745,AHMEDABAD-PUNE,33856,All
2016,1,AHMEDABAD,PUNE,16958,16515,AHMEDABAD-PUNE,33473,All
2016,2,AHMEDABAD,PUNE,16547,16235,AHMEDABAD-PUNE,32782,All
2016,3,AHMEDABAD,PUNE,16460,16479,AHMEDABAD-PUNE,32939,All
2016,4,AHMEDABAD,PUNE,15300,15836,AHMEDABAD-PUNE,31136,All
2016,5,AHMEDABAD,PUNE,16141,15477,AHMEDABAD-PUNE,31618,All
2016,6,AHMEDABAD,PUNE,13264,12831,AHMEDABAD-PUNE,26095,All
2016,7,AHMEDABAD,PUNE,14445,14096,AHMEDABAD-PUNE,28541,All
2016,8,AHMEDABAD,PUNE,14900,14952,AHMEDABAD-PUNE,29852,All
2016,9,AHMEDABAD,PUNE,14686,14531,AHMEDABAD-PUNE,29217,All
2016,10,AHMEDABAD,PUNE,15701,16567,AHMEDABAD-PUNE,32268,All
2016,11,AHMEDABAD,PUNE,17530,18187,AHMEDABAD-PUNE,35717,All
2016,12,AHMEDABAD,PUNE,17763,17744,AHMEDABAD-PUNE,35507,All
2017,1,AHMEDABAD,PUNE,17453,17421,AHMEDABAD-PUNE,34874,All
2017,2,AHMEDABAD,PUNE,16366,15451,AHMEDABAD-PUNE,31817,All
2017,3,AHMEDABAD,PUNE,16675,16225,AHMEDABAD-PUNE,32900,All
2017,4,AHMEDABAD,PUNE,16507,18000,AHMEDABAD-PUNE,34507,All
2017,5,AHMEDABAD,PUNE,18326,17561,AHMEDABAD-PUNE,35887,All
2017,6,AHMEDABAD,PUNE,16702,16193,AHMEDABAD-PUNE,32895,All
2017,7,AHMEDABAD,PUNE,17815,18035,AHMEDABAD-PUNE,35850,All
2017,8,AHMEDABAD,PUNE,20576,21801,AHMEDABAD-PUNE,42377,All
2017,9,AHMEDABAD,PUNE,19741,21166,AHMEDABAD-PUNE,40907,All
2017,10,AHMEDABAD,PUNE,21675,22897,AHMEDABAD-PUNE,44572,All
2017,11,AHMEDABAD,PUNE,22303,23616,AHMEDABAD-PUNE,45919,All
2017,12,AHMEDABAD,PUNE,23111,23642,AHMEDABAD-PUNE,46753,All
2018,1,AHMEDABAD,PUNE,22980,23516,AHMEDABAD-PUNE,46496,All
2018,2,AHMEDABAD,PUNE,21575,21698,AHMEDABAD-PUNE,43273,All
2018,3,AHMEDABAD,PUNE,20757,20718,AHMEDABAD-PUNE,41475,All
2018,4,AHMEDABAD,PUNE,21385,22573,AHMEDABAD-PUNE,43958,All
2018,5,AHMEDABAD,PUNE,24095,22579,AHMEDABAD-PUNE,46674,All
2018,6,AHMEDABAD,PUNE,21675,22575,AHMEDABAD-PUNE,44250,All
2018,7,AHMEDABAD,PUNE,23543,23649,AHMEDABAD-PUNE,47192,All
2018,8,AHMEDABAD,PUNE,23154,23719,AHMEDABAD-PUNE,46873,All
2018,9,AHMEDABAD,PUNE,22542,22963,AHMEDABAD-PUNE,45505,All
2018,10,AHMEDABAD,PUNE,23009,24136,AHMEDABAD-PUNE,47145,All
2018,11,AHMEDABAD,PUNE,23082,24170,AHMEDABAD-PUNE,47252,All
2018,12,AHMEDABAD,PUNE,24054,24298,AHMEDABAD-PUNE,48352,All
2019,1,AHMEDABAD,PUNE,24455,24763,AHMEDABAD-PUNE,49218,All
2019,2,AHMEDABAD,PUNE,22185,22432,AHMEDABAD-PUNE,44617,All
2019,3,AHMEDABAD,PUNE,24135,23847,AHMEDABAD-PUNE,47982,All
2019,4,AHMEDABAD,PUNE,23026,24461,AHMEDABAD-PUNE,47487,All
2019,5,AHMEDABAD,PUNE,26930,25795,AHMEDABAD-PUNE,52725,All
2019,6,AHMEDABAD,PUNE,24712,25335,AHMEDABAD-PUNE,50047,All
2019,7,AHMEDABAD,PUNE,26053,27082,AHMEDABAD-PUNE,53135,All
2019,8,AHMEDABAD,PUNE,26344,27060,AHMEDABAD-PUNE,53404,All
2019,9,AHMEDABAD,PUNE,25683,27005,AHMEDABAD-PUNE,52688,All
2019,10,AHMEDABAD,PUNE,25124,26386,AHMEDABAD-PUNE,51510,All
2019,11,AHMEDABAD,PUNE,25483,26091,AHMEDABAD-PUNE,51574,All
2019,12,AHMEDABAD,PUNE,27033,27121,AHMEDABAD-PUNE,54154,All
2020,1,AHMEDABAD,PUNE,26443,26456,AHMEDABAD-PUNE,52899,All
2020,2,AHMEDABAD,PUNE,24939,24890,AHMEDABAD-PUNE,49829,All
2020,3,AHMEDABAD,PUNE,14186,15737,AHMEDABAD-PUNE,29923,All
2020,5,AHMEDABAD,PUNE,326,544,AHMEDABAD-PUNE,870,All
2020,6,AHMEDABAD,PUNE,1999,2614,AHMEDABAD-PUNE,4613,All
2020,7,AHMEDABAD,PUNE,1935,3084,AHMEDABAD-PUNE,5019,All
2020,8,AHMEDABAD,PUNE,4724,4742,AHMEDABAD-PUNE,9466,All
2020,9,AHMEDABAD,PUNE,5442,4999,AHMEDABAD-PUNE,10441,All
2020,10,AHMEDABAD,PUNE,6713,6911,AHMEDABAD-PUNE,13624,All
2020,11,AHMEDABAD,PUNE,3577,4158,AHMEDABAD-PUNE,7735,All
2020,12,AHMEDABAD,PUNE,6860,5671,AHMEDABAD-PUNE,12531,All
2021,1,AHMEDABAD,PUNE,7678,7231,AHMEDABAD-PUNE,14909,All
2021,2,AHMEDABAD,PUNE,7112,7129,AHMEDABAD-PUNE,14241,All
2021,3,AHMEDABAD,PUNE,6637,7040,AHMEDABAD-PUNE,13677,All
2021,4,AHMEDABAD,PUNE,2454,3609,AHMEDABAD-PUNE,6063,All
2021,6,AHMEDABAD,PUNE,3734,3371,AHMEDABAD-PUNE,7105,All
2021,7,AHMEDABAD,PUNE,5770,6031,AHMEDABAD-PUNE,11801,All
2021,8,AHMEDABAD,PUNE,8327,8598,AHMEDABAD-PUNE,16925,All
2021,9,AHMEDABAD,PUNE,8414,8470,AHMEDABAD-PUNE,16884,All
2021,10,AHMEDABAD,PUNE,5119,5100,AHMEDABAD-PUNE,10219,All
2021,11,AHMEDABAD,PUNE,10706,10641,AHMEDABAD-PUNE,21347,All
2021,12,AHMEDABAD,PUNE,11715,11176,AHMEDABAD-PUNE,22891,All
2022,1,AHMEDABAD,PUNE,7784,6905,AHMEDABAD-PUNE,14689,All
2022,2,AHMEDABAD,PUNE,7691,7631,AHMEDABAD-PUNE,15322,All
2022,3,AHMEDABAD,PUNE,11448,11354,AHMEDABAD-PUNE,22802,All
2022,4,AHMEDABAD,PUNE,12693,12262,AHMEDABAD-PUNE,24955,All
2022,5,AHMEDABAD,PUNE,19547,16329,AHMEDABAD-PUNE,35876,All
2022,6,AHMEDABAD,PUNE,15473,14934,AHMEDABAD-PUNE,30407,All
2022,7,AHMEDABAD,PUNE,12788,12900,AHMEDABAD-PUNE,25688,All
2022,8,AHMEDABAD,PUNE,15299,15089,AHMEDABAD-PUNE,30388,All
2022,9,AHMEDABAD,PUNE,14909,15919,AHMEDABAD-PUNE,30828,All
2022,10,AHMEDABAD,PUNE,18768,18721,AHMEDABAD-PUNE,37489,All
2022,11,AHMEDABAD,PUNE,19959,19609,AHMEDABAD-PUNE,39568,All
2022,12,AHMEDABAD,PUNE,22116,21146,AHMEDABAD-PUNE,43262,All
2023,1,AHMEDABAD,PUNE,26089,24647,AHMEDABAD-PUNE,50736,All
2023,2,AHMEDABAD,PUNE,24562,23115,AHMEDABAD-PUNE,47677,All
2023,3,AHMEDABAD,PUNE,20618,20313,AHMEDABAD-PUNE,40931,All
2023,4,AHMEDABAD,PUNE,17259,17693,AHMEDABAD-PUNE,34952,All
2023,5,AHMEDABAD,PUNE,17957,18208,AHMEDABAD-PUNE,36165,All
2023,6,AHMEDABAD,PUNE,21668,20351,AHMEDABAD-PUNE,42019,All
2023,7,AHMEDABAD,PUNE,20192,20078,AHMEDABAD-PUNE,40270,All
2023,8,AHMEDABAD,PUNE,19423,22153,AHMEDABAD-PUNE,41576,All
2023,9,AHMEDABAD,PUNE,20151,21270,AHMEDABAD-PUNE,41421,All
2023,10,AHMEDABAD,PUNE,19750,20815,AHMEDABAD-PUNE,40565,All
2023,11,AHMEDABAD,PUNE,18012,19666,AHMEDABAD-PUNE,37678,All
2023,12,AHMEDABAD,PUNE,19287,19568,AHMEDABAD-PUNE,38855,All
2024,1,AHMEDABAD,PUNE,19218,20344,AHMEDABAD-PUNE,39562,All
2024,2,AHMEDABAD,PUNE,19728,20276,AHMEDABAD-PUNE,40004,All
2024,3,AHMEDABAD,PUNE,19682,20136,AHMEDABAD-PUNE,39818,All
2024,4,AHMEDABAD,PUNE,21108,23557,AHMEDABAD-PUNE,44665,All
2024,6,AHMEDABAD,PUNE,21889,22212,AHMEDABAD-PUNE,44101,All
2024,7,AHMEDABAD,PUNE,23283,24597,AHMEDABAD-PUNE,47880,All
2024,8,AHMEDABAD,PUNE,24469,25616,AHMEDABAD-PUNE,50085,All
2024,9,AHMEDABAD,PUNE,23256,24432,AHMEDABAD-PUNE,47688,All
2024,10,AHMEDABAD,PUNE,23130,24944,AHMEDABAD-PUNE,48074,All
2024,11,AHMEDABAD,PUNE,30146,30175,AHMEDABAD-PUNE,60321,All
2024,12,AHMEDABAD,PUNE,32474,32678,AHMEDABAD-PUNE,65152,All
2025,1,AHMEDABAD,PUNE,32670,32195,AHMEDABAD-PUNE,64865,All
2025,2,AHMEDABAD,PUNE,29563,30332,AHMEDABAD-PUNE,59895,All
2025,3,AHMEDABAD,PUNE,31143,31167,AHMEDABAD-PUNE,62310,All
2015,10,AHMEDABAD,RAIPUR,89,112,AHMEDABAD-RAIPUR,201,All
2015,11,AHMEDABAD,RAIPUR,933,912,AHMEDABAD-RAIPUR,1845,All
2015,12,AHMEDABAD,RAIPUR,857,945,AHMEDABAD-RAIPUR,1802,All
2016,1,AHMEDABAD,RAIPUR,725,796,AHMEDABAD-RAIPUR,1521,All
2016,2,AHMEDABAD,RAIPUR,732,667,AHMEDABAD-RAIPUR,1399,All
2016,3,AHMEDABAD,RAIPUR,1122,1138,AHMEDABAD-RAIPUR,2260,All
2016,4,AHMEDABAD,RAIPUR,589,448,AHMEDABAD-RAIPUR,1037,All
2020,5,AHMEDABAD,RAIPUR,133,0,AHMEDABAD-RAIPUR,133,All
2020,6,AHMEDABAD,RAIPUR,91,0,AHMEDABAD-RAIPUR,91,All
2020,8,AHMEDABAD,RAIPUR,342,299,AHMEDABAD-RAIPUR,641,All
2020,9,AHMEDABAD,RAIPUR,1110,1310,AHMEDABAD-RAIPUR,2420,All
2020,10,AHMEDABAD,RAIPUR,1296,1484,AHMEDABAD-RAIPUR,2780,All
2020,11,AHMEDABAD,RAIPUR,1945,1903,AHMEDABAD-RAIPUR,3848,All
2020,12,AHMEDABAD,RAIPUR,2208,2692,AHMEDABAD-RAIPUR,4900,All
2021,1,AHMEDABAD,RAIPUR,1873,2500,AHMEDABAD-RAIPUR,4373,All
2021,2,AHMEDABAD,RAIPUR,2127,2364,AHMEDABAD-RAIPUR,4491,All
2021,3,AHMEDABAD,RAIPUR,2239,2269,AHMEDABAD-RAIPUR,4508,All
2021,4,AHMEDABAD,RAIPUR,629,328,AHMEDABAD-RAIPUR,957,All
2021,8,AHMEDABAD,RAIPUR,970,984,AHMEDABAD-RAIPUR,1954,All
2021,9,AHMEDABAD,RAIPUR,894,915,AHMEDABAD-RAIPUR,1809,All
2021,10,AHMEDABAD,RAIPUR,1730,1473,AHMEDABAD-RAIPUR,3203,All
2021,11,AHMEDABAD,RAIPUR,1300,1395,AHMEDABAD-RAIPUR,2695,All
2021,12,AHMEDABAD,RAIPUR,1855,1854,AHMEDABAD-RAIPUR,3709,All
2022,1,AHMEDABAD,RAIPUR,787,706,AHMEDABAD-RAIPUR,1493,All
2022,6,AHMEDABAD,RAIPUR,2757,2804,AHMEDABAD-RAIPUR,5561,All
2022,7,AHMEDABAD,RAIPUR,2066,2039,AHMEDABAD-RAIPUR,4105,All
2022,8,AHMEDABAD,RAIPUR,2651,2493,AHMEDABAD-RAIPUR,5144,All
2022,9,AHMEDABAD,RAIPUR,3120,3070,AHMEDABAD-RAIPUR,6190,All
2022,10,AHMEDABAD,RAIPUR,2067,1783,AHMEDABAD-RAIPUR,3850,All
2022,11,AHMEDABAD,RAIPUR,2002,2073,AHMEDABAD-RAIPUR,4075,All
2022,12,AHMEDABAD,RAIPUR,2163,2192,AHMEDABAD-RAIPUR,4355,All
2023,1,AHMEDABAD,RAIPUR,2139,2059,AHMEDABAD-RAIPUR,4198,All
2023,2,AHMEDABAD,RAIPUR,2206,1978,AHMEDABAD-RAIPUR,4184,All
2023,3,AHMEDABAD,RAIPUR,2381,2105,AHMEDABAD-RAIPUR,4486,All
2023,4,AHMEDABAD,RAIPUR,2443,2181,AHMEDABAD-RAIPUR,4624,All
2023,5,AHMEDABAD,RAIPUR,2910,2739,AHMEDABAD-RAIPUR,5649,All
2023,6,AHMEDABAD,RAIPUR,2531,2418,AHMEDABAD-RAIPUR,4949,All
2023,7,AHMEDABAD,RAIPUR,2347,2257,AHMEDABAD-RAIPUR,4604,All
2023,8,AHMEDABAD,RAIPUR,2271,2279,AHMEDABAD-RAIPUR,4550,All
2023,9,AHMEDABAD,RAIPUR,2687,2513,AHMEDABAD-RAIPUR,5200,All
2023,10,AHMEDABAD,RAIPUR,2741,2529,AHMEDABAD-RAIPUR,5270,All
2023,11,AHMEDABAD,RAIPUR,2253,2150,AHMEDABAD-RAIPUR,4403,All
2023,12,AHMEDABAD,RAIPUR,2184,2334,AHMEDABAD-RAIPUR,4518,All
2024,1,AHMEDABAD,RAIPUR,2479,2424,AHMEDABAD-RAIPUR,4903,All
2024,2,AHMEDABAD,RAIPUR,1995,1981,AHMEDABAD-RAIPUR,3976,All
2024,3,AHMEDABAD,RAIPUR,2290,2178,AHMEDABAD-RAIPUR,4468,All
2024,4,AHMEDABAD,RAIPUR,2200,2199,AHMEDABAD-RAIPUR,4399,All
2024,6,AHMEDABAD,RAIPUR,2061,1987,AHMEDABAD-RAIPUR,4048,All
2024,7,AHMEDABAD,RAIPUR,2410,2463,AHMEDABAD-RAIPUR,4873,All
2024,8,AHMEDABAD,RAIPUR,2189,2221,AHMEDABAD-RAIPUR,4410,All
2024,9,AHMEDABAD,RAIPUR,2229,2259,AHMEDABAD-RAIPUR,4488,All
2024,10,AHMEDABAD,RAIPUR,4985,4831,AHMEDABAD-RAIPUR,9816,All
2024,11,AHMEDABAD,RAIPUR,4545,5324,AHMEDABAD-RAIPUR,9869,All
2024,12,AHMEDABAD,RAIPUR,4709,5478,AHMEDABAD-RAIPUR,10187,All
2025,1,AHMEDABAD,RAIPUR,4567,5408,AHMEDABAD-RAIPUR,9975,All
2025,2,AHMEDABAD,RAIPUR,4242,4843,AHMEDABAD-RAIPUR,9085,All
2025,3,AHMEDABAD,RAIPUR,5142,4769,AHMEDABAD-RAIPUR,9911,All
2021,9,AHMEDABAD,RAJKOT,85,1,AHMEDABAD-RAJKOT,86,All
2022,1,AHMEDABAD,RAJKOT,0,3,AHMEDABAD-RAJKOT,3,All
2023,2,AHMEDABAD,RAJKOT,0,115,AHMEDABAD-RAJKOT,115,All
2023,8,AHMEDABAD,RAJKOT,0,17,AHMEDABAD-RAJKOT,17,All
2017,9,AHMEDABAD,RANCHI,0,100,AHMEDABAD-RANCHI,100,All
2019,10,AHMEDABAD,RANCHI,28,0,AHMEDABAD-RANCHI,28,All
2019,11,AHMEDABAD,RANCHI,340,0,AHMEDABAD-RANCHI,340,All
2019,12,AHMEDABAD,RANCHI,695,0,AHMEDABAD-RANCHI,695,All
2020,1,AHMEDABAD,RANCHI,685,0,AHMEDABAD-RANCHI,685,All
2020,2,AHMEDABAD,RANCHI,618,0,AHMEDABAD-RANCHI,618,All
2020,3,AHMEDABAD,RANCHI,443,0,AHMEDABAD-RANCHI,443,All
2020,7,AHMEDABAD,RANCHI,50,91,AHMEDABAD-RANCHI,141,All
2021,2,AHMEDABAD,RANCHI,1321,1515,AHMEDABAD-RANCHI,2836,All
2021,3,AHMEDABAD,RANCHI,1703,1653,AHMEDABAD-RANCHI,3356,All
2021,4,AHMEDABAD,RANCHI,889,872,AHMEDABAD-RANCHI,1761,All
2021,11,AHMEDABAD,RANCHI,1961,2124,AHMEDABAD-RANCHI,4085,All
2021,12,AHMEDABAD,RANCHI,3010,3086,AHMEDABAD-RANCHI,6096,All
2022,1,AHMEDABAD,RANCHI,1360,1275,AHMEDABAD-RANCHI,2635,All
2022,6,AHMEDABAD,RANCHI,2269,2344,AHMEDABAD-RANCHI,4613,All
2022,7,AHMEDABAD,RANCHI,1545,1706,AHMEDABAD-RANCHI,3251,All
2022,8,AHMEDABAD,RANCHI,1378,1596,AHMEDABAD-RANCHI,2974,All
2022,9,AHMEDABAD,RANCHI,1528,1493,AHMEDABAD-RANCHI,3021,All
2022,10,AHMEDABAD,RANCHI,2333,2160,AHMEDABAD-RANCHI,4493,All
2022,11,AHMEDABAD,RANCHI,2818,3034,AHMEDABAD-RANCHI,5852,All
2022,12,AHMEDABAD,RANCHI,2696,2885,AHMEDABAD-RANCHI,5581,All
2023,1,AHMEDABAD,RANCHI,2616,2648,AHMEDABAD-RANCHI,5264,All
2023,2,AHMEDABAD,RANCHI,2578,2284,AHMEDABAD-RANCHI,4862,All
2023,3,AHMEDABAD,RANCHI,2576,2413,AHMEDABAD-RANCHI,4989,All
2023,4,AHMEDABAD,RANCHI,2935,2618,AHMEDABAD-RANCHI,5553,All
2023,5,AHMEDABAD,RANCHI,2930,2830,AHMEDABAD-RANCHI,5760,All
2023,6,AHMEDABAD,RANCHI,2814,2921,AHMEDABAD-RANCHI,5735,All
2023,7,AHMEDABAD,RANCHI,2656,2692,AHMEDABAD-RANCHI,5348,All
2023,8,AHMEDABAD,RANCHI,2718,2687,AHMEDABAD-RANCHI,5405,All
2023,9,AHMEDABAD,RANCHI,2668,2681,AHMEDABAD-RANCHI,5349,All
2023,10,AHMEDABAD,RANCHI,3103,2852,AHMEDABAD-RANCHI,5955,All
2023,11,AHMEDABAD,RANCHI,2961,2763,AHMEDABAD-RANCHI,5724,All
2023,12,AHMEDABAD,RANCHI,3094,3142,AHMEDABAD-RANCHI,6236,All
2024,1,AHMEDABAD,RANCHI,3000,2957,AHMEDABAD-RANCHI,5957,All
2024,2,AHMEDABAD,RANCHI,2884,2867,AHMEDABAD-RANCHI,5751,All
2024,3,AHMEDABAD,RANCHI,2971,2978,AHMEDABAD-RANCHI,5949,All
2024,4,AHMEDABAD,RANCHI,2923,2897,AHMEDABAD-RANCHI,5820,All
2024,6,AHMEDABAD,RANCHI,3187,3171,AHMEDABAD-RANCHI,6358,All
2024,7,AHMEDABAD,RANCHI,2482,2888,AHMEDABAD-RANCHI,5370,All
2024,8,AHMEDABAD,RANCHI,2564,2944,AHMEDABAD-RANCHI,5508,All
2024,9,AHMEDABAD,RANCHI,2836,2965,AHMEDABAD-RANCHI,5801,All
2024,10,AHMEDABAD,RANCHI,5516,4764,AHMEDABAD-RANCHI,10280,All
2024,11,AHMEDABAD,RANCHI,4787,5237,AHMEDABAD-RANCHI,10024,All
2024,12,AHMEDABAD,RANCHI,5212,5362,AHMEDABAD-RANCHI,10574,All
2025,1,AHMEDABAD,RANCHI,5825,5887,AHMEDABAD-RANCHI,11712,All
2025,2,AHMEDABAD,RANCHI,5006,4998,AHMEDABAD-RANCHI,10004,All
2025,3,AHMEDABAD,RANCHI,6155,5141,AHMEDABAD-RANCHI,11296,All
2024,3,AHMEDABAD,Rajkot International Airport,33,37,AHMEDABAD-Rajkot International Airport,70,All
2024,4,AHMEDABAD,Rajkot International Airport,762,571,AHMEDABAD-Rajkot International Airport,1333,All
2024,6,AHMEDABAD,Rajkot International Airport,1103,927,AHMEDABAD-Rajkot International Airport,2030,All
2024,7,AHMEDABAD,Rajkot International Airport,731,828,AHMEDABAD-Rajkot International Airport,1559,All
2024,8,AHMEDABAD,Rajkot International Airport,790,904,AHMEDABAD-Rajkot International Airport,1694,All
2024,9,AHMEDABAD,Rajkot International Airport,1191,909,AHMEDABAD-Rajkot International Airport,2100,All
2024,10,AHMEDABAD,Rajkot International Airport,949,885,AHMEDABAD-Rajkot International Airport,1834,All
2019,1,AHMEDABAD,SHIRDI,554,612,AHMEDABAD-SHIRDI,1166,All
2019,2,AHMEDABAD,SHIRDI,756,767,AHMEDABAD-SHIRDI,1523,All
2019,3,AHMEDABAD,SHIRDI,648,586,AHMEDABAD-SHIRDI,1234,All
2021,2,AHMEDABAD,SHIRDI,330,727,AHMEDABAD-SHIRDI,1057,All
2021,3,AHMEDABAD,SHIRDI,215,377,AHMEDABAD-SHIRDI,592,All
2022,4,AHMEDABAD,SHIRDI,137,114,AHMEDABAD-SHIRDI,251,All
2022,5,AHMEDABAD,SHIRDI,531,338,AHMEDABAD-SHIRDI,869,All
2022,6,AHMEDABAD,SHIRDI,478,386,AHMEDABAD-SHIRDI,864,All
2022,7,AHMEDABAD,SHIRDI,101,96,AHMEDABAD-SHIRDI,197,All
2022,8,AHMEDABAD,SHIRDI,46,35,AHMEDABAD-SHIRDI,81,All
2018,12,AHMEDABAD,SRINAGAR,0,1325,AHMEDABAD-SRINAGAR,1325,All
2019,1,AHMEDABAD,SRINAGAR,0,3048,AHMEDABAD-SRINAGAR,3048,All
2019,2,AHMEDABAD,SRINAGAR,0,2194,AHMEDABAD-SRINAGAR,2194,All
2019,3,AHMEDABAD,SRINAGAR,0,506,AHMEDABAD-SRINAGAR,506,All
2020,9,AHMEDABAD,SRINAGAR,153,96,AHMEDABAD-SRINAGAR,249,All
2020,10,AHMEDABAD,SRINAGAR,351,505,AHMEDABAD-SRINAGAR,856,All
2020,11,AHMEDABAD,SRINAGAR,879,611,AHMEDABAD-SRINAGAR,1490,All
2020,12,AHMEDABAD,SRINAGAR,1220,793,AHMEDABAD-SRINAGAR,2013,All
2021,1,AHMEDABAD,SRINAGAR,1002,641,AHMEDABAD-SRINAGAR,1643,All
2021,2,AHMEDABAD,SRINAGAR,1879,997,AHMEDABAD-SRINAGAR,2876,All
2021,3,AHMEDABAD,SRINAGAR,2401,1150,AHMEDABAD-SRINAGAR,3551,All
2021,4,AHMEDABAD,SRINAGAR,950,843,AHMEDABAD-SRINAGAR,1793,All
2021,7,AHMEDABAD,SRINAGAR,829,906,AHMEDABAD-SRINAGAR,1735,All
2021,8,AHMEDABAD,SRINAGAR,45,171,AHMEDABAD-SRINAGAR,216,All
2021,9,AHMEDABAD,SRINAGAR,612,417,AHMEDABAD-SRINAGAR,1029,All
2021,10,AHMEDABAD,SRINAGAR,317,241,AHMEDABAD-SRINAGAR,558,All
2022,5,AHMEDABAD,SRINAGAR,117,123,AHMEDABAD-SRINAGAR,240,All
2023,5,AHMEDABAD,SRINAGAR,0,730,AHMEDABAD-SRINAGAR,730,All
2023,6,AHMEDABAD,SRINAGAR,0,689,AHMEDABAD-SRINAGAR,689,All
2023,7,AHMEDABAD,SRINAGAR,0,838,AHMEDABAD-SRINAGAR,838,All
2023,8,AHMEDABAD,SRINAGAR,1760,1574,AHMEDABAD-SRINAGAR,3334,All
2023,9,AHMEDABAD,SRINAGAR,3367,2448,AHMEDABAD-SRINAGAR,5815,All
2023,10,AHMEDABAD,SRINAGAR,3717,4030,AHMEDABAD-SRINAGAR,7747,All
2023,11,AHMEDABAD,SRINAGAR,4235,4288,AHMEDABAD-SRINAGAR,8523,All
2023,12,AHMEDABAD,SRINAGAR,4869,4847,AHMEDABAD-SRINAGAR,9716,All
2024,1,AHMEDABAD,SRINAGAR,4336,4558,AHMEDABAD-SRINAGAR,8894,All
2024,2,AHMEDABAD,SRINAGAR,4249,4093,AHMEDABAD-SRINAGAR,8342,All
2024,3,AHMEDABAD,SRINAGAR,4662,4165,AHMEDABAD-SRINAGAR,8827,All
2024,4,AHMEDABAD,SRINAGAR,5197,3812,AHMEDABAD-SRINAGAR,9009,All
2024,6,AHMEDABAD,SRINAGAR,4948,4229,AHMEDABAD-SRINAGAR,9177,All
2024,7,AHMEDABAD,SRINAGAR,4726,4470,AHMEDABAD-SRINAGAR,9196,All
2024,8,AHMEDABAD,SRINAGAR,3729,3344,AHMEDABAD-SRINAGAR,7073,All
2024,9,AHMEDABAD,SRINAGAR,2970,2687,AHMEDABAD-SRINAGAR,5657,All
2024,10,AHMEDABAD,SRINAGAR,5246,3837,AHMEDABAD-SRINAGAR,9083,All
2024,11,AHMEDABAD,SRINAGAR,7132,7235,AHMEDABAD-SRINAGAR,14367,All
2024,12,AHMEDABAD,SRINAGAR,5271,5510,AHMEDABAD-SRINAGAR,10781,All
2025,1,AHMEDABAD,SRINAGAR,5710,5876,AHMEDABAD-SRINAGAR,11586,All
2025,2,AHMEDABAD,SRINAGAR,5082,5031,AHMEDABAD-SRINAGAR,10113,All
2025,3,AHMEDABAD,SRINAGAR,6481,6383,AHMEDABAD-SRINAGAR,12864,All
2017,8,AHMEDABAD,SURAT,13,0,AHMEDABAD-SURAT,13,All
2020,5,AHMEDABAD,SURAT,0,0,AHMEDABAD-SURAT,0,All
2023,2,AHMEDABAD,SURAT,0,3,AHMEDABAD-SURAT,3,All
2018,9,AHMEDABAD,TIRUPATI,0,118,AHMEDABAD-TIRUPATI,118,All
2018,10,AHMEDABAD,TIRUPATI,0,212,AHMEDABAD-TIRUPATI,212,All
2017,4,AHMEDABAD,TRIVANDRUM,275,214,AHMEDABAD-TRIVANDRUM,489,All
2017,5,AHMEDABAD,TRIVANDRUM,292,352,AHMEDABAD-TRIVANDRUM,644,All
2017,6,AHMEDABAD,TRIVANDRUM,177,287,AHMEDABAD-TRIVANDRUM,464,All
2017,7,AHMEDABAD,TRIVANDRUM,262,200,AHMEDABAD-TRIVANDRUM,462,All
2017,8,AHMEDABAD,TRIVANDRUM,408,397,AHMEDABAD-TRIVANDRUM,805,All
2017,9,AHMEDABAD,TRIVANDRUM,322,397,AHMEDABAD-TRIVANDRUM,719,All
2017,10,AHMEDABAD,TRIVANDRUM,792,854,AHMEDABAD-TRIVANDRUM,1646,All
2017,11,AHMEDABAD,TRIVANDRUM,410,594,AHMEDABAD-TRIVANDRUM,1004,All
2017,12,AHMEDABAD,TRIVANDRUM,261,448,AHMEDABAD-TRIVANDRUM,709,All
2018,1,AHMEDABAD,TRIVANDRUM,238,407,AHMEDABAD-TRIVANDRUM,645,All
2018,2,AHMEDABAD,TRIVANDRUM,311,562,AHMEDABAD-TRIVANDRUM,873,All
2018,3,AHMEDABAD,TRIVANDRUM,50,0,AHMEDABAD-TRIVANDRUM,50,All
2018,4,AHMEDABAD,TRIVANDRUM,190,0,AHMEDABAD-TRIVANDRUM,190,All
2018,6,AHMEDABAD,TRIVANDRUM,0,156,AHMEDABAD-TRIVANDRUM,156,All
2018,7,AHMEDABAD,TRIVANDRUM,0,241,AHMEDABAD-TRIVANDRUM,241,All
2018,8,AHMEDABAD,TRIVANDRUM,0,306,AHMEDABAD-TRIVANDRUM,306,All
2018,9,AHMEDABAD,TRIVANDRUM,0,453,AHMEDABAD-TRIVANDRUM,453,All
2018,10,AHMEDABAD,TRIVANDRUM,0,415,AHMEDABAD-TRIVANDRUM,415,All
2018,11,AHMEDABAD,TRIVANDRUM,0,986,AHMEDABAD-TRIVANDRUM,986,All
2018,12,AHMEDABAD,TRIVANDRUM,0,582,AHMEDABAD-TRIVANDRUM,582,All
2019,1,AHMEDABAD,TRIVANDRUM,0,581,AHMEDABAD-TRIVANDRUM,581,All
2019,2,AHMEDABAD,TRIVANDRUM,0,646,AHMEDABAD-TRIVANDRUM,646,All
2019,3,AHMEDABAD,TRIVANDRUM,0,519,AHMEDABAD-TRIVANDRUM,519,All
2019,4,AHMEDABAD,TRIVANDRUM,0,504,AHMEDABAD-TRIVANDRUM,504,All
2019,5,AHMEDABAD,TRIVANDRUM,0,909,AHMEDABAD-TRIVANDRUM,909,All
2019,6,AHMEDABAD,TRIVANDRUM,0,789,AHMEDABAD-TRIVANDRUM,789,All
2019,7,AHMEDABAD,TRIVANDRUM,0,216,AHMEDABAD-TRIVANDRUM,216,All
2019,8,AHMEDABAD,TRIVANDRUM,0,357,AHMEDABAD-TRIVANDRUM,357,All
2019,9,AHMEDABAD,TRIVANDRUM,0,413,AHMEDABAD-TRIVANDRUM,413,All
2019,10,AHMEDABAD,TRIVANDRUM,0,531,AHMEDABAD-TRIVANDRUM,531,All
2019,11,AHMEDABAD,TRIVANDRUM,0,790,AHMEDABAD-TRIVANDRUM,790,All
2019,12,AHMEDABAD,TRIVANDRUM,0,493,AHMEDABAD-TRIVANDRUM,493,All
2020,1,AHMEDABAD,TRIVANDRUM,0,474,AHMEDABAD-TRIVANDRUM,474,All
2020,2,AHMEDABAD,TRIVANDRUM,0,416,AHMEDABAD-TRIVANDRUM,416,All
2020,3,AHMEDABAD,TRIVANDRUM,0,232,AHMEDABAD-TRIVANDRUM,232,All
2020,10,AHMEDABAD,TRIVANDRUM,53,67,AHMEDABAD-TRIVANDRUM,120,All
2020,11,AHMEDABAD,TRIVANDRUM,321,484,AHMEDABAD-TRIVANDRUM,805,All
2020,12,AHMEDABAD,TRIVANDRUM,413,419,AHMEDABAD-TRIVANDRUM,832,All
2021,1,AHMEDABAD,TRIVANDRUM,333,425,AHMEDABAD-TRIVANDRUM,758,All
2021,2,AHMEDABAD,TRIVANDRUM,317,546,AHMEDABAD-TRIVANDRUM,863,All
2021,3,AHMEDABAD,TRIVANDRUM,283,378,AHMEDABAD-TRIVANDRUM,661,All
2022,6,AHMEDABAD,TRIVANDRUM,116,47,AHMEDABAD-TRIVANDRUM,163,All
2022,7,AHMEDABAD,TRIVANDRUM,53,64,AHMEDABAD-TRIVANDRUM,117,All
2022,8,AHMEDABAD,TRIVANDRUM,273,282,AHMEDABAD-TRIVANDRUM,555,All
2022,9,AHMEDABAD,TRIVANDRUM,276,215,AHMEDABAD-TRIVANDRUM,491,All
2022,10,AHMEDABAD,TRIVANDRUM,438,334,AHMEDABAD-TRIVANDRUM,772,All
2022,11,AHMEDABAD,TRIVANDRUM,347,357,AHMEDABAD-TRIVANDRUM,704,All
2022,12,AHMEDABAD,TRIVANDRUM,419,443,AHMEDABAD-TRIVANDRUM,862,All
2023,1,AHMEDABAD,TRIVANDRUM,319,283,AHMEDABAD-TRIVANDRUM,602,All
2023,2,AHMEDABAD,TRIVANDRUM,378,141,AHMEDABAD-TRIVANDRUM,519,All
2023,3,AHMEDABAD,TRIVANDRUM,184,160,AHMEDABAD-TRIVANDRUM,344,All
2023,4,AHMEDABAD,TRIVANDRUM,92,122,AHMEDABAD-TRIVANDRUM,214,All
2023,5,AHMEDABAD,TRIVANDRUM,156,187,AHMEDABAD-TRIVANDRUM,343,All
2023,6,AHMEDABAD,TRIVANDRUM,130,54,AHMEDABAD-TRIVANDRUM,184,All
2023,7,AHMEDABAD,TRIVANDRUM,106,57,AHMEDABAD-TRIVANDRUM,163,All
2023,8,AHMEDABAD,TRIVANDRUM,168,84,AHMEDABAD-TRIVANDRUM,252,All
2023,9,AHMEDABAD,TRIVANDRUM,119,82,AHMEDABAD-TRIVANDRUM,201,All
2023,10,AHMEDABAD,TRIVANDRUM,184,184,AHMEDABAD-TRIVANDRUM,368,All
2023,11,AHMEDABAD,TRIVANDRUM,265,239,AHMEDABAD-TRIVANDRUM,504,All
2023,12,AHMEDABAD,TRIVANDRUM,300,353,AHMEDABAD-TRIVANDRUM,653,All
2024,1,AHMEDABAD,TRIVANDRUM,141,280,AHMEDABAD-TRIVANDRUM,421,All
2024,2,AHMEDABAD,TRIVANDRUM,48,153,AHMEDABAD-TRIVANDRUM,201,All
2024,12,AHMEDABAD,TRIVANDRUM,2080,2034,AHMEDABAD-TRIVANDRUM,4114,All
2025,1,AHMEDABAD,TRIVANDRUM,2663,3176,AHMEDABAD-TRIVANDRUM,5839,All
2025,2,AHMEDABAD,TRIVANDRUM,2103,2692,AHMEDABAD-TRIVANDRUM,4795,All
2025,3,AHMEDABAD,TRIVANDRUM,1948,2410,AHMEDABAD-TRIVANDRUM,4358,All
2018,6,AHMEDABAD,UDAIPUR,38,0,AHMEDABAD-UDAIPUR,38,All
2018,7,AHMEDABAD,UDAIPUR,32,0,AHMEDABAD-UDAIPUR,32,All
2018,10,AHMEDABAD,UDAIPUR,0,9,AHMEDABAD-UDAIPUR,9,All
2018,11,AHMEDABAD,UDAIPUR,0,15,AHMEDABAD-UDAIPUR,15,All
2019,2,AHMEDABAD,UDAIPUR,570,0,AHMEDABAD-UDAIPUR,570,All
2019,3,AHMEDABAD,UDAIPUR,1096,122,AHMEDABAD-UDAIPUR,1218,All
2019,4,AHMEDABAD,UDAIPUR,290,288,AHMEDABAD-UDAIPUR,578,All
2019,5,AHMEDABAD,UDAIPUR,893,871,AHMEDABAD-UDAIPUR,1764,All
2019,6,AHMEDABAD,UDAIPUR,855,993,AHMEDABAD-UDAIPUR,1848,All
2019,7,AHMEDABAD,UDAIPUR,1052,1113,AHMEDABAD-UDAIPUR,2165,All
2019,8,AHMEDABAD,UDAIPUR,1415,1341,AHMEDABAD-UDAIPUR,2756,All
2019,9,AHMEDABAD,UDAIPUR,1213,1303,AHMEDABAD-UDAIPUR,2516,All
2019,10,AHMEDABAD,UDAIPUR,1146,1068,AHMEDABAD-UDAIPUR,2214,All
2019,12,AHMEDABAD,UDAIPUR,1042,970,AHMEDABAD-UDAIPUR,2012,All
2020,1,AHMEDABAD,UDAIPUR,1480,1320,AHMEDABAD-UDAIPUR,2800,All
2020,2,AHMEDABAD,UDAIPUR,1492,1457,AHMEDABAD-UDAIPUR,2949,All
2020,3,AHMEDABAD,UDAIPUR,637,631,AHMEDABAD-UDAIPUR,1268,All
2020,5,AHMEDABAD,UDAIPUR,74,36,AHMEDABAD-UDAIPUR,110,All
2020,6,AHMEDABAD,UDAIPUR,22,7,AHMEDABAD-UDAIPUR,29,All
2020,11,AHMEDABAD,UDAIPUR,211,212,AHMEDABAD-UDAIPUR,423,All
2020,12,AHMEDABAD,UDAIPUR,298,319,AHMEDABAD-UDAIPUR,617,All
2021,1,AHMEDABAD,UDAIPUR,59,51,AHMEDABAD-UDAIPUR,110,All
2021,2,AHMEDABAD,UDAIPUR,765,971,AHMEDABAD-UDAIPUR,1736,All
2021,3,AHMEDABAD,UDAIPUR,706,807,AHMEDABAD-UDAIPUR,1513,All
2021,7,AHMEDABAD,UDAIPUR,175,172,AHMEDABAD-UDAIPUR,347,All
2021,8,AHMEDABAD,UDAIPUR,371,479,AHMEDABAD-UDAIPUR,850,All
2021,9,AHMEDABAD,UDAIPUR,333,347,AHMEDABAD-UDAIPUR,680,All
2021,10,AHMEDABAD,UDAIPUR,565,620,AHMEDABAD-UDAIPUR,1185,All
2021,11,AHMEDABAD,UDAIPUR,1150,1351,AHMEDABAD-UDAIPUR,2501,All
2021,12,AHMEDABAD,UDAIPUR,1044,1122,AHMEDABAD-UDAIPUR,2166,All
2022,1,AHMEDABAD,UDAIPUR,240,316,AHMEDABAD-UDAIPUR,556,All
2022,2,AHMEDABAD,UDAIPUR,476,553,AHMEDABAD-UDAIPUR,1029,All
2022,3,AHMEDABAD,UDAIPUR,662,756,AHMEDABAD-UDAIPUR,1418,All
2022,9,AHMEDABAD,UDAIPUR,0,8,AHMEDABAD-UDAIPUR,8,All
2022,10,AHMEDABAD,UDAIPUR,0,9,AHMEDABAD-UDAIPUR,9,All
2022,12,AHMEDABAD,UDAIPUR,995,1043,AHMEDABAD-UDAIPUR,2038,All
2023,1,AHMEDABAD,UDAIPUR,1545,1636,AHMEDABAD-UDAIPUR,3181,All
2023,2,AHMEDABAD,UDAIPUR,926,966,AHMEDABAD-UDAIPUR,1892,All
2023,3,AHMEDABAD,UDAIPUR,924,821,AHMEDABAD-UDAIPUR,1745,All
2023,4,AHMEDABAD,UDAIPUR,1127,853,AHMEDABAD-UDAIPUR,1980,All
2023,5,AHMEDABAD,UDAIPUR,1322,1334,AHMEDABAD-UDAIPUR,2656,All
2023,6,AHMEDABAD,UDAIPUR,387,1019,AHMEDABAD-UDAIPUR,1406,All
2023,7,AHMEDABAD,UDAIPUR,768,933,AHMEDABAD-UDAIPUR,1701,All
2023,8,AHMEDABAD,UDAIPUR,605,577,AHMEDABAD-UDAIPUR,1182,All
2023,9,AHMEDABAD,UDAIPUR,544,490,AHMEDABAD-UDAIPUR,1034,All
2023,10,AHMEDABAD,UDAIPUR,544,567,AHMEDABAD-UDAIPUR,1111,All
2023,11,AHMEDABAD,UDAIPUR,967,906,AHMEDABAD-UDAIPUR,1873,All
2023,12,AHMEDABAD,UDAIPUR,614,1073,AHMEDABAD-UDAIPUR,1687,All
2024,1,AHMEDABAD,UDAIPUR,1020,908,AHMEDABAD-UDAIPUR,1928,All
2024,2,AHMEDABAD,UDAIPUR,771,526,AHMEDABAD-UDAIPUR,1297,All
2024,3,AHMEDABAD,UDAIPUR,762,542,AHMEDABAD-UDAIPUR,1304,All
2024,4,AHMEDABAD,UDAIPUR,633,362,AHMEDABAD-UDAIPUR,995,All
2024,6,AHMEDABAD,UDAIPUR,530,537,AHMEDABAD-UDAIPUR,1067,All
2024,7,AHMEDABAD,UDAIPUR,525,423,AHMEDABAD-UDAIPUR,948,All
2024,8,AHMEDABAD,UDAIPUR,858,714,AHMEDABAD-UDAIPUR,1572,All
2024,9,AHMEDABAD,UDAIPUR,802,595,AHMEDABAD-UDAIPUR,1397,All
2024,10,AHMEDABAD,UDAIPUR,547,387,AHMEDABAD-UDAIPUR,934,All
2024,11,AHMEDABAD,UDAIPUR,203,426,AHMEDABAD-UDAIPUR,629,All
2024,12,AHMEDABAD,UDAIPUR,209,306,AHMEDABAD-UDAIPUR,515,All
2025,1,AHMEDABAD,UDAIPUR,328,289,AHMEDABAD-UDAIPUR,617,All
2016,5,AHMEDABAD,VADODARA,0,62,AHMEDABAD-VADODARA,62,All
2018,6,AHMEDABAD,VADODARA,0,41,AHMEDABAD-VADODARA,41,All
2020,7,AHMEDABAD,VADODARA,8,0,AHMEDABAD-VADODARA,8,All
2020,8,AHMEDABAD,VADODARA,47,0,AHMEDABAD-VADODARA,47,All
2020,9,AHMEDABAD,VADODARA,20,0,AHMEDABAD-VADODARA,20,All
2020,10,AHMEDABAD,VADODARA,26,0,AHMEDABAD-VADODARA,26,All
2020,11,AHMEDABAD,VADODARA,9,0,AHMEDABAD-VADODARA,9,All
2020,12,AHMEDABAD,VADODARA,9,0,AHMEDABAD-VADODARA,9,All
2021,1,AHMEDABAD,VADODARA,5,0,AHMEDABAD-VADODARA,5,All
2021,2,AHMEDABAD,VADODARA,15,0,AHMEDABAD-VADODARA,15,All
2021,3,AHMEDABAD,VADODARA,5,0,AHMEDABAD-VADODARA,5,All
2023,1,AHMEDABAD,VADODARA,0,292,AHMEDABAD-VADODARA,292,All
2023,7,AHMEDABAD,VADODARA,0,109,AHMEDABAD-VADODARA,109,All
2024,1,AHMEDABAD,VADODARA,277,0,AHMEDABAD-VADODARA,277,All
2024,8,AHMEDABAD,VADODARA,157,133,AHMEDABAD-VADODARA,290,All
2017,12,AHMEDABAD,VARANASI,3372,3870,AHMEDABAD-VARANASI,7242,All
2018,1,AHMEDABAD,VARANASI,4748,4473,AHMEDABAD-VARANASI,9221,All
2018,2,AHMEDABAD,VARANASI,4514,4189,AHMEDABAD-VARANASI,8703,All
2018,4,AHMEDABAD,VARANASI,2457,1913,AHMEDABAD-VARANASI,4370,All
2018,5,AHMEDABAD,VARANASI,4792,5067,AHMEDABAD-VARANASI,9859,All
2018,6,AHMEDABAD,VARANASI,3296,3388,AHMEDABAD-VARANASI,6684,All
2018,7,AHMEDABAD,VARANASI,3875,4237,AHMEDABAD-VARANASI,8112,All
2018,8,AHMEDABAD,VARANASI,4624,3919,AHMEDABAD-VARANASI,8543,All
2018,9,AHMEDABAD,VARANASI,6186,5569,AHMEDABAD-VARANASI,11755,All
2018,10,AHMEDABAD,VARANASI,7749,5655,AHMEDABAD-VARANASI,13404,All
2018,11,AHMEDABAD,VARANASI,8966,7490,AHMEDABAD-VARANASI,16456,All
2018,12,AHMEDABAD,VARANASI,4549,4603,AHMEDABAD-VARANASI,9152,All
2019,1,AHMEDABAD,VARANASI,4961,4193,AHMEDABAD-VARANASI,9154,All
2019,2,AHMEDABAD,VARANASI,6693,6560,AHMEDABAD-VARANASI,13253,All
2019,3,AHMEDABAD,VARANASI,8802,8542,AHMEDABAD-VARANASI,17344,All
2019,4,AHMEDABAD,VARANASI,6412,5551,AHMEDABAD-VARANASI,11963,All
2019,5,AHMEDABAD,VARANASI,9925,9522,AHMEDABAD-VARANASI,19447,All
2019,6,AHMEDABAD,VARANASI,9316,10083,AHMEDABAD-VARANASI,19399,All
2019,7,AHMEDABAD,VARANASI,7599,8668,AHMEDABAD-VARANASI,16267,All
2019,8,AHMEDABAD,VARANASI,8812,8346,AHMEDABAD-VARANASI,17158,All
2019,9,AHMEDABAD,VARANASI,8169,8389,AHMEDABAD-VARANASI,16558,All
2019,10,AHMEDABAD,VARANASI,8969,7023,AHMEDABAD-VARANASI,15992,All
2019,11,AHMEDABAD,VARANASI,8018,8903,AHMEDABAD-VARANASI,16921,All
2019,12,AHMEDABAD,VARANASI,7477,9310,AHMEDABAD-VARANASI,16787,All
2020,1,AHMEDABAD,VARANASI,9036,8321,AHMEDABAD-VARANASI,17357,All
2020,2,AHMEDABAD,VARANASI,13007,10225,AHMEDABAD-VARANASI,23232,All
2020,3,AHMEDABAD,VARANASI,8235,7313,AHMEDABAD-VARANASI,15548,All
2020,5,AHMEDABAD,VARANASI,707,378,AHMEDABAD-VARANASI,1085,All
2020,6,AHMEDABAD,VARANASI,4741,2783,AHMEDABAD-VARANASI,7524,All
2020,7,AHMEDABAD,VARANASI,3790,4446,AHMEDABAD-VARANASI,8236,All
2020,8,AHMEDABAD,VARANASI,3043,4606,AHMEDABAD-VARANASI,7649,All
2020,9,AHMEDABAD,VARANASI,3400,9600,AHMEDABAD-VARANASI,13000,All
2020,10,AHMEDABAD,VARANASI,6412,8714,AHMEDABAD-VARANASI,15126,All
2020,11,AHMEDABAD,VARANASI,11745,6503,AHMEDABAD-VARANASI,18248,All
2020,12,AHMEDABAD,VARANASI,8665,8571,AHMEDABAD-VARANASI,17236,All
2021,1,AHMEDABAD,VARANASI,6081,6706,AHMEDABAD-VARANASI,12787,All
2021,2,AHMEDABAD,VARANASI,6343,4246,AHMEDABAD-VARANASI,10589,All
2021,3,AHMEDABAD,VARANASI,8379,4305,AHMEDABAD-VARANASI,12684,All
2021,4,AHMEDABAD,VARANASI,8435,3887,AHMEDABAD-VARANASI,12322,All
2021,6,AHMEDABAD,VARANASI,3797,6265,AHMEDABAD-VARANASI,10062,All
2021,7,AHMEDABAD,VARANASI,3783,4118,AHMEDABAD-VARANASI,7901,All
2021,8,AHMEDABAD,VARANASI,4108,3860,AHMEDABAD-VARANASI,7968,All
2021,9,AHMEDABAD,VARANASI,2991,2980,AHMEDABAD-VARANASI,5971,All
2021,10,AHMEDABAD,VARANASI,4674,3554,AHMEDABAD-VARANASI,8228,All
2021,11,AHMEDABAD,VARANASI,7797,6952,AHMEDABAD-VARANASI,14749,All
2021,12,AHMEDABAD,VARANASI,5118,7479,AHMEDABAD-VARANASI,12597,All
2022,1,AHMEDABAD,VARANASI,1981,2097,AHMEDABAD-VARANASI,4078,All
2022,2,AHMEDABAD,VARANASI,1607,1603,AHMEDABAD-VARANASI,3210,All
2022,3,AHMEDABAD,VARANASI,2239,2141,AHMEDABAD-VARANASI,4380,All
2022,4,AHMEDABAD,VARANASI,3035,1874,AHMEDABAD-VARANASI,4909,All
2022,5,AHMEDABAD,VARANASI,6449,5593,AHMEDABAD-VARANASI,12042,All
2022,6,AHMEDABAD,VARANASI,3497,5362,AHMEDABAD-VARANASI,8859,All
2022,7,AHMEDABAD,VARANASI,2209,2302,AHMEDABAD-VARANASI,4511,All
2022,8,AHMEDABAD,VARANASI,4594,5072,AHMEDABAD-VARANASI,9666,All
2022,9,AHMEDABAD,VARANASI,4634,4565,AHMEDABAD-VARANASI,9199,All
2022,10,AHMEDABAD,VARANASI,5869,3726,AHMEDABAD-VARANASI,9595,All
2022,11,AHMEDABAD,VARANASI,6769,8621,AHMEDABAD-VARANASI,15390,All
2022,12,AHMEDABAD,VARANASI,6326,8874,AHMEDABAD-VARANASI,15200,All
2023,1,AHMEDABAD,VARANASI,6775,6813,AHMEDABAD-VARANASI,13588,All
2023,2,AHMEDABAD,VARANASI,9259,7967,AHMEDABAD-VARANASI,17226,All
2023,3,AHMEDABAD,VARANASI,9354,9052,AHMEDABAD-VARANASI,18406,All
2023,4,AHMEDABAD,VARANASI,9644,7722,AHMEDABAD-VARANASI,17366,All
2023,5,AHMEDABAD,VARANASI,5833,5479,AHMEDABAD-VARANASI,11312,All
2023,6,AHMEDABAD,VARANASI,5007,5301,AHMEDABAD-VARANASI,10308,All
2023,7,AHMEDABAD,VARANASI,4909,5163,AHMEDABAD-VARANASI,10072,All
2023,8,AHMEDABAD,VARANASI,5067,4963,AHMEDABAD-VARANASI,10030,All
2023,9,AHMEDABAD,VARANASI,4934,4861,AHMEDABAD-VARANASI,9795,All
2023,10,AHMEDABAD,VARANASI,4900,4906,AHMEDABAD-VARANASI,9806,All
2023,11,AHMEDABAD,VARANASI,4907,4579,AHMEDABAD-VARANASI,9486,All
2023,12,AHMEDABAD,VARANASI,4961,5369,AHMEDABAD-VARANASI,10330,All
2024,1,AHMEDABAD,VARANASI,4415,4545,AHMEDABAD-VARANASI,8960,All
2024,2,AHMEDABAD,VARANASI,4912,4815,AHMEDABAD-VARANASI,9727,All
2024,3,AHMEDABAD,VARANASI,5074,4944,AHMEDABAD-VARANASI,10018,All
2024,4,AHMEDABAD,VARANASI,5241,4919,AHMEDABAD-VARANASI,10160,All
2024,6,AHMEDABAD,VARANASI,4866,5244,AHMEDABAD-VARANASI,10110,All
2024,7,AHMEDABAD,VARANASI,4163,5062,AHMEDABAD-VARANASI,9225,All
2024,8,AHMEDABAD,VARANASI,4760,5640,AHMEDABAD-VARANASI,10400,All
2024,9,AHMEDABAD,VARANASI,6779,7170,AHMEDABAD-VARANASI,13949,All
2024,10,AHMEDABAD,VARANASI,4649,3949,AHMEDABAD-VARANASI,8598,All
2024,11,AHMEDABAD,VARANASI,4613,5320,AHMEDABAD-VARANASI,9933,All
2024,12,AHMEDABAD,VARANASI,4563,5611,AHMEDABAD-VARANASI,10174,All
2025,1,AHMEDABAD,VARANASI,4281,5210,AHMEDABAD-VARANASI,9491,All
2025,2,AHMEDABAD,VARANASI,4450,5277,AHMEDABAD-VARANASI,9727,All
2025,3,AHMEDABAD,VARANASI,6081,6904,AHMEDABAD-VARANASI,12985,All
2016,6,AHMEDABAD,VISAKHAPATNAM,0,611,AHMEDABAD-VISAKHAPATNAM,611,All
2016,7,AHMEDABAD,VISAKHAPATNAM,347,575,AHMEDABAD-VISAKHAPATNAM,922,All
2016,8,AHMEDABAD,VISAKHAPATNAM,476,676,AHMEDABAD-VISAKHAPATNAM,1152,All
2016,9,AHMEDABAD,VISAKHAPATNAM,298,568,AHMEDABAD-VISAKHAPATNAM,866,All
2016,10,AHMEDABAD,VISAKHAPATNAM,363,761,AHMEDABAD-VISAKHAPATNAM,1124,All
2016,11,AHMEDABAD,VISAKHAPATNAM,594,707,AHMEDABAD-VISAKHAPATNAM,1301,All
2016,12,AHMEDABAD,VISAKHAPATNAM,593,905,AHMEDABAD-VISAKHAPATNAM,1498,All
2017,1,AHMEDABAD,VISAKHAPATNAM,485,1185,AHMEDABAD-VISAKHAPATNAM,1670,All
2017,2,AHMEDABAD,VISAKHAPATNAM,376,616,AHMEDABAD-VISAKHAPATNAM,992,All
2017,3,AHMEDABAD,VISAKHAPATNAM,418,574,AHMEDABAD-VISAKHAPATNAM,992,All
2017,4,AHMEDABAD,VISAKHAPATNAM,488,316,AHMEDABAD-VISAKHAPATNAM,804,All
2017,5,AHMEDABAD,VISAKHAPATNAM,513,455,AHMEDABAD-VISAKHAPATNAM,968,All
2017,6,AHMEDABAD,VISAKHAPATNAM,581,618,AHMEDABAD-VISAKHAPATNAM,1199,All
2017,7,AHMEDABAD,VISAKHAPATNAM,500,469,AHMEDABAD-VISAKHAPATNAM,969,All
2017,8,AHMEDABAD,VISAKHAPATNAM,448,328,AHMEDABAD-VISAKHAPATNAM,776,All
2017,9,AHMEDABAD,VISAKHAPATNAM,422,438,AHMEDABAD-VISAKHAPATNAM,860,All
2017,10,AHMEDABAD,VISAKHAPATNAM,451,439,AHMEDABAD-VISAKHAPATNAM,890,All
2017,11,AHMEDABAD,VISAKHAPATNAM,552,616,AHMEDABAD-VISAKHAPATNAM,1168,All
2017,12,AHMEDABAD,VISAKHAPATNAM,704,740,AHMEDABAD-VISAKHAPATNAM,1444,All
2018,1,AHMEDABAD,VISAKHAPATNAM,664,748,AHMEDABAD-VISAKHAPATNAM,1412,All
2018,2,AHMEDABAD,VISAKHAPATNAM,461,782,AHMEDABAD-VISAKHAPATNAM,1243,All
2018,3,AHMEDABAD,VISAKHAPATNAM,290,298,AHMEDABAD-VISAKHAPATNAM,588,All
2018,4,AHMEDABAD,VISAKHAPATNAM,404,427,AHMEDABAD-VISAKHAPATNAM,831,All
2018,5,AHMEDABAD,VISAKHAPATNAM,493,663,AHMEDABAD-VISAKHAPATNAM,1156,All
2018,6,AHMEDABAD,VISAKHAPATNAM,584,637,AHMEDABAD-VISAKHAPATNAM,1221,All
2018,7,AHMEDABAD,VISAKHAPATNAM,413,506,AHMEDABAD-VISAKHAPATNAM,919,All
2018,8,AHMEDABAD,VISAKHAPATNAM,498,570,AHMEDABAD-VISAKHAPATNAM,1068,All
2018,9,AHMEDABAD,VISAKHAPATNAM,543,598,AHMEDABAD-VISAKHAPATNAM,1141,All
2018,10,AHMEDABAD,VISAKHAPATNAM,746,751,AHMEDABAD-VISAKHAPATNAM,1497,All
2018,11,AHMEDABAD,VISAKHAPATNAM,814,733,AHMEDABAD-VISAKHAPATNAM,1547,All
2018,12,AHMEDABAD,VISAKHAPATNAM,999,870,AHMEDABAD-VISAKHAPATNAM,1869,All
2019,1,AHMEDABAD,VISAKHAPATNAM,1115,1105,AHMEDABAD-VISAKHAPATNAM,2220,All
2019,2,AHMEDABAD,VISAKHAPATNAM,806,693,AHMEDABAD-VISAKHAPATNAM,1499,All
2019,3,AHMEDABAD,VISAKHAPATNAM,764,671,AHMEDABAD-VISAKHAPATNAM,1435,All
2019,4,AHMEDABAD,VISAKHAPATNAM,755,201,AHMEDABAD-VISAKHAPATNAM,956,All
2019,5,AHMEDABAD,VISAKHAPATNAM,1119,242,AHMEDABAD-VISAKHAPATNAM,1361,All
2019,6,AHMEDABAD,VISAKHAPATNAM,960,0,AHMEDABAD-VISAKHAPATNAM,960,All
2019,7,AHMEDABAD,VISAKHAPATNAM,463,0,AHMEDABAD-VISAKHAPATNAM,463,All
2019,8,AHMEDABAD,VISAKHAPATNAM,747,0,AHMEDABAD-VISAKHAPATNAM,747,All
2019,9,AHMEDABAD,VISAKHAPATNAM,303,0,AHMEDABAD-VISAKHAPATNAM,303,All
2019,10,AHMEDABAD,VISAKHAPATNAM,468,0,AHMEDABAD-VISAKHAPATNAM,468,All
2019,11,AHMEDABAD,VISAKHAPATNAM,411,0,AHMEDABAD-VISAKHAPATNAM,411,All
2019,12,AHMEDABAD,VISAKHAPATNAM,496,125,AHMEDABAD-VISAKHAPATNAM,621,All
2020,1,AHMEDABAD,VISAKHAPATNAM,416,135,AHMEDABAD-VISAKHAPATNAM,551,All
2020,2,AHMEDABAD,VISAKHAPATNAM,315,129,AHMEDABAD-VISAKHAPATNAM,444,All
2020,3,AHMEDABAD,VISAKHAPATNAM,430,139,AHMEDABAD-VISAKHAPATNAM,569,All
2021,3,AHMEDABAD,VISAKHAPATNAM,72,0,AHMEDABAD-VISAKHAPATNAM,72,All
2021,4,AHMEDABAD,VISAKHAPATNAM,544,0,AHMEDABAD-VISAKHAPATNAM,544,All
2021,6,AHMEDABAD,VISAKHAPATNAM,494,0,AHMEDABAD-VISAKHAPATNAM,494,All
2021,7,AHMEDABAD,VISAKHAPATNAM,421,0,AHMEDABAD-VISAKHAPATNAM,421,All
2021,8,AHMEDABAD,VISAKHAPATNAM,0,430,AHMEDABAD-VISAKHAPATNAM,430,All
2021,9,AHMEDABAD,VISAKHAPATNAM,0,384,AHMEDABAD-VISAKHAPATNAM,384,All
2021,10,AHMEDABAD,VISAKHAPATNAM,12,403,AHMEDABAD-VISAKHAPATNAM,415,All
2021,11,AHMEDABAD,VISAKHAPATNAM,492,327,AHMEDABAD-VISAKHAPATNAM,819,All
2021,12,AHMEDABAD,VISAKHAPATNAM,435,295,AHMEDABAD-VISAKHAPATNAM,730,All
2022,1,AHMEDABAD,VISAKHAPATNAM,0,177,AHMEDABAD-VISAKHAPATNAM,177,All
2022,3,AHMEDABAD,VISAKHAPATNAM,40,185,AHMEDABAD-VISAKHAPATNAM,225,All
2022,4,AHMEDABAD,VISAKHAPATNAM,349,366,AHMEDABAD-VISAKHAPATNAM,715,All
2022,5,AHMEDABAD,VISAKHAPATNAM,417,340,AHMEDABAD-VISAKHAPATNAM,757,All
2022,6,AHMEDABAD,VISAKHAPATNAM,677,529,AHMEDABAD-VISAKHAPATNAM,1206,All
2022,7,AHMEDABAD,VISAKHAPATNAM,440,339,AHMEDABAD-VISAKHAPATNAM,779,All
2022,8,AHMEDABAD,VISAKHAPATNAM,450,270,AHMEDABAD-VISAKHAPATNAM,720,All
2022,9,AHMEDABAD,VISAKHAPATNAM,406,12,AHMEDABAD-VISAKHAPATNAM,418,All
2022,10,AHMEDABAD,VISAKHAPATNAM,555,248,AHMEDABAD-VISAKHAPATNAM,803,All
2022,11,AHMEDABAD,VISAKHAPATNAM,367,419,AHMEDABAD-VISAKHAPATNAM,786,All
2022,12,AHMEDABAD,VISAKHAPATNAM,704,429,AHMEDABAD-VISAKHAPATNAM,1133,All
2023,1,AHMEDABAD,VISAKHAPATNAM,512,527,AHMEDABAD-VISAKHAPATNAM,1039,All
2023,2,AHMEDABAD,VISAKHAPATNAM,383,328,AHMEDABAD-VISAKHAPATNAM,711,All
2023,3,AHMEDABAD,VISAKHAPATNAM,277,179,AHMEDABAD-VISAKHAPATNAM,456,All
2023,10,AHMEDABAD,VISAKHAPATNAM,46,62,AHMEDABAD-VISAKHAPATNAM,108,All
2023,11,AHMEDABAD,VISAKHAPATNAM,298,447,AHMEDABAD-VISAKHAPATNAM,745,All
2023,12,AHMEDABAD,VISAKHAPATNAM,431,726,AHMEDABAD-VISAKHAPATNAM,1157,All
2024,1,AHMEDABAD,VISAKHAPATNAM,354,317,AHMEDABAD-VISAKHAPATNAM,671,All
2024,2,AHMEDABAD,VISAKHAPATNAM,398,413,AHMEDABAD-VISAKHAPATNAM,811,All
2024,3,AHMEDABAD,VISAKHAPATNAM,248,480,AHMEDABAD-VISAKHAPATNAM,728,All
2024,4,AHMEDABAD,VISAKHAPATNAM,334,358,AHMEDABAD-VISAKHAPATNAM,692,All
2024,6,AHMEDABAD,VISAKHAPATNAM,465,471,AHMEDABAD-VISAKHAPATNAM,936,All
2024,7,AHMEDABAD,VISAKHAPATNAM,254,364,AHMEDABAD-VISAKHAPATNAM,618,All
2024,8,AHMEDABAD,VISAKHAPATNAM,247,388,AHMEDABAD-VISAKHAPATNAM,635,All
2024,9,AHMEDABAD,VISAKHAPATNAM,345,640,AHMEDABAD-VISAKHAPATNAM,985,All
2024,10,AHMEDABAD,VISAKHAPATNAM,365,837,AHMEDABAD-VISAKHAPATNAM,1202,All
2024,11,AHMEDABAD,VISAKHAPATNAM,322,771,AHMEDABAD-VISAKHAPATNAM,1093,All
2024,12,AHMEDABAD,VISAKHAPATNAM,489,1065,AHMEDABAD-VISAKHAPATNAM,1554,All
2025,3,AHMEDABAD,VISAKHAPATNAM,581,809,AHMEDABAD-VISAKHAPATNAM,1390,All
2016,3,AIZAWL,AHMEDABAD,2,0,AHMEDABAD-AIZAWL,2,All
2016,4,AIZAWL,AHMEDABAD,9,18,AHMEDABAD-AIZAWL,27,All
2016,5,AIZAWL,AHMEDABAD,26,42,AHMEDABAD-AIZAWL,68,All
2016,6,AIZAWL,AHMEDABAD,21,27,AHMEDABAD-AIZAWL,48,All
2016,7,AIZAWL,AHMEDABAD,7,11,AHMEDABAD-AIZAWL,18,All
2016,8,AIZAWL,AHMEDABAD,0,12,AHMEDABAD-AIZAWL,12,All
2016,9,AIZAWL,AHMEDABAD,0,19,AHMEDABAD-AIZAWL,19,All
2016,10,AIZAWL,AHMEDABAD,0,10,AHMEDABAD-AIZAWL,10,All
2016,11,AIZAWL,AHMEDABAD,32,30,AHMEDABAD-AIZAWL,62,All
2016,12,AIZAWL,AHMEDABAD,4,22,AHMEDABAD-AIZAWL,26,All
2017,1,AIZAWL,AHMEDABAD,32,13,AHMEDABAD-AIZAWL,45,All
2017,2,AIZAWL,AHMEDABAD,26,13,AHMEDABAD-AIZAWL,39,All
2017,3,AIZAWL,AHMEDABAD,25,15,AHMEDABAD-AIZAWL,40,All
2017,4,AIZAWL,AHMEDABAD,13,6,AHMEDABAD-AIZAWL,19,All
2017,5,AIZAWL,AHMEDABAD,17,13,AHMEDABAD-AIZAWL,30,All
2017,6,AIZAWL,AHMEDABAD,6,14,AHMEDABAD-AIZAWL,20,All
2017,7,AIZAWL,AHMEDABAD,23,10,AHMEDABAD-AIZAWL,33,All
2017,8,AIZAWL,AHMEDABAD,32,27,AHMEDABAD-AIZAWL,59,All
2017,9,AIZAWL,AHMEDABAD,35,37,AHMEDABAD-AIZAWL,72,All
2017,10,AIZAWL,AHMEDABAD,39,28,AHMEDABAD-AIZAWL,67,All
2017,11,AIZAWL,AHMEDABAD,8,11,AHMEDABAD-AIZAWL,19,All
2017,12,AIZAWL,AHMEDABAD,11,46,AHMEDABAD-AIZAWL,57,All
2018,1,AIZAWL,AHMEDABAD,35,3,AHMEDABAD-AIZAWL,38,All
2018,2,AIZAWL,AHMEDABAD,9,9,AHMEDABAD-AIZAWL,18,All
2018,3,AIZAWL,AHMEDABAD,28,21,AHMEDABAD-AIZAWL,49,All
2017,2,AIZAWL,BENGALURU,0,7,AIZAWL-BENGALURU,7,All
2017,3,AIZAWL,BENGALURU,20,18,AIZAWL-BENGALURU,38,All
2017,6,AIZAWL,BENGALURU,36,60,AIZAWL-BENGALURU,96,All
2018,9,AIZAWL,BENGALURU,162,174,AIZAWL-BENGALURU,336,All
2018,10,AIZAWL,BENGALURU,298,267,AIZAWL-BENGALURU,565,All
2018,11,AIZAWL,BENGALURU,247,210,AIZAWL-BENGALURU,457,All
2018,12,AIZAWL,BENGALURU,237,492,AIZAWL-BENGALURU,729,All
2019,1,AIZAWL,BENGALURU,451,235,AIZAWL-BENGALURU,686,All
2019,2,AIZAWL,BENGALURU,123,99,AIZAWL-BENGALURU,222,All
2021,7,AIZAWL,BENGALURU,113,39,AIZAWL-BENGALURU,152,All
2021,8,AIZAWL,BENGALURU,84,83,AIZAWL-BENGALURU,167,All
2021,9,AIZAWL,BENGALURU,268,106,AIZAWL-BENGALURU,374,All
2021,10,AIZAWL,BENGALURU,235,130,AIZAWL-BENGALURU,365,All
2024,6,AIZAWL,BENGALURU,116,160,AIZAWL-BENGALURU,276,All
2024,7,AIZAWL,BENGALURU,69,61,AIZAWL-BENGALURU,130,All
2024,8,AIZAWL,BENGALURU,85,69,AIZAWL-BENGALURU,154,All
2024,9,AIZAWL,BENGALURU,120,60,AIZAWL-BENGALURU,180,All
2024,10,AIZAWL,BENGALURU,59,91,AIZAWL-BENGALURU,150,All
2024,11,AIZAWL,BENGALURU,63,83,AIZAWL-BENGALURU,146,All
2024,12,AIZAWL,BENGALURU,59,289,AIZAWL-BENGALURU,348,All
2025,3,AIZAWL,BENGALURU,270,202,AIZAWL-BENGALURU,472,All
2016,3,AIZAWL,DELHI,111,131,AIZAWL-DELHI,242,All
2016,4,AIZAWL,DELHI,694,708,AIZAWL-DELHI,1402,All
2016,5,AIZAWL,DELHI,584,679,AIZAWL-DELHI,1263,All
2016,6,AIZAWL,DELHI,814,689,AIZAWL-DELHI,1503,All
2016,7,AIZAWL,DELHI,751,507,AIZAWL-DELHI,1258,All
2016,8,AIZAWL,DELHI,563,453,AIZAWL-DELHI,1016,All
2016,9,AIZAWL,DELHI,615,526,AIZAWL-DELHI,1141,All
2016,10,AIZAWL,DELHI,365,408,AIZAWL-DELHI,773,All
2016,11,AIZAWL,DELHI,526,669,AIZAWL-DELHI,1195,All
2016,12,AIZAWL,DELHI,576,1038,AIZAWL-DELHI,1614,All
2017,1,AIZAWL,DELHI,675,378,AIZAWL-DELHI,1053,All
2017,2,AIZAWL,DELHI,1065,680,AIZAWL-DELHI,1745,All
2017,3,AIZAWL,DELHI,1043,673,AIZAWL-DELHI,1716,All
2017,4,AIZAWL,DELHI,625,752,AIZAWL-DELHI,1377,All
2017,5,AIZAWL,DELHI,842,797,AIZAWL-DELHI,1639,All
2017,6,AIZAWL,DELHI,571,644,AIZAWL-DELHI,1215,All
2017,7,AIZAWL,DELHI,1011,684,AIZAWL-DELHI,1695,All
2017,8,AIZAWL,DELHI,1003,802,AIZAWL-DELHI,1805,All
2017,9,AIZAWL,DELHI,701,604,AIZAWL-DELHI,1305,All
2017,10,AIZAWL,DELHI,916,648,AIZAWL-DELHI,1564,All
2017,11,AIZAWL,DELHI,854,1040,AIZAWL-DELHI,1894,All
2017,12,AIZAWL,DELHI,508,1237,AIZAWL-DELHI,1745,All
2018,1,AIZAWL,DELHI,920,595,AIZAWL-DELHI,1515,All
2018,2,AIZAWL,DELHI,768,591,AIZAWL-DELHI,1359,All
2018,3,AIZAWL,DELHI,1256,1333,AIZAWL-DELHI,2589,All
2018,4,AIZAWL,DELHI,1444,2252,AIZAWL-DELHI,3696,All
2018,5,AIZAWL,DELHI,1130,2463,AIZAWL-DELHI,3593,All
2018,6,AIZAWL,DELHI,1375,2328,AIZAWL-DELHI,3703,All
2018,7,AIZAWL,DELHI,1354,1782,AIZAWL-DELHI,3136,All
2018,8,AIZAWL,DELHI,1371,1778,AIZAWL-DELHI,3149,All
2018,9,AIZAWL,DELHI,1485,1693,AIZAWL-DELHI,3178,All
2018,10,AIZAWL,DELHI,1263,1494,AIZAWL-DELHI,2757,All
2018,11,AIZAWL,DELHI,1909,2367,AIZAWL-DELHI,4276,All
2018,12,AIZAWL,DELHI,1789,2659,AIZAWL-DELHI,4448,All
2019,1,AIZAWL,DELHI,1576,1724,AIZAWL-DELHI,3300,All
2019,2,AIZAWL,DELHI,126,163,AIZAWL-DELHI,289,All
2020,11,AIZAWL,DELHI,425,265,AIZAWL-DELHI,690,All
2020,12,AIZAWL,DELHI,717,933,AIZAWL-DELHI,1650,All
2021,1,AIZAWL,DELHI,1262,962,AIZAWL-DELHI,2224,All
2021,2,AIZAWL,DELHI,1199,1179,AIZAWL-DELHI,2378,All
2021,3,AIZAWL,DELHI,1827,1719,AIZAWL-DELHI,3546,All
2021,4,AIZAWL,DELHI,1265,1667,AIZAWL-DELHI,2932,All
2021,6,AIZAWL,DELHI,558,606,AIZAWL-DELHI,1164,All
2021,7,AIZAWL,DELHI,957,561,AIZAWL-DELHI,1518,All
2021,8,AIZAWL,DELHI,1125,875,AIZAWL-DELHI,2000,All
2021,9,AIZAWL,DELHI,1284,1053,AIZAWL-DELHI,2337,All
2021,10,AIZAWL,DELHI,1426,1257,AIZAWL-DELHI,2683,All
2021,11,AIZAWL,DELHI,1728,2743,AIZAWL-DELHI,4471,All
2021,12,AIZAWL,DELHI,1777,3675,AIZAWL-DELHI,5452,All
2022,1,AIZAWL,DELHI,1449,1892,AIZAWL-DELHI,3341,All
2022,2,AIZAWL,DELHI,1320,1370,AIZAWL-DELHI,2690,All
2022,3,AIZAWL,DELHI,1950,1951,AIZAWL-DELHI,3901,All
2022,4,AIZAWL,DELHI,1798,1855,AIZAWL-DELHI,3653,All
2022,5,AIZAWL,DELHI,1609,1810,AIZAWL-DELHI,3419,All
2022,6,AIZAWL,DELHI,1843,1836,AIZAWL-DELHI,3679,All
2022,7,AIZAWL,DELHI,1964,1743,AIZAWL-DELHI,3707,All
2022,8,AIZAWL,DELHI,1913,1767,AIZAWL-DELHI,3680,All
2022,9,AIZAWL,DELHI,1970,1935,AIZAWL-DELHI,3905,All
2022,10,AIZAWL,DELHI,2116,2098,AIZAWL-DELHI,4214,All
2022,11,AIZAWL,DELHI,1809,2171,AIZAWL-DELHI,3980,All
2022,12,AIZAWL,DELHI,1680,2212,AIZAWL-DELHI,3892,All
2023,1,AIZAWL,DELHI,1860,1783,AIZAWL-DELHI,3643,All
2023,2,AIZAWL,DELHI,1584,1286,AIZAWL-DELHI,2870,All
2023,3,AIZAWL,DELHI,1927,2089,AIZAWL-DELHI,4016,All
2023,4,AIZAWL,DELHI,2029,2115,AIZAWL-DELHI,4144,All
2023,5,AIZAWL,DELHI,2110,2219,AIZAWL-DELHI,4329,All
2023,6,AIZAWL,DELHI,2241,2116,AIZAWL-DELHI,4357,All
2023,7,AIZAWL,DELHI,2084,1857,AIZAWL-DELHI,3941,All
2023,8,AIZAWL,DELHI,1964,1829,AIZAWL-DELHI,3793,All
2023,9,AIZAWL,DELHI,1962,1969,AIZAWL-DELHI,3931,All
2023,10,AIZAWL,DELHI,3251,3383,AIZAWL-DELHI,6634,All
2023,11,AIZAWL,DELHI,2925,3264,AIZAWL-DELHI,6189,All
2023,12,AIZAWL,DELHI,2878,3690,AIZAWL-DELHI,6568,All
2024,1,AIZAWL,DELHI,2884,3091,AIZAWL-DELHI,5975,All
2024,2,AIZAWL,DELHI,3121,3302,AIZAWL-DELHI,6423,All
2024,3,AIZAWL,DELHI,3323,3651,AIZAWL-DELHI,6974,All
2024,4,AIZAWL,DELHI,3047,3595,AIZAWL-DELHI,6642,All
2024,6,AIZAWL,DELHI,3302,3552,AIZAWL-DELHI,6854,All
2024,7,AIZAWL,DELHI,3465,3262,AIZAWL-DELHI,6727,All
2024,8,AIZAWL,DELHI,3118,3130,AIZAWL-DELHI,6248,All
2024,9,AIZAWL,DELHI,3108,3335,AIZAWL-DELHI,6443,All
2024,10,AIZAWL,DELHI,5134,5294,AIZAWL-DELHI,10428,All
2024,11,AIZAWL,DELHI,5371,6171,AIZAWL-DELHI,11542,All
2024,12,AIZAWL,DELHI,5008,7505,AIZAWL-DELHI,12513,All
2025,1,AIZAWL,DELHI,6702,4927,AIZAWL-DELHI,11629,All
2025,2,AIZAWL,DELHI,5422,4609,AIZAWL-DELHI,10031,All
2025,3,AIZAWL,DELHI,6722,7115,AIZAWL-DELHI,13837,All
2022,10,AIZAWL,DIMAPUR,0,3,AIZAWL-DIMAPUR,3,All
2022,11,AIZAWL,DIMAPUR,4,25,AIZAWL-DIMAPUR,29,All
2022,12,AIZAWL,DIMAPUR,0,108,AIZAWL-DIMAPUR,108,All
2023,2,AIZAWL,DIMAPUR,0,64,AIZAWL-DIMAPUR,64,All
2023,3,AIZAWL,DIMAPUR,0,69,AIZAWL-DIMAPUR,69,All
2024,7,AIZAWL,DIMAPUR,0,3,AIZAWL-DIMAPUR,3,All
2015,4,AIZAWL,GUWAHATI,1601,1481,AIZAWL-GUWAHATI,3082,All
2015,5,AIZAWL,GUWAHATI,1531,1586,AIZAWL-GUWAHATI,3117,All
2015,6,AIZAWL,GUWAHATI,1582,1530,AIZAWL-GUWAHATI,3112,All
2015,7,AIZAWL,GUWAHATI,1647,1410,AIZAWL-GUWAHATI,3057,All
2015,8,AIZAWL,GUWAHATI,1888,1666,AIZAWL-GUWAHATI,3554,All
2015,9,AIZAWL,GUWAHATI,1857,1703,AIZAWL-GUWAHATI,3560,All
2015,10,AIZAWL,GUWAHATI,1610,1479,AIZAWL-GUWAHATI,3089,All
2015,12,AIZAWL,GUWAHATI,1425,1489,AIZAWL-GUWAHATI,2914,All
2016,1,AIZAWL,GUWAHATI,1713,1395,AIZAWL-GUWAHATI,3108,All
2016,2,AIZAWL,GUWAHATI,1551,1554,AIZAWL-GUWAHATI,3105,All
2016,3,AIZAWL,GUWAHATI,1619,1524,AIZAWL-GUWAHATI,3143,All
2016,4,AIZAWL,GUWAHATI,1375,1546,AIZAWL-GUWAHATI,2921,All
2016,5,AIZAWL,GUWAHATI,1785,1822,AIZAWL-GUWAHATI,3607,All
2016,6,AIZAWL,GUWAHATI,1868,1868,AIZAWL-GUWAHATI,3736,All
2016,7,AIZAWL,GUWAHATI,2169,1862,AIZAWL-GUWAHATI,4031,All
2016,8,AIZAWL,GUWAHATI,2254,1823,AIZAWL-GUWAHATI,4077,All
2016,9,AIZAWL,GUWAHATI,2213,1743,AIZAWL-GUWAHATI,3956,All
2016,10,AIZAWL,GUWAHATI,3725,2959,AIZAWL-GUWAHATI,6684,All
2016,11,AIZAWL,GUWAHATI,4139,3899,AIZAWL-GUWAHATI,8038,All
2016,12,AIZAWL,GUWAHATI,4314,4373,AIZAWL-GUWAHATI,8687,All
2017,1,AIZAWL,GUWAHATI,4750,3309,AIZAWL-GUWAHATI,8059,All
2017,2,AIZAWL,GUWAHATI,3701,3297,AIZAWL-GUWAHATI,6998,All
2017,3,AIZAWL,GUWAHATI,4211,3710,AIZAWL-GUWAHATI,7921,All
2017,4,AIZAWL,GUWAHATI,3316,3375,AIZAWL-GUWAHATI,6691,All
2017,5,AIZAWL,GUWAHATI,4147,3577,AIZAWL-GUWAHATI,7724,All
2017,6,AIZAWL,GUWAHATI,4212,3888,AIZAWL-GUWAHATI,8100,All
2017,7,AIZAWL,GUWAHATI,4216,3604,AIZAWL-GUWAHATI,7820,All
2017,8,AIZAWL,GUWAHATI,5054,3789,AIZAWL-GUWAHATI,8843,All
2017,9,AIZAWL,GUWAHATI,4252,3804,AIZAWL-GUWAHATI,8056,All
2017,10,AIZAWL,GUWAHATI,3509,2945,AIZAWL-GUWAHATI,6454,All
2017,11,AIZAWL,GUWAHATI,3044,2936,AIZAWL-GUWAHATI,5980,All
2017,12,AIZAWL,GUWAHATI,2711,2550,AIZAWL-GUWAHATI,5261,All
2018,1,AIZAWL,GUWAHATI,3432,2936,AIZAWL-GUWAHATI,6368,All
2018,2,AIZAWL,GUWAHATI,2985,2587,AIZAWL-GUWAHATI,5572,All
2018,3,AIZAWL,GUWAHATI,3357,3233,AIZAWL-GUWAHATI,6590,All
2018,4,AIZAWL,GUWAHATI,3634,3153,AIZAWL-GUWAHATI,6787,All
2018,5,AIZAWL,GUWAHATI,3806,3247,AIZAWL-GUWAHATI,7053,All
2018,6,AIZAWL,GUWAHATI,3882,3134,AIZAWL-GUWAHATI,7016,All
2018,7,AIZAWL,GUWAHATI,4149,3060,AIZAWL-GUWAHATI,7209,All
2018,8,AIZAWL,GUWAHATI,3801,3110,AIZAWL-GUWAHATI,6911,All
2018,9,AIZAWL,GUWAHATI,3540,3375,AIZAWL-GUWAHATI,6915,All
2018,10,AIZAWL,GUWAHATI,3739,3552,AIZAWL-GUWAHATI,7291,All
2018,11,AIZAWL,GUWAHATI,3518,3364,AIZAWL-GUWAHATI,6882,All
2018,12,AIZAWL,GUWAHATI,3629,3548,AIZAWL-GUWAHATI,7177,All
2019,1,AIZAWL,GUWAHATI,3804,3537,AIZAWL-GUWAHATI,7341,All
2019,2,AIZAWL,GUWAHATI,1210,1113,AIZAWL-GUWAHATI,2323,All
2019,10,AIZAWL,GUWAHATI,2352,2191,AIZAWL-GUWAHATI,4543,All
2019,11,AIZAWL,GUWAHATI,4308,4187,AIZAWL-GUWAHATI,8495,All
2019,12,AIZAWL,GUWAHATI,3985,4335,AIZAWL-GUWAHATI,8320,All
2020,1,AIZAWL,GUWAHATI,5071,4685,AIZAWL-GUWAHATI,9756,All
2020,2,AIZAWL,GUWAHATI,4847,4773,AIZAWL-GUWAHATI,9620,All
2020,3,AIZAWL,GUWAHATI,3834,4361,AIZAWL-GUWAHATI,8195,All
2020,8,AIZAWL,GUWAHATI,389,432,AIZAWL-GUWAHATI,821,All
2020,9,AIZAWL,GUWAHATI,778,602,AIZAWL-GUWAHATI,1380,All
2020,10,AIZAWL,GUWAHATI,1263,1001,AIZAWL-GUWAHATI,2264,All
2020,11,AIZAWL,GUWAHATI,1260,1149,AIZAWL-GUWAHATI,2409,All
2020,12,AIZAWL,GUWAHATI,1017,1118,AIZAWL-GUWAHATI,2135,All
2021,1,AIZAWL,GUWAHATI,1293,1384,AIZAWL-GUWAHATI,2677,All
2021,2,AIZAWL,GUWAHATI,1578,1561,AIZAWL-GUWAHATI,3139,All
2021,3,AIZAWL,GUWAHATI,2091,1972,AIZAWL-GUWAHATI,4063,All
2021,4,AIZAWL,GUWAHATI,1088,1033,AIZAWL-GUWAHATI,2121,All
2021,6,AIZAWL,GUWAHATI,540,556,AIZAWL-GUWAHATI,1096,All
2021,7,AIZAWL,GUWAHATI,771,540,AIZAWL-GUWAHATI,1311,All
2021,8,AIZAWL,GUWAHATI,1355,1024,AIZAWL-GUWAHATI,2379,All
2021,9,AIZAWL,GUWAHATI,1503,1299,AIZAWL-GUWAHATI,2802,All
2021,10,AIZAWL,GUWAHATI,1922,1491,AIZAWL-GUWAHATI,3413,All
2021,11,AIZAWL,GUWAHATI,3802,4121,AIZAWL-GUWAHATI,7923,All
2021,12,AIZAWL,GUWAHATI,3905,6056,AIZAWL-GUWAHATI,9961,All
2022,1,AIZAWL,GUWAHATI,2779,2155,AIZAWL-GUWAHATI,4934,All
2022,2,AIZAWL,GUWAHATI,2543,1582,AIZAWL-GUWAHATI,4125,All
2022,3,AIZAWL,GUWAHATI,3707,3198,AIZAWL-GUWAHATI,6905,All
2022,4,AIZAWL,GUWAHATI,4155,3399,AIZAWL-GUWAHATI,7554,All
2022,5,AIZAWL,GUWAHATI,3784,3439,AIZAWL-GUWAHATI,7223,All
2022,6,AIZAWL,GUWAHATI,4482,4038,AIZAWL-GUWAHATI,8520,All
2022,7,AIZAWL,GUWAHATI,4029,3433,AIZAWL-GUWAHATI,7462,All
2022,8,AIZAWL,GUWAHATI,4353,3787,AIZAWL-GUWAHATI,8140,All
2022,9,AIZAWL,GUWAHATI,4312,3784,AIZAWL-GUWAHATI,8096,All
2022,10,AIZAWL,GUWAHATI,4841,3881,AIZAWL-GUWAHATI,8722,All
2022,11,AIZAWL,GUWAHATI,5784,5605,AIZAWL-GUWAHATI,11389,All
2022,12,AIZAWL,GUWAHATI,5445,5186,AIZAWL-GUWAHATI,10631,All
2023,1,AIZAWL,GUWAHATI,5907,4636,AIZAWL-GUWAHATI,10543,All
2023,2,AIZAWL,GUWAHATI,5249,4390,AIZAWL-GUWAHATI,9639,All
2023,3,AIZAWL,GUWAHATI,6036,5862,AIZAWL-GUWAHATI,11898,All
2023,4,AIZAWL,GUWAHATI,5658,5194,AIZAWL-GUWAHATI,10852,All
2023,5,AIZAWL,GUWAHATI,6471,6256,AIZAWL-GUWAHATI,12727,All
2023,6,AIZAWL,GUWAHATI,5933,5874,AIZAWL-GUWAHATI,11807,All
2023,7,AIZAWL,GUWAHATI,6232,6215,AIZAWL-GUWAHATI,12447,All
2023,8,AIZAWL,GUWAHATI,6080,6221,AIZAWL-GUWAHATI,12301,All
2023,9,AIZAWL,GUWAHATI,6126,5923,AIZAWL-GUWAHATI,12049,All
2023,10,AIZAWL,GUWAHATI,5939,6362,AIZAWL-GUWAHATI,12301,All
2023,11,AIZAWL,GUWAHATI,6265,6216,AIZAWL-GUWAHATI,12481,All
2023,12,AIZAWL,GUWAHATI,5687,6162,AIZAWL-GUWAHATI,11849,All
2024,1,AIZAWL,GUWAHATI,6352,5493,AIZAWL-GUWAHATI,11845,All
2024,2,AIZAWL,GUWAHATI,5686,5664,AIZAWL-GUWAHATI,11350,All
2024,3,AIZAWL,GUWAHATI,6331,6125,AIZAWL-GUWAHATI,12456,All
2024,4,AIZAWL,GUWAHATI,7595,7023,AIZAWL-GUWAHATI,14618,All
2024,6,AIZAWL,GUWAHATI,8247,8906,AIZAWL-GUWAHATI,17153,All
2024,7,AIZAWL,GUWAHATI,8850,9570,AIZAWL-GUWAHATI,18420,All
2024,8,AIZAWL,GUWAHATI,6432,6521,AIZAWL-GUWAHATI,12953,All
2024,9,AIZAWL,GUWAHATI,5777,6082,AIZAWL-GUWAHATI,11859,All
2024,10,AIZAWL,GUWAHATI,6266,6374,AIZAWL-GUWAHATI,12640,All
2024,11,AIZAWL,GUWAHATI,6011,6191,AIZAWL-GUWAHATI,12202,All
2024,12,AIZAWL,GUWAHATI,5763,6154,AIZAWL-GUWAHATI,11917,All
2025,1,AIZAWL,GUWAHATI,6030,5922,AIZAWL-GUWAHATI,11952,All
2025,2,AIZAWL,GUWAHATI,5591,5417,AIZAWL-GUWAHATI,11008,All
2025,3,AIZAWL,GUWAHATI,6291,6328,AIZAWL-GUWAHATI,12619,All
2015,4,AIZAWL,IMPHAL,380,366,AIZAWL-IMPHAL,746,All
2015,5,AIZAWL,IMPHAL,403,403,AIZAWL-IMPHAL,806,All
2015,6,AIZAWL,IMPHAL,319,418,AIZAWL-IMPHAL,737,All
2015,7,AIZAWL,IMPHAL,401,382,AIZAWL-IMPHAL,783,All
2015,8,AIZAWL,IMPHAL,353,393,AIZAWL-IMPHAL,746,All
2015,9,AIZAWL,IMPHAL,339,342,AIZAWL-IMPHAL,681,All
2015,10,AIZAWL,IMPHAL,8880,441,AIZAWL-IMPHAL,9321,All
2015,11,AIZAWL,IMPHAL,423,427,AIZAWL-IMPHAL,850,All
2015,12,AIZAWL,IMPHAL,499,428,AIZAWL-IMPHAL,927,All
2016,1,AIZAWL,IMPHAL,369,560,AIZAWL-IMPHAL,929,All
2016,2,AIZAWL,IMPHAL,371,445,AIZAWL-IMPHAL,816,All
2016,3,AIZAWL,IMPHAL,477,467,AIZAWL-IMPHAL,944,All
2016,4,AIZAWL,IMPHAL,444,510,AIZAWL-IMPHAL,954,All
2016,5,AIZAWL,IMPHAL,392,428,AIZAWL-IMPHAL,820,All
2016,6,AIZAWL,IMPHAL,462,523,AIZAWL-IMPHAL,985,All
2016,7,AIZAWL,IMPHAL,490,476,AIZAWL-IMPHAL,966,All
2016,8,AIZAWL,IMPHAL,450,484,AIZAWL-IMPHAL,934,All
2016,9,AIZAWL,IMPHAL,431,449,AIZAWL-IMPHAL,880,All
2016,10,AIZAWL,IMPHAL,534,591,AIZAWL-IMPHAL,1125,All
2016,11,AIZAWL,IMPHAL,272,0,AIZAWL-IMPHAL,272,All
2016,12,AIZAWL,IMPHAL,520,0,AIZAWL-IMPHAL,520,All
2017,1,AIZAWL,IMPHAL,343,147,AIZAWL-IMPHAL,490,All
2017,2,AIZAWL,IMPHAL,251,235,AIZAWL-IMPHAL,486,All
2017,3,AIZAWL,IMPHAL,279,291,AIZAWL-IMPHAL,570,All
2017,4,AIZAWL,IMPHAL,321,245,AIZAWL-IMPHAL,566,All
2017,5,AIZAWL,IMPHAL,188,230,AIZAWL-IMPHAL,418,All
2017,6,AIZAWL,IMPHAL,257,307,AIZAWL-IMPHAL,564,All
2017,7,AIZAWL,IMPHAL,337,266,AIZAWL-IMPHAL,603,All
2017,8,AIZAWL,IMPHAL,264,328,AIZAWL-IMPHAL,592,All
2017,9,AIZAWL,IMPHAL,245,260,AIZAWL-IMPHAL,505,All
2017,10,AIZAWL,IMPHAL,320,217,AIZAWL-IMPHAL,537,All
2017,11,AIZAWL,IMPHAL,220,231,AIZAWL-IMPHAL,451,All
2017,12,AIZAWL,IMPHAL,273,253,AIZAWL-IMPHAL,526,All
2018,1,AIZAWL,IMPHAL,199,260,AIZAWL-IMPHAL,459,All
2018,2,AIZAWL,IMPHAL,195,206,AIZAWL-IMPHAL,401,All
2018,3,AIZAWL,IMPHAL,184,222,AIZAWL-IMPHAL,406,All
2018,4,AIZAWL,IMPHAL,170,176,AIZAWL-IMPHAL,346,All
2018,5,AIZAWL,IMPHAL,116,131,AIZAWL-IMPHAL,247,All
2018,6,AIZAWL,IMPHAL,138,214,AIZAWL-IMPHAL,352,All
2018,7,AIZAWL,IMPHAL,192,161,AIZAWL-IMPHAL,353,All
2018,8,AIZAWL,IMPHAL,112,247,AIZAWL-IMPHAL,359,All
2018,9,AIZAWL,IMPHAL,181,166,AIZAWL-IMPHAL,347,All
2018,10,AIZAWL,IMPHAL,125,134,AIZAWL-IMPHAL,259,All
2018,11,AIZAWL,IMPHAL,149,178,AIZAWL-IMPHAL,327,All
2018,12,AIZAWL,IMPHAL,241,172,AIZAWL-IMPHAL,413,All
2019,1,AIZAWL,IMPHAL,193,242,AIZAWL-IMPHAL,435,All
2019,2,AIZAWL,IMPHAL,162,188,AIZAWL-IMPHAL,350,All
2019,3,AIZAWL,IMPHAL,178,175,AIZAWL-IMPHAL,353,All
2019,4,AIZAWL,IMPHAL,490,578,AIZAWL-IMPHAL,1068,All
2019,5,AIZAWL,IMPHAL,590,752,AIZAWL-IMPHAL,1342,All
2019,6,AIZAWL,IMPHAL,517,695,AIZAWL-IMPHAL,1212,All
2019,7,AIZAWL,IMPHAL,775,814,AIZAWL-IMPHAL,1589,All
2019,8,AIZAWL,IMPHAL,690,876,AIZAWL-IMPHAL,1566,All
2019,9,AIZAWL,IMPHAL,592,747,AIZAWL-IMPHAL,1339,All
2019,10,AIZAWL,IMPHAL,780,774,AIZAWL-IMPHAL,1554,All
2019,11,AIZAWL,IMPHAL,586,594,AIZAWL-IMPHAL,1180,All
2019,12,AIZAWL,IMPHAL,1075,696,AIZAWL-IMPHAL,1771,All
2020,1,AIZAWL,IMPHAL,698,1029,AIZAWL-IMPHAL,1727,All
2020,2,AIZAWL,IMPHAL,654,551,AIZAWL-IMPHAL,1205,All
2020,3,AIZAWL,IMPHAL,557,458,AIZAWL-IMPHAL,1015,All
2020,6,AIZAWL,IMPHAL,28,7,AIZAWL-IMPHAL,35,All
2020,7,AIZAWL,IMPHAL,138,226,AIZAWL-IMPHAL,364,All
2020,8,AIZAWL,IMPHAL,57,201,AIZAWL-IMPHAL,258,All
2020,9,AIZAWL,IMPHAL,120,108,AIZAWL-IMPHAL,228,All
2020,10,AIZAWL,IMPHAL,197,245,AIZAWL-IMPHAL,442,All
2020,11,AIZAWL,IMPHAL,270,253,AIZAWL-IMPHAL,523,All
2020,12,AIZAWL,IMPHAL,383,335,AIZAWL-IMPHAL,718,All
2021,1,AIZAWL,IMPHAL,253,299,AIZAWL-IMPHAL,552,All
2021,2,AIZAWL,IMPHAL,357,515,AIZAWL-IMPHAL,872,All
2021,3,AIZAWL,IMPHAL,545,635,AIZAWL-IMPHAL,1180,All
2021,4,AIZAWL,IMPHAL,312,344,AIZAWL-IMPHAL,656,All
2021,6,AIZAWL,IMPHAL,94,112,AIZAWL-IMPHAL,206,All
2021,7,AIZAWL,IMPHAL,230,177,AIZAWL-IMPHAL,407,All
2021,8,AIZAWL,IMPHAL,227,200,AIZAWL-IMPHAL,427,All
2021,9,AIZAWL,IMPHAL,326,337,AIZAWL-IMPHAL,663,All
2021,10,AIZAWL,IMPHAL,330,339,AIZAWL-IMPHAL,669,All
2021,11,AIZAWL,IMPHAL,525,521,AIZAWL-IMPHAL,1046,All
2021,12,AIZAWL,IMPHAL,853,633,AIZAWL-IMPHAL,1486,All
2022,1,AIZAWL,IMPHAL,449,630,AIZAWL-IMPHAL,1079,All
2022,2,AIZAWL,IMPHAL,410,395,AIZAWL-IMPHAL,805,All
2022,3,AIZAWL,IMPHAL,504,504,AIZAWL-IMPHAL,1008,All
2022,4,AIZAWL,IMPHAL,427,450,AIZAWL-IMPHAL,877,All
2022,5,AIZAWL,IMPHAL,597,595,AIZAWL-IMPHAL,1192,All
2022,6,AIZAWL,IMPHAL,627,724,AIZAWL-IMPHAL,1351,All
2022,7,AIZAWL,IMPHAL,775,663,AIZAWL-IMPHAL,1438,All
2022,8,AIZAWL,IMPHAL,348,416,AIZAWL-IMPHAL,764,All
2022,10,AIZAWL,IMPHAL,54,85,AIZAWL-IMPHAL,139,All
2022,11,AIZAWL,IMPHAL,838,827,AIZAWL-IMPHAL,1665,All
2022,12,AIZAWL,IMPHAL,982,833,AIZAWL-IMPHAL,1815,All
2023,1,AIZAWL,IMPHAL,950,994,AIZAWL-IMPHAL,1944,All
2023,2,AIZAWL,IMPHAL,713,693,AIZAWL-IMPHAL,1406,All
2023,3,AIZAWL,IMPHAL,1034,867,AIZAWL-IMPHAL,1901,All
2023,4,AIZAWL,IMPHAL,930,1063,AIZAWL-IMPHAL,1993,All
2023,5,AIZAWL,IMPHAL,478,868,AIZAWL-IMPHAL,1346,All
2023,6,AIZAWL,IMPHAL,498,584,AIZAWL-IMPHAL,1082,All
2023,7,AIZAWL,IMPHAL,620,552,AIZAWL-IMPHAL,1172,All
2023,8,AIZAWL,IMPHAL,443,530,AIZAWL-IMPHAL,973,All
2023,9,AIZAWL,IMPHAL,490,405,AIZAWL-IMPHAL,895,All
2023,10,AIZAWL,IMPHAL,370,442,AIZAWL-IMPHAL,812,All
2023,11,AIZAWL,IMPHAL,621,617,AIZAWL-IMPHAL,1238,All
2023,12,AIZAWL,IMPHAL,912,1157,AIZAWL-IMPHAL,2069,All
2024,1,AIZAWL,IMPHAL,1066,914,AIZAWL-IMPHAL,1980,All
2024,2,AIZAWL,IMPHAL,710,584,AIZAWL-IMPHAL,1294,All
2024,3,AIZAWL,IMPHAL,906,738,AIZAWL-IMPHAL,1644,All
2024,4,AIZAWL,IMPHAL,642,831,AIZAWL-IMPHAL,1473,All
2024,6,AIZAWL,IMPHAL,871,760,AIZAWL-IMPHAL,1631,All
2024,7,AIZAWL,IMPHAL,733,811,AIZAWL-IMPHAL,1544,All
2024,8,AIZAWL,IMPHAL,478,520,AIZAWL-IMPHAL,998,All
2024,9,AIZAWL,IMPHAL,478,471,AIZAWL-IMPHAL,949,All
2024,10,AIZAWL,IMPHAL,182,218,AIZAWL-IMPHAL,400,All
2024,11,AIZAWL,IMPHAL,233,316,AIZAWL-IMPHAL,549,All
2024,12,AIZAWL,IMPHAL,475,496,AIZAWL-IMPHAL,971,All
2025,1,AIZAWL,IMPHAL,403,461,AIZAWL-IMPHAL,864,All
2025,2,AIZAWL,IMPHAL,351,335,AIZAWL-IMPHAL,686,All
2025,3,AIZAWL,IMPHAL,295,255,AIZAWL-IMPHAL,550,All
2015,4,AIZAWL,KOLKATA,3709,4063,AIZAWL-KOLKATA,7772,All
2015,5,AIZAWL,KOLKATA,3972,4606,AIZAWL-KOLKATA,8578,All
2015,6,AIZAWL,KOLKATA,4391,4192,AIZAWL-KOLKATA,8583,All
2015,7,AIZAWL,KOLKATA,4505,4129,AIZAWL-KOLKATA,8634,All
2015,8,AIZAWL,KOLKATA,4359,3829,AIZAWL-KOLKATA,8188,All
2015,9,AIZAWL,KOLKATA,3930,4021,AIZAWL-KOLKATA,7951,All
2015,10,AIZAWL,KOLKATA,5962,2433,AIZAWL-KOLKATA,8395,All
2015,11,AIZAWL,KOLKATA,2550,2490,AIZAWL-KOLKATA,5040,All
2015,12,AIZAWL,KOLKATA,3798,4777,AIZAWL-KOLKATA,8575,All
2016,1,AIZAWL,KOLKATA,4818,3974,AIZAWL-KOLKATA,8792,All
2016,2,AIZAWL,KOLKATA,4222,4180,AIZAWL-KOLKATA,8402,All
2016,3,AIZAWL,KOLKATA,4330,4429,AIZAWL-KOLKATA,8759,All
2016,4,AIZAWL,KOLKATA,3476,4099,AIZAWL-KOLKATA,7575,All
2016,5,AIZAWL,KOLKATA,3790,4145,AIZAWL-KOLKATA,7935,All
2016,6,AIZAWL,KOLKATA,4049,3847,AIZAWL-KOLKATA,7896,All
2016,7,AIZAWL,KOLKATA,4230,3864,AIZAWL-KOLKATA,8094,All
2016,8,AIZAWL,KOLKATA,4176,3826,AIZAWL-KOLKATA,8002,All
2016,9,AIZAWL,KOLKATA,3675,3710,AIZAWL-KOLKATA,7385,All
2016,10,AIZAWL,KOLKATA,5385,4679,AIZAWL-KOLKATA,10064,All
2016,11,AIZAWL,KOLKATA,6020,5991,AIZAWL-KOLKATA,12011,All
2016,12,AIZAWL,KOLKATA,5634,7038,AIZAWL-KOLKATA,12672,All
2017,1,AIZAWL,KOLKATA,6774,5320,AIZAWL-KOLKATA,12094,All
2017,2,AIZAWL,KOLKATA,5127,5240,AIZAWL-KOLKATA,10367,All
2017,3,AIZAWL,KOLKATA,5550,5717,AIZAWL-KOLKATA,11267,All
2017,4,AIZAWL,KOLKATA,5253,5421,AIZAWL-KOLKATA,10674,All
2017,5,AIZAWL,KOLKATA,5735,6724,AIZAWL-KOLKATA,12459,All
2017,6,AIZAWL,KOLKATA,6848,5658,AIZAWL-KOLKATA,12506,All
2017,7,AIZAWL,KOLKATA,7301,6128,AIZAWL-KOLKATA,13429,All
2017,8,AIZAWL,KOLKATA,6770,6844,AIZAWL-KOLKATA,13614,All
2017,9,AIZAWL,KOLKATA,6591,6545,AIZAWL-KOLKATA,13136,All
2017,10,AIZAWL,KOLKATA,6304,6034,AIZAWL-KOLKATA,12338,All
2017,11,AIZAWL,KOLKATA,6599,6354,AIZAWL-KOLKATA,12953,All
2017,12,AIZAWL,KOLKATA,5899,6913,AIZAWL-KOLKATA,12812,All
2018,1,AIZAWL,KOLKATA,7437,6391,AIZAWL-KOLKATA,13828,All
2018,2,AIZAWL,KOLKATA,6575,5865,AIZAWL-KOLKATA,12440,All
2018,3,AIZAWL,KOLKATA,6326,6479,AIZAWL-KOLKATA,12805,All
2018,4,AIZAWL,KOLKATA,4059,4022,AIZAWL-KOLKATA,8081,All
2018,5,AIZAWL,KOLKATA,3931,4004,AIZAWL-KOLKATA,7935,All
2018,6,AIZAWL,KOLKATA,4045,3741,AIZAWL-KOLKATA,7786,All
2018,7,AIZAWL,KOLKATA,4050,3744,AIZAWL-KOLKATA,7794,All
2018,8,AIZAWL,KOLKATA,4114,3762,AIZAWL-KOLKATA,7876,All
2018,9,AIZAWL,KOLKATA,3563,3434,AIZAWL-KOLKATA,6997,All
2018,10,AIZAWL,KOLKATA,3907,3808,AIZAWL-KOLKATA,7715,All
2018,11,AIZAWL,KOLKATA,3642,3756,AIZAWL-KOLKATA,7398,All
2018,12,AIZAWL,KOLKATA,3622,4040,AIZAWL-KOLKATA,7662,All
2019,1,AIZAWL,KOLKATA,4284,3640,AIZAWL-KOLKATA,7924,All
2019,2,AIZAWL,KOLKATA,3464,3420,AIZAWL-KOLKATA,6884,All
2019,3,AIZAWL,KOLKATA,3541,3635,AIZAWL-KOLKATA,7176,All
2019,4,AIZAWL,KOLKATA,4084,4241,AIZAWL-KOLKATA,8325,All
2019,5,AIZAWL,KOLKATA,4716,4801,AIZAWL-KOLKATA,9517,All
2019,6,AIZAWL,KOLKATA,4664,4473,AIZAWL-KOLKATA,9137,All
2019,7,AIZAWL,KOLKATA,4777,4694,AIZAWL-KOLKATA,9471,All
2019,8,AIZAWL,KOLKATA,4535,4197,AIZAWL-KOLKATA,8732,All
2019,9,AIZAWL,KOLKATA,4131,4141,AIZAWL-KOLKATA,8272,All
2019,10,AIZAWL,KOLKATA,4285,4410,AIZAWL-KOLKATA,8695,All
2019,11,AIZAWL,KOLKATA,6651,7351,AIZAWL-KOLKATA,14002,All
2019,12,AIZAWL,KOLKATA,7051,8956,AIZAWL-KOLKATA,16007,All
2020,1,AIZAWL,KOLKATA,7905,6992,AIZAWL-KOLKATA,14897,All
2020,2,AIZAWL,KOLKATA,6967,6690,AIZAWL-KOLKATA,13657,All
2020,3,AIZAWL,KOLKATA,3884,5248,AIZAWL-KOLKATA,9132,All
2020,6,AIZAWL,KOLKATA,1077,1186,AIZAWL-KOLKATA,2263,All
2020,7,AIZAWL,KOLKATA,1335,1371,AIZAWL-KOLKATA,2706,All
2020,8,AIZAWL,KOLKATA,849,622,AIZAWL-KOLKATA,1471,All
2020,9,AIZAWL,KOLKATA,1378,1257,AIZAWL-KOLKATA,2635,All
2020,10,AIZAWL,KOLKATA,2189,1545,AIZAWL-KOLKATA,3734,All
2020,11,AIZAWL,KOLKATA,2237,1771,AIZAWL-KOLKATA,4008,All
2020,12,AIZAWL,KOLKATA,2358,2338,AIZAWL-KOLKATA,4696,All
2021,1,AIZAWL,KOLKATA,2520,1771,AIZAWL-KOLKATA,4291,All
2021,2,AIZAWL,KOLKATA,3075,2422,AIZAWL-KOLKATA,5497,All
2021,3,AIZAWL,KOLKATA,3736,3158,AIZAWL-KOLKATA,6894,All
2021,4,AIZAWL,KOLKATA,2641,2730,AIZAWL-KOLKATA,5371,All
2021,6,AIZAWL,KOLKATA,873,1227,AIZAWL-KOLKATA,2100,All
2021,7,AIZAWL,KOLKATA,1399,1442,AIZAWL-KOLKATA,2841,All
2021,8,AIZAWL,KOLKATA,2204,1979,AIZAWL-KOLKATA,4183,All
2021,9,AIZAWL,KOLKATA,2606,2412,AIZAWL-KOLKATA,5018,All
2021,10,AIZAWL,KOLKATA,2772,2518,AIZAWL-KOLKATA,5290,All
2021,11,AIZAWL,KOLKATA,4710,3611,AIZAWL-KOLKATA,8321,All
2021,12,AIZAWL,KOLKATA,5370,3939,AIZAWL-KOLKATA,9309,All
2022,1,AIZAWL,KOLKATA,3563,3416,AIZAWL-KOLKATA,6979,All
2022,2,AIZAWL,KOLKATA,3897,3016,AIZAWL-KOLKATA,6913,All
2022,3,AIZAWL,KOLKATA,5997,4999,AIZAWL-KOLKATA,10996,All
2022,4,AIZAWL,KOLKATA,6016,5958,AIZAWL-KOLKATA,11974,All
2022,5,AIZAWL,KOLKATA,5318,5629,AIZAWL-KOLKATA,10947,All
2022,6,AIZAWL,KOLKATA,6264,5658,AIZAWL-KOLKATA,11922,All
2022,7,AIZAWL,KOLKATA,5858,4916,AIZAWL-KOLKATA,10774,All
2022,8,AIZAWL,KOLKATA,5040,5212,AIZAWL-KOLKATA,10252,All
2022,9,AIZAWL,KOLKATA,5866,5495,AIZAWL-KOLKATA,11361,All
2022,10,AIZAWL,KOLKATA,5720,5619,AIZAWL-KOLKATA,11339,All
2022,11,AIZAWL,KOLKATA,6571,6517,AIZAWL-KOLKATA,13088,All
2022,12,AIZAWL,KOLKATA,6542,7696,AIZAWL-KOLKATA,14238,All
2023,1,AIZAWL,KOLKATA,6776,6384,AIZAWL-KOLKATA,13160,All
2023,2,AIZAWL,KOLKATA,5800,5352,AIZAWL-KOLKATA,11152,All
2023,3,AIZAWL,KOLKATA,6536,6300,AIZAWL-KOLKATA,12836,All
2023,4,AIZAWL,KOLKATA,5344,5149,AIZAWL-KOLKATA,10493,All
2023,5,AIZAWL,KOLKATA,5884,5561,AIZAWL-KOLKATA,11445,All
2023,6,AIZAWL,KOLKATA,5758,4699,AIZAWL-KOLKATA,10457,All
2023,7,AIZAWL,KOLKATA,6056,5359,AIZAWL-KOLKATA,11415,All
2023,8,AIZAWL,KOLKATA,6577,5940,AIZAWL-KOLKATA,12517,All
2023,9,AIZAWL,KOLKATA,6366,5883,AIZAWL-KOLKATA,12249,All
2023,10,AIZAWL,KOLKATA,6303,5715,AIZAWL-KOLKATA,12018,All
2023,11,AIZAWL,KOLKATA,5690,5212,AIZAWL-KOLKATA,10902,All
2023,12,AIZAWL,KOLKATA,5707,6025,AIZAWL-KOLKATA,11732,All
2024,1,AIZAWL,KOLKATA,6456,5627,AIZAWL-KOLKATA,12083,All
2024,2,AIZAWL,KOLKATA,5204,4649,AIZAWL-KOLKATA,9853,All
2024,3,AIZAWL,KOLKATA,7434,7116,AIZAWL-KOLKATA,14550,All
2024,4,AIZAWL,KOLKATA,7461,8045,AIZAWL-KOLKATA,15506,All
2024,6,AIZAWL,KOLKATA,9081,6683,AIZAWL-KOLKATA,15764,All
2024,7,AIZAWL,KOLKATA,9590,6799,AIZAWL-KOLKATA,16389,All
2024,8,AIZAWL,KOLKATA,8087,6854,AIZAWL-KOLKATA,14941,All
2024,9,AIZAWL,KOLKATA,8266,6755,AIZAWL-KOLKATA,15021,All
2024,10,AIZAWL,KOLKATA,8298,6873,AIZAWL-KOLKATA,15171,All
2024,11,AIZAWL,KOLKATA,7372,7279,AIZAWL-KOLKATA,14651,All
2024,12,AIZAWL,KOLKATA,8438,10088,AIZAWL-KOLKATA,18526,All
2025,1,AIZAWL,KOLKATA,10119,7641,AIZAWL-KOLKATA,17760,All
2025,2,AIZAWL,KOLKATA,4904,4832,AIZAWL-KOLKATA,9736,All
2025,3,AIZAWL,KOLKATA,6044,5597,AIZAWL-KOLKATA,11641,All
2017,5,AIZAWL,MUMBAI,247,301,AIZAWL-MUMBAI,548,All
2017,6,AIZAWL,MUMBAI,282,150,AIZAWL-MUMBAI,432,All
2017,7,AIZAWL,MUMBAI,251,198,AIZAWL-MUMBAI,449,All
2017,8,AIZAWL,MUMBAI,281,216,AIZAWL-MUMBAI,497,All
2017,9,AIZAWL,MUMBAI,203,178,AIZAWL-MUMBAI,381,All
2017,10,AIZAWL,MUMBAI,174,248,AIZAWL-MUMBAI,422,All
2017,11,AIZAWL,MUMBAI,219,146,AIZAWL-MUMBAI,365,All
2017,12,AIZAWL,MUMBAI,254,434,AIZAWL-MUMBAI,688,All
2018,1,AIZAWL,MUMBAI,415,227,AIZAWL-MUMBAI,642,All
2018,2,AIZAWL,MUMBAI,205,177,AIZAWL-MUMBAI,382,All
2018,3,AIZAWL,MUMBAI,203,217,AIZAWL-MUMBAI,420,All
2021,11,AIZAWL,MUMBAI,66,53,AIZAWL-MUMBAI,119,All
2021,12,AIZAWL,MUMBAI,74,119,AIZAWL-MUMBAI,193,All
2022,1,AIZAWL,MUMBAI,108,63,AIZAWL-MUMBAI,171,All
2022,2,AIZAWL,MUMBAI,81,56,AIZAWL-MUMBAI,137,All
2022,3,AIZAWL,MUMBAI,41,19,AIZAWL-MUMBAI,60,All
2022,4,AIZAWL,MUMBAI,51,34,AIZAWL-MUMBAI,85,All
2022,5,AIZAWL,MUMBAI,80,40,AIZAWL-MUMBAI,120,All
2022,6,AIZAWL,MUMBAI,73,70,AIZAWL-MUMBAI,143,All
2022,7,AIZAWL,MUMBAI,89,75,AIZAWL-MUMBAI,164,All
2022,8,AIZAWL,MUMBAI,242,147,AIZAWL-MUMBAI,389,All
2022,9,AIZAWL,MUMBAI,219,131,AIZAWL-MUMBAI,350,All
2022,10,AIZAWL,MUMBAI,235,233,AIZAWL-MUMBAI,468,All
2022,11,AIZAWL,MUMBAI,251,305,AIZAWL-MUMBAI,556,All
2022,12,AIZAWL,MUMBAI,291,451,AIZAWL-MUMBAI,742,All
2023,1,AIZAWL,MUMBAI,450,259,AIZAWL-MUMBAI,709,All
2023,2,AIZAWL,MUMBAI,302,217,AIZAWL-MUMBAI,519,All
2023,3,AIZAWL,MUMBAI,297,206,AIZAWL-MUMBAI,503,All
2023,4,AIZAWL,MUMBAI,273,266,AIZAWL-MUMBAI,539,All
2023,5,AIZAWL,MUMBAI,238,192,AIZAWL-MUMBAI,430,All
2023,6,AIZAWL,MUMBAI,385,189,AIZAWL-MUMBAI,574,All
2023,7,AIZAWL,MUMBAI,246,124,AIZAWL-MUMBAI,370,All
2023,8,AIZAWL,MUMBAI,171,86,AIZAWL-MUMBAI,257,All
2023,9,AIZAWL,MUMBAI,139,104,AIZAWL-MUMBAI,243,All
2023,10,AIZAWL,MUMBAI,177,112,AIZAWL-MUMBAI,289,All
2024,3,AIZAWL,MUMBAI,0,2,AIZAWL-MUMBAI,2,All
2024,4,AIZAWL,MUMBAI,82,48,AIZAWL-MUMBAI,130,All
2018,9,AIZAWL,PUNE,31,0,AIZAWL-PUNE,31,All
2018,10,AIZAWL,PUNE,41,0,AIZAWL-PUNE,41,All
2018,11,AIZAWL,PUNE,32,0,AIZAWL-PUNE,32,All
2021,10,AIZAWL,SHILLONG,193,79,AIZAWL-SHILLONG,272,All
2021,11,AIZAWL,SHILLONG,479,396,AIZAWL-SHILLONG,875,All
2021,12,AIZAWL,SHILLONG,345,442,AIZAWL-SHILLONG,787,All
2022,1,AIZAWL,SHILLONG,209,176,AIZAWL-SHILLONG,385,All
2022,2,AIZAWL,SHILLONG,194,143,AIZAWL-SHILLONG,337,All
2022,3,AIZAWL,SHILLONG,555,365,AIZAWL-SHILLONG,920,All
2022,4,AIZAWL,SHILLONG,479,396,AIZAWL-SHILLONG,875,All
2022,5,AIZAWL,SHILLONG,345,442,AIZAWL-SHILLONG,787,All
2022,6,AIZAWL,SHILLONG,479,396,AIZAWL-SHILLONG,875,All
2022,7,AIZAWL,SHILLONG,194,143,AIZAWL-SHILLONG,337,All
2022,8,AIZAWL,SHILLONG,345,442,AIZAWL-SHILLONG,787,All
2022,9,AIZAWL,SHILLONG,479,396,AIZAWL-SHILLONG,875,All
2022,10,AIZAWL,SHILLONG,538,482,AIZAWL-SHILLONG,1020,All
2022,11,AIZAWL,SHILLONG,556,553,AIZAWL-SHILLONG,1109,All
2022,12,AIZAWL,SHILLONG,433,673,AIZAWL-SHILLONG,1106,All
2023,1,AIZAWL,SHILLONG,523,416,AIZAWL-SHILLONG,939,All
2023,2,AIZAWL,SHILLONG,487,372,AIZAWL-SHILLONG,859,All
2023,3,AIZAWL,SHILLONG,613,489,AIZAWL-SHILLONG,1102,All
2023,4,AIZAWL,SHILLONG,415,442,AIZAWL-SHILLONG,857,All
2023,5,AIZAWL,SHILLONG,776,744,AIZAWL-SHILLONG,1520,All
2023,6,AIZAWL,SHILLONG,951,667,AIZAWL-SHILLONG,1618,All
2023,7,AIZAWL,SHILLONG,985,569,AIZAWL-SHILLONG,1554,All
2023,8,AIZAWL,SHILLONG,726,618,AIZAWL-SHILLONG,1344,All
2023,9,AIZAWL,SHILLONG,649,557,AIZAWL-SHILLONG,1206,All
2023,10,AIZAWL,SHILLONG,583,599,AIZAWL-SHILLONG,1182,All
2023,11,AIZAWL,SHILLONG,812,819,AIZAWL-SHILLONG,1631,All
2023,12,AIZAWL,SHILLONG,567,953,AIZAWL-SHILLONG,1520,All
2024,1,AIZAWL,SHILLONG,953,638,AIZAWL-SHILLONG,1591,All
2024,2,AIZAWL,SHILLONG,797,486,AIZAWL-SHILLONG,1283,All
2024,3,AIZAWL,SHILLONG,911,838,AIZAWL-SHILLONG,1749,All
2024,4,AIZAWL,SHILLONG,508,547,AIZAWL-SHILLONG,1055,All
2024,6,AIZAWL,SHILLONG,247,352,AIZAWL-SHILLONG,599,All
2024,7,AIZAWL,SHILLONG,477,400,AIZAWL-SHILLONG,877,All
2024,8,AIZAWL,SHILLONG,697,763,AIZAWL-SHILLONG,1460,All
2024,9,AIZAWL,SHILLONG,747,703,AIZAWL-SHILLONG,1450,All
2024,10,AIZAWL,SHILLONG,819,812,AIZAWL-SHILLONG,1631,All
2024,11,AIZAWL,SHILLONG,739,777,AIZAWL-SHILLONG,1516,All
2024,12,AIZAWL,SHILLONG,654,938,AIZAWL-SHILLONG,1592,All
2025,1,AIZAWL,SHILLONG,700,471,AIZAWL-SHILLONG,1171,All
2025,2,AIZAWL,SHILLONG,550,339,AIZAWL-SHILLONG,889,All
2025,3,AIZAWL,SHILLONG,688,604,AIZAWL-SHILLONG,1292,All
2022,6,AIZAWL,SILCHAR,1,0,AIZAWL-SILCHAR,1,All
2023,6,AIZAWL,SILCHAR,8,0,AIZAWL-SILCHAR,8,All
2019,5,AJMER,DELHI,2009,1804,AJMER-DELHI,3813,All
2019,6,AJMER,DELHI,1929,2047,AJMER-DELHI,3976,All
2019,7,AJMER,DELHI,1677,1807,AJMER-DELHI,3484,All
2019,8,AJMER,DELHI,2009,2074,AJMER-DELHI,4083,All
2019,9,AJMER,DELHI,2001,1985,AJMER-DELHI,3986,All
2019,10,AJMER,DELHI,2287,2361,AJMER-DELHI,4648,All
2019,11,AJMER,DELHI,2169,2248,AJMER-DELHI,4417,All
2019,12,AJMER,DELHI,2169,2237,AJMER-DELHI,4406,All
2020,1,AJMER,DELHI,2031,2012,AJMER-DELHI,4043,All
2020,2,AJMER,DELHI,2259,2215,AJMER-DELHI,4474,All
2020,3,AJMER,DELHI,1499,1363,AJMER-DELHI,2862,All
2020,5,AJMER,DELHI,50,96,AJMER-DELHI,146,All
2020,6,AJMER,DELHI,369,920,AJMER-DELHI,1289,All
2020,7,AJMER,DELHI,1605,1884,AJMER-DELHI,3489,All
2020,8,AJMER,DELHI,1316,1010,AJMER-DELHI,2326,All
2020,9,AJMER,DELHI,1030,1007,AJMER-DELHI,2037,All
2020,10,AJMER,DELHI,1196,1249,AJMER-DELHI,2445,All
2020,11,AJMER,DELHI,1169,1361,AJMER-DELHI,2530,All
2020,12,AJMER,DELHI,1686,1479,AJMER-DELHI,3165,All
2021,1,AJMER,DELHI,1637,1647,AJMER-DELHI,3284,All
2021,2,AJMER,DELHI,1925,1990,AJMER-DELHI,3915,All
2021,3,AJMER,DELHI,2155,2129,AJMER-DELHI,4284,All
2021,4,AJMER,DELHI,1004,858,AJMER-DELHI,1862,All
2021,6,AJMER,DELHI,781,745,AJMER-DELHI,1526,All
2021,7,AJMER,DELHI,1351,1377,AJMER-DELHI,2728,All
2021,8,AJMER,DELHI,1683,1697,AJMER-DELHI,3380,All
2021,9,AJMER,DELHI,1736,1686,AJMER-DELHI,3422,All
2021,10,AJMER,DELHI,1841,1948,AJMER-DELHI,3789,All
2021,11,AJMER,DELHI,1729,1906,AJMER-DELHI,3635,All
2021,12,AJMER,DELHI,1913,1833,AJMER-DELHI,3746,All
2022,1,AJMER,DELHI,575,610,AJMER-DELHI,1185,All
2022,2,AJMER,DELHI,1491,1757,AJMER-DELHI,3248,All
2022,3,AJMER,DELHI,2014,1971,AJMER-DELHI,3985,All
2022,4,AJMER,DELHI,1780,1905,AJMER-DELHI,3685,All
2022,5,AJMER,DELHI,2114,2023,AJMER-DELHI,4137,All
2022,6,AJMER,DELHI,1868,2043,AJMER-DELHI,3911,All
2022,7,AJMER,DELHI,1429,1377,AJMER-DELHI,2806,All
2022,8,AJMER,DELHI,1520,1526,AJMER-DELHI,3046,All
2019,5,AJMER,HYDERABAD,2275,2145,AJMER-HYDERABAD,4420,All
2019,6,AJMER,HYDERABAD,2164,2328,AJMER-HYDERABAD,4492,All
2019,7,AJMER,HYDERABAD,1725,2143,AJMER-HYDERABAD,3868,All
2019,8,AJMER,HYDERABAD,1975,2481,AJMER-HYDERABAD,4456,All
2019,9,AJMER,HYDERABAD,1875,2412,AJMER-HYDERABAD,4287,All
2019,10,AJMER,HYDERABAD,2161,2583,AJMER-HYDERABAD,4744,All
2019,11,AJMER,HYDERABAD,2432,2494,AJMER-HYDERABAD,4926,All
2019,12,AJMER,HYDERABAD,2536,2558,AJMER-HYDERABAD,5094,All
2020,1,AJMER,HYDERABAD,2374,2638,AJMER-HYDERABAD,5012,All
2020,2,AJMER,HYDERABAD,2221,2405,AJMER-HYDERABAD,4626,All
2020,3,AJMER,HYDERABAD,1573,1759,AJMER-HYDERABAD,3332,All
2020,6,AJMER,HYDERABAD,1492,1462,AJMER-HYDERABAD,2954,All
2020,7,AJMER,HYDERABAD,1321,1427,AJMER-HYDERABAD,2748,All
2020,8,AJMER,HYDERABAD,1600,1626,AJMER-HYDERABAD,3226,All
2020,9,AJMER,HYDERABAD,1286,1365,AJMER-HYDERABAD,2651,All
2020,10,AJMER,HYDERABAD,1514,1582,AJMER-HYDERABAD,3096,All
2020,11,AJMER,HYDERABAD,1309,1414,AJMER-HYDERABAD,2723,All
2020,12,AJMER,HYDERABAD,1634,1646,AJMER-HYDERABAD,3280,All
2021,1,AJMER,HYDERABAD,1238,1502,AJMER-HYDERABAD,2740,All
2021,2,AJMER,HYDERABAD,2339,2421,AJMER-HYDERABAD,4760,All
2021,3,AJMER,HYDERABAD,2413,2648,AJMER-HYDERABAD,5061,All
2021,4,AJMER,HYDERABAD,1944,2404,AJMER-HYDERABAD,4348,All
2021,6,AJMER,HYDERABAD,2010,1858,AJMER-HYDERABAD,3868,All
2021,7,AJMER,HYDERABAD,2320,2352,AJMER-HYDERABAD,4672,All
2021,8,AJMER,HYDERABAD,2388,2387,AJMER-HYDERABAD,4775,All
2021,9,AJMER,HYDERABAD,2290,2328,AJMER-HYDERABAD,4618,All
2021,10,AJMER,HYDERABAD,2142,2401,AJMER-HYDERABAD,4543,All
2021,11,AJMER,HYDERABAD,2479,2699,AJMER-HYDERABAD,5178,All
2021,12,AJMER,HYDERABAD,2687,2704,AJMER-HYDERABAD,5391,All
2022,1,AJMER,HYDERABAD,2106,2472,AJMER-HYDERABAD,4578,All
2022,2,AJMER,HYDERABAD,2402,2512,AJMER-HYDERABAD,4914,All
2022,3,AJMER,HYDERABAD,2499,2624,AJMER-HYDERABAD,5123,All
2022,4,AJMER,HYDERABAD,2214,2318,AJMER-HYDERABAD,4532,All
2022,5,AJMER,HYDERABAD,2338,2410,AJMER-HYDERABAD,4748,All
2022,6,AJMER,HYDERABAD,2038,2161,AJMER-HYDERABAD,4199,All
2022,7,AJMER,HYDERABAD,867,1015,AJMER-HYDERABAD,1882,All
2022,8,AJMER,HYDERABAD,53,78,AJMER-HYDERABAD,131,All
2020,3,AJMER,INDORE,176,174,AJMER-INDORE,350,All
2020,6,AJMER,INDORE,345,325,AJMER-INDORE,670,All
2020,7,AJMER,INDORE,405,445,AJMER-INDORE,850,All
2020,8,AJMER,INDORE,477,444,AJMER-INDORE,921,All
2020,9,AJMER,INDORE,481,466,AJMER-INDORE,947,All
2020,10,AJMER,INDORE,439,453,AJMER-INDORE,892,All
2020,11,AJMER,INDORE,477,536,AJMER-INDORE,1013,All
2020,12,AJMER,INDORE,593,591,AJMER-INDORE,1184,All
2021,1,AJMER,INDORE,598,574,AJMER-INDORE,1172,All
2021,2,AJMER,INDORE,616,666,AJMER-INDORE,1282,All
2021,3,AJMER,INDORE,629,661,AJMER-INDORE,1290,All
2021,4,AJMER,INDORE,365,427,AJMER-INDORE,792,All
2021,6,AJMER,INDORE,559,466,AJMER-INDORE,1025,All
2021,7,AJMER,INDORE,748,758,AJMER-INDORE,1506,All
2021,8,AJMER,INDORE,793,805,AJMER-INDORE,1598,All
2021,9,AJMER,INDORE,586,641,AJMER-INDORE,1227,All
2021,10,AJMER,INDORE,547,549,AJMER-INDORE,1096,All
2021,11,AJMER,INDORE,553,633,AJMER-INDORE,1186,All
2021,12,AJMER,INDORE,653,659,AJMER-INDORE,1312,All
2022,1,AJMER,INDORE,411,402,AJMER-INDORE,813,All
2022,2,AJMER,INDORE,481,490,AJMER-INDORE,971,All
2022,3,AJMER,INDORE,557,556,AJMER-INDORE,1113,All
2022,4,AJMER,INDORE,430,447,AJMER-INDORE,877,All
2022,5,AJMER,INDORE,521,493,AJMER-INDORE,1014,All
2022,6,AJMER,INDORE,316,324,AJMER-INDORE,640,All
2022,7,AJMER,INDORE,294,334,AJMER-INDORE,628,All
2022,8,AJMER,INDORE,311,299,AJMER-INDORE,610,All
2022,9,AJMER,INDORE,194,220,AJMER-INDORE,414,All
2022,10,AJMER,INDORE,185,231,AJMER-INDORE,416,All
2022,11,AJMER,INDORE,173,182,AJMER-INDORE,355,All
2022,12,AJMER,INDORE,270,248,AJMER-INDORE,518,All
2023,2,AJMER,INDORE,267,271,AJMER-INDORE,538,All
2023,3,AJMER,INDORE,184,256,AJMER-INDORE,440,All
2021,10,AJMER,JABALPUR,8,0,AJMER-JABALPUR,8,All
2021,12,AJMER,JABALPUR,1,0,AJMER-JABALPUR,1,All
2022,1,AJMER,JABALPUR,4,0,AJMER-JABALPUR,4,All
2022,2,AJMER,JABALPUR,1,0,AJMER-JABALPUR,1,All
2022,3,AJMER,JABALPUR,5,0,AJMER-JABALPUR,5,All
2021,2,AJMER,MUMBAI,639,630,AJMER-MUMBAI,1269,All
2021,3,AJMER,MUMBAI,1370,1462,AJMER-MUMBAI,2832,All
2021,8,AJMER,MUMBAI,326,284,AJMER-MUMBAI,610,All
2021,9,AJMER,MUMBAI,836,890,AJMER-MUMBAI,1726,All
2021,10,AJMER,MUMBAI,957,1038,AJMER-MUMBAI,1995,All
2021,11,AJMER,MUMBAI,1769,1880,AJMER-MUMBAI,3649,All
2021,12,AJMER,MUMBAI,1925,1655,AJMER-MUMBAI,3580,All
2022,1,AJMER,MUMBAI,683,615,AJMER-MUMBAI,1298,All
2022,2,AJMER,MUMBAI,1371,1396,AJMER-MUMBAI,2767,All
2022,3,AJMER,MUMBAI,1651,1650,AJMER-MUMBAI,3301,All
2022,4,AJMER,MUMBAI,1711,1836,AJMER-MUMBAI,3547,All
2022,5,AJMER,MUMBAI,907,867,AJMER-MUMBAI,1774,All
2022,6,AJMER,MUMBAI,836,819,AJMER-MUMBAI,1655,All
2022,7,AJMER,MUMBAI,322,408,AJMER-MUMBAI,730,All
2022,8,AJMER,MUMBAI,190,181,AJMER-MUMBAI,371,All
2022,9,AJMER,MUMBAI,134,171,AJMER-MUMBAI,305,All
2020,12,AJMER,SURAT,199,200,AJMER-SURAT,399,All
2021,1,AJMER,SURAT,365,406,AJMER-SURAT,771,All
2021,2,AJMER,SURAT,468,502,AJMER-SURAT,970,All
2021,3,AJMER,SURAT,423,515,AJMER-SURAT,938,All
2021,4,AJMER,SURAT,279,366,AJMER-SURAT,645,All
2021,6,AJMER,SURAT,473,523,AJMER-SURAT,996,All
2021,7,AJMER,SURAT,539,540,AJMER-SURAT,1079,All
2021,8,AJMER,SURAT,515,538,AJMER-SURAT,1053,All
2021,9,AJMER,SURAT,432,493,AJMER-SURAT,925,All
2021,10,AJMER,SURAT,455,515,AJMER-SURAT,970,All
2021,11,AJMER,SURAT,477,526,AJMER-SURAT,1003,All
2021,12,AJMER,SURAT,486,477,AJMER-SURAT,963,All
2022,1,AJMER,SURAT,273,374,AJMER-SURAT,647,All
2022,2,AJMER,SURAT,470,496,AJMER-SURAT,966,All
2022,3,AJMER,SURAT,476,511,AJMER-SURAT,987,All
2022,4,AJMER,SURAT,427,514,AJMER-SURAT,941,All
2022,5,AJMER,SURAT,500,572,AJMER-SURAT,1072,All
2022,6,AJMER,SURAT,487,529,AJMER-SURAT,1016,All
2022,7,AJMER,SURAT,380,421,AJMER-SURAT,801,All
2022,8,AJMER,SURAT,322,402,AJMER-SURAT,724,All
2022,9,AJMER,SURAT,270,261,AJMER-SURAT,531,All
2022,10,AJMER,SURAT,242,345,AJMER-SURAT,587,All
2022,11,AJMER,SURAT,309,287,AJMER-SURAT,596,All
2022,12,AJMER,SURAT,353,337,AJMER-SURAT,690,All
2023,2,AJMER,SURAT,309,374,AJMER-SURAT,683,All
2023,3,AJMER,SURAT,467,504,AJMER-SURAT,971,All
2023,4,AJMER,SURAT,427,556,AJMER-SURAT,983,All
2023,5,AJMER,SURAT,690,720,AJMER-SURAT,1410,All
2019,5,ALLAHABAD,BENGALURU,4735,3821,ALLAHABAD-BENGALURU,8556,All
2019,6,ALLAHABAD,BENGALURU,4949,4570,ALLAHABAD-BENGALURU,9519,All
2019,7,ALLAHABAD,BENGALURU,3935,4122,ALLAHABAD-BENGALURU,8057,All
2019,8,ALLAHABAD,BENGALURU,4313,4439,ALLAHABAD-BENGALURU,8752,All
2019,9,ALLAHABAD,BENGALURU,3460,4348,ALLAHABAD-BENGALURU,7808,All
2019,10,ALLAHABAD,BENGALURU,3575,4624,ALLAHABAD-BENGALURU,8199,All
2019,11,ALLAHABAD,BENGALURU,4643,4521,ALLAHABAD-BENGALURU,9164,All
2019,12,ALLAHABAD,BENGALURU,4651,4321,ALLAHABAD-BENGALURU,8972,All
2020,1,ALLAHABAD,BENGALURU,4228,4819,ALLAHABAD-BENGALURU,9047,All
2020,2,ALLAHABAD,BENGALURU,4827,5030,ALLAHABAD-BENGALURU,9857,All
2020,3,ALLAHABAD,BENGALURU,3454,4018,ALLAHABAD-BENGALURU,7472,All
2020,5,ALLAHABAD,BENGALURU,262,751,ALLAHABAD-BENGALURU,1013,All
2020,6,ALLAHABAD,BENGALURU,2150,4233,ALLAHABAD-BENGALURU,6383,All
2020,7,ALLAHABAD,BENGALURU,3423,4474,ALLAHABAD-BENGALURU,7897,All
2020,8,ALLAHABAD,BENGALURU,4764,2685,ALLAHABAD-BENGALURU,7449,All
2020,9,ALLAHABAD,BENGALURU,5271,2643,ALLAHABAD-BENGALURU,7914,All
2020,10,ALLAHABAD,BENGALURU,4960,4351,ALLAHABAD-BENGALURU,9311,All
2020,11,ALLAHABAD,BENGALURU,4225,5004,ALLAHABAD-BENGALURU,9229,All
2020,12,ALLAHABAD,BENGALURU,5099,3743,ALLAHABAD-BENGALURU,8842,All
2021,1,ALLAHABAD,BENGALURU,4870,3478,ALLAHABAD-BENGALURU,8348,All
2021,2,ALLAHABAD,BENGALURU,4233,4142,ALLAHABAD-BENGALURU,8375,All
2021,3,ALLAHABAD,BENGALURU,3970,4821,ALLAHABAD-BENGALURU,8791,All
2021,4,ALLAHABAD,BENGALURU,3100,4779,ALLAHABAD-BENGALURU,7879,All
2021,6,ALLAHABAD,BENGALURU,3048,2031,ALLAHABAD-BENGALURU,5079,All
2021,7,ALLAHABAD,BENGALURU,4724,3234,ALLAHABAD-BENGALURU,7958,All
2021,8,ALLAHABAD,BENGALURU,2018,1974,ALLAHABAD-BENGALURU,3992,All
2021,9,ALLAHABAD,BENGALURU,3903,3648,ALLAHABAD-BENGALURU,7551,All
2021,10,ALLAHABAD,BENGALURU,4284,5004,ALLAHABAD-BENGALURU,9288,All
2021,11,ALLAHABAD,BENGALURU,5555,5790,ALLAHABAD-BENGALURU,11345,All
2021,12,ALLAHABAD,BENGALURU,6471,5660,ALLAHABAD-BENGALURU,12131,All
2022,1,ALLAHABAD,BENGALURU,3340,3844,ALLAHABAD-BENGALURU,7184,All
2022,2,ALLAHABAD,BENGALURU,2467,2686,ALLAHABAD-BENGALURU,5153,All
2022,3,ALLAHABAD,BENGALURU,4674,4564,ALLAHABAD-BENGALURU,9238,All
2022,4,ALLAHABAD,BENGALURU,4551,4742,ALLAHABAD-BENGALURU,9293,All
2022,5,ALLAHABAD,BENGALURU,4562,3861,ALLAHABAD-BENGALURU,8423,All
2022,6,ALLAHABAD,BENGALURU,4069,3382,ALLAHABAD-BENGALURU,7451,All
2022,7,ALLAHABAD,BENGALURU,1777,1726,ALLAHABAD-BENGALURU,3503,All
2022,8,ALLAHABAD,BENGALURU,1646,1575,ALLAHABAD-BENGALURU,3221,All
2022,9,ALLAHABAD,BENGALURU,2163,2277,ALLAHABAD-BENGALURU,4440,All
2022,10,ALLAHABAD,BENGALURU,4190,4505,ALLAHABAD-BENGALURU,8695,All
2022,11,ALLAHABAD,BENGALURU,4461,4491,ALLAHABAD-BENGALURU,8952,All
2022,12,ALLAHABAD,BENGALURU,4310,3856,ALLAHABAD-BENGALURU,8166,All
2023,1,ALLAHABAD,BENGALURU,3380,3372,ALLAHABAD-BENGALURU,6752,All
2023,2,ALLAHABAD,BENGALURU,3913,4382,ALLAHABAD-BENGALURU,8295,All
2023,3,ALLAHABAD,BENGALURU,4550,4429,ALLAHABAD-BENGALURU,8979,All
2023,4,ALLAHABAD,BENGALURU,4309,4564,ALLAHABAD-BENGALURU,8873,All
2023,5,ALLAHABAD,BENGALURU,5165,4871,ALLAHABAD-BENGALURU,10036,All
2023,6,ALLAHABAD,BENGALURU,5479,5482,ALLAHABAD-BENGALURU,10961,All
2023,7,ALLAHABAD,BENGALURU,4996,5181,ALLAHABAD-BENGALURU,10177,All
2023,8,ALLAHABAD,BENGALURU,4670,5414,ALLAHABAD-BENGALURU,10084,All
2023,9,ALLAHABAD,BENGALURU,5131,5782,ALLAHABAD-BENGALURU,10913,All
2023,10,ALLAHABAD,BENGALURU,4601,6283,ALLAHABAD-BENGALURU,10884,All
2023,11,ALLAHABAD,BENGALURU,4212,5101,ALLAHABAD-BENGALURU,9313,All
2023,12,ALLAHABAD,BENGALURU,4763,4476,ALLAHABAD-BENGALURU,9239,All
2024,1,ALLAHABAD,BENGALURU,3579,3138,ALLAHABAD-BENGALURU,6717,All
2024,2,ALLAHABAD,BENGALURU,4318,4614,ALLAHABAD-BENGALURU,8932,All
2024,3,ALLAHABAD,BENGALURU,4206,4828,ALLAHABAD-BENGALURU,9034,All
2024,4,ALLAHABAD,BENGALURU,2800,3030,ALLAHABAD-BENGALURU,5830,All
2024,6,ALLAHABAD,BENGALURU,2784,2749,ALLAHABAD-BENGALURU,5533,All
2024,7,ALLAHABAD,BENGALURU,2553,2374,ALLAHABAD-BENGALURU,4927,All
2024,8,ALLAHABAD,BENGALURU,2459,2456,ALLAHABAD-BENGALURU,4915,All
2024,9,ALLAHABAD,BENGALURU,2602,2699,ALLAHABAD-BENGALURU,5301,All
2024,10,ALLAHABAD,BENGALURU,2349,2825,ALLAHABAD-BENGALURU,5174,All
2024,11,ALLAHABAD,BENGALURU,2963,2770,ALLAHABAD-BENGALURU,5733,All
2024,12,ALLAHABAD,BENGALURU,3089,3071,ALLAHABAD-BENGALURU,6160,All
2021,3,ALLAHABAD,BHOPAL,80,110,ALLAHABAD-BHOPAL,190,All
2021,4,ALLAHABAD,BHOPAL,495,639,ALLAHABAD-BHOPAL,1134,All
2021,6,ALLAHABAD,BHOPAL,688,477,ALLAHABAD-BHOPAL,1165,All
2021,7,ALLAHABAD,BHOPAL,896,750,ALLAHABAD-BHOPAL,1646,All
2021,8,ALLAHABAD,BHOPAL,883,865,ALLAHABAD-BHOPAL,1748,All
2021,9,ALLAHABAD,BHOPAL,727,665,ALLAHABAD-BHOPAL,1392,All
2021,10,ALLAHABAD,BHOPAL,949,980,ALLAHABAD-BHOPAL,1929,All
2021,11,ALLAHABAD,BHOPAL,1177,1447,ALLAHABAD-BHOPAL,2624,All
2021,12,ALLAHABAD,BHOPAL,1741,1038,ALLAHABAD-BHOPAL,2779,All
2022,1,ALLAHABAD,BHOPAL,711,593,ALLAHABAD-BHOPAL,1304,All
2022,2,ALLAHABAD,BHOPAL,1062,1133,ALLAHABAD-BHOPAL,2195,All
2022,3,ALLAHABAD,BHOPAL,1385,1398,ALLAHABAD-BHOPAL,2783,All
2022,4,ALLAHABAD,BHOPAL,892,1071,ALLAHABAD-BHOPAL,1963,All
2022,5,ALLAHABAD,BHOPAL,1048,1133,ALLAHABAD-BHOPAL,2181,All
2022,6,ALLAHABAD,BHOPAL,1047,838,ALLAHABAD-BHOPAL,1885,All
2022,7,ALLAHABAD,BHOPAL,555,615,ALLAHABAD-BHOPAL,1170,All
2022,8,ALLAHABAD,BHOPAL,569,599,ALLAHABAD-BHOPAL,1168,All
2022,9,ALLAHABAD,BHOPAL,450,522,ALLAHABAD-BHOPAL,972,All
2022,10,ALLAHABAD,BHOPAL,605,915,ALLAHABAD-BHOPAL,1520,All
2022,11,ALLAHABAD,BHOPAL,840,770,ALLAHABAD-BHOPAL,1610,All
2022,12,ALLAHABAD,BHOPAL,861,766,ALLAHABAD-BHOPAL,1627,All
2023,1,ALLAHABAD,BHOPAL,580,617,ALLAHABAD-BHOPAL,1197,All
2023,2,ALLAHABAD,BHOPAL,720,874,ALLAHABAD-BHOPAL,1594,All
2023,3,ALLAHABAD,BHOPAL,716,720,ALLAHABAD-BHOPAL,1436,All
2023,4,ALLAHABAD,BHOPAL,467,700,ALLAHABAD-BHOPAL,1167,All
2023,5,ALLAHABAD,BHOPAL,763,967,ALLAHABAD-BHOPAL,1730,All
2023,6,ALLAHABAD,BHOPAL,1063,942,ALLAHABAD-BHOPAL,2005,All
2023,7,ALLAHABAD,BHOPAL,636,581,ALLAHABAD-BHOPAL,1217,All
2023,8,ALLAHABAD,BHOPAL,440,506,ALLAHABAD-BHOPAL,946,All
2023,9,ALLAHABAD,BHOPAL,583,582,ALLAHABAD-BHOPAL,1165,All
2023,10,ALLAHABAD,BHOPAL,666,841,ALLAHABAD-BHOPAL,1507,All
2023,11,ALLAHABAD,BHOPAL,1184,1762,ALLAHABAD-BHOPAL,2946,All
2023,12,ALLAHABAD,BHOPAL,1699,1259,ALLAHABAD-BHOPAL,2958,All
2024,1,ALLAHABAD,BHOPAL,755,878,ALLAHABAD-BHOPAL,1633,All
2024,2,ALLAHABAD,BHOPAL,1256,1525,ALLAHABAD-BHOPAL,2781,All
2024,3,ALLAHABAD,BHOPAL,1274,1441,ALLAHABAD-BHOPAL,2715,All
2024,4,ALLAHABAD,BHOPAL,968,1875,ALLAHABAD-BHOPAL,2843,All
2024,6,ALLAHABAD,BHOPAL,1489,1625,ALLAHABAD-BHOPAL,3114,All
2024,7,ALLAHABAD,BHOPAL,1131,1443,ALLAHABAD-BHOPAL,2574,All
2024,8,ALLAHABAD,BHOPAL,701,916,ALLAHABAD-BHOPAL,1617,All
2024,9,ALLAHABAD,BHOPAL,109,230,ALLAHABAD-BHOPAL,339,All
2024,10,ALLAHABAD,BHOPAL,105,275,ALLAHABAD-BHOPAL,380,All
2024,11,ALLAHABAD,BHOPAL,177,232,ALLAHABAD-BHOPAL,409,All
2024,12,ALLAHABAD,BHOPAL,145,120,ALLAHABAD-BHOPAL,265,All
2021,3,ALLAHABAD,BHUBANESWAR,201,178,ALLAHABAD-BHUBANESWAR,379,All
2021,4,ALLAHABAD,BHUBANESWAR,382,588,ALLAHABAD-BHUBANESWAR,970,All
2021,6,ALLAHABAD,BHUBANESWAR,262,310,ALLAHABAD-BHUBANESWAR,572,All
2021,7,ALLAHABAD,BHUBANESWAR,475,644,ALLAHABAD-BHUBANESWAR,1119,All
2021,8,ALLAHABAD,BHUBANESWAR,822,822,ALLAHABAD-BHUBANESWAR,1644,All
2021,9,ALLAHABAD,BHUBANESWAR,759,1143,ALLAHABAD-BHUBANESWAR,1902,All
2021,10,ALLAHABAD,BHUBANESWAR,1348,1917,ALLAHABAD-BHUBANESWAR,3265,All
2021,11,ALLAHABAD,BHUBANESWAR,1586,1708,ALLAHABAD-BHUBANESWAR,3294,All
2021,12,ALLAHABAD,BHUBANESWAR,1591,1689,ALLAHABAD-BHUBANESWAR,3280,All
2022,1,ALLAHABAD,BHUBANESWAR,429,684,ALLAHABAD-BHUBANESWAR,1113,All
2022,2,ALLAHABAD,BHUBANESWAR,548,699,ALLAHABAD-BHUBANESWAR,1247,All
2022,3,ALLAHABAD,BHUBANESWAR,1593,2035,ALLAHABAD-BHUBANESWAR,3628,All
2022,4,ALLAHABAD,BHUBANESWAR,1811,1998,ALLAHABAD-BHUBANESWAR,3809,All
2022,5,ALLAHABAD,BHUBANESWAR,1701,1976,ALLAHABAD-BHUBANESWAR,3677,All
2022,6,ALLAHABAD,BHUBANESWAR,1104,1167,ALLAHABAD-BHUBANESWAR,2271,All
2022,7,ALLAHABAD,BHUBANESWAR,1238,1485,ALLAHABAD-BHUBANESWAR,2723,All
2022,8,ALLAHABAD,BHUBANESWAR,1251,1454,ALLAHABAD-BHUBANESWAR,2705,All
2022,9,ALLAHABAD,BHUBANESWAR,1501,1767,ALLAHABAD-BHUBANESWAR,3268,All
2022,10,ALLAHABAD,BHUBANESWAR,1935,1990,ALLAHABAD-BHUBANESWAR,3925,All
2022,11,ALLAHABAD,BHUBANESWAR,1697,1748,ALLAHABAD-BHUBANESWAR,3445,All
2022,12,ALLAHABAD,BHUBANESWAR,1777,1770,ALLAHABAD-BHUBANESWAR,3547,All
2023,1,ALLAHABAD,BHUBANESWAR,1450,1537,ALLAHABAD-BHUBANESWAR,2987,All
2023,2,ALLAHABAD,BHUBANESWAR,1375,1517,ALLAHABAD-BHUBANESWAR,2892,All
2023,3,ALLAHABAD,BHUBANESWAR,1642,1691,ALLAHABAD-BHUBANESWAR,3333,All
2023,4,ALLAHABAD,BHUBANESWAR,1574,1870,ALLAHABAD-BHUBANESWAR,3444,All
2023,5,ALLAHABAD,BHUBANESWAR,1787,1862,ALLAHABAD-BHUBANESWAR,3649,All
2023,6,ALLAHABAD,BHUBANESWAR,1811,1803,ALLAHABAD-BHUBANESWAR,3614,All
2023,7,ALLAHABAD,BHUBANESWAR,1508,1405,ALLAHABAD-BHUBANESWAR,2913,All
2023,8,ALLAHABAD,BHUBANESWAR,1670,1472,ALLAHABAD-BHUBANESWAR,3142,All
2023,9,ALLAHABAD,BHUBANESWAR,1687,1699,ALLAHABAD-BHUBANESWAR,3386,All
2023,10,ALLAHABAD,BHUBANESWAR,2049,2144,ALLAHABAD-BHUBANESWAR,4193,All
2023,11,ALLAHABAD,BHUBANESWAR,1997,1901,ALLAHABAD-BHUBANESWAR,3898,All
2023,12,ALLAHABAD,BHUBANESWAR,2011,1841,ALLAHABAD-BHUBANESWAR,3852,All
2024,1,ALLAHABAD,BHUBANESWAR,1677,1654,ALLAHABAD-BHUBANESWAR,3331,All
2024,2,ALLAHABAD,BHUBANESWAR,1854,1979,ALLAHABAD-BHUBANESWAR,3833,All
2024,3,ALLAHABAD,BHUBANESWAR,2118,2100,ALLAHABAD-BHUBANESWAR,4218,All
2024,4,ALLAHABAD,BHUBANESWAR,1686,1917,ALLAHABAD-BHUBANESWAR,3603,All
2024,6,ALLAHABAD,BHUBANESWAR,1787,1824,ALLAHABAD-BHUBANESWAR,3611,All
2024,7,ALLAHABAD,BHUBANESWAR,1772,1809,ALLAHABAD-BHUBANESWAR,3581,All
2024,8,ALLAHABAD,BHUBANESWAR,1778,1880,ALLAHABAD-BHUBANESWAR,3658,All
2024,9,ALLAHABAD,BHUBANESWAR,717,774,ALLAHABAD-BHUBANESWAR,1491,All
2024,10,ALLAHABAD,BHUBANESWAR,938,967,ALLAHABAD-BHUBANESWAR,1905,All
2024,11,ALLAHABAD,BHUBANESWAR,937,953,ALLAHABAD-BHUBANESWAR,1890,All
2024,12,ALLAHABAD,BHUBANESWAR,958,933,ALLAHABAD-BHUBANESWAR,1891,All
2021,3,ALLAHABAD,BILASPUR,423,449,ALLAHABAD-BILASPUR,872,All
2021,4,ALLAHABAD,BILASPUR,323,304,ALLAHABAD-BILASPUR,627,All
2021,6,ALLAHABAD,BILASPUR,360,345,ALLAHABAD-BILASPUR,705,All
2021,7,ALLAHABAD,BILASPUR,328,324,ALLAHABAD-BILASPUR,652,All
2021,8,ALLAHABAD,BILASPUR,211,236,ALLAHABAD-BILASPUR,447,All
2021,9,ALLAHABAD,BILASPUR,208,225,ALLAHABAD-BILASPUR,433,All
2021,10,ALLAHABAD,BILASPUR,300,277,ALLAHABAD-BILASPUR,577,All
2021,11,ALLAHABAD,BILASPUR,365,370,ALLAHABAD-BILASPUR,735,All
2021,12,ALLAHABAD,BILASPUR,498,325,ALLAHABAD-BILASPUR,823,All
2022,1,ALLAHABAD,BILASPUR,191,191,ALLAHABAD-BILASPUR,382,All
2022,2,ALLAHABAD,BILASPUR,380,448,ALLAHABAD-BILASPUR,828,All
2022,3,ALLAHABAD,BILASPUR,397,372,ALLAHABAD-BILASPUR,769,All
2022,4,ALLAHABAD,BILASPUR,365,370,ALLAHABAD-BILASPUR,735,All
2022,5,ALLAHABAD,BILASPUR,498,325,ALLAHABAD-BILASPUR,823,All
2022,6,ALLAHABAD,BILASPUR,365,370,ALLAHABAD-BILASPUR,735,All
2022,7,ALLAHABAD,BILASPUR,380,448,ALLAHABAD-BILASPUR,828,All
2022,8,ALLAHABAD,BILASPUR,498,325,ALLAHABAD-BILASPUR,823,All
2022,9,ALLAHABAD,BILASPUR,365,370,ALLAHABAD-BILASPUR,735,All
2022,10,ALLAHABAD,BILASPUR,462,520,ALLAHABAD-BILASPUR,982,All
2022,11,ALLAHABAD,BILASPUR,458,374,ALLAHABAD-BILASPUR,832,All
2022,12,ALLAHABAD,BILASPUR,642,494,ALLAHABAD-BILASPUR,1136,All
2023,1,ALLAHABAD,BILASPUR,554,603,ALLAHABAD-BILASPUR,1157,All
2023,2,ALLAHABAD,BILASPUR,511,476,ALLAHABAD-BILASPUR,987,All
2023,3,ALLAHABAD,BILASPUR,466,382,ALLAHABAD-BILASPUR,848,All
2023,4,ALLAHABAD,BILASPUR,429,581,ALLAHABAD-BILASPUR,1010,All
2023,5,ALLAHABAD,BILASPUR,885,942,ALLAHABAD-BILASPUR,1827,All
2023,6,ALLAHABAD,BILASPUR,787,522,ALLAHABAD-BILASPUR,1309,All
2023,7,ALLAHABAD,BILASPUR,429,444,ALLAHABAD-BILASPUR,873,All
2023,8,ALLAHABAD,BILASPUR,520,512,ALLAHABAD-BILASPUR,1032,All
2023,9,ALLAHABAD,BILASPUR,613,627,ALLAHABAD-BILASPUR,1240,All
2023,10,ALLAHABAD,BILASPUR,700,544,ALLAHABAD-BILASPUR,1244,All
2023,11,ALLAHABAD,BILASPUR,713,745,ALLAHABAD-BILASPUR,1458,All
2023,12,ALLAHABAD,BILASPUR,699,495,ALLAHABAD-BILASPUR,1194,All
2024,1,ALLAHABAD,BILASPUR,470,452,ALLAHABAD-BILASPUR,922,All
2024,2,ALLAHABAD,BILASPUR,721,758,ALLAHABAD-BILASPUR,1479,All
2024,3,ALLAHABAD,BILASPUR,579,677,ALLAHABAD-BILASPUR,1256,All
2024,4,ALLAHABAD,BILASPUR,106,110,ALLAHABAD-BILASPUR,216,All
2024,6,ALLAHABAD,BILASPUR,261,331,ALLAHABAD-BILASPUR,592,All
2024,7,ALLAHABAD,BILASPUR,423,507,ALLAHABAD-BILASPUR,930,All
2024,8,ALLAHABAD,BILASPUR,397,512,ALLAHABAD-BILASPUR,909,All
2024,9,ALLAHABAD,BILASPUR,254,288,ALLAHABAD-BILASPUR,542,All
2024,10,ALLAHABAD,BILASPUR,504,551,ALLAHABAD-BILASPUR,1055,All
2024,11,ALLAHABAD,BILASPUR,448,469,ALLAHABAD-BILASPUR,917,All
2024,12,ALLAHABAD,BILASPUR,604,587,ALLAHABAD-BILASPUR,1191,All
2022,5,ALLAHABAD,CHENNAI,15,0,ALLAHABAD-CHENNAI,15,All
2021,4,ALLAHABAD,DEHRA DUN,126,265,ALLAHABAD-DEHRA DUN,391,All
2021,7,ALLAHABAD,DEHRA DUN,292,238,ALLAHABAD-DEHRA DUN,530,All
2021,8,ALLAHABAD,DEHRA DUN,903,702,ALLAHABAD-DEHRA DUN,1605,All
2021,9,ALLAHABAD,DEHRA DUN,763,522,ALLAHABAD-DEHRA DUN,1285,All
2021,10,ALLAHABAD,DEHRA DUN,1673,1301,ALLAHABAD-DEHRA DUN,2974,All
2021,11,ALLAHABAD,DEHRA DUN,1483,1818,ALLAHABAD-DEHRA DUN,3301,All
2021,12,ALLAHABAD,DEHRA DUN,1757,1822,ALLAHABAD-DEHRA DUN,3579,All
2022,1,ALLAHABAD,DEHRA DUN,770,947,ALLAHABAD-DEHRA DUN,1717,All
2022,2,ALLAHABAD,DEHRA DUN,920,735,ALLAHABAD-DEHRA DUN,1655,All
2022,3,ALLAHABAD,DEHRA DUN,1215,1473,ALLAHABAD-DEHRA DUN,2688,All
2022,4,ALLAHABAD,DEHRA DUN,1515,1610,ALLAHABAD-DEHRA DUN,3125,All
2022,5,ALLAHABAD,DEHRA DUN,1938,1968,ALLAHABAD-DEHRA DUN,3906,All
2022,6,ALLAHABAD,DEHRA DUN,1939,2008,ALLAHABAD-DEHRA DUN,3947,All
2022,7,ALLAHABAD,DEHRA DUN,1069,1177,ALLAHABAD-DEHRA DUN,2246,All
2022,8,ALLAHABAD,DEHRA DUN,1064,1122,ALLAHABAD-DEHRA DUN,2186,All
2022,9,ALLAHABAD,DEHRA DUN,922,971,ALLAHABAD-DEHRA DUN,1893,All
2022,10,ALLAHABAD,DEHRA DUN,1465,1871,ALLAHABAD-DEHRA DUN,3336,All
2022,11,ALLAHABAD,DEHRA DUN,1296,1430,ALLAHABAD-DEHRA DUN,2726,All
2022,12,ALLAHABAD,DEHRA DUN,1414,1505,ALLAHABAD-DEHRA DUN,2919,All
2023,2,ALLAHABAD,DEHRA DUN,1124,1234,ALLAHABAD-DEHRA DUN,2358,All
2023,3,ALLAHABAD,DEHRA DUN,1335,1270,ALLAHABAD-DEHRA DUN,2605,All
2023,4,ALLAHABAD,DEHRA DUN,1671,1477,ALLAHABAD-DEHRA DUN,3148,All
2023,5,ALLAHABAD,DEHRA DUN,2126,2205,ALLAHABAD-DEHRA DUN,4331,All
2019,5,ALLAHABAD,DELHI,2875,3027,ALLAHABAD-DELHI,5902,All
2019,6,ALLAHABAD,DELHI,6887,6564,ALLAHABAD-DELHI,13451,All
2019,7,ALLAHABAD,DELHI,5678,5570,ALLAHABAD-DELHI,11248,All
2019,8,ALLAHABAD,DELHI,5064,5241,ALLAHABAD-DELHI,10305,All
2019,9,ALLAHABAD,DELHI,5049,5493,ALLAHABAD-DELHI,10542,All
2019,10,ALLAHABAD,DELHI,5614,6486,ALLAHABAD-DELHI,12100,All
2019,11,ALLAHABAD,DELHI,6596,6363,ALLAHABAD-DELHI,12959,All
2019,12,ALLAHABAD,DELHI,6725,6437,ALLAHABAD-DELHI,13162,All
2020,1,ALLAHABAD,DELHI,5972,5994,ALLAHABAD-DELHI,11966,All
2020,2,ALLAHABAD,DELHI,6347,6518,ALLAHABAD-DELHI,12865,All
2020,3,ALLAHABAD,DELHI,3857,4352,ALLAHABAD-DELHI,8209,All
2020,5,ALLAHABAD,DELHI,96,234,ALLAHABAD-DELHI,330,All
2020,6,ALLAHABAD,DELHI,971,2888,ALLAHABAD-DELHI,3859,All
2020,7,ALLAHABAD,DELHI,2420,2844,ALLAHABAD-DELHI,5264,All
2020,8,ALLAHABAD,DELHI,4688,2658,ALLAHABAD-DELHI,7346,All
2020,9,ALLAHABAD,DELHI,4399,2685,ALLAHABAD-DELHI,7084,All
2020,10,ALLAHABAD,DELHI,4179,3716,ALLAHABAD-DELHI,7895,All
2020,11,ALLAHABAD,DELHI,3856,5178,ALLAHABAD-DELHI,9034,All
2020,12,ALLAHABAD,DELHI,5815,4294,ALLAHABAD-DELHI,10109,All
2021,1,ALLAHABAD,DELHI,4411,3862,ALLAHABAD-DELHI,8273,All
2021,2,ALLAHABAD,DELHI,4993,4407,ALLAHABAD-DELHI,9400,All
2021,3,ALLAHABAD,DELHI,4670,5020,ALLAHABAD-DELHI,9690,All
2021,4,ALLAHABAD,DELHI,2571,4059,ALLAHABAD-DELHI,6630,All
2021,6,ALLAHABAD,DELHI,2108,1737,ALLAHABAD-DELHI,3845,All
2021,7,ALLAHABAD,DELHI,3105,3019,ALLAHABAD-DELHI,6124,All
2021,8,ALLAHABAD,DELHI,3952,4852,ALLAHABAD-DELHI,8804,All
2021,9,ALLAHABAD,DELHI,3558,3925,ALLAHABAD-DELHI,7483,All
2021,10,ALLAHABAD,DELHI,3637,4121,ALLAHABAD-DELHI,7758,All
2021,11,ALLAHABAD,DELHI,5109,5104,ALLAHABAD-DELHI,10213,All
2021,12,ALLAHABAD,DELHI,5681,4395,ALLAHABAD-DELHI,10076,All
2022,1,ALLAHABAD,DELHI,1879,1990,ALLAHABAD-DELHI,3869,All
2022,2,ALLAHABAD,DELHI,3211,3234,ALLAHABAD-DELHI,6445,All
2022,3,ALLAHABAD,DELHI,5195,5269,ALLAHABAD-DELHI,10464,All
2022,4,ALLAHABAD,DELHI,4434,4926,ALLAHABAD-DELHI,9360,All
2022,5,ALLAHABAD,DELHI,4223,4461,ALLAHABAD-DELHI,8684,All
2022,6,ALLAHABAD,DELHI,5593,5097,ALLAHABAD-DELHI,10690,All
2022,7,ALLAHABAD,DELHI,5412,5057,ALLAHABAD-DELHI,10469,All
2022,8,ALLAHABAD,DELHI,5154,4695,ALLAHABAD-DELHI,9849,All
2022,9,ALLAHABAD,DELHI,5260,5212,ALLAHABAD-DELHI,10472,All
2022,10,ALLAHABAD,DELHI,5262,6274,ALLAHABAD-DELHI,11536,All
2022,11,ALLAHABAD,DELHI,5771,5635,ALLAHABAD-DELHI,11406,All
2022,12,ALLAHABAD,DELHI,6162,5839,ALLAHABAD-DELHI,12001,All
2023,1,ALLAHABAD,DELHI,5616,5509,ALLAHABAD-DELHI,11125,All
2023,2,ALLAHABAD,DELHI,5593,5491,ALLAHABAD-DELHI,11084,All
2023,3,ALLAHABAD,DELHI,5864,5450,ALLAHABAD-DELHI,11314,All
2023,4,ALLAHABAD,DELHI,5644,6249,ALLAHABAD-DELHI,11893,All
2023,5,ALLAHABAD,DELHI,6626,7383,ALLAHABAD-DELHI,14009,All
2023,6,ALLAHABAD,DELHI,6175,6426,ALLAHABAD-DELHI,12601,All
2023,7,ALLAHABAD,DELHI,5952,5760,ALLAHABAD-DELHI,11712,All
2023,8,ALLAHABAD,DELHI,6796,6640,ALLAHABAD-DELHI,13436,All
2023,9,ALLAHABAD,DELHI,6857,6426,ALLAHABAD-DELHI,13283,All
2023,10,ALLAHABAD,DELHI,6148,6937,ALLAHABAD-DELHI,13085,All
2023,11,ALLAHABAD,DELHI,5318,6075,ALLAHABAD-DELHI,11393,All
2023,12,ALLAHABAD,DELHI,5456,5339,ALLAHABAD-DELHI,10795,All
2024,1,ALLAHABAD,DELHI,4771,4630,ALLAHABAD-DELHI,9401,All
2024,2,ALLAHABAD,DELHI,5541,5661,ALLAHABAD-DELHI,11202,All
2024,3,ALLAHABAD,DELHI,5723,5776,ALLAHABAD-DELHI,11499,All
2024,4,ALLAHABAD,DELHI,6118,6575,ALLAHABAD-DELHI,12693,All
2024,6,ALLAHABAD,DELHI,6871,6786,ALLAHABAD-DELHI,13657,All
2024,7,ALLAHABAD,DELHI,7246,6810,ALLAHABAD-DELHI,14056,All
2024,8,ALLAHABAD,DELHI,7066,6599,ALLAHABAD-DELHI,13665,All
2024,9,ALLAHABAD,DELHI,5920,6106,ALLAHABAD-DELHI,12026,All
2024,10,ALLAHABAD,DELHI,5666,6774,ALLAHABAD-DELHI,12440,All
2024,11,ALLAHABAD,DELHI,6549,6431,ALLAHABAD-DELHI,12980,All
2024,12,ALLAHABAD,DELHI,7415,7106,ALLAHABAD-DELHI,14521,All
2023,1,ALLAHABAD,DehraDun,1232,762,ALLAHABAD-DehraDun,1994,All
2023,6,ALLAHABAD,DehraDun,2421,2480,ALLAHABAD-DehraDun,4901,All
2023,7,ALLAHABAD,DehraDun,1302,1330,ALLAHABAD-DehraDun,2632,All
2023,8,ALLAHABAD,DehraDun,1027,988,ALLAHABAD-DehraDun,2015,All
2023,9,ALLAHABAD,DehraDun,1374,1069,ALLAHABAD-DehraDun,2443,All
2023,10,ALLAHABAD,DehraDun,1223,1168,ALLAHABAD-DehraDun,2391,All
2023,11,ALLAHABAD,DehraDun,1650,1757,ALLAHABAD-DehraDun,3407,All
2023,12,ALLAHABAD,DehraDun,1420,1313,ALLAHABAD-DehraDun,2733,All
2024,1,ALLAHABAD,DehraDun,720,530,ALLAHABAD-DehraDun,1250,All
2024,2,ALLAHABAD,DehraDun,1321,1092,ALLAHABAD-DehraDun,2413,All
2024,3,ALLAHABAD,DehraDun,1626,1527,ALLAHABAD-DehraDun,3153,All
2024,4,ALLAHABAD,DehraDun,1279,1181,ALLAHABAD-DehraDun,2460,All
2024,6,ALLAHABAD,DehraDun,1371,1467,ALLAHABAD-DehraDun,2838,All
2024,7,ALLAHABAD,DehraDun,1084,989,ALLAHABAD-DehraDun,2073,All
2024,8,ALLAHABAD,DehraDun,1037,888,ALLAHABAD-DehraDun,1925,All
2020,1,ALLAHABAD,GORAKHPUR,903,996,ALLAHABAD-GORAKHPUR,1899,All
2020,2,ALLAHABAD,GORAKHPUR,861,989,ALLAHABAD-GORAKHPUR,1850,All
2020,3,ALLAHABAD,GORAKHPUR,1022,977,ALLAHABAD-GORAKHPUR,1999,All
2020,6,ALLAHABAD,GORAKHPUR,15,141,ALLAHABAD-GORAKHPUR,156,All
2020,7,ALLAHABAD,GORAKHPUR,147,1173,ALLAHABAD-GORAKHPUR,1320,All
2020,8,ALLAHABAD,GORAKHPUR,125,1515,ALLAHABAD-GORAKHPUR,1640,All
2020,9,ALLAHABAD,GORAKHPUR,179,1351,ALLAHABAD-GORAKHPUR,1530,All
2020,10,ALLAHABAD,GORAKHPUR,311,1013,ALLAHABAD-GORAKHPUR,1324,All
2020,11,ALLAHABAD,GORAKHPUR,574,859,ALLAHABAD-GORAKHPUR,1433,All
2020,12,ALLAHABAD,GORAKHPUR,486,1355,ALLAHABAD-GORAKHPUR,1841,All
2021,1,ALLAHABAD,GORAKHPUR,443,733,ALLAHABAD-GORAKHPUR,1176,All
2021,2,ALLAHABAD,GORAKHPUR,321,240,ALLAHABAD-GORAKHPUR,561,All
2021,3,ALLAHABAD,GORAKHPUR,605,417,ALLAHABAD-GORAKHPUR,1022,All
2021,4,ALLAHABAD,GORAKHPUR,621,407,ALLAHABAD-GORAKHPUR,1028,All
2021,6,ALLAHABAD,GORAKHPUR,145,188,ALLAHABAD-GORAKHPUR,333,All
2021,7,ALLAHABAD,GORAKHPUR,332,456,ALLAHABAD-GORAKHPUR,788,All
2021,8,ALLAHABAD,GORAKHPUR,416,405,ALLAHABAD-GORAKHPUR,821,All
2021,9,ALLAHABAD,GORAKHPUR,476,294,ALLAHABAD-GORAKHPUR,770,All
2021,10,ALLAHABAD,GORAKHPUR,734,487,ALLAHABAD-GORAKHPUR,1221,All
2021,11,ALLAHABAD,GORAKHPUR,1184,1152,ALLAHABAD-GORAKHPUR,2336,All
2021,12,ALLAHABAD,GORAKHPUR,1129,1353,ALLAHABAD-GORAKHPUR,2482,All
2022,1,ALLAHABAD,GORAKHPUR,339,462,ALLAHABAD-GORAKHPUR,801,All
2022,2,ALLAHABAD,GORAKHPUR,641,479,ALLAHABAD-GORAKHPUR,1120,All
2022,3,ALLAHABAD,GORAKHPUR,917,742,ALLAHABAD-GORAKHPUR,1659,All
2022,4,ALLAHABAD,GORAKHPUR,1282,917,ALLAHABAD-GORAKHPUR,2199,All
2022,5,ALLAHABAD,GORAKHPUR,1681,1166,ALLAHABAD-GORAKHPUR,2847,All
2022,6,ALLAHABAD,GORAKHPUR,1330,1264,ALLAHABAD-GORAKHPUR,2594,All
2022,7,ALLAHABAD,GORAKHPUR,906,916,ALLAHABAD-GORAKHPUR,1822,All
2022,8,ALLAHABAD,GORAKHPUR,695,728,ALLAHABAD-GORAKHPUR,1423,All
2022,9,ALLAHABAD,GORAKHPUR,649,461,ALLAHABAD-GORAKHPUR,1110,All
2022,10,ALLAHABAD,GORAKHPUR,1437,623,ALLAHABAD-GORAKHPUR,2060,All
2022,11,ALLAHABAD,GORAKHPUR,1100,584,ALLAHABAD-GORAKHPUR,1684,All
2022,12,ALLAHABAD,GORAKHPUR,779,477,ALLAHABAD-GORAKHPUR,1256,All
2023,1,ALLAHABAD,GORAKHPUR,188,252,ALLAHABAD-GORAKHPUR,440,All
2023,2,ALLAHABAD,GORAKHPUR,1143,573,ALLAHABAD-GORAKHPUR,1716,All
2023,3,ALLAHABAD,GORAKHPUR,867,496,ALLAHABAD-GORAKHPUR,1363,All
2023,4,ALLAHABAD,GORAKHPUR,492,149,ALLAHABAD-GORAKHPUR,641,All
2024,6,ALLAHABAD,GORAKHPUR,0,41,ALLAHABAD-GORAKHPUR,41,All
2021,9,ALLAHABAD,HYDERABAD,11,0,ALLAHABAD-HYDERABAD,11,All
2024,9,ALLAHABAD,HYDERABAD,145,166,ALLAHABAD-HYDERABAD,311,All
2024,10,ALLAHABAD,HYDERABAD,1584,2198,ALLAHABAD-HYDERABAD,3782,All
2024,11,ALLAHABAD,HYDERABAD,2102,2101,ALLAHABAD-HYDERABAD,4203,All
2024,12,ALLAHABAD,HYDERABAD,2202,2024,ALLAHABAD-HYDERABAD,4226,All
2021,10,ALLAHABAD,INDORE,16,53,ALLAHABAD-INDORE,69,All
2021,11,ALLAHABAD,INDORE,1426,1384,ALLAHABAD-INDORE,2810,All
2021,12,ALLAHABAD,INDORE,1775,1189,ALLAHABAD-INDORE,2964,All
2022,1,ALLAHABAD,INDORE,653,681,ALLAHABAD-INDORE,1334,All
2022,2,ALLAHABAD,INDORE,613,704,ALLAHABAD-INDORE,1317,All
2022,3,ALLAHABAD,INDORE,1554,1352,ALLAHABAD-INDORE,2906,All
2022,4,ALLAHABAD,INDORE,1089,1313,ALLAHABAD-INDORE,2402,All
2022,5,ALLAHABAD,INDORE,1769,1465,ALLAHABAD-INDORE,3234,All
2022,6,ALLAHABAD,INDORE,1837,1220,ALLAHABAD-INDORE,3057,All
2022,7,ALLAHABAD,INDORE,1995,1468,ALLAHABAD-INDORE,3463,All
2022,8,ALLAHABAD,INDORE,1860,1549,ALLAHABAD-INDORE,3409,All
2022,9,ALLAHABAD,INDORE,1247,1149,ALLAHABAD-INDORE,2396,All
2022,10,ALLAHABAD,INDORE,1623,1889,ALLAHABAD-INDORE,3512,All
2022,11,ALLAHABAD,INDORE,1768,1631,ALLAHABAD-INDORE,3399,All
2022,12,ALLAHABAD,INDORE,1705,1504,ALLAHABAD-INDORE,3209,All
2023,1,ALLAHABAD,INDORE,974,1021,ALLAHABAD-INDORE,1995,All
2023,2,ALLAHABAD,INDORE,1398,1272,ALLAHABAD-INDORE,2670,All
2023,3,ALLAHABAD,INDORE,1652,1549,ALLAHABAD-INDORE,3201,All
2023,4,ALLAHABAD,INDORE,1569,1716,ALLAHABAD-INDORE,3285,All
2023,5,ALLAHABAD,INDORE,1841,2016,ALLAHABAD-INDORE,3857,All
2023,6,ALLAHABAD,INDORE,1995,1586,ALLAHABAD-INDORE,3581,All
2023,7,ALLAHABAD,INDORE,1247,1298,ALLAHABAD-INDORE,2545,All
2023,8,ALLAHABAD,INDORE,1365,1536,ALLAHABAD-INDORE,2901,All
2023,9,ALLAHABAD,INDORE,1419,1488,ALLAHABAD-INDORE,2907,All
2023,10,ALLAHABAD,INDORE,1034,1181,ALLAHABAD-INDORE,2215,All
2021,4,ALLAHABAD,JABALPUR,1,0,ALLAHABAD-JABALPUR,1,All
2021,11,ALLAHABAD,JABALPUR,4,2,ALLAHABAD-JABALPUR,6,All
2021,12,ALLAHABAD,JABALPUR,3,1,ALLAHABAD-JABALPUR,4,All
2022,4,ALLAHABAD,JABALPUR,4,2,ALLAHABAD-JABALPUR,6,All
2022,5,ALLAHABAD,JABALPUR,3,1,ALLAHABAD-JABALPUR,4,All
2022,6,ALLAHABAD,JABALPUR,4,2,ALLAHABAD-JABALPUR,6,All
2022,8,ALLAHABAD,JABALPUR,3,1,ALLAHABAD-JABALPUR,4,All
2022,9,ALLAHABAD,JABALPUR,4,2,ALLAHABAD-JABALPUR,6,All
2021,1,ALLAHABAD,JAIPUR,2,0,ALLAHABAD-JAIPUR,2,All
2023,8,ALLAHABAD,JAIPUR,32,0,ALLAHABAD-JAIPUR,32,All
2024,6,ALLAHABAD,JAIPUR,0,59,ALLAHABAD-JAIPUR,59,All
2019,6,ALLAHABAD,KOLKATA,182,194,ALLAHABAD-KOLKATA,376,All
2019,7,ALLAHABAD,KOLKATA,1444,1242,ALLAHABAD-KOLKATA,2686,All
2019,8,ALLAHABAD,KOLKATA,1622,1178,ALLAHABAD-KOLKATA,2800,All
2019,9,ALLAHABAD,KOLKATA,1116,1134,ALLAHABAD-KOLKATA,2250,All
2019,10,ALLAHABAD,KOLKATA,1711,1649,ALLAHABAD-KOLKATA,3360,All
2019,11,ALLAHABAD,KOLKATA,1687,1590,ALLAHABAD-KOLKATA,3277,All
2019,12,ALLAHABAD,KOLKATA,1774,1553,ALLAHABAD-KOLKATA,3327,All
2020,1,ALLAHABAD,KOLKATA,1708,1644,ALLAHABAD-KOLKATA,3352,All
2020,2,ALLAHABAD,KOLKATA,1594,1686,ALLAHABAD-KOLKATA,3280,All
2020,3,ALLAHABAD,KOLKATA,1463,1308,ALLAHABAD-KOLKATA,2771,All
2020,7,ALLAHABAD,KOLKATA,94,130,ALLAHABAD-KOLKATA,224,All
2020,8,ALLAHABAD,KOLKATA,570,806,ALLAHABAD-KOLKATA,1376,All
2020,9,ALLAHABAD,KOLKATA,838,1086,ALLAHABAD-KOLKATA,1924,All
2020,10,ALLAHABAD,KOLKATA,948,1059,ALLAHABAD-KOLKATA,2007,All
2020,11,ALLAHABAD,KOLKATA,1734,1769,ALLAHABAD-KOLKATA,3503,All
2020,12,ALLAHABAD,KOLKATA,1814,1585,ALLAHABAD-KOLKATA,3399,All
2021,1,ALLAHABAD,KOLKATA,1223,1221,ALLAHABAD-KOLKATA,2444,All
2021,2,ALLAHABAD,KOLKATA,738,883,ALLAHABAD-KOLKATA,1621,All
2021,3,ALLAHABAD,KOLKATA,947,1261,ALLAHABAD-KOLKATA,2208,All
2023,7,ALLAHABAD,KOLKATA,120,41,ALLAHABAD-KOLKATA,161,All
2023,8,ALLAHABAD,KOLKATA,5,0,ALLAHABAD-KOLKATA,5,All
2019,1,ALLAHABAD,LEH,0,4,ALLAHABAD-LEH,4,All
2019,2,ALLAHABAD,LEH,0,4,ALLAHABAD-LEH,4,All
2019,3,ALLAHABAD,LEH,0,5,ALLAHABAD-LEH,5,All
2018,6,ALLAHABAD,LUCKNOW,324,252,ALLAHABAD-LUCKNOW,576,All
2018,7,ALLAHABAD,LUCKNOW,425,315,ALLAHABAD-LUCKNOW,740,All
2018,8,ALLAHABAD,LUCKNOW,460,362,ALLAHABAD-LUCKNOW,822,All
2018,9,ALLAHABAD,LUCKNOW,465,408,ALLAHABAD-LUCKNOW,873,All
2018,10,ALLAHABAD,LUCKNOW,511,378,ALLAHABAD-LUCKNOW,889,All
2018,11,ALLAHABAD,LUCKNOW,444,397,ALLAHABAD-LUCKNOW,841,All
2018,12,ALLAHABAD,LUCKNOW,529,429,ALLAHABAD-LUCKNOW,958,All
2019,1,ALLAHABAD,LUCKNOW,619,561,ALLAHABAD-LUCKNOW,1180,All
2019,2,ALLAHABAD,LUCKNOW,703,718,ALLAHABAD-LUCKNOW,1421,All
2019,3,ALLAHABAD,LUCKNOW,309,355,ALLAHABAD-LUCKNOW,664,All
2019,4,ALLAHABAD,LUCKNOW,77,74,ALLAHABAD-LUCKNOW,151,All
2022,3,ALLAHABAD,LUCKNOW,194,159,ALLAHABAD-LUCKNOW,353,All
2022,4,ALLAHABAD,LUCKNOW,894,882,ALLAHABAD-LUCKNOW,1776,All
2022,5,ALLAHABAD,LUCKNOW,1176,1269,ALLAHABAD-LUCKNOW,2445,All
2022,6,ALLAHABAD,LUCKNOW,965,949,ALLAHABAD-LUCKNOW,1914,All
2022,7,ALLAHABAD,LUCKNOW,935,848,ALLAHABAD-LUCKNOW,1783,All
2022,8,ALLAHABAD,LUCKNOW,1032,858,ALLAHABAD-LUCKNOW,1890,All
2022,9,ALLAHABAD,LUCKNOW,942,573,ALLAHABAD-LUCKNOW,1515,All
2022,10,ALLAHABAD,LUCKNOW,1066,999,ALLAHABAD-LUCKNOW,2065,All
2022,11,ALLAHABAD,LUCKNOW,963,1229,ALLAHABAD-LUCKNOW,2192,All
2022,12,ALLAHABAD,LUCKNOW,867,1123,ALLAHABAD-LUCKNOW,1990,All
2023,1,ALLAHABAD,LUCKNOW,724,808,ALLAHABAD-LUCKNOW,1532,All
2023,2,ALLAHABAD,LUCKNOW,1090,1068,ALLAHABAD-LUCKNOW,2158,All
2023,3,ALLAHABAD,LUCKNOW,983,1067,ALLAHABAD-LUCKNOW,2050,All
2023,4,ALLAHABAD,LUCKNOW,1445,903,ALLAHABAD-LUCKNOW,2348,All
2023,5,ALLAHABAD,LUCKNOW,1260,1292,ALLAHABAD-LUCKNOW,2552,All
2023,6,ALLAHABAD,LUCKNOW,1006,1280,ALLAHABAD-LUCKNOW,2286,All
2023,7,ALLAHABAD,LUCKNOW,1089,874,ALLAHABAD-LUCKNOW,1963,All
2023,8,ALLAHABAD,LUCKNOW,1162,781,ALLAHABAD-LUCKNOW,1943,All
2023,9,ALLAHABAD,LUCKNOW,978,653,ALLAHABAD-LUCKNOW,1631,All
2023,10,ALLAHABAD,LUCKNOW,1225,874,ALLAHABAD-LUCKNOW,2099,All
2023,11,ALLAHABAD,LUCKNOW,1943,2036,ALLAHABAD-LUCKNOW,3979,All
2023,12,ALLAHABAD,LUCKNOW,1719,1731,ALLAHABAD-LUCKNOW,3450,All
2024,1,ALLAHABAD,LUCKNOW,1190,1073,ALLAHABAD-LUCKNOW,2263,All
2024,2,ALLAHABAD,LUCKNOW,1559,1558,ALLAHABAD-LUCKNOW,3117,All
2024,3,ALLAHABAD,LUCKNOW,1952,1789,ALLAHABAD-LUCKNOW,3741,All
2024,4,ALLAHABAD,LUCKNOW,1896,1403,ALLAHABAD-LUCKNOW,3299,All
2024,6,ALLAHABAD,LUCKNOW,1511,1328,ALLAHABAD-LUCKNOW,2839,All
2024,7,ALLAHABAD,LUCKNOW,1748,1402,ALLAHABAD-LUCKNOW,3150,All
2024,8,ALLAHABAD,LUCKNOW,1799,1477,ALLAHABAD-LUCKNOW,3276,All
2024,9,ALLAHABAD,LUCKNOW,1576,1317,ALLAHABAD-LUCKNOW,2893,All
2024,10,ALLAHABAD,LUCKNOW,1718,1474,ALLAHABAD-LUCKNOW,3192,All
2024,11,ALLAHABAD,LUCKNOW,1109,919,ALLAHABAD-LUCKNOW,2028,All
2024,12,ALLAHABAD,LUCKNOW,1286,1004,ALLAHABAD-LUCKNOW,2290,All
2019,5,ALLAHABAD,MUMBAI,4998,5146,ALLAHABAD-MUMBAI,10144,All
2019,6,ALLAHABAD,MUMBAI,5322,4332,ALLAHABAD-MUMBAI,9654,All
2019,7,ALLAHABAD,MUMBAI,3597,3309,ALLAHABAD-MUMBAI,6906,All
2019,8,ALLAHABAD,MUMBAI,4614,4457,ALLAHABAD-MUMBAI,9071,All
2019,9,ALLAHABAD,MUMBAI,4468,4307,ALLAHABAD-MUMBAI,8775,All
2019,10,ALLAHABAD,MUMBAI,4526,5109,ALLAHABAD-MUMBAI,9635,All
2019,11,ALLAHABAD,MUMBAI,5255,5094,ALLAHABAD-MUMBAI,10349,All
2019,12,ALLAHABAD,MUMBAI,5351,4991,ALLAHABAD-MUMBAI,10342,All
2020,1,ALLAHABAD,MUMBAI,5220,5422,ALLAHABAD-MUMBAI,10642,All
2020,2,ALLAHABAD,MUMBAI,4987,5131,ALLAHABAD-MUMBAI,10118,All
2020,3,ALLAHABAD,MUMBAI,3500,3974,ALLAHABAD-MUMBAI,7474,All
2020,5,ALLAHABAD,MUMBAI,297,661,ALLAHABAD-MUMBAI,958,All
2020,6,ALLAHABAD,MUMBAI,1293,2715,ALLAHABAD-MUMBAI,4008,All
2020,7,ALLAHABAD,MUMBAI,2291,4133,ALLAHABAD-MUMBAI,6424,All
2020,8,ALLAHABAD,MUMBAI,4683,2645,ALLAHABAD-MUMBAI,7328,All
2020,9,ALLAHABAD,MUMBAI,4826,2773,ALLAHABAD-MUMBAI,7599,All
2020,10,ALLAHABAD,MUMBAI,4198,3607,ALLAHABAD-MUMBAI,7805,All
2020,11,ALLAHABAD,MUMBAI,4248,4796,ALLAHABAD-MUMBAI,9044,All
2020,12,ALLAHABAD,MUMBAI,5032,4218,ALLAHABAD-MUMBAI,9250,All
2021,1,ALLAHABAD,MUMBAI,4318,3878,ALLAHABAD-MUMBAI,8196,All
2021,2,ALLAHABAD,MUMBAI,3892,4090,ALLAHABAD-MUMBAI,7982,All
2021,3,ALLAHABAD,MUMBAI,3627,4010,ALLAHABAD-MUMBAI,7637,All
2021,4,ALLAHABAD,MUMBAI,2547,4152,ALLAHABAD-MUMBAI,6699,All
2021,6,ALLAHABAD,MUMBAI,3327,2479,ALLAHABAD-MUMBAI,5806,All
2021,7,ALLAHABAD,MUMBAI,3476,3161,ALLAHABAD-MUMBAI,6637,All
2021,8,ALLAHABAD,MUMBAI,3809,3458,ALLAHABAD-MUMBAI,7267,All
2021,9,ALLAHABAD,MUMBAI,3702,3501,ALLAHABAD-MUMBAI,7203,All
2021,10,ALLAHABAD,MUMBAI,4194,4762,ALLAHABAD-MUMBAI,8956,All
2021,11,ALLAHABAD,MUMBAI,4817,5181,ALLAHABAD-MUMBAI,9998,All
2021,12,ALLAHABAD,MUMBAI,5109,4318,ALLAHABAD-MUMBAI,9427,All
2022,1,ALLAHABAD,MUMBAI,2684,2965,ALLAHABAD-MUMBAI,5649,All
2022,2,ALLAHABAD,MUMBAI,2698,2721,ALLAHABAD-MUMBAI,5419,All
2022,3,ALLAHABAD,MUMBAI,4812,4893,ALLAHABAD-MUMBAI,9705,All
2022,4,ALLAHABAD,MUMBAI,4601,5117,ALLAHABAD-MUMBAI,9718,All
2022,5,ALLAHABAD,MUMBAI,5350,5357,ALLAHABAD-MUMBAI,10707,All
2022,6,ALLAHABAD,MUMBAI,3803,3576,ALLAHABAD-MUMBAI,7379,All
2022,7,ALLAHABAD,MUMBAI,3017,2894,ALLAHABAD-MUMBAI,5911,All
2022,8,ALLAHABAD,MUMBAI,3241,3198,ALLAHABAD-MUMBAI,6439,All
2022,9,ALLAHABAD,MUMBAI,3082,3220,ALLAHABAD-MUMBAI,6302,All
2022,10,ALLAHABAD,MUMBAI,3069,3825,ALLAHABAD-MUMBAI,6894,All
2022,11,ALLAHABAD,MUMBAI,4401,4447,ALLAHABAD-MUMBAI,8848,All
2022,12,ALLAHABAD,MUMBAI,4642,4294,ALLAHABAD-MUMBAI,8936,All
2023,1,ALLAHABAD,MUMBAI,3613,4211,ALLAHABAD-MUMBAI,7824,All
2023,2,ALLAHABAD,MUMBAI,4150,5612,ALLAHABAD-MUMBAI,9762,All
2023,3,ALLAHABAD,MUMBAI,4944,4610,ALLAHABAD-MUMBAI,9554,All
2023,4,ALLAHABAD,MUMBAI,3657,5845,ALLAHABAD-MUMBAI,9502,All
2023,5,ALLAHABAD,MUMBAI,6356,6743,ALLAHABAD-MUMBAI,13099,All
2023,6,ALLAHABAD,MUMBAI,6697,6318,ALLAHABAD-MUMBAI,13015,All
2023,7,ALLAHABAD,MUMBAI,5167,4706,ALLAHABAD-MUMBAI,9873,All
2023,8,ALLAHABAD,MUMBAI,5408,5730,ALLAHABAD-MUMBAI,11138,All
2023,9,ALLAHABAD,MUMBAI,5444,6041,ALLAHABAD-MUMBAI,11485,All
2023,10,ALLAHABAD,MUMBAI,5100,6519,ALLAHABAD-MUMBAI,11619,All
2023,11,ALLAHABAD,MUMBAI,4584,5404,ALLAHABAD-MUMBAI,9988,All
2023,12,ALLAHABAD,MUMBAI,4835,4791,ALLAHABAD-MUMBAI,9626,All
2024,1,ALLAHABAD,MUMBAI,4139,4270,ALLAHABAD-MUMBAI,8409,All
2024,2,ALLAHABAD,MUMBAI,4707,5121,ALLAHABAD-MUMBAI,9828,All
2024,3,ALLAHABAD,MUMBAI,5011,5549,ALLAHABAD-MUMBAI,10560,All
2024,4,ALLAHABAD,MUMBAI,4548,5323,ALLAHABAD-MUMBAI,9871,All
2024,6,ALLAHABAD,MUMBAI,10121,8567,ALLAHABAD-MUMBAI,18688,All
2024,7,ALLAHABAD,MUMBAI,8957,7945,ALLAHABAD-MUMBAI,16902,All
2024,8,ALLAHABAD,MUMBAI,9502,8014,ALLAHABAD-MUMBAI,17516,All
2024,9,ALLAHABAD,MUMBAI,8752,9125,ALLAHABAD-MUMBAI,17877,All
2024,10,ALLAHABAD,MUMBAI,6687,10257,ALLAHABAD-MUMBAI,16944,All
2024,11,ALLAHABAD,MUMBAI,11696,12249,ALLAHABAD-MUMBAI,23945,All
2024,12,ALLAHABAD,MUMBAI,11515,11143,ALLAHABAD-MUMBAI,22658,All
2018,6,ALLAHABAD,NAGPUR,443,434,ALLAHABAD-NAGPUR,877,All
2018,7,ALLAHABAD,NAGPUR,591,624,ALLAHABAD-NAGPUR,1215,All
2018,8,ALLAHABAD,NAGPUR,586,619,ALLAHABAD-NAGPUR,1205,All
2018,9,ALLAHABAD,NAGPUR,571,638,ALLAHABAD-NAGPUR,1209,All
2018,10,ALLAHABAD,NAGPUR,614,722,ALLAHABAD-NAGPUR,1336,All
2018,11,ALLAHABAD,NAGPUR,661,666,ALLAHABAD-NAGPUR,1327,All
2018,12,ALLAHABAD,NAGPUR,805,745,ALLAHABAD-NAGPUR,1550,All
2019,1,ALLAHABAD,NAGPUR,677,709,ALLAHABAD-NAGPUR,1386,All
2019,2,ALLAHABAD,NAGPUR,748,785,ALLAHABAD-NAGPUR,1533,All
2019,3,ALLAHABAD,NAGPUR,689,681,ALLAHABAD-NAGPUR,1370,All
2019,4,ALLAHABAD,NAGPUR,184,225,ALLAHABAD-NAGPUR,409,All
2018,6,ALLAHABAD,PATNA,340,290,ALLAHABAD-PATNA,630,All
2018,7,ALLAHABAD,PATNA,353,400,ALLAHABAD-PATNA,753,All
2018,8,ALLAHABAD,PATNA,320,288,ALLAHABAD-PATNA,608,All
2018,9,ALLAHABAD,PATNA,347,364,ALLAHABAD-PATNA,711,All
2018,10,ALLAHABAD,PATNA,404,361,ALLAHABAD-PATNA,765,All
2018,11,ALLAHABAD,PATNA,511,474,ALLAHABAD-PATNA,985,All
2018,12,ALLAHABAD,PATNA,519,476,ALLAHABAD-PATNA,995,All
2019,1,ALLAHABAD,PATNA,586,642,ALLAHABAD-PATNA,1228,All
2019,2,ALLAHABAD,PATNA,615,595,ALLAHABAD-PATNA,1210,All
2019,3,ALLAHABAD,PATNA,438,328,ALLAHABAD-PATNA,766,All
2019,4,ALLAHABAD,PATNA,64,61,ALLAHABAD-PATNA,125,All
2020,3,ALLAHABAD,PUNE,1611,2996,ALLAHABAD-PUNE,4607,All
2020,6,ALLAHABAD,PUNE,650,2225,ALLAHABAD-PUNE,2875,All
2020,7,ALLAHABAD,PUNE,1484,2888,ALLAHABAD-PUNE,4372,All
2020,8,ALLAHABAD,PUNE,3117,1616,ALLAHABAD-PUNE,4733,All
2020,9,ALLAHABAD,PUNE,3772,1766,ALLAHABAD-PUNE,5538,All
2020,10,ALLAHABAD,PUNE,3160,2514,ALLAHABAD-PUNE,5674,All
2020,11,ALLAHABAD,PUNE,3274,4008,ALLAHABAD-PUNE,7282,All
2020,12,ALLAHABAD,PUNE,4510,3063,ALLAHABAD-PUNE,7573,All
2021,1,ALLAHABAD,PUNE,3522,2226,ALLAHABAD-PUNE,5748,All
2021,2,ALLAHABAD,PUNE,2671,2487,ALLAHABAD-PUNE,5158,All
2021,3,ALLAHABAD,PUNE,2140,3204,ALLAHABAD-PUNE,5344,All
2021,4,ALLAHABAD,PUNE,1322,3253,ALLAHABAD-PUNE,4575,All
2021,6,ALLAHABAD,PUNE,2690,1308,ALLAHABAD-PUNE,3998,All
2021,7,ALLAHABAD,PUNE,2760,2025,ALLAHABAD-PUNE,4785,All
2021,8,ALLAHABAD,PUNE,1057,641,ALLAHABAD-PUNE,1698,All
2021,9,ALLAHABAD,PUNE,1412,1289,ALLAHABAD-PUNE,2701,All
2021,10,ALLAHABAD,PUNE,713,1066,ALLAHABAD-PUNE,1779,All
2021,11,ALLAHABAD,PUNE,3530,4027,ALLAHABAD-PUNE,7557,All
2021,12,ALLAHABAD,PUNE,4354,3132,ALLAHABAD-PUNE,7486,All
2022,1,ALLAHABAD,PUNE,1499,2219,ALLAHABAD-PUNE,3718,All
2022,2,ALLAHABAD,PUNE,1755,1707,ALLAHABAD-PUNE,3462,All
2022,3,ALLAHABAD,PUNE,2822,3034,ALLAHABAD-PUNE,5856,All
2022,4,ALLAHABAD,PUNE,1870,2062,ALLAHABAD-PUNE,3932,All
2022,5,ALLAHABAD,PUNE,2349,2393,ALLAHABAD-PUNE,4742,All
2022,6,ALLAHABAD,PUNE,2293,2063,ALLAHABAD-PUNE,4356,All
2022,7,ALLAHABAD,PUNE,1985,1894,ALLAHABAD-PUNE,3879,All
2022,8,ALLAHABAD,PUNE,1940,1803,ALLAHABAD-PUNE,3743,All
2022,9,ALLAHABAD,PUNE,1547,1768,ALLAHABAD-PUNE,3315,All
2022,10,ALLAHABAD,PUNE,1548,1978,ALLAHABAD-PUNE,3526,All
2022,11,ALLAHABAD,PUNE,1537,1530,ALLAHABAD-PUNE,3067,All
2022,12,ALLAHABAD,PUNE,1435,1218,ALLAHABAD-PUNE,2653,All
2023,1,ALLAHABAD,PUNE,1298,1355,ALLAHABAD-PUNE,2653,All
2023,2,ALLAHABAD,PUNE,1696,1602,ALLAHABAD-PUNE,3298,All
2023,3,ALLAHABAD,PUNE,1823,1724,ALLAHABAD-PUNE,3547,All
2023,4,ALLAHABAD,PUNE,1485,1812,ALLAHABAD-PUNE,3297,All
2023,5,ALLAHABAD,PUNE,2200,2273,ALLAHABAD-PUNE,4473,All
2023,6,ALLAHABAD,PUNE,2796,1896,ALLAHABAD-PUNE,4692,All
2023,7,ALLAHABAD,PUNE,2137,1407,ALLAHABAD-PUNE,3544,All
2023,8,ALLAHABAD,PUNE,1886,1801,ALLAHABAD-PUNE,3687,All
2023,9,ALLAHABAD,PUNE,1877,1654,ALLAHABAD-PUNE,3531,All
2023,10,ALLAHABAD,PUNE,1887,1804,ALLAHABAD-PUNE,3691,All
2023,11,ALLAHABAD,PUNE,1778,2266,ALLAHABAD-PUNE,4044,All
2023,12,ALLAHABAD,PUNE,1968,1817,ALLAHABAD-PUNE,3785,All
2024,1,ALLAHABAD,PUNE,1545,1644,ALLAHABAD-PUNE,3189,All
2024,2,ALLAHABAD,PUNE,2103,2413,ALLAHABAD-PUNE,4516,All
2024,3,ALLAHABAD,PUNE,1933,2113,ALLAHABAD-PUNE,4046,All
2019,6,ALLAHABAD,RAIPUR,212,207,ALLAHABAD-RAIPUR,419,All
2019,7,ALLAHABAD,RAIPUR,1489,1701,ALLAHABAD-RAIPUR,3190,All
2019,8,ALLAHABAD,RAIPUR,1363,1666,ALLAHABAD-RAIPUR,3029,All
2019,9,ALLAHABAD,RAIPUR,1300,1682,ALLAHABAD-RAIPUR,2982,All
2019,10,ALLAHABAD,RAIPUR,1654,2051,ALLAHABAD-RAIPUR,3705,All
2019,11,ALLAHABAD,RAIPUR,1893,2105,ALLAHABAD-RAIPUR,3998,All
2019,12,ALLAHABAD,RAIPUR,1907,1950,ALLAHABAD-RAIPUR,3857,All
2020,1,ALLAHABAD,RAIPUR,1520,1834,ALLAHABAD-RAIPUR,3354,All
2020,2,ALLAHABAD,RAIPUR,1779,2097,ALLAHABAD-RAIPUR,3876,All
2020,3,ALLAHABAD,RAIPUR,1319,1480,ALLAHABAD-RAIPUR,2799,All
2020,10,ALLAHABAD,RAIPUR,293,414,ALLAHABAD-RAIPUR,707,All
2020,11,ALLAHABAD,RAIPUR,1575,1877,ALLAHABAD-RAIPUR,3452,All
2020,12,ALLAHABAD,RAIPUR,1967,1677,ALLAHABAD-RAIPUR,3644,All
2021,1,ALLAHABAD,RAIPUR,1358,1377,ALLAHABAD-RAIPUR,2735,All
2021,2,ALLAHABAD,RAIPUR,1353,1515,ALLAHABAD-RAIPUR,2868,All
2021,3,ALLAHABAD,RAIPUR,1105,1387,ALLAHABAD-RAIPUR,2492,All
2021,4,ALLAHABAD,RAIPUR,266,493,ALLAHABAD-RAIPUR,759,All
2021,7,ALLAHABAD,RAIPUR,520,568,ALLAHABAD-RAIPUR,1088,All
2021,8,ALLAHABAD,RAIPUR,1422,1358,ALLAHABAD-RAIPUR,2780,All
2021,9,ALLAHABAD,RAIPUR,1014,1415,ALLAHABAD-RAIPUR,2429,All
2021,10,ALLAHABAD,RAIPUR,1423,1812,ALLAHABAD-RAIPUR,3235,All
2021,11,ALLAHABAD,RAIPUR,1821,1964,ALLAHABAD-RAIPUR,3785,All
2021,12,ALLAHABAD,RAIPUR,2124,1904,ALLAHABAD-RAIPUR,4028,All
2022,1,ALLAHABAD,RAIPUR,1012,917,ALLAHABAD-RAIPUR,1929,All
2022,2,ALLAHABAD,RAIPUR,784,801,ALLAHABAD-RAIPUR,1585,All
2022,3,ALLAHABAD,RAIPUR,1889,1809,ALLAHABAD-RAIPUR,3698,All
2022,4,ALLAHABAD,RAIPUR,1997,1881,ALLAHABAD-RAIPUR,3878,All
2022,5,ALLAHABAD,RAIPUR,2047,2042,ALLAHABAD-RAIPUR,4089,All
2022,6,ALLAHABAD,RAIPUR,2160,1826,ALLAHABAD-RAIPUR,3986,All
2022,7,ALLAHABAD,RAIPUR,1892,1766,ALLAHABAD-RAIPUR,3658,All
2022,8,ALLAHABAD,RAIPUR,1698,1752,ALLAHABAD-RAIPUR,3450,All
2022,9,ALLAHABAD,RAIPUR,1481,1833,ALLAHABAD-RAIPUR,3314,All
2022,10,ALLAHABAD,RAIPUR,1707,1755,ALLAHABAD-RAIPUR,3462,All
2022,11,ALLAHABAD,RAIPUR,1935,1526,ALLAHABAD-RAIPUR,3461,All
2022,12,ALLAHABAD,RAIPUR,2047,1642,ALLAHABAD-RAIPUR,3689,All
2023,1,ALLAHABAD,RAIPUR,1291,1331,ALLAHABAD-RAIPUR,2622,All
2023,2,ALLAHABAD,RAIPUR,1683,1845,ALLAHABAD-RAIPUR,3528,All
2023,3,ALLAHABAD,RAIPUR,1844,1868,ALLAHABAD-RAIPUR,3712,All
2023,4,ALLAHABAD,RAIPUR,1786,2037,ALLAHABAD-RAIPUR,3823,All
2023,5,ALLAHABAD,RAIPUR,2081,2221,ALLAHABAD-RAIPUR,4302,All
2023,6,ALLAHABAD,RAIPUR,2155,2063,ALLAHABAD-RAIPUR,4218,All
2023,7,ALLAHABAD,RAIPUR,1562,1955,ALLAHABAD-RAIPUR,3517,All
2023,8,ALLAHABAD,RAIPUR,1591,1908,ALLAHABAD-RAIPUR,3499,All
2023,9,ALLAHABAD,RAIPUR,1800,1916,ALLAHABAD-RAIPUR,3716,All
2023,10,ALLAHABAD,RAIPUR,1356,1273,ALLAHABAD-RAIPUR,2629,All
2024,8,ALLAHABAD,RAIPUR,575,719,ALLAHABAD-RAIPUR,1294,All
2024,9,ALLAHABAD,RAIPUR,1189,1547,ALLAHABAD-RAIPUR,2736,All
2024,10,ALLAHABAD,RAIPUR,1510,1807,ALLAHABAD-RAIPUR,3317,All
2024,11,ALLAHABAD,RAIPUR,1918,1933,ALLAHABAD-RAIPUR,3851,All
2024,12,ALLAHABAD,RAIPUR,2137,1803,ALLAHABAD-RAIPUR,3940,All
2023,6,ALLAHABAD,VARANASI,0,55,ALLAHABAD-VARANASI,55,All
2023,8,ALLAHABAD,VARANASI,0,200,ALLAHABAD-VARANASI,200,All
2023,9,ALLAHABAD,VARANASI,208,0,ALLAHABAD-VARANASI,208,All
2024,3,ALLAHABAD,VARANASI,174,0,ALLAHABAD-VARANASI,174,All
2017,5,AMRITSAR,BAGDOGRA,0,29,AMRITSAR-BAGDOGRA,29,All
2017,6,AMRITSAR,BAGDOGRA,0,97,AMRITSAR-BAGDOGRA,97,All
2017,7,AMRITSAR,BAGDOGRA,0,180,AMRITSAR-BAGDOGRA,180,All
2017,8,AMRITSAR,BAGDOGRA,0,132,AMRITSAR-BAGDOGRA,132,All
2017,9,AMRITSAR,BAGDOGRA,0,184,AMRITSAR-BAGDOGRA,184,All
2017,10,AMRITSAR,BAGDOGRA,0,81,AMRITSAR-BAGDOGRA,81,All
2017,11,AMRITSAR,BAGDOGRA,0,160,AMRITSAR-BAGDOGRA,160,All
2017,12,AMRITSAR,BAGDOGRA,0,128,AMRITSAR-BAGDOGRA,128,All
2018,1,AMRITSAR,BAGDOGRA,0,115,AMRITSAR-BAGDOGRA,115,All
2018,2,AMRITSAR,BAGDOGRA,0,205,AMRITSAR-BAGDOGRA,205,All
2018,3,AMRITSAR,BAGDOGRA,0,238,AMRITSAR-BAGDOGRA,238,All
2018,4,AMRITSAR,BAGDOGRA,0,146,AMRITSAR-BAGDOGRA,146,All
2018,5,AMRITSAR,BAGDOGRA,0,101,AMRITSAR-BAGDOGRA,101,All
2018,6,AMRITSAR,BAGDOGRA,0,325,AMRITSAR-BAGDOGRA,325,All
2018,7,AMRITSAR,BAGDOGRA,0,200,AMRITSAR-BAGDOGRA,200,All
2018,8,AMRITSAR,BAGDOGRA,0,143,AMRITSAR-BAGDOGRA,143,All
2018,9,AMRITSAR,BAGDOGRA,0,218,AMRITSAR-BAGDOGRA,218,All
2018,10,AMRITSAR,BAGDOGRA,0,484,AMRITSAR-BAGDOGRA,484,All
2018,11,AMRITSAR,BAGDOGRA,0,325,AMRITSAR-BAGDOGRA,325,All
2018,12,AMRITSAR,BAGDOGRA,0,166,AMRITSAR-BAGDOGRA,166,All
2019,1,AMRITSAR,BAGDOGRA,0,300,AMRITSAR-BAGDOGRA,300,All
2019,2,AMRITSAR,BAGDOGRA,0,368,AMRITSAR-BAGDOGRA,368,All
2019,3,AMRITSAR,BAGDOGRA,0,332,AMRITSAR-BAGDOGRA,332,All
2019,4,AMRITSAR,BAGDOGRA,0,262,AMRITSAR-BAGDOGRA,262,All
2019,5,AMRITSAR,BAGDOGRA,0,118,AMRITSAR-BAGDOGRA,118,All
2019,6,AMRITSAR,BAGDOGRA,0,235,AMRITSAR-BAGDOGRA,235,All
2019,7,AMRITSAR,BAGDOGRA,0,241,AMRITSAR-BAGDOGRA,241,All
2019,8,AMRITSAR,BAGDOGRA,0,130,AMRITSAR-BAGDOGRA,130,All
2019,9,AMRITSAR,BAGDOGRA,0,100,AMRITSAR-BAGDOGRA,100,All
2019,10,AMRITSAR,BAGDOGRA,0,332,AMRITSAR-BAGDOGRA,332,All
2019,11,AMRITSAR,BAGDOGRA,0,238,AMRITSAR-BAGDOGRA,238,All
2019,12,AMRITSAR,BAGDOGRA,0,418,AMRITSAR-BAGDOGRA,418,All
2020,1,AMRITSAR,BAGDOGRA,0,351,AMRITSAR-BAGDOGRA,351,All
2020,2,AMRITSAR,BAGDOGRA,0,145,AMRITSAR-BAGDOGRA,145,All
2020,3,AMRITSAR,BAGDOGRA,0,173,AMRITSAR-BAGDOGRA,173,All
2021,8,AMRITSAR,BAGDOGRA,57,0,AMRITSAR-BAGDOGRA,57,All
2015,7,AMRITSAR,BENGALURU,152,156,AMRITSAR-BENGALURU,308,All
2015,8,AMRITSAR,BENGALURU,113,126,AMRITSAR-BENGALURU,239,All
2015,9,AMRITSAR,BENGALURU,87,148,AMRITSAR-BENGALURU,235,All
2015,10,AMRITSAR,BENGALURU,199,343,AMRITSAR-BENGALURU,542,All
2015,11,AMRITSAR,BENGALURU,141,159,AMRITSAR-BENGALURU,300,All
2015,12,AMRITSAR,BENGALURU,205,181,AMRITSAR-BENGALURU,386,All
2016,1,AMRITSAR,BENGALURU,124,184,AMRITSAR-BENGALURU,308,All
2016,2,AMRITSAR,BENGALURU,262,212,AMRITSAR-BENGALURU,474,All
2016,3,AMRITSAR,BENGALURU,195,301,AMRITSAR-BENGALURU,496,All
2016,4,AMRITSAR,BENGALURU,208,217,AMRITSAR-BENGALURU,425,All
2016,5,AMRITSAR,BENGALURU,146,87,AMRITSAR-BENGALURU,233,All
2016,6,AMRITSAR,BENGALURU,159,122,AMRITSAR-BENGALURU,281,All
2016,7,AMRITSAR,BENGALURU,144,203,AMRITSAR-BENGALURU,347,All
2016,8,AMRITSAR,BENGALURU,160,128,AMRITSAR-BENGALURU,288,All
2016,9,AMRITSAR,BENGALURU,99,151,AMRITSAR-BENGALURU,250,All
2016,10,AMRITSAR,BENGALURU,236,314,AMRITSAR-BENGALURU,550,All
2016,11,AMRITSAR,BENGALURU,170,134,AMRITSAR-BENGALURU,304,All
2016,12,AMRITSAR,BENGALURU,161,156,AMRITSAR-BENGALURU,317,All
2017,1,AMRITSAR,BENGALURU,208,193,AMRITSAR-BENGALURU,401,All
2017,2,AMRITSAR,BENGALURU,113,117,AMRITSAR-BENGALURU,230,All
2017,3,AMRITSAR,BENGALURU,198,231,AMRITSAR-BENGALURU,429,All
2017,4,AMRITSAR,BENGALURU,176,228,AMRITSAR-BENGALURU,404,All
2017,5,AMRITSAR,BENGALURU,181,97,AMRITSAR-BENGALURU,278,All
2017,6,AMRITSAR,BENGALURU,177,198,AMRITSAR-BENGALURU,375,All
2017,7,AMRITSAR,BENGALURU,320,243,AMRITSAR-BENGALURU,563,All
2017,8,AMRITSAR,BENGALURU,405,374,AMRITSAR-BENGALURU,779,All
2017,9,AMRITSAR,BENGALURU,446,816,AMRITSAR-BENGALURU,1262,All
2017,10,AMRITSAR,BENGALURU,2612,2502,AMRITSAR-BENGALURU,5114,All
2017,11,AMRITSAR,BENGALURU,2775,3040,AMRITSAR-BENGALURU,5815,All
2017,12,AMRITSAR,BENGALURU,2892,3275,AMRITSAR-BENGALURU,6167,All
2018,1,AMRITSAR,BENGALURU,2406,2651,AMRITSAR-BENGALURU,5057,All
2018,2,AMRITSAR,BENGALURU,2892,2993,AMRITSAR-BENGALURU,5885,All
2018,3,AMRITSAR,BENGALURU,3358,2950,AMRITSAR-BENGALURU,6308,All
2018,4,AMRITSAR,BENGALURU,3622,2980,AMRITSAR-BENGALURU,6602,All
2018,5,AMRITSAR,BENGALURU,3855,3048,AMRITSAR-BENGALURU,6903,All
2018,6,AMRITSAR,BENGALURU,3826,3161,AMRITSAR-BENGALURU,6987,All
2018,7,AMRITSAR,BENGALURU,3431,3449,AMRITSAR-BENGALURU,6880,All
2018,8,AMRITSAR,BENGALURU,6015,6311,AMRITSAR-BENGALURU,12326,All
2018,9,AMRITSAR,BENGALURU,5871,6423,AMRITSAR-BENGALURU,12294,All
2018,10,AMRITSAR,BENGALURU,6851,8106,AMRITSAR-BENGALURU,14957,All
2018,11,AMRITSAR,BENGALURU,5972,5836,AMRITSAR-BENGALURU,11808,All
2018,12,AMRITSAR,BENGALURU,9568,9606,AMRITSAR-BENGALURU,19174,All
2019,1,AMRITSAR,BENGALURU,7592,8333,AMRITSAR-BENGALURU,15925,All
2019,2,AMRITSAR,BENGALURU,4809,4570,AMRITSAR-BENGALURU,9379,All
2019,3,AMRITSAR,BENGALURU,4115,3070,AMRITSAR-BENGALURU,7185,All
2019,4,AMRITSAR,BENGALURU,3911,3723,AMRITSAR-BENGALURU,7634,All
2019,5,AMRITSAR,BENGALURU,4162,3151,AMRITSAR-BENGALURU,7313,All
2019,6,AMRITSAR,BENGALURU,4040,3042,AMRITSAR-BENGALURU,7082,All
2019,7,AMRITSAR,BENGALURU,2299,2112,AMRITSAR-BENGALURU,4411,All
2019,8,AMRITSAR,BENGALURU,2192,2522,AMRITSAR-BENGALURU,4714,All
2019,9,AMRITSAR,BENGALURU,2343,3112,AMRITSAR-BENGALURU,5455,All
2019,10,AMRITSAR,BENGALURU,3109,3971,AMRITSAR-BENGALURU,7080,All
2019,11,AMRITSAR,BENGALURU,3865,3354,AMRITSAR-BENGALURU,7219,All
2019,12,AMRITSAR,BENGALURU,3168,3505,AMRITSAR-BENGALURU,6673,All
2020,1,AMRITSAR,BENGALURU,2928,3131,AMRITSAR-BENGALURU,6059,All
2020,2,AMRITSAR,BENGALURU,3380,2745,AMRITSAR-BENGALURU,6125,All
2020,3,AMRITSAR,BENGALURU,2512,1527,AMRITSAR-BENGALURU,4039,All
2020,6,AMRITSAR,BENGALURU,725,1078,AMRITSAR-BENGALURU,1803,All
2020,7,AMRITSAR,BENGALURU,1187,2247,AMRITSAR-BENGALURU,3434,All
2020,8,AMRITSAR,BENGALURU,1224,2067,AMRITSAR-BENGALURU,3291,All
2020,9,AMRITSAR,BENGALURU,1480,2032,AMRITSAR-BENGALURU,3512,All
2020,10,AMRITSAR,BENGALURU,1807,2511,AMRITSAR-BENGALURU,4318,All
2020,11,AMRITSAR,BENGALURU,2364,2229,AMRITSAR-BENGALURU,4593,All
2020,12,AMRITSAR,BENGALURU,3406,2627,AMRITSAR-BENGALURU,6033,All
2021,1,AMRITSAR,BENGALURU,3013,2537,AMRITSAR-BENGALURU,5550,All
2021,2,AMRITSAR,BENGALURU,2527,2392,AMRITSAR-BENGALURU,4919,All
2021,3,AMRITSAR,BENGALURU,2117,2450,AMRITSAR-BENGALURU,4567,All
2021,4,AMRITSAR,BENGALURU,643,1242,AMRITSAR-BENGALURU,1885,All
2021,6,AMRITSAR,BENGALURU,505,626,AMRITSAR-BENGALURU,1131,All
2021,7,AMRITSAR,BENGALURU,1861,1931,AMRITSAR-BENGALURU,3792,All
2021,8,AMRITSAR,BENGALURU,1729,1875,AMRITSAR-BENGALURU,3604,All
2021,9,AMRITSAR,BENGALURU,1731,2058,AMRITSAR-BENGALURU,3789,All
2021,10,AMRITSAR,BENGALURU,2565,3594,AMRITSAR-BENGALURU,6159,All
2021,11,AMRITSAR,BENGALURU,3383,3488,AMRITSAR-BENGALURU,6871,All
2021,12,AMRITSAR,BENGALURU,3544,3448,AMRITSAR-BENGALURU,6992,All
2022,1,AMRITSAR,BENGALURU,2219,2293,AMRITSAR-BENGALURU,4512,All
2022,2,AMRITSAR,BENGALURU,1563,1895,AMRITSAR-BENGALURU,3458,All
2022,3,AMRITSAR,BENGALURU,2872,3403,AMRITSAR-BENGALURU,6275,All
2022,4,AMRITSAR,BENGALURU,2377,3103,AMRITSAR-BENGALURU,5480,All
2022,5,AMRITSAR,BENGALURU,2277,1915,AMRITSAR-BENGALURU,4192,All
2022,6,AMRITSAR,BENGALURU,2457,1782,AMRITSAR-BENGALURU,4239,All
2022,7,AMRITSAR,BENGALURU,2391,1916,AMRITSAR-BENGALURU,4307,All
2022,8,AMRITSAR,BENGALURU,2595,2434,AMRITSAR-BENGALURU,5029,All
2022,9,AMRITSAR,BENGALURU,2854,2903,AMRITSAR-BENGALURU,5757,All
2022,10,AMRITSAR,BENGALURU,3519,4246,AMRITSAR-BENGALURU,7765,All
2022,11,AMRITSAR,BENGALURU,3601,4110,AMRITSAR-BENGALURU,7711,All
2022,12,AMRITSAR,BENGALURU,3117,3012,AMRITSAR-BENGALURU,6129,All
2023,1,AMRITSAR,BENGALURU,2617,2791,AMRITSAR-BENGALURU,5408,All
2023,2,AMRITSAR,BENGALURU,2810,3120,AMRITSAR-BENGALURU,5930,All
2023,3,AMRITSAR,BENGALURU,3123,2521,AMRITSAR-BENGALURU,5644,All
2023,4,AMRITSAR,BENGALURU,2100,1576,AMRITSAR-BENGALURU,3676,All
2023,5,AMRITSAR,BENGALURU,1584,1227,AMRITSAR-BENGALURU,2811,All
2023,6,AMRITSAR,BENGALURU,2125,1746,AMRITSAR-BENGALURU,3871,All
2023,7,AMRITSAR,BENGALURU,2061,2032,AMRITSAR-BENGALURU,4093,All
2023,8,AMRITSAR,BENGALURU,2482,2733,AMRITSAR-BENGALURU,5215,All
2023,9,AMRITSAR,BENGALURU,3336,3300,AMRITSAR-BENGALURU,6636,All
2023,10,AMRITSAR,BENGALURU,2726,3113,AMRITSAR-BENGALURU,5839,All
2023,11,AMRITSAR,BENGALURU,3055,3692,AMRITSAR-BENGALURU,6747,All
2023,12,AMRITSAR,BENGALURU,2881,3682,AMRITSAR-BENGALURU,6563,All
2024,1,AMRITSAR,BENGALURU,3579,4133,AMRITSAR-BENGALURU,7712,All
2024,2,AMRITSAR,BENGALURU,3542,3378,AMRITSAR-BENGALURU,6920,All
2024,3,AMRITSAR,BENGALURU,3870,3576,AMRITSAR-BENGALURU,7446,All
2024,4,AMRITSAR,BENGALURU,2960,2508,AMRITSAR-BENGALURU,5468,All
2024,6,AMRITSAR,BENGALURU,2847,2143,AMRITSAR-BENGALURU,4990,All
2024,7,AMRITSAR,BENGALURU,4162,4303,AMRITSAR-BENGALURU,8465,All
2024,8,AMRITSAR,BENGALURU,3691,4139,AMRITSAR-BENGALURU,7830,All
2024,9,AMRITSAR,BENGALURU,3691,4410,AMRITSAR-BENGALURU,8101,All
2024,10,AMRITSAR,BENGALURU,4552,5674,AMRITSAR-BENGALURU,10226,All
2024,11,AMRITSAR,BENGALURU,4632,4641,AMRITSAR-BENGALURU,9273,All
2024,12,AMRITSAR,BENGALURU,6009,5258,AMRITSAR-BENGALURU,11267,All
2025,1,AMRITSAR,BENGALURU,8334,6886,AMRITSAR-BENGALURU,15220,All
2025,2,AMRITSAR,BENGALURU,5783,5854,AMRITSAR-BENGALURU,11637,All
2025,3,AMRITSAR,BENGALURU,6535,5570,AMRITSAR-BENGALURU,12105,All
2019,9,AMRITSAR,BHUBANESWAR,83,0,AMRITSAR-BHUBANESWAR,83,All
2019,10,AMRITSAR,BHUBANESWAR,118,0,AMRITSAR-BHUBANESWAR,118,All
2019,11,AMRITSAR,BHUBANESWAR,155,0,AMRITSAR-BHUBANESWAR,155,All
2019,12,AMRITSAR,BHUBANESWAR,227,0,AMRITSAR-BHUBANESWAR,227,All
2020,1,AMRITSAR,BHUBANESWAR,206,0,AMRITSAR-BHUBANESWAR,206,All
2020,2,AMRITSAR,BHUBANESWAR,178,0,AMRITSAR-BHUBANESWAR,178,All
2020,3,AMRITSAR,BHUBANESWAR,102,0,AMRITSAR-BHUBANESWAR,102,All
2018,10,AMRITSAR,CHANDIGARH,0,2,AMRITSAR-CHANDIGARH,2,All
2019,11,AMRITSAR,CHANDIGARH,0,33,AMRITSAR-CHANDIGARH,33,All
2022,1,AMRITSAR,CHANDIGARH,230,532,AMRITSAR-CHANDIGARH,762,All
2022,6,AMRITSAR,CHANDIGARH,89,427,AMRITSAR-CHANDIGARH,516,All
2022,8,AMRITSAR,CHANDIGARH,223,46,AMRITSAR-CHANDIGARH,269,All
2022,9,AMRITSAR,CHANDIGARH,64,0,AMRITSAR-CHANDIGARH,64,All
2022,10,AMRITSAR,CHANDIGARH,0,90,AMRITSAR-CHANDIGARH,90,All
2022,11,AMRITSAR,CHANDIGARH,96,80,AMRITSAR-CHANDIGARH,176,All
2023,6,AMRITSAR,CHANDIGARH,0,45,AMRITSAR-CHANDIGARH,45,All
2024,6,AMRITSAR,CHANDIGARH,166,0,AMRITSAR-CHANDIGARH,166,All
2024,11,AMRITSAR,CHANDIGARH,0,311,AMRITSAR-CHANDIGARH,311,All
2025,2,AMRITSAR,CHANDIGARH,122,0,AMRITSAR-CHANDIGARH,122,All
2015,4,AMRITSAR,CHENNAI,236,455,AMRITSAR-CHENNAI,691,All
2015,5,AMRITSAR,CHENNAI,302,520,AMRITSAR-CHENNAI,822,All
2015,6,AMRITSAR,CHENNAI,345,264,AMRITSAR-CHENNAI,609,All
2015,7,AMRITSAR,CHENNAI,263,289,AMRITSAR-CHENNAI,552,All
2015,8,AMRITSAR,CHENNAI,146,157,AMRITSAR-CHENNAI,303,All
2015,9,AMRITSAR,CHENNAI,148,196,AMRITSAR-CHENNAI,344,All
2015,10,AMRITSAR,CHENNAI,151,331,AMRITSAR-CHENNAI,482,All
2015,11,AMRITSAR,CHENNAI,302,516,AMRITSAR-CHENNAI,818,All
2015,12,AMRITSAR,CHENNAI,295,206,AMRITSAR-CHENNAI,501,All
2016,1,AMRITSAR,CHENNAI,331,186,AMRITSAR-CHENNAI,517,All
2016,2,AMRITSAR,CHENNAI,258,217,AMRITSAR-CHENNAI,475,All
2016,3,AMRITSAR,CHENNAI,424,283,AMRITSAR-CHENNAI,707,All
2016,4,AMRITSAR,CHENNAI,356,213,AMRITSAR-CHENNAI,569,All
2016,5,AMRITSAR,CHENNAI,271,154,AMRITSAR-CHENNAI,425,All
2016,6,AMRITSAR,CHENNAI,128,144,AMRITSAR-CHENNAI,272,All
2016,7,AMRITSAR,CHENNAI,132,123,AMRITSAR-CHENNAI,255,All
2016,8,AMRITSAR,CHENNAI,121,141,AMRITSAR-CHENNAI,262,All
2016,9,AMRITSAR,CHENNAI,105,232,AMRITSAR-CHENNAI,337,All
2016,10,AMRITSAR,CHENNAI,168,378,AMRITSAR-CHENNAI,546,All
2016,11,AMRITSAR,CHENNAI,232,405,AMRITSAR-CHENNAI,637,All
2016,12,AMRITSAR,CHENNAI,309,295,AMRITSAR-CHENNAI,604,All
2017,1,AMRITSAR,CHENNAI,213,190,AMRITSAR-CHENNAI,403,All
2017,2,AMRITSAR,CHENNAI,30,28,AMRITSAR-CHENNAI,58,All
2017,3,AMRITSAR,CHENNAI,138,132,AMRITSAR-CHENNAI,270,All
2017,4,AMRITSAR,CHENNAI,207,407,AMRITSAR-CHENNAI,614,All
2017,5,AMRITSAR,CHENNAI,137,420,AMRITSAR-CHENNAI,557,All
2017,6,AMRITSAR,CHENNAI,155,318,AMRITSAR-CHENNAI,473,All
2017,7,AMRITSAR,CHENNAI,225,266,AMRITSAR-CHENNAI,491,All
2017,8,AMRITSAR,CHENNAI,310,277,AMRITSAR-CHENNAI,587,All
2017,9,AMRITSAR,CHENNAI,270,338,AMRITSAR-CHENNAI,608,All
2017,10,AMRITSAR,CHENNAI,279,272,AMRITSAR-CHENNAI,551,All
2017,11,AMRITSAR,CHENNAI,129,0,AMRITSAR-CHENNAI,129,All
2017,12,AMRITSAR,CHENNAI,240,0,AMRITSAR-CHENNAI,240,All
2018,1,AMRITSAR,CHENNAI,232,0,AMRITSAR-CHENNAI,232,All
2018,2,AMRITSAR,CHENNAI,170,0,AMRITSAR-CHENNAI,170,All
2018,3,AMRITSAR,CHENNAI,140,0,AMRITSAR-CHENNAI,140,All
2021,3,AMRITSAR,CHENNAI,1,0,AMRITSAR-CHENNAI,1,All
2021,4,AMRITSAR,CHENNAI,18,0,AMRITSAR-CHENNAI,18,All
2022,3,AMRITSAR,CHENNAI,27,60,AMRITSAR-CHENNAI,87,All
2022,4,AMRITSAR,CHENNAI,187,146,AMRITSAR-CHENNAI,333,All
2022,5,AMRITSAR,CHENNAI,104,191,AMRITSAR-CHENNAI,295,All
2022,6,AMRITSAR,CHENNAI,100,271,AMRITSAR-CHENNAI,371,All
2022,7,AMRITSAR,CHENNAI,97,175,AMRITSAR-CHENNAI,272,All
2022,8,AMRITSAR,CHENNAI,132,134,AMRITSAR-CHENNAI,266,All
2022,9,AMRITSAR,CHENNAI,156,287,AMRITSAR-CHENNAI,443,All
2022,10,AMRITSAR,CHENNAI,138,265,AMRITSAR-CHENNAI,403,All
2022,11,AMRITSAR,CHENNAI,248,347,AMRITSAR-CHENNAI,595,All
2022,12,AMRITSAR,CHENNAI,246,250,AMRITSAR-CHENNAI,496,All
2023,1,AMRITSAR,CHENNAI,323,504,AMRITSAR-CHENNAI,827,All
2023,2,AMRITSAR,CHENNAI,179,118,AMRITSAR-CHENNAI,297,All
2023,3,AMRITSAR,CHENNAI,263,292,AMRITSAR-CHENNAI,555,All
2023,4,AMRITSAR,CHENNAI,73,103,AMRITSAR-CHENNAI,176,All
2023,5,AMRITSAR,CHENNAI,93,146,AMRITSAR-CHENNAI,239,All
2023,6,AMRITSAR,CHENNAI,140,111,AMRITSAR-CHENNAI,251,All
2023,7,AMRITSAR,CHENNAI,111,158,AMRITSAR-CHENNAI,269,All
2023,8,AMRITSAR,CHENNAI,126,153,AMRITSAR-CHENNAI,279,All
2023,9,AMRITSAR,CHENNAI,111,212,AMRITSAR-CHENNAI,323,All
2023,10,AMRITSAR,CHENNAI,160,166,AMRITSAR-CHENNAI,326,All
2023,11,AMRITSAR,CHENNAI,110,0,AMRITSAR-CHENNAI,110,All
2023,12,AMRITSAR,CHENNAI,163,0,AMRITSAR-CHENNAI,163,All
2024,1,AMRITSAR,CHENNAI,140,0,AMRITSAR-CHENNAI,140,All
2024,2,AMRITSAR,CHENNAI,190,0,AMRITSAR-CHENNAI,190,All
2024,3,AMRITSAR,CHENNAI,109,0,AMRITSAR-CHENNAI,109,All
2024,4,AMRITSAR,CHENNAI,90,43,AMRITSAR-CHENNAI,133,All
2024,6,AMRITSAR,CHENNAI,111,33,AMRITSAR-CHENNAI,144,All
2024,7,AMRITSAR,CHENNAI,161,174,AMRITSAR-CHENNAI,335,All
2024,8,AMRITSAR,CHENNAI,135,117,AMRITSAR-CHENNAI,252,All
2024,9,AMRITSAR,CHENNAI,287,203,AMRITSAR-CHENNAI,490,All
2024,10,AMRITSAR,CHENNAI,322,79,AMRITSAR-CHENNAI,401,All
2024,11,AMRITSAR,CHENNAI,80,118,AMRITSAR-CHENNAI,198,All
2017,6,AMRITSAR,COIMBATORE,0,3,AMRITSAR-COIMBATORE,3,All
2017,7,AMRITSAR,COIMBATORE,0,62,AMRITSAR-COIMBATORE,62,All
2017,8,AMRITSAR,COIMBATORE,0,32,AMRITSAR-COIMBATORE,32,All
2017,9,AMRITSAR,COIMBATORE,0,184,AMRITSAR-COIMBATORE,184,All
2017,10,AMRITSAR,COIMBATORE,0,75,AMRITSAR-COIMBATORE,75,All
2017,11,AMRITSAR,COIMBATORE,0,130,AMRITSAR-COIMBATORE,130,All
2017,12,AMRITSAR,COIMBATORE,0,188,AMRITSAR-COIMBATORE,188,All
2018,1,AMRITSAR,COIMBATORE,0,117,AMRITSAR-COIMBATORE,117,All
2018,2,AMRITSAR,COIMBATORE,0,146,AMRITSAR-COIMBATORE,146,All
2018,3,AMRITSAR,COIMBATORE,0,160,AMRITSAR-COIMBATORE,160,All
2018,4,AMRITSAR,COIMBATORE,0,124,AMRITSAR-COIMBATORE,124,All
2018,5,AMRITSAR,COIMBATORE,0,92,AMRITSAR-COIMBATORE,92,All
2018,6,AMRITSAR,COIMBATORE,0,121,AMRITSAR-COIMBATORE,121,All
2018,7,AMRITSAR,COIMBATORE,0,153,AMRITSAR-COIMBATORE,153,All
2018,8,AMRITSAR,COIMBATORE,0,159,AMRITSAR-COIMBATORE,159,All
2018,9,AMRITSAR,COIMBATORE,0,140,AMRITSAR-COIMBATORE,140,All
2018,10,AMRITSAR,COIMBATORE,0,153,AMRITSAR-COIMBATORE,153,All
2018,11,AMRITSAR,COIMBATORE,0,99,AMRITSAR-COIMBATORE,99,All
2018,12,AMRITSAR,COIMBATORE,0,83,AMRITSAR-COIMBATORE,83,All
2019,1,AMRITSAR,COIMBATORE,0,124,AMRITSAR-COIMBATORE,124,All
2019,2,AMRITSAR,COIMBATORE,0,34,AMRITSAR-COIMBATORE,34,All
2019,3,AMRITSAR,COIMBATORE,0,105,AMRITSAR-COIMBATORE,105,All
2019,4,AMRITSAR,COIMBATORE,0,82,AMRITSAR-COIMBATORE,82,All
2019,5,AMRITSAR,COIMBATORE,0,106,AMRITSAR-COIMBATORE,106,All
2019,6,AMRITSAR,COIMBATORE,0,138,AMRITSAR-COIMBATORE,138,All
2019,7,AMRITSAR,COIMBATORE,0,170,AMRITSAR-COIMBATORE,170,All
2019,8,AMRITSAR,COIMBATORE,0,78,AMRITSAR-COIMBATORE,78,All
2019,9,AMRITSAR,COIMBATORE,0,134,AMRITSAR-COIMBATORE,134,All
2019,10,AMRITSAR,COIMBATORE,0,72,AMRITSAR-COIMBATORE,72,All
2019,11,AMRITSAR,COIMBATORE,0,85,AMRITSAR-COIMBATORE,85,All
2019,12,AMRITSAR,COIMBATORE,0,73,AMRITSAR-COIMBATORE,73,All
2020,1,AMRITSAR,COIMBATORE,0,98,AMRITSAR-COIMBATORE,98,All
2020,2,AMRITSAR,COIMBATORE,0,44,AMRITSAR-COIMBATORE,44,All
2020,3,AMRITSAR,COIMBATORE,0,55,AMRITSAR-COIMBATORE,55,All
2019,1,AMRITSAR,DABOLIM,4188,4839,AMRITSAR-DABOLIM,9027,All
2019,2,AMRITSAR,DABOLIM,3361,3578,AMRITSAR-DABOLIM,6939,All
2019,3,AMRITSAR,DABOLIM,828,1119,AMRITSAR-DABOLIM,1947,All
2019,4,AMRITSAR,DABOLIM,0,199,AMRITSAR-DABOLIM,199,All
2019,5,AMRITSAR,DABOLIM,0,160,AMRITSAR-DABOLIM,160,All
2019,6,AMRITSAR,DABOLIM,0,217,AMRITSAR-DABOLIM,217,All
2019,7,AMRITSAR,DABOLIM,0,85,AMRITSAR-DABOLIM,85,All
2019,8,AMRITSAR,DABOLIM,0,77,AMRITSAR-DABOLIM,77,All
2019,9,AMRITSAR,DABOLIM,0,85,AMRITSAR-DABOLIM,85,All
2019,10,AMRITSAR,DABOLIM,0,190,AMRITSAR-DABOLIM,190,All
2019,11,AMRITSAR,DABOLIM,0,241,AMRITSAR-DABOLIM,241,All
2019,12,AMRITSAR,DABOLIM,0,200,AMRITSAR-DABOLIM,200,All
2020,1,AMRITSAR,DABOLIM,0,273,AMRITSAR-DABOLIM,273,All
2020,2,AMRITSAR,DABOLIM,0,102,AMRITSAR-DABOLIM,102,All
2020,3,AMRITSAR,DABOLIM,0,87,AMRITSAR-DABOLIM,87,All
2021,3,AMRITSAR,DABOLIM,345,369,AMRITSAR-DABOLIM,714,All
2021,4,AMRITSAR,DABOLIM,1204,1830,AMRITSAR-DABOLIM,3034,All
2021,11,AMRITSAR,DABOLIM,2458,2081,AMRITSAR-DABOLIM,4539,All
2021,12,AMRITSAR,DABOLIM,4061,3420,AMRITSAR-DABOLIM,7481,All
2022,1,AMRITSAR,DABOLIM,975,1361,AMRITSAR-DABOLIM,2336,All
2022,3,AMRITSAR,DABOLIM,572,773,AMRITSAR-DABOLIM,1345,All
2022,4,AMRITSAR,DABOLIM,1806,2458,AMRITSAR-DABOLIM,4264,All
2022,5,AMRITSAR,DABOLIM,2151,2383,AMRITSAR-DABOLIM,4534,All
2022,6,AMRITSAR,DABOLIM,1721,1817,AMRITSAR-DABOLIM,3538,All
2022,7,AMRITSAR,DABOLIM,1055,1208,AMRITSAR-DABOLIM,2263,All
2022,10,AMRITSAR,DABOLIM,1533,1951,AMRITSAR-DABOLIM,3484,All
2022,11,AMRITSAR,DABOLIM,3091,2202,AMRITSAR-DABOLIM,5293,All
2022,12,AMRITSAR,DABOLIM,2864,2029,AMRITSAR-DABOLIM,4893,All
2023,1,AMRITSAR,DABOLIM,2250,3123,AMRITSAR-DABOLIM,5373,All
2023,2,AMRITSAR,DABOLIM,3010,3980,AMRITSAR-DABOLIM,6990,All
2023,3,AMRITSAR,DABOLIM,2709,3569,AMRITSAR-DABOLIM,6278,All
2024,6,AMRITSAR,DABOLIM,0,6,AMRITSAR-DABOLIM,6,All
2019,1,AMRITSAR,DEHRA DUN,252,387,AMRITSAR-DEHRA DUN,639,All
2019,2,AMRITSAR,DEHRA DUN,633,973,AMRITSAR-DEHRA DUN,1606,All
2019,3,AMRITSAR,DEHRA DUN,878,1390,AMRITSAR-DEHRA DUN,2268,All
2019,4,AMRITSAR,DEHRA DUN,800,1171,AMRITSAR-DEHRA DUN,1971,All
2019,5,AMRITSAR,DEHRA DUN,810,845,AMRITSAR-DEHRA DUN,1655,All
2019,6,AMRITSAR,DEHRA DUN,1391,1427,AMRITSAR-DEHRA DUN,2818,All
2019,7,AMRITSAR,DEHRA DUN,1409,1669,AMRITSAR-DEHRA DUN,3078,All
2022,7,AMRITSAR,DEHRA DUN,91,0,AMRITSAR-DEHRA DUN,91,All
2022,8,AMRITSAR,DEHRA DUN,0,242,AMRITSAR-DEHRA DUN,242,All
2022,11,AMRITSAR,DEHRA DUN,0,91,AMRITSAR-DEHRA DUN,91,All
2015,4,AMRITSAR,DELHI,33676,26096,AMRITSAR-DELHI,59772,All
2015,5,AMRITSAR,DELHI,29954,22084,AMRITSAR-DELHI,52038,All
2015,6,AMRITSAR,DELHI,26157,21020,AMRITSAR-DELHI,47177,All
2015,7,AMRITSAR,DELHI,26176,27421,AMRITSAR-DELHI,53597,All
2015,8,AMRITSAR,DELHI,26095,27286,AMRITSAR-DELHI,53381,All
2015,9,AMRITSAR,DELHI,27768,29209,AMRITSAR-DELHI,56977,All
2015,10,AMRITSAR,DELHI,19197,21243,AMRITSAR-DELHI,40440,All
2015,11,AMRITSAR,DELHI,29968,31698,AMRITSAR-DELHI,61666,All
2015,12,AMRITSAR,DELHI,32171,33059,AMRITSAR-DELHI,65230,All
2016,1,AMRITSAR,DELHI,29428,32867,AMRITSAR-DELHI,62295,All
2016,2,AMRITSAR,DELHI,33351,35245,AMRITSAR-DELHI,68596,All
2016,3,AMRITSAR,DELHI,35319,34383,AMRITSAR-DELHI,69702,All
2016,4,AMRITSAR,DELHI,37088,29445,AMRITSAR-DELHI,66533,All
2016,5,AMRITSAR,DELHI,33355,28416,AMRITSAR-DELHI,61771,All
2016,6,AMRITSAR,DELHI,30825,28257,AMRITSAR-DELHI,59082,All
2016,7,AMRITSAR,DELHI,30468,32202,AMRITSAR-DELHI,62670,All
2016,8,AMRITSAR,DELHI,30803,32979,AMRITSAR-DELHI,63782,All
2016,9,AMRITSAR,DELHI,32141,34436,AMRITSAR-DELHI,66577,All
2016,10,AMRITSAR,DELHI,30596,39810,AMRITSAR-DELHI,70406,All
2016,11,AMRITSAR,DELHI,36834,36488,AMRITSAR-DELHI,73322,All
2016,12,AMRITSAR,DELHI,35667,37647,AMRITSAR-DELHI,73314,All
2017,1,AMRITSAR,DELHI,37514,41548,AMRITSAR-DELHI,79062,All
2017,2,AMRITSAR,DELHI,36865,38110,AMRITSAR-DELHI,74975,All
2017,3,AMRITSAR,DELHI,47411,45530,AMRITSAR-DELHI,92941,All
2017,4,AMRITSAR,DELHI,45008,37291,AMRITSAR-DELHI,82299,All
2017,5,AMRITSAR,DELHI,41107,33953,AMRITSAR-DELHI,75060,All
2017,6,AMRITSAR,DELHI,39937,36104,AMRITSAR-DELHI,76041,All
2017,7,AMRITSAR,DELHI,40848,44245,AMRITSAR-DELHI,85093,All
2017,8,AMRITSAR,DELHI,47992,49311,AMRITSAR-DELHI,97303,All
2017,9,AMRITSAR,DELHI,42903,51223,AMRITSAR-DELHI,94126,All
2017,10,AMRITSAR,DELHI,54746,58800,AMRITSAR-DELHI,113546,All
2017,11,AMRITSAR,DELHI,55348,57468,AMRITSAR-DELHI,112816,All
2017,12,AMRITSAR,DELHI,56711,60866,AMRITSAR-DELHI,117577,All
2018,1,AMRITSAR,DELHI,56358,59686,AMRITSAR-DELHI,116044,All
2018,2,AMRITSAR,DELHI,55792,56688,AMRITSAR-DELHI,112480,All
2018,3,AMRITSAR,DELHI,58139,58319,AMRITSAR-DELHI,116458,All
2018,4,AMRITSAR,DELHI,50093,47559,AMRITSAR-DELHI,97652,All
2018,5,AMRITSAR,DELHI,43826,40206,AMRITSAR-DELHI,84032,All
2018,6,AMRITSAR,DELHI,44317,38819,AMRITSAR-DELHI,83136,All
2018,7,AMRITSAR,DELHI,44172,45430,AMRITSAR-DELHI,89602,All
2018,8,AMRITSAR,DELHI,41900,43983,AMRITSAR-DELHI,85883,All
2018,9,AMRITSAR,DELHI,41074,43553,AMRITSAR-DELHI,84627,All
2018,10,AMRITSAR,DELHI,42609,45806,AMRITSAR-DELHI,88415,All
2018,11,AMRITSAR,DELHI,39426,40790,AMRITSAR-DELHI,80216,All
2018,12,AMRITSAR,DELHI,44981,46622,AMRITSAR-DELHI,91603,All
2019,1,AMRITSAR,DELHI,44343,45919,AMRITSAR-DELHI,90262,All
2019,2,AMRITSAR,DELHI,41368,43252,AMRITSAR-DELHI,84620,All
2019,3,AMRITSAR,DELHI,42390,41377,AMRITSAR-DELHI,83767,All
2019,4,AMRITSAR,DELHI,34960,32051,AMRITSAR-DELHI,67011,All
2019,5,AMRITSAR,DELHI,28505,25556,AMRITSAR-DELHI,54061,All
2019,6,AMRITSAR,DELHI,29957,26776,AMRITSAR-DELHI,56733,All
2019,7,AMRITSAR,DELHI,33213,34293,AMRITSAR-DELHI,67506,All
2019,8,AMRITSAR,DELHI,33138,33613,AMRITSAR-DELHI,66751,All
2019,9,AMRITSAR,DELHI,36438,38045,AMRITSAR-DELHI,74483,All
2019,10,AMRITSAR,DELHI,37232,41795,AMRITSAR-DELHI,79027,All
2019,11,AMRITSAR,DELHI,42981,42139,AMRITSAR-DELHI,85120,All
2019,12,AMRITSAR,DELHI,46341,48417,AMRITSAR-DELHI,94758,All
2020,1,AMRITSAR,DELHI,44493,47484,AMRITSAR-DELHI,91977,All
2020,2,AMRITSAR,DELHI,43939,46110,AMRITSAR-DELHI,90049,All
2020,3,AMRITSAR,DELHI,25157,22844,AMRITSAR-DELHI,48001,All
2020,5,AMRITSAR,DELHI,865,2701,AMRITSAR-DELHI,3566,All
2020,6,AMRITSAR,DELHI,6930,8803,AMRITSAR-DELHI,15733,All
2020,7,AMRITSAR,DELHI,8045,7945,AMRITSAR-DELHI,15990,All
2020,8,AMRITSAR,DELHI,9818,10001,AMRITSAR-DELHI,19819,All
2020,9,AMRITSAR,DELHI,12722,12636,AMRITSAR-DELHI,25358,All
2020,10,AMRITSAR,DELHI,21132,19714,AMRITSAR-DELHI,40846,All
2020,11,AMRITSAR,DELHI,26544,25636,AMRITSAR-DELHI,52180,All
2020,12,AMRITSAR,DELHI,32932,30507,AMRITSAR-DELHI,63439,All
2021,1,AMRITSAR,DELHI,31476,29076,AMRITSAR-DELHI,60552,All
2021,2,AMRITSAR,DELHI,32095,31462,AMRITSAR-DELHI,63557,All
2021,3,AMRITSAR,DELHI,31219,28723,AMRITSAR-DELHI,59942,All
2021,4,AMRITSAR,DELHI,19687,16477,AMRITSAR-DELHI,36164,All
2021,6,AMRITSAR,DELHI,10901,11704,AMRITSAR-DELHI,22605,All
2021,7,AMRITSAR,DELHI,14610,13896,AMRITSAR-DELHI,28506,All
2021,8,AMRITSAR,DELHI,20312,19666,AMRITSAR-DELHI,39978,All
2021,9,AMRITSAR,DELHI,20815,21606,AMRITSAR-DELHI,42421,All
2021,10,AMRITSAR,DELHI,25978,28183,AMRITSAR-DELHI,54161,All
2021,11,AMRITSAR,DELHI,39827,40050,AMRITSAR-DELHI,79877,All
2021,12,AMRITSAR,DELHI,42561,41559,AMRITSAR-DELHI,84120,All
2022,1,AMRITSAR,DELHI,24371,23491,AMRITSAR-DELHI,47862,All
2022,2,AMRITSAR,DELHI,29294,31065,AMRITSAR-DELHI,60359,All
2022,3,AMRITSAR,DELHI,37983,38128,AMRITSAR-DELHI,76111,All
2022,4,AMRITSAR,DELHI,32364,31982,AMRITSAR-DELHI,64346,All
2022,5,AMRITSAR,DELHI,29288,27746,AMRITSAR-DELHI,57034,All
2022,6,AMRITSAR,DELHI,27072,24297,AMRITSAR-DELHI,51369,All
2022,7,AMRITSAR,DELHI,25721,26159,AMRITSAR-DELHI,51880,All
2022,8,AMRITSAR,DELHI,28017,29061,AMRITSAR-DELHI,57078,All
2022,9,AMRITSAR,DELHI,30816,34416,AMRITSAR-DELHI,65232,All
2022,10,AMRITSAR,DELHI,32857,35835,AMRITSAR-DELHI,68692,All
2022,11,AMRITSAR,DELHI,36098,37358,AMRITSAR-DELHI,73456,All
2022,12,AMRITSAR,DELHI,41530,43303,AMRITSAR-DELHI,84833,All
2023,1,AMRITSAR,DELHI,38815,42772,AMRITSAR-DELHI,81587,All
2023,2,AMRITSAR,DELHI,43046,44617,AMRITSAR-DELHI,87663,All
2023,3,AMRITSAR,DELHI,42125,41338,AMRITSAR-DELHI,83463,All
2023,4,AMRITSAR,DELHI,44896,44056,AMRITSAR-DELHI,88952,All
2023,5,AMRITSAR,DELHI,41209,42134,AMRITSAR-DELHI,83343,All
2023,6,AMRITSAR,DELHI,38471,37471,AMRITSAR-DELHI,75942,All
2023,7,AMRITSAR,DELHI,39860,40021,AMRITSAR-DELHI,79881,All
2023,8,AMRITSAR,DELHI,39176,43302,AMRITSAR-DELHI,82478,All
2023,9,AMRITSAR,DELHI,41492,46007,AMRITSAR-DELHI,87499,All
2023,10,AMRITSAR,DELHI,44585,48024,AMRITSAR-DELHI,92609,All
2023,11,AMRITSAR,DELHI,44603,47662,AMRITSAR-DELHI,92265,All
2023,12,AMRITSAR,DELHI,47013,49398,AMRITSAR-DELHI,96411,All
2024,1,AMRITSAR,DELHI,42781,47465,AMRITSAR-DELHI,90246,All
2024,2,AMRITSAR,DELHI,55048,57160,AMRITSAR-DELHI,112208,All
2024,3,AMRITSAR,DELHI,60569,60856,AMRITSAR-DELHI,121425,All
2024,4,AMRITSAR,DELHI,51511,49794,AMRITSAR-DELHI,101305,All
2024,6,AMRITSAR,DELHI,48407,42769,AMRITSAR-DELHI,91176,All
2024,7,AMRITSAR,DELHI,44159,46262,AMRITSAR-DELHI,90421,All
2024,8,AMRITSAR,DELHI,43762,48058,AMRITSAR-DELHI,91820,All
2024,9,AMRITSAR,DELHI,45218,49801,AMRITSAR-DELHI,95019,All
2024,10,AMRITSAR,DELHI,46482,54951,AMRITSAR-DELHI,101433,All
2024,11,AMRITSAR,DELHI,57858,57950,AMRITSAR-DELHI,115808,All
2024,12,AMRITSAR,DELHI,61164,60891,AMRITSAR-DELHI,122055,All
2025,1,AMRITSAR,DELHI,53380,56882,AMRITSAR-DELHI,110262,All
2025,2,AMRITSAR,DELHI,59957,63483,AMRITSAR-DELHI,123440,All
2025,3,AMRITSAR,DELHI,65075,64468,AMRITSAR-DELHI,129543,All
2019,8,AMRITSAR,DHARAMSALA,0,3,AMRITSAR-DHARAMSALA,3,All
2024,4,AMRITSAR,DHARAMSALA,0,51,AMRITSAR-DHARAMSALA,51,All
2024,3,AMRITSAR,DehraDun,46,85,AMRITSAR-DehraDun,131,All
2024,6,AMRITSAR,DehraDun,121,116,AMRITSAR-DehraDun,237,All
2024,7,AMRITSAR,DehraDun,70,92,AMRITSAR-DehraDun,162,All
2024,8,AMRITSAR,DehraDun,198,208,AMRITSAR-DehraDun,406,All
2024,9,AMRITSAR,DehraDun,214,140,AMRITSAR-DehraDun,354,All
2024,10,AMRITSAR,DehraDun,261,240,AMRITSAR-DehraDun,501,All
2024,11,AMRITSAR,DehraDun,157,154,AMRITSAR-DehraDun,311,All
2017,10,AMRITSAR,GOA,0,35,AMRITSAR-GOA,35,All
2017,11,AMRITSAR,GOA,0,63,AMRITSAR-GOA,63,All
2017,12,AMRITSAR,GOA,0,38,AMRITSAR-GOA,38,All
2018,1,AMRITSAR,GOA,0,190,AMRITSAR-GOA,190,All
2018,2,AMRITSAR,GOA,0,238,AMRITSAR-GOA,238,All
2018,3,AMRITSAR,GOA,0,234,AMRITSAR-GOA,234,All
2018,4,AMRITSAR,GOA,0,64,AMRITSAR-GOA,64,All
2018,5,AMRITSAR,GOA,0,127,AMRITSAR-GOA,127,All
2018,6,AMRITSAR,GOA,0,198,AMRITSAR-GOA,198,All
2018,7,AMRITSAR,GOA,0,130,AMRITSAR-GOA,130,All
2018,8,AMRITSAR,GOA,0,139,AMRITSAR-GOA,139,All
2018,9,AMRITSAR,GOA,0,236,AMRITSAR-GOA,236,All
2018,10,AMRITSAR,GOA,0,382,AMRITSAR-GOA,382,All
2018,11,AMRITSAR,GOA,3092,2601,AMRITSAR-GOA,5693,All
2018,12,AMRITSAR,GOA,3873,3537,AMRITSAR-GOA,7410,All
2018,10,AMRITSAR,GUWAHATI,277,466,AMRITSAR-GUWAHATI,743,All
2018,11,AMRITSAR,GUWAHATI,3295,4017,AMRITSAR-GUWAHATI,7312,All
2018,12,AMRITSAR,GUWAHATI,4785,4705,AMRITSAR-GUWAHATI,9490,All
2019,1,AMRITSAR,GUWAHATI,3399,4097,AMRITSAR-GUWAHATI,7496,All
2019,2,AMRITSAR,GUWAHATI,3391,4341,AMRITSAR-GUWAHATI,7732,All
2019,3,AMRITSAR,GUWAHATI,4321,4578,AMRITSAR-GUWAHATI,8899,All
2019,4,AMRITSAR,GUWAHATI,4676,4117,AMRITSAR-GUWAHATI,8793,All
2019,5,AMRITSAR,GUWAHATI,4827,3697,AMRITSAR-GUWAHATI,8524,All
2019,6,AMRITSAR,GUWAHATI,4651,4174,AMRITSAR-GUWAHATI,8825,All
2019,7,AMRITSAR,GUWAHATI,0,48,AMRITSAR-GUWAHATI,48,All
2020,8,AMRITSAR,GUWAHATI,20,22,AMRITSAR-GUWAHATI,42,All
2020,9,AMRITSAR,GUWAHATI,58,132,AMRITSAR-GUWAHATI,190,All
2020,10,AMRITSAR,GUWAHATI,134,264,AMRITSAR-GUWAHATI,398,All
2020,11,AMRITSAR,GUWAHATI,30,165,AMRITSAR-GUWAHATI,195,All
2020,12,AMRITSAR,GUWAHATI,82,159,AMRITSAR-GUWAHATI,241,All
2021,1,AMRITSAR,GUWAHATI,152,253,AMRITSAR-GUWAHATI,405,All
2021,2,AMRITSAR,GUWAHATI,157,243,AMRITSAR-GUWAHATI,400,All
2021,3,AMRITSAR,GUWAHATI,149,161,AMRITSAR-GUWAHATI,310,All
2021,4,AMRITSAR,GUWAHATI,306,195,AMRITSAR-GUWAHATI,501,All
2021,6,AMRITSAR,GUWAHATI,0,384,AMRITSAR-GUWAHATI,384,All
2021,7,AMRITSAR,GUWAHATI,0,351,AMRITSAR-GUWAHATI,351,All
2021,8,AMRITSAR,GUWAHATI,159,284,AMRITSAR-GUWAHATI,443,All
2021,9,AMRITSAR,GUWAHATI,408,280,AMRITSAR-GUWAHATI,688,All
2021,10,AMRITSAR,GUWAHATI,700,567,AMRITSAR-GUWAHATI,1267,All
2021,11,AMRITSAR,GUWAHATI,382,267,AMRITSAR-GUWAHATI,649,All
2021,12,AMRITSAR,GUWAHATI,538,326,AMRITSAR-GUWAHATI,864,All
2022,1,AMRITSAR,GUWAHATI,723,381,AMRITSAR-GUWAHATI,1104,All
2022,2,AMRITSAR,GUWAHATI,434,371,AMRITSAR-GUWAHATI,805,All
2022,3,AMRITSAR,GUWAHATI,537,348,AMRITSAR-GUWAHATI,885,All
2022,4,AMRITSAR,GUWAHATI,513,509,AMRITSAR-GUWAHATI,1022,All
2022,5,AMRITSAR,GUWAHATI,489,404,AMRITSAR-GUWAHATI,893,All
2022,6,AMRITSAR,GUWAHATI,247,357,AMRITSAR-GUWAHATI,604,All
2022,7,AMRITSAR,GUWAHATI,189,298,AMRITSAR-GUWAHATI,487,All
2022,8,AMRITSAR,GUWAHATI,62,250,AMRITSAR-GUWAHATI,312,All
2022,9,AMRITSAR,GUWAHATI,105,206,AMRITSAR-GUWAHATI,311,All
2022,10,AMRITSAR,GUWAHATI,245,422,AMRITSAR-GUWAHATI,667,All
2022,11,AMRITSAR,GUWAHATI,63,53,AMRITSAR-GUWAHATI,116,All
2023,7,AMRITSAR,GUWAHATI,58,140,AMRITSAR-GUWAHATI,198,All
2023,8,AMRITSAR,GUWAHATI,72,143,AMRITSAR-GUWAHATI,215,All
2023,10,AMRITSAR,GUWAHATI,14,61,AMRITSAR-GUWAHATI,75,All
2023,11,AMRITSAR,GUWAHATI,602,840,AMRITSAR-GUWAHATI,1442,All
2023,12,AMRITSAR,GUWAHATI,343,168,AMRITSAR-GUWAHATI,511,All
2024,4,AMRITSAR,GUWAHATI,52,102,AMRITSAR-GUWAHATI,154,All
2024,6,AMRITSAR,GUWAHATI,109,192,AMRITSAR-GUWAHATI,301,All
2024,7,AMRITSAR,GUWAHATI,176,197,AMRITSAR-GUWAHATI,373,All
2024,8,AMRITSAR,GUWAHATI,114,179,AMRITSAR-GUWAHATI,293,All
2024,9,AMRITSAR,GUWAHATI,99,112,AMRITSAR-GUWAHATI,211,All
2024,10,AMRITSAR,GUWAHATI,187,227,AMRITSAR-GUWAHATI,414,All
2024,11,AMRITSAR,GUWAHATI,109,121,AMRITSAR-GUWAHATI,230,All
2024,12,AMRITSAR,GUWAHATI,64,83,AMRITSAR-GUWAHATI,147,All
2025,3,AMRITSAR,GUWAHATI,37,110,AMRITSAR-GUWAHATI,147,All
2023,11,AMRITSAR,Goa,4323,4251,AMRITSAR-Goa,8574,All
2023,12,AMRITSAR,Goa,5068,4211,AMRITSAR-Goa,9279,All
2024,1,AMRITSAR,Goa,2673,2784,AMRITSAR-Goa,5457,All
2018,9,AMRITSAR,HYDERABAD,970,998,AMRITSAR-HYDERABAD,1968,All
2018,10,AMRITSAR,HYDERABAD,3239,3576,AMRITSAR-HYDERABAD,6815,All
2018,11,AMRITSAR,HYDERABAD,4106,3916,AMRITSAR-HYDERABAD,8022,All
2018,12,AMRITSAR,HYDERABAD,5054,4512,AMRITSAR-HYDERABAD,9566,All
2019,1,AMRITSAR,HYDERABAD,4603,4886,AMRITSAR-HYDERABAD,9489,All
2019,2,AMRITSAR,HYDERABAD,4217,4497,AMRITSAR-HYDERABAD,8714,All
2019,3,AMRITSAR,HYDERABAD,4264,4620,AMRITSAR-HYDERABAD,8884,All
2019,4,AMRITSAR,HYDERABAD,4036,4792,AMRITSAR-HYDERABAD,8828,All
2019,5,AMRITSAR,HYDERABAD,4533,4167,AMRITSAR-HYDERABAD,8700,All
2019,6,AMRITSAR,HYDERABAD,5018,3533,AMRITSAR-HYDERABAD,8551,All
2019,7,AMRITSAR,HYDERABAD,3604,3800,AMRITSAR-HYDERABAD,7404,All
2019,8,AMRITSAR,HYDERABAD,3431,3945,AMRITSAR-HYDERABAD,7376,All
2019,10,AMRITSAR,HYDERABAD,3458,3895,AMRITSAR-HYDERABAD,7353,All
2019,11,AMRITSAR,HYDERABAD,4576,4334,AMRITSAR-HYDERABAD,8910,All
2019,12,AMRITSAR,HYDERABAD,5072,4585,AMRITSAR-HYDERABAD,9657,All
2020,1,AMRITSAR,HYDERABAD,4351,4537,AMRITSAR-HYDERABAD,8888,All
2020,2,AMRITSAR,HYDERABAD,1849,2269,AMRITSAR-HYDERABAD,4118,All
2020,6,AMRITSAR,HYDERABAD,0,0,AMRITSAR-HYDERABAD,0,All
2021,3,AMRITSAR,HYDERABAD,30,76,AMRITSAR-HYDERABAD,106,All
2021,4,AMRITSAR,HYDERABAD,265,216,AMRITSAR-HYDERABAD,481,All
2021,10,AMRITSAR,HYDERABAD,7,7,AMRITSAR-HYDERABAD,14,All
2021,11,AMRITSAR,HYDERABAD,309,319,AMRITSAR-HYDERABAD,628,All
2021,12,AMRITSAR,HYDERABAD,544,571,AMRITSAR-HYDERABAD,1115,All
2022,1,AMRITSAR,HYDERABAD,127,405,AMRITSAR-HYDERABAD,532,All
2022,2,AMRITSAR,HYDERABAD,171,346,AMRITSAR-HYDERABAD,517,All
2022,3,AMRITSAR,HYDERABAD,504,381,AMRITSAR-HYDERABAD,885,All
2022,5,AMRITSAR,HYDERABAD,168,233,AMRITSAR-HYDERABAD,401,All
2022,6,AMRITSAR,HYDERABAD,314,137,AMRITSAR-HYDERABAD,451,All
2022,7,AMRITSAR,HYDERABAD,172,122,AMRITSAR-HYDERABAD,294,All
2022,10,AMRITSAR,HYDERABAD,14,3,AMRITSAR-HYDERABAD,17,All
2022,11,AMRITSAR,HYDERABAD,209,225,AMRITSAR-HYDERABAD,434,All
2022,12,AMRITSAR,HYDERABAD,518,281,AMRITSAR-HYDERABAD,799,All
2023,1,AMRITSAR,HYDERABAD,79,42,AMRITSAR-HYDERABAD,121,All
2023,2,AMRITSAR,HYDERABAD,452,497,AMRITSAR-HYDERABAD,949,All
2023,3,AMRITSAR,HYDERABAD,439,266,AMRITSAR-HYDERABAD,705,All
2023,11,AMRITSAR,HYDERABAD,2250,1704,AMRITSAR-HYDERABAD,3954,All
2023,12,AMRITSAR,HYDERABAD,4741,3886,AMRITSAR-HYDERABAD,8627,All
2024,1,AMRITSAR,HYDERABAD,3870,4378,AMRITSAR-HYDERABAD,8248,All
2024,2,AMRITSAR,HYDERABAD,3480,3597,AMRITSAR-HYDERABAD,7077,All
2024,3,AMRITSAR,HYDERABAD,4732,4586,AMRITSAR-HYDERABAD,9318,All
2024,4,AMRITSAR,HYDERABAD,9558,8926,AMRITSAR-HYDERABAD,18484,All
2024,6,AMRITSAR,HYDERABAD,9879,8519,AMRITSAR-HYDERABAD,18398,All
2024,7,AMRITSAR,HYDERABAD,6439,6888,AMRITSAR-HYDERABAD,13327,All
2024,8,AMRITSAR,HYDERABAD,7173,8363,AMRITSAR-HYDERABAD,15536,All
2024,9,AMRITSAR,HYDERABAD,6558,7223,AMRITSAR-HYDERABAD,13781,All
2024,10,AMRITSAR,HYDERABAD,6834,8294,AMRITSAR-HYDERABAD,15128,All
2024,11,AMRITSAR,HYDERABAD,4890,4682,AMRITSAR-HYDERABAD,9572,All
2024,12,AMRITSAR,HYDERABAD,5146,4561,AMRITSAR-HYDERABAD,9707,All
2025,1,AMRITSAR,HYDERABAD,4258,5217,AMRITSAR-HYDERABAD,9475,All
2025,2,AMRITSAR,HYDERABAD,4114,4790,AMRITSAR-HYDERABAD,8904,All
2025,3,AMRITSAR,HYDERABAD,4879,5066,AMRITSAR-HYDERABAD,9945,All
2021,10,AMRITSAR,INDORE,136,229,AMRITSAR-INDORE,365,All
2024,8,AMRITSAR,INDORE,13,0,AMRITSAR-INDORE,13,All
2024,11,AMRITSAR,INDORE,0,56,AMRITSAR-INDORE,56,All
2017,3,AMRITSAR,JAIPUR,67,0,AMRITSAR-JAIPUR,67,All
2017,4,AMRITSAR,JAIPUR,87,0,AMRITSAR-JAIPUR,87,All
2018,1,AMRITSAR,JAIPUR,50,49,AMRITSAR-JAIPUR,99,All
2018,3,AMRITSAR,JAIPUR,228,0,AMRITSAR-JAIPUR,228,All
2019,1,AMRITSAR,JAIPUR,96,0,AMRITSAR-JAIPUR,96,All
2019,2,AMRITSAR,JAIPUR,337,0,AMRITSAR-JAIPUR,337,All
2019,3,AMRITSAR,JAIPUR,434,78,AMRITSAR-JAIPUR,512,All
2019,4,AMRITSAR,JAIPUR,1949,1897,AMRITSAR-JAIPUR,3846,All
2019,5,AMRITSAR,JAIPUR,1759,1883,AMRITSAR-JAIPUR,3642,All
2019,6,AMRITSAR,JAIPUR,2320,2098,AMRITSAR-JAIPUR,4418,All
2019,7,AMRITSAR,JAIPUR,1835,1850,AMRITSAR-JAIPUR,3685,All
2019,8,AMRITSAR,JAIPUR,1986,2080,AMRITSAR-JAIPUR,4066,All
2019,9,AMRITSAR,JAIPUR,1616,1465,AMRITSAR-JAIPUR,3081,All
2019,10,AMRITSAR,JAIPUR,1994,1886,AMRITSAR-JAIPUR,3880,All
2019,11,AMRITSAR,JAIPUR,2121,2017,AMRITSAR-JAIPUR,4138,All
2019,12,AMRITSAR,JAIPUR,2254,2103,AMRITSAR-JAIPUR,4357,All
2020,1,AMRITSAR,JAIPUR,2008,1860,AMRITSAR-JAIPUR,3868,All
2020,2,AMRITSAR,JAIPUR,2087,1905,AMRITSAR-JAIPUR,3992,All
2020,3,AMRITSAR,JAIPUR,1070,1024,AMRITSAR-JAIPUR,2094,All
2020,5,AMRITSAR,JAIPUR,51,125,AMRITSAR-JAIPUR,176,All
2020,6,AMRITSAR,JAIPUR,25,21,AMRITSAR-JAIPUR,46,All
2020,8,AMRITSAR,JAIPUR,58,35,AMRITSAR-JAIPUR,93,All
2020,9,AMRITSAR,JAIPUR,356,198,AMRITSAR-JAIPUR,554,All
2020,10,AMRITSAR,JAIPUR,735,488,AMRITSAR-JAIPUR,1223,All
2020,11,AMRITSAR,JAIPUR,743,573,AMRITSAR-JAIPUR,1316,All
2021,2,AMRITSAR,JAIPUR,474,444,AMRITSAR-JAIPUR,918,All
2021,3,AMRITSAR,JAIPUR,956,865,AMRITSAR-JAIPUR,1821,All
2021,4,AMRITSAR,JAIPUR,378,430,AMRITSAR-JAIPUR,808,All
2021,6,AMRITSAR,JAIPUR,134,125,AMRITSAR-JAIPUR,259,All
2021,7,AMRITSAR,JAIPUR,434,491,AMRITSAR-JAIPUR,925,All
2021,8,AMRITSAR,JAIPUR,692,659,AMRITSAR-JAIPUR,1351,All
2021,9,AMRITSAR,JAIPUR,882,820,AMRITSAR-JAIPUR,1702,All
2021,10,AMRITSAR,JAIPUR,1570,1604,AMRITSAR-JAIPUR,3174,All
2021,11,AMRITSAR,JAIPUR,1837,1486,AMRITSAR-JAIPUR,3323,All
2021,12,AMRITSAR,JAIPUR,1795,1745,AMRITSAR-JAIPUR,3540,All
2022,1,AMRITSAR,JAIPUR,1022,788,AMRITSAR-JAIPUR,1810,All
2022,2,AMRITSAR,JAIPUR,1552,1249,AMRITSAR-JAIPUR,2801,All
2022,3,AMRITSAR,JAIPUR,1731,1582,AMRITSAR-JAIPUR,3313,All
2022,4,AMRITSAR,JAIPUR,1254,1263,AMRITSAR-JAIPUR,2517,All
2022,5,AMRITSAR,JAIPUR,1132,1211,AMRITSAR-JAIPUR,2343,All
2022,6,AMRITSAR,JAIPUR,1118,963,AMRITSAR-JAIPUR,2081,All
2022,7,AMRITSAR,JAIPUR,450,373,AMRITSAR-JAIPUR,823,All
2022,8,AMRITSAR,JAIPUR,199,201,AMRITSAR-JAIPUR,400,All
2022,9,AMRITSAR,JAIPUR,466,476,AMRITSAR-JAIPUR,942,All
2022,11,AMRITSAR,JAIPUR,0,99,AMRITSAR-JAIPUR,99,All
2023,1,AMRITSAR,JAIPUR,378,468,AMRITSAR-JAIPUR,846,All
2023,2,AMRITSAR,JAIPUR,1571,1485,AMRITSAR-JAIPUR,3056,All
2023,3,AMRITSAR,JAIPUR,1773,2027,AMRITSAR-JAIPUR,3800,All
2023,4,AMRITSAR,JAIPUR,1447,1491,AMRITSAR-JAIPUR,2938,All
2023,5,AMRITSAR,JAIPUR,1405,1543,AMRITSAR-JAIPUR,2948,All
2023,6,AMRITSAR,JAIPUR,1681,1484,AMRITSAR-JAIPUR,3165,All
2023,7,AMRITSAR,JAIPUR,444,428,AMRITSAR-JAIPUR,872,All
2023,12,AMRITSAR,JAIPUR,0,251,AMRITSAR-JAIPUR,251,All
2024,3,AMRITSAR,JAIPUR,30,0,AMRITSAR-JAIPUR,30,All
2024,11,AMRITSAR,JAIPUR,190,195,AMRITSAR-JAIPUR,385,All
2024,12,AMRITSAR,JAIPUR,63,59,AMRITSAR-JAIPUR,122,All
2025,3,AMRITSAR,JAIPUR,1459,1463,AMRITSAR-JAIPUR,2922,All
2019,9,AMRITSAR,JAISALMER,0,44,AMRITSAR-JAISALMER,44,All
2019,10,AMRITSAR,JAISALMER,0,69,AMRITSAR-JAISALMER,69,All
2019,11,AMRITSAR,JAISALMER,0,82,AMRITSAR-JAISALMER,82,All
2019,12,AMRITSAR,JAISALMER,0,63,AMRITSAR-JAISALMER,63,All
2020,1,AMRITSAR,JAISALMER,0,117,AMRITSAR-JAISALMER,117,All
2020,2,AMRITSAR,JAISALMER,0,106,AMRITSAR-JAISALMER,106,All
2020,3,AMRITSAR,JAISALMER,0,66,AMRITSAR-JAISALMER,66,All
2021,11,AMRITSAR,JAISALMER,0,49,AMRITSAR-JAISALMER,49,All
2021,12,AMRITSAR,JAISALMER,0,81,AMRITSAR-JAISALMER,81,All
2022,1,AMRITSAR,JAISALMER,0,67,AMRITSAR-JAISALMER,67,All
2022,2,AMRITSAR,JAISALMER,0,58,AMRITSAR-JAISALMER,58,All
2022,3,AMRITSAR,JAISALMER,0,90,AMRITSAR-JAISALMER,90,All
2016,2,AMRITSAR,JAMMU,0,66,AMRITSAR-JAMMU,66,All
2017,5,AMRITSAR,JAMMU,140,230,AMRITSAR-JAMMU,370,All
2017,6,AMRITSAR,JAMMU,170,348,AMRITSAR-JAMMU,518,All
2017,7,AMRITSAR,JAMMU,186,329,AMRITSAR-JAMMU,515,All
2017,8,AMRITSAR,JAMMU,255,549,AMRITSAR-JAMMU,804,All
2017,9,AMRITSAR,JAMMU,229,370,AMRITSAR-JAMMU,599,All
2017,10,AMRITSAR,JAMMU,309,420,AMRITSAR-JAMMU,729,All
2017,11,AMRITSAR,JAMMU,303,625,AMRITSAR-JAMMU,928,All
2017,12,AMRITSAR,JAMMU,374,809,AMRITSAR-JAMMU,1183,All
2018,1,AMRITSAR,JAMMU,454,709,AMRITSAR-JAMMU,1163,All
2018,2,AMRITSAR,JAMMU,1075,1152,AMRITSAR-JAMMU,2227,All
2018,3,AMRITSAR,JAMMU,731,878,AMRITSAR-JAMMU,1609,All
2021,7,AMRITSAR,JAMMU,0,84,AMRITSAR-JAMMU,84,All
2021,8,AMRITSAR,JAMMU,0,85,AMRITSAR-JAMMU,85,All
2021,9,AMRITSAR,JAMMU,0,101,AMRITSAR-JAMMU,101,All
2021,10,AMRITSAR,JAMMU,13,144,AMRITSAR-JAMMU,157,All
2021,11,AMRITSAR,JAMMU,0,224,AMRITSAR-JAMMU,224,All
2021,12,AMRITSAR,JAMMU,0,277,AMRITSAR-JAMMU,277,All
2022,1,AMRITSAR,JAMMU,0,143,AMRITSAR-JAMMU,143,All
2022,2,AMRITSAR,JAMMU,0,230,AMRITSAR-JAMMU,230,All
2022,3,AMRITSAR,JAMMU,0,201,AMRITSAR-JAMMU,201,All
2022,4,AMRITSAR,JAMMU,0,119,AMRITSAR-JAMMU,119,All
2022,5,AMRITSAR,JAMMU,0,145,AMRITSAR-JAMMU,145,All
2022,6,AMRITSAR,JAMMU,0,164,AMRITSAR-JAMMU,164,All
2022,7,AMRITSAR,JAMMU,0,172,AMRITSAR-JAMMU,172,All
2022,8,AMRITSAR,JAMMU,0,247,AMRITSAR-JAMMU,247,All
2022,9,AMRITSAR,JAMMU,0,270,AMRITSAR-JAMMU,270,All
2022,10,AMRITSAR,JAMMU,0,277,AMRITSAR-JAMMU,277,All
2024,4,AMRITSAR,JAMMU,165,0,AMRITSAR-JAMMU,165,All
2021,6,AMRITSAR,JHARSUGUDA,8,0,AMRITSAR-JHARSUGUDA,8,All
2021,7,AMRITSAR,JHARSUGUDA,10,0,AMRITSAR-JHARSUGUDA,10,All
2021,8,AMRITSAR,JHARSUGUDA,1,0,AMRITSAR-JHARSUGUDA,1,All
2017,2,AMRITSAR,JODHPUR,0,1,AMRITSAR-JODHPUR,1,All
2017,3,AMRITSAR,JODHPUR,0,3,AMRITSAR-JODHPUR,3,All
2021,1,AMRITSAR,JODHPUR,111,211,AMRITSAR-JODHPUR,322,All
2019,8,AMRITSAR,KOCHI,0,45,AMRITSAR-KOCHI,45,All
2025,3,AMRITSAR,KOCHI,0,1,AMRITSAR-KOCHI,1,All
2017,10,AMRITSAR,KOLKATA,41,38,AMRITSAR-KOLKATA,79,All
2017,11,AMRITSAR,KOLKATA,337,279,AMRITSAR-KOLKATA,616,All
2017,12,AMRITSAR,KOLKATA,474,476,AMRITSAR-KOLKATA,950,All
2018,1,AMRITSAR,KOLKATA,235,361,AMRITSAR-KOLKATA,596,All
2018,2,AMRITSAR,KOLKATA,259,273,AMRITSAR-KOLKATA,532,All
2018,3,AMRITSAR,KOLKATA,304,316,AMRITSAR-KOLKATA,620,All
2018,7,AMRITSAR,KOLKATA,0,199,AMRITSAR-KOLKATA,199,All
2018,12,AMRITSAR,KOLKATA,0,15,AMRITSAR-KOLKATA,15,All
2019,10,AMRITSAR,KOLKATA,142,0,AMRITSAR-KOLKATA,142,All
2019,11,AMRITSAR,KOLKATA,815,0,AMRITSAR-KOLKATA,815,All
2019,12,AMRITSAR,KOLKATA,6177,4516,AMRITSAR-KOLKATA,10693,All
2020,1,AMRITSAR,KOLKATA,5203,4049,AMRITSAR-KOLKATA,9252,All
2020,2,AMRITSAR,KOLKATA,5247,4476,AMRITSAR-KOLKATA,9723,All
2020,3,AMRITSAR,KOLKATA,4688,3055,AMRITSAR-KOLKATA,7743,All
2020,6,AMRITSAR,KOLKATA,1373,649,AMRITSAR-KOLKATA,2022,All
2020,7,AMRITSAR,KOLKATA,2146,1309,AMRITSAR-KOLKATA,3455,All
2020,8,AMRITSAR,KOLKATA,2820,3063,AMRITSAR-KOLKATA,5883,All
2020,9,AMRITSAR,KOLKATA,2575,3302,AMRITSAR-KOLKATA,5877,All
2020,10,AMRITSAR,KOLKATA,3552,3643,AMRITSAR-KOLKATA,7195,All
2020,11,AMRITSAR,KOLKATA,4412,4215,AMRITSAR-KOLKATA,8627,All
2020,12,AMRITSAR,KOLKATA,4511,4428,AMRITSAR-KOLKATA,8939,All
2021,1,AMRITSAR,KOLKATA,3977,4020,AMRITSAR-KOLKATA,7997,All
2021,2,AMRITSAR,KOLKATA,4055,4285,AMRITSAR-KOLKATA,8340,All
2021,3,AMRITSAR,KOLKATA,4361,4560,AMRITSAR-KOLKATA,8921,All
2021,4,AMRITSAR,KOLKATA,3580,3122,AMRITSAR-KOLKATA,6702,All
2021,6,AMRITSAR,KOLKATA,858,244,AMRITSAR-KOLKATA,1102,All
2021,7,AMRITSAR,KOLKATA,2483,2921,AMRITSAR-KOLKATA,5404,All
2021,8,AMRITSAR,KOLKATA,1971,2019,AMRITSAR-KOLKATA,3990,All
2021,9,AMRITSAR,KOLKATA,2204,2098,AMRITSAR-KOLKATA,4302,All
2021,10,AMRITSAR,KOLKATA,4307,4305,AMRITSAR-KOLKATA,8612,All
2021,11,AMRITSAR,KOLKATA,2456,2358,AMRITSAR-KOLKATA,4814,All
2021,12,AMRITSAR,KOLKATA,2347,2255,AMRITSAR-KOLKATA,4602,All
2022,1,AMRITSAR,KOLKATA,2952,2642,AMRITSAR-KOLKATA,5594,All
2022,2,AMRITSAR,KOLKATA,2049,2184,AMRITSAR-KOLKATA,4233,All
2022,3,AMRITSAR,KOLKATA,4242,4380,AMRITSAR-KOLKATA,8622,All
2022,4,AMRITSAR,KOLKATA,4565,4397,AMRITSAR-KOLKATA,8962,All
2022,5,AMRITSAR,KOLKATA,4801,4781,AMRITSAR-KOLKATA,9582,All
2022,6,AMRITSAR,KOLKATA,4873,4524,AMRITSAR-KOLKATA,9397,All
2022,7,AMRITSAR,KOLKATA,5081,5185,AMRITSAR-KOLKATA,10266,All
2022,8,AMRITSAR,KOLKATA,4842,4935,AMRITSAR-KOLKATA,9777,All
2022,9,AMRITSAR,KOLKATA,4339,4240,AMRITSAR-KOLKATA,8579,All
2022,10,AMRITSAR,KOLKATA,5437,4887,AMRITSAR-KOLKATA,10324,All
2022,11,AMRITSAR,KOLKATA,3604,3547,AMRITSAR-KOLKATA,7151,All
2022,12,AMRITSAR,KOLKATA,3526,3034,AMRITSAR-KOLKATA,6560,All
2023,1,AMRITSAR,KOLKATA,3146,2831,AMRITSAR-KOLKATA,5977,All
2023,2,AMRITSAR,KOLKATA,2613,2714,AMRITSAR-KOLKATA,5327,All
2023,3,AMRITSAR,KOLKATA,2194,2089,AMRITSAR-KOLKATA,4283,All
2023,4,AMRITSAR,KOLKATA,3644,2763,AMRITSAR-KOLKATA,6407,All
2023,5,AMRITSAR,KOLKATA,4587,4356,AMRITSAR-KOLKATA,8943,All
2023,6,AMRITSAR,KOLKATA,5088,3804,AMRITSAR-KOLKATA,8892,All
2023,7,AMRITSAR,KOLKATA,3412,3658,AMRITSAR-KOLKATA,7070,All
2023,8,AMRITSAR,KOLKATA,3118,3588,AMRITSAR-KOLKATA,6706,All
2023,9,AMRITSAR,KOLKATA,3910,3882,AMRITSAR-KOLKATA,7792,All
2023,10,AMRITSAR,KOLKATA,4944,4714,AMRITSAR-KOLKATA,9658,All
2023,11,AMRITSAR,KOLKATA,4622,4067,AMRITSAR-KOLKATA,8689,All
2023,12,AMRITSAR,KOLKATA,4960,4891,AMRITSAR-KOLKATA,9851,All
2024,4,AMRITSAR,KOLKATA,2051,1677,AMRITSAR-KOLKATA,3728,All
2024,6,AMRITSAR,KOLKATA,2051,1490,AMRITSAR-KOLKATA,3541,All
2024,7,AMRITSAR,KOLKATA,2043,1938,AMRITSAR-KOLKATA,3981,All
2024,8,AMRITSAR,KOLKATA,2019,2021,AMRITSAR-KOLKATA,4040,All
2024,9,AMRITSAR,KOLKATA,1765,1658,AMRITSAR-KOLKATA,3423,All
2024,10,AMRITSAR,KOLKATA,1967,1883,AMRITSAR-KOLKATA,3850,All
2024,11,AMRITSAR,KOLKATA,2229,2101,AMRITSAR-KOLKATA,4330,All
2024,12,AMRITSAR,KOLKATA,2762,2463,AMRITSAR-KOLKATA,5225,All
2025,1,AMRITSAR,KOLKATA,2291,2352,AMRITSAR-KOLKATA,4643,All
2025,2,AMRITSAR,KOLKATA,2199,2305,AMRITSAR-KOLKATA,4504,All
2025,3,AMRITSAR,KOLKATA,2554,2346,AMRITSAR-KOLKATA,4900,All
2023,10,AMRITSAR,KULLU,283,368,AMRITSAR-KULLU,651,All
2023,11,AMRITSAR,KULLU,287,294,AMRITSAR-KULLU,581,All
2023,12,AMRITSAR,KULLU,202,187,AMRITSAR-KULLU,389,All
2024,1,AMRITSAR,KULLU,101,85,AMRITSAR-KULLU,186,All
2024,2,AMRITSAR,KULLU,311,309,AMRITSAR-KULLU,620,All
2024,3,AMRITSAR,KULLU,563,455,AMRITSAR-KULLU,1018,All
2024,4,AMRITSAR,KULLU,673,468,AMRITSAR-KULLU,1141,All
2024,6,AMRITSAR,KULLU,549,394,AMRITSAR-KULLU,943,All
2024,7,AMRITSAR,KULLU,244,212,AMRITSAR-KULLU,456,All
2024,8,AMRITSAR,KULLU,207,181,AMRITSAR-KULLU,388,All
2024,9,AMRITSAR,KULLU,467,277,AMRITSAR-KULLU,744,All
2024,10,AMRITSAR,KULLU,471,391,AMRITSAR-KULLU,862,All
2024,11,AMRITSAR,KULLU,329,218,AMRITSAR-KULLU,547,All
2024,12,AMRITSAR,KULLU,143,78,AMRITSAR-KULLU,221,All
2025,1,AMRITSAR,KULLU,158,133,AMRITSAR-KULLU,291,All
2025,2,AMRITSAR,KULLU,181,126,AMRITSAR-KULLU,307,All
2025,3,AMRITSAR,KULLU,462,296,AMRITSAR-KULLU,758,All
2020,9,AMRITSAR,LEH,42,0,AMRITSAR-LEH,42,All
2020,10,AMRITSAR,LEH,9,0,AMRITSAR-LEH,9,All
2020,5,AMRITSAR,LUCKNOW,0,93,AMRITSAR-LUCKNOW,93,All
2020,8,AMRITSAR,LUCKNOW,0,94,AMRITSAR-LUCKNOW,94,All
2022,3,AMRITSAR,LUCKNOW,250,204,AMRITSAR-LUCKNOW,454,All
2022,4,AMRITSAR,LUCKNOW,1670,1204,AMRITSAR-LUCKNOW,2874,All
2022,5,AMRITSAR,LUCKNOW,1071,1306,AMRITSAR-LUCKNOW,2377,All
2022,6,AMRITSAR,LUCKNOW,2794,2372,AMRITSAR-LUCKNOW,5166,All
2022,7,AMRITSAR,LUCKNOW,1062,1052,AMRITSAR-LUCKNOW,2114,All
2022,8,AMRITSAR,LUCKNOW,1563,1338,AMRITSAR-LUCKNOW,2901,All
2022,9,AMRITSAR,LUCKNOW,1572,1018,AMRITSAR-LUCKNOW,2590,All
2022,10,AMRITSAR,LUCKNOW,1455,1484,AMRITSAR-LUCKNOW,2939,All
2022,11,AMRITSAR,LUCKNOW,1588,1557,AMRITSAR-LUCKNOW,3145,All
2022,12,AMRITSAR,LUCKNOW,1559,1907,AMRITSAR-LUCKNOW,3466,All
2023,1,AMRITSAR,LUCKNOW,799,1332,AMRITSAR-LUCKNOW,2131,All
2023,2,AMRITSAR,LUCKNOW,1687,1563,AMRITSAR-LUCKNOW,3250,All
2023,3,AMRITSAR,LUCKNOW,2125,1846,AMRITSAR-LUCKNOW,3971,All
2023,4,AMRITSAR,LUCKNOW,2791,1989,AMRITSAR-LUCKNOW,4780,All
2023,5,AMRITSAR,LUCKNOW,2749,2835,AMRITSAR-LUCKNOW,5584,All
2023,6,AMRITSAR,LUCKNOW,2173,2105,AMRITSAR-LUCKNOW,4278,All
2023,7,AMRITSAR,LUCKNOW,2762,2381,AMRITSAR-LUCKNOW,5143,All
2023,8,AMRITSAR,LUCKNOW,2855,2792,AMRITSAR-LUCKNOW,5647,All
2023,9,AMRITSAR,LUCKNOW,3194,3261,AMRITSAR-LUCKNOW,6455,All
2023,10,AMRITSAR,LUCKNOW,2998,2533,AMRITSAR-LUCKNOW,5531,All
2023,11,AMRITSAR,LUCKNOW,3152,2759,AMRITSAR-LUCKNOW,5911,All
2023,12,AMRITSAR,LUCKNOW,3088,3554,AMRITSAR-LUCKNOW,6642,All
2024,2,AMRITSAR,LUCKNOW,949,712,AMRITSAR-LUCKNOW,1661,All
2024,3,AMRITSAR,LUCKNOW,3797,2725,AMRITSAR-LUCKNOW,6522,All
2024,4,AMRITSAR,LUCKNOW,3502,2214,AMRITSAR-LUCKNOW,5716,All
2024,6,AMRITSAR,LUCKNOW,2295,2040,AMRITSAR-LUCKNOW,4335,All
2024,7,AMRITSAR,LUCKNOW,1599,2105,AMRITSAR-LUCKNOW,3704,All
2024,8,AMRITSAR,LUCKNOW,2072,3135,AMRITSAR-LUCKNOW,5207,All
2024,9,AMRITSAR,LUCKNOW,2450,2456,AMRITSAR-LUCKNOW,4906,All
2024,10,AMRITSAR,LUCKNOW,2908,2309,AMRITSAR-LUCKNOW,5217,All
2024,11,AMRITSAR,LUCKNOW,3887,3203,AMRITSAR-LUCKNOW,7090,All
2024,12,AMRITSAR,LUCKNOW,3356,3242,AMRITSAR-LUCKNOW,6598,All
2025,1,AMRITSAR,LUCKNOW,3241,3354,AMRITSAR-LUCKNOW,6595,All
2025,2,AMRITSAR,LUCKNOW,3778,4396,AMRITSAR-LUCKNOW,8174,All
2015,4,AMRITSAR,MUMBAI,5407,5800,AMRITSAR-MUMBAI,11207,All
2015,5,AMRITSAR,MUMBAI,5448,5525,AMRITSAR-MUMBAI,10973,All
2015,6,AMRITSAR,MUMBAI,5479,4620,AMRITSAR-MUMBAI,10099,All
2015,7,AMRITSAR,MUMBAI,5237,4505,AMRITSAR-MUMBAI,9742,All
2015,8,AMRITSAR,MUMBAI,4918,4848,AMRITSAR-MUMBAI,9766,All
2015,9,AMRITSAR,MUMBAI,5035,5528,AMRITSAR-MUMBAI,10563,All
2015,10,AMRITSAR,MUMBAI,4901,5831,AMRITSAR-MUMBAI,10732,All
2015,11,AMRITSAR,MUMBAI,5581,5851,AMRITSAR-MUMBAI,11432,All
2015,12,AMRITSAR,MUMBAI,5717,5577,AMRITSAR-MUMBAI,11294,All
2016,1,AMRITSAR,MUMBAI,5524,5797,AMRITSAR-MUMBAI,11321,All
2016,2,AMRITSAR,MUMBAI,5618,6034,AMRITSAR-MUMBAI,11652,All
2016,3,AMRITSAR,MUMBAI,6190,6459,AMRITSAR-MUMBAI,12649,All
2016,4,AMRITSAR,MUMBAI,5469,5046,AMRITSAR-MUMBAI,10515,All
2016,5,AMRITSAR,MUMBAI,4909,4297,AMRITSAR-MUMBAI,9206,All
2016,6,AMRITSAR,MUMBAI,5183,4886,AMRITSAR-MUMBAI,10069,All
2016,7,AMRITSAR,MUMBAI,5422,5269,AMRITSAR-MUMBAI,10691,All
2016,8,AMRITSAR,MUMBAI,5595,5895,AMRITSAR-MUMBAI,11490,All
2016,9,AMRITSAR,MUMBAI,5518,5832,AMRITSAR-MUMBAI,11350,All
2016,10,AMRITSAR,MUMBAI,4827,6412,AMRITSAR-MUMBAI,11239,All
2016,11,AMRITSAR,MUMBAI,6423,6145,AMRITSAR-MUMBAI,12568,All
2016,12,AMRITSAR,MUMBAI,6283,6298,AMRITSAR-MUMBAI,12581,All
2017,1,AMRITSAR,MUMBAI,5673,6138,AMRITSAR-MUMBAI,11811,All
2017,2,AMRITSAR,MUMBAI,5349,5575,AMRITSAR-MUMBAI,10924,All
2017,3,AMRITSAR,MUMBAI,10657,10847,AMRITSAR-MUMBAI,21504,All
2017,4,AMRITSAR,MUMBAI,11715,12980,AMRITSAR-MUMBAI,24695,All
2017,5,AMRITSAR,MUMBAI,14101,13416,AMRITSAR-MUMBAI,27517,All
2017,6,AMRITSAR,MUMBAI,14058,11034,AMRITSAR-MUMBAI,25092,All
2017,7,AMRITSAR,MUMBAI,10982,10521,AMRITSAR-MUMBAI,21503,All
2017,8,AMRITSAR,MUMBAI,11851,11712,AMRITSAR-MUMBAI,23563,All
2017,9,AMRITSAR,MUMBAI,12049,12829,AMRITSAR-MUMBAI,24878,All
2017,10,AMRITSAR,MUMBAI,14359,15017,AMRITSAR-MUMBAI,29376,All
2017,11,AMRITSAR,MUMBAI,15119,14222,AMRITSAR-MUMBAI,29341,All
2017,12,AMRITSAR,MUMBAI,16065,14965,AMRITSAR-MUMBAI,31030,All
2018,1,AMRITSAR,MUMBAI,15032,14806,AMRITSAR-MUMBAI,29838,All
2018,2,AMRITSAR,MUMBAI,14954,15236,AMRITSAR-MUMBAI,30190,All
2018,3,AMRITSAR,MUMBAI,16847,16133,AMRITSAR-MUMBAI,32980,All
2018,4,AMRITSAR,MUMBAI,12890,13353,AMRITSAR-MUMBAI,26243,All
2018,5,AMRITSAR,MUMBAI,14059,13709,AMRITSAR-MUMBAI,27768,All
2018,6,AMRITSAR,MUMBAI,12048,10463,AMRITSAR-MUMBAI,22511,All
2018,7,AMRITSAR,MUMBAI,10949,11239,AMRITSAR-MUMBAI,22188,All
2018,8,AMRITSAR,MUMBAI,9994,10283,AMRITSAR-MUMBAI,20277,All
2018,9,AMRITSAR,MUMBAI,11486,11279,AMRITSAR-MUMBAI,22765,All
2018,10,AMRITSAR,MUMBAI,10698,11813,AMRITSAR-MUMBAI,22511,All
2018,11,AMRITSAR,MUMBAI,12001,12057,AMRITSAR-MUMBAI,24058,All
2018,12,AMRITSAR,MUMBAI,15831,14944,AMRITSAR-MUMBAI,30775,All
2019,1,AMRITSAR,MUMBAI,14460,14054,AMRITSAR-MUMBAI,28514,All
2019,2,AMRITSAR,MUMBAI,13813,12494,AMRITSAR-MUMBAI,26307,All
2019,3,AMRITSAR,MUMBAI,15547,13598,AMRITSAR-MUMBAI,29145,All
2019,4,AMRITSAR,MUMBAI,11872,13068,AMRITSAR-MUMBAI,24940,All
2019,5,AMRITSAR,MUMBAI,19261,19826,AMRITSAR-MUMBAI,39087,All
2019,6,AMRITSAR,MUMBAI,20643,19578,AMRITSAR-MUMBAI,40221,All
2019,7,AMRITSAR,MUMBAI,20046,19988,AMRITSAR-MUMBAI,40034,All
2019,8,AMRITSAR,MUMBAI,19395,19179,AMRITSAR-MUMBAI,38574,All
2019,9,AMRITSAR,MUMBAI,10322,10878,AMRITSAR-MUMBAI,21200,All
2019,10,AMRITSAR,MUMBAI,14537,15496,AMRITSAR-MUMBAI,30033,All
2019,11,AMRITSAR,MUMBAI,14658,14004,AMRITSAR-MUMBAI,28662,All
2019,12,AMRITSAR,MUMBAI,15201,14890,AMRITSAR-MUMBAI,30091,All
2020,1,AMRITSAR,MUMBAI,13857,13916,AMRITSAR-MUMBAI,27773,All
2020,2,AMRITSAR,MUMBAI,14008,14221,AMRITSAR-MUMBAI,28229,All
2020,3,AMRITSAR,MUMBAI,8987,8099,AMRITSAR-MUMBAI,17086,All
2020,7,AMRITSAR,MUMBAI,276,329,AMRITSAR-MUMBAI,605,All
2020,8,AMRITSAR,MUMBAI,1114,1335,AMRITSAR-MUMBAI,2449,All
2020,9,AMRITSAR,MUMBAI,941,1167,AMRITSAR-MUMBAI,2108,All
2020,10,AMRITSAR,MUMBAI,1322,1734,AMRITSAR-MUMBAI,3056,All
2020,11,AMRITSAR,MUMBAI,2758,2915,AMRITSAR-MUMBAI,5673,All
2020,12,AMRITSAR,MUMBAI,6576,5390,AMRITSAR-MUMBAI,11966,All
2021,1,AMRITSAR,MUMBAI,8462,7096,AMRITSAR-MUMBAI,15558,All
2021,2,AMRITSAR,MUMBAI,9040,8290,AMRITSAR-MUMBAI,17330,All
2021,3,AMRITSAR,MUMBAI,9337,7701,AMRITSAR-MUMBAI,17038,All
2021,4,AMRITSAR,MUMBAI,4467,3922,AMRITSAR-MUMBAI,8389,All
2021,6,AMRITSAR,MUMBAI,231,219,AMRITSAR-MUMBAI,450,All
2021,7,AMRITSAR,MUMBAI,2109,1945,AMRITSAR-MUMBAI,4054,All
2021,8,AMRITSAR,MUMBAI,5083,4654,AMRITSAR-MUMBAI,9737,All
2021,9,AMRITSAR,MUMBAI,5075,5101,AMRITSAR-MUMBAI,10176,All
2021,10,AMRITSAR,MUMBAI,6601,6974,AMRITSAR-MUMBAI,13575,All
2021,11,AMRITSAR,MUMBAI,12166,11429,AMRITSAR-MUMBAI,23595,All
2021,12,AMRITSAR,MUMBAI,15825,15791,AMRITSAR-MUMBAI,31616,All
2022,1,AMRITSAR,MUMBAI,10052,8169,AMRITSAR-MUMBAI,18221,All
2022,2,AMRITSAR,MUMBAI,10472,10941,AMRITSAR-MUMBAI,21413,All
2022,3,AMRITSAR,MUMBAI,16992,16669,AMRITSAR-MUMBAI,33661,All
2022,4,AMRITSAR,MUMBAI,14872,15515,AMRITSAR-MUMBAI,30387,All
2022,5,AMRITSAR,MUMBAI,18004,18758,AMRITSAR-MUMBAI,36762,All
2022,6,AMRITSAR,MUMBAI,14673,10961,AMRITSAR-MUMBAI,25634,All
2022,7,AMRITSAR,MUMBAI,9087,7622,AMRITSAR-MUMBAI,16709,All
2022,8,AMRITSAR,MUMBAI,12515,11264,AMRITSAR-MUMBAI,23779,All
2022,9,AMRITSAR,MUMBAI,10540,11700,AMRITSAR-MUMBAI,22240,All
2022,10,AMRITSAR,MUMBAI,12613,14973,AMRITSAR-MUMBAI,27586,All
2022,11,AMRITSAR,MUMBAI,17602,17114,AMRITSAR-MUMBAI,34716,All
2022,12,AMRITSAR,MUMBAI,19495,19562,AMRITSAR-MUMBAI,39057,All
2023,1,AMRITSAR,MUMBAI,17811,18891,AMRITSAR-MUMBAI,36702,All
2023,2,AMRITSAR,MUMBAI,15488,16683,AMRITSAR-MUMBAI,32171,All
2023,3,AMRITSAR,MUMBAI,16126,16041,AMRITSAR-MUMBAI,32167,All
2023,4,AMRITSAR,MUMBAI,13056,13900,AMRITSAR-MUMBAI,26956,All
2023,5,AMRITSAR,MUMBAI,7614,7324,AMRITSAR-MUMBAI,14938,All
2023,6,AMRITSAR,MUMBAI,11446,10488,AMRITSAR-MUMBAI,21934,All
2023,7,AMRITSAR,MUMBAI,10441,11495,AMRITSAR-MUMBAI,21936,All
2023,8,AMRITSAR,MUMBAI,8930,10547,AMRITSAR-MUMBAI,19477,All
2023,9,AMRITSAR,MUMBAI,10597,12201,AMRITSAR-MUMBAI,22798,All
2023,10,AMRITSAR,MUMBAI,11994,14558,AMRITSAR-MUMBAI,26552,All
2023,11,AMRITSAR,MUMBAI,17096,17775,AMRITSAR-MUMBAI,34871,All
2023,12,AMRITSAR,MUMBAI,18830,15539,AMRITSAR-MUMBAI,34369,All
2024,1,AMRITSAR,MUMBAI,17463,17502,AMRITSAR-MUMBAI,34965,All
2024,2,AMRITSAR,MUMBAI,16359,16883,AMRITSAR-MUMBAI,33242,All
2024,3,AMRITSAR,MUMBAI,17539,17263,AMRITSAR-MUMBAI,34802,All
2024,4,AMRITSAR,MUMBAI,12099,12287,AMRITSAR-MUMBAI,24386,All
2024,6,AMRITSAR,MUMBAI,13235,9488,AMRITSAR-MUMBAI,22723,All
2024,7,AMRITSAR,MUMBAI,9582,8867,AMRITSAR-MUMBAI,18449,All
2024,8,AMRITSAR,MUMBAI,9582,8691,AMRITSAR-MUMBAI,18273,All
2024,9,AMRITSAR,MUMBAI,12325,12813,AMRITSAR-MUMBAI,25138,All
2024,10,AMRITSAR,MUMBAI,10423,13840,AMRITSAR-MUMBAI,24263,All
2024,11,AMRITSAR,MUMBAI,11045,10450,AMRITSAR-MUMBAI,21495,All
2024,12,AMRITSAR,MUMBAI,16885,15753,AMRITSAR-MUMBAI,32638,All
2025,1,AMRITSAR,MUMBAI,14736,15318,AMRITSAR-MUMBAI,30054,All
2025,2,AMRITSAR,MUMBAI,12621,14105,AMRITSAR-MUMBAI,26726,All
2025,3,AMRITSAR,MUMBAI,12496,11995,AMRITSAR-MUMBAI,24491,All
2024,4,AMRITSAR,NAGPUR,12,0,AMRITSAR-NAGPUR,12,All
2017,12,AMRITSAR,NANDED,561,458,AMRITSAR-NANDED,1019,All
2018,1,AMRITSAR,NANDED,1084,1053,AMRITSAR-NANDED,2137,All
2018,2,AMRITSAR,NANDED,1032,936,AMRITSAR-NANDED,1968,All
2018,3,AMRITSAR,NANDED,1092,985,AMRITSAR-NANDED,2077,All
2018,4,AMRITSAR,NANDED,1169,1212,AMRITSAR-NANDED,2381,All
2018,5,AMRITSAR,NANDED,1021,931,AMRITSAR-NANDED,1952,All
2018,6,AMRITSAR,NANDED,1309,1181,AMRITSAR-NANDED,2490,All
2018,7,AMRITSAR,NANDED,1275,1292,AMRITSAR-NANDED,2567,All
2018,8,AMRITSAR,NANDED,1087,1018,AMRITSAR-NANDED,2105,All
2018,9,AMRITSAR,NANDED,1318,1254,AMRITSAR-NANDED,2572,All
2018,10,AMRITSAR,NANDED,1072,1029,AMRITSAR-NANDED,2101,All
2018,11,AMRITSAR,NANDED,1098,1019,AMRITSAR-NANDED,2117,All
2018,12,AMRITSAR,NANDED,1420,1301,AMRITSAR-NANDED,2721,All
2019,1,AMRITSAR,NANDED,1088,1037,AMRITSAR-NANDED,2125,All
2019,2,AMRITSAR,NANDED,1151,1018,AMRITSAR-NANDED,2169,All
2019,3,AMRITSAR,NANDED,1435,1351,AMRITSAR-NANDED,2786,All
2019,4,AMRITSAR,NANDED,837,898,AMRITSAR-NANDED,1735,All
2019,5,AMRITSAR,NANDED,650,590,AMRITSAR-NANDED,1240,All
2019,6,AMRITSAR,NANDED,1278,969,AMRITSAR-NANDED,2247,All
2019,7,AMRITSAR,NANDED,735,705,AMRITSAR-NANDED,1440,All
2019,8,AMRITSAR,NANDED,968,846,AMRITSAR-NANDED,1814,All
2019,9,AMRITSAR,NANDED,951,836,AMRITSAR-NANDED,1787,All
2019,10,AMRITSAR,NANDED,584,506,AMRITSAR-NANDED,1090,All
2019,11,AMRITSAR,NANDED,837,776,AMRITSAR-NANDED,1613,All
2019,12,AMRITSAR,NANDED,1001,868,AMRITSAR-NANDED,1869,All
2020,1,AMRITSAR,NANDED,912,880,AMRITSAR-NANDED,1792,All
2020,2,AMRITSAR,NANDED,1060,972,AMRITSAR-NANDED,2032,All
2020,3,AMRITSAR,NANDED,626,647,AMRITSAR-NANDED,1273,All
2020,11,AMRITSAR,NANDED,648,618,AMRITSAR-NANDED,1266,All
2020,12,AMRITSAR,NANDED,1113,813,AMRITSAR-NANDED,1926,All
2021,1,AMRITSAR,NANDED,892,888,AMRITSAR-NANDED,1780,All
2021,2,AMRITSAR,NANDED,1277,1250,AMRITSAR-NANDED,2527,All
2021,3,AMRITSAR,NANDED,1052,1101,AMRITSAR-NANDED,2153,All
2021,4,AMRITSAR,NANDED,367,389,AMRITSAR-NANDED,756,All
2021,8,AMRITSAR,NANDED,722,632,AMRITSAR-NANDED,1354,All
2021,9,AMRITSAR,NANDED,480,583,AMRITSAR-NANDED,1063,All
2021,10,AMRITSAR,NANDED,1053,941,AMRITSAR-NANDED,1994,All
2021,11,AMRITSAR,NANDED,69,61,AMRITSAR-NANDED,130,All
2021,12,AMRITSAR,NANDED,411,265,AMRITSAR-NANDED,676,All
2022,1,AMRITSAR,NANDED,383,519,AMRITSAR-NANDED,902,All
2022,2,AMRITSAR,NANDED,469,423,AMRITSAR-NANDED,892,All
2022,3,AMRITSAR,NANDED,490,436,AMRITSAR-NANDED,926,All
2019,10,AMRITSAR,PATNA,301,364,AMRITSAR-PATNA,665,All
2019,11,AMRITSAR,PATNA,1534,2122,AMRITSAR-PATNA,3656,All
2019,12,AMRITSAR,PATNA,1237,1843,AMRITSAR-PATNA,3080,All
2020,1,AMRITSAR,PATNA,846,1555,AMRITSAR-PATNA,2401,All
2020,2,AMRITSAR,PATNA,1018,1496,AMRITSAR-PATNA,2514,All
2020,3,AMRITSAR,PATNA,646,1289,AMRITSAR-PATNA,1935,All
2020,5,AMRITSAR,PATNA,234,136,AMRITSAR-PATNA,370,All
2020,6,AMRITSAR,PATNA,78,65,AMRITSAR-PATNA,143,All
2020,8,AMRITSAR,PATNA,90,177,AMRITSAR-PATNA,267,All
2020,9,AMRITSAR,PATNA,611,728,AMRITSAR-PATNA,1339,All
2020,10,AMRITSAR,PATNA,920,767,AMRITSAR-PATNA,1687,All
2020,11,AMRITSAR,PATNA,1203,811,AMRITSAR-PATNA,2014,All
2020,12,AMRITSAR,PATNA,969,969,AMRITSAR-PATNA,1938,All
2021,1,AMRITSAR,PATNA,863,900,AMRITSAR-PATNA,1763,All
2021,2,AMRITSAR,PATNA,910,810,AMRITSAR-PATNA,1720,All
2021,3,AMRITSAR,PATNA,1168,978,AMRITSAR-PATNA,2146,All
2021,4,AMRITSAR,PATNA,1861,1615,AMRITSAR-PATNA,3476,All
2021,6,AMRITSAR,PATNA,1049,1193,AMRITSAR-PATNA,2242,All
2021,7,AMRITSAR,PATNA,1343,1225,AMRITSAR-PATNA,2568,All
2021,8,AMRITSAR,PATNA,1320,1574,AMRITSAR-PATNA,2894,All
2021,9,AMRITSAR,PATNA,1037,1112,AMRITSAR-PATNA,2149,All
2021,10,AMRITSAR,PATNA,1453,1432,AMRITSAR-PATNA,2885,All
2021,11,AMRITSAR,PATNA,1557,1607,AMRITSAR-PATNA,3164,All
2021,12,AMRITSAR,PATNA,1420,1694,AMRITSAR-PATNA,3114,All
2022,1,AMRITSAR,PATNA,931,980,AMRITSAR-PATNA,1911,All
2022,2,AMRITSAR,PATNA,1264,1139,AMRITSAR-PATNA,2403,All
2022,3,AMRITSAR,PATNA,1582,1567,AMRITSAR-PATNA,3149,All
2022,4,AMRITSAR,PATNA,1584,1394,AMRITSAR-PATNA,2978,All
2022,5,AMRITSAR,PATNA,1553,1676,AMRITSAR-PATNA,3229,All
2022,6,AMRITSAR,PATNA,1698,1725,AMRITSAR-PATNA,3423,All
2022,7,AMRITSAR,PATNA,1005,1112,AMRITSAR-PATNA,2117,All
2022,8,AMRITSAR,PATNA,1068,1211,AMRITSAR-PATNA,2279,All
2022,9,AMRITSAR,PATNA,965,1008,AMRITSAR-PATNA,1973,All
2022,10,AMRITSAR,PATNA,1607,1428,AMRITSAR-PATNA,3035,All
2022,11,AMRITSAR,PATNA,671,734,AMRITSAR-PATNA,1405,All
2023,1,AMRITSAR,PATNA,408,257,AMRITSAR-PATNA,665,All
2023,2,AMRITSAR,PATNA,1890,1838,AMRITSAR-PATNA,3728,All
2023,3,AMRITSAR,PATNA,2218,2210,AMRITSAR-PATNA,4428,All
2023,4,AMRITSAR,PATNA,1933,1556,AMRITSAR-PATNA,3489,All
2023,5,AMRITSAR,PATNA,2152,1730,AMRITSAR-PATNA,3882,All
2023,6,AMRITSAR,PATNA,2078,2005,AMRITSAR-PATNA,4083,All
2023,7,AMRITSAR,PATNA,1305,1396,AMRITSAR-PATNA,2701,All
2023,8,AMRITSAR,PATNA,690,625,AMRITSAR-PATNA,1315,All
2017,6,AMRITSAR,PUNE,831,372,AMRITSAR-PUNE,1203,All
2017,7,AMRITSAR,PUNE,248,328,AMRITSAR-PUNE,576,All
2017,8,AMRITSAR,PUNE,197,365,AMRITSAR-PUNE,562,All
2017,9,AMRITSAR,PUNE,160,385,AMRITSAR-PUNE,545,All
2017,10,AMRITSAR,PUNE,615,894,AMRITSAR-PUNE,1509,All
2017,11,AMRITSAR,PUNE,531,610,AMRITSAR-PUNE,1141,All
2017,12,AMRITSAR,PUNE,864,748,AMRITSAR-PUNE,1612,All
2018,1,AMRITSAR,PUNE,761,518,AMRITSAR-PUNE,1279,All
2018,2,AMRITSAR,PUNE,666,649,AMRITSAR-PUNE,1315,All
2018,3,AMRITSAR,PUNE,418,468,AMRITSAR-PUNE,886,All
2018,4,AMRITSAR,PUNE,281,397,AMRITSAR-PUNE,678,All
2018,5,AMRITSAR,PUNE,193,418,AMRITSAR-PUNE,611,All
2018,6,AMRITSAR,PUNE,101,242,AMRITSAR-PUNE,343,All
2018,7,AMRITSAR,PUNE,55,201,AMRITSAR-PUNE,256,All
2018,8,AMRITSAR,PUNE,62,236,AMRITSAR-PUNE,298,All
2018,9,AMRITSAR,PUNE,89,202,AMRITSAR-PUNE,291,All
2018,10,AMRITSAR,PUNE,211,331,AMRITSAR-PUNE,542,All
2018,11,AMRITSAR,PUNE,244,147,AMRITSAR-PUNE,391,All
2018,12,AMRITSAR,PUNE,78,7,AMRITSAR-PUNE,85,All
2019,1,AMRITSAR,PUNE,92,0,AMRITSAR-PUNE,92,All
2019,2,AMRITSAR,PUNE,84,0,AMRITSAR-PUNE,84,All
2019,3,AMRITSAR,PUNE,63,0,AMRITSAR-PUNE,63,All
2021,1,AMRITSAR,PUNE,209,213,AMRITSAR-PUNE,422,All
2021,2,AMRITSAR,PUNE,343,297,AMRITSAR-PUNE,640,All
2021,3,AMRITSAR,PUNE,526,363,AMRITSAR-PUNE,889,All
2021,12,AMRITSAR,PUNE,2345,1938,AMRITSAR-PUNE,4283,All
2022,1,AMRITSAR,PUNE,903,580,AMRITSAR-PUNE,1483,All
2022,3,AMRITSAR,PUNE,1965,2046,AMRITSAR-PUNE,4011,All
2022,4,AMRITSAR,PUNE,3578,4411,AMRITSAR-PUNE,7989,All
2022,5,AMRITSAR,PUNE,4189,5074,AMRITSAR-PUNE,9263,All
2022,6,AMRITSAR,PUNE,3994,3728,AMRITSAR-PUNE,7722,All
2022,7,AMRITSAR,PUNE,3029,3575,AMRITSAR-PUNE,6604,All
2022,8,AMRITSAR,PUNE,2739,2965,AMRITSAR-PUNE,5704,All
2022,9,AMRITSAR,PUNE,1946,2277,AMRITSAR-PUNE,4223,All
2022,10,AMRITSAR,PUNE,2644,2911,AMRITSAR-PUNE,5555,All
2022,11,AMRITSAR,PUNE,4432,3766,AMRITSAR-PUNE,8198,All
2022,12,AMRITSAR,PUNE,4041,3573,AMRITSAR-PUNE,7614,All
2023,1,AMRITSAR,PUNE,3106,2684,AMRITSAR-PUNE,5790,All
2023,2,AMRITSAR,PUNE,4074,4228,AMRITSAR-PUNE,8302,All
2023,3,AMRITSAR,PUNE,4739,4586,AMRITSAR-PUNE,9325,All
2023,4,AMRITSAR,PUNE,4319,4340,AMRITSAR-PUNE,8659,All
2023,5,AMRITSAR,PUNE,5293,5043,AMRITSAR-PUNE,10336,All
2023,6,AMRITSAR,PUNE,5103,4347,AMRITSAR-PUNE,9450,All
2023,7,AMRITSAR,PUNE,4624,4498,AMRITSAR-PUNE,9122,All
2023,8,AMRITSAR,PUNE,4531,4374,AMRITSAR-PUNE,8905,All
2023,9,AMRITSAR,PUNE,4872,4436,AMRITSAR-PUNE,9308,All
2023,10,AMRITSAR,PUNE,4826,4909,AMRITSAR-PUNE,9735,All
2023,11,AMRITSAR,PUNE,4802,5045,AMRITSAR-PUNE,9847,All
2023,12,AMRITSAR,PUNE,4718,4367,AMRITSAR-PUNE,9085,All
2024,1,AMRITSAR,PUNE,4979,5104,AMRITSAR-PUNE,10083,All
2024,2,AMRITSAR,PUNE,4733,4899,AMRITSAR-PUNE,9632,All
2024,3,AMRITSAR,PUNE,5166,5327,AMRITSAR-PUNE,10493,All
2024,4,AMRITSAR,PUNE,5124,5138,AMRITSAR-PUNE,10262,All
2024,6,AMRITSAR,PUNE,5355,4944,AMRITSAR-PUNE,10299,All
2024,7,AMRITSAR,PUNE,5377,5052,AMRITSAR-PUNE,10429,All
2024,8,AMRITSAR,PUNE,4550,4325,AMRITSAR-PUNE,8875,All
2024,9,AMRITSAR,PUNE,4371,4451,AMRITSAR-PUNE,8822,All
2024,10,AMRITSAR,PUNE,4219,5209,AMRITSAR-PUNE,9428,All
2024,11,AMRITSAR,PUNE,3602,3407,AMRITSAR-PUNE,7009,All
2024,12,AMRITSAR,PUNE,5316,5069,AMRITSAR-PUNE,10385,All
2025,1,AMRITSAR,PUNE,3293,3327,AMRITSAR-PUNE,6620,All
2025,2,AMRITSAR,PUNE,4250,4652,AMRITSAR-PUNE,8902,All
2025,3,AMRITSAR,PUNE,5355,5014,AMRITSAR-PUNE,10369,All
2022,5,AMRITSAR,RAJKOT,0,86,AMRITSAR-RAJKOT,86,All
2023,11,AMRITSAR,SIMLA,113,110,AMRITSAR-SIMLA,223,All
2023,12,AMRITSAR,SIMLA,142,141,AMRITSAR-SIMLA,283,All
2024,1,AMRITSAR,SIMLA,131,95,AMRITSAR-SIMLA,226,All
2024,2,AMRITSAR,SIMLA,199,135,AMRITSAR-SIMLA,334,All
2024,3,AMRITSAR,SIMLA,363,232,AMRITSAR-SIMLA,595,All
2024,4,AMRITSAR,SIMLA,369,185,AMRITSAR-SIMLA,554,All
2024,6,AMRITSAR,SIMLA,336,183,AMRITSAR-SIMLA,519,All
2024,7,AMRITSAR,SIMLA,65,25,AMRITSAR-SIMLA,90,All
2024,8,AMRITSAR,SIMLA,70,40,AMRITSAR-SIMLA,110,All
2024,9,AMRITSAR,SIMLA,72,52,AMRITSAR-SIMLA,124,All
2024,10,AMRITSAR,SIMLA,314,243,AMRITSAR-SIMLA,557,All
2024,11,AMRITSAR,SIMLA,191,121,AMRITSAR-SIMLA,312,All
2024,12,AMRITSAR,SIMLA,52,46,AMRITSAR-SIMLA,98,All
2025,1,AMRITSAR,SIMLA,104,68,AMRITSAR-SIMLA,172,All
2025,2,AMRITSAR,SIMLA,212,140,AMRITSAR-SIMLA,352,All
2025,3,AMRITSAR,SIMLA,361,260,AMRITSAR-SIMLA,621,All
2015,4,AMRITSAR,SRINAGAR,3683,3858,AMRITSAR-SRINAGAR,7541,All
2015,5,AMRITSAR,SRINAGAR,3225,3687,AMRITSAR-SRINAGAR,6912,All
2015,6,AMRITSAR,SRINAGAR,4641,4415,AMRITSAR-SRINAGAR,9056,All
2015,7,AMRITSAR,SRINAGAR,4152,5144,AMRITSAR-SRINAGAR,9296,All
2015,8,AMRITSAR,SRINAGAR,3615,4742,AMRITSAR-SRINAGAR,8357,All
2015,9,AMRITSAR,SRINAGAR,3910,4444,AMRITSAR-SRINAGAR,8354,All
2015,10,AMRITSAR,SRINAGAR,3513,5297,AMRITSAR-SRINAGAR,8810,All
2015,11,AMRITSAR,SRINAGAR,2868,4447,AMRITSAR-SRINAGAR,7315,All
2015,12,AMRITSAR,SRINAGAR,3505,5197,AMRITSAR-SRINAGAR,8702,All
2016,1,AMRITSAR,SRINAGAR,3132,4948,AMRITSAR-SRINAGAR,8080,All
2016,2,AMRITSAR,SRINAGAR,4792,4977,AMRITSAR-SRINAGAR,9769,All
2016,3,AMRITSAR,SRINAGAR,5357,5231,AMRITSAR-SRINAGAR,10588,All
2016,4,AMRITSAR,SRINAGAR,4408,4622,AMRITSAR-SRINAGAR,9030,All
2016,5,AMRITSAR,SRINAGAR,3877,4107,AMRITSAR-SRINAGAR,7984,All
2016,6,AMRITSAR,SRINAGAR,4668,4628,AMRITSAR-SRINAGAR,9296,All
2016,7,AMRITSAR,SRINAGAR,3188,4597,AMRITSAR-SRINAGAR,7785,All
2016,8,AMRITSAR,SRINAGAR,2487,5082,AMRITSAR-SRINAGAR,7569,All
2016,9,AMRITSAR,SRINAGAR,3278,4509,AMRITSAR-SRINAGAR,7787,All
2016,10,AMRITSAR,SRINAGAR,4272,5261,AMRITSAR-SRINAGAR,9533,All
2016,11,AMRITSAR,SRINAGAR,1313,1617,AMRITSAR-SRINAGAR,2930,All
2017,3,AMRITSAR,SRINAGAR,1002,1046,AMRITSAR-SRINAGAR,2048,All
2017,4,AMRITSAR,SRINAGAR,4045,4999,AMRITSAR-SRINAGAR,9044,All
2017,5,AMRITSAR,SRINAGAR,3670,4642,AMRITSAR-SRINAGAR,8312,All
2017,6,AMRITSAR,SRINAGAR,4073,4749,AMRITSAR-SRINAGAR,8822,All
2017,7,AMRITSAR,SRINAGAR,3853,5096,AMRITSAR-SRINAGAR,8949,All
2017,10,AMRITSAR,SRINAGAR,2368,3084,AMRITSAR-SRINAGAR,5452,All
2017,11,AMRITSAR,SRINAGAR,1742,2884,AMRITSAR-SRINAGAR,4626,All
2017,12,AMRITSAR,SRINAGAR,2353,2768,AMRITSAR-SRINAGAR,5121,All
2018,1,AMRITSAR,SRINAGAR,1640,2350,AMRITSAR-SRINAGAR,3990,All
2018,2,AMRITSAR,SRINAGAR,2801,2725,AMRITSAR-SRINAGAR,5526,All
2018,3,AMRITSAR,SRINAGAR,3471,2465,AMRITSAR-SRINAGAR,5936,All
2018,4,AMRITSAR,SRINAGAR,2629,3043,AMRITSAR-SRINAGAR,5672,All
2018,5,AMRITSAR,SRINAGAR,2947,2476,AMRITSAR-SRINAGAR,5423,All
2018,6,AMRITSAR,SRINAGAR,3275,3030,AMRITSAR-SRINAGAR,6305,All
2018,7,AMRITSAR,SRINAGAR,2989,3763,AMRITSAR-SRINAGAR,6752,All
2018,8,AMRITSAR,SRINAGAR,1607,1828,AMRITSAR-SRINAGAR,3435,All
2018,9,AMRITSAR,SRINAGAR,1473,1744,AMRITSAR-SRINAGAR,3217,All
2018,10,AMRITSAR,SRINAGAR,2061,2693,AMRITSAR-SRINAGAR,4754,All
2018,11,AMRITSAR,SRINAGAR,2284,3185,AMRITSAR-SRINAGAR,5469,All
2018,12,AMRITSAR,SRINAGAR,2864,3050,AMRITSAR-SRINAGAR,5914,All
2019,1,AMRITSAR,SRINAGAR,2288,2224,AMRITSAR-SRINAGAR,4512,All
2019,2,AMRITSAR,SRINAGAR,2698,3184,AMRITSAR-SRINAGAR,5882,All
2019,3,AMRITSAR,SRINAGAR,3609,3924,AMRITSAR-SRINAGAR,7533,All
2019,4,AMRITSAR,SRINAGAR,3472,4120,AMRITSAR-SRINAGAR,7592,All
2019,5,AMRITSAR,SRINAGAR,3358,3749,AMRITSAR-SRINAGAR,7107,All
2019,6,AMRITSAR,SRINAGAR,3119,3732,AMRITSAR-SRINAGAR,6851,All
2019,7,AMRITSAR,SRINAGAR,2757,3452,AMRITSAR-SRINAGAR,6209,All
2019,8,AMRITSAR,SRINAGAR,1722,2157,AMRITSAR-SRINAGAR,3879,All
2019,9,AMRITSAR,SRINAGAR,2099,2580,AMRITSAR-SRINAGAR,4679,All
2019,10,AMRITSAR,SRINAGAR,2886,4494,AMRITSAR-SRINAGAR,7380,All
2019,11,AMRITSAR,SRINAGAR,3536,3714,AMRITSAR-SRINAGAR,7250,All
2019,12,AMRITSAR,SRINAGAR,6077,6200,AMRITSAR-SRINAGAR,12277,All
2020,1,AMRITSAR,SRINAGAR,6956,6845,AMRITSAR-SRINAGAR,13801,All
2020,2,AMRITSAR,SRINAGAR,5441,5431,AMRITSAR-SRINAGAR,10872,All
2020,3,AMRITSAR,SRINAGAR,1599,2807,AMRITSAR-SRINAGAR,4406,All
2020,5,AMRITSAR,SRINAGAR,0,68,AMRITSAR-SRINAGAR,68,All
2020,7,AMRITSAR,SRINAGAR,48,0,AMRITSAR-SRINAGAR,48,All
2020,10,AMRITSAR,SRINAGAR,322,447,AMRITSAR-SRINAGAR,769,All
2020,11,AMRITSAR,SRINAGAR,1132,1724,AMRITSAR-SRINAGAR,2856,All
2020,12,AMRITSAR,SRINAGAR,1365,1654,AMRITSAR-SRINAGAR,3019,All
2021,1,AMRITSAR,SRINAGAR,1243,1456,AMRITSAR-SRINAGAR,2699,All
2021,2,AMRITSAR,SRINAGAR,1531,1772,AMRITSAR-SRINAGAR,3303,All
2021,3,AMRITSAR,SRINAGAR,2216,2071,AMRITSAR-SRINAGAR,4287,All
2021,4,AMRITSAR,SRINAGAR,2492,2446,AMRITSAR-SRINAGAR,4938,All
2021,6,AMRITSAR,SRINAGAR,803,817,AMRITSAR-SRINAGAR,1620,All
2021,7,AMRITSAR,SRINAGAR,3567,3493,AMRITSAR-SRINAGAR,7060,All
2021,8,AMRITSAR,SRINAGAR,3023,3158,AMRITSAR-SRINAGAR,6181,All
2021,9,AMRITSAR,SRINAGAR,2661,3140,AMRITSAR-SRINAGAR,5801,All
2021,10,AMRITSAR,SRINAGAR,2534,3422,AMRITSAR-SRINAGAR,5956,All
2021,11,AMRITSAR,SRINAGAR,3859,5605,AMRITSAR-SRINAGAR,9464,All
2021,12,AMRITSAR,SRINAGAR,6088,6539,AMRITSAR-SRINAGAR,12627,All
2022,1,AMRITSAR,SRINAGAR,3655,3943,AMRITSAR-SRINAGAR,7598,All
2022,2,AMRITSAR,SRINAGAR,3604,4026,AMRITSAR-SRINAGAR,7630,All
2022,3,AMRITSAR,SRINAGAR,5451,4566,AMRITSAR-SRINAGAR,10017,All
2022,4,AMRITSAR,SRINAGAR,9109,7320,AMRITSAR-SRINAGAR,16429,All
2022,5,AMRITSAR,SRINAGAR,11774,8165,AMRITSAR-SRINAGAR,19939,All
2022,6,AMRITSAR,SRINAGAR,11558,11129,AMRITSAR-SRINAGAR,22687,All
2022,7,AMRITSAR,SRINAGAR,8857,9423,AMRITSAR-SRINAGAR,18280,All
2022,8,AMRITSAR,SRINAGAR,5214,5654,AMRITSAR-SRINAGAR,10868,All
2022,9,AMRITSAR,SRINAGAR,3742,4060,AMRITSAR-SRINAGAR,7802,All
2022,10,AMRITSAR,SRINAGAR,3934,4179,AMRITSAR-SRINAGAR,8113,All
2022,11,AMRITSAR,SRINAGAR,3279,3804,AMRITSAR-SRINAGAR,7083,All
2022,12,AMRITSAR,SRINAGAR,3741,3081,AMRITSAR-SRINAGAR,6822,All
2023,1,AMRITSAR,SRINAGAR,3247,3317,AMRITSAR-SRINAGAR,6564,All
2023,2,AMRITSAR,SRINAGAR,4968,4173,AMRITSAR-SRINAGAR,9141,All
2023,3,AMRITSAR,SRINAGAR,6920,6206,AMRITSAR-SRINAGAR,13126,All
2023,4,AMRITSAR,SRINAGAR,5937,5662,AMRITSAR-SRINAGAR,11599,All
2023,5,AMRITSAR,SRINAGAR,5588,5266,AMRITSAR-SRINAGAR,10854,All
2023,6,AMRITSAR,SRINAGAR,5187,4880,AMRITSAR-SRINAGAR,10067,All
2023,7,AMRITSAR,SRINAGAR,6370,6021,AMRITSAR-SRINAGAR,12391,All
2023,8,AMRITSAR,SRINAGAR,4980,4855,AMRITSAR-SRINAGAR,9835,All
2023,9,AMRITSAR,SRINAGAR,5049,4511,AMRITSAR-SRINAGAR,9560,All
2023,10,AMRITSAR,SRINAGAR,5247,6018,AMRITSAR-SRINAGAR,11265,All
2023,11,AMRITSAR,SRINAGAR,5775,5607,AMRITSAR-SRINAGAR,11382,All
2023,12,AMRITSAR,SRINAGAR,6747,5805,AMRITSAR-SRINAGAR,12552,All
2024,1,AMRITSAR,SRINAGAR,3521,3517,AMRITSAR-SRINAGAR,7038,All
2024,2,AMRITSAR,SRINAGAR,4241,3793,AMRITSAR-SRINAGAR,8034,All
2024,3,AMRITSAR,SRINAGAR,7342,6381,AMRITSAR-SRINAGAR,13723,All
2024,4,AMRITSAR,SRINAGAR,6205,5555,AMRITSAR-SRINAGAR,11760,All
2024,6,AMRITSAR,SRINAGAR,6549,5857,AMRITSAR-SRINAGAR,12406,All
2024,7,AMRITSAR,SRINAGAR,7557,7115,AMRITSAR-SRINAGAR,14672,All
2024,8,AMRITSAR,SRINAGAR,7069,6539,AMRITSAR-SRINAGAR,13608,All
2024,9,AMRITSAR,SRINAGAR,6626,6308,AMRITSAR-SRINAGAR,12934,All
2024,10,AMRITSAR,SRINAGAR,6111,7831,AMRITSAR-SRINAGAR,13942,All
2024,11,AMRITSAR,SRINAGAR,6248,5669,AMRITSAR-SRINAGAR,11917,All
2024,12,AMRITSAR,SRINAGAR,7799,7445,AMRITSAR-SRINAGAR,15244,All
2025,1,AMRITSAR,SRINAGAR,7219,6960,AMRITSAR-SRINAGAR,14179,All
2025,2,AMRITSAR,SRINAGAR,7860,7407,AMRITSAR-SRINAGAR,15267,All
2025,3,AMRITSAR,SRINAGAR,9574,8863,AMRITSAR-SRINAGAR,18437,All
2024,11,AMRITSAR,VARANASI,0,1,AMRITSAR-VARANASI,1,All
2024,12,AMRITSAR,VARANASI,0,1,AMRITSAR-VARANASI,1,All
2025,3,AMRITSAR,VARANASI,0,46,AMRITSAR-VARANASI,46,All
2019,11,AMRITSAR,VISAKHAPATNAM,0,0,AMRITSAR-VISAKHAPATNAM,0,All
2020,3,AURANGABAD,BAGDOGRA,0,50,AURANGABAD-BAGDOGRA,50,All
2019,11,AURANGABAD,BENGALURU,1282,1293,AURANGABAD-BENGALURU,2575,All
2019,12,AURANGABAD,BENGALURU,3150,2891,AURANGABAD-BENGALURU,6041,All
2020,1,AURANGABAD,BENGALURU,2933,2730,AURANGABAD-BENGALURU,5663,All
2020,2,AURANGABAD,BENGALURU,2714,2864,AURANGABAD-BENGALURU,5578,All
2020,3,AURANGABAD,BENGALURU,1900,2420,AURANGABAD-BENGALURU,4320,All
2020,12,AURANGABAD,BENGALURU,845,697,AURANGABAD-BENGALURU,1542,All
2021,1,AURANGABAD,BENGALURU,1767,1123,AURANGABAD-BENGALURU,2890,All
2021,2,AURANGABAD,BENGALURU,1597,1111,AURANGABAD-BENGALURU,2708,All
2021,3,AURANGABAD,BENGALURU,806,537,AURANGABAD-BENGALURU,1343,All
2023,3,AURANGABAD,BENGALURU,201,216,AURANGABAD-BENGALURU,417,All
2023,4,AURANGABAD,BENGALURU,1666,1760,AURANGABAD-BENGALURU,3426,All
2023,5,AURANGABAD,BENGALURU,1996,1897,AURANGABAD-BENGALURU,3893,All
2023,6,AURANGABAD,BENGALURU,1884,2032,AURANGABAD-BENGALURU,3916,All
2023,7,AURANGABAD,BENGALURU,1839,1884,AURANGABAD-BENGALURU,3723,All
2023,8,AURANGABAD,BENGALURU,2002,2175,AURANGABAD-BENGALURU,4177,All
2023,9,AURANGABAD,BENGALURU,1916,1973,AURANGABAD-BENGALURU,3889,All
2023,10,AURANGABAD,BENGALURU,1945,2030,AURANGABAD-BENGALURU,3975,All
2023,11,AURANGABAD,BENGALURU,2624,2640,AURANGABAD-BENGALURU,5264,All
2023,12,AURANGABAD,BENGALURU,2996,2913,AURANGABAD-BENGALURU,5909,All
2024,1,AURANGABAD,BENGALURU,2848,2951,AURANGABAD-BENGALURU,5799,All
2024,2,AURANGABAD,BENGALURU,2500,2678,AURANGABAD-BENGALURU,5178,All
2024,3,AURANGABAD,BENGALURU,2677,2820,AURANGABAD-BENGALURU,5497,All
2024,4,AURANGABAD,BENGALURU,2673,2739,AURANGABAD-BENGALURU,5412,All
2024,6,AURANGABAD,BENGALURU,2803,2728,AURANGABAD-BENGALURU,5531,All
2024,7,AURANGABAD,BENGALURU,1460,1383,AURANGABAD-BENGALURU,2843,All
2024,8,AURANGABAD,BENGALURU,2836,2900,AURANGABAD-BENGALURU,5736,All
2024,9,AURANGABAD,BENGALURU,2554,2641,AURANGABAD-BENGALURU,5195,All
2024,10,AURANGABAD,BENGALURU,2560,2732,AURANGABAD-BENGALURU,5292,All
2024,11,AURANGABAD,BENGALURU,2104,1968,AURANGABAD-BENGALURU,4072,All
2024,12,AURANGABAD,BENGALURU,2170,2238,AURANGABAD-BENGALURU,4408,All
2025,1,AURANGABAD,BENGALURU,2173,2030,AURANGABAD-BENGALURU,4203,All
2025,2,AURANGABAD,BENGALURU,1270,1330,AURANGABAD-BENGALURU,2600,All
2025,3,AURANGABAD,BENGALURU,1960,2129,AURANGABAD-BENGALURU,4089,All
2019,10,AURANGABAD,BHOPAL,0,0,AURANGABAD-BHOPAL,0,All
2019,10,AURANGABAD,CHENNAI,0,71,AURANGABAD-CHENNAI,71,All
2019,11,AURANGABAD,CHENNAI,1865,2117,AURANGABAD-CHENNAI,3982,All
2019,12,AURANGABAD,CHENNAI,2037,2034,AURANGABAD-CHENNAI,4071,All
2020,12,AURANGABAD,CHENNAI,55,58,AURANGABAD-CHENNAI,113,All
2021,1,AURANGABAD,CHENNAI,154,177,AURANGABAD-CHENNAI,331,All
2021,2,AURANGABAD,CHENNAI,278,294,AURANGABAD-CHENNAI,572,All
2021,3,AURANGABAD,CHENNAI,171,140,AURANGABAD-CHENNAI,311,All
2024,10,AURANGABAD,DABOLIM,106,109,AURANGABAD-DABOLIM,215,All
2024,11,AURANGABAD,DABOLIM,669,556,AURANGABAD-DABOLIM,1225,All
2024,12,AURANGABAD,DABOLIM,601,593,AURANGABAD-DABOLIM,1194,All
2025,1,AURANGABAD,DABOLIM,617,521,AURANGABAD-DABOLIM,1138,All
2025,2,AURANGABAD,DABOLIM,611,581,AURANGABAD-DABOLIM,1192,All
2025,3,AURANGABAD,DABOLIM,562,603,AURANGABAD-DABOLIM,1165,All
2019,5,AURANGABAD,DELHI,3645,3244,AURANGABAD-DELHI,6889,All
2019,6,AURANGABAD,DELHI,3354,2963,AURANGABAD-DELHI,6317,All
2019,7,AURANGABAD,DELHI,3115,3514,AURANGABAD-DELHI,6629,All
2019,8,AURANGABAD,DELHI,3305,3164,AURANGABAD-DELHI,6469,All
2019,9,AURANGABAD,DELHI,3547,3063,AURANGABAD-DELHI,6610,All
2019,10,AURANGABAD,DELHI,6765,5654,AURANGABAD-DELHI,12419,All
2019,11,AURANGABAD,DELHI,10066,11253,AURANGABAD-DELHI,21319,All
2019,12,AURANGABAD,DELHI,14527,14968,AURANGABAD-DELHI,29495,All
2020,1,AURANGABAD,DELHI,11054,9966,AURANGABAD-DELHI,21020,All
2020,2,AURANGABAD,DELHI,10592,9919,AURANGABAD-DELHI,20511,All
2020,3,AURANGABAD,DELHI,7784,7459,AURANGABAD-DELHI,15243,All
2020,6,AURANGABAD,DELHI,339,425,AURANGABAD-DELHI,764,All
2020,7,AURANGABAD,DELHI,1437,1162,AURANGABAD-DELHI,2599,All
2020,8,AURANGABAD,DELHI,1730,2075,AURANGABAD-DELHI,3805,All
2020,9,AURANGABAD,DELHI,2781,3258,AURANGABAD-DELHI,6039,All
2020,10,AURANGABAD,DELHI,4149,4648,AURANGABAD-DELHI,8797,All
2020,11,AURANGABAD,DELHI,5157,5333,AURANGABAD-DELHI,10490,All
2020,12,AURANGABAD,DELHI,3704,4157,AURANGABAD-DELHI,7861,All
2021,1,AURANGABAD,DELHI,4286,4449,AURANGABAD-DELHI,8735,All
2021,2,AURANGABAD,DELHI,4814,4531,AURANGABAD-DELHI,9345,All
2021,3,AURANGABAD,DELHI,3724,3312,AURANGABAD-DELHI,7036,All
2021,4,AURANGABAD,DELHI,2171,2984,AURANGABAD-DELHI,5155,All
2021,6,AURANGABAD,DELHI,2152,2236,AURANGABAD-DELHI,4388,All
2021,7,AURANGABAD,DELHI,4636,4617,AURANGABAD-DELHI,9253,All
2021,8,AURANGABAD,DELHI,5089,4124,AURANGABAD-DELHI,9213,All
2021,9,AURANGABAD,DELHI,5314,4584,AURANGABAD-DELHI,9898,All
2021,10,AURANGABAD,DELHI,6779,6548,AURANGABAD-DELHI,13327,All
2021,11,AURANGABAD,DELHI,7582,7902,AURANGABAD-DELHI,15484,All
2021,12,AURANGABAD,DELHI,8549,8912,AURANGABAD-DELHI,17461,All
2022,1,AURANGABAD,DELHI,4720,4334,AURANGABAD-DELHI,9054,All
2022,2,AURANGABAD,DELHI,5180,5296,AURANGABAD-DELHI,10476,All
2022,3,AURANGABAD,DELHI,7090,6694,AURANGABAD-DELHI,13784,All
2022,4,AURANGABAD,DELHI,7563,7165,AURANGABAD-DELHI,14728,All
2022,5,AURANGABAD,DELHI,8414,8765,AURANGABAD-DELHI,17179,All
2022,6,AURANGABAD,DELHI,6073,8065,AURANGABAD-DELHI,14138,All
2022,7,AURANGABAD,DELHI,6527,6765,AURANGABAD-DELHI,13292,All
2022,8,AURANGABAD,DELHI,5748,5554,AURANGABAD-DELHI,11302,All
2022,9,AURANGABAD,DELHI,7190,5668,AURANGABAD-DELHI,12858,All
2022,10,AURANGABAD,DELHI,8116,6570,AURANGABAD-DELHI,14686,All
2022,11,AURANGABAD,DELHI,9203,9654,AURANGABAD-DELHI,18857,All
2022,12,AURANGABAD,DELHI,9178,10282,AURANGABAD-DELHI,19460,All
2023,1,AURANGABAD,DELHI,9215,8570,AURANGABAD-DELHI,17785,All
2023,2,AURANGABAD,DELHI,9460,9103,AURANGABAD-DELHI,18563,All
2023,3,AURANGABAD,DELHI,9841,10061,AURANGABAD-DELHI,19902,All
2023,4,AURANGABAD,DELHI,9980,9097,AURANGABAD-DELHI,19077,All
2023,5,AURANGABAD,DELHI,8886,9000,AURANGABAD-DELHI,17886,All
2023,6,AURANGABAD,DELHI,8079,8547,AURANGABAD-DELHI,16626,All
2023,7,AURANGABAD,DELHI,8567,8729,AURANGABAD-DELHI,17296,All
2023,8,AURANGABAD,DELHI,8179,8430,AURANGABAD-DELHI,16609,All
2023,9,AURANGABAD,DELHI,7554,7971,AURANGABAD-DELHI,15525,All
2023,10,AURANGABAD,DELHI,8933,9100,AURANGABAD-DELHI,18033,All
2023,11,AURANGABAD,DELHI,9643,9639,AURANGABAD-DELHI,19282,All
2023,12,AURANGABAD,DELHI,9440,10323,AURANGABAD-DELHI,19763,All
2024,1,AURANGABAD,DELHI,9932,9380,AURANGABAD-DELHI,19312,All
2024,2,AURANGABAD,DELHI,9517,8730,AURANGABAD-DELHI,18247,All
2024,3,AURANGABAD,DELHI,11647,11815,AURANGABAD-DELHI,23462,All
2024,4,AURANGABAD,DELHI,10470,9425,AURANGABAD-DELHI,19895,All
2024,6,AURANGABAD,DELHI,10273,12426,AURANGABAD-DELHI,22699,All
2024,7,AURANGABAD,DELHI,9585,10867,AURANGABAD-DELHI,20452,All
2024,8,AURANGABAD,DELHI,10240,10655,AURANGABAD-DELHI,20895,All
2024,9,AURANGABAD,DELHI,9826,10590,AURANGABAD-DELHI,20416,All
2024,10,AURANGABAD,DELHI,12176,11511,AURANGABAD-DELHI,23687,All
2024,11,AURANGABAD,DELHI,13122,14220,AURANGABAD-DELHI,27342,All
2024,12,AURANGABAD,DELHI,13223,15393,AURANGABAD-DELHI,28616,All
2025,1,AURANGABAD,DELHI,11124,10617,AURANGABAD-DELHI,21741,All
2025,2,AURANGABAD,DELHI,10660,10293,AURANGABAD-DELHI,20953,All
2025,3,AURANGABAD,DELHI,11149,11231,AURANGABAD-DELHI,22380,All
2024,7,AURANGABAD,Goa,537,470,AURANGABAD-Goa,1007,All
2024,8,AURANGABAD,Goa,516,510,AURANGABAD-Goa,1026,All
2024,9,AURANGABAD,Goa,442,488,AURANGABAD-Goa,930,All
2024,10,AURANGABAD,Goa,471,440,AURANGABAD-Goa,911,All
2019,5,AURANGABAD,HYDERABAD,1565,1561,AURANGABAD-HYDERABAD,3126,All
2019,6,AURANGABAD,HYDERABAD,1326,1366,AURANGABAD-HYDERABAD,2692,All
2019,7,AURANGABAD,HYDERABAD,1688,1612,AURANGABAD-HYDERABAD,3300,All
2019,8,AURANGABAD,HYDERABAD,312,324,AURANGABAD-HYDERABAD,636,All
2019,9,AURANGABAD,HYDERABAD,88,57,AURANGABAD-HYDERABAD,145,All
2019,10,AURANGABAD,HYDERABAD,1199,992,AURANGABAD-HYDERABAD,2191,All
2019,11,AURANGABAD,HYDERABAD,4792,5348,AURANGABAD-HYDERABAD,10140,All
2019,12,AURANGABAD,HYDERABAD,6292,6007,AURANGABAD-HYDERABAD,12299,All
2020,1,AURANGABAD,HYDERABAD,4033,4552,AURANGABAD-HYDERABAD,8585,All
2020,2,AURANGABAD,HYDERABAD,6356,5414,AURANGABAD-HYDERABAD,11770,All
2020,3,AURANGABAD,HYDERABAD,2864,2755,AURANGABAD-HYDERABAD,5619,All
2020,7,AURANGABAD,HYDERABAD,500,558,AURANGABAD-HYDERABAD,1058,All
2020,8,AURANGABAD,HYDERABAD,1253,1300,AURANGABAD-HYDERABAD,2553,All
2020,9,AURANGABAD,HYDERABAD,1557,1499,AURANGABAD-HYDERABAD,3056,All
2020,10,AURANGABAD,HYDERABAD,1647,1507,AURANGABAD-HYDERABAD,3154,All
2020,11,AURANGABAD,HYDERABAD,2025,2061,AURANGABAD-HYDERABAD,4086,All
2020,12,AURANGABAD,HYDERABAD,2065,2137,AURANGABAD-HYDERABAD,4202,All
2021,1,AURANGABAD,HYDERABAD,1955,1866,AURANGABAD-HYDERABAD,3821,All
2021,2,AURANGABAD,HYDERABAD,1734,1633,AURANGABAD-HYDERABAD,3367,All
2021,3,AURANGABAD,HYDERABAD,1359,1217,AURANGABAD-HYDERABAD,2576,All
2021,4,AURANGABAD,HYDERABAD,719,370,AURANGABAD-HYDERABAD,1089,All
2021,6,AURANGABAD,HYDERABAD,202,232,AURANGABAD-HYDERABAD,434,All
2021,7,AURANGABAD,HYDERABAD,1070,657,AURANGABAD-HYDERABAD,1727,All
2021,8,AURANGABAD,HYDERABAD,1382,984,AURANGABAD-HYDERABAD,2366,All
2021,9,AURANGABAD,HYDERABAD,1801,1170,AURANGABAD-HYDERABAD,2971,All
2021,10,AURANGABAD,HYDERABAD,1886,1652,AURANGABAD-HYDERABAD,3538,All
2021,11,AURANGABAD,HYDERABAD,2108,2112,AURANGABAD-HYDERABAD,4220,All
2021,12,AURANGABAD,HYDERABAD,1968,2084,AURANGABAD-HYDERABAD,4052,All
2022,1,AURANGABAD,HYDERABAD,1260,1206,AURANGABAD-HYDERABAD,2466,All
2022,2,AURANGABAD,HYDERABAD,1137,1071,AURANGABAD-HYDERABAD,2208,All
2022,3,AURANGABAD,HYDERABAD,2277,2088,AURANGABAD-HYDERABAD,4365,All
2022,4,AURANGABAD,HYDERABAD,2201,2036,AURANGABAD-HYDERABAD,4237,All
2022,5,AURANGABAD,HYDERABAD,2165,2076,AURANGABAD-HYDERABAD,4241,All
2022,6,AURANGABAD,HYDERABAD,2695,2438,AURANGABAD-HYDERABAD,5133,All
2022,7,AURANGABAD,HYDERABAD,2820,2347,AURANGABAD-HYDERABAD,5167,All
2022,8,AURANGABAD,HYDERABAD,2359,2224,AURANGABAD-HYDERABAD,4583,All
2022,9,AURANGABAD,HYDERABAD,2162,2062,AURANGABAD-HYDERABAD,4224,All
2022,10,AURANGABAD,HYDERABAD,2435,2105,AURANGABAD-HYDERABAD,4540,All
2022,11,AURANGABAD,HYDERABAD,4161,3547,AURANGABAD-HYDERABAD,7708,All
2022,12,AURANGABAD,HYDERABAD,4241,3337,AURANGABAD-HYDERABAD,7578,All
2023,1,AURANGABAD,HYDERABAD,3948,3518,AURANGABAD-HYDERABAD,7466,All
2023,2,AURANGABAD,HYDERABAD,3732,3300,AURANGABAD-HYDERABAD,7032,All
2023,3,AURANGABAD,HYDERABAD,3851,3539,AURANGABAD-HYDERABAD,7390,All
2023,4,AURANGABAD,HYDERABAD,4069,3883,AURANGABAD-HYDERABAD,7952,All
2023,5,AURANGABAD,HYDERABAD,4335,4063,AURANGABAD-HYDERABAD,8398,All
2023,6,AURANGABAD,HYDERABAD,3996,3843,AURANGABAD-HYDERABAD,7839,All
2023,7,AURANGABAD,HYDERABAD,4000,3786,AURANGABAD-HYDERABAD,7786,All
2023,8,AURANGABAD,HYDERABAD,3803,3697,AURANGABAD-HYDERABAD,7500,All
2023,9,AURANGABAD,HYDERABAD,3631,3610,AURANGABAD-HYDERABAD,7241,All
2023,10,AURANGABAD,HYDERABAD,3774,3460,AURANGABAD-HYDERABAD,7234,All
2023,11,AURANGABAD,HYDERABAD,4037,3609,AURANGABAD-HYDERABAD,7646,All
2023,12,AURANGABAD,HYDERABAD,4244,3805,AURANGABAD-HYDERABAD,8049,All
2024,1,AURANGABAD,HYDERABAD,4077,3377,AURANGABAD-HYDERABAD,7454,All
2024,2,AURANGABAD,HYDERABAD,3772,3265,AURANGABAD-HYDERABAD,7037,All
2024,3,AURANGABAD,HYDERABAD,4283,3389,AURANGABAD-HYDERABAD,7672,All
2024,4,AURANGABAD,HYDERABAD,3763,3112,AURANGABAD-HYDERABAD,6875,All
2024,6,AURANGABAD,HYDERABAD,4101,3153,AURANGABAD-HYDERABAD,7254,All
2024,7,AURANGABAD,HYDERABAD,4159,3381,AURANGABAD-HYDERABAD,7540,All
2024,8,AURANGABAD,HYDERABAD,4265,3348,AURANGABAD-HYDERABAD,7613,All
2024,9,AURANGABAD,HYDERABAD,3929,3194,AURANGABAD-HYDERABAD,7123,All
2024,10,AURANGABAD,HYDERABAD,4107,3584,AURANGABAD-HYDERABAD,7691,All
2024,11,AURANGABAD,HYDERABAD,4293,4102,AURANGABAD-HYDERABAD,8395,All
2024,12,AURANGABAD,HYDERABAD,4442,4263,AURANGABAD-HYDERABAD,8705,All
2025,1,AURANGABAD,HYDERABAD,4436,4247,AURANGABAD-HYDERABAD,8683,All
2025,2,AURANGABAD,HYDERABAD,4151,3893,AURANGABAD-HYDERABAD,8044,All
2025,3,AURANGABAD,HYDERABAD,4367,3984,AURANGABAD-HYDERABAD,8351,All
2019,11,AURANGABAD,INDORE,172,273,AURANGABAD-INDORE,445,All
2019,12,AURANGABAD,INDORE,517,699,AURANGABAD-INDORE,1216,All
2021,3,AURANGABAD,JAIPUR,166,176,AURANGABAD-JAIPUR,342,All
2024,10,AURANGABAD,JAIPUR,31,17,AURANGABAD-JAIPUR,48,All
2024,11,AURANGABAD,JAIPUR,306,195,AURANGABAD-JAIPUR,501,All
2019,11,AURANGABAD,KOLKATA,40,32,AURANGABAD-KOLKATA,72,All
2019,12,AURANGABAD,KOLKATA,71,34,AURANGABAD-KOLKATA,105,All
2021,1,AURANGABAD,KOLKATA,64,70,AURANGABAD-KOLKATA,134,All
2021,2,AURANGABAD,KOLKATA,115,93,AURANGABAD-KOLKATA,208,All
2021,3,AURANGABAD,KOLKATA,61,44,AURANGABAD-KOLKATA,105,All
2024,7,AURANGABAD,LUCKNOW,109,79,AURANGABAD-LUCKNOW,188,All
2024,8,AURANGABAD,LUCKNOW,132,116,AURANGABAD-LUCKNOW,248,All
2024,9,AURANGABAD,LUCKNOW,145,77,AURANGABAD-LUCKNOW,222,All
2024,10,AURANGABAD,LUCKNOW,155,78,AURANGABAD-LUCKNOW,233,All
2024,11,AURANGABAD,LUCKNOW,122,98,AURANGABAD-LUCKNOW,220,All
2024,12,AURANGABAD,LUCKNOW,64,58,AURANGABAD-LUCKNOW,122,All
2025,3,AURANGABAD,LUCKNOW,178,123,AURANGABAD-LUCKNOW,301,All
2020,2,AURANGABAD,MANGALORE,13,0,AURANGABAD-MANGALORE,13,All
2020,3,AURANGABAD,MANGALORE,11,0,AURANGABAD-MANGALORE,11,All
2019,5,AURANGABAD,MUMBAI,3211,3510,AURANGABAD-MUMBAI,6721,All
2019,6,AURANGABAD,MUMBAI,3089,3538,AURANGABAD-MUMBAI,6627,All
2019,7,AURANGABAD,MUMBAI,3220,3234,AURANGABAD-MUMBAI,6454,All
2019,8,AURANGABAD,MUMBAI,3307,3380,AURANGABAD-MUMBAI,6687,All
2019,9,AURANGABAD,MUMBAI,4061,3636,AURANGABAD-MUMBAI,7697,All
2019,10,AURANGABAD,MUMBAI,3550,3874,AURANGABAD-MUMBAI,7424,All
2019,11,AURANGABAD,MUMBAI,3956,3931,AURANGABAD-MUMBAI,7887,All
2019,12,AURANGABAD,MUMBAI,4194,3876,AURANGABAD-MUMBAI,8070,All
2020,1,AURANGABAD,MUMBAI,4519,4108,AURANGABAD-MUMBAI,8627,All
2020,2,AURANGABAD,MUMBAI,7118,6162,AURANGABAD-MUMBAI,13280,All
2020,3,AURANGABAD,MUMBAI,3495,3218,AURANGABAD-MUMBAI,6713,All
2020,9,AURANGABAD,MUMBAI,187,155,AURANGABAD-MUMBAI,342,All
2020,10,AURANGABAD,MUMBAI,1723,1771,AURANGABAD-MUMBAI,3494,All
2020,11,AURANGABAD,MUMBAI,3407,3388,AURANGABAD-MUMBAI,6795,All
2020,12,AURANGABAD,MUMBAI,2822,2662,AURANGABAD-MUMBAI,5484,All
2021,1,AURANGABAD,MUMBAI,4356,3787,AURANGABAD-MUMBAI,8143,All
2021,2,AURANGABAD,MUMBAI,4985,4178,AURANGABAD-MUMBAI,9163,All
2021,3,AURANGABAD,MUMBAI,3230,2695,AURANGABAD-MUMBAI,5925,All
2021,4,AURANGABAD,MUMBAI,2042,1455,AURANGABAD-MUMBAI,3497,All
2021,6,AURANGABAD,MUMBAI,1796,1681,AURANGABAD-MUMBAI,3477,All
2021,7,AURANGABAD,MUMBAI,3365,3158,AURANGABAD-MUMBAI,6523,All
2021,8,AURANGABAD,MUMBAI,3553,4139,AURANGABAD-MUMBAI,7692,All
2021,9,AURANGABAD,MUMBAI,3900,4401,AURANGABAD-MUMBAI,8301,All
2021,10,AURANGABAD,MUMBAI,6219,6089,AURANGABAD-MUMBAI,12308,All
2021,11,AURANGABAD,MUMBAI,6684,6142,AURANGABAD-MUMBAI,12826,All
2021,12,AURANGABAD,MUMBAI,6699,6546,AURANGABAD-MUMBAI,13245,All
2022,1,AURANGABAD,MUMBAI,3278,3120,AURANGABAD-MUMBAI,6398,All
2022,2,AURANGABAD,MUMBAI,4365,4254,AURANGABAD-MUMBAI,8619,All
2022,3,AURANGABAD,MUMBAI,6108,6461,AURANGABAD-MUMBAI,12569,All
2022,4,AURANGABAD,MUMBAI,6559,6388,AURANGABAD-MUMBAI,12947,All
2022,5,AURANGABAD,MUMBAI,7311,6547,AURANGABAD-MUMBAI,13858,All
2022,6,AURANGABAD,MUMBAI,6588,6496,AURANGABAD-MUMBAI,13084,All
2022,7,AURANGABAD,MUMBAI,7260,7241,AURANGABAD-MUMBAI,14501,All
2022,8,AURANGABAD,MUMBAI,8274,7595,AURANGABAD-MUMBAI,15869,All
2022,9,AURANGABAD,MUMBAI,8620,8301,AURANGABAD-MUMBAI,16921,All
2022,10,AURANGABAD,MUMBAI,8094,7940,AURANGABAD-MUMBAI,16034,All
2022,11,AURANGABAD,MUMBAI,8135,6496,AURANGABAD-MUMBAI,14631,All
2022,12,AURANGABAD,MUMBAI,13343,12375,AURANGABAD-MUMBAI,25718,All
2023,1,AURANGABAD,MUMBAI,13112,11766,AURANGABAD-MUMBAI,24878,All
2023,2,AURANGABAD,MUMBAI,12227,10746,AURANGABAD-MUMBAI,22973,All
2023,3,AURANGABAD,MUMBAI,12050,9979,AURANGABAD-MUMBAI,22029,All
2023,4,AURANGABAD,MUMBAI,8485,7421,AURANGABAD-MUMBAI,15906,All
2023,5,AURANGABAD,MUMBAI,9494,8327,AURANGABAD-MUMBAI,17821,All
2023,6,AURANGABAD,MUMBAI,8284,8049,AURANGABAD-MUMBAI,16333,All
2023,7,AURANGABAD,MUMBAI,12163,11032,AURANGABAD-MUMBAI,23195,All
2023,8,AURANGABAD,MUMBAI,12962,10628,AURANGABAD-MUMBAI,23590,All
2023,9,AURANGABAD,MUMBAI,11924,10521,AURANGABAD-MUMBAI,22445,All
2023,10,AURANGABAD,MUMBAI,11166,10167,AURANGABAD-MUMBAI,21333,All
2023,11,AURANGABAD,MUMBAI,10707,10080,AURANGABAD-MUMBAI,20787,All
2023,12,AURANGABAD,MUMBAI,11131,11272,AURANGABAD-MUMBAI,22403,All
2024,1,AURANGABAD,MUMBAI,12890,11695,AURANGABAD-MUMBAI,24585,All
2024,2,AURANGABAD,MUMBAI,11277,10897,AURANGABAD-MUMBAI,22174,All
2024,3,AURANGABAD,MUMBAI,8839,8788,AURANGABAD-MUMBAI,17627,All
2024,4,AURANGABAD,MUMBAI,7136,7568,AURANGABAD-MUMBAI,14704,All
2024,6,AURANGABAD,MUMBAI,7903,8820,AURANGABAD-MUMBAI,16723,All
2024,7,AURANGABAD,MUMBAI,8452,8544,AURANGABAD-MUMBAI,16996,All
2024,8,AURANGABAD,MUMBAI,9717,9569,AURANGABAD-MUMBAI,19286,All
2024,9,AURANGABAD,MUMBAI,9805,9405,AURANGABAD-MUMBAI,19210,All
2024,10,AURANGABAD,MUMBAI,9038,10597,AURANGABAD-MUMBAI,19635,All
2024,11,AURANGABAD,MUMBAI,9617,8649,AURANGABAD-MUMBAI,18266,All
2024,12,AURANGABAD,MUMBAI,9947,9886,AURANGABAD-MUMBAI,19833,All
2025,1,AURANGABAD,MUMBAI,10104,9629,AURANGABAD-MUMBAI,19733,All
2025,2,AURANGABAD,MUMBAI,9584,9527,AURANGABAD-MUMBAI,19111,All
2025,3,AURANGABAD,MUMBAI,10330,9916,AURANGABAD-MUMBAI,20246,All
2024,7,AURANGABAD,NAGPUR,335,331,AURANGABAD-NAGPUR,666,All
2024,8,AURANGABAD,NAGPUR,387,389,AURANGABAD-NAGPUR,776,All
2024,9,AURANGABAD,NAGPUR,346,331,AURANGABAD-NAGPUR,677,All
2024,10,AURANGABAD,NAGPUR,424,275,AURANGABAD-NAGPUR,699,All
2024,11,AURANGABAD,NAGPUR,458,501,AURANGABAD-NAGPUR,959,All
2024,12,AURANGABAD,NAGPUR,370,397,AURANGABAD-NAGPUR,767,All
2025,1,AURANGABAD,NAGPUR,369,389,AURANGABAD-NAGPUR,758,All
2025,2,AURANGABAD,NAGPUR,424,336,AURANGABAD-NAGPUR,760,All
2025,3,AURANGABAD,NAGPUR,247,331,AURANGABAD-NAGPUR,578,All
2018,3,AURANGABAD,PUNE,23,9,AURANGABAD-PUNE,32,All
2015,10,AURANGABAD,TIRUPATI,0,71,AURANGABAD-TIRUPATI,71,All
2019,10,AURANGABAD,UDAIPUR,201,118,AURANGABAD-UDAIPUR,319,All
2019,11,AURANGABAD,UDAIPUR,490,519,AURANGABAD-UDAIPUR,1009,All
2019,12,AURANGABAD,UDAIPUR,518,335,AURANGABAD-UDAIPUR,853,All
2020,1,AURANGABAD,UDAIPUR,427,421,AURANGABAD-UDAIPUR,848,All
2020,2,AURANGABAD,UDAIPUR,363,473,AURANGABAD-UDAIPUR,836,All
2020,3,AURANGABAD,UDAIPUR,294,273,AURANGABAD-UDAIPUR,567,All
2021,4,AURANGABAD,VADODARA,3,0,AURANGABAD-VADODARA,3,All
2019,5,BAGDOGRA,BENGALURU,21129,22067,BAGDOGRA-BENGALURU,43196,All
2019,6,BAGDOGRA,BENGALURU,18645,18838,BAGDOGRA-BENGALURU,37483,All
2019,7,BAGDOGRA,BENGALURU,17865,17528,BAGDOGRA-BENGALURU,35393,All
2019,8,BAGDOGRA,BENGALURU,19518,19693,BAGDOGRA-BENGALURU,39211,All
2019,9,BAGDOGRA,BENGALURU,18623,21011,BAGDOGRA-BENGALURU,39634,All
2019,10,BAGDOGRA,BENGALURU,20319,22360,BAGDOGRA-BENGALURU,42679,All
2019,11,BAGDOGRA,BENGALURU,17381,17767,BAGDOGRA-BENGALURU,35148,All
2019,12,BAGDOGRA,BENGALURU,17281,18997,BAGDOGRA-BENGALURU,36278,All
2020,1,BAGDOGRA,BENGALURU,17621,19190,BAGDOGRA-BENGALURU,36811,All
2020,2,BAGDOGRA,BENGALURU,13732,16360,BAGDOGRA-BENGALURU,30092,All
2020,3,BAGDOGRA,BENGALURU,8295,13203,BAGDOGRA-BENGALURU,21498,All
2020,5,BAGDOGRA,BENGALURU,258,1007,BAGDOGRA-BENGALURU,1265,All
2020,6,BAGDOGRA,BENGALURU,2983,7262,BAGDOGRA-BENGALURU,10245,All
2020,7,BAGDOGRA,BENGALURU,4220,9067,BAGDOGRA-BENGALURU,13287,All
2020,8,BAGDOGRA,BENGALURU,11016,9362,BAGDOGRA-BENGALURU,20378,All
2020,9,BAGDOGRA,BENGALURU,14777,8973,BAGDOGRA-BENGALURU,23750,All
2020,10,BAGDOGRA,BENGALURU,19316,13593,BAGDOGRA-BENGALURU,32909,All
2020,11,BAGDOGRA,BENGALURU,18282,14573,BAGDOGRA-BENGALURU,32855,All
2020,12,BAGDOGRA,BENGALURU,24323,18744,BAGDOGRA-BENGALURU,43067,All
2021,1,BAGDOGRA,BENGALURU,22080,17013,BAGDOGRA-BENGALURU,39093,All
2021,2,BAGDOGRA,BENGALURU,20052,17666,BAGDOGRA-BENGALURU,37718,All
2021,3,BAGDOGRA,BENGALURU,19311,18578,BAGDOGRA-BENGALURU,37889,All
2021,4,BAGDOGRA,BENGALURU,10047,13307,BAGDOGRA-BENGALURU,23354,All
2021,6,BAGDOGRA,BENGALURU,6033,2388,BAGDOGRA-BENGALURU,8421,All
2021,7,BAGDOGRA,BENGALURU,12795,5280,BAGDOGRA-BENGALURU,18075,All
2021,8,BAGDOGRA,BENGALURU,16609,7824,BAGDOGRA-BENGALURU,24433,All
2021,9,BAGDOGRA,BENGALURU,14280,11106,BAGDOGRA-BENGALURU,25386,All
2021,10,BAGDOGRA,BENGALURU,16856,17651,BAGDOGRA-BENGALURU,34507,All
2021,11,BAGDOGRA,BENGALURU,18693,18300,BAGDOGRA-BENGALURU,36993,All
2021,12,BAGDOGRA,BENGALURU,19883,18510,BAGDOGRA-BENGALURU,38393,All
2022,1,BAGDOGRA,BENGALURU,10193,10629,BAGDOGRA-BENGALURU,20822,All
2022,2,BAGDOGRA,BENGALURU,10629,8433,BAGDOGRA-BENGALURU,19062,All
2022,3,BAGDOGRA,BENGALURU,15294,13654,BAGDOGRA-BENGALURU,28948,All
2022,4,BAGDOGRA,BENGALURU,6971,7392,BAGDOGRA-BENGALURU,14363,All
2022,5,BAGDOGRA,BENGALURU,16586,16003,BAGDOGRA-BENGALURU,32589,All
2022,6,BAGDOGRA,BENGALURU,15169,13755,BAGDOGRA-BENGALURU,28924,All
2022,7,BAGDOGRA,BENGALURU,14866,13189,BAGDOGRA-BENGALURU,28055,All
2022,8,BAGDOGRA,BENGALURU,15707,13423,BAGDOGRA-BENGALURU,29130,All
2022,9,BAGDOGRA,BENGALURU,14031,15242,BAGDOGRA-BENGALURU,29273,All
2022,10,BAGDOGRA,BENGALURU,15406,16461,BAGDOGRA-BENGALURU,31867,All
2022,11,BAGDOGRA,BENGALURU,20744,17415,BAGDOGRA-BENGALURU,38159,All
2022,12,BAGDOGRA,BENGALURU,21525,21580,BAGDOGRA-BENGALURU,43105,All
2023,1,BAGDOGRA,BENGALURU,20021,19276,BAGDOGRA-BENGALURU,39297,All
2023,2,BAGDOGRA,BENGALURU,16567,18099,BAGDOGRA-BENGALURU,34666,All
2023,3,BAGDOGRA,BENGALURU,21090,21307,BAGDOGRA-BENGALURU,42397,All
2023,4,BAGDOGRA,BENGALURU,21263,22684,BAGDOGRA-BENGALURU,43947,All
2023,5,BAGDOGRA,BENGALURU,27467,25699,BAGDOGRA-BENGALURU,53166,All
2023,6,BAGDOGRA,BENGALURU,21188,21468,BAGDOGRA-BENGALURU,42656,All
2023,7,BAGDOGRA,BENGALURU,26643,21823,BAGDOGRA-BENGALURU,48466,All
2023,8,BAGDOGRA,BENGALURU,20819,19065,BAGDOGRA-BENGALURU,39884,All
2023,9,BAGDOGRA,BENGALURU,18772,18761,BAGDOGRA-BENGALURU,37533,All
2023,10,BAGDOGRA,BENGALURU,22492,28539,BAGDOGRA-BENGALURU,51031,All
2023,11,BAGDOGRA,BENGALURU,23814,23503,BAGDOGRA-BENGALURU,47317,All
2023,12,BAGDOGRA,BENGALURU,29846,27592,BAGDOGRA-BENGALURU,57438,All
2024,1,BAGDOGRA,BENGALURU,30094,29330,BAGDOGRA-BENGALURU,59424,All
2024,2,BAGDOGRA,BENGALURU,23920,23427,BAGDOGRA-BENGALURU,47347,All
2024,3,BAGDOGRA,BENGALURU,25268,25830,BAGDOGRA-BENGALURU,51098,All
2024,4,BAGDOGRA,BENGALURU,29385,30433,BAGDOGRA-BENGALURU,59818,All
2024,6,BAGDOGRA,BENGALURU,32147,29202,BAGDOGRA-BENGALURU,61349,All
2024,7,BAGDOGRA,BENGALURU,28872,25548,BAGDOGRA-BENGALURU,54420,All
2024,8,BAGDOGRA,BENGALURU,22762,21145,BAGDOGRA-BENGALURU,43907,All
2024,9,BAGDOGRA,BENGALURU,22840,22536,BAGDOGRA-BENGALURU,45376,All
2024,10,BAGDOGRA,BENGALURU,31038,30836,BAGDOGRA-BENGALURU,61874,All
2024,11,BAGDOGRA,BENGALURU,25189,20799,BAGDOGRA-BENGALURU,45988,All
2024,12,BAGDOGRA,BENGALURU,26159,23766,BAGDOGRA-BENGALURU,49925,All
2025,1,BAGDOGRA,BENGALURU,26152,23424,BAGDOGRA-BENGALURU,49576,All
2025,2,BAGDOGRA,BENGALURU,21473,20062,BAGDOGRA-BENGALURU,41535,All
2025,3,BAGDOGRA,BENGALURU,25715,23242,BAGDOGRA-BENGALURU,48957,All
2021,7,BAGDOGRA,BHUBANESWAR,105,118,BAGDOGRA-BHUBANESWAR,223,All
2022,1,BAGDOGRA,BHUBANESWAR,0,7,BAGDOGRA-BHUBANESWAR,7,All
2022,3,BAGDOGRA,BHUBANESWAR,0,140,BAGDOGRA-BHUBANESWAR,140,All
2024,8,BAGDOGRA,BHUBANESWAR,4,22,BAGDOGRA-BHUBANESWAR,26,All
2024,9,BAGDOGRA,BHUBANESWAR,239,473,BAGDOGRA-BHUBANESWAR,712,All
2024,10,BAGDOGRA,BHUBANESWAR,554,546,BAGDOGRA-BHUBANESWAR,1100,All
2024,11,BAGDOGRA,BHUBANESWAR,708,754,BAGDOGRA-BHUBANESWAR,1462,All
2024,12,BAGDOGRA,BHUBANESWAR,763,717,BAGDOGRA-BHUBANESWAR,1480,All
2025,3,BAGDOGRA,BHUBANESWAR,689,723,BAGDOGRA-BHUBANESWAR,1412,All
2020,3,BAGDOGRA,CHANDIGARH,185,411,BAGDOGRA-CHANDIGARH,596,All
2024,6,BAGDOGRA,CHANDIGARH,4,0,BAGDOGRA-CHANDIGARH,4,All
2015,4,BAGDOGRA,CHENNAI,1290,1588,BAGDOGRA-CHENNAI,2878,All
2015,5,BAGDOGRA,CHENNAI,1413,1394,BAGDOGRA-CHENNAI,2807,All
2015,6,BAGDOGRA,CHENNAI,1637,1431,BAGDOGRA-CHENNAI,3068,All
2015,7,BAGDOGRA,CHENNAI,2077,2220,BAGDOGRA-CHENNAI,4297,All
2015,8,BAGDOGRA,CHENNAI,2084,1871,BAGDOGRA-CHENNAI,3955,All
2015,9,BAGDOGRA,CHENNAI,1970,2288,BAGDOGRA-CHENNAI,4258,All
2015,10,BAGDOGRA,CHENNAI,1512,1584,BAGDOGRA-CHENNAI,3096,All
2015,11,BAGDOGRA,CHENNAI,1519,1663,BAGDOGRA-CHENNAI,3182,All
2015,12,BAGDOGRA,CHENNAI,651,1090,BAGDOGRA-CHENNAI,1741,All
2016,1,BAGDOGRA,CHENNAI,1321,1909,BAGDOGRA-CHENNAI,3230,All
2016,2,BAGDOGRA,CHENNAI,1870,1950,BAGDOGRA-CHENNAI,3820,All
2016,3,BAGDOGRA,CHENNAI,1545,1410,BAGDOGRA-CHENNAI,2955,All
2016,4,BAGDOGRA,CHENNAI,1064,1581,BAGDOGRA-CHENNAI,2645,All
2016,5,BAGDOGRA,CHENNAI,1174,1379,BAGDOGRA-CHENNAI,2553,All
2016,6,BAGDOGRA,CHENNAI,1224,2023,BAGDOGRA-CHENNAI,3247,All
2016,7,BAGDOGRA,CHENNAI,2248,1700,BAGDOGRA-CHENNAI,3948,All
2016,8,BAGDOGRA,CHENNAI,2148,2425,BAGDOGRA-CHENNAI,4573,All
2016,9,BAGDOGRA,CHENNAI,1915,2434,BAGDOGRA-CHENNAI,4349,All
2016,10,BAGDOGRA,CHENNAI,1111,1131,BAGDOGRA-CHENNAI,2242,All
2016,11,BAGDOGRA,CHENNAI,1065,2296,BAGDOGRA-CHENNAI,3361,All
2016,12,BAGDOGRA,CHENNAI,909,1989,BAGDOGRA-CHENNAI,2898,All
2017,1,BAGDOGRA,CHENNAI,1907,2850,BAGDOGRA-CHENNAI,4757,All
2017,2,BAGDOGRA,CHENNAI,1363,1788,BAGDOGRA-CHENNAI,3151,All
2017,3,BAGDOGRA,CHENNAI,1046,1341,BAGDOGRA-CHENNAI,2387,All
2017,4,BAGDOGRA,CHENNAI,661,1428,BAGDOGRA-CHENNAI,2089,All
2017,5,BAGDOGRA,CHENNAI,864,1121,BAGDOGRA-CHENNAI,1985,All
2017,6,BAGDOGRA,CHENNAI,568,1057,BAGDOGRA-CHENNAI,1625,All
2017,7,BAGDOGRA,CHENNAI,1019,1022,BAGDOGRA-CHENNAI,2041,All
2017,8,BAGDOGRA,CHENNAI,1456,955,BAGDOGRA-CHENNAI,2411,All
2017,9,BAGDOGRA,CHENNAI,1307,1210,BAGDOGRA-CHENNAI,2517,All
2017,10,BAGDOGRA,CHENNAI,1311,1646,BAGDOGRA-CHENNAI,2957,All
2017,11,BAGDOGRA,CHENNAI,2053,2210,BAGDOGRA-CHENNAI,4263,All
2017,12,BAGDOGRA,CHENNAI,1810,2077,BAGDOGRA-CHENNAI,3887,All
2018,1,BAGDOGRA,CHENNAI,2448,2834,BAGDOGRA-CHENNAI,5282,All
2018,2,BAGDOGRA,CHENNAI,1990,2429,BAGDOGRA-CHENNAI,4419,All
2018,3,BAGDOGRA,CHENNAI,2167,2250,BAGDOGRA-CHENNAI,4417,All
2018,4,BAGDOGRA,CHENNAI,433,1848,BAGDOGRA-CHENNAI,2281,All
2018,5,BAGDOGRA,CHENNAI,1014,1713,BAGDOGRA-CHENNAI,2727,All
2018,6,BAGDOGRA,CHENNAI,874,1697,BAGDOGRA-CHENNAI,2571,All
2018,7,BAGDOGRA,CHENNAI,2334,2880,BAGDOGRA-CHENNAI,5214,All
2018,8,BAGDOGRA,CHENNAI,2547,2327,BAGDOGRA-CHENNAI,4874,All
2018,9,BAGDOGRA,CHENNAI,2189,1410,BAGDOGRA-CHENNAI,3599,All
2018,10,BAGDOGRA,CHENNAI,2027,1678,BAGDOGRA-CHENNAI,3705,All
2018,11,BAGDOGRA,CHENNAI,2020,1767,BAGDOGRA-CHENNAI,3787,All
2018,12,BAGDOGRA,CHENNAI,2251,1489,BAGDOGRA-CHENNAI,3740,All
2019,1,BAGDOGRA,CHENNAI,1976,1532,BAGDOGRA-CHENNAI,3508,All
2019,2,BAGDOGRA,CHENNAI,4417,4224,BAGDOGRA-CHENNAI,8641,All
2019,3,BAGDOGRA,CHENNAI,6477,6567,BAGDOGRA-CHENNAI,13044,All
2019,4,BAGDOGRA,CHENNAI,6821,6349,BAGDOGRA-CHENNAI,13170,All
2019,5,BAGDOGRA,CHENNAI,6655,5893,BAGDOGRA-CHENNAI,12548,All
2019,6,BAGDOGRA,CHENNAI,5975,5750,BAGDOGRA-CHENNAI,11725,All
2019,7,BAGDOGRA,CHENNAI,5492,5477,BAGDOGRA-CHENNAI,10969,All
2019,8,BAGDOGRA,CHENNAI,5293,5513,BAGDOGRA-CHENNAI,10806,All
2019,9,BAGDOGRA,CHENNAI,5356,5662,BAGDOGRA-CHENNAI,11018,All
2019,10,BAGDOGRA,CHENNAI,6313,6138,BAGDOGRA-CHENNAI,12451,All
2019,11,BAGDOGRA,CHENNAI,6186,6215,BAGDOGRA-CHENNAI,12401,All
2019,12,BAGDOGRA,CHENNAI,6641,6300,BAGDOGRA-CHENNAI,12941,All
2020,1,BAGDOGRA,CHENNAI,6732,6413,BAGDOGRA-CHENNAI,13145,All
2020,2,BAGDOGRA,CHENNAI,6016,7141,BAGDOGRA-CHENNAI,13157,All
2020,3,BAGDOGRA,CHENNAI,6129,8953,BAGDOGRA-CHENNAI,15082,All
2020,5,BAGDOGRA,CHENNAI,107,738,BAGDOGRA-CHENNAI,845,All
2020,6,BAGDOGRA,CHENNAI,587,2108,BAGDOGRA-CHENNAI,2695,All
2020,9,BAGDOGRA,CHENNAI,3790,1741,BAGDOGRA-CHENNAI,5531,All
2020,10,BAGDOGRA,CHENNAI,4278,2226,BAGDOGRA-CHENNAI,6504,All
2020,11,BAGDOGRA,CHENNAI,4472,2866,BAGDOGRA-CHENNAI,7338,All
2020,12,BAGDOGRA,CHENNAI,4784,3086,BAGDOGRA-CHENNAI,7870,All
2021,1,BAGDOGRA,CHENNAI,4543,2610,BAGDOGRA-CHENNAI,7153,All
2021,2,BAGDOGRA,CHENNAI,4264,3334,BAGDOGRA-CHENNAI,7598,All
2021,3,BAGDOGRA,CHENNAI,4106,4476,BAGDOGRA-CHENNAI,8582,All
2021,4,BAGDOGRA,CHENNAI,3050,4567,BAGDOGRA-CHENNAI,7617,All
2021,6,BAGDOGRA,CHENNAI,558,143,BAGDOGRA-CHENNAI,701,All
2021,7,BAGDOGRA,CHENNAI,2573,1360,BAGDOGRA-CHENNAI,3933,All
2021,8,BAGDOGRA,CHENNAI,2317,1457,BAGDOGRA-CHENNAI,3774,All
2021,9,BAGDOGRA,CHENNAI,2090,1891,BAGDOGRA-CHENNAI,3981,All
2021,10,BAGDOGRA,CHENNAI,1894,2106,BAGDOGRA-CHENNAI,4000,All
2021,11,BAGDOGRA,CHENNAI,2046,1987,BAGDOGRA-CHENNAI,4033,All
2021,12,BAGDOGRA,CHENNAI,2362,2477,BAGDOGRA-CHENNAI,4839,All
2022,1,BAGDOGRA,CHENNAI,1234,1414,BAGDOGRA-CHENNAI,2648,All
2022,2,BAGDOGRA,CHENNAI,1588,1451,BAGDOGRA-CHENNAI,3039,All
2022,3,BAGDOGRA,CHENNAI,3326,2914,BAGDOGRA-CHENNAI,6240,All
2022,4,BAGDOGRA,CHENNAI,3903,4376,BAGDOGRA-CHENNAI,8279,All
2022,5,BAGDOGRA,CHENNAI,10548,9965,BAGDOGRA-CHENNAI,20513,All
2022,6,BAGDOGRA,CHENNAI,9192,7562,BAGDOGRA-CHENNAI,16754,All
2022,7,BAGDOGRA,CHENNAI,8018,7520,BAGDOGRA-CHENNAI,15538,All
2022,8,BAGDOGRA,CHENNAI,5905,5083,BAGDOGRA-CHENNAI,10988,All
2022,9,BAGDOGRA,CHENNAI,4771,5054,BAGDOGRA-CHENNAI,9825,All
2022,10,BAGDOGRA,CHENNAI,5026,5164,BAGDOGRA-CHENNAI,10190,All
2022,11,BAGDOGRA,CHENNAI,3879,3534,BAGDOGRA-CHENNAI,7413,All
2022,12,BAGDOGRA,CHENNAI,4598,4682,BAGDOGRA-CHENNAI,9280,All
2023,1,BAGDOGRA,CHENNAI,4536,4314,BAGDOGRA-CHENNAI,8850,All
2023,2,BAGDOGRA,CHENNAI,4413,4390,BAGDOGRA-CHENNAI,8803,All
2023,3,BAGDOGRA,CHENNAI,5366,5442,BAGDOGRA-CHENNAI,10808,All
2023,4,BAGDOGRA,CHENNAI,5731,5443,BAGDOGRA-CHENNAI,11174,All
2023,5,BAGDOGRA,CHENNAI,6100,5082,BAGDOGRA-CHENNAI,11182,All
2023,6,BAGDOGRA,CHENNAI,8726,7747,BAGDOGRA-CHENNAI,16473,All
2023,7,BAGDOGRA,CHENNAI,5878,4582,BAGDOGRA-CHENNAI,10460,All
2023,8,BAGDOGRA,CHENNAI,5982,4870,BAGDOGRA-CHENNAI,10852,All
2023,9,BAGDOGRA,CHENNAI,4846,4622,BAGDOGRA-CHENNAI,9468,All
2023,10,BAGDOGRA,CHENNAI,5091,5627,BAGDOGRA-CHENNAI,10718,All
2023,11,BAGDOGRA,CHENNAI,5284,6339,BAGDOGRA-CHENNAI,11623,All
2023,12,BAGDOGRA,CHENNAI,5415,5818,BAGDOGRA-CHENNAI,11233,All
2024,1,BAGDOGRA,CHENNAI,5943,6157,BAGDOGRA-CHENNAI,12100,All
2024,2,BAGDOGRA,CHENNAI,5297,6378,BAGDOGRA-CHENNAI,11675,All
2024,3,BAGDOGRA,CHENNAI,5701,6578,BAGDOGRA-CHENNAI,12279,All
2024,4,BAGDOGRA,CHENNAI,4607,5045,BAGDOGRA-CHENNAI,9652,All
2024,6,BAGDOGRA,CHENNAI,4662,4695,BAGDOGRA-CHENNAI,9357,All
2024,7,BAGDOGRA,CHENNAI,5477,4204,BAGDOGRA-CHENNAI,9681,All
2024,8,BAGDOGRA,CHENNAI,7638,6122,BAGDOGRA-CHENNAI,13760,All
2024,9,BAGDOGRA,CHENNAI,7943,8690,BAGDOGRA-CHENNAI,16633,All
2024,10,BAGDOGRA,CHENNAI,6222,8363,BAGDOGRA-CHENNAI,14585,All
2024,11,BAGDOGRA,CHENNAI,6808,6469,BAGDOGRA-CHENNAI,13277,All
2024,12,BAGDOGRA,CHENNAI,7132,7162,BAGDOGRA-CHENNAI,14294,All
2025,1,BAGDOGRA,CHENNAI,7887,7387,BAGDOGRA-CHENNAI,15274,All
2025,2,BAGDOGRA,CHENNAI,7100,8393,BAGDOGRA-CHENNAI,15493,All
2025,3,BAGDOGRA,CHENNAI,9068,9081,BAGDOGRA-CHENNAI,18149,All
2021,1,BAGDOGRA,COIMBATORE,32,14,BAGDOGRA-COIMBATORE,46,All
2021,2,BAGDOGRA,COIMBATORE,228,104,BAGDOGRA-COIMBATORE,332,All
2021,3,BAGDOGRA,COIMBATORE,208,116,BAGDOGRA-COIMBATORE,324,All
2025,3,BAGDOGRA,COIMBATORE,129,0,BAGDOGRA-COIMBATORE,129,All
2019,5,BAGDOGRA,DELHI,49879,50546,BAGDOGRA-DELHI,100425,All
2019,6,BAGDOGRA,DELHI,54802,51372,BAGDOGRA-DELHI,106174,All
2019,7,BAGDOGRA,DELHI,51089,46133,BAGDOGRA-DELHI,97222,All
2019,8,BAGDOGRA,DELHI,45222,44559,BAGDOGRA-DELHI,89781,All
2019,9,BAGDOGRA,DELHI,44509,46544,BAGDOGRA-DELHI,91053,All
2019,10,BAGDOGRA,DELHI,52937,52427,BAGDOGRA-DELHI,105364,All
2019,11,BAGDOGRA,DELHI,50635,50807,BAGDOGRA-DELHI,101442,All
2019,12,BAGDOGRA,DELHI,47847,51233,BAGDOGRA-DELHI,99080,All
2020,1,BAGDOGRA,DELHI,46230,43711,BAGDOGRA-DELHI,89941,All
2020,2,BAGDOGRA,DELHI,45603,45905,BAGDOGRA-DELHI,91508,All
2020,3,BAGDOGRA,DELHI,30426,36086,BAGDOGRA-DELHI,66512,All
2020,5,BAGDOGRA,DELHI,1195,2311,BAGDOGRA-DELHI,3506,All
2020,6,BAGDOGRA,DELHI,13530,17791,BAGDOGRA-DELHI,31321,All
2020,7,BAGDOGRA,DELHI,16176,16030,BAGDOGRA-DELHI,32206,All
2020,8,BAGDOGRA,DELHI,8193,0,BAGDOGRA-DELHI,8193,All
2020,9,BAGDOGRA,DELHI,18288,13095,BAGDOGRA-DELHI,31383,All
2020,10,BAGDOGRA,DELHI,28938,19790,BAGDOGRA-DELHI,48728,All
2020,11,BAGDOGRA,DELHI,27290,23046,BAGDOGRA-DELHI,50336,All
2020,12,BAGDOGRA,DELHI,29252,32097,BAGDOGRA-DELHI,61349,All
2021,1,BAGDOGRA,DELHI,42722,34664,BAGDOGRA-DELHI,77386,All
2021,2,BAGDOGRA,DELHI,40832,37991,BAGDOGRA-DELHI,78823,All
2021,3,BAGDOGRA,DELHI,44171,48135,BAGDOGRA-DELHI,92306,All
2021,4,BAGDOGRA,DELHI,40315,54336,BAGDOGRA-DELHI,94651,All
2021,6,BAGDOGRA,DELHI,20085,17560,BAGDOGRA-DELHI,37645,All
2021,7,BAGDOGRA,DELHI,26088,27185,BAGDOGRA-DELHI,53273,All
2021,8,BAGDOGRA,DELHI,34199,31542,BAGDOGRA-DELHI,65741,All
2021,9,BAGDOGRA,DELHI,36913,36187,BAGDOGRA-DELHI,73100,All
2021,10,BAGDOGRA,DELHI,53888,54585,BAGDOGRA-DELHI,108473,All
2021,11,BAGDOGRA,DELHI,55177,54823,BAGDOGRA-DELHI,110000,All
2021,12,BAGDOGRA,DELHI,53478,56688,BAGDOGRA-DELHI,110166,All
2022,1,BAGDOGRA,DELHI,28322,20480,BAGDOGRA-DELHI,48802,All
2022,2,BAGDOGRA,DELHI,36060,31385,BAGDOGRA-DELHI,67445,All
2022,3,BAGDOGRA,DELHI,48792,47168,BAGDOGRA-DELHI,95960,All
2022,4,BAGDOGRA,DELHI,19122,20348,BAGDOGRA-DELHI,39470,All
2022,5,BAGDOGRA,DELHI,43864,49161,BAGDOGRA-DELHI,93025,All
2022,6,BAGDOGRA,DELHI,42932,46309,BAGDOGRA-DELHI,89241,All
2022,7,BAGDOGRA,DELHI,39416,37117,BAGDOGRA-DELHI,76533,All
2022,8,BAGDOGRA,DELHI,39217,37399,BAGDOGRA-DELHI,76616,All
2022,9,BAGDOGRA,DELHI,39610,42694,BAGDOGRA-DELHI,82304,All
2022,10,BAGDOGRA,DELHI,44291,50921,BAGDOGRA-DELHI,95212,All
2022,11,BAGDOGRA,DELHI,42302,46390,BAGDOGRA-DELHI,88692,All
2022,12,BAGDOGRA,DELHI,43762,50583,BAGDOGRA-DELHI,94345,All
2023,1,BAGDOGRA,DELHI,42253,45210,BAGDOGRA-DELHI,87463,All
2023,2,BAGDOGRA,DELHI,40401,44826,BAGDOGRA-DELHI,85227,All
2023,3,BAGDOGRA,DELHI,46568,51366,BAGDOGRA-DELHI,97934,All
2023,4,BAGDOGRA,DELHI,43356,49136,BAGDOGRA-DELHI,92492,All
2023,5,BAGDOGRA,DELHI,39558,41883,BAGDOGRA-DELHI,81441,All
2023,6,BAGDOGRA,DELHI,41341,43506,BAGDOGRA-DELHI,84847,All
2023,7,BAGDOGRA,DELHI,47996,46571,BAGDOGRA-DELHI,94567,All
2023,8,BAGDOGRA,DELHI,48010,49500,BAGDOGRA-DELHI,97510,All
2023,9,BAGDOGRA,DELHI,43829,46157,BAGDOGRA-DELHI,89986,All
2023,10,BAGDOGRA,DELHI,46299,51412,BAGDOGRA-DELHI,97711,All
2023,11,BAGDOGRA,DELHI,43383,45995,BAGDOGRA-DELHI,89378,All
2023,12,BAGDOGRA,DELHI,48886,50527,BAGDOGRA-DELHI,99413,All
2024,1,BAGDOGRA,DELHI,46195,45855,BAGDOGRA-DELHI,92050,All
2024,2,BAGDOGRA,DELHI,44799,46489,BAGDOGRA-DELHI,91288,All
2024,3,BAGDOGRA,DELHI,47610,49554,BAGDOGRA-DELHI,97164,All
2024,4,BAGDOGRA,DELHI,42695,47202,BAGDOGRA-DELHI,89897,All
2024,6,BAGDOGRA,DELHI,44879,44867,BAGDOGRA-DELHI,89746,All
2024,7,BAGDOGRA,DELHI,44141,42328,BAGDOGRA-DELHI,86469,All
2024,8,BAGDOGRA,DELHI,42186,40708,BAGDOGRA-DELHI,82894,All
2024,9,BAGDOGRA,DELHI,38648,40414,BAGDOGRA-DELHI,79062,All
2024,10,BAGDOGRA,DELHI,40334,44006,BAGDOGRA-DELHI,84340,All
2024,11,BAGDOGRA,DELHI,41968,43042,BAGDOGRA-DELHI,85010,All
2024,12,BAGDOGRA,DELHI,42511,43502,BAGDOGRA-DELHI,86013,All
2025,1,BAGDOGRA,DELHI,36114,36986,BAGDOGRA-DELHI,73100,All
2025,2,BAGDOGRA,DELHI,37371,40325,BAGDOGRA-DELHI,77696,All
2025,3,BAGDOGRA,DELHI,42926,46793,BAGDOGRA-DELHI,89719,All
2019,5,BAGDOGRA,DIBRUGARH,2170,2216,BAGDOGRA-DIBRUGARH,4386,All
2019,6,BAGDOGRA,DIBRUGARH,2276,2411,BAGDOGRA-DIBRUGARH,4687,All
2019,7,BAGDOGRA,DIBRUGARH,4040,4208,BAGDOGRA-DIBRUGARH,8248,All
2019,8,BAGDOGRA,DIBRUGARH,2639,3112,BAGDOGRA-DIBRUGARH,5751,All
2019,9,BAGDOGRA,DIBRUGARH,2012,2354,BAGDOGRA-DIBRUGARH,4366,All
2019,10,BAGDOGRA,DIBRUGARH,3427,3946,BAGDOGRA-DIBRUGARH,7373,All
2019,11,BAGDOGRA,DIBRUGARH,3081,3449,BAGDOGRA-DIBRUGARH,6530,All
2019,12,BAGDOGRA,DIBRUGARH,3036,2933,BAGDOGRA-DIBRUGARH,5969,All
2020,1,BAGDOGRA,DIBRUGARH,3237,3763,BAGDOGRA-DIBRUGARH,7000,All
2020,2,BAGDOGRA,DIBRUGARH,2700,3634,BAGDOGRA-DIBRUGARH,6334,All
2020,3,BAGDOGRA,DIBRUGARH,2459,2005,BAGDOGRA-DIBRUGARH,4464,All
2020,5,BAGDOGRA,DIBRUGARH,0,172,BAGDOGRA-DIBRUGARH,172,All
2020,6,BAGDOGRA,DIBRUGARH,0,1142,BAGDOGRA-DIBRUGARH,1142,All
2020,7,BAGDOGRA,DIBRUGARH,0,2077,BAGDOGRA-DIBRUGARH,2077,All
2020,8,BAGDOGRA,DIBRUGARH,0,2010,BAGDOGRA-DIBRUGARH,2010,All
2020,9,BAGDOGRA,DIBRUGARH,423,1247,BAGDOGRA-DIBRUGARH,1670,All
2020,10,BAGDOGRA,DIBRUGARH,688,2701,BAGDOGRA-DIBRUGARH,3389,All
2020,11,BAGDOGRA,DIBRUGARH,1159,3569,BAGDOGRA-DIBRUGARH,4728,All
2020,12,BAGDOGRA,DIBRUGARH,1548,2727,BAGDOGRA-DIBRUGARH,4275,All
2021,1,BAGDOGRA,DIBRUGARH,1393,1756,BAGDOGRA-DIBRUGARH,3149,All
2021,2,BAGDOGRA,DIBRUGARH,1548,1629,BAGDOGRA-DIBRUGARH,3177,All
2021,3,BAGDOGRA,DIBRUGARH,2620,1648,BAGDOGRA-DIBRUGARH,4268,All
2021,4,BAGDOGRA,DIBRUGARH,3258,1710,BAGDOGRA-DIBRUGARH,4968,All
2021,6,BAGDOGRA,DIBRUGARH,2741,1320,BAGDOGRA-DIBRUGARH,4061,All
2021,7,BAGDOGRA,DIBRUGARH,1606,1093,BAGDOGRA-DIBRUGARH,2699,All
2021,8,BAGDOGRA,DIBRUGARH,2371,1533,BAGDOGRA-DIBRUGARH,3904,All
2021,9,BAGDOGRA,DIBRUGARH,2812,2119,BAGDOGRA-DIBRUGARH,4931,All
2021,10,BAGDOGRA,DIBRUGARH,2829,2737,BAGDOGRA-DIBRUGARH,5566,All
2021,11,BAGDOGRA,DIBRUGARH,2491,2489,BAGDOGRA-DIBRUGARH,4980,All
2021,12,BAGDOGRA,DIBRUGARH,3539,2493,BAGDOGRA-DIBRUGARH,6032,All
2022,1,BAGDOGRA,DIBRUGARH,1165,1942,BAGDOGRA-DIBRUGARH,3107,All
2022,2,BAGDOGRA,DIBRUGARH,2366,3022,BAGDOGRA-DIBRUGARH,5388,All
2022,3,BAGDOGRA,DIBRUGARH,3091,2935,BAGDOGRA-DIBRUGARH,6026,All
2022,4,BAGDOGRA,DIBRUGARH,873,850,BAGDOGRA-DIBRUGARH,1723,All
2022,5,BAGDOGRA,DIBRUGARH,1936,1316,BAGDOGRA-DIBRUGARH,3252,All
2022,6,BAGDOGRA,DIBRUGARH,1531,1115,BAGDOGRA-DIBRUGARH,2646,All
2022,7,BAGDOGRA,DIBRUGARH,4124,2896,BAGDOGRA-DIBRUGARH,7020,All
2022,8,BAGDOGRA,DIBRUGARH,3785,2708,BAGDOGRA-DIBRUGARH,6493,All
2022,9,BAGDOGRA,DIBRUGARH,3123,2428,BAGDOGRA-DIBRUGARH,5551,All
2022,10,BAGDOGRA,DIBRUGARH,3101,2975,BAGDOGRA-DIBRUGARH,6076,All
2022,11,BAGDOGRA,DIBRUGARH,3229,2654,BAGDOGRA-DIBRUGARH,5883,All
2022,12,BAGDOGRA,DIBRUGARH,3918,2487,BAGDOGRA-DIBRUGARH,6405,All
2023,1,BAGDOGRA,DIBRUGARH,2727,2551,BAGDOGRA-DIBRUGARH,5278,All
2023,2,BAGDOGRA,DIBRUGARH,2253,2583,BAGDOGRA-DIBRUGARH,4836,All
2023,3,BAGDOGRA,DIBRUGARH,2756,2272,BAGDOGRA-DIBRUGARH,5028,All
2023,4,BAGDOGRA,DIBRUGARH,3190,2530,BAGDOGRA-DIBRUGARH,5720,All
2023,5,BAGDOGRA,DIBRUGARH,1785,1383,BAGDOGRA-DIBRUGARH,3168,All
2023,6,BAGDOGRA,DIBRUGARH,2098,1630,BAGDOGRA-DIBRUGARH,3728,All
2023,7,BAGDOGRA,DIBRUGARH,2497,2969,BAGDOGRA-DIBRUGARH,5466,All
2023,8,BAGDOGRA,DIBRUGARH,1344,1773,BAGDOGRA-DIBRUGARH,3117,All
2023,9,BAGDOGRA,DIBRUGARH,1163,1209,BAGDOGRA-DIBRUGARH,2372,All
2023,10,BAGDOGRA,DIBRUGARH,3273,2079,BAGDOGRA-DIBRUGARH,5352,All
2023,11,BAGDOGRA,DIBRUGARH,2459,2092,BAGDOGRA-DIBRUGARH,4551,All
2023,12,BAGDOGRA,DIBRUGARH,3695,2130,BAGDOGRA-DIBRUGARH,5825,All
2024,1,BAGDOGRA,DIBRUGARH,2711,2473,BAGDOGRA-DIBRUGARH,5184,All
2024,2,BAGDOGRA,DIBRUGARH,1923,2088,BAGDOGRA-DIBRUGARH,4011,All
2024,3,BAGDOGRA,DIBRUGARH,2576,2261,BAGDOGRA-DIBRUGARH,4837,All
2024,4,BAGDOGRA,DIBRUGARH,3424,2521,BAGDOGRA-DIBRUGARH,5945,All
2024,6,BAGDOGRA,DIBRUGARH,1605,1379,BAGDOGRA-DIBRUGARH,2984,All
2024,7,BAGDOGRA,DIBRUGARH,2945,3561,BAGDOGRA-DIBRUGARH,6506,All
2024,8,BAGDOGRA,DIBRUGARH,1728,1547,BAGDOGRA-DIBRUGARH,3275,All
2024,9,BAGDOGRA,DIBRUGARH,1427,1065,BAGDOGRA-DIBRUGARH,2492,All
2024,10,BAGDOGRA,DIBRUGARH,3488,3262,BAGDOGRA-DIBRUGARH,6750,All
2024,11,BAGDOGRA,DIBRUGARH,1799,1367,BAGDOGRA-DIBRUGARH,3166,All
2024,12,BAGDOGRA,DIBRUGARH,1995,1119,BAGDOGRA-DIBRUGARH,3114,All
2025,1,BAGDOGRA,DIBRUGARH,1764,1045,BAGDOGRA-DIBRUGARH,2809,All
2025,2,BAGDOGRA,DIBRUGARH,1552,1079,BAGDOGRA-DIBRUGARH,2631,All
2025,3,BAGDOGRA,DIBRUGARH,1599,1021,BAGDOGRA-DIBRUGARH,2620,All
2024,8,BAGDOGRA,DURGAPUR,16,15,BAGDOGRA-DURGAPUR,31,All
2024,9,BAGDOGRA,DURGAPUR,233,292,BAGDOGRA-DURGAPUR,525,All
2024,10,BAGDOGRA,DURGAPUR,555,563,BAGDOGRA-DURGAPUR,1118,All
2024,11,BAGDOGRA,DURGAPUR,445,438,BAGDOGRA-DURGAPUR,883,All
2024,12,BAGDOGRA,DURGAPUR,508,501,BAGDOGRA-DURGAPUR,1009,All
2025,1,BAGDOGRA,DURGAPUR,494,458,BAGDOGRA-DURGAPUR,952,All
2025,2,BAGDOGRA,DURGAPUR,438,510,BAGDOGRA-DURGAPUR,948,All
2025,3,BAGDOGRA,DURGAPUR,622,596,BAGDOGRA-DURGAPUR,1218,All
2019,5,BAGDOGRA,GUWAHATI,8781,9577,BAGDOGRA-GUWAHATI,18358,All
2019,6,BAGDOGRA,GUWAHATI,10267,14193,BAGDOGRA-GUWAHATI,24460,All
2019,7,BAGDOGRA,GUWAHATI,13229,15521,BAGDOGRA-GUWAHATI,28750,All
2019,8,BAGDOGRA,GUWAHATI,8073,8789,BAGDOGRA-GUWAHATI,16862,All
2019,9,BAGDOGRA,GUWAHATI,7401,7678,BAGDOGRA-GUWAHATI,15079,All
2019,10,BAGDOGRA,GUWAHATI,10873,13859,BAGDOGRA-GUWAHATI,24732,All
2019,11,BAGDOGRA,GUWAHATI,9962,7432,BAGDOGRA-GUWAHATI,17394,All
2019,12,BAGDOGRA,GUWAHATI,11142,8335,BAGDOGRA-GUWAHATI,19477,All
2020,1,BAGDOGRA,GUWAHATI,9280,8146,BAGDOGRA-GUWAHATI,17426,All
2020,2,BAGDOGRA,GUWAHATI,6953,7063,BAGDOGRA-GUWAHATI,14016,All
2020,3,BAGDOGRA,GUWAHATI,5431,5137,BAGDOGRA-GUWAHATI,10568,All
2020,5,BAGDOGRA,GUWAHATI,111,0,BAGDOGRA-GUWAHATI,111,All
2020,6,BAGDOGRA,GUWAHATI,11,4,BAGDOGRA-GUWAHATI,15,All
2020,8,BAGDOGRA,GUWAHATI,0,915,BAGDOGRA-GUWAHATI,915,All
2020,9,BAGDOGRA,GUWAHATI,0,243,BAGDOGRA-GUWAHATI,243,All
2020,10,BAGDOGRA,GUWAHATI,1673,4086,BAGDOGRA-GUWAHATI,5759,All
2020,11,BAGDOGRA,GUWAHATI,1662,2929,BAGDOGRA-GUWAHATI,4591,All
2020,12,BAGDOGRA,GUWAHATI,1777,3910,BAGDOGRA-GUWAHATI,5687,All
2021,1,BAGDOGRA,GUWAHATI,0,603,BAGDOGRA-GUWAHATI,603,All
2021,2,BAGDOGRA,GUWAHATI,0,610,BAGDOGRA-GUWAHATI,610,All
2021,3,BAGDOGRA,GUWAHATI,3758,949,BAGDOGRA-GUWAHATI,4707,All
2021,4,BAGDOGRA,GUWAHATI,3687,2785,BAGDOGRA-GUWAHATI,6472,All
2021,6,BAGDOGRA,GUWAHATI,1688,520,BAGDOGRA-GUWAHATI,2208,All
2021,7,BAGDOGRA,GUWAHATI,1659,1523,BAGDOGRA-GUWAHATI,3182,All
2021,8,BAGDOGRA,GUWAHATI,978,646,BAGDOGRA-GUWAHATI,1624,All
2021,10,BAGDOGRA,GUWAHATI,129,2161,BAGDOGRA-GUWAHATI,2290,All
2021,11,BAGDOGRA,GUWAHATI,103,0,BAGDOGRA-GUWAHATI,103,All
2021,12,BAGDOGRA,GUWAHATI,75,0,BAGDOGRA-GUWAHATI,75,All
2022,1,BAGDOGRA,GUWAHATI,0,2733,BAGDOGRA-GUWAHATI,2733,All
2022,2,BAGDOGRA,GUWAHATI,0,1005,BAGDOGRA-GUWAHATI,1005,All
2022,3,BAGDOGRA,GUWAHATI,1990,0,BAGDOGRA-GUWAHATI,1990,All
2022,4,BAGDOGRA,GUWAHATI,945,0,BAGDOGRA-GUWAHATI,945,All
2022,5,BAGDOGRA,GUWAHATI,3229,0,BAGDOGRA-GUWAHATI,3229,All
2022,6,BAGDOGRA,GUWAHATI,2620,0,BAGDOGRA-GUWAHATI,2620,All
2022,8,BAGDOGRA,GUWAHATI,51,30,BAGDOGRA-GUWAHATI,81,All
2022,10,BAGDOGRA,GUWAHATI,3642,0,BAGDOGRA-GUWAHATI,3642,All
2022,11,BAGDOGRA,GUWAHATI,4337,0,BAGDOGRA-GUWAHATI,4337,All
2022,12,BAGDOGRA,GUWAHATI,4850,0,BAGDOGRA-GUWAHATI,4850,All
2023,1,BAGDOGRA,GUWAHATI,3356,0,BAGDOGRA-GUWAHATI,3356,All
2023,2,BAGDOGRA,GUWAHATI,3694,973,BAGDOGRA-GUWAHATI,4667,All
2023,3,BAGDOGRA,GUWAHATI,5323,2595,BAGDOGRA-GUWAHATI,7918,All
2023,4,BAGDOGRA,GUWAHATI,6753,2700,BAGDOGRA-GUWAHATI,9453,All
2023,5,BAGDOGRA,GUWAHATI,4028,3101,BAGDOGRA-GUWAHATI,7129,All
2023,6,BAGDOGRA,GUWAHATI,3487,3419,BAGDOGRA-GUWAHATI,6906,All
2023,7,BAGDOGRA,GUWAHATI,4111,3503,BAGDOGRA-GUWAHATI,7614,All
2023,8,BAGDOGRA,GUWAHATI,2408,3748,BAGDOGRA-GUWAHATI,6156,All
2023,9,BAGDOGRA,GUWAHATI,1379,2613,BAGDOGRA-GUWAHATI,3992,All
2023,10,BAGDOGRA,GUWAHATI,2155,3029,BAGDOGRA-GUWAHATI,5184,All
2023,11,BAGDOGRA,GUWAHATI,1704,3773,BAGDOGRA-GUWAHATI,5477,All
2023,12,BAGDOGRA,GUWAHATI,3690,4607,BAGDOGRA-GUWAHATI,8297,All
2024,1,BAGDOGRA,GUWAHATI,1896,4325,BAGDOGRA-GUWAHATI,6221,All
2024,2,BAGDOGRA,GUWAHATI,1347,3154,BAGDOGRA-GUWAHATI,4501,All
2024,3,BAGDOGRA,GUWAHATI,1904,3118,BAGDOGRA-GUWAHATI,5022,All
2024,4,BAGDOGRA,GUWAHATI,1010,2322,BAGDOGRA-GUWAHATI,3332,All
2024,6,BAGDOGRA,GUWAHATI,2164,3512,BAGDOGRA-GUWAHATI,5676,All
2024,7,BAGDOGRA,GUWAHATI,2396,4385,BAGDOGRA-GUWAHATI,6781,All
2024,8,BAGDOGRA,GUWAHATI,1375,3120,BAGDOGRA-GUWAHATI,4495,All
2024,9,BAGDOGRA,GUWAHATI,1114,2534,BAGDOGRA-GUWAHATI,3648,All
2024,10,BAGDOGRA,GUWAHATI,1617,3918,BAGDOGRA-GUWAHATI,5535,All
2024,11,BAGDOGRA,GUWAHATI,1431,4251,BAGDOGRA-GUWAHATI,5682,All
2024,12,BAGDOGRA,GUWAHATI,202,2643,BAGDOGRA-GUWAHATI,2845,All
2025,1,BAGDOGRA,GUWAHATI,518,2410,BAGDOGRA-GUWAHATI,2928,All
2025,2,BAGDOGRA,GUWAHATI,1441,3293,BAGDOGRA-GUWAHATI,4734,All
2025,3,BAGDOGRA,GUWAHATI,1334,4644,BAGDOGRA-GUWAHATI,5978,All
2019,5,BAGDOGRA,HYDERABAD,5741,5503,BAGDOGRA-HYDERABAD,11244,All
2019,6,BAGDOGRA,HYDERABAD,5419,4595,BAGDOGRA-HYDERABAD,10014,All
2019,7,BAGDOGRA,HYDERABAD,4993,4166,BAGDOGRA-HYDERABAD,9159,All
2019,8,BAGDOGRA,HYDERABAD,3962,4097,BAGDOGRA-HYDERABAD,8059,All
2019,9,BAGDOGRA,HYDERABAD,4063,4418,BAGDOGRA-HYDERABAD,8481,All
2019,10,BAGDOGRA,HYDERABAD,4837,4929,BAGDOGRA-HYDERABAD,9766,All
2019,11,BAGDOGRA,HYDERABAD,5577,4780,BAGDOGRA-HYDERABAD,10357,All
2019,12,BAGDOGRA,HYDERABAD,5846,5197,BAGDOGRA-HYDERABAD,11043,All
2020,1,BAGDOGRA,HYDERABAD,5383,5057,BAGDOGRA-HYDERABAD,10440,All
2020,2,BAGDOGRA,HYDERABAD,5070,4919,BAGDOGRA-HYDERABAD,9989,All
2020,3,BAGDOGRA,HYDERABAD,3426,4031,BAGDOGRA-HYDERABAD,7457,All
2020,7,BAGDOGRA,HYDERABAD,2789,2699,BAGDOGRA-HYDERABAD,5488,All
2020,8,BAGDOGRA,HYDERABAD,4376,2831,BAGDOGRA-HYDERABAD,7207,All
2020,9,BAGDOGRA,HYDERABAD,6884,4668,BAGDOGRA-HYDERABAD,11552,All
2020,10,BAGDOGRA,HYDERABAD,7137,5565,BAGDOGRA-HYDERABAD,12702,All
2020,11,BAGDOGRA,HYDERABAD,5300,4960,BAGDOGRA-HYDERABAD,10260,All
2020,12,BAGDOGRA,HYDERABAD,5456,5125,BAGDOGRA-HYDERABAD,10581,All
2021,1,BAGDOGRA,HYDERABAD,5081,3877,BAGDOGRA-HYDERABAD,8958,All
2021,2,BAGDOGRA,HYDERABAD,5139,4615,BAGDOGRA-HYDERABAD,9754,All
2021,3,BAGDOGRA,HYDERABAD,5405,4865,BAGDOGRA-HYDERABAD,10270,All
2021,4,BAGDOGRA,HYDERABAD,4886,5820,BAGDOGRA-HYDERABAD,10706,All
2021,6,BAGDOGRA,HYDERABAD,2895,1410,BAGDOGRA-HYDERABAD,4305,All
2021,7,BAGDOGRA,HYDERABAD,4019,2988,BAGDOGRA-HYDERABAD,7007,All
2021,8,BAGDOGRA,HYDERABAD,5480,3872,BAGDOGRA-HYDERABAD,9352,All
2021,9,BAGDOGRA,HYDERABAD,5644,5831,BAGDOGRA-HYDERABAD,11475,All
2021,10,BAGDOGRA,HYDERABAD,5388,6306,BAGDOGRA-HYDERABAD,11694,All
2021,11,BAGDOGRA,HYDERABAD,5003,5231,BAGDOGRA-HYDERABAD,10234,All
2021,12,BAGDOGRA,HYDERABAD,5269,5389,BAGDOGRA-HYDERABAD,10658,All
2022,1,BAGDOGRA,HYDERABAD,5359,5578,BAGDOGRA-HYDERABAD,10937,All
2022,2,BAGDOGRA,HYDERABAD,4695,5293,BAGDOGRA-HYDERABAD,9988,All
2022,3,BAGDOGRA,HYDERABAD,5337,5428,BAGDOGRA-HYDERABAD,10765,All
2022,4,BAGDOGRA,HYDERABAD,2672,2651,BAGDOGRA-HYDERABAD,5323,All
2022,5,BAGDOGRA,HYDERABAD,5621,5788,BAGDOGRA-HYDERABAD,11409,All
2022,6,BAGDOGRA,HYDERABAD,5160,5072,BAGDOGRA-HYDERABAD,10232,All
2022,7,BAGDOGRA,HYDERABAD,5412,5490,BAGDOGRA-HYDERABAD,10902,All
2022,8,BAGDOGRA,HYDERABAD,5433,5525,BAGDOGRA-HYDERABAD,10958,All
2022,9,BAGDOGRA,HYDERABAD,4826,5073,BAGDOGRA-HYDERABAD,9899,All
2022,10,BAGDOGRA,HYDERABAD,5220,5261,BAGDOGRA-HYDERABAD,10481,All
2022,11,BAGDOGRA,HYDERABAD,5122,4738,BAGDOGRA-HYDERABAD,9860,All
2022,12,BAGDOGRA,HYDERABAD,4336,4326,BAGDOGRA-HYDERABAD,8662,All
2023,1,BAGDOGRA,HYDERABAD,4845,4603,BAGDOGRA-HYDERABAD,9448,All
2023,2,BAGDOGRA,HYDERABAD,4492,4538,BAGDOGRA-HYDERABAD,9030,All
2023,3,BAGDOGRA,HYDERABAD,5784,6501,BAGDOGRA-HYDERABAD,12285,All
2023,4,BAGDOGRA,HYDERABAD,8994,11230,BAGDOGRA-HYDERABAD,20224,All
2023,5,BAGDOGRA,HYDERABAD,10273,11401,BAGDOGRA-HYDERABAD,21674,All
2023,6,BAGDOGRA,HYDERABAD,9875,11126,BAGDOGRA-HYDERABAD,21001,All
2023,7,BAGDOGRA,HYDERABAD,9525,8770,BAGDOGRA-HYDERABAD,18295,All
2023,8,BAGDOGRA,HYDERABAD,9198,9756,BAGDOGRA-HYDERABAD,18954,All
2023,9,BAGDOGRA,HYDERABAD,9073,9894,BAGDOGRA-HYDERABAD,18967,All
2023,10,BAGDOGRA,HYDERABAD,7342,10087,BAGDOGRA-HYDERABAD,17429,All
2023,11,BAGDOGRA,HYDERABAD,5233,5298,BAGDOGRA-HYDERABAD,10531,All
2023,12,BAGDOGRA,HYDERABAD,5517,5558,BAGDOGRA-HYDERABAD,11075,All
2024,1,BAGDOGRA,HYDERABAD,5401,5435,BAGDOGRA-HYDERABAD,10836,All
2024,2,BAGDOGRA,HYDERABAD,4967,5066,BAGDOGRA-HYDERABAD,10033,All
2024,3,BAGDOGRA,HYDERABAD,5263,5525,BAGDOGRA-HYDERABAD,10788,All
2024,4,BAGDOGRA,HYDERABAD,9465,11264,BAGDOGRA-HYDERABAD,20729,All
2024,6,BAGDOGRA,HYDERABAD,13231,12472,BAGDOGRA-HYDERABAD,25703,All
2024,7,BAGDOGRA,HYDERABAD,13368,9668,BAGDOGRA-HYDERABAD,23036,All
2024,8,BAGDOGRA,HYDERABAD,12237,10178,BAGDOGRA-HYDERABAD,22415,All
2024,9,BAGDOGRA,HYDERABAD,10496,12282,BAGDOGRA-HYDERABAD,22778,All
2024,10,BAGDOGRA,HYDERABAD,11648,14979,BAGDOGRA-HYDERABAD,26627,All
2024,11,BAGDOGRA,HYDERABAD,13982,14054,BAGDOGRA-HYDERABAD,28036,All
2024,12,BAGDOGRA,HYDERABAD,14912,14950,BAGDOGRA-HYDERABAD,29862,All
2025,1,BAGDOGRA,HYDERABAD,13046,13001,BAGDOGRA-HYDERABAD,26047,All
2025,2,BAGDOGRA,HYDERABAD,11902,13751,BAGDOGRA-HYDERABAD,25653,All
2025,3,BAGDOGRA,HYDERABAD,13184,14150,BAGDOGRA-HYDERABAD,27334,All
2020,9,BAGDOGRA,JAIPUR,98,42,BAGDOGRA-JAIPUR,140,All
2020,10,BAGDOGRA,JAIPUR,242,127,BAGDOGRA-JAIPUR,369,All
2020,11,BAGDOGRA,JAIPUR,290,294,BAGDOGRA-JAIPUR,584,All
2020,12,BAGDOGRA,JAIPUR,257,294,BAGDOGRA-JAIPUR,551,All
2021,1,BAGDOGRA,JAIPUR,268,206,BAGDOGRA-JAIPUR,474,All
2021,2,BAGDOGRA,JAIPUR,225,226,BAGDOGRA-JAIPUR,451,All
2021,3,BAGDOGRA,JAIPUR,194,172,BAGDOGRA-JAIPUR,366,All
2021,10,BAGDOGRA,JAIPUR,308,563,BAGDOGRA-JAIPUR,871,All
2021,11,BAGDOGRA,JAIPUR,2921,2897,BAGDOGRA-JAIPUR,5818,All
2021,12,BAGDOGRA,JAIPUR,2621,3046,BAGDOGRA-JAIPUR,5667,All
2022,1,BAGDOGRA,JAIPUR,964,1436,BAGDOGRA-JAIPUR,2400,All
2022,2,BAGDOGRA,JAIPUR,2385,2621,BAGDOGRA-JAIPUR,5006,All
2022,3,BAGDOGRA,JAIPUR,2466,2068,BAGDOGRA-JAIPUR,4534,All
2023,3,BAGDOGRA,JAIPUR,8,0,BAGDOGRA-JAIPUR,8,All
2025,1,BAGDOGRA,JAIPUR,156,0,BAGDOGRA-JAIPUR,156,All
2020,11,BAGDOGRA,JAMMU,46,0,BAGDOGRA-JAMMU,46,All
2020,12,BAGDOGRA,JAMMU,291,0,BAGDOGRA-JAMMU,291,All
2021,1,BAGDOGRA,JAMMU,85,0,BAGDOGRA-JAMMU,85,All
2018,11,BAGDOGRA,KANPUR,0,360,BAGDOGRA-KANPUR,360,All
2018,12,BAGDOGRA,KANPUR,0,201,BAGDOGRA-KANPUR,201,All
2019,1,BAGDOGRA,KANPUR,0,215,BAGDOGRA-KANPUR,215,All
2019,2,BAGDOGRA,KANPUR,0,270,BAGDOGRA-KANPUR,270,All
2019,3,BAGDOGRA,KANPUR,0,125,BAGDOGRA-KANPUR,125,All
2019,5,BAGDOGRA,KOLKATA,41167,42483,BAGDOGRA-KOLKATA,83650,All
2019,6,BAGDOGRA,KOLKATA,38917,36092,BAGDOGRA-KOLKATA,75009,All
2019,7,BAGDOGRA,KOLKATA,36473,33832,BAGDOGRA-KOLKATA,70305,All
2019,8,BAGDOGRA,KOLKATA,35105,33329,BAGDOGRA-KOLKATA,68434,All
2019,9,BAGDOGRA,KOLKATA,33874,34022,BAGDOGRA-KOLKATA,67896,All
2019,10,BAGDOGRA,KOLKATA,38014,37466,BAGDOGRA-KOLKATA,75480,All
2019,11,BAGDOGRA,KOLKATA,37564,35110,BAGDOGRA-KOLKATA,72674,All
2019,12,BAGDOGRA,KOLKATA,38897,38203,BAGDOGRA-KOLKATA,77100,All
2020,1,BAGDOGRA,KOLKATA,39173,35162,BAGDOGRA-KOLKATA,74335,All
2020,2,BAGDOGRA,KOLKATA,36337,34217,BAGDOGRA-KOLKATA,70554,All
2020,3,BAGDOGRA,KOLKATA,27196,25463,BAGDOGRA-KOLKATA,52659,All
2020,5,BAGDOGRA,KOLKATA,96,100,BAGDOGRA-KOLKATA,196,All
2020,6,BAGDOGRA,KOLKATA,6580,8641,BAGDOGRA-KOLKATA,15221,All
2020,7,BAGDOGRA,KOLKATA,6860,5997,BAGDOGRA-KOLKATA,12857,All
2020,8,BAGDOGRA,KOLKATA,9125,7295,BAGDOGRA-KOLKATA,16420,All
2020,9,BAGDOGRA,KOLKATA,14493,10043,BAGDOGRA-KOLKATA,24536,All
2020,10,BAGDOGRA,KOLKATA,20692,18481,BAGDOGRA-KOLKATA,39173,All
2020,11,BAGDOGRA,KOLKATA,26062,22792,BAGDOGRA-KOLKATA,48854,All
2020,12,BAGDOGRA,KOLKATA,31121,34521,BAGDOGRA-KOLKATA,65642,All
2021,1,BAGDOGRA,KOLKATA,32765,26166,BAGDOGRA-KOLKATA,58931,All
2021,2,BAGDOGRA,KOLKATA,30460,28235,BAGDOGRA-KOLKATA,58695,All
2021,3,BAGDOGRA,KOLKATA,34714,32555,BAGDOGRA-KOLKATA,67269,All
2021,4,BAGDOGRA,KOLKATA,25038,23284,BAGDOGRA-KOLKATA,48322,All
2021,6,BAGDOGRA,KOLKATA,5877,4783,BAGDOGRA-KOLKATA,10660,All
2021,7,BAGDOGRA,KOLKATA,14068,10225,BAGDOGRA-KOLKATA,24293,All
2021,8,BAGDOGRA,KOLKATA,18993,16016,BAGDOGRA-KOLKATA,35009,All
2021,9,BAGDOGRA,KOLKATA,21138,20177,BAGDOGRA-KOLKATA,41315,All
2021,10,BAGDOGRA,KOLKATA,35744,36236,BAGDOGRA-KOLKATA,71980,All
2021,11,BAGDOGRA,KOLKATA,34892,33310,BAGDOGRA-KOLKATA,68202,All
2021,12,BAGDOGRA,KOLKATA,37166,36715,BAGDOGRA-KOLKATA,73881,All
2022,1,BAGDOGRA,KOLKATA,23415,21308,BAGDOGRA-KOLKATA,44723,All
2022,2,BAGDOGRA,KOLKATA,26948,25230,BAGDOGRA-KOLKATA,52178,All
2022,3,BAGDOGRA,KOLKATA,33503,33867,BAGDOGRA-KOLKATA,67370,All
2022,4,BAGDOGRA,KOLKATA,15314,15982,BAGDOGRA-KOLKATA,31296,All
2022,5,BAGDOGRA,KOLKATA,34223,33584,BAGDOGRA-KOLKATA,67807,All
2022,6,BAGDOGRA,KOLKATA,31252,26075,BAGDOGRA-KOLKATA,57327,All
2022,7,BAGDOGRA,KOLKATA,22627,19367,BAGDOGRA-KOLKATA,41994,All
2022,8,BAGDOGRA,KOLKATA,24534,20504,BAGDOGRA-KOLKATA,45038,All
2022,9,BAGDOGRA,KOLKATA,24291,23640,BAGDOGRA-KOLKATA,47931,All
2022,10,BAGDOGRA,KOLKATA,32635,30861,BAGDOGRA-KOLKATA,63496,All
2022,11,BAGDOGRA,KOLKATA,25290,23815,BAGDOGRA-KOLKATA,49105,All
2022,12,BAGDOGRA,KOLKATA,25992,25809,BAGDOGRA-KOLKATA,51801,All
2023,1,BAGDOGRA,KOLKATA,27259,25525,BAGDOGRA-KOLKATA,52784,All
2023,2,BAGDOGRA,KOLKATA,25876,25109,BAGDOGRA-KOLKATA,50985,All
2023,3,BAGDOGRA,KOLKATA,28568,28551,BAGDOGRA-KOLKATA,57119,All
2023,4,BAGDOGRA,KOLKATA,21859,22419,BAGDOGRA-KOLKATA,44278,All
2023,5,BAGDOGRA,KOLKATA,23225,23495,BAGDOGRA-KOLKATA,46720,All
2023,6,BAGDOGRA,KOLKATA,31668,31186,BAGDOGRA-KOLKATA,62854,All
2023,7,BAGDOGRA,KOLKATA,25013,24289,BAGDOGRA-KOLKATA,49302,All
2023,8,BAGDOGRA,KOLKATA,24422,24797,BAGDOGRA-KOLKATA,49219,All
2023,9,BAGDOGRA,KOLKATA,27551,29661,BAGDOGRA-KOLKATA,57212,All
2023,10,BAGDOGRA,KOLKATA,33361,32773,BAGDOGRA-KOLKATA,66134,All
2023,11,BAGDOGRA,KOLKATA,40136,39230,BAGDOGRA-KOLKATA,79366,All
2023,12,BAGDOGRA,KOLKATA,38074,38491,BAGDOGRA-KOLKATA,76565,All
2024,1,BAGDOGRA,KOLKATA,37716,36675,BAGDOGRA-KOLKATA,74391,All
2024,2,BAGDOGRA,KOLKATA,27693,28606,BAGDOGRA-KOLKATA,56299,All
2024,3,BAGDOGRA,KOLKATA,30033,31798,BAGDOGRA-KOLKATA,61831,All
2024,4,BAGDOGRA,KOLKATA,27623,29473,BAGDOGRA-KOLKATA,57096,All
2024,6,BAGDOGRA,KOLKATA,33640,28494,BAGDOGRA-KOLKATA,62134,All
2024,7,BAGDOGRA,KOLKATA,25748,21165,BAGDOGRA-KOLKATA,46913,All
2024,8,BAGDOGRA,KOLKATA,23158,21536,BAGDOGRA-KOLKATA,44694,All
2024,9,BAGDOGRA,KOLKATA,21436,22197,BAGDOGRA-KOLKATA,43633,All
2024,10,BAGDOGRA,KOLKATA,25530,26197,BAGDOGRA-KOLKATA,51727,All
2024,11,BAGDOGRA,KOLKATA,26025,24850,BAGDOGRA-KOLKATA,50875,All
2024,12,BAGDOGRA,KOLKATA,22530,22890,BAGDOGRA-KOLKATA,45420,All
2025,1,BAGDOGRA,KOLKATA,26734,25456,BAGDOGRA-KOLKATA,52190,All
2025,2,BAGDOGRA,KOLKATA,24617,23835,BAGDOGRA-KOLKATA,48452,All
2025,3,BAGDOGRA,KOLKATA,27803,27763,BAGDOGRA-KOLKATA,55566,All
2017,4,BAGDOGRA,LUCKNOW,0,37,BAGDOGRA-LUCKNOW,37,All
2017,5,BAGDOGRA,LUCKNOW,0,95,BAGDOGRA-LUCKNOW,95,All
2019,10,BAGDOGRA,LUCKNOW,0,4,BAGDOGRA-LUCKNOW,4,All
2019,11,BAGDOGRA,LUCKNOW,0,108,BAGDOGRA-LUCKNOW,108,All
2019,12,BAGDOGRA,LUCKNOW,0,319,BAGDOGRA-LUCKNOW,319,All
2020,1,BAGDOGRA,LUCKNOW,0,113,BAGDOGRA-LUCKNOW,113,All
2020,2,BAGDOGRA,LUCKNOW,0,43,BAGDOGRA-LUCKNOW,43,All
2020,3,BAGDOGRA,LUCKNOW,0,38,BAGDOGRA-LUCKNOW,38,All
2020,12,BAGDOGRA,LUCKNOW,0,180,BAGDOGRA-LUCKNOW,180,All
2021,3,BAGDOGRA,LUCKNOW,3,58,BAGDOGRA-LUCKNOW,61,All
2021,4,BAGDOGRA,LUCKNOW,167,315,BAGDOGRA-LUCKNOW,482,All
2023,9,BAGDOGRA,LUCKNOW,15,0,BAGDOGRA-LUCKNOW,15,All
2018,8,BAGDOGRA,MANGALORE,22,0,BAGDOGRA-MANGALORE,22,All
2018,9,BAGDOGRA,MANGALORE,42,0,BAGDOGRA-MANGALORE,42,All
2018,10,BAGDOGRA,MANGALORE,88,0,BAGDOGRA-MANGALORE,88,All
2018,11,BAGDOGRA,MANGALORE,61,0,BAGDOGRA-MANGALORE,61,All
2018,12,BAGDOGRA,MANGALORE,58,0,BAGDOGRA-MANGALORE,58,All
2019,1,BAGDOGRA,MANGALORE,115,0,BAGDOGRA-MANGALORE,115,All
2019,2,BAGDOGRA,MANGALORE,24,0,BAGDOGRA-MANGALORE,24,All
2019,3,BAGDOGRA,MANGALORE,16,0,BAGDOGRA-MANGALORE,16,All
2019,4,BAGDOGRA,MANGALORE,47,0,BAGDOGRA-MANGALORE,47,All
2019,5,BAGDOGRA,MANGALORE,36,0,BAGDOGRA-MANGALORE,36,All
2019,6,BAGDOGRA,MANGALORE,55,0,BAGDOGRA-MANGALORE,55,All
2019,7,BAGDOGRA,MANGALORE,65,0,BAGDOGRA-MANGALORE,65,All
2019,8,BAGDOGRA,MANGALORE,43,0,BAGDOGRA-MANGALORE,43,All
2019,9,BAGDOGRA,MANGALORE,19,0,BAGDOGRA-MANGALORE,19,All
2019,10,BAGDOGRA,MANGALORE,74,0,BAGDOGRA-MANGALORE,74,All
2019,11,BAGDOGRA,MANGALORE,33,0,BAGDOGRA-MANGALORE,33,All
2019,12,BAGDOGRA,MANGALORE,50,0,BAGDOGRA-MANGALORE,50,All
2020,1,BAGDOGRA,MANGALORE,85,0,BAGDOGRA-MANGALORE,85,All
2020,2,BAGDOGRA,MANGALORE,50,0,BAGDOGRA-MANGALORE,50,All
2020,3,BAGDOGRA,MANGALORE,47,0,BAGDOGRA-MANGALORE,47,All
2019,5,BAGDOGRA,MUMBAI,13548,13984,BAGDOGRA-MUMBAI,27532,All
2019,6,BAGDOGRA,MUMBAI,14306,12175,BAGDOGRA-MUMBAI,26481,All
2019,7,BAGDOGRA,MUMBAI,9871,8632,BAGDOGRA-MUMBAI,18503,All
2019,8,BAGDOGRA,MUMBAI,8736,9905,BAGDOGRA-MUMBAI,18641,All
2019,9,BAGDOGRA,MUMBAI,8071,8407,BAGDOGRA-MUMBAI,16478,All
2019,10,BAGDOGRA,MUMBAI,11720,13053,BAGDOGRA-MUMBAI,24773,All
2019,11,BAGDOGRA,MUMBAI,13200,12374,BAGDOGRA-MUMBAI,25574,All
2019,12,BAGDOGRA,MUMBAI,13213,13161,BAGDOGRA-MUMBAI,26374,All
2020,1,BAGDOGRA,MUMBAI,11342,11167,BAGDOGRA-MUMBAI,22509,All
2020,2,BAGDOGRA,MUMBAI,9746,11751,BAGDOGRA-MUMBAI,21497,All
2020,3,BAGDOGRA,MUMBAI,7278,9065,BAGDOGRA-MUMBAI,16343,All
2020,6,BAGDOGRA,MUMBAI,1606,3356,BAGDOGRA-MUMBAI,4962,All
2020,7,BAGDOGRA,MUMBAI,2389,2533,BAGDOGRA-MUMBAI,4922,All
2020,9,BAGDOGRA,MUMBAI,4543,1897,BAGDOGRA-MUMBAI,6440,All
2020,10,BAGDOGRA,MUMBAI,7267,2761,BAGDOGRA-MUMBAI,10028,All
2020,11,BAGDOGRA,MUMBAI,6983,5318,BAGDOGRA-MUMBAI,12301,All
2020,12,BAGDOGRA,MUMBAI,6896,4795,BAGDOGRA-MUMBAI,11691,All
2021,1,BAGDOGRA,MUMBAI,7763,4471,BAGDOGRA-MUMBAI,12234,All
2021,2,BAGDOGRA,MUMBAI,7838,5456,BAGDOGRA-MUMBAI,13294,All
2021,3,BAGDOGRA,MUMBAI,7706,5847,BAGDOGRA-MUMBAI,13553,All
2021,4,BAGDOGRA,MUMBAI,2432,2958,BAGDOGRA-MUMBAI,5390,All
2021,6,BAGDOGRA,MUMBAI,1141,486,BAGDOGRA-MUMBAI,1627,All
2021,7,BAGDOGRA,MUMBAI,1769,1496,BAGDOGRA-MUMBAI,3265,All
2021,8,BAGDOGRA,MUMBAI,1983,1384,BAGDOGRA-MUMBAI,3367,All
2021,9,BAGDOGRA,MUMBAI,1957,1670,BAGDOGRA-MUMBAI,3627,All
2021,10,BAGDOGRA,MUMBAI,2100,2183,BAGDOGRA-MUMBAI,4283,All
2021,11,BAGDOGRA,MUMBAI,9814,7706,BAGDOGRA-MUMBAI,17520,All
2021,12,BAGDOGRA,MUMBAI,12798,10012,BAGDOGRA-MUMBAI,22810,All
2022,1,BAGDOGRA,MUMBAI,5378,3159,BAGDOGRA-MUMBAI,8537,All
2022,2,BAGDOGRA,MUMBAI,4276,4941,BAGDOGRA-MUMBAI,9217,All
2022,3,BAGDOGRA,MUMBAI,9988,9204,BAGDOGRA-MUMBAI,19192,All
2022,4,BAGDOGRA,MUMBAI,6893,7245,BAGDOGRA-MUMBAI,14138,All
2022,5,BAGDOGRA,MUMBAI,16231,16417,BAGDOGRA-MUMBAI,32648,All
2022,6,BAGDOGRA,MUMBAI,13996,11185,BAGDOGRA-MUMBAI,25181,All
2022,7,BAGDOGRA,MUMBAI,6907,6566,BAGDOGRA-MUMBAI,13473,All
2022,8,BAGDOGRA,MUMBAI,7298,5289,BAGDOGRA-MUMBAI,12587,All
2022,9,BAGDOGRA,MUMBAI,8159,8087,BAGDOGRA-MUMBAI,16246,All
2022,10,BAGDOGRA,MUMBAI,9864,10736,BAGDOGRA-MUMBAI,20600,All
2022,11,BAGDOGRA,MUMBAI,10762,9812,BAGDOGRA-MUMBAI,20574,All
2022,12,BAGDOGRA,MUMBAI,11039,10998,BAGDOGRA-MUMBAI,22037,All
2023,1,BAGDOGRA,MUMBAI,9797,9515,BAGDOGRA-MUMBAI,19312,All
2023,2,BAGDOGRA,MUMBAI,9957,10065,BAGDOGRA-MUMBAI,20022,All
2023,3,BAGDOGRA,MUMBAI,11196,11288,BAGDOGRA-MUMBAI,22484,All
2023,4,BAGDOGRA,MUMBAI,10562,10998,BAGDOGRA-MUMBAI,21560,All
2023,5,BAGDOGRA,MUMBAI,12334,12560,BAGDOGRA-MUMBAI,24894,All
2023,6,BAGDOGRA,MUMBAI,14694,15664,BAGDOGRA-MUMBAI,30358,All
2023,7,BAGDOGRA,MUMBAI,11519,9310,BAGDOGRA-MUMBAI,20829,All
2023,8,BAGDOGRA,MUMBAI,12458,10582,BAGDOGRA-MUMBAI,23040,All
2023,9,BAGDOGRA,MUMBAI,9733,9950,BAGDOGRA-MUMBAI,19683,All
2023,10,BAGDOGRA,MUMBAI,9661,10343,BAGDOGRA-MUMBAI,20004,All
2023,11,BAGDOGRA,MUMBAI,12751,15394,BAGDOGRA-MUMBAI,28145,All
2023,12,BAGDOGRA,MUMBAI,14749,14763,BAGDOGRA-MUMBAI,29512,All
2024,1,BAGDOGRA,MUMBAI,10589,10838,BAGDOGRA-MUMBAI,21427,All
2024,2,BAGDOGRA,MUMBAI,9448,10068,BAGDOGRA-MUMBAI,19516,All
2024,3,BAGDOGRA,MUMBAI,10643,11055,BAGDOGRA-MUMBAI,21698,All
2024,4,BAGDOGRA,MUMBAI,16646,18986,BAGDOGRA-MUMBAI,35632,All
2024,6,BAGDOGRA,MUMBAI,17484,16771,BAGDOGRA-MUMBAI,34255,All
2024,7,BAGDOGRA,MUMBAI,11040,10228,BAGDOGRA-MUMBAI,21268,All
2024,8,BAGDOGRA,MUMBAI,10828,10526,BAGDOGRA-MUMBAI,21354,All
2024,9,BAGDOGRA,MUMBAI,9854,9966,BAGDOGRA-MUMBAI,19820,All
2024,10,BAGDOGRA,MUMBAI,11290,11996,BAGDOGRA-MUMBAI,23286,All
2024,11,BAGDOGRA,MUMBAI,11907,11975,BAGDOGRA-MUMBAI,23882,All
2024,12,BAGDOGRA,MUMBAI,14217,14700,BAGDOGRA-MUMBAI,28917,All
2025,1,BAGDOGRA,MUMBAI,12589,12583,BAGDOGRA-MUMBAI,25172,All
2025,2,BAGDOGRA,MUMBAI,9620,9865,BAGDOGRA-MUMBAI,19485,All
2025,3,BAGDOGRA,MUMBAI,10296,10383,BAGDOGRA-MUMBAI,20679,All
2018,10,BAGDOGRA,PATNA,1,0,BAGDOGRA-PATNA,1,All
2020,3,BAGDOGRA,PATNA,1917,1222,BAGDOGRA-PATNA,3139,All
2020,5,BAGDOGRA,PATNA,0,0,BAGDOGRA-PATNA,0,All
2021,8,BAGDOGRA,PATNA,189,227,BAGDOGRA-PATNA,416,All
2022,1,BAGDOGRA,PATNA,0,386,BAGDOGRA-PATNA,386,All
2022,2,BAGDOGRA,PATNA,0,80,BAGDOGRA-PATNA,80,All
2024,11,BAGDOGRA,PATNA,2,6,BAGDOGRA-PATNA,8,All
2024,12,BAGDOGRA,PATNA,3,8,BAGDOGRA-PATNA,11,All
2025,2,BAGDOGRA,PATNA,11,8,BAGDOGRA-PATNA,19,All
2025,3,BAGDOGRA,PATNA,21,70,BAGDOGRA-PATNA,91,All
2020,10,BAGDOGRA,PUNE,0,76,BAGDOGRA-PUNE,76,All
2020,11,BAGDOGRA,PUNE,0,417,BAGDOGRA-PUNE,417,All
2020,12,BAGDOGRA,PUNE,0,250,BAGDOGRA-PUNE,250,All
2021,1,BAGDOGRA,PUNE,0,158,BAGDOGRA-PUNE,158,All
2021,2,BAGDOGRA,PUNE,0,202,BAGDOGRA-PUNE,202,All
2021,3,BAGDOGRA,PUNE,0,293,BAGDOGRA-PUNE,293,All
2021,10,BAGDOGRA,PUNE,185,321,BAGDOGRA-PUNE,506,All
2017,3,BAGDOGRA,RANCHI,0,4,BAGDOGRA-RANCHI,4,All
2017,4,BAGDOGRA,RANCHI,0,10,BAGDOGRA-RANCHI,10,All
2017,5,BAGDOGRA,RANCHI,0,9,BAGDOGRA-RANCHI,9,All
2017,6,BAGDOGRA,RANCHI,0,4,BAGDOGRA-RANCHI,4,All
2017,7,BAGDOGRA,RANCHI,0,4,BAGDOGRA-RANCHI,4,All
2017,8,BAGDOGRA,RANCHI,0,7,BAGDOGRA-RANCHI,7,All
2017,9,BAGDOGRA,RANCHI,0,9,BAGDOGRA-RANCHI,9,All
2017,10,BAGDOGRA,RANCHI,0,17,BAGDOGRA-RANCHI,17,All
2017,11,BAGDOGRA,RANCHI,0,14,BAGDOGRA-RANCHI,14,All
2017,12,BAGDOGRA,RANCHI,0,38,BAGDOGRA-RANCHI,38,All
2018,1,BAGDOGRA,RANCHI,0,14,BAGDOGRA-RANCHI,14,All
2018,2,BAGDOGRA,RANCHI,0,16,BAGDOGRA-RANCHI,16,All
2018,3,BAGDOGRA,RANCHI,0,10,BAGDOGRA-RANCHI,10,All
2021,3,BAGDOGRA,RANCHI,1,0,BAGDOGRA-RANCHI,1,All
2021,11,BAGDOGRA,RANCHI,31,41,BAGDOGRA-RANCHI,72,All
2022,1,BAGDOGRA,RANCHI,1,0,BAGDOGRA-RANCHI,1,All
2022,4,BAGDOGRA,RANCHI,31,41,BAGDOGRA-RANCHI,72,All
2022,6,BAGDOGRA,RANCHI,31,41,BAGDOGRA-RANCHI,72,All
2022,9,BAGDOGRA,RANCHI,31,41,BAGDOGRA-RANCHI,72,All
2023,12,BAGDOGRA,RANCHI,167,0,BAGDOGRA-RANCHI,167,All
2022,9,BAGDOGRA,SILCHAR,133,0,BAGDOGRA-SILCHAR,133,All
2025,3,BAGDOGRA,SRINAGAR,0,2,BAGDOGRA-SRINAGAR,2,All
2019,9,BAGDOGRA,SURAT,86,0,BAGDOGRA-SURAT,86,All
2019,10,BAGDOGRA,SURAT,42,0,BAGDOGRA-SURAT,42,All
2021,10,BAGDOGRA,SURAT,0,34,BAGDOGRA-SURAT,34,All
2021,11,BAGDOGRA,SURAT,0,512,BAGDOGRA-SURAT,512,All
2021,12,BAGDOGRA,SURAT,0,393,BAGDOGRA-SURAT,393,All
2022,1,BAGDOGRA,SURAT,0,32,BAGDOGRA-SURAT,32,All
2025,1,BAGDOGRA,VARANASI,4,0,BAGDOGRA-VARANASI,4,All
2021,8,BAREILLY,BENGALURU,950,874,BAREILLY-BENGALURU,1824,All
2021,9,BAREILLY,BENGALURU,1877,1785,BAREILLY-BENGALURU,3662,All
2021,10,BAREILLY,BENGALURU,1320,1736,BAREILLY-BENGALURU,3056,All
2021,11,BAREILLY,BENGALURU,3033,2348,BAREILLY-BENGALURU,5381,All
2021,12,BAREILLY,BENGALURU,3057,2037,BAREILLY-BENGALURU,5094,All
2022,1,BAREILLY,BENGALURU,2116,2363,BAREILLY-BENGALURU,4479,All
2022,2,BAREILLY,BENGALURU,1620,1645,BAREILLY-BENGALURU,3265,All
2022,3,BAREILLY,BENGALURU,3248,3079,BAREILLY-BENGALURU,6327,All
2022,4,BAREILLY,BENGALURU,2717,2675,BAREILLY-BENGALURU,5392,All
2022,5,BAREILLY,BENGALURU,3049,2568,BAREILLY-BENGALURU,5617,All
2022,6,BAREILLY,BENGALURU,2971,2747,BAREILLY-BENGALURU,5718,All
2022,7,BAREILLY,BENGALURU,2772,2400,BAREILLY-BENGALURU,5172,All
2022,8,BAREILLY,BENGALURU,1985,1683,BAREILLY-BENGALURU,3668,All
2022,9,BAREILLY,BENGALURU,1539,1830,BAREILLY-BENGALURU,3369,All
2022,10,BAREILLY,BENGALURU,2158,2636,BAREILLY-BENGALURU,4794,All
2022,11,BAREILLY,BENGALURU,1971,1847,BAREILLY-BENGALURU,3818,All
2022,12,BAREILLY,BENGALURU,1771,1565,BAREILLY-BENGALURU,3336,All
2023,1,BAREILLY,BENGALURU,1385,1626,BAREILLY-BENGALURU,3011,All
2023,2,BAREILLY,BENGALURU,1644,1826,BAREILLY-BENGALURU,3470,All
2023,3,BAREILLY,BENGALURU,1904,1825,BAREILLY-BENGALURU,3729,All
2023,4,BAREILLY,BENGALURU,1776,2074,BAREILLY-BENGALURU,3850,All
2023,5,BAREILLY,BENGALURU,1983,1911,BAREILLY-BENGALURU,3894,All
2023,6,BAREILLY,BENGALURU,2100,2000,BAREILLY-BENGALURU,4100,All
2023,7,BAREILLY,BENGALURU,1920,1850,BAREILLY-BENGALURU,3770,All
2023,8,BAREILLY,BENGALURU,1911,2082,BAREILLY-BENGALURU,3993,All
2023,9,BAREILLY,BENGALURU,2016,2121,BAREILLY-BENGALURU,4137,All
2023,10,BAREILLY,BENGALURU,1866,2154,BAREILLY-BENGALURU,4020,All
2023,11,BAREILLY,BENGALURU,1990,2118,BAREILLY-BENGALURU,4108,All
2023,12,BAREILLY,BENGALURU,2017,2006,BAREILLY-BENGALURU,4023,All
2024,1,BAREILLY,BENGALURU,1154,1185,BAREILLY-BENGALURU,2339,All
2024,2,BAREILLY,BENGALURU,2033,2115,BAREILLY-BENGALURU,4148,All
2024,3,BAREILLY,BENGALURU,1884,2023,BAREILLY-BENGALURU,3907,All
2024,4,BAREILLY,BENGALURU,1987,2134,BAREILLY-BENGALURU,4121,All
2024,6,BAREILLY,BENGALURU,2195,2128,BAREILLY-BENGALURU,4323,All
2024,7,BAREILLY,BENGALURU,2153,2096,BAREILLY-BENGALURU,4249,All
2024,8,BAREILLY,BENGALURU,2260,2276,BAREILLY-BENGALURU,4536,All
2024,9,BAREILLY,BENGALURU,1866,1968,BAREILLY-BENGALURU,3834,All
2024,10,BAREILLY,BENGALURU,1840,2413,BAREILLY-BENGALURU,4253,All
2024,11,BAREILLY,BENGALURU,2293,2192,BAREILLY-BENGALURU,4485,All
2024,12,BAREILLY,BENGALURU,2173,2120,BAREILLY-BENGALURU,4293,All
2025,1,BAREILLY,BENGALURU,1830,1866,BAREILLY-BENGALURU,3696,All
2025,2,BAREILLY,BENGALURU,1646,1621,BAREILLY-BENGALURU,3267,All
2025,3,BAREILLY,BENGALURU,2202,2161,BAREILLY-BENGALURU,4363,All
2023,4,BAREILLY,CHENNAI,120,0,BAREILLY-CHENNAI,120,All
2021,3,BAREILLY,DELHI,756,742,BAREILLY-DELHI,1498,All
2021,4,BAREILLY,DELHI,616,813,BAREILLY-DELHI,1429,All
2021,6,BAREILLY,DELHI,788,647,BAREILLY-DELHI,1435,All
2021,7,BAREILLY,DELHI,821,815,BAREILLY-DELHI,1636,All
2021,8,BAREILLY,DELHI,1022,1005,BAREILLY-DELHI,2027,All
2021,9,BAREILLY,DELHI,1256,1017,BAREILLY-DELHI,2273,All
2021,10,BAREILLY,DELHI,1389,1094,BAREILLY-DELHI,2483,All
2021,11,BAREILLY,DELHI,1634,1376,BAREILLY-DELHI,3010,All
2021,12,BAREILLY,DELHI,1624,1281,BAREILLY-DELHI,2905,All
2022,1,BAREILLY,DELHI,710,565,BAREILLY-DELHI,1275,All
2022,2,BAREILLY,DELHI,1128,908,BAREILLY-DELHI,2036,All
2022,3,BAREILLY,DELHI,1714,1447,BAREILLY-DELHI,3161,All
2022,4,BAREILLY,DELHI,1634,1376,BAREILLY-DELHI,3010,All
2022,5,BAREILLY,DELHI,1624,1281,BAREILLY-DELHI,2905,All
2022,6,BAREILLY,DELHI,1634,1376,BAREILLY-DELHI,3010,All
2022,7,BAREILLY,DELHI,1128,908,BAREILLY-DELHI,2036,All
2022,8,BAREILLY,DELHI,1624,1281,BAREILLY-DELHI,2905,All
2022,9,BAREILLY,DELHI,1634,1376,BAREILLY-DELHI,3010,All
2022,10,BAREILLY,DELHI,1009,1175,BAREILLY-DELHI,2184,All
2022,11,BAREILLY,DELHI,1404,1303,BAREILLY-DELHI,2707,All
2022,12,BAREILLY,DELHI,1222,1196,BAREILLY-DELHI,2418,All
2023,1,BAREILLY,DELHI,552,588,BAREILLY-DELHI,1140,All
2023,2,BAREILLY,DELHI,819,836,BAREILLY-DELHI,1655,All
2023,3,BAREILLY,DELHI,868,841,BAREILLY-DELHI,1709,All
2023,4,BAREILLY,DELHI,574,632,BAREILLY-DELHI,1206,All
2023,5,BAREILLY,DELHI,596,667,BAREILLY-DELHI,1263,All
2023,6,BAREILLY,DELHI,380,375,BAREILLY-DELHI,755,All
2023,7,BAREILLY,DELHI,602,494,BAREILLY-DELHI,1096,All
2023,8,BAREILLY,DELHI,673,644,BAREILLY-DELHI,1317,All
2023,9,BAREILLY,DELHI,516,480,BAREILLY-DELHI,996,All
2023,10,BAREILLY,DELHI,561,564,BAREILLY-DELHI,1125,All
2023,11,BAREILLY,DELHI,603,675,BAREILLY-DELHI,1278,All
2023,12,BAREILLY,DELHI,574,554,BAREILLY-DELHI,1128,All
2024,1,BAREILLY,DELHI,542,539,BAREILLY-DELHI,1081,All
2024,2,BAREILLY,DELHI,568,559,BAREILLY-DELHI,1127,All
2024,3,BAREILLY,DELHI,515,551,BAREILLY-DELHI,1066,All
2024,4,BAREILLY,DELHI,32,0,BAREILLY-DELHI,32,All
2023,3,BAREILLY,JAIPUR,162,77,BAREILLY-JAIPUR,239,All
2023,4,BAREILLY,JAIPUR,947,701,BAREILLY-JAIPUR,1648,All
2023,5,BAREILLY,JAIPUR,981,997,BAREILLY-JAIPUR,1978,All
2023,6,BAREILLY,JAIPUR,977,980,BAREILLY-JAIPUR,1957,All
2023,7,BAREILLY,JAIPUR,975,790,BAREILLY-JAIPUR,1765,All
2023,8,BAREILLY,JAIPUR,844,838,BAREILLY-JAIPUR,1682,All
2023,9,BAREILLY,JAIPUR,777,717,BAREILLY-JAIPUR,1494,All
2023,10,BAREILLY,JAIPUR,548,686,BAREILLY-JAIPUR,1234,All
2024,6,BAREILLY,LUCKNOW,0,159,BAREILLY-LUCKNOW,159,All
2021,8,BAREILLY,MUMBAI,1615,1480,BAREILLY-MUMBAI,3095,All
2021,9,BAREILLY,MUMBAI,2647,2558,BAREILLY-MUMBAI,5205,All
2021,10,BAREILLY,MUMBAI,2714,3304,BAREILLY-MUMBAI,6018,All
2021,11,BAREILLY,MUMBAI,4404,4232,BAREILLY-MUMBAI,8636,All
2021,12,BAREILLY,MUMBAI,4460,3783,BAREILLY-MUMBAI,8243,All
2022,1,BAREILLY,MUMBAI,1558,1704,BAREILLY-MUMBAI,3262,All
2022,2,BAREILLY,MUMBAI,2344,2314,BAREILLY-MUMBAI,4658,All
2022,3,BAREILLY,MUMBAI,3056,2930,BAREILLY-MUMBAI,5986,All
2022,4,BAREILLY,MUMBAI,3259,3735,BAREILLY-MUMBAI,6994,All
2022,5,BAREILLY,MUMBAI,3257,3070,BAREILLY-MUMBAI,6327,All
2022,6,BAREILLY,MUMBAI,3029,2335,BAREILLY-MUMBAI,5364,All
2022,7,BAREILLY,MUMBAI,1813,1800,BAREILLY-MUMBAI,3613,All
2022,8,BAREILLY,MUMBAI,2306,2308,BAREILLY-MUMBAI,4614,All
2022,9,BAREILLY,MUMBAI,1882,2151,BAREILLY-MUMBAI,4033,All
2022,10,BAREILLY,MUMBAI,2861,3600,BAREILLY-MUMBAI,6461,All
2022,11,BAREILLY,MUMBAI,2911,2678,BAREILLY-MUMBAI,5589,All
2022,12,BAREILLY,MUMBAI,2365,2282,BAREILLY-MUMBAI,4647,All
2023,1,BAREILLY,MUMBAI,2023,2037,BAREILLY-MUMBAI,4060,All
2023,2,BAREILLY,MUMBAI,2340,2532,BAREILLY-MUMBAI,4872,All
2023,3,BAREILLY,MUMBAI,2612,2602,BAREILLY-MUMBAI,5214,All
2023,4,BAREILLY,MUMBAI,1801,2110,BAREILLY-MUMBAI,3911,All
2023,5,BAREILLY,MUMBAI,1821,1834,BAREILLY-MUMBAI,3655,All
2023,6,BAREILLY,MUMBAI,2089,2085,BAREILLY-MUMBAI,4174,All
2023,7,BAREILLY,MUMBAI,1991,1843,BAREILLY-MUMBAI,3834,All
2023,8,BAREILLY,MUMBAI,2022,1946,BAREILLY-MUMBAI,3968,All
2023,9,BAREILLY,MUMBAI,1900,1947,BAREILLY-MUMBAI,3847,All
2023,10,BAREILLY,MUMBAI,2249,2392,BAREILLY-MUMBAI,4641,All
2023,11,BAREILLY,MUMBAI,2631,2942,BAREILLY-MUMBAI,5573,All
2023,12,BAREILLY,MUMBAI,2959,2762,BAREILLY-MUMBAI,5721,All
2024,1,BAREILLY,MUMBAI,2071,2092,BAREILLY-MUMBAI,4163,All
2024,2,BAREILLY,MUMBAI,2625,2647,BAREILLY-MUMBAI,5272,All
2024,3,BAREILLY,MUMBAI,2820,2969,BAREILLY-MUMBAI,5789,All
2024,4,BAREILLY,MUMBAI,2682,2832,BAREILLY-MUMBAI,5514,All
2024,6,BAREILLY,MUMBAI,2887,2900,BAREILLY-MUMBAI,5787,All
2024,7,BAREILLY,MUMBAI,2745,2609,BAREILLY-MUMBAI,5354,All
2024,8,BAREILLY,MUMBAI,2788,2750,BAREILLY-MUMBAI,5538,All
2024,9,BAREILLY,MUMBAI,2785,2864,BAREILLY-MUMBAI,5649,All
2024,10,BAREILLY,MUMBAI,2364,2847,BAREILLY-MUMBAI,5211,All
2024,11,BAREILLY,MUMBAI,2786,2946,BAREILLY-MUMBAI,5732,All
2024,12,BAREILLY,MUMBAI,3174,3060,BAREILLY-MUMBAI,6234,All
2025,1,BAREILLY,MUMBAI,3018,3111,BAREILLY-MUMBAI,6129,All
2025,2,BAREILLY,MUMBAI,2844,2845,BAREILLY-MUMBAI,5689,All
2025,3,BAREILLY,MUMBAI,2838,2973,BAREILLY-MUMBAI,5811,All
2019,5,BELGAUM,BENGALURU,3741,3108,BELGAUM-BENGALURU,6849,All
2019,6,BELGAUM,BENGALURU,3352,3143,BELGAUM-BENGALURU,6495,All
2019,7,BELGAUM,BENGALURU,5337,5159,BELGAUM-BENGALURU,10496,All
2019,8,BELGAUM,BENGALURU,5507,5182,BELGAUM-BENGALURU,10689,All
2019,9,BELGAUM,BENGALURU,5816,5317,BELGAUM-BENGALURU,11133,All
2019,10,BELGAUM,BENGALURU,7225,6859,BELGAUM-BENGALURU,14084,All
2019,11,BELGAUM,BENGALURU,7418,7101,BELGAUM-BENGALURU,14519,All
2019,12,BELGAUM,BENGALURU,7632,7259,BELGAUM-BENGALURU,14891,All
2020,1,BELGAUM,BENGALURU,6928,5638,BELGAUM-BENGALURU,12566,All
2020,2,BELGAUM,BENGALURU,5947,5174,BELGAUM-BENGALURU,11121,All
2020,3,BELGAUM,BENGALURU,2907,2702,BELGAUM-BENGALURU,5609,All
2020,5,BELGAUM,BENGALURU,18,7,BELGAUM-BENGALURU,25,All
2020,6,BELGAUM,BENGALURU,295,315,BELGAUM-BENGALURU,610,All
2020,7,BELGAUM,BENGALURU,920,794,BELGAUM-BENGALURU,1714,All
2020,8,BELGAUM,BENGALURU,1818,1680,BELGAUM-BENGALURU,3498,All
2020,9,BELGAUM,BENGALURU,3042,2785,BELGAUM-BENGALURU,5827,All
2020,10,BELGAUM,BENGALURU,3743,3389,BELGAUM-BENGALURU,7132,All
2020,11,BELGAUM,BENGALURU,4146,4051,BELGAUM-BENGALURU,8197,All
2020,12,BELGAUM,BENGALURU,3525,3634,BELGAUM-BENGALURU,7159,All
2021,1,BELGAUM,BENGALURU,4839,4047,BELGAUM-BENGALURU,8886,All
2021,2,BELGAUM,BENGALURU,3658,3430,BELGAUM-BENGALURU,7088,All
2021,3,BELGAUM,BENGALURU,3706,3290,BELGAUM-BENGALURU,6996,All
2021,4,BELGAUM,BENGALURU,1745,1939,BELGAUM-BENGALURU,3684,All
2021,6,BELGAUM,BENGALURU,1139,1132,BELGAUM-BENGALURU,2271,All
2021,7,BELGAUM,BENGALURU,1570,1648,BELGAUM-BENGALURU,3218,All
2021,8,BELGAUM,BENGALURU,1987,1914,BELGAUM-BENGALURU,3901,All
2021,9,BELGAUM,BENGALURU,2802,2578,BELGAUM-BENGALURU,5380,All
2021,10,BELGAUM,BENGALURU,3177,2956,BELGAUM-BENGALURU,6133,All
2021,11,BELGAUM,BENGALURU,2102,2031,BELGAUM-BENGALURU,4133,All
2021,12,BELGAUM,BENGALURU,2058,2055,BELGAUM-BENGALURU,4113,All
2022,1,BELGAUM,BENGALURU,1346,1206,BELGAUM-BENGALURU,2552,All
2022,2,BELGAUM,BENGALURU,1891,1902,BELGAUM-BENGALURU,3793,All
2022,3,BELGAUM,BENGALURU,2265,2246,BELGAUM-BENGALURU,4511,All
2022,4,BELGAUM,BENGALURU,2113,2036,BELGAUM-BENGALURU,4149,All
2022,5,BELGAUM,BENGALURU,2228,1999,BELGAUM-BENGALURU,4227,All
2022,6,BELGAUM,BENGALURU,2214,2047,BELGAUM-BENGALURU,4261,All
2022,7,BELGAUM,BENGALURU,2254,2150,BELGAUM-BENGALURU,4404,All
2022,8,BELGAUM,BENGALURU,2245,2183,BELGAUM-BENGALURU,4428,All
2022,9,BELGAUM,BENGALURU,1994,1852,BELGAUM-BENGALURU,3846,All
2022,10,BELGAUM,BENGALURU,2165,2185,BELGAUM-BENGALURU,4350,All
2022,11,BELGAUM,BENGALURU,3878,3728,BELGAUM-BENGALURU,7606,All
2022,12,BELGAUM,BENGALURU,3858,3989,BELGAUM-BENGALURU,7847,All
2023,1,BELGAUM,BENGALURU,3701,3757,BELGAUM-BENGALURU,7458,All
2023,2,BELGAUM,BENGALURU,3325,3507,BELGAUM-BENGALURU,6832,All
2023,3,BELGAUM,BENGALURU,3508,3983,BELGAUM-BENGALURU,7491,All
2023,4,BELGAUM,BENGALURU,3632,3895,BELGAUM-BENGALURU,7527,All
2023,5,BELGAUM,BENGALURU,4677,4440,BELGAUM-BENGALURU,9117,All
2023,6,BELGAUM,BENGALURU,4387,4546,BELGAUM-BENGALURU,8933,All
2023,7,BELGAUM,BENGALURU,5016,4750,BELGAUM-BENGALURU,9766,All
2023,8,BELGAUM,BENGALURU,4787,4704,BELGAUM-BENGALURU,9491,All
2023,9,BELGAUM,BENGALURU,4368,4607,BELGAUM-BENGALURU,8975,All
2023,10,BELGAUM,BENGALURU,4145,4193,BELGAUM-BENGALURU,8338,All
2023,11,BELGAUM,BENGALURU,3842,3844,BELGAUM-BENGALURU,7686,All
2023,12,BELGAUM,BENGALURU,4224,4426,BELGAUM-BENGALURU,8650,All
2024,1,BELGAUM,BENGALURU,4223,3872,BELGAUM-BENGALURU,8095,All
2024,2,BELGAUM,BENGALURU,3820,3790,BELGAUM-BENGALURU,7610,All
2024,3,BELGAUM,BENGALURU,3762,3923,BELGAUM-BENGALURU,7685,All
2024,4,BELGAUM,BENGALURU,3730,3986,BELGAUM-BENGALURU,7716,All
2024,6,BELGAUM,BENGALURU,3893,4002,BELGAUM-BENGALURU,7895,All
2024,7,BELGAUM,BENGALURU,3811,3758,BELGAUM-BENGALURU,7569,All
2024,8,BELGAUM,BENGALURU,3950,4078,BELGAUM-BENGALURU,8028,All
2024,9,BELGAUM,BENGALURU,3649,3851,BELGAUM-BENGALURU,7500,All
2024,10,BELGAUM,BENGALURU,3452,3839,BELGAUM-BENGALURU,7291,All
2024,11,BELGAUM,BENGALURU,2163,2117,BELGAUM-BENGALURU,4280,All
2024,12,BELGAUM,BENGALURU,3730,4210,BELGAUM-BENGALURU,7940,All
2025,1,BELGAUM,BENGALURU,4269,4024,BELGAUM-BENGALURU,8293,All
2025,2,BELGAUM,BENGALURU,3254,3203,BELGAUM-BENGALURU,6457,All
2025,3,BELGAUM,BENGALURU,3996,3820,BELGAUM-BENGALURU,7816,All
2015,4,BELGAUM,CHENNAI,592,612,BELGAUM-CHENNAI,1204,All
2015,5,BELGAUM,CHENNAI,1024,959,BELGAUM-CHENNAI,1983,All
2015,6,BELGAUM,CHENNAI,982,914,BELGAUM-CHENNAI,1896,All
2015,7,BELGAUM,CHENNAI,489,382,BELGAUM-CHENNAI,871,All
2015,8,BELGAUM,CHENNAI,497,399,BELGAUM-CHENNAI,896,All
2015,9,BELGAUM,CHENNAI,521,374,BELGAUM-CHENNAI,895,All
2015,10,BELGAUM,CHENNAI,561,404,BELGAUM-CHENNAI,965,All
2015,11,BELGAUM,CHENNAI,605,518,BELGAUM-CHENNAI,1123,All
2015,12,BELGAUM,CHENNAI,515,407,BELGAUM-CHENNAI,922,All
2017,10,BELGAUM,CHENNAI,1645,1604,BELGAUM-CHENNAI,3249,All
2017,11,BELGAUM,CHENNAI,1502,1659,BELGAUM-CHENNAI,3161,All
2017,12,BELGAUM,CHENNAI,2116,2162,BELGAUM-CHENNAI,4278,All
2018,1,BELGAUM,CHENNAI,2073,2148,BELGAUM-CHENNAI,4221,All
2018,2,BELGAUM,CHENNAI,1812,1950,BELGAUM-CHENNAI,3762,All
2018,3,BELGAUM,CHENNAI,1931,2163,BELGAUM-CHENNAI,4094,All
2018,4,BELGAUM,CHENNAI,1892,2172,BELGAUM-CHENNAI,4064,All
2018,5,BELGAUM,CHENNAI,903,972,BELGAUM-CHENNAI,1875,All
2021,1,BELGAUM,CHENNAI,189,151,BELGAUM-CHENNAI,340,All
2021,2,BELGAUM,CHENNAI,328,332,BELGAUM-CHENNAI,660,All
2021,3,BELGAUM,CHENNAI,0,163,BELGAUM-CHENNAI,163,All
2021,7,BELGAUM,DELHI,28,24,BELGAUM-DELHI,52,All
2021,8,BELGAUM,DELHI,874,831,BELGAUM-DELHI,1705,All
2021,9,BELGAUM,DELHI,1159,1158,BELGAUM-DELHI,2317,All
2021,10,BELGAUM,DELHI,1651,1636,BELGAUM-DELHI,3287,All
2021,11,BELGAUM,DELHI,1872,1812,BELGAUM-DELHI,3684,All
2021,12,BELGAUM,DELHI,2335,2185,BELGAUM-DELHI,4520,All
2022,1,BELGAUM,DELHI,763,550,BELGAUM-DELHI,1313,All
2022,2,BELGAUM,DELHI,910,785,BELGAUM-DELHI,1695,All
2022,3,BELGAUM,DELHI,2445,2099,BELGAUM-DELHI,4544,All
2022,4,BELGAUM,DELHI,4532,4309,BELGAUM-DELHI,8841,All
2022,5,BELGAUM,DELHI,5030,4781,BELGAUM-DELHI,9811,All
2022,6,BELGAUM,DELHI,4831,4513,BELGAUM-DELHI,9344,All
2022,7,BELGAUM,DELHI,2544,2240,BELGAUM-DELHI,4784,All
2022,8,BELGAUM,DELHI,2449,2436,BELGAUM-DELHI,4885,All
2022,9,BELGAUM,DELHI,2413,1965,BELGAUM-DELHI,4378,All
2022,10,BELGAUM,DELHI,2533,2468,BELGAUM-DELHI,5001,All
2022,11,BELGAUM,DELHI,2282,2376,BELGAUM-DELHI,4658,All
2022,12,BELGAUM,DELHI,1438,1506,BELGAUM-DELHI,2944,All
2023,10,BELGAUM,DELHI,3845,3992,BELGAUM-DELHI,7837,All
2023,11,BELGAUM,DELHI,4721,4497,BELGAUM-DELHI,9218,All
2023,12,BELGAUM,DELHI,4854,5403,BELGAUM-DELHI,10257,All
2024,1,BELGAUM,DELHI,3519,2975,BELGAUM-DELHI,6494,All
2024,2,BELGAUM,DELHI,4069,3196,BELGAUM-DELHI,7265,All
2024,3,BELGAUM,DELHI,4208,2959,BELGAUM-DELHI,7167,All
2024,4,BELGAUM,DELHI,4512,3522,BELGAUM-DELHI,8034,All
2024,6,BELGAUM,DELHI,3804,4294,BELGAUM-DELHI,8098,All
2024,7,BELGAUM,DELHI,3488,3489,BELGAUM-DELHI,6977,All
2024,8,BELGAUM,DELHI,3252,3538,BELGAUM-DELHI,6790,All
2024,9,BELGAUM,DELHI,3747,3342,BELGAUM-DELHI,7089,All
2024,10,BELGAUM,DELHI,4707,4090,BELGAUM-DELHI,8797,All
2024,11,BELGAUM,DELHI,4381,4965,BELGAUM-DELHI,9346,All
2024,12,BELGAUM,DELHI,4589,5158,BELGAUM-DELHI,9747,All
2025,1,BELGAUM,DELHI,4004,3984,BELGAUM-DELHI,7988,All
2025,2,BELGAUM,DELHI,4717,4643,BELGAUM-DELHI,9360,All
2025,3,BELGAUM,DELHI,4232,4544,BELGAUM-DELHI,8776,All
2019,5,BELGAUM,HYDERABAD,1745,1678,BELGAUM-HYDERABAD,3423,All
2019,6,BELGAUM,HYDERABAD,1794,1496,BELGAUM-HYDERABAD,3290,All
2019,7,BELGAUM,HYDERABAD,1308,1226,BELGAUM-HYDERABAD,2534,All
2019,8,BELGAUM,HYDERABAD,1493,1272,BELGAUM-HYDERABAD,2765,All
2019,9,BELGAUM,HYDERABAD,1327,1076,BELGAUM-HYDERABAD,2403,All
2019,10,BELGAUM,HYDERABAD,2321,1829,BELGAUM-HYDERABAD,4150,All
2019,11,BELGAUM,HYDERABAD,2505,3043,BELGAUM-HYDERABAD,5548,All
2019,12,BELGAUM,HYDERABAD,3553,3343,BELGAUM-HYDERABAD,6896,All
2020,1,BELGAUM,HYDERABAD,3640,3507,BELGAUM-HYDERABAD,7147,All
2020,2,BELGAUM,HYDERABAD,5199,4903,BELGAUM-HYDERABAD,10102,All
2020,3,BELGAUM,HYDERABAD,3062,3133,BELGAUM-HYDERABAD,6195,All
2020,5,BELGAUM,HYDERABAD,148,204,BELGAUM-HYDERABAD,352,All
2020,6,BELGAUM,HYDERABAD,2292,2794,BELGAUM-HYDERABAD,5086,All
2020,7,BELGAUM,HYDERABAD,2667,3754,BELGAUM-HYDERABAD,6421,All
2020,8,BELGAUM,HYDERABAD,4281,4415,BELGAUM-HYDERABAD,8696,All
2020,9,BELGAUM,HYDERABAD,5068,5021,BELGAUM-HYDERABAD,10089,All
2020,10,BELGAUM,HYDERABAD,5627,5516,BELGAUM-HYDERABAD,11143,All
2020,11,BELGAUM,HYDERABAD,5815,5783,BELGAUM-HYDERABAD,11598,All
2020,12,BELGAUM,HYDERABAD,6513,6561,BELGAUM-HYDERABAD,13074,All
2021,1,BELGAUM,HYDERABAD,6436,6314,BELGAUM-HYDERABAD,12750,All
2021,2,BELGAUM,HYDERABAD,6025,6073,BELGAUM-HYDERABAD,12098,All
2021,3,BELGAUM,HYDERABAD,6101,5930,BELGAUM-HYDERABAD,12031,All
2021,4,BELGAUM,HYDERABAD,5322,4919,BELGAUM-HYDERABAD,10241,All
2021,6,BELGAUM,HYDERABAD,4216,3780,BELGAUM-HYDERABAD,7996,All
2021,7,BELGAUM,HYDERABAD,3203,3811,BELGAUM-HYDERABAD,7014,All
2021,8,BELGAUM,HYDERABAD,3077,3403,BELGAUM-HYDERABAD,6480,All
2021,9,BELGAUM,HYDERABAD,2680,2995,BELGAUM-HYDERABAD,5675,All
2021,10,BELGAUM,HYDERABAD,4115,3836,BELGAUM-HYDERABAD,7951,All
2021,11,BELGAUM,HYDERABAD,3652,3448,BELGAUM-HYDERABAD,7100,All
2021,12,BELGAUM,HYDERABAD,3791,3968,BELGAUM-HYDERABAD,7759,All
2022,1,BELGAUM,HYDERABAD,2350,2252,BELGAUM-HYDERABAD,4602,All
2022,2,BELGAUM,HYDERABAD,2948,3032,BELGAUM-HYDERABAD,5980,All
2022,3,BELGAUM,HYDERABAD,3657,3575,BELGAUM-HYDERABAD,7232,All
2022,4,BELGAUM,HYDERABAD,3940,3733,BELGAUM-HYDERABAD,7673,All
2022,5,BELGAUM,HYDERABAD,4136,3951,BELGAUM-HYDERABAD,8087,All
2022,6,BELGAUM,HYDERABAD,3516,3305,BELGAUM-HYDERABAD,6821,All
2022,7,BELGAUM,HYDERABAD,3128,3056,BELGAUM-HYDERABAD,6184,All
2022,8,BELGAUM,HYDERABAD,2420,2505,BELGAUM-HYDERABAD,4925,All
2022,9,BELGAUM,HYDERABAD,2135,1988,BELGAUM-HYDERABAD,4123,All
2022,10,BELGAUM,HYDERABAD,3788,3468,BELGAUM-HYDERABAD,7256,All
2022,11,BELGAUM,HYDERABAD,1873,1915,BELGAUM-HYDERABAD,3788,All
2022,12,BELGAUM,HYDERABAD,1876,1790,BELGAUM-HYDERABAD,3666,All
2023,1,BELGAUM,HYDERABAD,1539,1439,BELGAUM-HYDERABAD,2978,All
2023,2,BELGAUM,HYDERABAD,1870,1696,BELGAUM-HYDERABAD,3566,All
2023,3,BELGAUM,HYDERABAD,1854,1682,BELGAUM-HYDERABAD,3536,All
2023,4,BELGAUM,HYDERABAD,1701,1658,BELGAUM-HYDERABAD,3359,All
2023,5,BELGAUM,HYDERABAD,1905,1928,BELGAUM-HYDERABAD,3833,All
2023,6,BELGAUM,HYDERABAD,1648,1668,BELGAUM-HYDERABAD,3316,All
2023,7,BELGAUM,HYDERABAD,1555,1545,BELGAUM-HYDERABAD,3100,All
2023,8,BELGAUM,HYDERABAD,1734,1764,BELGAUM-HYDERABAD,3498,All
2023,9,BELGAUM,HYDERABAD,1764,1763,BELGAUM-HYDERABAD,3527,All
2023,10,BELGAUM,HYDERABAD,1858,1776,BELGAUM-HYDERABAD,3634,All
2023,11,BELGAUM,HYDERABAD,1729,1951,BELGAUM-HYDERABAD,3680,All
2023,12,BELGAUM,HYDERABAD,1626,1867,BELGAUM-HYDERABAD,3493,All
2024,1,BELGAUM,HYDERABAD,1564,1515,BELGAUM-HYDERABAD,3079,All
2024,2,BELGAUM,HYDERABAD,1482,1449,BELGAUM-HYDERABAD,2931,All
2024,3,BELGAUM,HYDERABAD,1539,1427,BELGAUM-HYDERABAD,2966,All
2024,4,BELGAUM,HYDERABAD,1525,1739,BELGAUM-HYDERABAD,3264,All
2024,6,BELGAUM,HYDERABAD,1815,1553,BELGAUM-HYDERABAD,3368,All
2024,7,BELGAUM,HYDERABAD,1706,1605,BELGAUM-HYDERABAD,3311,All
2024,8,BELGAUM,HYDERABAD,1876,1854,BELGAUM-HYDERABAD,3730,All
2024,9,BELGAUM,HYDERABAD,1804,1813,BELGAUM-HYDERABAD,3617,All
2024,10,BELGAUM,HYDERABAD,1865,1752,BELGAUM-HYDERABAD,3617,All
2024,11,BELGAUM,HYDERABAD,1996,2065,BELGAUM-HYDERABAD,4061,All
2024,12,BELGAUM,HYDERABAD,2091,2163,BELGAUM-HYDERABAD,4254,All
2025,1,BELGAUM,HYDERABAD,2049,1991,BELGAUM-HYDERABAD,4040,All
2025,2,BELGAUM,HYDERABAD,1868,1927,BELGAUM-HYDERABAD,3795,All
2025,3,BELGAUM,HYDERABAD,2015,2041,BELGAUM-HYDERABAD,4056,All
2020,1,BELGAUM,INDORE,226,213,BELGAUM-INDORE,439,All
2020,2,BELGAUM,INDORE,428,429,BELGAUM-INDORE,857,All
2020,3,BELGAUM,INDORE,331,342,BELGAUM-INDORE,673,All
2020,6,BELGAUM,INDORE,245,325,BELGAUM-INDORE,570,All
2020,7,BELGAUM,INDORE,311,305,BELGAUM-INDORE,616,All
2020,8,BELGAUM,INDORE,283,371,BELGAUM-INDORE,654,All
2020,9,BELGAUM,INDORE,453,512,BELGAUM-INDORE,965,All
2020,10,BELGAUM,INDORE,493,463,BELGAUM-INDORE,956,All
2020,11,BELGAUM,INDORE,499,492,BELGAUM-INDORE,991,All
2020,12,BELGAUM,INDORE,505,545,BELGAUM-INDORE,1050,All
2021,1,BELGAUM,INDORE,529,474,BELGAUM-INDORE,1003,All
2021,2,BELGAUM,INDORE,502,475,BELGAUM-INDORE,977,All
2021,3,BELGAUM,INDORE,445,451,BELGAUM-INDORE,896,All
2021,4,BELGAUM,INDORE,417,362,BELGAUM-INDORE,779,All
2021,6,BELGAUM,INDORE,380,426,BELGAUM-INDORE,806,All
2021,7,BELGAUM,INDORE,496,438,BELGAUM-INDORE,934,All
2021,8,BELGAUM,INDORE,516,526,BELGAUM-INDORE,1042,All
2021,9,BELGAUM,INDORE,531,540,BELGAUM-INDORE,1071,All
2021,10,BELGAUM,INDORE,531,524,BELGAUM-INDORE,1055,All
2021,11,BELGAUM,INDORE,551,522,BELGAUM-INDORE,1073,All
2021,12,BELGAUM,INDORE,471,496,BELGAUM-INDORE,967,All
2022,1,BELGAUM,INDORE,413,435,BELGAUM-INDORE,848,All
2022,2,BELGAUM,INDORE,453,453,BELGAUM-INDORE,906,All
2022,3,BELGAUM,INDORE,573,593,BELGAUM-INDORE,1166,All
2022,4,BELGAUM,INDORE,493,481,BELGAUM-INDORE,974,All
2022,5,BELGAUM,INDORE,563,580,BELGAUM-INDORE,1143,All
2022,6,BELGAUM,INDORE,373,329,BELGAUM-INDORE,702,All
2022,7,BELGAUM,INDORE,344,352,BELGAUM-INDORE,696,All
2022,8,BELGAUM,INDORE,316,339,BELGAUM-INDORE,655,All
2022,9,BELGAUM,INDORE,247,231,BELGAUM-INDORE,478,All
2022,10,BELGAUM,INDORE,314,296,BELGAUM-INDORE,610,All
2022,11,BELGAUM,INDORE,349,337,BELGAUM-INDORE,686,All
2022,12,BELGAUM,INDORE,327,323,BELGAUM-INDORE,650,All
2023,1,BELGAUM,INDORE,336,298,BELGAUM-INDORE,634,All
2023,2,BELGAUM,INDORE,362,296,BELGAUM-INDORE,658,All
2023,3,BELGAUM,INDORE,445,438,BELGAUM-INDORE,883,All
2023,4,BELGAUM,INDORE,454,429,BELGAUM-INDORE,883,All
2023,5,BELGAUM,INDORE,690,671,BELGAUM-INDORE,1361,All
2023,6,BELGAUM,INDORE,535,420,BELGAUM-INDORE,955,All
2023,7,BELGAUM,INDORE,550,478,BELGAUM-INDORE,1028,All
2023,8,BELGAUM,INDORE,482,380,BELGAUM-INDORE,862,All
2023,9,BELGAUM,INDORE,420,431,BELGAUM-INDORE,851,All
2023,10,BELGAUM,INDORE,480,430,BELGAUM-INDORE,910,All
2015,4,BELGAUM,JABALPUR,15,9,BELGAUM-JABALPUR,24,All
2015,5,BELGAUM,JABALPUR,6,13,BELGAUM-JABALPUR,19,All
2015,6,BELGAUM,JABALPUR,2,0,BELGAUM-JABALPUR,2,All
2016,3,BELGAUM,JABALPUR,2,17,BELGAUM-JABALPUR,19,All
2016,4,BELGAUM,JABALPUR,9,21,BELGAUM-JABALPUR,30,All
2016,5,BELGAUM,JABALPUR,41,49,BELGAUM-JABALPUR,90,All
2016,6,BELGAUM,JABALPUR,22,11,BELGAUM-JABALPUR,33,All
2016,7,BELGAUM,JABALPUR,9,9,BELGAUM-JABALPUR,18,All
2016,8,BELGAUM,JABALPUR,15,19,BELGAUM-JABALPUR,34,All
2016,9,BELGAUM,JABALPUR,16,19,BELGAUM-JABALPUR,35,All
2016,10,BELGAUM,JABALPUR,17,31,BELGAUM-JABALPUR,48,All
2016,11,BELGAUM,JABALPUR,7,11,BELGAUM-JABALPUR,18,All
2016,12,BELGAUM,JABALPUR,23,14,BELGAUM-JABALPUR,37,All
2017,1,BELGAUM,JABALPUR,13,17,BELGAUM-JABALPUR,30,All
2017,2,BELGAUM,JABALPUR,24,15,BELGAUM-JABALPUR,39,All
2017,3,BELGAUM,JABALPUR,27,42,BELGAUM-JABALPUR,69,All
2017,4,BELGAUM,JABALPUR,44,40,BELGAUM-JABALPUR,84,All
2017,5,BELGAUM,JABALPUR,26,23,BELGAUM-JABALPUR,49,All
2017,6,BELGAUM,JABALPUR,22,20,BELGAUM-JABALPUR,42,All
2017,7,BELGAUM,JABALPUR,20,30,BELGAUM-JABALPUR,50,All
2017,8,BELGAUM,JABALPUR,27,32,BELGAUM-JABALPUR,59,All
2017,9,BELGAUM,JABALPUR,23,13,BELGAUM-JABALPUR,36,All
2017,10,BELGAUM,JABALPUR,16,11,BELGAUM-JABALPUR,27,All
2017,11,BELGAUM,JABALPUR,10,5,BELGAUM-JABALPUR,15,All
2017,12,BELGAUM,JABALPUR,26,11,BELGAUM-JABALPUR,37,All
2018,1,BELGAUM,JABALPUR,16,4,BELGAUM-JABALPUR,20,All
2018,2,BELGAUM,JABALPUR,7,10,BELGAUM-JABALPUR,17,All
2018,3,BELGAUM,JABALPUR,5,5,BELGAUM-JABALPUR,10,All
2018,4,BELGAUM,JABALPUR,8,11,BELGAUM-JABALPUR,19,All
2018,5,BELGAUM,JABALPUR,4,5,BELGAUM-JABALPUR,9,All
2019,6,BELGAUM,JABALPUR,5,7,BELGAUM-JABALPUR,12,All
2019,7,BELGAUM,JABALPUR,32,23,BELGAUM-JABALPUR,55,All
2019,8,BELGAUM,JABALPUR,21,25,BELGAUM-JABALPUR,46,All
2019,9,BELGAUM,JABALPUR,22,10,BELGAUM-JABALPUR,32,All
2019,10,BELGAUM,JABALPUR,25,28,BELGAUM-JABALPUR,53,All
2019,11,BELGAUM,JABALPUR,48,42,BELGAUM-JABALPUR,90,All
2019,12,BELGAUM,JABALPUR,38,19,BELGAUM-JABALPUR,57,All
2020,1,BELGAUM,JABALPUR,43,33,BELGAUM-JABALPUR,76,All
2020,2,BELGAUM,JABALPUR,48,21,BELGAUM-JABALPUR,69,All
2020,3,BELGAUM,JABALPUR,41,18,BELGAUM-JABALPUR,59,All
2020,6,BELGAUM,JABALPUR,12,5,BELGAUM-JABALPUR,17,All
2020,7,BELGAUM,JABALPUR,34,48,BELGAUM-JABALPUR,82,All
2020,8,BELGAUM,JABALPUR,19,25,BELGAUM-JABALPUR,44,All
2023,5,BELGAUM,JAIPUR,340,364,BELGAUM-JAIPUR,704,All
2023,6,BELGAUM,JAIPUR,461,518,BELGAUM-JAIPUR,979,All
2023,7,BELGAUM,JAIPUR,450,510,BELGAUM-JAIPUR,960,All
2023,8,BELGAUM,JAIPUR,541,550,BELGAUM-JAIPUR,1091,All
2023,9,BELGAUM,JAIPUR,490,512,BELGAUM-JAIPUR,1002,All
2023,10,BELGAUM,JAIPUR,523,458,BELGAUM-JAIPUR,981,All
2023,11,BELGAUM,JAIPUR,599,612,BELGAUM-JAIPUR,1211,All
2023,12,BELGAUM,JAIPUR,603,623,BELGAUM-JAIPUR,1226,All
2024,1,BELGAUM,JAIPUR,667,615,BELGAUM-JAIPUR,1282,All
2024,2,BELGAUM,JAIPUR,597,571,BELGAUM-JAIPUR,1168,All
2024,3,BELGAUM,JAIPUR,536,469,BELGAUM-JAIPUR,1005,All
2024,4,BELGAUM,JAIPUR,620,533,BELGAUM-JAIPUR,1153,All
2024,6,BELGAUM,JAIPUR,539,544,BELGAUM-JAIPUR,1083,All
2024,7,BELGAUM,JAIPUR,637,605,BELGAUM-JAIPUR,1242,All
2024,8,BELGAUM,JAIPUR,571,535,BELGAUM-JAIPUR,1106,All
2024,9,BELGAUM,JAIPUR,563,505,BELGAUM-JAIPUR,1068,All
2024,10,BELGAUM,JAIPUR,643,558,BELGAUM-JAIPUR,1201,All
2024,11,BELGAUM,JAIPUR,486,523,BELGAUM-JAIPUR,1009,All
2024,12,BELGAUM,JAIPUR,638,639,BELGAUM-JAIPUR,1277,All
2025,1,BELGAUM,JAIPUR,553,526,BELGAUM-JAIPUR,1079,All
2025,2,BELGAUM,JAIPUR,559,471,BELGAUM-JAIPUR,1030,All
2025,3,BELGAUM,JAIPUR,599,576,BELGAUM-JAIPUR,1175,All
2021,2,BELGAUM,JODHPUR,273,284,BELGAUM-JODHPUR,557,All
2021,3,BELGAUM,JODHPUR,579,541,BELGAUM-JODHPUR,1120,All
2021,4,BELGAUM,JODHPUR,571,427,BELGAUM-JODHPUR,998,All
2021,6,BELGAUM,JODHPUR,494,558,BELGAUM-JODHPUR,1052,All
2021,7,BELGAUM,JODHPUR,551,549,BELGAUM-JODHPUR,1100,All
2021,8,BELGAUM,JODHPUR,642,561,BELGAUM-JODHPUR,1203,All
2021,9,BELGAUM,JODHPUR,588,526,BELGAUM-JODHPUR,1114,All
2021,10,BELGAUM,JODHPUR,538,503,BELGAUM-JODHPUR,1041,All
2021,11,BELGAUM,JODHPUR,526,476,BELGAUM-JODHPUR,1002,All
2021,12,BELGAUM,JODHPUR,596,572,BELGAUM-JODHPUR,1168,All
2022,1,BELGAUM,JODHPUR,581,550,BELGAUM-JODHPUR,1131,All
2022,2,BELGAUM,JODHPUR,538,506,BELGAUM-JODHPUR,1044,All
2022,3,BELGAUM,JODHPUR,577,516,BELGAUM-JODHPUR,1093,All
2022,4,BELGAUM,JODHPUR,560,510,BELGAUM-JODHPUR,1070,All
2022,5,BELGAUM,JODHPUR,598,597,BELGAUM-JODHPUR,1195,All
2022,6,BELGAUM,JODHPUR,521,502,BELGAUM-JODHPUR,1023,All
2022,7,BELGAUM,JODHPUR,453,413,BELGAUM-JODHPUR,866,All
2022,8,BELGAUM,JODHPUR,258,248,BELGAUM-JODHPUR,506,All
2022,9,BELGAUM,JODHPUR,410,388,BELGAUM-JODHPUR,798,All
2022,10,BELGAUM,JODHPUR,393,361,BELGAUM-JODHPUR,754,All
2022,11,BELGAUM,JODHPUR,434,406,BELGAUM-JODHPUR,840,All
2022,12,BELGAUM,JODHPUR,427,418,BELGAUM-JODHPUR,845,All
2023,1,BELGAUM,JODHPUR,302,270,BELGAUM-JODHPUR,572,All
2023,2,BELGAUM,JODHPUR,383,354,BELGAUM-JODHPUR,737,All
2023,3,BELGAUM,JODHPUR,504,437,BELGAUM-JODHPUR,941,All
2023,4,BELGAUM,JODHPUR,487,434,BELGAUM-JODHPUR,921,All
2023,5,BELGAUM,JODHPUR,531,597,BELGAUM-JODHPUR,1128,All
2023,6,BELGAUM,JODHPUR,491,540,BELGAUM-JODHPUR,1031,All
2023,7,BELGAUM,JODHPUR,512,482,BELGAUM-JODHPUR,994,All
2023,8,BELGAUM,JODHPUR,515,404,BELGAUM-JODHPUR,919,All
2023,9,BELGAUM,JODHPUR,534,512,BELGAUM-JODHPUR,1046,All
2023,10,BELGAUM,JODHPUR,533,510,BELGAUM-JODHPUR,1043,All
2023,11,BELGAUM,JODHPUR,764,710,BELGAUM-JODHPUR,1474,All
2023,12,BELGAUM,JODHPUR,812,874,BELGAUM-JODHPUR,1686,All
2024,1,BELGAUM,JODHPUR,827,791,BELGAUM-JODHPUR,1618,All
2024,2,BELGAUM,JODHPUR,820,754,BELGAUM-JODHPUR,1574,All
2024,3,BELGAUM,JODHPUR,781,670,BELGAUM-JODHPUR,1451,All
2024,4,BELGAUM,JODHPUR,801,683,BELGAUM-JODHPUR,1484,All
2024,6,BELGAUM,JODHPUR,753,687,BELGAUM-JODHPUR,1440,All
2024,7,BELGAUM,JODHPUR,487,387,BELGAUM-JODHPUR,874,All
2020,3,BELGAUM,KADAPA,616,546,BELGAUM-KADAPA,1162,All
2020,10,BELGAUM,KADAPA,405,349,BELGAUM-KADAPA,754,All
2020,11,BELGAUM,KADAPA,603,691,BELGAUM-KADAPA,1294,All
2020,12,BELGAUM,KADAPA,1326,1303,BELGAUM-KADAPA,2629,All
2021,1,BELGAUM,KADAPA,1643,1408,BELGAUM-KADAPA,3051,All
2021,2,BELGAUM,KADAPA,1492,1491,BELGAUM-KADAPA,2983,All
2021,3,BELGAUM,KADAPA,1450,1346,BELGAUM-KADAPA,2796,All
2021,4,BELGAUM,KADAPA,1136,1004,BELGAUM-KADAPA,2140,All
2021,6,BELGAUM,KADAPA,408,243,BELGAUM-KADAPA,651,All
2021,7,BELGAUM,KADAPA,589,378,BELGAUM-KADAPA,967,All
2021,8,BELGAUM,KADAPA,741,524,BELGAUM-KADAPA,1265,All
2021,9,BELGAUM,KADAPA,194,119,BELGAUM-KADAPA,313,All
2021,10,BELGAUM,KADAPA,551,385,BELGAUM-KADAPA,936,All
2021,11,BELGAUM,KADAPA,274,153,BELGAUM-KADAPA,427,All
2019,10,BELGAUM,MADURAI,0,11,BELGAUM-MADURAI,11,All
2019,11,BELGAUM,MADURAI,0,50,BELGAUM-MADURAI,50,All
2019,12,BELGAUM,MADURAI,0,36,BELGAUM-MADURAI,36,All
2020,1,BELGAUM,MADURAI,0,46,BELGAUM-MADURAI,46,All
2020,2,BELGAUM,MADURAI,0,47,BELGAUM-MADURAI,47,All
2020,3,BELGAUM,MADURAI,0,33,BELGAUM-MADURAI,33,All
2019,6,BELGAUM,MANGALORE,0,24,BELGAUM-MANGALORE,24,All
2019,7,BELGAUM,MANGALORE,0,72,BELGAUM-MANGALORE,72,All
2019,8,BELGAUM,MANGALORE,0,98,BELGAUM-MANGALORE,98,All
2019,9,BELGAUM,MANGALORE,0,84,BELGAUM-MANGALORE,84,All
2019,10,BELGAUM,MANGALORE,0,100,BELGAUM-MANGALORE,100,All
2019,11,BELGAUM,MANGALORE,0,124,BELGAUM-MANGALORE,124,All
2019,12,BELGAUM,MANGALORE,0,105,BELGAUM-MANGALORE,105,All
2020,1,BELGAUM,MANGALORE,0,82,BELGAUM-MANGALORE,82,All
2020,2,BELGAUM,MANGALORE,0,75,BELGAUM-MANGALORE,75,All
2020,3,BELGAUM,MANGALORE,0,29,BELGAUM-MANGALORE,29,All
2019,6,BELGAUM,MUMBAI,624,641,BELGAUM-MUMBAI,1265,All
2019,7,BELGAUM,MUMBAI,1951,2123,BELGAUM-MUMBAI,4074,All
2019,8,BELGAUM,MUMBAI,2385,2471,BELGAUM-MUMBAI,4856,All
2019,9,BELGAUM,MUMBAI,2693,2417,BELGAUM-MUMBAI,5110,All
2019,10,BELGAUM,MUMBAI,2686,2885,BELGAUM-MUMBAI,5571,All
2019,11,BELGAUM,MUMBAI,2986,2818,BELGAUM-MUMBAI,5804,All
2019,12,BELGAUM,MUMBAI,3188,3205,BELGAUM-MUMBAI,6393,All
2020,1,BELGAUM,MUMBAI,3127,2907,BELGAUM-MUMBAI,6034,All
2020,2,BELGAUM,MUMBAI,2719,2631,BELGAUM-MUMBAI,5350,All
2020,3,BELGAUM,MUMBAI,1431,1453,BELGAUM-MUMBAI,2884,All
2020,6,BELGAUM,MUMBAI,311,425,BELGAUM-MUMBAI,736,All
2020,7,BELGAUM,MUMBAI,967,1752,BELGAUM-MUMBAI,2719,All
2020,8,BELGAUM,MUMBAI,1220,1675,BELGAUM-MUMBAI,2895,All
2020,9,BELGAUM,MUMBAI,1572,1663,BELGAUM-MUMBAI,3235,All
2020,10,BELGAUM,MUMBAI,1679,1826,BELGAUM-MUMBAI,3505,All
2020,11,BELGAUM,MUMBAI,2160,2466,BELGAUM-MUMBAI,4626,All
2020,12,BELGAUM,MUMBAI,2718,3050,BELGAUM-MUMBAI,5768,All
2021,1,BELGAUM,MUMBAI,2681,2589,BELGAUM-MUMBAI,5270,All
2021,2,BELGAUM,MUMBAI,2448,2755,BELGAUM-MUMBAI,5203,All
2021,3,BELGAUM,MUMBAI,1961,2043,BELGAUM-MUMBAI,4004,All
2021,4,BELGAUM,MUMBAI,1507,1332,BELGAUM-MUMBAI,2839,All
2021,6,BELGAUM,MUMBAI,1922,1653,BELGAUM-MUMBAI,3575,All
2021,7,BELGAUM,MUMBAI,2067,2171,BELGAUM-MUMBAI,4238,All
2021,8,BELGAUM,MUMBAI,2031,1757,BELGAUM-MUMBAI,3788,All
2021,9,BELGAUM,MUMBAI,2202,2129,BELGAUM-MUMBAI,4331,All
2021,10,BELGAUM,MUMBAI,2713,2553,BELGAUM-MUMBAI,5266,All
2021,11,BELGAUM,MUMBAI,2929,2892,BELGAUM-MUMBAI,5821,All
2021,12,BELGAUM,MUMBAI,3025,3035,BELGAUM-MUMBAI,6060,All
2022,1,BELGAUM,MUMBAI,2125,1795,BELGAUM-MUMBAI,3920,All
2022,2,BELGAUM,MUMBAI,2688,2592,BELGAUM-MUMBAI,5280,All
2022,3,BELGAUM,MUMBAI,3192,3004,BELGAUM-MUMBAI,6196,All
2022,4,BELGAUM,MUMBAI,3219,3283,BELGAUM-MUMBAI,6502,All
2022,5,BELGAUM,MUMBAI,3241,3250,BELGAUM-MUMBAI,6491,All
2022,6,BELGAUM,MUMBAI,2914,2906,BELGAUM-MUMBAI,5820,All
2022,7,BELGAUM,MUMBAI,2518,2627,BELGAUM-MUMBAI,5145,All
2022,8,BELGAUM,MUMBAI,2580,2610,BELGAUM-MUMBAI,5190,All
2022,9,BELGAUM,MUMBAI,2119,1987,BELGAUM-MUMBAI,4106,All
2022,10,BELGAUM,MUMBAI,2760,2918,BELGAUM-MUMBAI,5678,All
2022,11,BELGAUM,MUMBAI,1028,1044,BELGAUM-MUMBAI,2072,All
2022,12,BELGAUM,MUMBAI,750,762,BELGAUM-MUMBAI,1512,All
2023,1,BELGAUM,MUMBAI,667,647,BELGAUM-MUMBAI,1314,All
2023,2,BELGAUM,MUMBAI,690,690,BELGAUM-MUMBAI,1380,All
2023,3,BELGAUM,MUMBAI,840,819,BELGAUM-MUMBAI,1659,All
2023,4,BELGAUM,MUMBAI,642,646,BELGAUM-MUMBAI,1288,All
2023,5,BELGAUM,MUMBAI,710,726,BELGAUM-MUMBAI,1436,All
2023,6,BELGAUM,MUMBAI,680,654,BELGAUM-MUMBAI,1334,All
2023,7,BELGAUM,MUMBAI,710,680,BELGAUM-MUMBAI,1390,All
2023,8,BELGAUM,MUMBAI,780,780,BELGAUM-MUMBAI,1560,All
2023,9,BELGAUM,MUMBAI,678,580,BELGAUM-MUMBAI,1258,All
2023,10,BELGAUM,MUMBAI,1200,1120,BELGAUM-MUMBAI,2320,All
2023,11,BELGAUM,MUMBAI,1210,1340,BELGAUM-MUMBAI,2550,All
2023,12,BELGAUM,MUMBAI,1245,1389,BELGAUM-MUMBAI,2634,All
2024,1,BELGAUM,MUMBAI,1036,1050,BELGAUM-MUMBAI,2086,All
2024,2,BELGAUM,MUMBAI,1339,1389,BELGAUM-MUMBAI,2728,All
2024,3,BELGAUM,MUMBAI,1244,1296,BELGAUM-MUMBAI,2540,All
2024,4,BELGAUM,MUMBAI,1493,1510,BELGAUM-MUMBAI,3003,All
2024,6,BELGAUM,MUMBAI,1347,1535,BELGAUM-MUMBAI,2882,All
2024,7,BELGAUM,MUMBAI,1093,1059,BELGAUM-MUMBAI,2152,All
2024,8,BELGAUM,MUMBAI,1269,1209,BELGAUM-MUMBAI,2478,All
2024,9,BELGAUM,MUMBAI,1219,1323,BELGAUM-MUMBAI,2542,All
2024,10,BELGAUM,MUMBAI,1244,1356,BELGAUM-MUMBAI,2600,All
2024,11,BELGAUM,MUMBAI,1218,1327,BELGAUM-MUMBAI,2545,All
2024,12,BELGAUM,MUMBAI,1175,1421,BELGAUM-MUMBAI,2596,All
2025,1,BELGAUM,MUMBAI,1248,1327,BELGAUM-MUMBAI,2575,All
2025,2,BELGAUM,MUMBAI,1160,1184,BELGAUM-MUMBAI,2344,All
2025,3,BELGAUM,MUMBAI,1180,1252,BELGAUM-MUMBAI,2432,All
2020,1,BELGAUM,MYSORE,774,841,BELGAUM-MYSORE,1615,All
2020,2,BELGAUM,MYSORE,1789,1841,BELGAUM-MYSORE,3630,All
2020,3,BELGAUM,MYSORE,1092,1177,BELGAUM-MYSORE,2269,All
2020,5,BELGAUM,MYSORE,26,15,BELGAUM-MYSORE,41,All
2020,6,BELGAUM,MYSORE,313,321,BELGAUM-MYSORE,634,All
2020,7,BELGAUM,MYSORE,194,184,BELGAUM-MYSORE,378,All
2020,8,BELGAUM,MYSORE,50,59,BELGAUM-MYSORE,109,All
2020,9,BELGAUM,MYSORE,108,122,BELGAUM-MYSORE,230,All
2020,10,BELGAUM,MYSORE,831,792,BELGAUM-MYSORE,1623,All
2020,11,BELGAUM,MYSORE,505,540,BELGAUM-MYSORE,1045,All
2020,12,BELGAUM,MYSORE,1082,1107,BELGAUM-MYSORE,2189,All
2021,1,BELGAUM,MYSORE,1136,1102,BELGAUM-MYSORE,2238,All
2021,2,BELGAUM,MYSORE,1490,1367,BELGAUM-MYSORE,2857,All
2021,3,BELGAUM,MYSORE,1202,1082,BELGAUM-MYSORE,2284,All
2021,4,BELGAUM,MYSORE,763,932,BELGAUM-MYSORE,1695,All
2021,6,BELGAUM,MYSORE,20,19,BELGAUM-MYSORE,39,All
2021,7,BELGAUM,MYSORE,469,303,BELGAUM-MYSORE,772,All
2021,8,BELGAUM,MYSORE,430,267,BELGAUM-MYSORE,697,All
2021,9,BELGAUM,MYSORE,141,101,BELGAUM-MYSORE,242,All
2021,10,BELGAUM,MYSORE,188,114,BELGAUM-MYSORE,302,All
2021,11,BELGAUM,MYSORE,85,64,BELGAUM-MYSORE,149,All
2022,4,BELGAUM,NAGPUR,212,204,BELGAUM-NAGPUR,416,All
2022,5,BELGAUM,NAGPUR,351,380,BELGAUM-NAGPUR,731,All
2022,6,BELGAUM,NAGPUR,250,224,BELGAUM-NAGPUR,474,All
2022,7,BELGAUM,NAGPUR,243,257,BELGAUM-NAGPUR,500,All
2022,8,BELGAUM,NAGPUR,239,236,BELGAUM-NAGPUR,475,All
2022,9,BELGAUM,NAGPUR,197,193,BELGAUM-NAGPUR,390,All
2022,10,BELGAUM,NAGPUR,270,248,BELGAUM-NAGPUR,518,All
2022,11,BELGAUM,NAGPUR,208,253,BELGAUM-NAGPUR,461,All
2022,12,BELGAUM,NAGPUR,279,310,BELGAUM-NAGPUR,589,All
2023,1,BELGAUM,NAGPUR,189,212,BELGAUM-NAGPUR,401,All
2023,2,BELGAUM,NAGPUR,190,200,BELGAUM-NAGPUR,390,All
2023,3,BELGAUM,NAGPUR,228,239,BELGAUM-NAGPUR,467,All
2023,4,BELGAUM,NAGPUR,389,396,BELGAUM-NAGPUR,785,All
2023,5,BELGAUM,NAGPUR,550,514,BELGAUM-NAGPUR,1064,All
2023,6,BELGAUM,NAGPUR,510,383,BELGAUM-NAGPUR,893,All
2023,7,BELGAUM,NAGPUR,425,410,BELGAUM-NAGPUR,835,All
2023,8,BELGAUM,NAGPUR,610,580,BELGAUM-NAGPUR,1190,All
2023,9,BELGAUM,NAGPUR,410,380,BELGAUM-NAGPUR,790,All
2023,10,BELGAUM,NAGPUR,490,510,BELGAUM-NAGPUR,1000,All
2023,11,BELGAUM,NAGPUR,519,473,BELGAUM-NAGPUR,992,All
2023,12,BELGAUM,NAGPUR,473,496,BELGAUM-NAGPUR,969,All
2024,1,BELGAUM,NAGPUR,552,567,BELGAUM-NAGPUR,1119,All
2024,2,BELGAUM,NAGPUR,467,485,BELGAUM-NAGPUR,952,All
2024,3,BELGAUM,NAGPUR,381,435,BELGAUM-NAGPUR,816,All
2024,4,BELGAUM,NAGPUR,553,592,BELGAUM-NAGPUR,1145,All
2024,6,BELGAUM,NAGPUR,602,621,BELGAUM-NAGPUR,1223,All
2024,7,BELGAUM,NAGPUR,487,492,BELGAUM-NAGPUR,979,All
2024,8,BELGAUM,NAGPUR,573,500,BELGAUM-NAGPUR,1073,All
2024,9,BELGAUM,NAGPUR,455,420,BELGAUM-NAGPUR,875,All
2024,10,BELGAUM,NAGPUR,440,452,BELGAUM-NAGPUR,892,All
2024,11,BELGAUM,NAGPUR,388,434,BELGAUM-NAGPUR,822,All
2024,12,BELGAUM,NAGPUR,424,444,BELGAUM-NAGPUR,868,All
2025,1,BELGAUM,NAGPUR,465,421,BELGAUM-NAGPUR,886,All
2025,2,BELGAUM,NAGPUR,567,539,BELGAUM-NAGPUR,1106,All
2025,3,BELGAUM,NAGPUR,423,342,BELGAUM-NAGPUR,765,All
2021,1,BELGAUM,NASIK,77,78,BELGAUM-NASIK,155,All
2021,2,BELGAUM,NASIK,405,402,BELGAUM-NASIK,807,All
2021,3,BELGAUM,NASIK,215,157,BELGAUM-NASIK,372,All
2021,4,BELGAUM,NASIK,79,70,BELGAUM-NASIK,149,All
2021,7,BELGAUM,NASIK,290,291,BELGAUM-NASIK,581,All
2021,8,BELGAUM,NASIK,372,354,BELGAUM-NASIK,726,All
2021,9,BELGAUM,NASIK,296,280,BELGAUM-NASIK,576,All
2021,10,BELGAUM,NASIK,332,311,BELGAUM-NASIK,643,All
2021,11,BELGAUM,NASIK,606,517,BELGAUM-NASIK,1123,All
2021,12,BELGAUM,NASIK,508,453,BELGAUM-NASIK,961,All
2022,1,BELGAUM,NASIK,280,225,BELGAUM-NASIK,505,All
2022,2,BELGAUM,NASIK,324,373,BELGAUM-NASIK,697,All
2022,3,BELGAUM,NASIK,383,391,BELGAUM-NASIK,774,All
2022,4,BELGAUM,NASIK,554,481,BELGAUM-NASIK,1035,All
2022,5,BELGAUM,NASIK,473,489,BELGAUM-NASIK,962,All
2022,6,BELGAUM,NASIK,543,474,BELGAUM-NASIK,1017,All
2022,7,BELGAUM,NASIK,177,193,BELGAUM-NASIK,370,All
2022,8,BELGAUM,NASIK,356,308,BELGAUM-NASIK,664,All
2022,9,BELGAUM,NASIK,441,368,BELGAUM-NASIK,809,All
2022,10,BELGAUM,NASIK,356,399,BELGAUM-NASIK,755,All
2019,5,BELGAUM,PUNE,576,549,BELGAUM-PUNE,1125,All
2019,6,BELGAUM,PUNE,1082,984,BELGAUM-PUNE,2066,All
2019,7,BELGAUM,PUNE,830,781,BELGAUM-PUNE,1611,All
2019,8,BELGAUM,PUNE,912,946,BELGAUM-PUNE,1858,All
2019,9,BELGAUM,PUNE,986,843,BELGAUM-PUNE,1829,All
2019,10,BELGAUM,PUNE,1050,1029,BELGAUM-PUNE,2079,All
2019,11,BELGAUM,PUNE,968,852,BELGAUM-PUNE,1820,All
2019,12,BELGAUM,PUNE,1155,1148,BELGAUM-PUNE,2303,All
2020,1,BELGAUM,PUNE,1140,1104,BELGAUM-PUNE,2244,All
2020,2,BELGAUM,PUNE,1047,1016,BELGAUM-PUNE,2063,All
2020,3,BELGAUM,PUNE,523,514,BELGAUM-PUNE,1037,All
2020,6,BELGAUM,PUNE,613,682,BELGAUM-PUNE,1295,All
2020,7,BELGAUM,PUNE,428,705,BELGAUM-PUNE,1133,All
2020,8,BELGAUM,PUNE,236,265,BELGAUM-PUNE,501,All
2020,9,BELGAUM,PUNE,584,567,BELGAUM-PUNE,1151,All
2020,10,BELGAUM,PUNE,520,495,BELGAUM-PUNE,1015,All
2020,11,BELGAUM,PUNE,662,674,BELGAUM-PUNE,1336,All
2020,12,BELGAUM,PUNE,731,735,BELGAUM-PUNE,1466,All
2021,1,BELGAUM,PUNE,758,696,BELGAUM-PUNE,1454,All
2021,2,BELGAUM,PUNE,87,99,BELGAUM-PUNE,186,All
2021,3,BELGAUM,PUNE,57,54,BELGAUM-PUNE,111,All
2021,4,BELGAUM,PUNE,166,120,BELGAUM-PUNE,286,All
2021,7,BELGAUM,PUNE,466,465,BELGAUM-PUNE,931,All
2021,8,BELGAUM,PUNE,692,639,BELGAUM-PUNE,1331,All
2021,9,BELGAUM,PUNE,702,746,BELGAUM-PUNE,1448,All
2021,10,BELGAUM,PUNE,458,393,BELGAUM-PUNE,851,All
2021,11,BELGAUM,PUNE,894,871,BELGAUM-PUNE,1765,All
2021,12,BELGAUM,PUNE,731,761,BELGAUM-PUNE,1492,All
2022,1,BELGAUM,PUNE,577,409,BELGAUM-PUNE,986,All
2022,2,BELGAUM,PUNE,734,596,BELGAUM-PUNE,1330,All
2022,3,BELGAUM,PUNE,934,828,BELGAUM-PUNE,1762,All
2022,4,BELGAUM,PUNE,894,871,BELGAUM-PUNE,1765,All
2022,5,BELGAUM,PUNE,731,761,BELGAUM-PUNE,1492,All
2022,6,BELGAUM,PUNE,894,871,BELGAUM-PUNE,1765,All
2022,7,BELGAUM,PUNE,734,596,BELGAUM-PUNE,1330,All
2022,8,BELGAUM,PUNE,731,761,BELGAUM-PUNE,1492,All
2022,9,BELGAUM,PUNE,894,871,BELGAUM-PUNE,1765,All
2022,10,BELGAUM,PUNE,624,686,BELGAUM-PUNE,1310,All
2020,12,BELGAUM,SURAT,115,188,BELGAUM-SURAT,303,All
2021,1,BELGAUM,SURAT,423,372,BELGAUM-SURAT,795,All
2021,2,BELGAUM,SURAT,452,419,BELGAUM-SURAT,871,All
2021,3,BELGAUM,SURAT,502,431,BELGAUM-SURAT,933,All
2021,4,BELGAUM,SURAT,352,288,BELGAUM-SURAT,640,All
2021,6,BELGAUM,SURAT,369,322,BELGAUM-SURAT,691,All
2021,7,BELGAUM,SURAT,383,392,BELGAUM-SURAT,775,All
2021,8,BELGAUM,SURAT,444,419,BELGAUM-SURAT,863,All
2021,9,BELGAUM,SURAT,496,446,BELGAUM-SURAT,942,All
2021,10,BELGAUM,SURAT,561,511,BELGAUM-SURAT,1072,All
2021,11,BELGAUM,SURAT,493,466,BELGAUM-SURAT,959,All
2021,12,BELGAUM,SURAT,509,515,BELGAUM-SURAT,1024,All
2022,1,BELGAUM,SURAT,369,360,BELGAUM-SURAT,729,All
2022,2,BELGAUM,SURAT,481,467,BELGAUM-SURAT,948,All
2022,3,BELGAUM,SURAT,530,500,BELGAUM-SURAT,1030,All
2022,4,BELGAUM,SURAT,479,442,BELGAUM-SURAT,921,All
2022,5,BELGAUM,SURAT,501,543,BELGAUM-SURAT,1044,All
2022,6,BELGAUM,SURAT,496,429,BELGAUM-SURAT,925,All
2022,7,BELGAUM,SURAT,418,352,BELGAUM-SURAT,770,All
2022,8,BELGAUM,SURAT,404,367,BELGAUM-SURAT,771,All
2022,9,BELGAUM,SURAT,329,281,BELGAUM-SURAT,610,All
2022,10,BELGAUM,SURAT,293,289,BELGAUM-SURAT,582,All
2022,11,BELGAUM,SURAT,368,330,BELGAUM-SURAT,698,All
2022,12,BELGAUM,SURAT,356,344,BELGAUM-SURAT,700,All
2023,1,BELGAUM,SURAT,298,309,BELGAUM-SURAT,607,All
2023,2,BELGAUM,SURAT,348,320,BELGAUM-SURAT,668,All
2023,3,BELGAUM,SURAT,533,468,BELGAUM-SURAT,1001,All
2023,4,BELGAUM,SURAT,594,497,BELGAUM-SURAT,1091,All
2023,5,BELGAUM,SURAT,711,700,BELGAUM-SURAT,1411,All
2023,6,BELGAUM,SURAT,640,670,BELGAUM-SURAT,1310,All
2023,7,BELGAUM,SURAT,789,650,BELGAUM-SURAT,1439,All
2023,8,BELGAUM,SURAT,633,654,BELGAUM-SURAT,1287,All
2023,9,BELGAUM,SURAT,690,712,BELGAUM-SURAT,1402,All
2023,10,BELGAUM,SURAT,790,769,BELGAUM-SURAT,1559,All
2023,11,BELGAUM,SURAT,610,649,BELGAUM-SURAT,1259,All
2023,12,BELGAUM,SURAT,786,764,BELGAUM-SURAT,1550,All
2024,1,BELGAUM,SURAT,721,660,BELGAUM-SURAT,1381,All
2024,2,BELGAUM,SURAT,712,679,BELGAUM-SURAT,1391,All
2024,3,BELGAUM,SURAT,717,637,BELGAUM-SURAT,1354,All
2024,4,BELGAUM,SURAT,775,619,BELGAUM-SURAT,1394,All
2024,6,BELGAUM,SURAT,243,204,BELGAUM-SURAT,447,All
2020,1,BELGAUM,TIRUPATI,912,816,BELGAUM-TIRUPATI,1728,All
2020,2,BELGAUM,TIRUPATI,1793,1779,BELGAUM-TIRUPATI,3572,All
2020,3,BELGAUM,TIRUPATI,1149,1178,BELGAUM-TIRUPATI,2327,All
2020,10,BELGAUM,TIRUPATI,303,243,BELGAUM-TIRUPATI,546,All
2020,11,BELGAUM,TIRUPATI,468,494,BELGAUM-TIRUPATI,962,All
2020,12,BELGAUM,TIRUPATI,645,712,BELGAUM-TIRUPATI,1357,All
2021,1,BELGAUM,TIRUPATI,848,738,BELGAUM-TIRUPATI,1586,All
2021,2,BELGAUM,TIRUPATI,932,845,BELGAUM-TIRUPATI,1777,All
2021,3,BELGAUM,TIRUPATI,674,661,BELGAUM-TIRUPATI,1335,All
2021,4,BELGAUM,TIRUPATI,355,350,BELGAUM-TIRUPATI,705,All
2021,6,BELGAUM,TIRUPATI,264,658,BELGAUM-TIRUPATI,922,All
2021,7,BELGAUM,TIRUPATI,401,451,BELGAUM-TIRUPATI,852,All
2021,8,BELGAUM,TIRUPATI,400,439,BELGAUM-TIRUPATI,839,All
2021,9,BELGAUM,TIRUPATI,105,132,BELGAUM-TIRUPATI,237,All
2021,10,BELGAUM,TIRUPATI,411,402,BELGAUM-TIRUPATI,813,All
2021,11,BELGAUM,TIRUPATI,406,346,BELGAUM-TIRUPATI,752,All
2021,12,BELGAUM,TIRUPATI,56,68,BELGAUM-TIRUPATI,124,All
2022,1,BELGAUM,TIRUPATI,75,33,BELGAUM-TIRUPATI,108,All
2022,2,BELGAUM,TIRUPATI,162,135,BELGAUM-TIRUPATI,297,All
2022,3,BELGAUM,TIRUPATI,361,315,BELGAUM-TIRUPATI,676,All
2022,4,BELGAUM,TIRUPATI,333,300,BELGAUM-TIRUPATI,633,All
2022,5,BELGAUM,TIRUPATI,587,504,BELGAUM-TIRUPATI,1091,All
2022,6,BELGAUM,TIRUPATI,433,309,BELGAUM-TIRUPATI,742,All
2022,7,BELGAUM,TIRUPATI,234,251,BELGAUM-TIRUPATI,485,All
2022,8,BELGAUM,TIRUPATI,302,243,BELGAUM-TIRUPATI,545,All
2022,9,BELGAUM,TIRUPATI,306,229,BELGAUM-TIRUPATI,535,All
2022,10,BELGAUM,TIRUPATI,291,234,BELGAUM-TIRUPATI,525,All
2022,11,BELGAUM,TIRUPATI,309,347,BELGAUM-TIRUPATI,656,All
2022,12,BELGAUM,TIRUPATI,347,357,BELGAUM-TIRUPATI,704,All
2023,1,BELGAUM,TIRUPATI,269,216,BELGAUM-TIRUPATI,485,All
2023,2,BELGAUM,TIRUPATI,263,237,BELGAUM-TIRUPATI,500,All
2023,3,BELGAUM,TIRUPATI,345,324,BELGAUM-TIRUPATI,669,All
2023,4,BELGAUM,TIRUPATI,481,498,BELGAUM-TIRUPATI,979,All
2023,5,BELGAUM,TIRUPATI,610,708,BELGAUM-TIRUPATI,1318,All
2023,6,BELGAUM,TIRUPATI,551,470,BELGAUM-TIRUPATI,1021,All
2023,7,BELGAUM,TIRUPATI,610,712,BELGAUM-TIRUPATI,1322,All
2023,8,BELGAUM,TIRUPATI,617,712,BELGAUM-TIRUPATI,1329,All
2023,9,BELGAUM,TIRUPATI,619,520,BELGAUM-TIRUPATI,1139,All
2023,10,BELGAUM,TIRUPATI,710,590,BELGAUM-TIRUPATI,1300,All
2023,11,BELGAUM,TIRUPATI,821,910,BELGAUM-TIRUPATI,1731,All
2023,12,BELGAUM,TIRUPATI,923,1089,BELGAUM-TIRUPATI,2012,All
2024,1,BELGAUM,TIRUPATI,1031,1037,BELGAUM-TIRUPATI,2068,All
2024,2,BELGAUM,TIRUPATI,687,823,BELGAUM-TIRUPATI,1510,All
2024,3,BELGAUM,TIRUPATI,631,542,BELGAUM-TIRUPATI,1173,All
2024,4,BELGAUM,TIRUPATI,566,504,BELGAUM-TIRUPATI,1070,All
2024,6,BELGAUM,TIRUPATI,609,545,BELGAUM-TIRUPATI,1154,All
2024,7,BELGAUM,TIRUPATI,451,450,BELGAUM-TIRUPATI,901,All
2024,8,BELGAUM,TIRUPATI,573,573,BELGAUM-TIRUPATI,1146,All
2024,9,BELGAUM,TIRUPATI,570,527,BELGAUM-TIRUPATI,1097,All
2024,10,BELGAUM,TIRUPATI,524,625,BELGAUM-TIRUPATI,1149,All
2024,11,BELGAUM,TIRUPATI,362,268,BELGAUM-TIRUPATI,630,All
2024,12,BELGAUM,TIRUPATI,50,83,BELGAUM-TIRUPATI,133,All
2025,1,BELGAUM,TIRUPATI,27,27,BELGAUM-TIRUPATI,54,All
2015,4,BENGALURU,AGARTALA,777,1080,AGARTALA-BENGALURU,1857,All
2015,5,BENGALURU,AGARTALA,1209,1069,AGARTALA-BENGALURU,2278,All
2015,6,BENGALURU,AGARTALA,1080,921,AGARTALA-BENGALURU,2001,All
2015,7,BENGALURU,AGARTALA,1175,1854,AGARTALA-BENGALURU,3029,All
2015,8,BENGALURU,AGARTALA,1385,1460,AGARTALA-BENGALURU,2845,All
2015,9,BENGALURU,AGARTALA,933,1130,AGARTALA-BENGALURU,2063,All
2015,9,BENGALURU,AGARTALA,341,509,AGARTALA-BENGALURU,850,All
2015,10,BENGALURU,AGARTALA,1065,979,AGARTALA-BENGALURU,2044,All
2015,11,BENGALURU,AGARTALA,583,985,AGARTALA-BENGALURU,1568,All
2015,12,BENGALURU,AGARTALA,417,690,AGARTALA-BENGALURU,1107,All
2016,1,BENGALURU,AGARTALA,364,618,AGARTALA-BENGALURU,982,All
2016,2,BENGALURU,AGARTALA,489,660,AGARTALA-BENGALURU,1149,All
2016,3,BENGALURU,AGARTALA,812,759,AGARTALA-BENGALURU,1571,All
2016,4,BENGALURU,AGARTALA,676,897,AGARTALA-BENGALURU,1573,All
2016,5,BENGALURU,AGARTALA,702,779,AGARTALA-BENGALURU,1481,All
2016,6,BENGALURU,AGARTALA,765,831,AGARTALA-BENGALURU,1596,All
2016,7,BENGALURU,AGARTALA,368,496,AGARTALA-BENGALURU,864,All
2016,8,BENGALURU,AGARTALA,549,498,AGARTALA-BENGALURU,1047,All
2016,9,BENGALURU,AGARTALA,330,295,AGARTALA-BENGALURU,625,All
2016,10,BENGALURU,AGARTALA,622,499,AGARTALA-BENGALURU,1121,All
2016,11,BENGALURU,AGARTALA,410,711,AGARTALA-BENGALURU,1121,All
2016,12,BENGALURU,AGARTALA,716,722,AGARTALA-BENGALURU,1438,All
2017,1,BENGALURU,AGARTALA,788,656,AGARTALA-BENGALURU,1444,All
2017,2,BENGALURU,AGARTALA,645,651,AGARTALA-BENGALURU,1296,All
2017,3,BENGALURU,AGARTALA,1050,767,AGARTALA-BENGALURU,1817,All
2017,4,BENGALURU,AGARTALA,918,901,AGARTALA-BENGALURU,1819,All
2017,5,BENGALURU,AGARTALA,497,796,AGARTALA-BENGALURU,1293,All
2017,6,BENGALURU,AGARTALA,848,594,AGARTALA-BENGALURU,1442,All
2017,7,BENGALURU,AGARTALA,472,396,AGARTALA-BENGALURU,868,All
2017,8,BENGALURU,AGARTALA,607,639,AGARTALA-BENGALURU,1246,All
2017,9,BENGALURU,AGARTALA,825,483,AGARTALA-BENGALURU,1308,All
2017,10,BENGALURU,AGARTALA,474,901,AGARTALA-BENGALURU,1375,All
2017,11,BENGALURU,AGARTALA,339,288,AGARTALA-BENGALURU,627,All
2017,12,BENGALURU,AGARTALA,310,448,AGARTALA-BENGALURU,758,All
2018,1,BENGALURU,AGARTALA,710,1007,AGARTALA-BENGALURU,1717,All
2018,2,BENGALURU,AGARTALA,977,1480,AGARTALA-BENGALURU,2457,All
2018,3,BENGALURU,AGARTALA,1854,803,AGARTALA-BENGALURU,2657,All
2018,4,BENGALURU,AGARTALA,5263,464,AGARTALA-BENGALURU,5727,All
2018,5,BENGALURU,AGARTALA,3929,884,AGARTALA-BENGALURU,4813,All
2018,6,BENGALURU,AGARTALA,4123,1062,AGARTALA-BENGALURU,5185,All
2018,7,BENGALURU,AGARTALA,1232,450,AGARTALA-BENGALURU,1682,All
2018,8,BENGALURU,AGARTALA,2029,680,AGARTALA-BENGALURU,2709,All
2018,9,BENGALURU,AGARTALA,3181,517,AGARTALA-BENGALURU,3698,All
2018,10,BENGALURU,AGARTALA,4875,1707,AGARTALA-BENGALURU,6582,All
2018,11,BENGALURU,AGARTALA,1362,1565,AGARTALA-BENGALURU,2927,All
2018,12,BENGALURU,AGARTALA,4622,5369,AGARTALA-BENGALURU,9991,All
2019,1,BENGALURU,AGARTALA,4285,4737,AGARTALA-BENGALURU,9022,All
2019,2,BENGALURU,AGARTALA,3882,4100,AGARTALA-BENGALURU,7982,All
2019,3,BENGALURU,AGARTALA,3982,3933,AGARTALA-BENGALURU,7915,All
2019,4,BENGALURU,AGARTALA,3408,3332,AGARTALA-BENGALURU,6740,All
2018,11,BENGALURU,ALLAHABAD,2038,2385,ALLAHABAD-BENGALURU,4423,All
2018,12,BENGALURU,ALLAHABAD,4550,4585,ALLAHABAD-BENGALURU,9135,All
2019,1,BENGALURU,ALLAHABAD,4223,4055,ALLAHABAD-BENGALURU,8278,All
2019,2,BENGALURU,ALLAHABAD,4019,3907,ALLAHABAD-BENGALURU,7926,All
2019,3,BENGALURU,ALLAHABAD,4140,4241,ALLAHABAD-BENGALURU,8381,All
2019,4,BENGALURU,ALLAHABAD,4773,3698,ALLAHABAD-BENGALURU,8471,All
2024,1,BENGALURU,Ayodhya International Airport ,1146,916,Ayodhya International Airport -BENGALURU,2062,All
2024,2,BENGALURU,Ayodhya International Airport ,5346,4974,Ayodhya International Airport -BENGALURU,10320,All
2024,3,BENGALURU,Ayodhya International Airport ,5535,4775,Ayodhya International Airport -BENGALURU,10310,All
2024,4,BENGALURU,Ayodhya International Airport ,2676,2345,Ayodhya International Airport -BENGALURU,5021,All
2024,6,BENGALURU,Ayodhya International Airport ,7191,7810,Ayodhya International Airport -BENGALURU,15001,All
2024,7,BENGALURU,Ayodhya International Airport ,6771,7192,Ayodhya International Airport -BENGALURU,13963,All
2024,8,BENGALURU,Ayodhya International Airport ,7659,7387,Ayodhya International Airport -BENGALURU,15046,All
2024,9,BENGALURU,Ayodhya International Airport ,7340,6190,Ayodhya International Airport -BENGALURU,13530,All
2024,10,BENGALURU,Ayodhya International Airport ,8280,6010,Ayodhya International Airport -BENGALURU,14290,All
2024,11,BENGALURU,Ayodhya International Airport ,9321,9547,Ayodhya International Airport -BENGALURU,18868,All
2024,12,BENGALURU,Ayodhya International Airport ,9933,10914,Ayodhya International Airport -BENGALURU,20847,All
2025,1,BENGALURU,Ayodhya International Airport ,14524,14691,Ayodhya International Airport -BENGALURU,29215,All
2025,2,BENGALURU,Ayodhya International Airport ,14264,14122,Ayodhya International Airport -BENGALURU,28386,All
2025,3,BENGALURU,Ayodhya International Airport ,15136,15170,Ayodhya International Airport -BENGALURU,30306,All
2015,4,BENGALURU,BAGDOGRA,3796,3108,BAGDOGRA-BENGALURU,6904,All
2015,5,BENGALURU,BAGDOGRA,2865,3020,BAGDOGRA-BENGALURU,5885,All
2015,6,BENGALURU,BAGDOGRA,2486,2454,BAGDOGRA-BENGALURU,4940,All
2015,7,BENGALURU,BAGDOGRA,2694,2746,BAGDOGRA-BENGALURU,5440,All
2015,8,BENGALURU,BAGDOGRA,2417,2708,BAGDOGRA-BENGALURU,5125,All
2015,9,BENGALURU,BAGDOGRA,2725,2250,BAGDOGRA-BENGALURU,4975,All
2015,10,BENGALURU,BAGDOGRA,3059,2343,BAGDOGRA-BENGALURU,5402,All
2015,11,BENGALURU,BAGDOGRA,2718,2988,BAGDOGRA-BENGALURU,5706,All
2015,12,BENGALURU,BAGDOGRA,2964,2839,BAGDOGRA-BENGALURU,5803,All
2016,1,BENGALURU,BAGDOGRA,2689,2645,BAGDOGRA-BENGALURU,5334,All
2016,2,BENGALURU,BAGDOGRA,2436,1850,BAGDOGRA-BENGALURU,4286,All
2016,3,BENGALURU,BAGDOGRA,2081,1442,BAGDOGRA-BENGALURU,3523,All
2016,4,BENGALURU,BAGDOGRA,2806,2244,BAGDOGRA-BENGALURU,5050,All
2016,5,BENGALURU,BAGDOGRA,1338,1437,BAGDOGRA-BENGALURU,2775,All
2016,6,BENGALURU,BAGDOGRA,1773,1304,BAGDOGRA-BENGALURU,3077,All
2016,7,BENGALURU,BAGDOGRA,1453,1508,BAGDOGRA-BENGALURU,2961,All
2016,8,BENGALURU,BAGDOGRA,1012,978,BAGDOGRA-BENGALURU,1990,All
2016,9,BENGALURU,BAGDOGRA,830,562,BAGDOGRA-BENGALURU,1392,All
2016,10,BENGALURU,BAGDOGRA,507,341,BAGDOGRA-BENGALURU,848,All
2016,11,BENGALURU,BAGDOGRA,1251,1053,BAGDOGRA-BENGALURU,2304,All
2016,12,BENGALURU,BAGDOGRA,2601,1742,BAGDOGRA-BENGALURU,4343,All
2017,1,BENGALURU,BAGDOGRA,3684,2013,BAGDOGRA-BENGALURU,5697,All
2017,2,BENGALURU,BAGDOGRA,2075,1661,BAGDOGRA-BENGALURU,3736,All
2017,3,BENGALURU,BAGDOGRA,2247,1457,BAGDOGRA-BENGALURU,3704,All
2017,4,BENGALURU,BAGDOGRA,2401,1322,BAGDOGRA-BENGALURU,3723,All
2017,5,BENGALURU,BAGDOGRA,3052,3310,BAGDOGRA-BENGALURU,6362,All
2017,6,BENGALURU,BAGDOGRA,5197,4949,BAGDOGRA-BENGALURU,10146,All
2017,7,BENGALURU,BAGDOGRA,1090,1602,BAGDOGRA-BENGALURU,2692,All
2017,8,BENGALURU,BAGDOGRA,838,1216,BAGDOGRA-BENGALURU,2054,All
2017,9,BENGALURU,BAGDOGRA,1272,897,BAGDOGRA-BENGALURU,2169,All
2017,10,BENGALURU,BAGDOGRA,1231,1029,BAGDOGRA-BENGALURU,2260,All
2017,11,BENGALURU,BAGDOGRA,1700,1833,BAGDOGRA-BENGALURU,3533,All
2017,12,BENGALURU,BAGDOGRA,6880,6329,BAGDOGRA-BENGALURU,13209,All
2018,1,BENGALURU,BAGDOGRA,6122,6015,BAGDOGRA-BENGALURU,12137,All
2018,2,BENGALURU,BAGDOGRA,5641,5353,BAGDOGRA-BENGALURU,10994,All
2018,3,BENGALURU,BAGDOGRA,5477,6126,BAGDOGRA-BENGALURU,11603,All
2018,4,BENGALURU,BAGDOGRA,6175,5877,BAGDOGRA-BENGALURU,12052,All
2018,5,BENGALURU,BAGDOGRA,5668,5823,BAGDOGRA-BENGALURU,11491,All
2018,6,BENGALURU,BAGDOGRA,6097,5837,BAGDOGRA-BENGALURU,11934,All
2018,7,BENGALURU,BAGDOGRA,6404,6377,BAGDOGRA-BENGALURU,12781,All
2018,8,BENGALURU,BAGDOGRA,11323,10065,BAGDOGRA-BENGALURU,21388,All
2018,9,BENGALURU,BAGDOGRA,15676,14519,BAGDOGRA-BENGALURU,30195,All
2018,10,BENGALURU,BAGDOGRA,17979,16049,BAGDOGRA-BENGALURU,34028,All
2018,11,BENGALURU,BAGDOGRA,17075,16457,BAGDOGRA-BENGALURU,33532,All
2018,12,BENGALURU,BAGDOGRA,15517,14327,BAGDOGRA-BENGALURU,29844,All
2019,1,BENGALURU,BAGDOGRA,18786,17575,BAGDOGRA-BENGALURU,36361,All
2019,2,BENGALURU,BAGDOGRA,14293,12715,BAGDOGRA-BENGALURU,27008,All
2019,3,BENGALURU,BAGDOGRA,18462,16606,BAGDOGRA-BENGALURU,35068,All
2019,4,BENGALURU,BAGDOGRA,16941,12725,BAGDOGRA-BENGALURU,29666,All
2015,4,BENGALURU,BELGAUM,1926,1936,BELGAUM-BENGALURU,3862,All
2015,5,BENGALURU,BELGAUM,3092,3202,BELGAUM-BENGALURU,6294,All
2015,6,BENGALURU,BELGAUM,2825,2547,BELGAUM-BENGALURU,5372,All
2015,7,BENGALURU,BELGAUM,4148,3896,BELGAUM-BENGALURU,8044,All
2015,8,BENGALURU,BELGAUM,3870,3817,BELGAUM-BENGALURU,7687,All
2015,9,BENGALURU,BELGAUM,3775,3847,BELGAUM-BENGALURU,7622,All
2015,10,BENGALURU,BELGAUM,3670,3470,BELGAUM-BENGALURU,7140,All
2015,11,BENGALURU,BELGAUM,3466,3284,BELGAUM-BENGALURU,6750,All
2015,12,BENGALURU,BELGAUM,3780,3576,BELGAUM-BENGALURU,7356,All
2016,1,BENGALURU,BELGAUM,2202,2226,BELGAUM-BENGALURU,4428,All
2016,2,BENGALURU,BELGAUM,2104,2030,BELGAUM-BENGALURU,4134,All
2016,3,BENGALURU,BELGAUM,2278,2252,BELGAUM-BENGALURU,4530,All
2016,4,BENGALURU,BELGAUM,2218,2137,BELGAUM-BENGALURU,4355,All
2016,5,BENGALURU,BELGAUM,2221,2259,BELGAUM-BENGALURU,4480,All
2016,6,BENGALURU,BELGAUM,2196,2212,BELGAUM-BENGALURU,4408,All
2016,7,BENGALURU,BELGAUM,2213,2237,BELGAUM-BENGALURU,4450,All
2016,8,BENGALURU,BELGAUM,2267,2284,BELGAUM-BENGALURU,4551,All
2016,9,BENGALURU,BELGAUM,2219,2215,BELGAUM-BENGALURU,4434,All
2016,10,BENGALURU,BELGAUM,2304,2085,BELGAUM-BENGALURU,4389,All
2016,11,BENGALURU,BELGAUM,2170,1991,BELGAUM-BENGALURU,4161,All
2016,12,BENGALURU,BELGAUM,2263,2146,BELGAUM-BENGALURU,4409,All
2017,1,BENGALURU,BELGAUM,2208,2233,BELGAUM-BENGALURU,4441,All
2017,2,BENGALURU,BELGAUM,2020,2055,BELGAUM-BENGALURU,4075,All
2017,3,BENGALURU,BELGAUM,2157,2173,BELGAUM-BENGALURU,4330,All
2017,4,BENGALURU,BELGAUM,2127,2067,BELGAUM-BENGALURU,4194,All
2017,5,BENGALURU,BELGAUM,2115,2086,BELGAUM-BENGALURU,4201,All
2017,6,BENGALURU,BELGAUM,2093,2092,BELGAUM-BENGALURU,4185,All
2017,7,BENGALURU,BELGAUM,2309,2252,BELGAUM-BENGALURU,4561,All
2017,8,BENGALURU,BELGAUM,2275,2218,BELGAUM-BENGALURU,4493,All
2017,9,BENGALURU,BELGAUM,2242,2127,BELGAUM-BENGALURU,4369,All
2017,10,BENGALURU,BELGAUM,3726,3789,BELGAUM-BENGALURU,7515,All
2017,11,BENGALURU,BELGAUM,4145,3965,BELGAUM-BENGALURU,8110,All
2017,12,BENGALURU,BELGAUM,4555,4546,BELGAUM-BENGALURU,9101,All
2018,1,BENGALURU,BELGAUM,4327,4528,BELGAUM-BENGALURU,8855,All
2018,2,BENGALURU,BELGAUM,3943,3988,BELGAUM-BENGALURU,7931,All
2018,3,BENGALURU,BELGAUM,4415,4460,BELGAUM-BENGALURU,8875,All
2018,4,BENGALURU,BELGAUM,4160,4231,BELGAUM-BENGALURU,8391,All
2018,5,BENGALURU,BELGAUM,2920,3062,BELGAUM-BENGALURU,5982,All
2018,6,BENGALURU,BELGAUM,1999,1983,BELGAUM-BENGALURU,3982,All
2018,7,BENGALURU,BELGAUM,458,446,BELGAUM-BENGALURU,904,All
2018,8,BENGALURU,BELGAUM,1713,1856,BELGAUM-BENGALURU,3569,All
2018,9,BENGALURU,BELGAUM,2260,2402,BELGAUM-BENGALURU,4662,All
2018,10,BENGALURU,BELGAUM,2408,2405,BELGAUM-BENGALURU,4813,All
2018,11,BENGALURU,BELGAUM,2532,2509,BELGAUM-BENGALURU,5041,All
2018,12,BENGALURU,BELGAUM,2687,2556,BELGAUM-BENGALURU,5243,All
2019,1,BENGALURU,BELGAUM,2502,2569,BELGAUM-BENGALURU,5071,All
2019,2,BENGALURU,BELGAUM,1915,2042,BELGAUM-BENGALURU,3957,All
2019,3,BENGALURU,BELGAUM,2823,2966,BELGAUM-BENGALURU,5789,All
2019,4,BENGALURU,BELGAUM,2636,2740,BELGAUM-BENGALURU,5376,All
2019,5,BENGALURU,BHOPAL,4172,5277,BENGALURU-BHOPAL,9449,All
2019,6,BENGALURU,BHOPAL,3930,4443,BENGALURU-BHOPAL,8373,All
2019,7,BENGALURU,BHOPAL,3673,4270,BENGALURU-BHOPAL,7943,All
2019,8,BENGALURU,BHOPAL,4444,4096,BENGALURU-BHOPAL,8540,All
2019,9,BENGALURU,BHOPAL,4291,3855,BENGALURU-BHOPAL,8146,All
2019,10,BENGALURU,BHOPAL,5165,4276,BENGALURU-BHOPAL,9441,All
2019,11,BENGALURU,BHOPAL,5065,5044,BENGALURU-BHOPAL,10109,All
2019,12,BENGALURU,BHOPAL,5580,5476,BENGALURU-BHOPAL,11056,All
2020,1,BENGALURU,BHOPAL,5462,5268,BENGALURU-BHOPAL,10730,All
2020,2,BENGALURU,BHOPAL,4819,4698,BENGALURU-BHOPAL,9517,All
2020,3,BENGALURU,BHOPAL,3844,2671,BENGALURU-BHOPAL,6515,All
2020,8,BENGALURU,BHOPAL,1049,819,BENGALURU-BHOPAL,1868,All
2020,9,BENGALURU,BHOPAL,1950,1948,BENGALURU-BHOPAL,3898,All
2020,10,BENGALURU,BHOPAL,3028,2939,BENGALURU-BHOPAL,5967,All
2020,11,BENGALURU,BHOPAL,3897,3971,BENGALURU-BHOPAL,7868,All
2020,12,BENGALURU,BHOPAL,4142,5732,BENGALURU-BHOPAL,9874,All
2021,1,BENGALURU,BHOPAL,4220,5896,BENGALURU-BHOPAL,10116,All
2021,2,BENGALURU,BHOPAL,5321,5693,BENGALURU-BHOPAL,11014,All
2021,3,BENGALURU,BHOPAL,5732,4992,BENGALURU-BHOPAL,10724,All
2021,4,BENGALURU,BHOPAL,3149,1885,BENGALURU-BHOPAL,5034,All
2021,7,BENGALURU,BHOPAL,2570,2162,BENGALURU-BHOPAL,4732,All
2021,8,BENGALURU,BHOPAL,3461,2982,BENGALURU-BHOPAL,6443,All
2021,9,BENGALURU,BHOPAL,3491,2988,BENGALURU-BHOPAL,6479,All
2021,10,BENGALURU,BHOPAL,4512,3439,BENGALURU-BHOPAL,7951,All
2021,11,BENGALURU,BHOPAL,3638,4271,BENGALURU-BHOPAL,7909,All
2021,12,BENGALURU,BHOPAL,3705,4445,BENGALURU-BHOPAL,8150,All
2022,1,BENGALURU,BHOPAL,2731,2851,BENGALURU-BHOPAL,5582,All
2022,2,BENGALURU,BHOPAL,1975,2433,BENGALURU-BHOPAL,4408,All
2022,3,BENGALURU,BHOPAL,4042,4710,BENGALURU-BHOPAL,8752,All
2022,4,BENGALURU,BHOPAL,4264,4528,BENGALURU-BHOPAL,8792,All
2022,5,BENGALURU,BHOPAL,4007,4652,BENGALURU-BHOPAL,8659,All
2022,6,BENGALURU,BHOPAL,4046,4463,BENGALURU-BHOPAL,8509,All
2022,7,BENGALURU,BHOPAL,3935,4663,BENGALURU-BHOPAL,8598,All
2022,8,BENGALURU,BHOPAL,4061,4470,BENGALURU-BHOPAL,8531,All
2022,9,BENGALURU,BHOPAL,3620,3358,BENGALURU-BHOPAL,6978,All
2022,10,BENGALURU,BHOPAL,4611,4222,BENGALURU-BHOPAL,8833,All
2022,11,BENGALURU,BHOPAL,4289,4602,BENGALURU-BHOPAL,8891,All
2022,12,BENGALURU,BHOPAL,3973,4090,BENGALURU-BHOPAL,8063,All
2023,1,BENGALURU,BHOPAL,3928,4261,BENGALURU-BHOPAL,8189,All
2023,2,BENGALURU,BHOPAL,3504,3667,BENGALURU-BHOPAL,7171,All
2023,3,BENGALURU,BHOPAL,6257,6383,BENGALURU-BHOPAL,12640,All
2023,4,BENGALURU,BHOPAL,5532,5404,BENGALURU-BHOPAL,10936,All
2023,5,BENGALURU,BHOPAL,7393,8321,BENGALURU-BHOPAL,15714,All
2023,6,BENGALURU,BHOPAL,7353,8287,BENGALURU-BHOPAL,15640,All
2023,7,BENGALURU,BHOPAL,5503,5862,BENGALURU-BHOPAL,11365,All
2023,8,BENGALURU,BHOPAL,6602,6077,BENGALURU-BHOPAL,12679,All
2023,9,BENGALURU,BHOPAL,6682,6568,BENGALURU-BHOPAL,13250,All
2023,10,BENGALURU,BHOPAL,10725,9423,BENGALURU-BHOPAL,20148,All
2023,11,BENGALURU,BHOPAL,9656,8838,BENGALURU-BHOPAL,18494,All
2023,12,BENGALURU,BHOPAL,10251,10569,BENGALURU-BHOPAL,20820,All
2024,1,BENGALURU,BHOPAL,6180,6499,BENGALURU-BHOPAL,12679,All
2024,2,BENGALURU,BHOPAL,4800,4660,BENGALURU-BHOPAL,9460,All
2024,3,BENGALURU,BHOPAL,9006,8339,BENGALURU-BHOPAL,17345,All
2024,4,BENGALURU,BHOPAL,12617,11328,BENGALURU-BHOPAL,23945,All
2024,6,BENGALURU,BHOPAL,12059,12229,BENGALURU-BHOPAL,24288,All
2024,7,BENGALURU,BHOPAL,10472,10735,BENGALURU-BHOPAL,21207,All
2024,8,BENGALURU,BHOPAL,12035,12213,BENGALURU-BHOPAL,24248,All
2024,9,BENGALURU,BHOPAL,11159,10668,BENGALURU-BHOPAL,21827,All
2024,10,BENGALURU,BHOPAL,12252,10122,BENGALURU-BHOPAL,22374,All
2024,11,BENGALURU,BHOPAL,9418,10485,BENGALURU-BHOPAL,19903,All
2024,12,BENGALURU,BHOPAL,10221,10589,BENGALURU-BHOPAL,20810,All
2025,1,BENGALURU,BHOPAL,10254,10664,BENGALURU-BHOPAL,20918,All
2025,2,BENGALURU,BHOPAL,8260,8266,BENGALURU-BHOPAL,16526,All
2025,3,BENGALURU,BHOPAL,9897,9811,BENGALURU-BHOPAL,19708,All
2019,5,BENGALURU,BHUBANESWAR,28039,28377,BENGALURU-BHUBANESWAR,56416,All
2019,6,BENGALURU,BHUBANESWAR,29854,27577,BENGALURU-BHUBANESWAR,57431,All
2019,7,BENGALURU,BHUBANESWAR,24049,23464,BENGALURU-BHUBANESWAR,47513,All
2019,8,BENGALURU,BHUBANESWAR,20962,18257,BENGALURU-BHUBANESWAR,39219,All
2019,9,BENGALURU,BHUBANESWAR,24504,20006,BENGALURU-BHUBANESWAR,44510,All
2019,10,BENGALURU,BHUBANESWAR,31284,24633,BENGALURU-BHUBANESWAR,55917,All
2019,11,BENGALURU,BHUBANESWAR,28728,28707,BENGALURU-BHUBANESWAR,57435,All
2019,12,BENGALURU,BHUBANESWAR,31988,31339,BENGALURU-BHUBANESWAR,63327,All
2020,1,BENGALURU,BHUBANESWAR,32605,31318,BENGALURU-BHUBANESWAR,63923,All
2020,2,BENGALURU,BHUBANESWAR,30218,29327,BENGALURU-BHUBANESWAR,59545,All
2020,3,BENGALURU,BHUBANESWAR,25594,17041,BENGALURU-BHUBANESWAR,42635,All
2020,5,BENGALURU,BHUBANESWAR,1986,640,BENGALURU-BHUBANESWAR,2626,All
2020,6,BENGALURU,BHUBANESWAR,9919,4042,BENGALURU-BHUBANESWAR,13961,All
2020,7,BENGALURU,BHUBANESWAR,12490,3170,BENGALURU-BHUBANESWAR,15660,All
2020,8,BENGALURU,BHUBANESWAR,11857,8458,BENGALURU-BHUBANESWAR,20315,All
2020,9,BENGALURU,BHUBANESWAR,12155,21195,BENGALURU-BHUBANESWAR,33350,All
2020,10,BENGALURU,BHUBANESWAR,19862,29068,BENGALURU-BHUBANESWAR,48930,All
2020,11,BENGALURU,BHUBANESWAR,20968,20598,BENGALURU-BHUBANESWAR,41566,All
2020,12,BENGALURU,BHUBANESWAR,25229,25625,BENGALURU-BHUBANESWAR,50854,All
2021,1,BENGALURU,BHUBANESWAR,19921,28547,BENGALURU-BHUBANESWAR,48468,All
2021,2,BENGALURU,BHUBANESWAR,21352,24164,BENGALURU-BHUBANESWAR,45516,All
2021,3,BENGALURU,BHUBANESWAR,18109,21134,BENGALURU-BHUBANESWAR,39243,All
2021,4,BENGALURU,BHUBANESWAR,15859,11511,BENGALURU-BHUBANESWAR,27370,All
2021,6,BENGALURU,BHUBANESWAR,5099,5878,BENGALURU-BHUBANESWAR,10977,All
2021,7,BENGALURU,BHUBANESWAR,7764,10826,BENGALURU-BHUBANESWAR,18590,All
2021,8,BENGALURU,BHUBANESWAR,11514,14907,BENGALURU-BHUBANESWAR,26421,All
2021,9,BENGALURU,BHUBANESWAR,13477,15225,BENGALURU-BHUBANESWAR,28702,All
2021,10,BENGALURU,BHUBANESWAR,23263,20599,BENGALURU-BHUBANESWAR,43862,All
2021,11,BENGALURU,BHUBANESWAR,22985,22140,BENGALURU-BHUBANESWAR,45125,All
2021,12,BENGALURU,BHUBANESWAR,24696,26237,BENGALURU-BHUBANESWAR,50933,All
2022,1,BENGALURU,BHUBANESWAR,14345,13535,BENGALURU-BHUBANESWAR,27880,All
2022,2,BENGALURU,BHUBANESWAR,17848,17108,BENGALURU-BHUBANESWAR,34956,All
2022,3,BENGALURU,BHUBANESWAR,19996,22223,BENGALURU-BHUBANESWAR,42219,All
2022,4,BENGALURU,BHUBANESWAR,23071,23061,BENGALURU-BHUBANESWAR,46132,All
2022,5,BENGALURU,BHUBANESWAR,18388,25657,BENGALURU-BHUBANESWAR,44045,All
2022,6,BENGALURU,BHUBANESWAR,20830,21591,BENGALURU-BHUBANESWAR,42421,All
2022,7,BENGALURU,BHUBANESWAR,18999,22696,BENGALURU-BHUBANESWAR,41695,All
2022,8,BENGALURU,BHUBANESWAR,18208,20930,BENGALURU-BHUBANESWAR,39138,All
2022,9,BENGALURU,BHUBANESWAR,22358,20292,BENGALURU-BHUBANESWAR,42650,All
2022,10,BENGALURU,BHUBANESWAR,28510,25512,BENGALURU-BHUBANESWAR,54022,All
2022,11,BENGALURU,BHUBANESWAR,25015,28619,BENGALURU-BHUBANESWAR,53634,All
2022,12,BENGALURU,BHUBANESWAR,30792,30619,BENGALURU-BHUBANESWAR,61411,All
2023,1,BENGALURU,BHUBANESWAR,28926,30321,BENGALURU-BHUBANESWAR,59247,All
2023,2,BENGALURU,BHUBANESWAR,24733,25913,BENGALURU-BHUBANESWAR,50646,All
2023,3,BENGALURU,BHUBANESWAR,27250,29312,BENGALURU-BHUBANESWAR,56562,All
2023,4,BENGALURU,BHUBANESWAR,34197,29609,BENGALURU-BHUBANESWAR,63806,All
2023,5,BENGALURU,BHUBANESWAR,35928,37763,BENGALURU-BHUBANESWAR,73691,All
2023,6,BENGALURU,BHUBANESWAR,37633,37330,BENGALURU-BHUBANESWAR,74963,All
2023,7,BENGALURU,BHUBANESWAR,31799,36746,BENGALURU-BHUBANESWAR,68545,All
2023,8,BENGALURU,BHUBANESWAR,33354,34851,BENGALURU-BHUBANESWAR,68205,All
2023,9,BENGALURU,BHUBANESWAR,33167,31989,BENGALURU-BHUBANESWAR,65156,All
2023,10,BENGALURU,BHUBANESWAR,37433,31779,BENGALURU-BHUBANESWAR,69212,All
2023,11,BENGALURU,BHUBANESWAR,33196,32004,BENGALURU-BHUBANESWAR,65200,All
2023,12,BENGALURU,BHUBANESWAR,34304,36075,BENGALURU-BHUBANESWAR,70379,All
2024,1,BENGALURU,BHUBANESWAR,35557,36945,BENGALURU-BHUBANESWAR,72502,All
2024,2,BENGALURU,BHUBANESWAR,36257,36437,BENGALURU-BHUBANESWAR,72694,All
2024,3,BENGALURU,BHUBANESWAR,36191,35000,BENGALURU-BHUBANESWAR,71191,All
2024,4,BENGALURU,BHUBANESWAR,33118,32592,BENGALURU-BHUBANESWAR,65710,All
2024,6,BENGALURU,BHUBANESWAR,35049,34728,BENGALURU-BHUBANESWAR,69777,All
2024,7,BENGALURU,BHUBANESWAR,33158,36815,BENGALURU-BHUBANESWAR,69973,All
2024,8,BENGALURU,BHUBANESWAR,32535,35078,BENGALURU-BHUBANESWAR,67613,All
2024,9,BENGALURU,BHUBANESWAR,31874,30485,BENGALURU-BHUBANESWAR,62359,All
2024,10,BENGALURU,BHUBANESWAR,37365,32395,BENGALURU-BHUBANESWAR,69760,All
2024,11,BENGALURU,BHUBANESWAR,34722,35689,BENGALURU-BHUBANESWAR,70411,All
2024,12,BENGALURU,BHUBANESWAR,31999,31298,BENGALURU-BHUBANESWAR,63297,All
2025,1,BENGALURU,BHUBANESWAR,35538,36286,BENGALURU-BHUBANESWAR,71824,All
2025,2,BENGALURU,BHUBANESWAR,31415,30250,BENGALURU-BHUBANESWAR,61665,All
2025,3,BENGALURU,BHUBANESWAR,34219,33575,BENGALURU-BHUBANESWAR,67794,All
2022,11,BENGALURU,BIDAR ,419,454,BENGALURU-BIDAR ,873,All
2023,1,BENGALURU,BIDAR ,296,321,BENGALURU-BIDAR ,617,All
2023,2,BENGALURU,BIDAR ,330,422,BENGALURU-BIDAR ,752,All
2023,3,BENGALURU,BIDAR ,569,668,BENGALURU-BIDAR ,1237,All
2023,4,BENGALURU,BIDAR ,628,683,BENGALURU-BIDAR ,1311,All
2023,5,BENGALURU,BIDAR ,810,1021,BENGALURU-BIDAR ,1831,All
2023,6,BENGALURU,BIDAR ,1009,1185,BENGALURU-BIDAR ,2194,All
2023,7,BENGALURU,BIDAR ,1210,1340,BENGALURU-BIDAR ,2550,All
2023,8,BENGALURU,BIDAR ,873,1161,BENGALURU-BIDAR ,2034,All
2023,9,BENGALURU,BIDAR ,920,1032,BENGALURU-BIDAR ,1952,All
2023,10,BENGALURU,BIDAR ,1310,1406,BENGALURU-BIDAR ,2716,All
2023,11,BENGALURU,BIDAR ,1230,1286,BENGALURU-BIDAR ,2516,All
2023,12,BENGALURU,BIDAR ,348,403,BENGALURU-BIDAR ,751,All
2020,2,BENGALURU,"BIDAR AIRPORT, KARNATAKA",1447,1488,"BENGALURU-BIDAR AIRPORT, KARNATAKA",2935,All
2020,7,BENGALURU,"BIDAR AIRPORT, KARNATAKA",570,398,"BENGALURU-BIDAR AIRPORT, KARNATAKA",968,All
2020,8,BENGALURU,"BIDAR AIRPORT, KARNATAKA",413,445,"BENGALURU-BIDAR AIRPORT, KARNATAKA",858,All
2020,9,BENGALURU,"BIDAR AIRPORT, KARNATAKA",395,433,"BENGALURU-BIDAR AIRPORT, KARNATAKA",828,All
2020,10,BENGALURU,"BIDAR AIRPORT, KARNATAKA",694,614,"BENGALURU-BIDAR AIRPORT, KARNATAKA",1308,All
2020,11,BENGALURU,"BIDAR AIRPORT, KARNATAKA",546,580,"BENGALURU-BIDAR AIRPORT, KARNATAKA",1126,All
2020,12,BENGALURU,"BIDAR AIRPORT, KARNATAKA",708,706,"BENGALURU-BIDAR AIRPORT, KARNATAKA",1414,All
2021,1,BENGALURU,"BIDAR AIRPORT, KARNATAKA",586,670,"BENGALURU-BIDAR AIRPORT, KARNATAKA",1256,All
2021,2,BENGALURU,"BIDAR AIRPORT, KARNATAKA",697,667,"BENGALURU-BIDAR AIRPORT, KARNATAKA",1364,All
2021,3,BENGALURU,"BIDAR AIRPORT, KARNATAKA",638,775,"BENGALURU-BIDAR AIRPORT, KARNATAKA",1413,All
2021,4,BENGALURU,"BIDAR AIRPORT, KARNATAKA",561,436,"BENGALURU-BIDAR AIRPORT, KARNATAKA",997,All
2021,6,BENGALURU,"BIDAR AIRPORT, KARNATAKA",171,205,"BENGALURU-BIDAR AIRPORT, KARNATAKA",376,All
2021,7,BENGALURU,"BIDAR AIRPORT, KARNATAKA",41,71,"BENGALURU-BIDAR AIRPORT, KARNATAKA",112,All
2021,8,BENGALURU,"BIDAR AIRPORT, KARNATAKA",484,534,"BENGALURU-BIDAR AIRPORT, KARNATAKA",1018,All
2021,9,BENGALURU,"BIDAR AIRPORT, KARNATAKA",180,198,"BENGALURU-BIDAR AIRPORT, KARNATAKA",378,All
2021,10,BENGALURU,"BIDAR AIRPORT, KARNATAKA",274,167,"BENGALURU-BIDAR AIRPORT, KARNATAKA",441,All
2021,11,BENGALURU,"BIDAR AIRPORT, KARNATAKA",54,143,"BENGALURU-BIDAR AIRPORT, KARNATAKA",197,All
2022,2,BENGALURU,"BIDAR AIRPORT, KARNATAKA",44,57,"BENGALURU-BIDAR AIRPORT, KARNATAKA",101,All
2022,6,BENGALURU,"BIDAR AIRPORT, KARNATAKA",346,361,"BENGALURU-BIDAR AIRPORT, KARNATAKA",707,All
2022,7,BENGALURU,"BIDAR AIRPORT, KARNATAKA",694,813,"BENGALURU-BIDAR AIRPORT, KARNATAKA",1507,All
2022,8,BENGALURU,"BIDAR AIRPORT, KARNATAKA",677,689,"BENGALURU-BIDAR AIRPORT, KARNATAKA",1366,All
2022,9,BENGALURU,"BIDAR AIRPORT, KARNATAKA",586,607,"BENGALURU-BIDAR AIRPORT, KARNATAKA",1193,All
2022,10,BENGALURU,"BIDAR AIRPORT, KARNATAKA",411,462,"BENGALURU-BIDAR AIRPORT, KARNATAKA",873,All
2022,12,BENGALURU,"BIDAR AIRPORT, KARNATAKA",373,392,"BENGALURU-BIDAR AIRPORT, KARNATAKA",765,All
2015,4,BENGALURU,CHANDIGARH,11186,9930,BENGALURU-CHANDIGARH,21116,All
2015,5,BENGALURU,CHANDIGARH,10189,11688,BENGALURU-CHANDIGARH,21877,All
2015,6,BENGALURU,CHANDIGARH,10418,11219,BENGALURU-CHANDIGARH,21637,All
2015,7,BENGALURU,CHANDIGARH,10082,9549,BENGALURU-CHANDIGARH,19631,All
2015,8,BENGALURU,CHANDIGARH,9638,9045,BENGALURU-CHANDIGARH,18683,All
2015,9,BENGALURU,CHANDIGARH,4993,4771,BENGALURU-CHANDIGARH,9764,All
2015,9,BENGALURU,CHANDIGARH,3740,3612,BENGALURU-CHANDIGARH,7352,All
2015,10,BENGALURU,CHANDIGARH,10343,9223,BENGALURU-CHANDIGARH,19566,All
2015,11,BENGALURU,CHANDIGARH,9824,10055,BENGALURU-CHANDIGARH,19879,All
2015,12,BENGALURU,CHANDIGARH,8048,8331,BENGALURU-CHANDIGARH,16379,All
2016,1,BENGALURU,CHANDIGARH,8002,7655,BENGALURU-CHANDIGARH,15657,All
2016,2,BENGALURU,CHANDIGARH,9144,8473,BENGALURU-CHANDIGARH,17617,All
2016,3,BENGALURU,CHANDIGARH,13968,19911,BENGALURU-CHANDIGARH,33879,All
2016,4,BENGALURU,CHANDIGARH,8662,7949,BENGALURU-CHANDIGARH,16611,All
2016,5,BENGALURU,CHANDIGARH,14362,16221,BENGALURU-CHANDIGARH,30583,All
2016,6,BENGALURU,CHANDIGARH,10274,10093,BENGALURU-CHANDIGARH,20367,All
2016,7,BENGALURU,CHANDIGARH,10679,10459,BENGALURU-CHANDIGARH,21138,All
2016,8,BENGALURU,CHANDIGARH,10204,10086,BENGALURU-CHANDIGARH,20290,All
2016,9,BENGALURU,CHANDIGARH,9788,8968,BENGALURU-CHANDIGARH,18756,All
2016,10,BENGALURU,CHANDIGARH,14043,11387,BENGALURU-CHANDIGARH,25430,All
2016,11,BENGALURU,CHANDIGARH,13638,15616,BENGALURU-CHANDIGARH,29254,All
2016,12,BENGALURU,CHANDIGARH,13168,13912,BENGALURU-CHANDIGARH,27080,All
2017,1,BENGALURU,CHANDIGARH,13856,14019,BENGALURU-CHANDIGARH,27875,All
2017,2,BENGALURU,CHANDIGARH,12355,12293,BENGALURU-CHANDIGARH,24648,All
2017,3,BENGALURU,CHANDIGARH,14110,12956,BENGALURU-CHANDIGARH,27066,All
2017,4,BENGALURU,CHANDIGARH,14528,14201,BENGALURU-CHANDIGARH,28729,All
2017,5,BENGALURU,CHANDIGARH,15315,16267,BENGALURU-CHANDIGARH,31582,All
2017,6,BENGALURU,CHANDIGARH,14665,14763,BENGALURU-CHANDIGARH,29428,All
2017,7,BENGALURU,CHANDIGARH,14165,14189,BENGALURU-CHANDIGARH,28354,All
2017,8,BENGALURU,CHANDIGARH,12587,12372,BENGALURU-CHANDIGARH,24959,All
2017,9,BENGALURU,CHANDIGARH,13092,10592,BENGALURU-CHANDIGARH,23684,All
2017,10,BENGALURU,CHANDIGARH,9815,9307,BENGALURU-CHANDIGARH,19122,All
2017,11,BENGALURU,CHANDIGARH,9884,9554,BENGALURU-CHANDIGARH,19438,All
2017,12,BENGALURU,CHANDIGARH,9725,10296,BENGALURU-CHANDIGARH,20021,All
2018,1,BENGALURU,CHANDIGARH,9508,10522,BENGALURU-CHANDIGARH,20030,All
2018,2,BENGALURU,CHANDIGARH,4211,3924,BENGALURU-CHANDIGARH,8135,All
2018,3,BENGALURU,CHANDIGARH,10134,10186,BENGALURU-CHANDIGARH,20320,All
2018,4,BENGALURU,CHANDIGARH,10463,9538,BENGALURU-CHANDIGARH,20001,All
2018,5,BENGALURU,CHANDIGARH,3802,4330,BENGALURU-CHANDIGARH,8132,All
2018,6,BENGALURU,CHANDIGARH,9571,10273,BENGALURU-CHANDIGARH,19844,All
2018,7,BENGALURU,CHANDIGARH,12774,13826,BENGALURU-CHANDIGARH,26600,All
2018,8,BENGALURU,CHANDIGARH,13296,12363,BENGALURU-CHANDIGARH,25659,All
2018,9,BENGALURU,CHANDIGARH,11966,11421,BENGALURU-CHANDIGARH,23387,All
2018,10,BENGALURU,CHANDIGARH,15052,13643,BENGALURU-CHANDIGARH,28695,All
2018,11,BENGALURU,CHANDIGARH,13433,13517,BENGALURU-CHANDIGARH,26950,All
2018,12,BENGALURU,CHANDIGARH,10181,10033,BENGALURU-CHANDIGARH,20214,All
2019,1,BENGALURU,CHANDIGARH,10156,10146,BENGALURU-CHANDIGARH,20302,All
2019,2,BENGALURU,CHANDIGARH,9115,7544,BENGALURU-CHANDIGARH,16659,All
2019,3,BENGALURU,CHANDIGARH,15468,13874,BENGALURU-CHANDIGARH,29342,All
2019,4,BENGALURU,CHANDIGARH,14428,13803,BENGALURU-CHANDIGARH,28231,All
2019,5,BENGALURU,CHANDIGARH,14366,15693,BENGALURU-CHANDIGARH,30059,All
2019,6,BENGALURU,CHANDIGARH,13452,14724,BENGALURU-CHANDIGARH,28176,All
2019,7,BENGALURU,CHANDIGARH,13822,14422,BENGALURU-CHANDIGARH,28244,All
2019,8,BENGALURU,CHANDIGARH,13878,13747,BENGALURU-CHANDIGARH,27625,All
2019,9,BENGALURU,CHANDIGARH,13081,12447,BENGALURU-CHANDIGARH,25528,All
2019,10,BENGALURU,CHANDIGARH,14181,13095,BENGALURU-CHANDIGARH,27276,All
2019,11,BENGALURU,CHANDIGARH,13456,13771,BENGALURU-CHANDIGARH,27227,All
2019,12,BENGALURU,CHANDIGARH,14009,14237,BENGALURU-CHANDIGARH,28246,All
2020,1,BENGALURU,CHANDIGARH,14195,13474,BENGALURU-CHANDIGARH,27669,All
2020,2,BENGALURU,CHANDIGARH,14840,13002,BENGALURU-CHANDIGARH,27842,All
2020,3,BENGALURU,CHANDIGARH,12941,8338,BENGALURU-CHANDIGARH,21279,All
2020,5,BENGALURU,CHANDIGARH,1358,478,BENGALURU-CHANDIGARH,1836,All
2020,6,BENGALURU,CHANDIGARH,4825,2539,BENGALURU-CHANDIGARH,7364,All
2020,7,BENGALURU,CHANDIGARH,3706,1987,BENGALURU-CHANDIGARH,5693,All
2020,8,BENGALURU,CHANDIGARH,3149,2176,BENGALURU-CHANDIGARH,5325,All
2020,9,BENGALURU,CHANDIGARH,3206,2886,BENGALURU-CHANDIGARH,6092,All
2020,10,BENGALURU,CHANDIGARH,5139,3634,BENGALURU-CHANDIGARH,8773,All
2020,11,BENGALURU,CHANDIGARH,7409,7160,BENGALURU-CHANDIGARH,14569,All
2020,12,BENGALURU,CHANDIGARH,12339,11598,BENGALURU-CHANDIGARH,23937,All
2021,1,BENGALURU,CHANDIGARH,6984,8891,BENGALURU-CHANDIGARH,15875,All
2021,2,BENGALURU,CHANDIGARH,8636,8704,BENGALURU-CHANDIGARH,17340,All
2021,3,BENGALURU,CHANDIGARH,9141,7909,BENGALURU-CHANDIGARH,17050,All
2021,4,BENGALURU,CHANDIGARH,6785,4717,BENGALURU-CHANDIGARH,11502,All
2021,6,BENGALURU,CHANDIGARH,2321,2627,BENGALURU-CHANDIGARH,4948,All
2021,7,BENGALURU,CHANDIGARH,5342,6175,BENGALURU-CHANDIGARH,11517,All
2021,8,BENGALURU,CHANDIGARH,7341,8576,BENGALURU-CHANDIGARH,15917,All
2021,9,BENGALURU,CHANDIGARH,7196,6940,BENGALURU-CHANDIGARH,14136,All
2021,10,BENGALURU,CHANDIGARH,12122,9914,BENGALURU-CHANDIGARH,22036,All
2021,11,BENGALURU,CHANDIGARH,13115,13107,BENGALURU-CHANDIGARH,26222,All
2021,12,BENGALURU,CHANDIGARH,13828,13665,BENGALURU-CHANDIGARH,27493,All
2022,1,BENGALURU,CHANDIGARH,8509,7658,BENGALURU-CHANDIGARH,16167,All
2022,2,BENGALURU,CHANDIGARH,7474,6374,BENGALURU-CHANDIGARH,13848,All
2022,3,BENGALURU,CHANDIGARH,13675,12789,BENGALURU-CHANDIGARH,26464,All
2022,4,BENGALURU,CHANDIGARH,17191,16030,BENGALURU-CHANDIGARH,33221,All
2022,5,BENGALURU,CHANDIGARH,16953,18718,BENGALURU-CHANDIGARH,35671,All
2022,6,BENGALURU,CHANDIGARH,16584,17313,BENGALURU-CHANDIGARH,33897,All
2022,7,BENGALURU,CHANDIGARH,16713,16219,BENGALURU-CHANDIGARH,32932,All
2022,8,BENGALURU,CHANDIGARH,15953,14988,BENGALURU-CHANDIGARH,30941,All
2022,9,BENGALURU,CHANDIGARH,15394,11613,BENGALURU-CHANDIGARH,27007,All
2022,10,BENGALURU,CHANDIGARH,15708,13162,BENGALURU-CHANDIGARH,28870,All
2022,11,BENGALURU,CHANDIGARH,14838,17093,BENGALURU-CHANDIGARH,31931,All
2022,12,BENGALURU,CHANDIGARH,18579,19758,BENGALURU-CHANDIGARH,38337,All
2023,1,BENGALURU,CHANDIGARH,16839,16733,BENGALURU-CHANDIGARH,33572,All
2023,2,BENGALURU,CHANDIGARH,17261,13891,BENGALURU-CHANDIGARH,31152,All
2023,3,BENGALURU,CHANDIGARH,18667,17184,BENGALURU-CHANDIGARH,35851,All
2023,4,BENGALURU,CHANDIGARH,20562,17442,BENGALURU-CHANDIGARH,38004,All
2023,5,BENGALURU,CHANDIGARH,20414,21460,BENGALURU-CHANDIGARH,41874,All
2023,6,BENGALURU,CHANDIGARH,14881,15598,BENGALURU-CHANDIGARH,30479,All
2023,7,BENGALURU,CHANDIGARH,13070,14420,BENGALURU-CHANDIGARH,27490,All
2023,8,BENGALURU,CHANDIGARH,17960,14642,BENGALURU-CHANDIGARH,32602,All
2023,9,BENGALURU,CHANDIGARH,19894,18314,BENGALURU-CHANDIGARH,38208,All
2023,10,BENGALURU,CHANDIGARH,21832,18278,BENGALURU-CHANDIGARH,40110,All
2023,11,BENGALURU,CHANDIGARH,18904,18622,BENGALURU-CHANDIGARH,37526,All
2023,12,BENGALURU,CHANDIGARH,19257,19777,BENGALURU-CHANDIGARH,39034,All
2024,1,BENGALURU,CHANDIGARH,19180,19573,BENGALURU-CHANDIGARH,38753,All
2024,2,BENGALURU,CHANDIGARH,15411,14692,BENGALURU-CHANDIGARH,30103,All
2024,3,BENGALURU,CHANDIGARH,23440,21775,BENGALURU-CHANDIGARH,45215,All
2024,4,BENGALURU,CHANDIGARH,21330,20592,BENGALURU-CHANDIGARH,41922,All
2024,6,BENGALURU,CHANDIGARH,20426,21286,BENGALURU-CHANDIGARH,41712,All
2024,7,BENGALURU,CHANDIGARH,19955,19739,BENGALURU-CHANDIGARH,39694,All
2024,8,BENGALURU,CHANDIGARH,19884,18441,BENGALURU-CHANDIGARH,38325,All
2024,9,BENGALURU,CHANDIGARH,18966,16878,BENGALURU-CHANDIGARH,35844,All
2024,10,BENGALURU,CHANDIGARH,23598,18933,BENGALURU-CHANDIGARH,42531,All
2024,11,BENGALURU,CHANDIGARH,18794,21772,BENGALURU-CHANDIGARH,40566,All
2024,12,BENGALURU,CHANDIGARH,19352,20527,BENGALURU-CHANDIGARH,39879,All
2025,1,BENGALURU,CHANDIGARH,18391,19724,BENGALURU-CHANDIGARH,38115,All
2025,2,BENGALURU,CHANDIGARH,15932,15219,BENGALURU-CHANDIGARH,31151,All
2025,3,BENGALURU,CHANDIGARH,22795,21742,BENGALURU-CHANDIGARH,44537,All
2015,4,BENGALURU,CHENNAI,39124,38366,BENGALURU-CHENNAI,77490,All
2015,5,BENGALURU,CHENNAI,38020,39752,BENGALURU-CHENNAI,77772,All
2015,6,BENGALURU,CHENNAI,31719,30909,BENGALURU-CHENNAI,62628,All
2015,7,BENGALURU,CHENNAI,32863,33136,BENGALURU-CHENNAI,65999,All
2015,8,BENGALURU,CHENNAI,33361,33299,BENGALURU-CHENNAI,66660,All
2015,9,BENGALURU,CHENNAI,20487,21070,BENGALURU-CHENNAI,41557,All
2015,9,BENGALURU,CHENNAI,11168,10938,BENGALURU-CHENNAI,22106,All
2015,10,BENGALURU,CHENNAI,33744,33604,BENGALURU-CHENNAI,67348,All
2015,11,BENGALURU,CHENNAI,29793,30079,BENGALURU-CHENNAI,59872,All
2015,12,BENGALURU,CHENNAI,25164,24257,BENGALURU-CHENNAI,49421,All
2016,1,BENGALURU,CHENNAI,33680,32483,BENGALURU-CHENNAI,66163,All
2016,2,BENGALURU,CHENNAI,32419,32113,BENGALURU-CHENNAI,64532,All
2016,3,BENGALURU,CHENNAI,37094,37033,BENGALURU-CHENNAI,74127,All
2016,4,BENGALURU,CHENNAI,43499,44397,BENGALURU-CHENNAI,87896,All
2016,5,BENGALURU,CHENNAI,47426,51455,BENGALURU-CHENNAI,98881,All
2016,6,BENGALURU,CHENNAI,43157,44857,BENGALURU-CHENNAI,88014,All
2016,7,BENGALURU,CHENNAI,47765,49562,BENGALURU-CHENNAI,97327,All
2016,8,BENGALURU,CHENNAI,47427,49904,BENGALURU-CHENNAI,97331,All
2016,9,BENGALURU,CHENNAI,48448,52110,BENGALURU-CHENNAI,100558,All
2016,10,BENGALURU,CHENNAI,48933,48139,BENGALURU-CHENNAI,97072,All
2016,11,BENGALURU,CHENNAI,43703,47751,BENGALURU-CHENNAI,91454,All
2016,12,BENGALURU,CHENNAI,43067,41662,BENGALURU-CHENNAI,84729,All
2017,1,BENGALURU,CHENNAI,43761,43005,BENGALURU-CHENNAI,86766,All
2017,2,BENGALURU,CHENNAI,37827,37804,BENGALURU-CHENNAI,75631,All
2017,3,BENGALURU,CHENNAI,36392,36315,BENGALURU-CHENNAI,72707,All
2017,4,BENGALURU,CHENNAI,36239,34656,BENGALURU-CHENNAI,70895,All
2017,5,BENGALURU,CHENNAI,40658,43311,BENGALURU-CHENNAI,83969,All
2017,6,BENGALURU,CHENNAI,41868,40911,BENGALURU-CHENNAI,82779,All
2017,7,BENGALURU,CHENNAI,44494,45248,BENGALURU-CHENNAI,89742,All
2017,8,BENGALURU,CHENNAI,44159,45217,BENGALURU-CHENNAI,89376,All
2017,9,BENGALURU,CHENNAI,43417,44209,BENGALURU-CHENNAI,87626,All
2017,10,BENGALURU,CHENNAI,41829,42164,BENGALURU-CHENNAI,83993,All
2017,11,BENGALURU,CHENNAI,45228,45574,BENGALURU-CHENNAI,90802,All
2017,12,BENGALURU,CHENNAI,45420,45678,BENGALURU-CHENNAI,91098,All
2018,1,BENGALURU,CHENNAI,46825,46690,BENGALURU-CHENNAI,93515,All
2018,2,BENGALURU,CHENNAI,50168,47750,BENGALURU-CHENNAI,97918,All
2018,3,BENGALURU,CHENNAI,62357,62619,BENGALURU-CHENNAI,124976,All
2018,4,BENGALURU,CHENNAI,57206,58756,BENGALURU-CHENNAI,115962,All
2018,5,BENGALURU,CHENNAI,50200,54998,BENGALURU-CHENNAI,105198,All
2018,6,BENGALURU,CHENNAI,51243,52782,BENGALURU-CHENNAI,104025,All
2018,7,BENGALURU,CHENNAI,56228,59782,BENGALURU-CHENNAI,116010,All
2018,8,BENGALURU,CHENNAI,55210,58082,BENGALURU-CHENNAI,113292,All
2018,9,BENGALURU,CHENNAI,54931,61414,BENGALURU-CHENNAI,116345,All
2018,10,BENGALURU,CHENNAI,60954,58703,BENGALURU-CHENNAI,119657,All
2018,11,BENGALURU,CHENNAI,54955,56660,BENGALURU-CHENNAI,111615,All
2018,12,BENGALURU,CHENNAI,62359,60586,BENGALURU-CHENNAI,122945,All
2019,1,BENGALURU,CHENNAI,60561,60527,BENGALURU-CHENNAI,121088,All
2019,2,BENGALURU,CHENNAI,59997,58912,BENGALURU-CHENNAI,118909,All
2019,3,BENGALURU,CHENNAI,57790,55770,BENGALURU-CHENNAI,113560,All
2019,4,BENGALURU,CHENNAI,56649,56929,BENGALURU-CHENNAI,113578,All
2019,5,BENGALURU,CHENNAI,61151,62915,BENGALURU-CHENNAI,124066,All
2019,6,BENGALURU,CHENNAI,63250,62406,BENGALURU-CHENNAI,125656,All
2019,7,BENGALURU,CHENNAI,62169,62969,BENGALURU-CHENNAI,125138,All
2019,8,BENGALURU,CHENNAI,61106,62993,BENGALURU-CHENNAI,124099,All
2019,9,BENGALURU,CHENNAI,57467,58181,BENGALURU-CHENNAI,115648,All
2019,10,BENGALURU,CHENNAI,58281,55112,BENGALURU-CHENNAI,113393,All
2019,11,BENGALURU,CHENNAI,53110,56859,BENGALURU-CHENNAI,109969,All
2019,12,BENGALURU,CHENNAI,56441,54862,BENGALURU-CHENNAI,111303,All
2020,1,BENGALURU,CHENNAI,52456,52137,BENGALURU-CHENNAI,104593,All
2020,2,BENGALURU,CHENNAI,51759,52562,BENGALURU-CHENNAI,104321,All
2020,3,BENGALURU,CHENNAI,29573,28836,BENGALURU-CHENNAI,58409,All
2020,4,BENGALURU,CHENNAI,0,0,BENGALURU-CHENNAI,0,All
2020,5,BENGALURU,CHENNAI,1162,1459,BENGALURU-CHENNAI,2621,All
2020,6,BENGALURU,CHENNAI,4775,5877,BENGALURU-CHENNAI,10652,All
2020,7,BENGALURU,CHENNAI,6516,5682,BENGALURU-CHENNAI,12198,All
2020,8,BENGALURU,CHENNAI,15825,11893,BENGALURU-CHENNAI,27718,All
2020,9,BENGALURU,CHENNAI,15638,15866,BENGALURU-CHENNAI,31504,All
2020,10,BENGALURU,CHENNAI,22957,21523,BENGALURU-CHENNAI,44480,All
2020,11,BENGALURU,CHENNAI,19604,20124,BENGALURU-CHENNAI,39728,All
2020,12,BENGALURU,CHENNAI,23405,26087,BENGALURU-CHENNAI,49492,All
2021,1,BENGALURU,CHENNAI,35754,34483,BENGALURU-CHENNAI,70237,All
2021,2,BENGALURU,CHENNAI,32268,33268,BENGALURU-CHENNAI,65536,All
2021,3,BENGALURU,CHENNAI,31832,34560,BENGALURU-CHENNAI,66392,All
2021,4,BENGALURU,CHENNAI,19016,20721,BENGALURU-CHENNAI,39737,All
2021,6,BENGALURU,CHENNAI,9911,11082,BENGALURU-CHENNAI,20993,All
2021,7,BENGALURU,CHENNAI,18666,22635,BENGALURU-CHENNAI,41301,All
2021,8,BENGALURU,CHENNAI,24602,27190,BENGALURU-CHENNAI,51792,All
2021,9,BENGALURU,CHENNAI,26266,28074,BENGALURU-CHENNAI,54340,All
2021,10,BENGALURU,CHENNAI,30995,30976,BENGALURU-CHENNAI,61971,All
2021,11,BENGALURU,CHENNAI,29607,33332,BENGALURU-CHENNAI,62939,All
2021,12,BENGALURU,CHENNAI,35992,36385,BENGALURU-CHENNAI,72377,All
2022,1,BENGALURU,CHENNAI,16491,16376,BENGALURU-CHENNAI,32867,All
2022,2,BENGALURU,CHENNAI,23405,23760,BENGALURU-CHENNAI,47165,All
2022,3,BENGALURU,CHENNAI,36935,40001,BENGALURU-CHENNAI,76936,All
2022,4,BENGALURU,CHENNAI,34192,35119,BENGALURU-CHENNAI,69311,All
2022,5,BENGALURU,CHENNAI,31665,36558,BENGALURU-CHENNAI,68223,All
2022,6,BENGALURU,CHENNAI,32228,32861,BENGALURU-CHENNAI,65089,All
2022,7,BENGALURU,CHENNAI,29978,31973,BENGALURU-CHENNAI,61951,All
2022,8,BENGALURU,CHENNAI,31602,33185,BENGALURU-CHENNAI,64787,All
2022,9,BENGALURU,CHENNAI,39744,42099,BENGALURU-CHENNAI,81843,All
2022,10,BENGALURU,CHENNAI,47760,47194,BENGALURU-CHENNAI,94954,All
2022,11,BENGALURU,CHENNAI,55570,61914,BENGALURU-CHENNAI,117484,All
2022,12,BENGALURU,CHENNAI,58571,60736,BENGALURU-CHENNAI,119307,All
2023,1,BENGALURU,CHENNAI,69533,68843,BENGALURU-CHENNAI,138376,All
2023,2,BENGALURU,CHENNAI,59915,62114,BENGALURU-CHENNAI,122029,All
2023,3,BENGALURU,CHENNAI,68535,70236,BENGALURU-CHENNAI,138771,All
2023,4,BENGALURU,CHENNAI,69784,68013,BENGALURU-CHENNAI,137797,All
2023,5,BENGALURU,CHENNAI,70038,73170,BENGALURU-CHENNAI,143208,All
2023,6,BENGALURU,CHENNAI,61275,61975,BENGALURU-CHENNAI,123250,All
2023,7,BENGALURU,CHENNAI,50295,50932,BENGALURU-CHENNAI,101227,All
2023,8,BENGALURU,CHENNAI,49061,48910,BENGALURU-CHENNAI,97971,All
2023,9,BENGALURU,CHENNAI,44929,45901,BENGALURU-CHENNAI,90830,All
2023,10,BENGALURU,CHENNAI,46560,44779,BENGALURU-CHENNAI,91339,All
2023,11,BENGALURU,CHENNAI,45379,47985,BENGALURU-CHENNAI,93364,All
2023,12,BENGALURU,CHENNAI,45905,48768,BENGALURU-CHENNAI,94673,All
2024,1,BENGALURU,CHENNAI,48808,51988,BENGALURU-CHENNAI,100796,All
2024,2,BENGALURU,CHENNAI,50428,54396,BENGALURU-CHENNAI,104824,All
2024,3,BENGALURU,CHENNAI,57872,58237,BENGALURU-CHENNAI,116109,All
2024,4,BENGALURU,CHENNAI,61328,60543,BENGALURU-CHENNAI,121871,All
2024,6,BENGALURU,CHENNAI,61002,61487,BENGALURU-CHENNAI,122489,All
2024,7,BENGALURU,CHENNAI,63975,63408,BENGALURU-CHENNAI,127383,All
2024,8,BENGALURU,CHENNAI,65548,65312,BENGALURU-CHENNAI,130860,All
2024,9,BENGALURU,CHENNAI,69705,69554,BENGALURU-CHENNAI,139259,All
2024,10,BENGALURU,CHENNAI,65638,62488,BENGALURU-CHENNAI,128126,All
2024,11,BENGALURU,CHENNAI,46712,50441,BENGALURU-CHENNAI,97153,All
2024,12,BENGALURU,CHENNAI,59701,59077,BENGALURU-CHENNAI,118778,All
2025,1,BENGALURU,CHENNAI,61468,63882,BENGALURU-CHENNAI,125350,All
2025,2,BENGALURU,CHENNAI,54317,55430,BENGALURU-CHENNAI,109747,All
2025,3,BENGALURU,CHENNAI,65189,67352,BENGALURU-CHENNAI,132541,All
2015,9,BENGALURU,COCHIN,7209,8458,BENGALURU-COCHIN,15667,All
2015,10,BENGALURU,COCHIN,8084,8263,BENGALURU-COCHIN,16347,All
2015,11,BENGALURU,COCHIN,6827,6960,BENGALURU-COCHIN,13787,All
2015,12,BENGALURU,COCHIN,0,15247,BENGALURU-COCHIN,15247,All
2016,1,BENGALURU,COCHIN,0,7446,BENGALURU-COCHIN,7446,All
2015,4,BENGALURU,COIMBATORE,6675,6544,BENGALURU-COIMBATORE,13219,All
2015,5,BENGALURU,COIMBATORE,6252,6380,BENGALURU-COIMBATORE,12632,All
2015,6,BENGALURU,COIMBATORE,5700,5440,BENGALURU-COIMBATORE,11140,All
2015,7,BENGALURU,COIMBATORE,6434,6071,BENGALURU-COIMBATORE,12505,All
2015,8,BENGALURU,COIMBATORE,6001,6528,BENGALURU-COIMBATORE,12529,All
2015,9,BENGALURU,COIMBATORE,4201,4549,BENGALURU-COIMBATORE,8750,All
2015,9,BENGALURU,COIMBATORE,1462,1744,BENGALURU-COIMBATORE,3206,All
2015,10,BENGALURU,COIMBATORE,5892,5494,BENGALURU-COIMBATORE,11386,All
2015,11,BENGALURU,COIMBATORE,5530,5404,BENGALURU-COIMBATORE,10934,All
2015,12,BENGALURU,COIMBATORE,6606,6170,BENGALURU-COIMBATORE,12776,All
2016,1,BENGALURU,COIMBATORE,6370,6363,BENGALURU-COIMBATORE,12733,All
2016,2,BENGALURU,COIMBATORE,7031,6887,BENGALURU-COIMBATORE,13918,All
2016,3,BENGALURU,COIMBATORE,7307,6899,BENGALURU-COIMBATORE,14206,All
2016,4,BENGALURU,COIMBATORE,9335,9424,BENGALURU-COIMBATORE,18759,All
2016,5,BENGALURU,COIMBATORE,11997,11754,BENGALURU-COIMBATORE,23751,All
2016,6,BENGALURU,COIMBATORE,11345,11337,BENGALURU-COIMBATORE,22682,All
2016,7,BENGALURU,COIMBATORE,11505,11084,BENGALURU-COIMBATORE,22589,All
2016,8,BENGALURU,COIMBATORE,10162,10680,BENGALURU-COIMBATORE,20842,All
2016,9,BENGALURU,COIMBATORE,8166,8936,BENGALURU-COIMBATORE,17102,All
2016,10,BENGALURU,COIMBATORE,6513,6096,BENGALURU-COIMBATORE,12609,All
2016,11,BENGALURU,COIMBATORE,6394,6839,BENGALURU-COIMBATORE,13233,All
2016,12,BENGALURU,COIMBATORE,6181,6333,BENGALURU-COIMBATORE,12514,All
2017,1,BENGALURU,COIMBATORE,6180,6405,BENGALURU-COIMBATORE,12585,All
2017,2,BENGALURU,COIMBATORE,5178,5447,BENGALURU-COIMBATORE,10625,All
2017,3,BENGALURU,COIMBATORE,4968,5146,BENGALURU-COIMBATORE,10114,All
2017,4,BENGALURU,COIMBATORE,3552,3616,BENGALURU-COIMBATORE,7168,All
2017,5,BENGALURU,COIMBATORE,5742,6390,BENGALURU-COIMBATORE,12132,All
2017,6,BENGALURU,COIMBATORE,5448,5863,BENGALURU-COIMBATORE,11311,All
2017,7,BENGALURU,COIMBATORE,6074,6231,BENGALURU-COIMBATORE,12305,All
2017,8,BENGALURU,COIMBATORE,6329,6507,BENGALURU-COIMBATORE,12836,All
2017,9,BENGALURU,COIMBATORE,5884,6304,BENGALURU-COIMBATORE,12188,All
2017,10,BENGALURU,COIMBATORE,7155,7026,BENGALURU-COIMBATORE,14181,All
2017,11,BENGALURU,COIMBATORE,8587,9757,BENGALURU-COIMBATORE,18344,All
2017,12,BENGALURU,COIMBATORE,10660,11090,BENGALURU-COIMBATORE,21750,All
2018,1,BENGALURU,COIMBATORE,17616,19186,BENGALURU-COIMBATORE,36802,All
2018,2,BENGALURU,COIMBATORE,16407,17978,BENGALURU-COIMBATORE,34385,All
2018,3,BENGALURU,COIMBATORE,14047,16142,BENGALURU-COIMBATORE,30189,All
2018,4,BENGALURU,COIMBATORE,16098,17389,BENGALURU-COIMBATORE,33487,All
2018,5,BENGALURU,COIMBATORE,16231,19120,BENGALURU-COIMBATORE,35351,All
2018,6,BENGALURU,COIMBATORE,15442,18023,BENGALURU-COIMBATORE,33465,All
2018,7,BENGALURU,COIMBATORE,12993,13617,BENGALURU-COIMBATORE,26610,All
2018,8,BENGALURU,COIMBATORE,11992,13619,BENGALURU-COIMBATORE,25611,All
2018,9,BENGALURU,COIMBATORE,11126,13035,BENGALURU-COIMBATORE,24161,All
2018,10,BENGALURU,COIMBATORE,12852,12807,BENGALURU-COIMBATORE,25659,All
2018,11,BENGALURU,COIMBATORE,15014,15167,BENGALURU-COIMBATORE,30181,All
2018,12,BENGALURU,COIMBATORE,15436,15862,BENGALURU-COIMBATORE,31298,All
2019,1,BENGALURU,COIMBATORE,13339,15345,BENGALURU-COIMBATORE,28684,All
2019,2,BENGALURU,COIMBATORE,11483,12996,BENGALURU-COIMBATORE,24479,All
2019,3,BENGALURU,COIMBATORE,16768,17148,BENGALURU-COIMBATORE,33916,All
2019,4,BENGALURU,COIMBATORE,18381,18832,BENGALURU-COIMBATORE,37213,All
2019,5,BENGALURU,COIMBATORE,19912,22112,BENGALURU-COIMBATORE,42024,All
2019,6,BENGALURU,COIMBATORE,16998,18673,BENGALURU-COIMBATORE,35671,All
2019,7,BENGALURU,COIMBATORE,19077,19931,BENGALURU-COIMBATORE,39008,All
2019,8,BENGALURU,COIMBATORE,18709,19703,BENGALURU-COIMBATORE,38412,All
2019,9,BENGALURU,COIMBATORE,15637,15657,BENGALURU-COIMBATORE,31294,All
2019,10,BENGALURU,COIMBATORE,15012,14884,BENGALURU-COIMBATORE,29896,All
2019,11,BENGALURU,COIMBATORE,14322,16300,BENGALURU-COIMBATORE,30622,All
2019,12,BENGALURU,COIMBATORE,16702,16327,BENGALURU-COIMBATORE,33029,All
2020,1,BENGALURU,COIMBATORE,14419,16025,BENGALURU-COIMBATORE,30444,All
2020,2,BENGALURU,COIMBATORE,12874,14052,BENGALURU-COIMBATORE,26926,All
2020,3,BENGALURU,COIMBATORE,6257,6378,BENGALURU-COIMBATORE,12635,All
2020,5,BENGALURU,COIMBATORE,785,408,BENGALURU-COIMBATORE,1193,All
2020,6,BENGALURU,COIMBATORE,1828,1899,BENGALURU-COIMBATORE,3727,All
2020,7,BENGALURU,COIMBATORE,2142,1822,BENGALURU-COIMBATORE,3964,All
2020,8,BENGALURU,COIMBATORE,3515,2374,BENGALURU-COIMBATORE,5889,All
2020,9,BENGALURU,COIMBATORE,6266,5863,BENGALURU-COIMBATORE,12129,All
2020,10,BENGALURU,COIMBATORE,7680,8953,BENGALURU-COIMBATORE,16633,All
2020,11,BENGALURU,COIMBATORE,6485,9725,BENGALURU-COIMBATORE,16210,All
2020,12,BENGALURU,COIMBATORE,7096,8641,BENGALURU-COIMBATORE,15737,All
2021,1,BENGALURU,COIMBATORE,6199,8745,BENGALURU-COIMBATORE,14944,All
2021,2,BENGALURU,COIMBATORE,6320,8501,BENGALURU-COIMBATORE,14821,All
2021,3,BENGALURU,COIMBATORE,6386,8984,BENGALURU-COIMBATORE,15370,All
2021,4,BENGALURU,COIMBATORE,5100,4341,BENGALURU-COIMBATORE,9441,All
2021,6,BENGALURU,COIMBATORE,2177,2058,BENGALURU-COIMBATORE,4235,All
2021,7,BENGALURU,COIMBATORE,4627,5636,BENGALURU-COIMBATORE,10263,All
2021,8,BENGALURU,COIMBATORE,5479,8013,BENGALURU-COIMBATORE,13492,All
2021,9,BENGALURU,COIMBATORE,5752,7675,BENGALURU-COIMBATORE,13427,All
2021,10,BENGALURU,COIMBATORE,8308,9454,BENGALURU-COIMBATORE,17762,All
2021,11,BENGALURU,COIMBATORE,10455,12112,BENGALURU-COIMBATORE,22567,All
2021,12,BENGALURU,COIMBATORE,11878,11207,BENGALURU-COIMBATORE,23085,All
2022,1,BENGALURU,COIMBATORE,5391,6912,BENGALURU-COIMBATORE,12303,All
2022,2,BENGALURU,COIMBATORE,7332,6903,BENGALURU-COIMBATORE,14235,All
2022,3,BENGALURU,COIMBATORE,10387,11836,BENGALURU-COIMBATORE,22223,All
2022,4,BENGALURU,COIMBATORE,10004,11121,BENGALURU-COIMBATORE,21125,All
2022,5,BENGALURU,COIMBATORE,12211,13898,BENGALURU-COIMBATORE,26109,All
2022,6,BENGALURU,COIMBATORE,12769,13453,BENGALURU-COIMBATORE,26222,All
2022,7,BENGALURU,COIMBATORE,11896,13143,BENGALURU-COIMBATORE,25039,All
2022,8,BENGALURU,COIMBATORE,12176,13447,BENGALURU-COIMBATORE,25623,All
2022,9,BENGALURU,COIMBATORE,8744,9899,BENGALURU-COIMBATORE,18643,All
2022,10,BENGALURU,COIMBATORE,8923,9749,BENGALURU-COIMBATORE,18672,All
2022,11,BENGALURU,COIMBATORE,12899,14926,BENGALURU-COIMBATORE,27825,All
2022,12,BENGALURU,COIMBATORE,15508,14935,BENGALURU-COIMBATORE,30443,All
2023,1,BENGALURU,COIMBATORE,12510,14012,BENGALURU-COIMBATORE,26522,All
2023,2,BENGALURU,COIMBATORE,10969,11103,BENGALURU-COIMBATORE,22072,All
2023,3,BENGALURU,COIMBATORE,14303,14671,BENGALURU-COIMBATORE,28974,All
2023,4,BENGALURU,COIMBATORE,13224,14143,BENGALURU-COIMBATORE,27367,All
2023,5,BENGALURU,COIMBATORE,14395,15049,BENGALURU-COIMBATORE,29444,All
2023,6,BENGALURU,COIMBATORE,11969,12234,BENGALURU-COIMBATORE,24203,All
2023,7,BENGALURU,COIMBATORE,13399,14850,BENGALURU-COIMBATORE,28249,All
2023,8,BENGALURU,COIMBATORE,13154,14485,BENGALURU-COIMBATORE,27639,All
2023,9,BENGALURU,COIMBATORE,14038,16673,BENGALURU-COIMBATORE,30711,All
2023,10,BENGALURU,COIMBATORE,14407,13885,BENGALURU-COIMBATORE,28292,All
2023,11,BENGALURU,COIMBATORE,12564,12917,BENGALURU-COIMBATORE,25481,All
2023,12,BENGALURU,COIMBATORE,13149,13039,BENGALURU-COIMBATORE,26188,All
2024,1,BENGALURU,COIMBATORE,9083,10012,BENGALURU-COIMBATORE,19095,All
2024,2,BENGALURU,COIMBATORE,8591,8454,BENGALURU-COIMBATORE,17045,All
2024,3,BENGALURU,COIMBATORE,10219,10263,BENGALURU-COIMBATORE,20482,All
2024,4,BENGALURU,COIMBATORE,12571,13298,BENGALURU-COIMBATORE,25869,All
2024,6,BENGALURU,COIMBATORE,15559,16542,BENGALURU-COIMBATORE,32101,All
2024,7,BENGALURU,COIMBATORE,13768,14065,BENGALURU-COIMBATORE,27833,All
2024,8,BENGALURU,COIMBATORE,15046,16049,BENGALURU-COIMBATORE,31095,All
2024,9,BENGALURU,COIMBATORE,14334,15472,BENGALURU-COIMBATORE,29806,All
2024,10,BENGALURU,COIMBATORE,14997,12892,BENGALURU-COIMBATORE,27889,All
2024,11,BENGALURU,COIMBATORE,13893,16051,BENGALURU-COIMBATORE,29944,All
2024,12,BENGALURU,COIMBATORE,16913,14511,BENGALURU-COIMBATORE,31424,All
2025,1,BENGALURU,COIMBATORE,16506,16860,BENGALURU-COIMBATORE,33366,All
2025,2,BENGALURU,COIMBATORE,16380,16066,BENGALURU-COIMBATORE,32446,All
2025,3,BENGALURU,COIMBATORE,17441,18154,BENGALURU-COIMBATORE,35595,All
2015,6,BENGALURU,CUDDAPAH,268,389,BENGALURU-CUDDAPAH,657,All
2015,7,BENGALURU,CUDDAPAH,380,489,BENGALURU-CUDDAPAH,869,All
2015,8,BENGALURU,CUDDAPAH,204,233,BENGALURU-CUDDAPAH,437,All
2023,1,BENGALURU,Cuddapah,312,483,BENGALURU-Cuddapah,795,All
2023,6,BENGALURU,Cuddapah,394,389,BENGALURU-Cuddapah,783,All
2023,7,BENGALURU,Cuddapah,330,454,BENGALURU-Cuddapah,784,All
2023,8,BENGALURU,Cuddapah,401,448,BENGALURU-Cuddapah,849,All
2023,9,BENGALURU,Cuddapah,297,392,BENGALURU-Cuddapah,689,All
2023,10,BENGALURU,Cuddapah,317,296,BENGALURU-Cuddapah,613,All
2023,11,BENGALURU,Cuddapah,310,406,BENGALURU-Cuddapah,716,All
2023,12,BENGALURU,Cuddapah,298,318,BENGALURU-Cuddapah,616,All
2024,1,BENGALURU,Cuddapah,406,532,BENGALURU-Cuddapah,938,All
2024,2,BENGALURU,Cuddapah,483,611,BENGALURU-Cuddapah,1094,All
2024,3,BENGALURU,Cuddapah,398,526,BENGALURU-Cuddapah,924,All
2024,4,BENGALURU,Cuddapah,448,478,BENGALURU-Cuddapah,926,All
2024,6,BENGALURU,Cuddapah,513,594,BENGALURU-Cuddapah,1107,All
2024,7,BENGALURU,Cuddapah,426,580,BENGALURU-Cuddapah,1006,All
2024,8,BENGALURU,Cuddapah,543,596,BENGALURU-Cuddapah,1139,All
2024,9,BENGALURU,Cuddapah,401,546,BENGALURU-Cuddapah,947,All
2024,10,BENGALURU,Cuddapah,279,317,BENGALURU-Cuddapah,596,All
2019,1,BENGALURU,DABOLIM,44730,47936,BENGALURU-DABOLIM,92666,All
2019,2,BENGALURU,DABOLIM,41071,41721,BENGALURU-DABOLIM,82792,All
2019,3,BENGALURU,DABOLIM,44593,43178,BENGALURU-DABOLIM,87771,All
2019,4,BENGALURU,DABOLIM,42054,42610,BENGALURU-DABOLIM,84664,All
2019,5,BENGALURU,DABOLIM,42266,46137,BENGALURU-DABOLIM,88403,All
2019,6,BENGALURU,DABOLIM,37698,39818,BENGALURU-DABOLIM,77516,All
2019,7,BENGALURU,DABOLIM,42204,43988,BENGALURU-DABOLIM,86192,All
2019,8,BENGALURU,DABOLIM,44035,42495,BENGALURU-DABOLIM,86530,All
2019,9,BENGALURU,DABOLIM,42562,41181,BENGALURU-DABOLIM,83743,All
2019,10,BENGALURU,DABOLIM,48397,47788,BENGALURU-DABOLIM,96185,All
2019,11,BENGALURU,DABOLIM,47796,48639,BENGALURU-DABOLIM,96435,All
2019,12,BENGALURU,DABOLIM,50385,49525,BENGALURU-DABOLIM,99910,All
2020,1,BENGALURU,DABOLIM,48311,51803,BENGALURU-DABOLIM,100114,All
2020,2,BENGALURU,DABOLIM,46080,48779,BENGALURU-DABOLIM,94859,All
2020,3,BENGALURU,DABOLIM,24151,28425,BENGALURU-DABOLIM,52576,All
2020,5,BENGALURU,DABOLIM,313,406,BENGALURU-DABOLIM,719,All
2020,6,BENGALURU,DABOLIM,1315,2842,BENGALURU-DABOLIM,4157,All
2020,7,BENGALURU,DABOLIM,1733,3076,BENGALURU-DABOLIM,4809,All
2020,8,BENGALURU,DABOLIM,3885,3403,BENGALURU-DABOLIM,7288,All
2020,9,BENGALURU,DABOLIM,6753,5361,BENGALURU-DABOLIM,12114,All
2020,10,BENGALURU,DABOLIM,18626,13947,BENGALURU-DABOLIM,32573,All
2020,11,BENGALURU,DABOLIM,24966,22743,BENGALURU-DABOLIM,47709,All
2020,12,BENGALURU,DABOLIM,32724,25940,BENGALURU-DABOLIM,58664,All
2021,1,BENGALURU,DABOLIM,34764,36763,BENGALURU-DABOLIM,71527,All
2021,2,BENGALURU,DABOLIM,35383,34680,BENGALURU-DABOLIM,70063,All
2021,3,BENGALURU,DABOLIM,34236,37037,BENGALURU-DABOLIM,71273,All
2021,4,BENGALURU,DABOLIM,19597,22030,BENGALURU-DABOLIM,41627,All
2021,6,BENGALURU,DABOLIM,1718,1876,BENGALURU-DABOLIM,3594,All
2021,7,BENGALURU,DABOLIM,7236,6496,BENGALURU-DABOLIM,13732,All
2021,8,BENGALURU,DABOLIM,17736,16768,BENGALURU-DABOLIM,34504,All
2021,9,BENGALURU,DABOLIM,27871,24566,BENGALURU-DABOLIM,52437,All
2021,10,BENGALURU,DABOLIM,43242,41410,BENGALURU-DABOLIM,84652,All
2021,11,BENGALURU,DABOLIM,42345,45758,BENGALURU-DABOLIM,88103,All
2021,12,BENGALURU,DABOLIM,53748,48636,BENGALURU-DABOLIM,102384,All
2022,1,BENGALURU,DABOLIM,18477,25767,BENGALURU-DABOLIM,44244,All
2022,2,BENGALURU,DABOLIM,26087,23133,BENGALURU-DABOLIM,49220,All
2022,3,BENGALURU,DABOLIM,47782,49903,BENGALURU-DABOLIM,97685,All
2022,4,BENGALURU,DABOLIM,39950,40335,BENGALURU-DABOLIM,80285,All
2022,5,BENGALURU,DABOLIM,42483,47418,BENGALURU-DABOLIM,89901,All
2022,6,BENGALURU,DABOLIM,35992,36830,BENGALURU-DABOLIM,72822,All
2022,7,BENGALURU,DABOLIM,34059,35482,BENGALURU-DABOLIM,69541,All
2022,8,BENGALURU,DABOLIM,39142,39947,BENGALURU-DABOLIM,79089,All
2022,9,BENGALURU,DABOLIM,42082,40137,BENGALURU-DABOLIM,82219,All
2022,10,BENGALURU,DABOLIM,50983,49611,BENGALURU-DABOLIM,100594,All
2022,11,BENGALURU,DABOLIM,43177,43840,BENGALURU-DABOLIM,87017,All
2022,12,BENGALURU,DABOLIM,53529,52358,BENGALURU-DABOLIM,105887,All
2023,1,BENGALURU,DABOLIM,41393,47313,BENGALURU-DABOLIM,88706,All
2023,2,BENGALURU,DABOLIM,36429,35734,BENGALURU-DABOLIM,72163,All
2023,3,BENGALURU,DABOLIM,40098,40839,BENGALURU-DABOLIM,80937,All
2023,4,BENGALURU,DABOLIM,51597,50454,BENGALURU-DABOLIM,102051,All
2023,5,BENGALURU,DABOLIM,46694,50314,BENGALURU-DABOLIM,97008,All
2023,6,BENGALURU,DABOLIM,38435,40521,BENGALURU-DABOLIM,78956,All
2023,7,BENGALURU,DABOLIM,36397,41063,BENGALURU-DABOLIM,77460,All
2023,8,BENGALURU,DABOLIM,40200,39916,BENGALURU-DABOLIM,80116,All
2023,9,BENGALURU,DABOLIM,39942,39158,BENGALURU-DABOLIM,79100,All
2023,10,BENGALURU,DABOLIM,42283,42593,BENGALURU-DABOLIM,84876,All
2023,11,BENGALURU,DABOLIM,37038,37418,BENGALURU-DABOLIM,74456,All
2023,12,BENGALURU,DABOLIM,48238,49404,BENGALURU-DABOLIM,97642,All
2024,1,BENGALURU,DABOLIM,46358,49166,BENGALURU-DABOLIM,95524,All
2024,2,BENGALURU,DABOLIM,42983,44592,BENGALURU-DABOLIM,87575,All
2024,3,BENGALURU,DABOLIM,41088,41633,BENGALURU-DABOLIM,82721,All
2024,4,BENGALURU,DABOLIM,43250,44275,BENGALURU-DABOLIM,87525,All
2024,6,BENGALURU,DABOLIM,35693,38389,BENGALURU-DABOLIM,74082,All
2024,7,BENGALURU,DABOLIM,33864,36460,BENGALURU-DABOLIM,70324,All
2024,8,BENGALURU,DABOLIM,43212,43169,BENGALURU-DABOLIM,86381,All
2024,9,BENGALURU,DABOLIM,50107,52167,BENGALURU-DABOLIM,102274,All
2024,10,BENGALURU,DABOLIM,54730,53416,BENGALURU-DABOLIM,108146,All
2024,11,BENGALURU,DABOLIM,50162,52481,BENGALURU-DABOLIM,102643,All
2024,12,BENGALURU,DABOLIM,62573,60309,BENGALURU-DABOLIM,122882,All
2025,1,BENGALURU,DABOLIM,55302,58352,BENGALURU-DABOLIM,113654,All
2025,2,BENGALURU,DABOLIM,50139,51306,BENGALURU-DABOLIM,101445,All
2025,3,BENGALURU,DABOLIM,52180,52985,BENGALURU-DABOLIM,105165,All
2020,11,BENGALURU,DARBHANGA,4144,3995,BENGALURU-DARBHANGA,8139,All
2020,12,BENGALURU,DARBHANGA,3526,4078,BENGALURU-DARBHANGA,7604,All
2021,1,BENGALURU,DARBHANGA,2854,3706,BENGALURU-DARBHANGA,6560,All
2021,2,BENGALURU,DARBHANGA,4504,4808,BENGALURU-DARBHANGA,9312,All
2021,3,BENGALURU,DARBHANGA,5141,5123,BENGALURU-DARBHANGA,10264,All
2021,4,BENGALURU,DARBHANGA,5361,4438,BENGALURU-DARBHANGA,9799,All
2021,6,BENGALURU,DARBHANGA,4768,8401,BENGALURU-DARBHANGA,13169,All
2021,7,BENGALURU,DARBHANGA,6774,11769,BENGALURU-DARBHANGA,18543,All
2021,8,BENGALURU,DARBHANGA,6774,10503,BENGALURU-DARBHANGA,17277,All
2021,9,BENGALURU,DARBHANGA,6080,7212,BENGALURU-DARBHANGA,13292,All
2021,10,BENGALURU,DARBHANGA,10056,7758,BENGALURU-DARBHANGA,17814,All
2021,11,BENGALURU,DARBHANGA,10884,9751,BENGALURU-DARBHANGA,20635,All
2021,12,BENGALURU,DARBHANGA,7084,10362,BENGALURU-DARBHANGA,17446,All
2022,1,BENGALURU,DARBHANGA,4732,3717,BENGALURU-DARBHANGA,8449,All
2022,2,BENGALURU,DARBHANGA,4506,4847,BENGALURU-DARBHANGA,9353,All
2022,3,BENGALURU,DARBHANGA,5756,6220,BENGALURU-DARBHANGA,11976,All
2022,4,BENGALURU,DARBHANGA,10323,8894,BENGALURU-DARBHANGA,19217,All
2022,5,BENGALURU,DARBHANGA,8207,10971,BENGALURU-DARBHANGA,19178,All
2022,6,BENGALURU,DARBHANGA,8647,10855,BENGALURU-DARBHANGA,19502,All
2022,7,BENGALURU,DARBHANGA,7064,7572,BENGALURU-DARBHANGA,14636,All
2022,8,BENGALURU,DARBHANGA,4781,5163,BENGALURU-DARBHANGA,9944,All
2022,9,BENGALURU,DARBHANGA,5006,3872,BENGALURU-DARBHANGA,8878,All
2022,10,BENGALURU,DARBHANGA,8231,5808,BENGALURU-DARBHANGA,14039,All
2022,11,BENGALURU,DARBHANGA,5851,5671,BENGALURU-DARBHANGA,11522,All
2022,12,BENGALURU,DARBHANGA,5572,5575,BENGALURU-DARBHANGA,11147,All
2023,1,BENGALURU,DARBHANGA,5399,4957,BENGALURU-DARBHANGA,10356,All
2023,2,BENGALURU,DARBHANGA,5903,5148,BENGALURU-DARBHANGA,11051,All
2023,3,BENGALURU,DARBHANGA,6341,5575,BENGALURU-DARBHANGA,11916,All
2023,4,BENGALURU,DARBHANGA,6285,5633,BENGALURU-DARBHANGA,11918,All
2023,5,BENGALURU,DARBHANGA,5615,5603,BENGALURU-DARBHANGA,11218,All
2023,6,BENGALURU,DARBHANGA,87,120,BENGALURU-DARBHANGA,207,All
2023,7,BENGALURU,DARBHANGA,4322,4843,BENGALURU-DARBHANGA,9165,All
2023,8,BENGALURU,DARBHANGA,3571,3491,BENGALURU-DARBHANGA,7062,All
2023,9,BENGALURU,DARBHANGA,3721,3525,BENGALURU-DARBHANGA,7246,All
2023,10,BENGALURU,DARBHANGA,4797,3829,BENGALURU-DARBHANGA,8626,All
2023,11,BENGALURU,DARBHANGA,5645,4812,BENGALURU-DARBHANGA,10457,All
2023,12,BENGALURU,DARBHANGA,5366,5778,BENGALURU-DARBHANGA,11144,All
2024,1,BENGALURU,DARBHANGA,3613,3651,BENGALURU-DARBHANGA,7264,All
2024,2,BENGALURU,DARBHANGA,127,195,BENGALURU-DARBHANGA,322,All
2024,3,BENGALURU,DARBHANGA,288,244,BENGALURU-DARBHANGA,532,All
2024,4,BENGALURU,DARBHANGA,304,364,BENGALURU-DARBHANGA,668,All
2024,6,BENGALURU,DARBHANGA,621,574,BENGALURU-DARBHANGA,1195,All
2024,7,BENGALURU,DARBHANGA,399,387,BENGALURU-DARBHANGA,786,All
2024,8,BENGALURU,DARBHANGA,395,343,BENGALURU-DARBHANGA,738,All
2024,9,BENGALURU,DARBHANGA,373,265,BENGALURU-DARBHANGA,638,All
2024,10,BENGALURU,DARBHANGA,1470,585,BENGALURU-DARBHANGA,2055,All
2024,11,BENGALURU,DARBHANGA,3666,4612,BENGALURU-DARBHANGA,8278,All
2024,12,BENGALURU,DARBHANGA,4168,5085,BENGALURU-DARBHANGA,9253,All
2025,1,BENGALURU,DARBHANGA,1689,2505,BENGALURU-DARBHANGA,4194,All
2025,3,BENGALURU,DARBHANGA,5014,4277,BENGALURU-DARBHANGA,9291,All
2015,4,BENGALURU,DEHRA DUN,931,930,BENGALURU-DEHRA DUN,1861,All
2015,5,BENGALURU,DEHRA DUN,985,1055,BENGALURU-DEHRA DUN,2040,All
2015,6,BENGALURU,DEHRA DUN,481,652,BENGALURU-DEHRA DUN,1133,All
2015,7,BENGALURU,DEHRA DUN,478,497,BENGALURU-DEHRA DUN,975,All
2015,8,BENGALURU,DEHRA DUN,271,351,BENGALURU-DEHRA DUN,622,All
2015,9,BENGALURU,DEHRA DUN,290,304,BENGALURU-DEHRA DUN,594,All
2015,10,BENGALURU,DEHRA DUN,410,503,BENGALURU-DEHRA DUN,913,All
2015,11,BENGALURU,DEHRA DUN,616,737,BENGALURU-DEHRA DUN,1353,All
2015,12,BENGALURU,DEHRA DUN,432,506,BENGALURU-DEHRA DUN,938,All
2016,1,BENGALURU,DEHRA DUN,340,537,BENGALURU-DEHRA DUN,877,All
2016,2,BENGALURU,DEHRA DUN,307,269,BENGALURU-DEHRA DUN,576,All
2016,3,BENGALURU,DEHRA DUN,537,557,BENGALURU-DEHRA DUN,1094,All
2016,4,BENGALURU,DEHRA DUN,332,393,BENGALURU-DEHRA DUN,725,All
2016,5,BENGALURU,DEHRA DUN,695,843,BENGALURU-DEHRA DUN,1538,All
2016,6,BENGALURU,DEHRA DUN,600,680,BENGALURU-DEHRA DUN,1280,All
2016,7,BENGALURU,DEHRA DUN,519,414,BENGALURU-DEHRA DUN,933,All
2016,8,BENGALURU,DEHRA DUN,306,362,BENGALURU-DEHRA DUN,668,All
2016,9,BENGALURU,DEHRA DUN,264,256,BENGALURU-DEHRA DUN,520,All
2016,10,BENGALURU,DEHRA DUN,416,400,BENGALURU-DEHRA DUN,816,All
2016,11,BENGALURU,DEHRA DUN,515,439,BENGALURU-DEHRA DUN,954,All
2016,12,BENGALURU,DEHRA DUN,756,815,BENGALURU-DEHRA DUN,1571,All
2017,1,BENGALURU,DEHRA DUN,724,784,BENGALURU-DEHRA DUN,1508,All
2017,2,BENGALURU,DEHRA DUN,362,484,BENGALURU-DEHRA DUN,846,All
2017,3,BENGALURU,DEHRA DUN,0,421,BENGALURU-DEHRA DUN,421,All
2017,4,BENGALURU,DEHRA DUN,0,554,BENGALURU-DEHRA DUN,554,All
2017,5,BENGALURU,DEHRA DUN,447,652,BENGALURU-DEHRA DUN,1099,All
2017,6,BENGALURU,DEHRA DUN,699,377,BENGALURU-DEHRA DUN,1076,All
2017,7,BENGALURU,DEHRA DUN,482,388,BENGALURU-DEHRA DUN,870,All
2017,8,BENGALURU,DEHRA DUN,310,237,BENGALURU-DEHRA DUN,547,All
2017,9,BENGALURU,DEHRA DUN,938,664,BENGALURU-DEHRA DUN,1602,All
2017,10,BENGALURU,DEHRA DUN,1553,1679,BENGALURU-DEHRA DUN,3232,All
2017,11,BENGALURU,DEHRA DUN,2599,2155,BENGALURU-DEHRA DUN,4754,All
2017,12,BENGALURU,DEHRA DUN,3663,3551,BENGALURU-DEHRA DUN,7214,All
2018,1,BENGALURU,DEHRA DUN,5191,5629,BENGALURU-DEHRA DUN,10820,All
2018,2,BENGALURU,DEHRA DUN,5211,4777,BENGALURU-DEHRA DUN,9988,All
2018,3,BENGALURU,DEHRA DUN,5128,5303,BENGALURU-DEHRA DUN,10431,All
2018,4,BENGALURU,DEHRA DUN,5418,5127,BENGALURU-DEHRA DUN,10545,All
2018,5,BENGALURU,DEHRA DUN,4999,5167,BENGALURU-DEHRA DUN,10166,All
2018,6,BENGALURU,DEHRA DUN,4747,4935,BENGALURU-DEHRA DUN,9682,All
2018,7,BENGALURU,DEHRA DUN,4397,3809,BENGALURU-DEHRA DUN,8206,All
2018,8,BENGALURU,DEHRA DUN,3542,3402,BENGALURU-DEHRA DUN,6944,All
2018,9,BENGALURU,DEHRA DUN,4377,3761,BENGALURU-DEHRA DUN,8138,All
2018,10,BENGALURU,DEHRA DUN,4159,4127,BENGALURU-DEHRA DUN,8286,All
2018,11,BENGALURU,DEHRA DUN,4255,4784,BENGALURU-DEHRA DUN,9039,All
2018,12,BENGALURU,DEHRA DUN,4805,5475,BENGALURU-DEHRA DUN,10280,All
2019,1,BENGALURU,DEHRA DUN,4833,4707,BENGALURU-DEHRA DUN,9540,All
2019,2,BENGALURU,DEHRA DUN,4406,4291,BENGALURU-DEHRA DUN,8697,All
2019,3,BENGALURU,DEHRA DUN,5252,5158,BENGALURU-DEHRA DUN,10410,All
2019,4,BENGALURU,DEHRA DUN,5006,4654,BENGALURU-DEHRA DUN,9660,All
2019,5,BENGALURU,DEHRA DUN,5026,5293,BENGALURU-DEHRA DUN,10319,All
2019,6,BENGALURU,DEHRA DUN,5056,5354,BENGALURU-DEHRA DUN,10410,All
2019,7,BENGALURU,DEHRA DUN,4258,4379,BENGALURU-DEHRA DUN,8637,All
2019,8,BENGALURU,DEHRA DUN,4652,4713,BENGALURU-DEHRA DUN,9365,All
2019,9,BENGALURU,DEHRA DUN,4184,3919,BENGALURU-DEHRA DUN,8103,All
2019,10,BENGALURU,DEHRA DUN,4810,4507,BENGALURU-DEHRA DUN,9317,All
2019,11,BENGALURU,DEHRA DUN,4435,4581,BENGALURU-DEHRA DUN,9016,All
2019,12,BENGALURU,DEHRA DUN,4490,5006,BENGALURU-DEHRA DUN,9496,All
2020,1,BENGALURU,DEHRA DUN,4631,4731,BENGALURU-DEHRA DUN,9362,All
2020,2,BENGALURU,DEHRA DUN,4935,4474,BENGALURU-DEHRA DUN,9409,All
2020,3,BENGALURU,DEHRA DUN,3406,3233,BENGALURU-DEHRA DUN,6639,All
2020,6,BENGALURU,DEHRA DUN,1566,892,BENGALURU-DEHRA DUN,2458,All
2020,7,BENGALURU,DEHRA DUN,2213,1067,BENGALURU-DEHRA DUN,3280,All
2020,8,BENGALURU,DEHRA DUN,2075,1424,BENGALURU-DEHRA DUN,3499,All
2020,9,BENGALURU,DEHRA DUN,1917,1728,BENGALURU-DEHRA DUN,3645,All
2020,10,BENGALURU,DEHRA DUN,3299,2245,BENGALURU-DEHRA DUN,5544,All
2020,11,BENGALURU,DEHRA DUN,4494,3895,BENGALURU-DEHRA DUN,8389,All
2020,12,BENGALURU,DEHRA DUN,4436,5128,BENGALURU-DEHRA DUN,9564,All
2021,1,BENGALURU,DEHRA DUN,3878,4455,BENGALURU-DEHRA DUN,8333,All
2021,2,BENGALURU,DEHRA DUN,4349,3886,BENGALURU-DEHRA DUN,8235,All
2021,3,BENGALURU,DEHRA DUN,5357,4487,BENGALURU-DEHRA DUN,9844,All
2021,4,BENGALURU,DEHRA DUN,3607,3064,BENGALURU-DEHRA DUN,6671,All
2021,6,BENGALURU,DEHRA DUN,484,511,BENGALURU-DEHRA DUN,995,All
2021,7,BENGALURU,DEHRA DUN,1666,1886,BENGALURU-DEHRA DUN,3552,All
2021,8,BENGALURU,DEHRA DUN,2817,2743,BENGALURU-DEHRA DUN,5560,All
2021,9,BENGALURU,DEHRA DUN,2780,2467,BENGALURU-DEHRA DUN,5247,All
2021,10,BENGALURU,DEHRA DUN,5014,4130,BENGALURU-DEHRA DUN,9144,All
2021,11,BENGALURU,DEHRA DUN,4153,4180,BENGALURU-DEHRA DUN,8333,All
2021,12,BENGALURU,DEHRA DUN,4031,4431,BENGALURU-DEHRA DUN,8462,All
2022,1,BENGALURU,DEHRA DUN,2701,2647,BENGALURU-DEHRA DUN,5348,All
2022,2,BENGALURU,DEHRA DUN,2850,2623,BENGALURU-DEHRA DUN,5473,All
2022,3,BENGALURU,DEHRA DUN,4792,4570,BENGALURU-DEHRA DUN,9362,All
2022,4,BENGALURU,DEHRA DUN,4822,4754,BENGALURU-DEHRA DUN,9576,All
2022,5,BENGALURU,DEHRA DUN,8778,9094,BENGALURU-DEHRA DUN,17872,All
2022,6,BENGALURU,DEHRA DUN,8678,9609,BENGALURU-DEHRA DUN,18287,All
2022,7,BENGALURU,DEHRA DUN,6367,7093,BENGALURU-DEHRA DUN,13460,All
2022,8,BENGALURU,DEHRA DUN,4833,4660,BENGALURU-DEHRA DUN,9493,All
2022,9,BENGALURU,DEHRA DUN,5163,4495,BENGALURU-DEHRA DUN,9658,All
2022,10,BENGALURU,DEHRA DUN,10085,9646,BENGALURU-DEHRA DUN,19731,All
2022,11,BENGALURU,DEHRA DUN,4423,4361,BENGALURU-DEHRA DUN,8784,All
2022,12,BENGALURU,DEHRA DUN,4055,4243,BENGALURU-DEHRA DUN,8298,All
2023,2,BENGALURU,DEHRA DUN,4457,4086,BENGALURU-DEHRA DUN,8543,All
2023,3,BENGALURU,DEHRA DUN,4783,4551,BENGALURU-DEHRA DUN,9334,All
2023,4,BENGALURU,DEHRA DUN,5124,4784,BENGALURU-DEHRA DUN,9908,All
2023,5,BENGALURU,DEHRA DUN,5482,5564,BENGALURU-DEHRA DUN,11046,All
2015,4,BENGALURU,DELHI,125123,114390,BENGALURU-DELHI,239513,All
2015,5,BENGALURU,DELHI,118191,140253,BENGALURU-DELHI,258444,All
2015,6,BENGALURU,DELHI,130835,135306,BENGALURU-DELHI,266141,All
2015,7,BENGALURU,DELHI,140822,140945,BENGALURU-DELHI,281767,All
2015,8,BENGALURU,DELHI,139728,138294,BENGALURU-DELHI,278022,All
2015,9,BENGALURU,DELHI,74793,74111,BENGALURU-DELHI,148904,All
2015,9,BENGALURU,DELHI,55104,51644,BENGALURU-DELHI,106748,All
2015,10,BENGALURU,DELHI,129563,119288,BENGALURU-DELHI,248851,All
2015,11,BENGALURU,DELHI,145466,146834,BENGALURU-DELHI,292300,All
2015,12,BENGALURU,DELHI,156196,163789,BENGALURU-DELHI,319985,All
2016,1,BENGALURU,DELHI,147684,141710,BENGALURU-DELHI,289394,All
2016,2,BENGALURU,DELHI,150014,147722,BENGALURU-DELHI,297736,All
2016,3,BENGALURU,DELHI,153796,145566,BENGALURU-DELHI,299362,All
2016,4,BENGALURU,DELHI,170267,157947,BENGALURU-DELHI,328214,All
2016,5,BENGALURU,DELHI,157554,179085,BENGALURU-DELHI,336639,All
2016,6,BENGALURU,DELHI,161308,170270,BENGALURU-DELHI,331578,All
2016,7,BENGALURU,DELHI,178709,182931,BENGALURU-DELHI,361640,All
2016,8,BENGALURU,DELHI,171584,172947,BENGALURU-DELHI,344531,All
2016,9,BENGALURU,DELHI,168280,158778,BENGALURU-DELHI,327058,All
2016,10,BENGALURU,DELHI,185858,162145,BENGALURU-DELHI,348003,All
2016,11,BENGALURU,DELHI,161657,176316,BENGALURU-DELHI,337973,All
2016,12,BENGALURU,DELHI,172364,180619,BENGALURU-DELHI,352983,All
2017,1,BENGALURU,DELHI,176753,170122,BENGALURU-DELHI,346875,All
2017,2,BENGALURU,DELHI,158477,148867,BENGALURU-DELHI,307344,All
2017,3,BENGALURU,DELHI,156713,152664,BENGALURU-DELHI,309377,All
2017,4,BENGALURU,DELHI,167233,150920,BENGALURU-DELHI,318153,All
2017,5,BENGALURU,DELHI,167769,190445,BENGALURU-DELHI,358214,All
2017,6,BENGALURU,DELHI,171411,175722,BENGALURU-DELHI,347133,All
2017,7,BENGALURU,DELHI,175434,180114,BENGALURU-DELHI,355548,All
2017,8,BENGALURU,DELHI,175467,176752,BENGALURU-DELHI,352219,All
2017,9,BENGALURU,DELHI,182580,169772,BENGALURU-DELHI,352352,All
2017,10,BENGALURU,DELHI,186427,185120,BENGALURU-DELHI,371547,All
2017,11,BENGALURU,DELHI,179656,178576,BENGALURU-DELHI,358232,All
2017,12,BENGALURU,DELHI,182549,192829,BENGALURU-DELHI,375378,All
2018,1,BENGALURU,DELHI,185692,181900,BENGALURU-DELHI,367592,All
2018,2,BENGALURU,DELHI,184090,179121,BENGALURU-DELHI,363211,All
2018,3,BENGALURU,DELHI,194029,194405,BENGALURU-DELHI,388434,All
2018,4,BENGALURU,DELHI,197175,182790,BENGALURU-DELHI,379965,All
2018,5,BENGALURU,DELHI,185889,204057,BENGALURU-DELHI,389946,All
2018,6,BENGALURU,DELHI,190406,193060,BENGALURU-DELHI,383466,All
2018,7,BENGALURU,DELHI,194582,193888,BENGALURU-DELHI,388470,All
2018,8,BENGALURU,DELHI,204488,202528,BENGALURU-DELHI,407016,All
2018,9,BENGALURU,DELHI,188373,182982,BENGALURU-DELHI,371355,All
2018,10,BENGALURU,DELHI,197728,185409,BENGALURU-DELHI,383137,All
2018,11,BENGALURU,DELHI,174273,178357,BENGALURU-DELHI,352630,All
2018,12,BENGALURU,DELHI,185664,193558,BENGALURU-DELHI,379222,All
2019,1,BENGALURU,DELHI,189592,186861,BENGALURU-DELHI,376453,All
2019,2,BENGALURU,DELHI,170288,169468,BENGALURU-DELHI,339756,All
2019,3,BENGALURU,DELHI,170478,171829,BENGALURU-DELHI,342307,All
2019,4,BENGALURU,DELHI,171177,163569,BENGALURU-DELHI,334746,All
2019,5,BENGALURU,DELHI,173617,191762,BENGALURU-DELHI,365379,All
2019,6,BENGALURU,DELHI,180065,190097,BENGALURU-DELHI,370162,All
2019,7,BENGALURU,DELHI,189227,192977,BENGALURU-DELHI,382204,All
2019,8,BENGALURU,DELHI,192079,191083,BENGALURU-DELHI,383162,All
2019,9,BENGALURU,DELHI,189939,180875,BENGALURU-DELHI,370814,All
2019,10,BENGALURU,DELHI,197492,181125,BENGALURU-DELHI,378617,All
2019,11,BENGALURU,DELHI,190375,198341,BENGALURU-DELHI,388716,All
2019,12,BENGALURU,DELHI,190407,199335,BENGALURU-DELHI,389742,All
2020,1,BENGALURU,DELHI,190573,184517,BENGALURU-DELHI,375090,All
2020,2,BENGALURU,DELHI,195161,188896,BENGALURU-DELHI,384057,All
2020,3,BENGALURU,DELHI,121740,106714,BENGALURU-DELHI,228454,All
2020,4,BENGALURU,DELHI,0,0,BENGALURU-DELHI,0,All
2020,5,BENGALURU,DELHI,7764,4254,BENGALURU-DELHI,12018,All
2020,6,BENGALURU,DELHI,25286,22565,BENGALURU-DELHI,47851,All
2020,7,BENGALURU,DELHI,27936,19506,BENGALURU-DELHI,47442,All
2020,8,BENGALURU,DELHI,33754,36652,BENGALURU-DELHI,70406,All
2020,9,BENGALURU,DELHI,42121,48666,BENGALURU-DELHI,90787,All
2020,10,BENGALURU,DELHI,62130,57520,BENGALURU-DELHI,119650,All
2020,11,BENGALURU,DELHI,69348,66255,BENGALURU-DELHI,135603,All
2020,12,BENGALURU,DELHI,70276,90729,BENGALURU-DELHI,161005,All
2021,1,BENGALURU,DELHI,77158,96333,BENGALURU-DELHI,173491,All
2021,2,BENGALURU,DELHI,92299,90174,BENGALURU-DELHI,182473,All
2021,3,BENGALURU,DELHI,104631,95021,BENGALURU-DELHI,199652,All
2021,4,BENGALURU,DELHI,90379,72042,BENGALURU-DELHI,162421,All
2021,6,BENGALURU,DELHI,32893,38208,BENGALURU-DELHI,71101,All
2021,7,BENGALURU,DELHI,58221,68302,BENGALURU-DELHI,126523,All
2021,8,BENGALURU,DELHI,85511,92234,BENGALURU-DELHI,177745,All
2021,9,BENGALURU,DELHI,93135,96346,BENGALURU-DELHI,189481,All
2021,10,BENGALURU,DELHI,130529,114079,BENGALURU-DELHI,244608,All
2021,11,BENGALURU,DELHI,131274,143750,BENGALURU-DELHI,275024,All
2021,12,BENGALURU,DELHI,133714,155286,BENGALURU-DELHI,289000,All
2022,1,BENGALURU,DELHI,76912,71080,BENGALURU-DELHI,147992,All
2022,2,BENGALURU,DELHI,107635,106215,BENGALURU-DELHI,213850,All
2022,3,BENGALURU,DELHI,151853,156667,BENGALURU-DELHI,308520,All
2022,4,BENGALURU,DELHI,175445,172421,BENGALURU-DELHI,347866,All
2022,5,BENGALURU,DELHI,165452,189672,BENGALURU-DELHI,355124,All
2022,6,BENGALURU,DELHI,162580,175979,BENGALURU-DELHI,338559,All
2022,7,BENGALURU,DELHI,169558,173794,BENGALURU-DELHI,343352,All
2022,8,BENGALURU,DELHI,172791,174710,BENGALURU-DELHI,347501,All
2022,9,BENGALURU,DELHI,175630,159677,BENGALURU-DELHI,335307,All
2022,10,BENGALURU,DELHI,191082,175741,BENGALURU-DELHI,366823,All
2022,11,BENGALURU,DELHI,194739,208039,BENGALURU-DELHI,402778,All
2022,12,BENGALURU,DELHI,214390,221883,BENGALURU-DELHI,436273,All
2023,1,BENGALURU,DELHI,206890,205146,BENGALURU-DELHI,412036,All
2023,2,BENGALURU,DELHI,189950,183974,BENGALURU-DELHI,373924,All
2023,3,BENGALURU,DELHI,202622,202316,BENGALURU-DELHI,404938,All
2023,4,BENGALURU,DELHI,211000,201582,BENGALURU-DELHI,412582,All
2023,5,BENGALURU,DELHI,192506,202718,BENGALURU-DELHI,395224,All
2023,6,BENGALURU,DELHI,184262,187021,BENGALURU-DELHI,371283,All
2023,7,BENGALURU,DELHI,196823,203835,BENGALURU-DELHI,400658,All
2023,8,BENGALURU,DELHI,209179,195611,BENGALURU-DELHI,404790,All
2023,9,BENGALURU,DELHI,191576,188916,BENGALURU-DELHI,380492,All
2023,10,BENGALURU,DELHI,215227,195918,BENGALURU-DELHI,411145,All
2023,11,BENGALURU,DELHI,188673,185492,BENGALURU-DELHI,374165,All
2023,12,BENGALURU,DELHI,204471,219660,BENGALURU-DELHI,424131,All
2024,1,BENGALURU,DELHI,202724,201415,BENGALURU-DELHI,404139,All
2024,2,BENGALURU,DELHI,201616,195258,BENGALURU-DELHI,396874,All
2024,3,BENGALURU,DELHI,206370,197494,BENGALURU-DELHI,403864,All
2024,4,BENGALURU,DELHI,202807,197812,BENGALURU-DELHI,400619,All
2024,6,BENGALURU,DELHI,187355,201380,BENGALURU-DELHI,388735,All
2024,7,BENGALURU,DELHI,194677,201763,BENGALURU-DELHI,396440,All
2024,8,BENGALURU,DELHI,197396,195261,BENGALURU-DELHI,392657,All
2024,9,BENGALURU,DELHI,195132,188636,BENGALURU-DELHI,383768,All
2024,10,BENGALURU,DELHI,210278,174119,BENGALURU-DELHI,384397,All
2024,11,BENGALURU,DELHI,188317,209474,BENGALURU-DELHI,397791,All
2024,12,BENGALURU,DELHI,194427,202492,BENGALURU-DELHI,396919,All
2025,1,BENGALURU,DELHI,194935,192619,BENGALURU-DELHI,387554,All
2025,2,BENGALURU,DELHI,182478,179446,BENGALURU-DELHI,361924,All
2025,3,BENGALURU,DELHI,185461,189358,BENGALURU-DELHI,374819,All
2021,3,BENGALURU,DIBRUGARH,1837,2113,BENGALURU-DIBRUGARH,3950,All
2021,7,BENGALURU,DIBRUGARH,742,1138,BENGALURU-DIBRUGARH,1880,All
2021,8,BENGALURU,DIBRUGARH,1763,1936,BENGALURU-DIBRUGARH,3699,All
2021,9,BENGALURU,DIBRUGARH,1666,1880,BENGALURU-DIBRUGARH,3546,All
2021,10,BENGALURU,DIBRUGARH,1944,1742,BENGALURU-DIBRUGARH,3686,All
2022,1,BENGALURU,DIBRUGARH,692,626,BENGALURU-DIBRUGARH,1318,All
2022,3,BENGALURU,DIBRUGARH,1681,1788,BENGALURU-DIBRUGARH,3469,All
2024,10,BENGALURU,DIBRUGARH,60,9,BENGALURU-DIBRUGARH,69,All
2024,11,BENGALURU,DIBRUGARH,322,436,BENGALURU-DIBRUGARH,758,All
2024,12,BENGALURU,DIBRUGARH,337,490,BENGALURU-DIBRUGARH,827,All
2025,3,BENGALURU,DIBRUGARH,522,415,BENGALURU-DIBRUGARH,937,All
2021,3,BENGALURU,DIMAPUR,21,9,BENGALURU-DIMAPUR,30,All
2021,4,BENGALURU,DIMAPUR,338,29,BENGALURU-DIMAPUR,367,All
2021,6,BENGALURU,DIMAPUR,0,82,BENGALURU-DIMAPUR,82,All
2021,7,BENGALURU,DIMAPUR,204,392,BENGALURU-DIMAPUR,596,All
2021,8,BENGALURU,DIMAPUR,195,333,BENGALURU-DIMAPUR,528,All
2021,9,BENGALURU,DIMAPUR,252,430,BENGALURU-DIMAPUR,682,All
2021,10,BENGALURU,DIMAPUR,432,506,BENGALURU-DIMAPUR,938,All
2021,11,BENGALURU,DIMAPUR,681,639,BENGALURU-DIMAPUR,1320,All
2021,12,BENGALURU,DIMAPUR,1072,528,BENGALURU-DIMAPUR,1600,All
2022,1,BENGALURU,DIMAPUR,751,669,BENGALURU-DIMAPUR,1420,All
2022,2,BENGALURU,DIMAPUR,488,436,BENGALURU-DIMAPUR,924,All
2022,3,BENGALURU,DIMAPUR,752,626,BENGALURU-DIMAPUR,1378,All
2022,4,BENGALURU,DIMAPUR,662,436,BENGALURU-DIMAPUR,1098,All
2022,5,BENGALURU,DIMAPUR,1010,925,BENGALURU-DIMAPUR,1935,All
2022,6,BENGALURU,DIMAPUR,969,977,BENGALURU-DIMAPUR,1946,All
2022,7,BENGALURU,DIMAPUR,1131,848,BENGALURU-DIMAPUR,1979,All
2022,8,BENGALURU,DIMAPUR,1135,720,BENGALURU-DIMAPUR,1855,All
2022,9,BENGALURU,DIMAPUR,918,492,BENGALURU-DIMAPUR,1410,All
2022,10,BENGALURU,DIMAPUR,981,525,BENGALURU-DIMAPUR,1506,All
2022,11,BENGALURU,DIMAPUR,942,336,BENGALURU-DIMAPUR,1278,All
2022,12,BENGALURU,DIMAPUR,1455,715,BENGALURU-DIMAPUR,2170,All
2023,1,BENGALURU,DIMAPUR,1119,1231,BENGALURU-DIMAPUR,2350,All
2023,2,BENGALURU,DIMAPUR,653,689,BENGALURU-DIMAPUR,1342,All
2023,3,BENGALURU,DIMAPUR,765,746,BENGALURU-DIMAPUR,1511,All
2023,4,BENGALURU,DIMAPUR,1262,949,BENGALURU-DIMAPUR,2211,All
2023,5,BENGALURU,DIMAPUR,919,870,BENGALURU-DIMAPUR,1789,All
2023,6,BENGALURU,DIMAPUR,905,1017,BENGALURU-DIMAPUR,1922,All
2023,7,BENGALURU,DIMAPUR,818,1040,BENGALURU-DIMAPUR,1858,All
2023,8,BENGALURU,DIMAPUR,571,623,BENGALURU-DIMAPUR,1194,All
2023,9,BENGALURU,DIMAPUR,643,660,BENGALURU-DIMAPUR,1303,All
2023,10,BENGALURU,DIMAPUR,451,408,BENGALURU-DIMAPUR,859,All
2021,2,BENGALURU,DURGAPUR,105,126,BENGALURU-DURGAPUR,231,All
2021,3,BENGALURU,DURGAPUR,1368,1590,BENGALURU-DURGAPUR,2958,All
2021,4,BENGALURU,DURGAPUR,2326,1119,BENGALURU-DURGAPUR,3445,All
2021,6,BENGALURU,DURGAPUR,532,995,BENGALURU-DURGAPUR,1527,All
2021,7,BENGALURU,DURGAPUR,1880,2926,BENGALURU-DURGAPUR,4806,All
2021,8,BENGALURU,DURGAPUR,1994,2943,BENGALURU-DURGAPUR,4937,All
2021,9,BENGALURU,DURGAPUR,2645,2958,BENGALURU-DURGAPUR,5603,All
2021,10,BENGALURU,DURGAPUR,4537,3265,BENGALURU-DURGAPUR,7802,All
2021,11,BENGALURU,DURGAPUR,3855,3932,BENGALURU-DURGAPUR,7787,All
2021,12,BENGALURU,DURGAPUR,3221,3386,BENGALURU-DURGAPUR,6607,All
2022,1,BENGALURU,DURGAPUR,2691,2210,BENGALURU-DURGAPUR,4901,All
2022,2,BENGALURU,DURGAPUR,1862,1967,BENGALURU-DURGAPUR,3829,All
2022,3,BENGALURU,DURGAPUR,4333,4752,BENGALURU-DURGAPUR,9085,All
2022,4,BENGALURU,DURGAPUR,4332,5083,BENGALURU-DURGAPUR,9415,All
2022,5,BENGALURU,DURGAPUR,3347,5675,BENGALURU-DURGAPUR,9022,All
2022,6,BENGALURU,DURGAPUR,4376,5130,BENGALURU-DURGAPUR,9506,All
2022,7,BENGALURU,DURGAPUR,4331,5050,BENGALURU-DURGAPUR,9381,All
2022,8,BENGALURU,DURGAPUR,4091,5157,BENGALURU-DURGAPUR,9248,All
2022,9,BENGALURU,DURGAPUR,4133,3797,BENGALURU-DURGAPUR,7930,All
2022,10,BENGALURU,DURGAPUR,4833,4671,BENGALURU-DURGAPUR,9504,All
2022,11,BENGALURU,DURGAPUR,4337,5392,BENGALURU-DURGAPUR,9729,All
2022,12,BENGALURU,DURGAPUR,5149,4859,BENGALURU-DURGAPUR,10008,All
2023,1,BENGALURU,DURGAPUR,4322,4260,BENGALURU-DURGAPUR,8582,All
2023,2,BENGALURU,DURGAPUR,3125,3250,BENGALURU-DURGAPUR,6375,All
2023,3,BENGALURU,DURGAPUR,5215,5371,BENGALURU-DURGAPUR,10586,All
2023,4,BENGALURU,DURGAPUR,4623,4192,BENGALURU-DURGAPUR,8815,All
2023,5,BENGALURU,DURGAPUR,4762,5170,BENGALURU-DURGAPUR,9932,All
2023,6,BENGALURU,DURGAPUR,5821,6074,BENGALURU-DURGAPUR,11895,All
2023,7,BENGALURU,DURGAPUR,3212,3569,BENGALURU-DURGAPUR,6781,All
2023,8,BENGALURU,DURGAPUR,2561,2704,BENGALURU-DURGAPUR,5265,All
2023,9,BENGALURU,DURGAPUR,4740,5018,BENGALURU-DURGAPUR,9758,All
2023,10,BENGALURU,DURGAPUR,6032,4745,BENGALURU-DURGAPUR,10777,All
2023,11,BENGALURU,DURGAPUR,4450,4339,BENGALURU-DURGAPUR,8789,All
2023,12,BENGALURU,DURGAPUR,4585,4958,BENGALURU-DURGAPUR,9543,All
2024,1,BENGALURU,DURGAPUR,4618,4610,BENGALURU-DURGAPUR,9228,All
2024,2,BENGALURU,DURGAPUR,4317,4346,BENGALURU-DURGAPUR,8663,All
2024,3,BENGALURU,DURGAPUR,4936,4687,BENGALURU-DURGAPUR,9623,All
2024,4,BENGALURU,DURGAPUR,4935,4817,BENGALURU-DURGAPUR,9752,All
2024,6,BENGALURU,DURGAPUR,5311,5418,BENGALURU-DURGAPUR,10729,All
2024,7,BENGALURU,DURGAPUR,4976,5884,BENGALURU-DURGAPUR,10860,All
2024,8,BENGALURU,DURGAPUR,4629,4908,BENGALURU-DURGAPUR,9537,All
2024,9,BENGALURU,DURGAPUR,4316,3492,BENGALURU-DURGAPUR,7808,All
2024,10,BENGALURU,DURGAPUR,5384,4271,BENGALURU-DURGAPUR,9655,All
2024,11,BENGALURU,DURGAPUR,4406,4929,BENGALURU-DURGAPUR,9335,All
2024,12,BENGALURU,DURGAPUR,5018,4842,BENGALURU-DURGAPUR,9860,All
2025,1,BENGALURU,DURGAPUR,4803,4925,BENGALURU-DURGAPUR,9728,All
2025,2,BENGALURU,DURGAPUR,3251,3131,BENGALURU-DURGAPUR,6382,All
2025,3,BENGALURU,DURGAPUR,4766,4245,BENGALURU-DURGAPUR,9011,All
2023,1,BENGALURU,DehraDun,4248,3948,BENGALURU-DehraDun,8196,All
2023,6,BENGALURU,DehraDun,5164,5353,BENGALURU-DehraDun,10517,All
2023,7,BENGALURU,DehraDun,4688,5309,BENGALURU-DehraDun,9997,All
2023,8,BENGALURU,DehraDun,4565,4616,BENGALURU-DehraDun,9181,All
2023,9,BENGALURU,DehraDun,5038,4833,BENGALURU-DehraDun,9871,All
2023,10,BENGALURU,DehraDun,5494,5154,BENGALURU-DehraDun,10648,All
2023,11,BENGALURU,DehraDun,5188,5087,BENGALURU-DehraDun,10275,All
2023,12,BENGALURU,DehraDun,4996,5342,BENGALURU-DehraDun,10338,All
2024,1,BENGALURU,DehraDun,3005,2929,BENGALURU-DehraDun,5934,All
2024,2,BENGALURU,DehraDun,3086,2959,BENGALURU-DehraDun,6045,All
2024,3,BENGALURU,DehraDun,6978,6008,BENGALURU-DehraDun,12986,All
2024,4,BENGALURU,DehraDun,8985,8772,BENGALURU-DehraDun,17757,All
2024,6,BENGALURU,DehraDun,9441,10492,BENGALURU-DehraDun,19933,All
2024,7,BENGALURU,DehraDun,8279,8149,BENGALURU-DehraDun,16428,All
2024,8,BENGALURU,DehraDun,8050,7214,BENGALURU-DehraDun,15264,All
2024,9,BENGALURU,DehraDun,9351,7557,BENGALURU-DehraDun,16908,All
2024,10,BENGALURU,DehraDun,10118,8294,BENGALURU-DehraDun,18412,All
2024,11,BENGALURU,DehraDun,7923,9802,BENGALURU-DehraDun,17725,All
2024,12,BENGALURU,DehraDun,9111,9780,BENGALURU-DehraDun,18891,All
2025,1,BENGALURU,DehraDun,8231,7338,BENGALURU-DehraDun,15569,All
2025,2,BENGALURU,DehraDun,9147,8081,BENGALURU-DehraDun,17228,All
2025,3,BENGALURU,DehraDun,8747,8022,BENGALURU-DehraDun,16769,All
2024,6,BENGALURU,Deoghar ,2166,2035,BENGALURU-Deoghar ,4201,All
2024,7,BENGALURU,Deoghar ,2170,2223,BENGALURU-Deoghar ,4393,All
2024,8,BENGALURU,Deoghar ,2291,2278,BENGALURU-Deoghar ,4569,All
2024,9,BENGALURU,Deoghar ,2029,1981,BENGALURU-Deoghar ,4010,All
2024,10,BENGALURU,Deoghar ,2929,2049,BENGALURU-Deoghar ,4978,All
2024,11,BENGALURU,Deoghar ,4629,5055,BENGALURU-Deoghar ,9684,All
2024,12,BENGALURU,Deoghar ,5258,5332,BENGALURU-Deoghar ,10590,All
2025,1,BENGALURU,Deoghar ,4823,5004,BENGALURU-Deoghar ,9827,All
2025,2,BENGALURU,Deoghar ,3392,3144,BENGALURU-Deoghar ,6536,All
2025,3,BENGALURU,Deoghar ,5061,4851,BENGALURU-Deoghar ,9912,All
2015,4,BENGALURU,GOA,25539,24536,BENGALURU-GOA,50075,All
2015,5,BENGALURU,GOA,26848,26850,BENGALURU-GOA,53698,All
2015,6,BENGALURU,GOA,22369,22758,BENGALURU-GOA,45127,All
2015,7,BENGALURU,GOA,25231,25155,BENGALURU-GOA,50386,All
2015,8,BENGALURU,GOA,25243,25034,BENGALURU-GOA,50277,All
2015,9,BENGALURU,GOA,14783,14400,BENGALURU-GOA,29183,All
2015,9,BENGALURU,GOA,9846,9585,BENGALURU-GOA,19431,All
2015,10,BENGALURU,GOA,46145,27663,BENGALURU-GOA,73808,All
2015,11,BENGALURU,GOA,26146,26034,BENGALURU-GOA,52180,All
2015,12,BENGALURU,GOA,29552,27869,BENGALURU-GOA,57421,All
2016,1,BENGALURU,GOA,28440,29236,BENGALURU-GOA,57676,All
2016,2,BENGALURU,GOA,26337,26886,BENGALURU-GOA,53223,All
2016,3,BENGALURU,GOA,26762,30867,BENGALURU-GOA,57629,All
2016,4,BENGALURU,GOA,27616,27086,BENGALURU-GOA,54702,All
2016,5,BENGALURU,GOA,31903,38021,BENGALURU-GOA,69924,All
2016,6,BENGALURU,GOA,23528,23613,BENGALURU-GOA,47141,All
2016,7,BENGALURU,GOA,31905,30974,BENGALURU-GOA,62879,All
2016,8,BENGALURU,GOA,30681,30352,BENGALURU-GOA,61033,All
2016,9,BENGALURU,GOA,32173,30645,BENGALURU-GOA,62818,All
2016,10,BENGALURU,GOA,37106,36176,BENGALURU-GOA,73282,All
2016,11,BENGALURU,GOA,40372,41721,BENGALURU-GOA,82093,All
2016,12,BENGALURU,GOA,40453,39129,BENGALURU-GOA,79582,All
2017,1,BENGALURU,GOA,39800,44343,BENGALURU-GOA,84143,All
2017,2,BENGALURU,GOA,31364,33752,BENGALURU-GOA,65116,All
2017,3,BENGALURU,GOA,28212,31292,BENGALURU-GOA,59504,All
2017,4,BENGALURU,GOA,30398,31748,BENGALURU-GOA,62146,All
2017,5,BENGALURU,GOA,32876,36659,BENGALURU-GOA,69535,All
2017,6,BENGALURU,GOA,32665,33945,BENGALURU-GOA,66610,All
2017,7,BENGALURU,GOA,33477,34763,BENGALURU-GOA,68240,All
2017,8,BENGALURU,GOA,36199,36615,BENGALURU-GOA,72814,All
2017,9,BENGALURU,GOA,33928,31283,BENGALURU-GOA,65211,All
2017,10,BENGALURU,GOA,37302,39446,BENGALURU-GOA,76748,All
2017,11,BENGALURU,GOA,37547,38074,BENGALURU-GOA,75621,All
2017,12,BENGALURU,GOA,49584,46812,BENGALURU-GOA,96396,All
2018,1,BENGALURU,GOA,47005,51189,BENGALURU-GOA,98194,All
2018,2,BENGALURU,GOA,41585,42838,BENGALURU-GOA,84423,All
2018,3,BENGALURU,GOA,43109,42485,BENGALURU-GOA,85594,All
2018,4,BENGALURU,GOA,43705,42572,BENGALURU-GOA,86277,All
2018,5,BENGALURU,GOA,42971,45986,BENGALURU-GOA,88957,All
2018,6,BENGALURU,GOA,41923,29823,BENGALURU-GOA,71746,All
2018,7,BENGALURU,GOA,40576,30455,BENGALURU-GOA,71031,All
2018,8,BENGALURU,GOA,41442,41060,BENGALURU-GOA,82502,All
2018,9,BENGALURU,GOA,43143,41392,BENGALURU-GOA,84535,All
2018,10,BENGALURU,GOA,46697,45831,BENGALURU-GOA,92528,All
2018,11,BENGALURU,GOA,47914,45963,BENGALURU-GOA,93877,All
2018,12,BENGALURU,GOA,47894,44521,BENGALURU-GOA,92415,All
2019,1,BENGALURU,GORAKHPUR,3793,3029,BENGALURU-GORAKHPUR,6822,All
2019,2,BENGALURU,GORAKHPUR,4648,3983,BENGALURU-GORAKHPUR,8631,All
2019,3,BENGALURU,GORAKHPUR,4690,4136,BENGALURU-GORAKHPUR,8826,All
2019,4,BENGALURU,GORAKHPUR,5059,3396,BENGALURU-GORAKHPUR,8455,All
2019,5,BENGALURU,GORAKHPUR,4404,4582,BENGALURU-GORAKHPUR,8986,All
2019,6,BENGALURU,GORAKHPUR,4355,5567,BENGALURU-GORAKHPUR,9922,All
2019,7,BENGALURU,GORAKHPUR,3229,4077,BENGALURU-GORAKHPUR,7306,All
2019,8,BENGALURU,GORAKHPUR,4237,4157,BENGALURU-GORAKHPUR,8394,All
2019,9,BENGALURU,GORAKHPUR,3358,2479,BENGALURU-GORAKHPUR,5837,All
2019,10,BENGALURU,GORAKHPUR,4526,3153,BENGALURU-GORAKHPUR,7679,All
2019,11,BENGALURU,GORAKHPUR,4664,5243,BENGALURU-GORAKHPUR,9907,All
2019,12,BENGALURU,GORAKHPUR,0,185,BENGALURU-GORAKHPUR,185,All
2020,1,BENGALURU,GORAKHPUR,0,534,BENGALURU-GORAKHPUR,534,All
2020,2,BENGALURU,GORAKHPUR,0,624,BENGALURU-GORAKHPUR,624,All
2020,3,BENGALURU,GORAKHPUR,0,568,BENGALURU-GORAKHPUR,568,All
2020,5,BENGALURU,GORAKHPUR,208,0,BENGALURU-GORAKHPUR,208,All
2020,12,BENGALURU,GORAKHPUR,274,0,BENGALURU-GORAKHPUR,274,All
2021,1,BENGALURU,GORAKHPUR,909,1359,BENGALURU-GORAKHPUR,2268,All
2021,2,BENGALURU,GORAKHPUR,2883,3575,BENGALURU-GORAKHPUR,6458,All
2021,3,BENGALURU,GORAKHPUR,4266,3095,BENGALURU-GORAKHPUR,7361,All
2021,4,BENGALURU,GORAKHPUR,6395,3190,BENGALURU-GORAKHPUR,9585,All
2021,6,BENGALURU,GORAKHPUR,1515,4964,BENGALURU-GORAKHPUR,6479,All
2021,7,BENGALURU,GORAKHPUR,1818,4393,BENGALURU-GORAKHPUR,6211,All
2021,8,BENGALURU,GORAKHPUR,1784,2655,BENGALURU-GORAKHPUR,4439,All
2021,9,BENGALURU,GORAKHPUR,2635,2964,BENGALURU-GORAKHPUR,5599,All
2021,10,BENGALURU,GORAKHPUR,4457,3765,BENGALURU-GORAKHPUR,8222,All
2021,11,BENGALURU,GORAKHPUR,3768,3439,BENGALURU-GORAKHPUR,7207,All
2021,12,BENGALURU,GORAKHPUR,1760,1850,BENGALURU-GORAKHPUR,3610,All
2022,1,BENGALURU,GORAKHPUR,1223,768,BENGALURU-GORAKHPUR,1991,All
2022,2,BENGALURU,GORAKHPUR,1056,972,BENGALURU-GORAKHPUR,2028,All
2022,3,BENGALURU,GORAKHPUR,1711,1702,BENGALURU-GORAKHPUR,3413,All
2022,4,BENGALURU,GORAKHPUR,952,1566,BENGALURU-GORAKHPUR,2518,All
2022,5,BENGALURU,GORAKHPUR,1212,1466,BENGALURU-GORAKHPUR,2678,All
2022,6,BENGALURU,GORAKHPUR,1229,1171,BENGALURU-GORAKHPUR,2400,All
2022,7,BENGALURU,GORAKHPUR,1262,1258,BENGALURU-GORAKHPUR,2520,All
2022,8,BENGALURU,GORAKHPUR,1263,1190,BENGALURU-GORAKHPUR,2453,All
2022,9,BENGALURU,GORAKHPUR,953,960,BENGALURU-GORAKHPUR,1913,All
2022,10,BENGALURU,GORAKHPUR,1010,986,BENGALURU-GORAKHPUR,1996,All
2022,11,BENGALURU,GORAKHPUR,990,1304,BENGALURU-GORAKHPUR,2294,All
2022,12,BENGALURU,GORAKHPUR,1149,1459,BENGALURU-GORAKHPUR,2608,All
2023,1,BENGALURU,GORAKHPUR,746,1035,BENGALURU-GORAKHPUR,1781,All
2023,2,BENGALURU,GORAKHPUR,459,470,BENGALURU-GORAKHPUR,929,All
2023,3,BENGALURU,GORAKHPUR,513,638,BENGALURU-GORAKHPUR,1151,All
2023,4,BENGALURU,GORAKHPUR,773,435,BENGALURU-GORAKHPUR,1208,All
2023,5,BENGALURU,GORAKHPUR,736,795,BENGALURU-GORAKHPUR,1531,All
2023,6,BENGALURU,GORAKHPUR,852,120,BENGALURU-GORAKHPUR,972,All
2023,7,BENGALURU,GORAKHPUR,338,19,BENGALURU-GORAKHPUR,357,All
2023,8,BENGALURU,GORAKHPUR,369,4,BENGALURU-GORAKHPUR,373,All
2023,9,BENGALURU,GORAKHPUR,301,343,BENGALURU-GORAKHPUR,644,All
2023,10,BENGALURU,GORAKHPUR,546,539,BENGALURU-GORAKHPUR,1085,All
2023,11,BENGALURU,GORAKHPUR,198,240,BENGALURU-GORAKHPUR,438,All
2023,12,BENGALURU,GORAKHPUR,417,102,BENGALURU-GORAKHPUR,519,All
2024,1,BENGALURU,GORAKHPUR,201,35,BENGALURU-GORAKHPUR,236,All
2024,2,BENGALURU,GORAKHPUR,178,0,BENGALURU-GORAKHPUR,178,All
2024,3,BENGALURU,GORAKHPUR,204,15,BENGALURU-GORAKHPUR,219,All
2024,4,BENGALURU,GORAKHPUR,617,1059,BENGALURU-GORAKHPUR,1676,All
2024,6,BENGALURU,GORAKHPUR,4429,4583,BENGALURU-GORAKHPUR,9012,All
2024,7,BENGALURU,GORAKHPUR,3766,4084,BENGALURU-GORAKHPUR,7850,All
2024,8,BENGALURU,GORAKHPUR,3953,4216,BENGALURU-GORAKHPUR,8169,All
2024,9,BENGALURU,GORAKHPUR,5004,4997,BENGALURU-GORAKHPUR,10001,All
2024,10,BENGALURU,GORAKHPUR,5343,4381,BENGALURU-GORAKHPUR,9724,All
2024,11,BENGALURU,GORAKHPUR,5476,5497,BENGALURU-GORAKHPUR,10973,All
2024,12,BENGALURU,GORAKHPUR,7352,7605,BENGALURU-GORAKHPUR,14957,All
2025,1,BENGALURU,GORAKHPUR,10281,10649,BENGALURU-GORAKHPUR,20930,All
2025,2,BENGALURU,GORAKHPUR,9714,9693,BENGALURU-GORAKHPUR,19407,All
2025,3,BENGALURU,GORAKHPUR,10928,10651,BENGALURU-GORAKHPUR,21579,All
2015,4,BENGALURU,GUWAHATI,6016,5235,BENGALURU-GUWAHATI,11251,All
2015,5,BENGALURU,GUWAHATI,5264,5410,BENGALURU-GUWAHATI,10674,All
2015,6,BENGALURU,GUWAHATI,4322,4909,BENGALURU-GUWAHATI,9231,All
2015,7,BENGALURU,GUWAHATI,5309,5640,BENGALURU-GUWAHATI,10949,All
2015,8,BENGALURU,GUWAHATI,3563,4103,BENGALURU-GUWAHATI,7666,All
2015,9,BENGALURU,GUWAHATI,3397,3047,BENGALURU-GUWAHATI,6444,All
2015,9,BENGALURU,GUWAHATI,40,37,BENGALURU-GUWAHATI,77,All
2015,10,BENGALURU,GUWAHATI,4455,4007,BENGALURU-GUWAHATI,8462,All
2015,11,BENGALURU,GUWAHATI,4591,4430,BENGALURU-GUWAHATI,9021,All
2015,12,BENGALURU,GUWAHATI,6020,5077,BENGALURU-GUWAHATI,11097,All
2016,1,BENGALURU,GUWAHATI,5145,5172,BENGALURU-GUWAHATI,10317,All
2016,2,BENGALURU,GUWAHATI,4575,4692,BENGALURU-GUWAHATI,9267,All
2016,3,BENGALURU,GUWAHATI,3994,4442,BENGALURU-GUWAHATI,8436,All
2016,4,BENGALURU,GUWAHATI,7860,6829,BENGALURU-GUWAHATI,14689,All
2016,5,BENGALURU,GUWAHATI,8310,8913,BENGALURU-GUWAHATI,17223,All
2016,6,BENGALURU,GUWAHATI,8426,8968,BENGALURU-GUWAHATI,17394,All
2016,7,BENGALURU,GUWAHATI,9666,9844,BENGALURU-GUWAHATI,19510,All
2016,8,BENGALURU,GUWAHATI,7670,7688,BENGALURU-GUWAHATI,15358,All
2016,9,BENGALURU,GUWAHATI,9839,8155,BENGALURU-GUWAHATI,17994,All
2016,10,BENGALURU,GUWAHATI,14023,12025,BENGALURU-GUWAHATI,26048,All
2016,11,BENGALURU,GUWAHATI,14819,15189,BENGALURU-GUWAHATI,30008,All
2016,12,BENGALURU,GUWAHATI,19338,17686,BENGALURU-GUWAHATI,37024,All
2017,1,BENGALURU,GUWAHATI,19382,18699,BENGALURU-GUWAHATI,38081,All
2017,2,BENGALURU,GUWAHATI,15704,15100,BENGALURU-GUWAHATI,30804,All
2017,3,BENGALURU,GUWAHATI,13806,14420,BENGALURU-GUWAHATI,28226,All
2017,4,BENGALURU,GUWAHATI,15545,14902,BENGALURU-GUWAHATI,30447,All
2017,5,BENGALURU,GUWAHATI,19261,19755,BENGALURU-GUWAHATI,39016,All
2017,6,BENGALURU,GUWAHATI,18258,18538,BENGALURU-GUWAHATI,36796,All
2017,7,BENGALURU,GUWAHATI,16459,16043,BENGALURU-GUWAHATI,32502,All
2017,8,BENGALURU,GUWAHATI,16246,15442,BENGALURU-GUWAHATI,31688,All
2017,9,BENGALURU,GUWAHATI,17192,15391,BENGALURU-GUWAHATI,32583,All
2017,10,BENGALURU,GUWAHATI,16038,15413,BENGALURU-GUWAHATI,31451,All
2017,11,BENGALURU,GUWAHATI,15694,15363,BENGALURU-GUWAHATI,31057,All
2017,12,BENGALURU,GUWAHATI,17466,14489,BENGALURU-GUWAHATI,31955,All
2018,1,BENGALURU,GUWAHATI,17202,15858,BENGALURU-GUWAHATI,33060,All
2018,2,BENGALURU,GUWAHATI,16198,14815,BENGALURU-GUWAHATI,31013,All
2018,3,BENGALURU,GUWAHATI,18624,16728,BENGALURU-GUWAHATI,35352,All
2018,4,BENGALURU,GUWAHATI,19818,18153,BENGALURU-GUWAHATI,37971,All
2018,5,BENGALURU,GUWAHATI,18774,20273,BENGALURU-GUWAHATI,39047,All
2018,6,BENGALURU,GUWAHATI,28279,24027,BENGALURU-GUWAHATI,52306,All
2018,7,BENGALURU,GUWAHATI,25575,22825,BENGALURU-GUWAHATI,48400,All
2018,8,BENGALURU,GUWAHATI,18881,19392,BENGALURU-GUWAHATI,38273,All
2018,9,BENGALURU,GUWAHATI,18207,17292,BENGALURU-GUWAHATI,35499,All
2018,10,BENGALURU,GUWAHATI,23121,19546,BENGALURU-GUWAHATI,42667,All
2018,11,BENGALURU,GUWAHATI,19680,17959,BENGALURU-GUWAHATI,37639,All
2018,12,BENGALURU,GUWAHATI,25514,20449,BENGALURU-GUWAHATI,45963,All
2019,1,BENGALURU,GUWAHATI,23451,21036,BENGALURU-GUWAHATI,44487,All
2019,2,BENGALURU,GUWAHATI,18557,15662,BENGALURU-GUWAHATI,34219,All
2019,3,BENGALURU,GUWAHATI,21020,15809,BENGALURU-GUWAHATI,36829,All
2019,4,BENGALURU,GUWAHATI,19928,15781,BENGALURU-GUWAHATI,35709,All
2019,5,BENGALURU,GUWAHATI,17517,18303,BENGALURU-GUWAHATI,35820,All
2019,6,BENGALURU,GUWAHATI,15001,15746,BENGALURU-GUWAHATI,30747,All
2019,7,BENGALURU,GUWAHATI,13502,13291,BENGALURU-GUWAHATI,26793,All
2019,8,BENGALURU,GUWAHATI,11675,10213,BENGALURU-GUWAHATI,21888,All
2019,9,BENGALURU,GUWAHATI,11668,9242,BENGALURU-GUWAHATI,20910,All
2019,10,BENGALURU,GUWAHATI,15378,13167,BENGALURU-GUWAHATI,28545,All
2019,11,BENGALURU,GUWAHATI,17875,17514,BENGALURU-GUWAHATI,35389,All
2019,12,BENGALURU,GUWAHATI,18380,16303,BENGALURU-GUWAHATI,34683,All
2020,1,BENGALURU,GUWAHATI,18479,17486,BENGALURU-GUWAHATI,35965,All
2020,2,BENGALURU,GUWAHATI,14214,12933,BENGALURU-GUWAHATI,27147,All
2020,3,BENGALURU,GUWAHATI,12120,7727,BENGALURU-GUWAHATI,19847,All
2020,5,BENGALURU,GUWAHATI,1667,457,BENGALURU-GUWAHATI,2124,All
2020,6,BENGALURU,GUWAHATI,6421,2475,BENGALURU-GUWAHATI,8896,All
2020,7,BENGALURU,GUWAHATI,6273,2876,BENGALURU-GUWAHATI,9149,All
2020,8,BENGALURU,GUWAHATI,9851,8756,BENGALURU-GUWAHATI,18607,All
2020,9,BENGALURU,GUWAHATI,11483,16016,BENGALURU-GUWAHATI,27499,All
2020,10,BENGALURU,GUWAHATI,15322,25342,BENGALURU-GUWAHATI,40664,All
2020,11,BENGALURU,GUWAHATI,17734,24375,BENGALURU-GUWAHATI,42109,All
2020,12,BENGALURU,GUWAHATI,23212,21938,BENGALURU-GUWAHATI,45150,All
2021,1,BENGALURU,GUWAHATI,21910,26064,BENGALURU-GUWAHATI,47974,All
2021,2,BENGALURU,GUWAHATI,20120,22565,BENGALURU-GUWAHATI,42685,All
2021,3,BENGALURU,GUWAHATI,26953,19545,BENGALURU-GUWAHATI,46498,All
2021,4,BENGALURU,GUWAHATI,19287,19128,BENGALURU-GUWAHATI,38415,All
2021,6,BENGALURU,GUWAHATI,3322,7165,BENGALURU-GUWAHATI,10487,All
2021,7,BENGALURU,GUWAHATI,4893,9885,BENGALURU-GUWAHATI,14778,All
2021,8,BENGALURU,GUWAHATI,6736,19247,BENGALURU-GUWAHATI,25983,All
2021,9,BENGALURU,GUWAHATI,11387,18103,BENGALURU-GUWAHATI,29490,All
2021,10,BENGALURU,GUWAHATI,21334,21566,BENGALURU-GUWAHATI,42900,All
2021,11,BENGALURU,GUWAHATI,17621,20139,BENGALURU-GUWAHATI,37760,All
2021,12,BENGALURU,GUWAHATI,21477,21178,BENGALURU-GUWAHATI,42655,All
2022,1,BENGALURU,GUWAHATI,15950,14791,BENGALURU-GUWAHATI,30741,All
2022,2,BENGALURU,GUWAHATI,13856,15006,BENGALURU-GUWAHATI,28862,All
2022,3,BENGALURU,GUWAHATI,19155,21098,BENGALURU-GUWAHATI,40253,All
2022,4,BENGALURU,GUWAHATI,26810,23426,BENGALURU-GUWAHATI,50236,All
2022,5,BENGALURU,GUWAHATI,19605,25595,BENGALURU-GUWAHATI,45200,All
2022,6,BENGALURU,GUWAHATI,16624,20177,BENGALURU-GUWAHATI,36801,All
2022,7,BENGALURU,GUWAHATI,15919,15850,BENGALURU-GUWAHATI,31769,All
2022,8,BENGALURU,GUWAHATI,13960,18083,BENGALURU-GUWAHATI,32043,All
2022,9,BENGALURU,GUWAHATI,14738,12999,BENGALURU-GUWAHATI,27737,All
2022,10,BENGALURU,GUWAHATI,27273,24771,BENGALURU-GUWAHATI,52044,All
2022,11,BENGALURU,GUWAHATI,29980,29259,BENGALURU-GUWAHATI,59239,All
2022,12,BENGALURU,GUWAHATI,31998,30398,BENGALURU-GUWAHATI,62396,All
2023,1,BENGALURU,GUWAHATI,30903,30528,BENGALURU-GUWAHATI,61431,All
2023,2,BENGALURU,GUWAHATI,26437,27475,BENGALURU-GUWAHATI,53912,All
2023,3,BENGALURU,GUWAHATI,31205,29324,BENGALURU-GUWAHATI,60529,All
2023,4,BENGALURU,GUWAHATI,30228,27636,BENGALURU-GUWAHATI,57864,All
2023,5,BENGALURU,GUWAHATI,29947,30699,BENGALURU-GUWAHATI,60646,All
2023,6,BENGALURU,GUWAHATI,31699,30714,BENGALURU-GUWAHATI,62413,All
2023,7,BENGALURU,GUWAHATI,32433,31054,BENGALURU-GUWAHATI,63487,All
2023,8,BENGALURU,GUWAHATI,34618,33693,BENGALURU-GUWAHATI,68311,All
2023,9,BENGALURU,GUWAHATI,32881,31021,BENGALURU-GUWAHATI,63902,All
2023,10,BENGALURU,GUWAHATI,36622,31208,BENGALURU-GUWAHATI,67830,All
2023,11,BENGALURU,GUWAHATI,34294,32823,BENGALURU-GUWAHATI,67117,All
2023,12,BENGALURU,GUWAHATI,37351,35240,BENGALURU-GUWAHATI,72591,All
2024,1,BENGALURU,GUWAHATI,34368,32741,BENGALURU-GUWAHATI,67109,All
2024,2,BENGALURU,GUWAHATI,27528,26186,BENGALURU-GUWAHATI,53714,All
2024,3,BENGALURU,GUWAHATI,31729,25745,BENGALURU-GUWAHATI,57474,All
2024,4,BENGALURU,GUWAHATI,36787,29419,BENGALURU-GUWAHATI,66206,All
2024,6,BENGALURU,GUWAHATI,33238,34336,BENGALURU-GUWAHATI,67574,All
2024,7,BENGALURU,GUWAHATI,29570,28730,BENGALURU-GUWAHATI,58300,All
2024,8,BENGALURU,GUWAHATI,24363,21809,BENGALURU-GUWAHATI,46172,All
2024,9,BENGALURU,GUWAHATI,28768,26131,BENGALURU-GUWAHATI,54899,All
2024,10,BENGALURU,GUWAHATI,37045,30401,BENGALURU-GUWAHATI,67446,All
2024,11,BENGALURU,GUWAHATI,37103,31975,BENGALURU-GUWAHATI,69078,All
2024,12,BENGALURU,GUWAHATI,38627,34044,BENGALURU-GUWAHATI,72671,All
2025,1,BENGALURU,GUWAHATI,34174,30889,BENGALURU-GUWAHATI,65063,All
2025,2,BENGALURU,GUWAHATI,34490,30693,BENGALURU-GUWAHATI,65183,All
2025,3,BENGALURU,GUWAHATI,39010,34327,BENGALURU-GUWAHATI,73337,All
2019,6,BENGALURU,GWALIOR,750,747,BENGALURU-GWALIOR,1497,All
2019,7,BENGALURU,GWALIOR,1909,1939,BENGALURU-GWALIOR,3848,All
2019,8,BENGALURU,GWALIOR,2005,1949,BENGALURU-GWALIOR,3954,All
2019,9,BENGALURU,GWALIOR,1873,1727,BENGALURU-GWALIOR,3600,All
2019,10,BENGALURU,GWALIOR,1919,1702,BENGALURU-GWALIOR,3621,All
2019,11,BENGALURU,GWALIOR,1876,1877,BENGALURU-GWALIOR,3753,All
2019,12,BENGALURU,GWALIOR,1924,1904,BENGALURU-GWALIOR,3828,All
2020,1,BENGALURU,GWALIOR,2083,2037,BENGALURU-GWALIOR,4120,All
2020,2,BENGALURU,GWALIOR,1916,1874,BENGALURU-GWALIOR,3790,All
2020,3,BENGALURU,GWALIOR,1446,1198,BENGALURU-GWALIOR,2644,All
2020,5,BENGALURU,GWALIOR,424,80,BENGALURU-GWALIOR,504,All
2020,8,BENGALURU,GWALIOR,484,609,BENGALURU-GWALIOR,1093,All
2020,9,BENGALURU,GWALIOR,1184,1294,BENGALURU-GWALIOR,2478,All
2020,10,BENGALURU,GWALIOR,1540,1236,BENGALURU-GWALIOR,2776,All
2020,11,BENGALURU,GWALIOR,1577,1344,BENGALURU-GWALIOR,2921,All
2020,12,BENGALURU,GWALIOR,1387,1412,BENGALURU-GWALIOR,2799,All
2021,1,BENGALURU,GWALIOR,1542,1681,BENGALURU-GWALIOR,3223,All
2021,2,BENGALURU,GWALIOR,1384,1391,BENGALURU-GWALIOR,2775,All
2021,3,BENGALURU,GWALIOR,1564,1554,BENGALURU-GWALIOR,3118,All
2021,4,BENGALURU,GWALIOR,2311,1643,BENGALURU-GWALIOR,3954,All
2021,6,BENGALURU,GWALIOR,1278,1471,BENGALURU-GWALIOR,2749,All
2021,7,BENGALURU,GWALIOR,1886,2184,BENGALURU-GWALIOR,4070,All
2021,8,BENGALURU,GWALIOR,2068,2139,BENGALURU-GWALIOR,4207,All
2021,9,BENGALURU,GWALIOR,1956,1893,BENGALURU-GWALIOR,3849,All
2021,10,BENGALURU,GWALIOR,2407,2085,BENGALURU-GWALIOR,4492,All
2021,11,BENGALURU,GWALIOR,2319,2125,BENGALURU-GWALIOR,4444,All
2021,12,BENGALURU,GWALIOR,2472,2542,BENGALURU-GWALIOR,5014,All
2022,1,BENGALURU,GWALIOR,2004,1691,BENGALURU-GWALIOR,3695,All
2022,2,BENGALURU,GWALIOR,2017,1985,BENGALURU-GWALIOR,4002,All
2022,3,BENGALURU,GWALIOR,2147,2178,BENGALURU-GWALIOR,4325,All
2022,4,BENGALURU,GWALIOR,2391,2417,BENGALURU-GWALIOR,4808,All
2022,5,BENGALURU,GWALIOR,2146,2263,BENGALURU-GWALIOR,4409,All
2022,6,BENGALURU,GWALIOR,2175,2183,BENGALURU-GWALIOR,4358,All
2022,7,BENGALURU,GWALIOR,2348,2338,BENGALURU-GWALIOR,4686,All
2022,8,BENGALURU,GWALIOR,2316,2273,BENGALURU-GWALIOR,4589,All
2022,9,BENGALURU,GWALIOR,1541,1334,BENGALURU-GWALIOR,2875,All
2022,10,BENGALURU,GWALIOR,2476,1981,BENGALURU-GWALIOR,4457,All
2022,11,BENGALURU,GWALIOR,1818,2294,BENGALURU-GWALIOR,4112,All
2022,12,BENGALURU,GWALIOR,2631,3040,BENGALURU-GWALIOR,5671,All
2023,1,BENGALURU,GWALIOR,2327,2391,BENGALURU-GWALIOR,4718,All
2023,2,BENGALURU,GWALIOR,2828,2698,BENGALURU-GWALIOR,5526,All
2023,3,BENGALURU,GWALIOR,2809,2813,BENGALURU-GWALIOR,5622,All
2023,4,BENGALURU,GWALIOR,2752,2231,BENGALURU-GWALIOR,4983,All
2023,5,BENGALURU,GWALIOR,2754,2954,BENGALURU-GWALIOR,5708,All
2023,6,BENGALURU,GWALIOR,2426,2468,BENGALURU-GWALIOR,4894,All
2023,7,BENGALURU,GWALIOR,2211,2176,BENGALURU-GWALIOR,4387,All
2023,8,BENGALURU,GWALIOR,2529,2234,BENGALURU-GWALIOR,4763,All
2023,9,BENGALURU,GWALIOR,2403,2288,BENGALURU-GWALIOR,4691,All
2023,10,BENGALURU,GWALIOR,1686,1172,BENGALURU-GWALIOR,2858,All
2023,11,BENGALURU,GWALIOR,2363,2054,BENGALURU-GWALIOR,4417,All
2023,12,BENGALURU,GWALIOR,292,369,BENGALURU-GWALIOR,661,All
2024,1,BENGALURU,GWALIOR,993,2160,BENGALURU-GWALIOR,3153,All
2024,2,BENGALURU,GWALIOR,4340,4410,BENGALURU-GWALIOR,8750,All
2024,3,BENGALURU,GWALIOR,4598,4389,BENGALURU-GWALIOR,8987,All
2024,4,BENGALURU,GWALIOR,4735,4441,BENGALURU-GWALIOR,9176,All
2024,6,BENGALURU,GWALIOR,4274,4666,BENGALURU-GWALIOR,8940,All
2024,7,BENGALURU,GWALIOR,3018,2990,BENGALURU-GWALIOR,6008,All
2024,8,BENGALURU,GWALIOR,4372,4343,BENGALURU-GWALIOR,8715,All
2024,9,BENGALURU,GWALIOR,4239,3678,BENGALURU-GWALIOR,7917,All
2024,10,BENGALURU,GWALIOR,4713,2913,BENGALURU-GWALIOR,7626,All
2024,11,BENGALURU,GWALIOR,2396,3094,BENGALURU-GWALIOR,5490,All
2024,12,BENGALURU,GWALIOR,4022,4774,BENGALURU-GWALIOR,8796,All
2025,1,BENGALURU,GWALIOR,2363,2573,BENGALURU-GWALIOR,4936,All
2025,2,BENGALURU,GWALIOR,4628,4197,BENGALURU-GWALIOR,8825,All
2025,3,BENGALURU,GWALIOR,4196,3792,BENGALURU-GWALIOR,7988,All
2023,11,BENGALURU,Goa,25530,25449,BENGALURU-Goa,50979,All
2023,12,BENGALURU,Goa,28517,29523,BENGALURU-Goa,58040,All
2024,1,BENGALURU,Goa,26963,30530,BENGALURU-Goa,57493,All
2024,2,BENGALURU,Goa,25351,25041,BENGALURU-Goa,50392,All
2024,3,BENGALURU,Goa,26169,25109,BENGALURU-Goa,51278,All
2024,4,BENGALURU,Goa,29589,29757,BENGALURU-Goa,59346,All
2024,6,BENGALURU,Goa,29978,30183,BENGALURU-Goa,60161,All
2024,7,BENGALURU,Goa,26153,25796,BENGALURU-Goa,51949,All
2024,8,BENGALURU,Goa,26956,25472,BENGALURU-Goa,52428,All
2024,9,BENGALURU,Goa,21842,21188,BENGALURU-Goa,43030,All
2024,10,BENGALURU,Goa,23600,22547,BENGALURU-Goa,46147,All
2024,11,BENGALURU,Goa,17712,18198,BENGALURU-Goa,35910,All
2024,12,BENGALURU,Goa,12904,12192,BENGALURU-Goa,25096,All
2025,1,BENGALURU,Goa,15423,15618,BENGALURU-Goa,31041,All
2025,2,BENGALURU,Goa,13071,13443,BENGALURU-Goa,26514,All
2025,3,BENGALURU,Goa,15938,16816,BENGALURU-Goa,32754,All
2025,3,BENGALURU,HINDON AIRPORT,7177,7351,BENGALURU-HINDON AIRPORT,14528,All
2015,5,BENGALURU,HUBLI,1448,1635,BENGALURU-HUBLI,3083,All
2015,6,BENGALURU,HUBLI,1388,1579,BENGALURU-HUBLI,2967,All
2015,7,BENGALURU,HUBLI,1303,1470,BENGALURU-HUBLI,2773,All
2015,8,BENGALURU,HUBLI,1440,1572,BENGALURU-HUBLI,3012,All
2015,9,BENGALURU,HUBLI,1353,1443,BENGALURU-HUBLI,2796,All
2015,10,BENGALURU,HUBLI,1407,1673,BENGALURU-HUBLI,3080,All
2015,11,BENGALURU,HUBLI,2096,2199,BENGALURU-HUBLI,4295,All
2015,12,BENGALURU,HUBLI,2479,2307,BENGALURU-HUBLI,4786,All
2016,1,BENGALURU,HUBLI,2330,2586,BENGALURU-HUBLI,4916,All
2016,2,BENGALURU,HUBLI,2315,2312,BENGALURU-HUBLI,4627,All
2016,3,BENGALURU,HUBLI,1588,1667,BENGALURU-HUBLI,3255,All
2016,4,BENGALURU,HUBLI,2325,2285,BENGALURU-HUBLI,4610,All
2016,5,BENGALURU,HUBLI,2029,2009,BENGALURU-HUBLI,4038,All
2016,6,BENGALURU,HUBLI,1403,1332,BENGALURU-HUBLI,2735,All
2016,7,BENGALURU,HUBLI,1411,1490,BENGALURU-HUBLI,2901,All
2016,8,BENGALURU,HUBLI,486,532,BENGALURU-HUBLI,1018,All
2016,9,BENGALURU,HUBLI,565,589,BENGALURU-HUBLI,1154,All
2016,10,BENGALURU,HUBLI,632,672,BENGALURU-HUBLI,1304,All
2016,11,BENGALURU,HUBLI,716,757,BENGALURU-HUBLI,1473,All
2016,12,BENGALURU,HUBLI,880,941,BENGALURU-HUBLI,1821,All
2017,1,BENGALURU,HUBLI,952,1015,BENGALURU-HUBLI,1967,All
2017,2,BENGALURU,HUBLI,870,922,BENGALURU-HUBLI,1792,All
2017,3,BENGALURU,HUBLI,790,830,BENGALURU-HUBLI,1620,All
2017,4,BENGALURU,HUBLI,650,722,BENGALURU-HUBLI,1372,All
2017,5,BENGALURU,HUBLI,1024,1096,BENGALURU-HUBLI,2120,All
2017,6,BENGALURU,HUBLI,1119,1153,BENGALURU-HUBLI,2272,All
2017,7,BENGALURU,HUBLI,1233,1299,BENGALURU-HUBLI,2532,All
2017,8,BENGALURU,HUBLI,1763,1894,BENGALURU-HUBLI,3657,All
2017,9,BENGALURU,HUBLI,1793,1778,BENGALURU-HUBLI,3571,All
2017,10,BENGALURU,HUBLI,1689,1883,BENGALURU-HUBLI,3572,All
2017,11,BENGALURU,HUBLI,1726,1813,BENGALURU-HUBLI,3539,All
2017,12,BENGALURU,HUBLI,2213,2258,BENGALURU-HUBLI,4471,All
2018,1,BENGALURU,HUBLI,2538,2744,BENGALURU-HUBLI,5282,All
2018,2,BENGALURU,HUBLI,2408,2479,BENGALURU-HUBLI,4887,All
2018,3,BENGALURU,HUBLI,2473,2651,BENGALURU-HUBLI,5124,All
2018,4,BENGALURU,HUBLI,2258,2377,BENGALURU-HUBLI,4635,All
2018,5,BENGALURU,HUBLI,4057,4407,BENGALURU-HUBLI,8464,All
2018,6,BENGALURU,HUBLI,6041,6234,BENGALURU-HUBLI,12275,All
2018,7,BENGALURU,HUBLI,9860,11271,BENGALURU-HUBLI,21131,All
2018,8,BENGALURU,HUBLI,9825,10852,BENGALURU-HUBLI,20677,All
2018,9,BENGALURU,HUBLI,10050,10650,BENGALURU-HUBLI,20700,All
2018,10,BENGALURU,HUBLI,9457,9962,BENGALURU-HUBLI,19419,All
2018,11,BENGALURU,HUBLI,9924,10102,BENGALURU-HUBLI,20026,All
2018,12,BENGALURU,HUBLI,10292,9956,BENGALURU-HUBLI,20248,All
2019,1,BENGALURU,HUBLI,7635,8596,BENGALURU-HUBLI,16231,All
2019,2,BENGALURU,HUBLI,7753,8260,BENGALURU-HUBLI,16013,All
2019,3,BENGALURU,HUBLI,7499,8267,BENGALURU-HUBLI,15766,All
2019,4,BENGALURU,HUBLI,8514,8875,BENGALURU-HUBLI,17389,All
2019,5,BENGALURU,HUBLI,8552,9853,BENGALURU-HUBLI,18405,All
2019,6,BENGALURU,HUBLI,7594,9316,BENGALURU-HUBLI,16910,All
2019,7,BENGALURU,HUBLI,6237,6319,BENGALURU-HUBLI,12556,All
2019,8,BENGALURU,HUBLI,6304,5899,BENGALURU-HUBLI,12203,All
2019,9,BENGALURU,HUBLI,6409,6707,BENGALURU-HUBLI,13116,All
2019,10,BENGALURU,HUBLI,6261,6448,BENGALURU-HUBLI,12709,All
2019,11,BENGALURU,HUBLI,4417,5569,BENGALURU-HUBLI,9986,All
2019,12,BENGALURU,HUBLI,4551,5479,BENGALURU-HUBLI,10030,All
2020,1,BENGALURU,HUBLI,4270,5159,BENGALURU-HUBLI,9429,All
2020,2,BENGALURU,HUBLI,4007,4429,BENGALURU-HUBLI,8436,All
2020,3,BENGALURU,HUBLI,2175,2394,BENGALURU-HUBLI,4569,All
2020,5,BENGALURU,HUBLI,5,14,BENGALURU-HUBLI,19,All
2020,7,BENGALURU,HUBLI,297,391,BENGALURU-HUBLI,688,All
2020,8,BENGALURU,HUBLI,865,1034,BENGALURU-HUBLI,1899,All
2020,9,BENGALURU,HUBLI,1450,1924,BENGALURU-HUBLI,3374,All
2020,10,BENGALURU,HUBLI,2149,2220,BENGALURU-HUBLI,4369,All
2020,11,BENGALURU,HUBLI,3950,3571,BENGALURU-HUBLI,7521,All
2020,12,BENGALURU,HUBLI,4820,4211,BENGALURU-HUBLI,9031,All
2021,1,BENGALURU,HUBLI,4480,4469,BENGALURU-HUBLI,8949,All
2021,2,BENGALURU,HUBLI,3989,4066,BENGALURU-HUBLI,8055,All
2021,3,BENGALURU,HUBLI,4365,4333,BENGALURU-HUBLI,8698,All
2021,4,BENGALURU,HUBLI,3402,3314,BENGALURU-HUBLI,6716,All
2021,6,BENGALURU,HUBLI,1704,1677,BENGALURU-HUBLI,3381,All
2021,7,BENGALURU,HUBLI,3825,3715,BENGALURU-HUBLI,7540,All
2021,8,BENGALURU,HUBLI,3923,4033,BENGALURU-HUBLI,7956,All
2021,9,BENGALURU,HUBLI,4212,4193,BENGALURU-HUBLI,8405,All
2021,10,BENGALURU,HUBLI,4658,4668,BENGALURU-HUBLI,9326,All
2021,11,BENGALURU,HUBLI,4685,4920,BENGALURU-HUBLI,9605,All
2021,12,BENGALURU,HUBLI,5177,5240,BENGALURU-HUBLI,10417,All
2022,1,BENGALURU,HUBLI,2466,3019,BENGALURU-HUBLI,5485,All
2022,2,BENGALURU,HUBLI,2447,2758,BENGALURU-HUBLI,5205,All
2022,3,BENGALURU,HUBLI,4970,5297,BENGALURU-HUBLI,10267,All
2022,4,BENGALURU,HUBLI,4668,4702,BENGALURU-HUBLI,9370,All
2022,5,BENGALURU,HUBLI,4606,4884,BENGALURU-HUBLI,9490,All
2022,6,BENGALURU,HUBLI,4758,4821,BENGALURU-HUBLI,9579,All
2022,7,BENGALURU,HUBLI,5025,5120,BENGALURU-HUBLI,10145,All
2022,8,BENGALURU,HUBLI,4845,4949,BENGALURU-HUBLI,9794,All
2022,9,BENGALURU,HUBLI,4743,4931,BENGALURU-HUBLI,9674,All
2022,10,BENGALURU,HUBLI,4344,4388,BENGALURU-HUBLI,8732,All
2022,11,BENGALURU,HUBLI,4354,4528,BENGALURU-HUBLI,8882,All
2022,12,BENGALURU,HUBLI,4702,4801,BENGALURU-HUBLI,9503,All
2023,1,BENGALURU,HUBLI,4222,4338,BENGALURU-HUBLI,8560,All
2023,2,BENGALURU,HUBLI,3632,3753,BENGALURU-HUBLI,7385,All
2023,3,BENGALURU,HUBLI,3998,4133,BENGALURU-HUBLI,8131,All
2023,4,BENGALURU,HUBLI,3774,3970,BENGALURU-HUBLI,7744,All
2023,5,BENGALURU,HUBLI,3932,4158,BENGALURU-HUBLI,8090,All
2023,6,BENGALURU,HUBLI,3898,4110,BENGALURU-HUBLI,8008,All
2023,7,BENGALURU,HUBLI,3740,3961,BENGALURU-HUBLI,7701,All
2023,8,BENGALURU,HUBLI,3960,3822,BENGALURU-HUBLI,7782,All
2023,9,BENGALURU,HUBLI,2840,2791,BENGALURU-HUBLI,5631,All
2023,10,BENGALURU,HUBLI,3631,3432,BENGALURU-HUBLI,7063,All
2023,11,BENGALURU,HUBLI,3777,3685,BENGALURU-HUBLI,7462,All
2023,12,BENGALURU,HUBLI,4421,4311,BENGALURU-HUBLI,8732,All
2024,1,BENGALURU,HUBLI,3943,4248,BENGALURU-HUBLI,8191,All
2024,2,BENGALURU,HUBLI,3791,3875,BENGALURU-HUBLI,7666,All
2024,3,BENGALURU,HUBLI,3803,3895,BENGALURU-HUBLI,7698,All
2024,4,BENGALURU,HUBLI,3891,4032,BENGALURU-HUBLI,7923,All
2024,6,BENGALURU,HUBLI,3868,4037,BENGALURU-HUBLI,7905,All
2024,7,BENGALURU,HUBLI,3723,3894,BENGALURU-HUBLI,7617,All
2024,8,BENGALURU,HUBLI,3866,3784,BENGALURU-HUBLI,7650,All
2024,9,BENGALURU,HUBLI,3843,3513,BENGALURU-HUBLI,7356,All
2024,10,BENGALURU,HUBLI,3999,3842,BENGALURU-HUBLI,7841,All
2024,11,BENGALURU,HUBLI,4032,4135,BENGALURU-HUBLI,8167,All
2024,12,BENGALURU,HUBLI,4215,4130,BENGALURU-HUBLI,8345,All
2025,1,BENGALURU,HUBLI,3906,4101,BENGALURU-HUBLI,8007,All
2025,2,BENGALURU,HUBLI,3165,3271,BENGALURU-HUBLI,6436,All
2025,3,BENGALURU,HUBLI,3906,3978,BENGALURU-HUBLI,7884,All
2015,4,BENGALURU,HYDERABAD,42464,43308,BENGALURU-HYDERABAD,85772,All
2015,5,BENGALURU,HYDERABAD,44472,49104,BENGALURU-HYDERABAD,93576,All
2015,6,BENGALURU,HYDERABAD,41908,41624,BENGALURU-HYDERABAD,83532,All
2015,7,BENGALURU,HYDERABAD,44190,44564,BENGALURU-HYDERABAD,88754,All
2015,8,BENGALURU,HYDERABAD,43192,43872,BENGALURU-HYDERABAD,87064,All
2015,9,BENGALURU,HYDERABAD,28130,29709,BENGALURU-HYDERABAD,57839,All
2015,9,BENGALURU,HYDERABAD,13244,12659,BENGALURU-HYDERABAD,25903,All
2015,10,BENGALURU,HYDERABAD,44428,49309,BENGALURU-HYDERABAD,93737,All
2015,11,BENGALURU,HYDERABAD,47492,48990,BENGALURU-HYDERABAD,96482,All
2015,12,BENGALURU,HYDERABAD,56157,56291,BENGALURU-HYDERABAD,112448,All
2016,1,BENGALURU,HYDERABAD,48510,50161,BENGALURU-HYDERABAD,98671,All
2016,2,BENGALURU,HYDERABAD,48620,48846,BENGALURU-HYDERABAD,97466,All
2016,3,BENGALURU,HYDERABAD,48430,48301,BENGALURU-HYDERABAD,96731,All
2016,4,BENGALURU,HYDERABAD,50661,50570,BENGALURU-HYDERABAD,101231,All
2016,5,BENGALURU,HYDERABAD,54355,55961,BENGALURU-HYDERABAD,110316,All
2016,6,BENGALURU,HYDERABAD,53215,50019,BENGALURU-HYDERABAD,103234,All
2016,7,BENGALURU,HYDERABAD,59060,57830,BENGALURU-HYDERABAD,116890,All
2016,8,BENGALURU,HYDERABAD,63234,62278,BENGALURU-HYDERABAD,125512,All
2016,9,BENGALURU,HYDERABAD,60359,57702,BENGALURU-HYDERABAD,118061,All
2016,10,BENGALURU,HYDERABAD,76304,71605,BENGALURU-HYDERABAD,147909,All
2016,11,BENGALURU,HYDERABAD,77078,78405,BENGALURU-HYDERABAD,155483,All
2016,12,BENGALURU,HYDERABAD,81027,80276,BENGALURU-HYDERABAD,161303,All
2017,1,BENGALURU,HYDERABAD,74669,74035,BENGALURU-HYDERABAD,148704,All
2017,2,BENGALURU,HYDERABAD,64554,64761,BENGALURU-HYDERABAD,129315,All
2017,3,BENGALURU,HYDERABAD,64847,64648,BENGALURU-HYDERABAD,129495,All
2017,4,BENGALURU,HYDERABAD,69564,67590,BENGALURU-HYDERABAD,137154,All
2017,5,BENGALURU,HYDERABAD,72935,78089,BENGALURU-HYDERABAD,151024,All
2017,6,BENGALURU,HYDERABAD,79310,74310,BENGALURU-HYDERABAD,153620,All
2017,7,BENGALURU,HYDERABAD,81795,81108,BENGALURU-HYDERABAD,162903,All
2017,8,BENGALURU,HYDERABAD,83555,82846,BENGALURU-HYDERABAD,166401,All
2017,9,BENGALURU,HYDERABAD,84144,82599,BENGALURU-HYDERABAD,166743,All
2017,10,BENGALURU,HYDERABAD,92816,96495,BENGALURU-HYDERABAD,189311,All
2017,11,BENGALURU,HYDERABAD,93145,95638,BENGALURU-HYDERABAD,188783,All
2017,12,BENGALURU,HYDERABAD,95530,96643,BENGALURU-HYDERABAD,192173,All
2018,1,BENGALURU,HYDERABAD,99138,101004,BENGALURU-HYDERABAD,200142,All
2018,2,BENGALURU,HYDERABAD,94705,93468,BENGALURU-HYDERABAD,188173,All
2018,3,BENGALURU,HYDERABAD,93681,93832,BENGALURU-HYDERABAD,187513,All
2018,4,BENGALURU,HYDERABAD,96035,97211,BENGALURU-HYDERABAD,193246,All
2018,5,BENGALURU,HYDERABAD,94024,102480,BENGALURU-HYDERABAD,196504,All
2018,6,BENGALURU,HYDERABAD,83272,89963,BENGALURU-HYDERABAD,173235,All
2018,7,BENGALURU,HYDERABAD,87276,99952,BENGALURU-HYDERABAD,187228,All
2018,8,BENGALURU,HYDERABAD,96426,96209,BENGALURU-HYDERABAD,192635,All
2018,9,BENGALURU,HYDERABAD,97477,96489,BENGALURU-HYDERABAD,193966,All
2018,10,BENGALURU,HYDERABAD,110343,104331,BENGALURU-HYDERABAD,214674,All
2018,11,BENGALURU,HYDERABAD,103123,104544,BENGALURU-HYDERABAD,207667,All
2018,12,BENGALURU,HYDERABAD,113446,113280,BENGALURU-HYDERABAD,226726,All
2019,1,BENGALURU,HYDERABAD,105962,109497,BENGALURU-HYDERABAD,215459,All
2019,2,BENGALURU,HYDERABAD,88291,87921,BENGALURU-HYDERABAD,176212,All
2019,3,BENGALURU,HYDERABAD,92457,93708,BENGALURU-HYDERABAD,186165,All
2019,4,BENGALURU,HYDERABAD,84029,82846,BENGALURU-HYDERABAD,166875,All
2019,5,BENGALURU,HYDERABAD,83092,86080,BENGALURU-HYDERABAD,169172,All
2019,6,BENGALURU,HYDERABAD,74734,74823,BENGALURU-HYDERABAD,149557,All
2019,7,BENGALURU,HYDERABAD,75682,77272,BENGALURU-HYDERABAD,152954,All
2019,8,BENGALURU,HYDERABAD,85919,87304,BENGALURU-HYDERABAD,173223,All
2019,9,BENGALURU,HYDERABAD,84384,84398,BENGALURU-HYDERABAD,168782,All
2019,10,BENGALURU,HYDERABAD,91844,88473,BENGALURU-HYDERABAD,180317,All
2019,11,BENGALURU,HYDERABAD,95126,100073,BENGALURU-HYDERABAD,195199,All
2019,12,BENGALURU,HYDERABAD,102274,103292,BENGALURU-HYDERABAD,205566,All
2020,1,BENGALURU,HYDERABAD,89345,91775,BENGALURU-HYDERABAD,181120,All
2020,2,BENGALURU,HYDERABAD,83685,84173,BENGALURU-HYDERABAD,167858,All
2020,3,BENGALURU,HYDERABAD,49214,42183,BENGALURU-HYDERABAD,91397,All
2020,5,BENGALURU,HYDERABAD,2572,1842,BENGALURU-HYDERABAD,4414,All
2020,6,BENGALURU,HYDERABAD,13936,11189,BENGALURU-HYDERABAD,25125,All
2020,7,BENGALURU,HYDERABAD,13182,11953,BENGALURU-HYDERABAD,25135,All
2020,8,BENGALURU,HYDERABAD,14127,16463,BENGALURU-HYDERABAD,30590,All
2020,9,BENGALURU,HYDERABAD,15846,19697,BENGALURU-HYDERABAD,35543,All
2020,10,BENGALURU,HYDERABAD,25996,27311,BENGALURU-HYDERABAD,53307,All
2020,11,BENGALURU,HYDERABAD,29021,29469,BENGALURU-HYDERABAD,58490,All
2020,12,BENGALURU,HYDERABAD,36443,40126,BENGALURU-HYDERABAD,76569,All
2021,1,BENGALURU,HYDERABAD,34643,40175,BENGALURU-HYDERABAD,74818,All
2021,2,BENGALURU,HYDERABAD,35483,38143,BENGALURU-HYDERABAD,73626,All
2021,3,BENGALURU,HYDERABAD,36760,38879,BENGALURU-HYDERABAD,75639,All
2021,4,BENGALURU,HYDERABAD,31013,24090,BENGALURU-HYDERABAD,55103,All
2021,6,BENGALURU,HYDERABAD,14866,16183,BENGALURU-HYDERABAD,31049,All
2021,7,BENGALURU,HYDERABAD,26167,31350,BENGALURU-HYDERABAD,57517,All
2021,8,BENGALURU,HYDERABAD,38247,41281,BENGALURU-HYDERABAD,79528,All
2021,9,BENGALURU,HYDERABAD,38055,41090,BENGALURU-HYDERABAD,79145,All
2021,10,BENGALURU,HYDERABAD,50712,47291,BENGALURU-HYDERABAD,98003,All
2021,11,BENGALURU,HYDERABAD,55892,59623,BENGALURU-HYDERABAD,115515,All
2021,12,BENGALURU,HYDERABAD,63890,67318,BENGALURU-HYDERABAD,131208,All
2022,1,BENGALURU,HYDERABAD,30702,32410,BENGALURU-HYDERABAD,63112,All
2022,2,BENGALURU,HYDERABAD,43190,46362,BENGALURU-HYDERABAD,89552,All
2022,3,BENGALURU,HYDERABAD,63044,65185,BENGALURU-HYDERABAD,128229,All
2022,4,BENGALURU,HYDERABAD,62003,61833,BENGALURU-HYDERABAD,123836,All
2022,5,BENGALURU,HYDERABAD,61141,68135,BENGALURU-HYDERABAD,129276,All
2022,6,BENGALURU,HYDERABAD,62705,59637,BENGALURU-HYDERABAD,122342,All
2022,7,BENGALURU,HYDERABAD,58000,58247,BENGALURU-HYDERABAD,116247,All
2022,8,BENGALURU,HYDERABAD,61089,63541,BENGALURU-HYDERABAD,124630,All
2022,9,BENGALURU,HYDERABAD,65318,64654,BENGALURU-HYDERABAD,129972,All
2022,10,BENGALURU,HYDERABAD,70114,66357,BENGALURU-HYDERABAD,136471,All
2022,11,BENGALURU,HYDERABAD,75235,80970,BENGALURU-HYDERABAD,156205,All
2022,12,BENGALURU,HYDERABAD,88518,85785,BENGALURU-HYDERABAD,174303,All
2023,1,BENGALURU,HYDERABAD,86422,90622,BENGALURU-HYDERABAD,177044,All
2023,2,BENGALURU,HYDERABAD,92089,93291,BENGALURU-HYDERABAD,185380,All
2023,3,BENGALURU,HYDERABAD,107566,110234,BENGALURU-HYDERABAD,217800,All
2023,4,BENGALURU,HYDERABAD,116205,112262,BENGALURU-HYDERABAD,228467,All
2023,5,BENGALURU,HYDERABAD,120030,124595,BENGALURU-HYDERABAD,244625,All
2023,6,BENGALURU,HYDERABAD,89742,88514,BENGALURU-HYDERABAD,178256,All
2023,7,BENGALURU,HYDERABAD,89956,91893,BENGALURU-HYDERABAD,181849,All
2023,8,BENGALURU,HYDERABAD,93740,91581,BENGALURU-HYDERABAD,185321,All
2023,9,BENGALURU,HYDERABAD,90447,88971,BENGALURU-HYDERABAD,179418,All
2023,10,BENGALURU,HYDERABAD,92355,89135,BENGALURU-HYDERABAD,181490,All
2023,11,BENGALURU,HYDERABAD,80809,79074,BENGALURU-HYDERABAD,159883,All
2023,12,BENGALURU,HYDERABAD,84401,84327,BENGALURU-HYDERABAD,168728,All
2024,1,BENGALURU,HYDERABAD,88636,92409,BENGALURU-HYDERABAD,181045,All
2024,2,BENGALURU,HYDERABAD,89404,90781,BENGALURU-HYDERABAD,180185,All
2024,3,BENGALURU,HYDERABAD,92431,90281,BENGALURU-HYDERABAD,182712,All
2024,4,BENGALURU,HYDERABAD,100190,97164,BENGALURU-HYDERABAD,197354,All
2024,6,BENGALURU,HYDERABAD,92263,87964,BENGALURU-HYDERABAD,180227,All
2024,7,BENGALURU,HYDERABAD,91988,91704,BENGALURU-HYDERABAD,183692,All
2024,8,BENGALURU,HYDERABAD,97638,97547,BENGALURU-HYDERABAD,195185,All
2024,9,BENGALURU,HYDERABAD,93420,91911,BENGALURU-HYDERABAD,185331,All
2024,10,BENGALURU,HYDERABAD,96543,89388,BENGALURU-HYDERABAD,185931,All
2024,11,BENGALURU,HYDERABAD,91887,93016,BENGALURU-HYDERABAD,184903,All
2024,12,BENGALURU,HYDERABAD,103815,101828,BENGALURU-HYDERABAD,205643,All
2025,1,BENGALURU,HYDERABAD,96188,98008,BENGALURU-HYDERABAD,194196,All
2025,2,BENGALURU,HYDERABAD,93484,91552,BENGALURU-HYDERABAD,185036,All
2025,3,BENGALURU,HYDERABAD,104936,101042,BENGALURU-HYDERABAD,205978,All
2015,4,BENGALURU,IMPHAL,748,622,BENGALURU-IMPHAL,1370,All
2015,5,BENGALURU,IMPHAL,679,715,BENGALURU-IMPHAL,1394,All
2015,6,BENGALURU,IMPHAL,474,664,BENGALURU-IMPHAL,1138,All
2015,7,BENGALURU,IMPHAL,403,479,BENGALURU-IMPHAL,882,All
2015,8,BENGALURU,IMPHAL,268,433,BENGALURU-IMPHAL,701,All
2015,9,BENGALURU,IMPHAL,155,153,BENGALURU-IMPHAL,308,All
2015,10,BENGALURU,IMPHAL,378,214,BENGALURU-IMPHAL,592,All
2015,11,BENGALURU,IMPHAL,420,312,BENGALURU-IMPHAL,732,All
2015,12,BENGALURU,IMPHAL,417,401,BENGALURU-IMPHAL,818,All
2016,1,BENGALURU,IMPHAL,475,635,BENGALURU-IMPHAL,1110,All
2016,2,BENGALURU,IMPHAL,179,344,BENGALURU-IMPHAL,523,All
2016,3,BENGALURU,IMPHAL,220,264,BENGALURU-IMPHAL,484,All
2016,4,BENGALURU,IMPHAL,235,739,BENGALURU-IMPHAL,974,All
2016,5,BENGALURU,IMPHAL,326,1151,BENGALURU-IMPHAL,1477,All
2016,6,BENGALURU,IMPHAL,263,1533,BENGALURU-IMPHAL,1796,All
2016,7,BENGALURU,IMPHAL,71,1529,BENGALURU-IMPHAL,1600,All
2016,8,BENGALURU,IMPHAL,80,1464,BENGALURU-IMPHAL,1544,All
2016,9,BENGALURU,IMPHAL,60,657,BENGALURU-IMPHAL,717,All
2016,10,BENGALURU,IMPHAL,529,633,BENGALURU-IMPHAL,1162,All
2016,11,BENGALURU,IMPHAL,800,855,BENGALURU-IMPHAL,1655,All
2016,12,BENGALURU,IMPHAL,644,754,BENGALURU-IMPHAL,1398,All
2017,1,BENGALURU,IMPHAL,0,149,BENGALURU-IMPHAL,149,All
2017,2,BENGALURU,IMPHAL,759,984,BENGALURU-IMPHAL,1743,All
2017,3,BENGALURU,IMPHAL,827,887,BENGALURU-IMPHAL,1714,All
2017,4,BENGALURU,IMPHAL,900,994,BENGALURU-IMPHAL,1894,All
2017,5,BENGALURU,IMPHAL,1066,1212,BENGALURU-IMPHAL,2278,All
2017,6,BENGALURU,IMPHAL,1240,1507,BENGALURU-IMPHAL,2747,All
2017,7,BENGALURU,IMPHAL,895,1464,BENGALURU-IMPHAL,2359,All
2017,8,BENGALURU,IMPHAL,923,1026,BENGALURU-IMPHAL,1949,All
2017,9,BENGALURU,IMPHAL,813,788,BENGALURU-IMPHAL,1601,All
2017,10,BENGALURU,IMPHAL,657,634,BENGALURU-IMPHAL,1291,All
2017,11,BENGALURU,IMPHAL,120,151,BENGALURU-IMPHAL,271,All
2017,12,BENGALURU,IMPHAL,767,755,BENGALURU-IMPHAL,1522,All
2018,1,BENGALURU,IMPHAL,1039,792,BENGALURU-IMPHAL,1831,All
2018,2,BENGALURU,IMPHAL,811,811,BENGALURU-IMPHAL,1622,All
2018,3,BENGALURU,IMPHAL,493,913,BENGALURU-IMPHAL,1406,All
2018,4,BENGALURU,IMPHAL,688,587,BENGALURU-IMPHAL,1275,All
2018,5,BENGALURU,IMPHAL,790,1019,BENGALURU-IMPHAL,1809,All
2018,6,BENGALURU,IMPHAL,864,1233,BENGALURU-IMPHAL,2097,All
2018,7,BENGALURU,IMPHAL,588,780,BENGALURU-IMPHAL,1368,All
2018,8,BENGALURU,IMPHAL,548,835,BENGALURU-IMPHAL,1383,All
2018,9,BENGALURU,IMPHAL,834,919,BENGALURU-IMPHAL,1753,All
2018,10,BENGALURU,IMPHAL,1571,1115,BENGALURU-IMPHAL,2686,All
2018,11,BENGALURU,IMPHAL,1875,1398,BENGALURU-IMPHAL,3273,All
2018,12,BENGALURU,IMPHAL,2554,1708,BENGALURU-IMPHAL,4262,All
2019,1,BENGALURU,IMPHAL,1817,2092,BENGALURU-IMPHAL,3909,All
2019,2,BENGALURU,IMPHAL,1103,1486,BENGALURU-IMPHAL,2589,All
2019,3,BENGALURU,IMPHAL,4672,3612,BENGALURU-IMPHAL,8284,All
2019,4,BENGALURU,IMPHAL,5085,3798,BENGALURU-IMPHAL,8883,All
2019,5,BENGALURU,IMPHAL,4859,5005,BENGALURU-IMPHAL,9864,All
2019,6,BENGALURU,IMPHAL,3948,5586,BENGALURU-IMPHAL,9534,All
2019,7,BENGALURU,IMPHAL,3303,4987,BENGALURU-IMPHAL,8290,All
2019,8,BENGALURU,IMPHAL,3594,4431,BENGALURU-IMPHAL,8025,All
2019,9,BENGALURU,IMPHAL,1817,1989,BENGALURU-IMPHAL,3806,All
2019,10,BENGALURU,IMPHAL,4854,4033,BENGALURU-IMPHAL,8887,All
2019,11,BENGALURU,IMPHAL,2921,3501,BENGALURU-IMPHAL,6422,All
2019,12,BENGALURU,IMPHAL,1756,1575,BENGALURU-IMPHAL,3331,All
2020,1,BENGALURU,IMPHAL,1969,1537,BENGALURU-IMPHAL,3506,All
2020,2,BENGALURU,IMPHAL,2008,1563,BENGALURU-IMPHAL,3571,All
2020,3,BENGALURU,IMPHAL,1817,961,BENGALURU-IMPHAL,2778,All
2020,8,BENGALURU,IMPHAL,24,29,BENGALURU-IMPHAL,53,All
2020,9,BENGALURU,IMPHAL,377,474,BENGALURU-IMPHAL,851,All
2020,10,BENGALURU,IMPHAL,499,702,BENGALURU-IMPHAL,1201,All
2020,11,BENGALURU,IMPHAL,965,1458,BENGALURU-IMPHAL,2423,All
2020,12,BENGALURU,IMPHAL,1801,1427,BENGALURU-IMPHAL,3228,All
2021,1,BENGALURU,IMPHAL,789,2117,BENGALURU-IMPHAL,2906,All
2021,2,BENGALURU,IMPHAL,863,1542,BENGALURU-IMPHAL,2405,All
2021,3,BENGALURU,IMPHAL,1016,1201,BENGALURU-IMPHAL,2217,All
2021,4,BENGALURU,IMPHAL,2899,1445,BENGALURU-IMPHAL,4344,All
2021,6,BENGALURU,IMPHAL,0,71,BENGALURU-IMPHAL,71,All
2021,8,BENGALURU,IMPHAL,151,1578,BENGALURU-IMPHAL,1729,All
2021,9,BENGALURU,IMPHAL,672,586,BENGALURU-IMPHAL,1258,All
2021,10,BENGALURU,IMPHAL,453,1934,BENGALURU-IMPHAL,2387,All
2021,11,BENGALURU,IMPHAL,450,499,BENGALURU-IMPHAL,949,All
2021,12,BENGALURU,IMPHAL,837,358,BENGALURU-IMPHAL,1195,All
2022,1,BENGALURU,IMPHAL,374,457,BENGALURU-IMPHAL,831,All
2022,2,BENGALURU,IMPHAL,211,238,BENGALURU-IMPHAL,449,All
2022,3,BENGALURU,IMPHAL,324,390,BENGALURU-IMPHAL,714,All
2022,4,BENGALURU,IMPHAL,1299,1332,BENGALURU-IMPHAL,2631,All
2022,5,BENGALURU,IMPHAL,1029,1305,BENGALURU-IMPHAL,2334,All
2022,6,BENGALURU,IMPHAL,1043,830,BENGALURU-IMPHAL,1873,All
2022,7,BENGALURU,IMPHAL,828,867,BENGALURU-IMPHAL,1695,All
2022,8,BENGALURU,IMPHAL,515,557,BENGALURU-IMPHAL,1072,All
2022,9,BENGALURU,IMPHAL,208,298,BENGALURU-IMPHAL,506,All
2022,10,BENGALURU,IMPHAL,690,426,BENGALURU-IMPHAL,1116,All
2022,11,BENGALURU,IMPHAL,423,321,BENGALURU-IMPHAL,744,All
2022,12,BENGALURU,IMPHAL,809,343,BENGALURU-IMPHAL,1152,All
2023,1,BENGALURU,IMPHAL,892,717,BENGALURU-IMPHAL,1609,All
2023,2,BENGALURU,IMPHAL,487,267,BENGALURU-IMPHAL,754,All
2023,3,BENGALURU,IMPHAL,956,333,BENGALURU-IMPHAL,1289,All
2023,4,BENGALURU,IMPHAL,1991,1059,BENGALURU-IMPHAL,3050,All
2023,5,BENGALURU,IMPHAL,1191,1397,BENGALURU-IMPHAL,2588,All
2023,6,BENGALURU,IMPHAL,1077,1414,BENGALURU-IMPHAL,2491,All
2023,7,BENGALURU,IMPHAL,401,581,BENGALURU-IMPHAL,982,All
2023,8,BENGALURU,IMPHAL,265,457,BENGALURU-IMPHAL,722,All
2023,9,BENGALURU,IMPHAL,409,308,BENGALURU-IMPHAL,717,All
2023,10,BENGALURU,IMPHAL,463,299,BENGALURU-IMPHAL,762,All
2023,11,BENGALURU,IMPHAL,828,703,BENGALURU-IMPHAL,1531,All
2023,12,BENGALURU,IMPHAL,2203,1447,BENGALURU-IMPHAL,3650,All
2024,1,BENGALURU,IMPHAL,778,1497,BENGALURU-IMPHAL,2275,All
2024,2,BENGALURU,IMPHAL,925,1022,BENGALURU-IMPHAL,1947,All
2024,3,BENGALURU,IMPHAL,1215,836,BENGALURU-IMPHAL,2051,All
2024,4,BENGALURU,IMPHAL,943,567,BENGALURU-IMPHAL,1510,All
2024,6,BENGALURU,IMPHAL,1171,759,BENGALURU-IMPHAL,1930,All
2024,7,BENGALURU,IMPHAL,753,584,BENGALURU-IMPHAL,1337,All
2024,8,BENGALURU,IMPHAL,713,423,BENGALURU-IMPHAL,1136,All
2024,9,BENGALURU,IMPHAL,599,213,BENGALURU-IMPHAL,812,All
2024,10,BENGALURU,IMPHAL,1112,425,BENGALURU-IMPHAL,1537,All
2024,11,BENGALURU,IMPHAL,491,545,BENGALURU-IMPHAL,1036,All
2024,12,BENGALURU,IMPHAL,665,546,BENGALURU-IMPHAL,1211,All
2025,3,BENGALURU,IMPHAL,849,704,BENGALURU-IMPHAL,1553,All
2015,4,BENGALURU,INDORE,1595,1754,BENGALURU-INDORE,3349,All
2015,5,BENGALURU,INDORE,1552,2223,BENGALURU-INDORE,3775,All
2015,6,BENGALURU,INDORE,1433,2288,BENGALURU-INDORE,3721,All
2015,7,BENGALURU,INDORE,1468,2399,BENGALURU-INDORE,3867,All
2015,8,BENGALURU,INDORE,1541,2486,BENGALURU-INDORE,4027,All
2015,9,BENGALURU,INDORE,1307,2188,BENGALURU-INDORE,3495,All
2015,10,BENGALURU,INDORE,1500,2415,BENGALURU-INDORE,3915,All
2015,11,BENGALURU,INDORE,1448,2121,BENGALURU-INDORE,3569,All
2015,12,BENGALURU,INDORE,1553,2197,BENGALURU-INDORE,3750,All
2016,1,BENGALURU,INDORE,1586,2196,BENGALURU-INDORE,3782,All
2016,2,BENGALURU,INDORE,1313,1824,BENGALURU-INDORE,3137,All
2016,3,BENGALURU,INDORE,1555,1882,BENGALURU-INDORE,3437,All
2016,4,BENGALURU,INDORE,1788,2025,BENGALURU-INDORE,3813,All
2016,5,BENGALURU,INDORE,2313,3175,BENGALURU-INDORE,5488,All
2016,6,BENGALURU,INDORE,1509,2127,BENGALURU-INDORE,3636,All
2016,7,BENGALURU,INDORE,1382,1927,BENGALURU-INDORE,3309,All
2016,8,BENGALURU,INDORE,1371,1818,BENGALURU-INDORE,3189,All
2016,9,BENGALURU,INDORE,1089,1460,BENGALURU-INDORE,2549,All
2016,10,BENGALURU,INDORE,1641,1855,BENGALURU-INDORE,3496,All
2016,11,BENGALURU,INDORE,2136,3266,BENGALURU-INDORE,5402,All
2016,12,BENGALURU,INDORE,4770,5629,BENGALURU-INDORE,10399,All
2017,1,BENGALURU,INDORE,5107,5382,BENGALURU-INDORE,10489,All
2017,2,BENGALURU,INDORE,4710,4596,BENGALURU-INDORE,9306,All
2017,3,BENGALURU,INDORE,4437,3904,BENGALURU-INDORE,8341,All
2017,4,BENGALURU,INDORE,4307,3679,BENGALURU-INDORE,7986,All
2017,5,BENGALURU,INDORE,4621,5014,BENGALURU-INDORE,9635,All
2017,6,BENGALURU,INDORE,4630,4383,BENGALURU-INDORE,9013,All
2017,7,BENGALURU,INDORE,3652,4595,BENGALURU-INDORE,8247,All
2017,8,BENGALURU,INDORE,4298,4784,BENGALURU-INDORE,9082,All
2017,9,BENGALURU,INDORE,4346,4428,BENGALURU-INDORE,8774,All
2017,10,BENGALURU,INDORE,4844,5158,BENGALURU-INDORE,10002,All
2017,11,BENGALURU,INDORE,4581,5321,BENGALURU-INDORE,9902,All
2017,12,BENGALURU,INDORE,5552,6543,BENGALURU-INDORE,12095,All
2018,1,BENGALURU,INDORE,4839,6017,BENGALURU-INDORE,10856,All
2018,2,BENGALURU,INDORE,5666,6081,BENGALURU-INDORE,11747,All
2018,3,BENGALURU,INDORE,10084,9449,BENGALURU-INDORE,19533,All
2018,4,BENGALURU,INDORE,16914,15958,BENGALURU-INDORE,32872,All
2018,5,BENGALURU,INDORE,12264,14924,BENGALURU-INDORE,27188,All
2018,6,BENGALURU,INDORE,12749,25613,BENGALURU-INDORE,38362,All
2018,7,BENGALURU,INDORE,19765,35045,BENGALURU-INDORE,54810,All
2018,8,BENGALURU,INDORE,21937,23679,BENGALURU-INDORE,45616,All
2018,9,BENGALURU,INDORE,17563,18179,BENGALURU-INDORE,35742,All
2018,10,BENGALURU,INDORE,20055,16443,BENGALURU-INDORE,36498,All
2018,11,BENGALURU,INDORE,22334,24530,BENGALURU-INDORE,46864,All
2018,12,BENGALURU,INDORE,31189,32166,BENGALURU-INDORE,63355,All
2019,1,BENGALURU,INDORE,29424,30504,BENGALURU-INDORE,59928,All
2019,2,BENGALURU,INDORE,21445,22334,BENGALURU-INDORE,43779,All
2019,3,BENGALURU,INDORE,24363,23311,BENGALURU-INDORE,47674,All
2019,4,BENGALURU,INDORE,20632,16535,BENGALURU-INDORE,37167,All
2019,5,BENGALURU,INDORE,19534,19975,BENGALURU-INDORE,39509,All
2019,6,BENGALURU,INDORE,16422,15047,BENGALURU-INDORE,31469,All
2019,7,BENGALURU,INDORE,14089,13430,BENGALURU-INDORE,27519,All
2019,8,BENGALURU,INDORE,13935,13052,BENGALURU-INDORE,26987,All
2019,9,BENGALURU,INDORE,14052,12762,BENGALURU-INDORE,26814,All
2019,10,BENGALURU,INDORE,15567,12623,BENGALURU-INDORE,28190,All
2019,11,BENGALURU,INDORE,14595,14752,BENGALURU-INDORE,29347,All
2019,12,BENGALURU,INDORE,16141,14136,BENGALURU-INDORE,30277,All
2020,1,BENGALURU,INDORE,15359,14220,BENGALURU-INDORE,29579,All
2020,2,BENGALURU,INDORE,13662,13508,BENGALURU-INDORE,27170,All
2020,3,BENGALURU,INDORE,9991,6864,BENGALURU-INDORE,16855,All
2020,5,BENGALURU,INDORE,329,56,BENGALURU-INDORE,385,All
2020,6,BENGALURU,INDORE,2462,1655,BENGALURU-INDORE,4117,All
2020,7,BENGALURU,INDORE,2734,1011,BENGALURU-INDORE,3745,All
2020,8,BENGALURU,INDORE,3014,2198,BENGALURU-INDORE,5212,All
2020,9,BENGALURU,INDORE,3469,3155,BENGALURU-INDORE,6624,All
2020,10,BENGALURU,INDORE,5952,4637,BENGALURU-INDORE,10589,All
2020,11,BENGALURU,INDORE,7619,6730,BENGALURU-INDORE,14349,All
2020,12,BENGALURU,INDORE,6627,8186,BENGALURU-INDORE,14813,All
2021,1,BENGALURU,INDORE,7590,8540,BENGALURU-INDORE,16130,All
2021,2,BENGALURU,INDORE,8837,8115,BENGALURU-INDORE,16952,All
2021,3,BENGALURU,INDORE,7583,6348,BENGALURU-INDORE,13931,All
2021,4,BENGALURU,INDORE,4419,3576,BENGALURU-INDORE,7995,All
2021,6,BENGALURU,INDORE,2648,2520,BENGALURU-INDORE,5168,All
2021,7,BENGALURU,INDORE,4395,4791,BENGALURU-INDORE,9186,All
2021,8,BENGALURU,INDORE,6388,6541,BENGALURU-INDORE,12929,All
2021,9,BENGALURU,INDORE,5343,6152,BENGALURU-INDORE,11495,All
2021,10,BENGALURU,INDORE,8386,7271,BENGALURU-INDORE,15657,All
2021,11,BENGALURU,INDORE,9380,9663,BENGALURU-INDORE,19043,All
2021,12,BENGALURU,INDORE,12597,14549,BENGALURU-INDORE,27146,All
2022,1,BENGALURU,INDORE,7316,7018,BENGALURU-INDORE,14334,All
2022,2,BENGALURU,INDORE,6430,7158,BENGALURU-INDORE,13588,All
2022,3,BENGALURU,INDORE,9083,9795,BENGALURU-INDORE,18878,All
2022,4,BENGALURU,INDORE,9371,9298,BENGALURU-INDORE,18669,All
2022,5,BENGALURU,INDORE,11321,15620,BENGALURU-INDORE,26941,All
2022,6,BENGALURU,INDORE,12813,13976,BENGALURU-INDORE,26789,All
2022,7,BENGALURU,INDORE,11340,12579,BENGALURU-INDORE,23919,All
2022,8,BENGALURU,INDORE,13704,14174,BENGALURU-INDORE,27878,All
2022,9,BENGALURU,INDORE,12761,11789,BENGALURU-INDORE,24550,All
2022,10,BENGALURU,INDORE,12420,11663,BENGALURU-INDORE,24083,All
2022,11,BENGALURU,INDORE,11302,13326,BENGALURU-INDORE,24628,All
2022,12,BENGALURU,INDORE,12500,13217,BENGALURU-INDORE,25717,All
2023,1,BENGALURU,INDORE,12110,12759,BENGALURU-INDORE,24869,All
2023,2,BENGALURU,INDORE,12144,12356,BENGALURU-INDORE,24500,All
2023,3,BENGALURU,INDORE,11797,13036,BENGALURU-INDORE,24833,All
2023,4,BENGALURU,INDORE,12674,12715,BENGALURU-INDORE,25389,All
2023,5,BENGALURU,INDORE,13059,14865,BENGALURU-INDORE,27924,All
2023,6,BENGALURU,INDORE,13364,14507,BENGALURU-INDORE,27871,All
2023,7,BENGALURU,INDORE,12453,14203,BENGALURU-INDORE,26656,All
2023,8,BENGALURU,INDORE,13537,13748,BENGALURU-INDORE,27285,All
2023,9,BENGALURU,INDORE,12841,13991,BENGALURU-INDORE,26832,All
2023,10,BENGALURU,INDORE,13741,12910,BENGALURU-INDORE,26651,All
2023,11,BENGALURU,INDORE,13461,12850,BENGALURU-INDORE,26311,All
2023,12,BENGALURU,INDORE,13980,14608,BENGALURU-INDORE,28588,All
2024,1,BENGALURU,INDORE,13722,14566,BENGALURU-INDORE,28288,All
2024,2,BENGALURU,INDORE,13147,13733,BENGALURU-INDORE,26880,All
2024,3,BENGALURU,INDORE,14442,15197,BENGALURU-INDORE,29639,All
2024,4,BENGALURU,INDORE,14224,13636,BENGALURU-INDORE,27860,All
2024,6,BENGALURU,INDORE,14063,14067,BENGALURU-INDORE,28130,All
2024,7,BENGALURU,INDORE,13064,13324,BENGALURU-INDORE,26388,All
2024,8,BENGALURU,INDORE,14326,14439,BENGALURU-INDORE,28765,All
2024,9,BENGALURU,INDORE,16133,16249,BENGALURU-INDORE,32382,All
2024,10,BENGALURU,INDORE,18351,14167,BENGALURU-INDORE,32518,All
2024,11,BENGALURU,INDORE,16359,18633,BENGALURU-INDORE,34992,All
2024,12,BENGALURU,INDORE,16853,17141,BENGALURU-INDORE,33994,All
2025,1,BENGALURU,INDORE,17797,18005,BENGALURU-INDORE,35802,All
2025,2,BENGALURU,INDORE,19200,18579,BENGALURU-INDORE,37779,All
2025,3,BENGALURU,INDORE,19873,19913,BENGALURU-INDORE,39786,All
2015,7,BENGALURU,JABALPUR,298,428,BENGALURU-JABALPUR,726,All
2015,8,BENGALURU,JABALPUR,442,490,BENGALURU-JABALPUR,932,All
2015,9,BENGALURU,JABALPUR,320,529,BENGALURU-JABALPUR,849,All
2015,10,BENGALURU,JABALPUR,237,426,BENGALURU-JABALPUR,663,All
2015,11,BENGALURU,JABALPUR,176,258,BENGALURU-JABALPUR,434,All
2015,12,BENGALURU,JABALPUR,9,18,BENGALURU-JABALPUR,27,All
2020,11,BENGALURU,JABALPUR,671,627,BENGALURU-JABALPUR,1298,All
2020,12,BENGALURU,JABALPUR,1799,1958,BENGALURU-JABALPUR,3757,All
2021,1,BENGALURU,JABALPUR,1438,1697,BENGALURU-JABALPUR,3135,All
2021,2,BENGALURU,JABALPUR,1433,1490,BENGALURU-JABALPUR,2923,All
2021,3,BENGALURU,JABALPUR,645,587,BENGALURU-JABALPUR,1232,All
2021,4,BENGALURU,JABALPUR,1492,890,BENGALURU-JABALPUR,2382,All
2021,6,BENGALURU,JABALPUR,881,842,BENGALURU-JABALPUR,1723,All
2021,7,BENGALURU,JABALPUR,1339,1726,BENGALURU-JABALPUR,3065,All
2021,8,BENGALURU,JABALPUR,1604,1740,BENGALURU-JABALPUR,3344,All
2021,9,BENGALURU,JABALPUR,1393,1570,BENGALURU-JABALPUR,2963,All
2021,10,BENGALURU,JABALPUR,2472,1952,BENGALURU-JABALPUR,4424,All
2021,11,BENGALURU,JABALPUR,986,1043,BENGALURU-JABALPUR,2029,All
2021,12,BENGALURU,JABALPUR,1526,1589,BENGALURU-JABALPUR,3115,All
2022,1,BENGALURU,JABALPUR,1864,1485,BENGALURU-JABALPUR,3349,All
2022,2,BENGALURU,JABALPUR,2106,2101,BENGALURU-JABALPUR,4207,All
2022,3,BENGALURU,JABALPUR,2220,2374,BENGALURU-JABALPUR,4594,All
2022,4,BENGALURU,JABALPUR,2442,2368,BENGALURU-JABALPUR,4810,All
2022,5,BENGALURU,JABALPUR,2305,2515,BENGALURU-JABALPUR,4820,All
2022,6,BENGALURU,JABALPUR,1860,1918,BENGALURU-JABALPUR,3778,All
2022,7,BENGALURU,JABALPUR,1638,1951,BENGALURU-JABALPUR,3589,All
2022,8,BENGALURU,JABALPUR,1864,1939,BENGALURU-JABALPUR,3803,All
2022,9,BENGALURU,JABALPUR,1730,1520,BENGALURU-JABALPUR,3250,All
2022,10,BENGALURU,JABALPUR,2293,1858,BENGALURU-JABALPUR,4151,All
2022,11,BENGALURU,JABALPUR,731,1039,BENGALURU-JABALPUR,1770,All
2024,9,BENGALURU,JABALPUR,2881,2898,BENGALURU-JABALPUR,5779,All
2024,10,BENGALURU,JABALPUR,2801,2360,BENGALURU-JABALPUR,5161,All
2024,11,BENGALURU,JABALPUR,2636,2917,BENGALURU-JABALPUR,5553,All
2024,12,BENGALURU,JABALPUR,2809,2987,BENGALURU-JABALPUR,5796,All
2025,1,BENGALURU,JABALPUR,3237,3145,BENGALURU-JABALPUR,6382,All
2025,2,BENGALURU,JABALPUR,2614,2533,BENGALURU-JABALPUR,5147,All
2025,3,BENGALURU,JABALPUR,2916,2961,BENGALURU-JABALPUR,5877,All
2015,4,BENGALURU,JAIPUR,22084,17984,BENGALURU-JAIPUR,40068,All
2015,5,BENGALURU,JAIPUR,20381,23868,BENGALURU-JAIPUR,44249,All
2015,6,BENGALURU,JAIPUR,19709,21116,BENGALURU-JAIPUR,40825,All
2015,7,BENGALURU,JAIPUR,20774,19318,BENGALURU-JAIPUR,40092,All
2015,8,BENGALURU,JAIPUR,20609,19647,BENGALURU-JAIPUR,40256,All
2015,9,BENGALURU,JAIPUR,10297,9558,BENGALURU-JAIPUR,19855,All
2015,9,BENGALURU,JAIPUR,10154,9660,BENGALURU-JAIPUR,19814,All
2015,10,BENGALURU,JAIPUR,23815,21866,BENGALURU-JAIPUR,45681,All
2015,11,BENGALURU,JAIPUR,23878,21797,BENGALURU-JAIPUR,45675,All
2015,12,BENGALURU,JAIPUR,24189,24545,BENGALURU-JAIPUR,48734,All
2016,1,BENGALURU,JAIPUR,20903,20157,BENGALURU-JAIPUR,41060,All
2016,2,BENGALURU,JAIPUR,18080,18086,BENGALURU-JAIPUR,36166,All
2016,3,BENGALURU,JAIPUR,19557,17477,BENGALURU-JAIPUR,37034,All
2016,4,BENGALURU,JAIPUR,20395,17920,BENGALURU-JAIPUR,38315,All
2016,5,BENGALURU,JAIPUR,21327,25010,BENGALURU-JAIPUR,46337,All
2016,6,BENGALURU,JAIPUR,20720,19557,BENGALURU-JAIPUR,40277,All
2016,7,BENGALURU,JAIPUR,22224,20981,BENGALURU-JAIPUR,43205,All
2016,8,BENGALURU,JAIPUR,21521,20188,BENGALURU-JAIPUR,41709,All
2016,9,BENGALURU,JAIPUR,21465,19160,BENGALURU-JAIPUR,40625,All
2016,10,BENGALURU,JAIPUR,23992,19126,BENGALURU-JAIPUR,43118,All
2016,11,BENGALURU,JAIPUR,24315,24390,BENGALURU-JAIPUR,48705,All
2016,12,BENGALURU,JAIPUR,23707,24479,BENGALURU-JAIPUR,48186,All
2017,1,BENGALURU,JAIPUR,24597,23485,BENGALURU-JAIPUR,48082,All
2017,2,BENGALURU,JAIPUR,20797,20301,BENGALURU-JAIPUR,41098,All
2017,3,BENGALURU,JAIPUR,16395,15958,BENGALURU-JAIPUR,32353,All
2017,4,BENGALURU,JAIPUR,17323,15810,BENGALURU-JAIPUR,33133,All
2017,5,BENGALURU,JAIPUR,21237,22133,BENGALURU-JAIPUR,43370,All
2017,6,BENGALURU,JAIPUR,20973,20196,BENGALURU-JAIPUR,41169,All
2017,7,BENGALURU,JAIPUR,21339,20281,BENGALURU-JAIPUR,41620,All
2017,8,BENGALURU,JAIPUR,22742,21160,BENGALURU-JAIPUR,43902,All
2017,9,BENGALURU,JAIPUR,21346,18139,BENGALURU-JAIPUR,39485,All
2017,10,BENGALURU,JAIPUR,23183,21038,BENGALURU-JAIPUR,44221,All
2017,11,BENGALURU,JAIPUR,22498,20515,BENGALURU-JAIPUR,43013,All
2017,12,BENGALURU,JAIPUR,25151,23611,BENGALURU-JAIPUR,48762,All
2018,1,BENGALURU,JAIPUR,26492,24721,BENGALURU-JAIPUR,51213,All
2018,2,BENGALURU,JAIPUR,27122,24844,BENGALURU-JAIPUR,51966,All
2018,3,BENGALURU,JAIPUR,25118,24625,BENGALURU-JAIPUR,49743,All
2018,4,BENGALURU,JAIPUR,22558,19438,BENGALURU-JAIPUR,41996,All
2018,5,BENGALURU,JAIPUR,21816,22076,BENGALURU-JAIPUR,43892,All
2018,6,BENGALURU,JAIPUR,21793,19242,BENGALURU-JAIPUR,41035,All
2018,7,BENGALURU,JAIPUR,21965,18799,BENGALURU-JAIPUR,40764,All
2018,8,BENGALURU,JAIPUR,31619,28741,BENGALURU-JAIPUR,60360,All
2018,9,BENGALURU,JAIPUR,27962,24440,BENGALURU-JAIPUR,52402,All
2018,10,BENGALURU,JAIPUR,31133,25965,BENGALURU-JAIPUR,57098,All
2018,11,BENGALURU,JAIPUR,26303,24217,BENGALURU-JAIPUR,50520,All
2018,12,BENGALURU,JAIPUR,30460,29491,BENGALURU-JAIPUR,59951,All
2019,1,BENGALURU,JAIPUR,34201,31737,BENGALURU-JAIPUR,65938,All
2019,2,BENGALURU,JAIPUR,25398,24144,BENGALURU-JAIPUR,49542,All
2019,3,BENGALURU,JAIPUR,29033,27829,BENGALURU-JAIPUR,56862,All
2019,4,BENGALURU,JAIPUR,26730,23452,BENGALURU-JAIPUR,50182,All
2019,5,BENGALURU,JAIPUR,21643,23302,BENGALURU-JAIPUR,44945,All
2019,6,BENGALURU,JAIPUR,21773,21437,BENGALURU-JAIPUR,43210,All
2019,7,BENGALURU,JAIPUR,20487,20803,BENGALURU-JAIPUR,41290,All
2019,8,BENGALURU,JAIPUR,23999,23221,BENGALURU-JAIPUR,47220,All
2019,9,BENGALURU,JAIPUR,24074,22513,BENGALURU-JAIPUR,46587,All
2019,10,BENGALURU,JAIPUR,28047,24126,BENGALURU-JAIPUR,52173,All
2019,11,BENGALURU,JAIPUR,28326,27923,BENGALURU-JAIPUR,56249,All
2019,12,BENGALURU,JAIPUR,25899,26706,BENGALURU-JAIPUR,52605,All
2020,1,BENGALURU,JAIPUR,33415,32498,BENGALURU-JAIPUR,65913,All
2020,2,BENGALURU,JAIPUR,30618,29058,BENGALURU-JAIPUR,59676,All
2020,3,BENGALURU,JAIPUR,20267,15668,BENGALURU-JAIPUR,35935,All
2020,5,BENGALURU,JAIPUR,1886,648,BENGALURU-JAIPUR,2534,All
2020,6,BENGALURU,JAIPUR,3659,3314,BENGALURU-JAIPUR,6973,All
2020,7,BENGALURU,JAIPUR,7517,1383,BENGALURU-JAIPUR,8900,All
2020,8,BENGALURU,JAIPUR,11187,7223,BENGALURU-JAIPUR,18410,All
2020,9,BENGALURU,JAIPUR,10312,9685,BENGALURU-JAIPUR,19997,All
2020,10,BENGALURU,JAIPUR,12305,10642,BENGALURU-JAIPUR,22947,All
2020,11,BENGALURU,JAIPUR,17756,11847,BENGALURU-JAIPUR,29603,All
2020,12,BENGALURU,JAIPUR,21253,20061,BENGALURU-JAIPUR,41314,All
2021,1,BENGALURU,JAIPUR,16431,15109,BENGALURU-JAIPUR,31540,All
2021,2,BENGALURU,JAIPUR,19579,16641,BENGALURU-JAIPUR,36220,All
2021,3,BENGALURU,JAIPUR,18557,15830,BENGALURU-JAIPUR,34387,All
2021,4,BENGALURU,JAIPUR,18413,10274,BENGALURU-JAIPUR,28687,All
2021,6,BENGALURU,JAIPUR,3185,4515,BENGALURU-JAIPUR,7700,All
2021,7,BENGALURU,JAIPUR,8129,9336,BENGALURU-JAIPUR,17465,All
2021,8,BENGALURU,JAIPUR,12424,12516,BENGALURU-JAIPUR,24940,All
2021,9,BENGALURU,JAIPUR,14039,14880,BENGALURU-JAIPUR,28919,All
2021,10,BENGALURU,JAIPUR,21880,17395,BENGALURU-JAIPUR,39275,All
2021,11,BENGALURU,JAIPUR,23819,22535,BENGALURU-JAIPUR,46354,All
2021,12,BENGALURU,JAIPUR,22164,24097,BENGALURU-JAIPUR,46261,All
2022,1,BENGALURU,JAIPUR,13226,11243,BENGALURU-JAIPUR,24469,All
2022,2,BENGALURU,JAIPUR,19032,17624,BENGALURU-JAIPUR,36656,All
2022,3,BENGALURU,JAIPUR,22081,22096,BENGALURU-JAIPUR,44177,All
2022,4,BENGALURU,JAIPUR,20060,19748,BENGALURU-JAIPUR,39808,All
2022,5,BENGALURU,JAIPUR,18498,23036,BENGALURU-JAIPUR,41534,All
2022,6,BENGALURU,JAIPUR,19382,20248,BENGALURU-JAIPUR,39630,All
2022,7,BENGALURU,JAIPUR,19278,19237,BENGALURU-JAIPUR,38515,All
2022,8,BENGALURU,JAIPUR,20985,21622,BENGALURU-JAIPUR,42607,All
2022,9,BENGALURU,JAIPUR,19958,17993,BENGALURU-JAIPUR,37951,All
2022,10,BENGALURU,JAIPUR,22187,18860,BENGALURU-JAIPUR,41047,All
2022,11,BENGALURU,JAIPUR,24719,27079,BENGALURU-JAIPUR,51798,All
2022,12,BENGALURU,JAIPUR,28211,29547,BENGALURU-JAIPUR,57758,All
2023,1,BENGALURU,JAIPUR,26565,26898,BENGALURU-JAIPUR,53463,All
2023,2,BENGALURU,JAIPUR,23687,23721,BENGALURU-JAIPUR,47408,All
2023,3,BENGALURU,JAIPUR,25030,25325,BENGALURU-JAIPUR,50355,All
2023,4,BENGALURU,JAIPUR,26088,22287,BENGALURU-JAIPUR,48375,All
2023,5,BENGALURU,JAIPUR,24851,26634,BENGALURU-JAIPUR,51485,All
2023,6,BENGALURU,JAIPUR,24964,25150,BENGALURU-JAIPUR,50114,All
2023,7,BENGALURU,JAIPUR,22475,24388,BENGALURU-JAIPUR,46863,All
2023,8,BENGALURU,JAIPUR,23240,22530,BENGALURU-JAIPUR,45770,All
2023,9,BENGALURU,JAIPUR,21847,21250,BENGALURU-JAIPUR,43097,All
2023,10,BENGALURU,JAIPUR,24261,21078,BENGALURU-JAIPUR,45339,All
2023,11,BENGALURU,JAIPUR,30116,27824,BENGALURU-JAIPUR,57940,All
2023,12,BENGALURU,JAIPUR,29882,32291,BENGALURU-JAIPUR,62173,All
2024,1,BENGALURU,JAIPUR,30206,29274,BENGALURU-JAIPUR,59480,All
2024,2,BENGALURU,JAIPUR,26747,25257,BENGALURU-JAIPUR,52004,All
2024,3,BENGALURU,JAIPUR,26450,24138,BENGALURU-JAIPUR,50588,All
2024,4,BENGALURU,JAIPUR,30387,27232,BENGALURU-JAIPUR,57619,All
2024,6,BENGALURU,JAIPUR,28408,28143,BENGALURU-JAIPUR,56551,All
2024,7,BENGALURU,JAIPUR,27985,27233,BENGALURU-JAIPUR,55218,All
2024,8,BENGALURU,JAIPUR,30173,28931,BENGALURU-JAIPUR,59104,All
2024,9,BENGALURU,JAIPUR,29523,27616,BENGALURU-JAIPUR,57139,All
2024,10,BENGALURU,JAIPUR,38989,29130,BENGALURU-JAIPUR,68119,All
2024,11,BENGALURU,JAIPUR,31654,33048,BENGALURU-JAIPUR,64702,All
2024,12,BENGALURU,JAIPUR,34917,36012,BENGALURU-JAIPUR,70929,All
2025,1,BENGALURU,JAIPUR,36579,35859,BENGALURU-JAIPUR,72438,All
2025,2,BENGALURU,JAIPUR,30378,30075,BENGALURU-JAIPUR,60453,All
2025,3,BENGALURU,JAIPUR,29929,29370,BENGALURU-JAIPUR,59299,All
2021,10,BENGALURU,JAISALMER,132,31,BENGALURU-JAISALMER,163,All
2021,11,BENGALURU,JAISALMER,101,186,BENGALURU-JAISALMER,287,All
2021,12,BENGALURU,JAISALMER,749,613,BENGALURU-JAISALMER,1362,All
2022,1,BENGALURU,JAISALMER,47,300,BENGALURU-JAISALMER,347,All
2017,8,BENGALURU,JAMMU,0,1,BENGALURU-JAMMU,1,All
2017,10,BENGALURU,JAMMU,0,1,BENGALURU-JAMMU,1,All
2017,11,BENGALURU,JAMMU,0,24,BENGALURU-JAMMU,24,All
2017,12,BENGALURU,JAMMU,0,96,BENGALURU-JAMMU,96,All
2018,1,BENGALURU,JAMMU,0,114,BENGALURU-JAMMU,114,All
2018,2,BENGALURU,JAMMU,13,209,BENGALURU-JAMMU,222,All
2018,3,BENGALURU,JAMMU,19,94,BENGALURU-JAMMU,113,All
2021,12,BENGALURU,JAMMU,76,0,BENGALURU-JAMMU,76,All
2022,3,BENGALURU,JAMMU,47,21,BENGALURU-JAMMU,68,All
2022,4,BENGALURU,JAMMU,371,446,BENGALURU-JAMMU,817,All
2022,5,BENGALURU,JAMMU,649,891,BENGALURU-JAMMU,1540,All
2022,6,BENGALURU,JAMMU,972,1078,BENGALURU-JAMMU,2050,All
2022,7,BENGALURU,JAMMU,951,1006,BENGALURU-JAMMU,1957,All
2022,8,BENGALURU,JAMMU,506,548,BENGALURU-JAMMU,1054,All
2022,9,BENGALURU,JAMMU,425,308,BENGALURU-JAMMU,733,All
2022,10,BENGALURU,JAMMU,798,664,BENGALURU-JAMMU,1462,All
2022,11,BENGALURU,JAMMU,807,508,BENGALURU-JAMMU,1315,All
2022,12,BENGALURU,JAMMU,958,927,BENGALURU-JAMMU,1885,All
2023,1,BENGALURU,JAMMU,753,667,BENGALURU-JAMMU,1420,All
2023,2,BENGALURU,JAMMU,959,624,BENGALURU-JAMMU,1583,All
2023,3,BENGALURU,JAMMU,946,594,BENGALURU-JAMMU,1540,All
2023,4,BENGALURU,JAMMU,901,738,BENGALURU-JAMMU,1639,All
2023,5,BENGALURU,JAMMU,506,860,BENGALURU-JAMMU,1366,All
2023,6,BENGALURU,JAMMU,486,762,BENGALURU-JAMMU,1248,All
2023,7,BENGALURU,JAMMU,689,532,BENGALURU-JAMMU,1221,All
2023,8,BENGALURU,JAMMU,381,288,BENGALURU-JAMMU,669,All
2023,9,BENGALURU,JAMMU,494,311,BENGALURU-JAMMU,805,All
2023,10,BENGALURU,JAMMU,938,561,BENGALURU-JAMMU,1499,All
2023,11,BENGALURU,JAMMU,1111,1069,BENGALURU-JAMMU,2180,All
2023,12,BENGALURU,JAMMU,936,1352,BENGALURU-JAMMU,2288,All
2024,1,BENGALURU,JAMMU,768,871,BENGALURU-JAMMU,1639,All
2024,2,BENGALURU,JAMMU,961,590,BENGALURU-JAMMU,1551,All
2024,3,BENGALURU,JAMMU,1502,1187,BENGALURU-JAMMU,2689,All
2024,4,BENGALURU,JAMMU,873,1125,BENGALURU-JAMMU,1998,All
2024,6,BENGALURU,JAMMU,627,1076,BENGALURU-JAMMU,1703,All
2024,7,BENGALURU,JAMMU,601,738,BENGALURU-JAMMU,1339,All
2024,8,BENGALURU,JAMMU,685,601,BENGALURU-JAMMU,1286,All
2024,9,BENGALURU,JAMMU,1012,890,BENGALURU-JAMMU,1902,All
2024,10,BENGALURU,JAMMU,1390,1087,BENGALURU-JAMMU,2477,All
2024,11,BENGALURU,JAMMU,1864,1996,BENGALURU-JAMMU,3860,All
2024,12,BENGALURU,JAMMU,3623,3744,BENGALURU-JAMMU,7367,All
2025,1,BENGALURU,JAMMU,2404,2236,BENGALURU-JAMMU,4640,All
2025,2,BENGALURU,JAMMU,1525,1537,BENGALURU-JAMMU,3062,All
2025,3,BENGALURU,JAMMU,2196,2143,BENGALURU-JAMMU,4339,All
2021,8,BENGALURU,JAMNAGAR,118,154,BENGALURU-JAMNAGAR,272,All
2021,9,BENGALURU,JAMNAGAR,475,538,BENGALURU-JAMNAGAR,1013,All
2021,10,BENGALURU,JAMNAGAR,523,526,BENGALURU-JAMNAGAR,1049,All
2021,11,BENGALURU,JAMNAGAR,526,526,BENGALURU-JAMNAGAR,1052,All
2021,12,BENGALURU,JAMNAGAR,542,539,BENGALURU-JAMNAGAR,1081,All
2022,1,BENGALURU,JAMNAGAR,402,344,BENGALURU-JAMNAGAR,746,All
2022,2,BENGALURU,JAMNAGAR,447,506,BENGALURU-JAMNAGAR,953,All
2022,3,BENGALURU,JAMNAGAR,588,551,BENGALURU-JAMNAGAR,1139,All
2022,4,BENGALURU,JAMNAGAR,553,540,BENGALURU-JAMNAGAR,1093,All
2022,5,BENGALURU,JAMNAGAR,221,229,BENGALURU-JAMNAGAR,450,All
2022,6,BENGALURU,JAMNAGAR,526,478,BENGALURU-JAMNAGAR,1004,All
2022,7,BENGALURU,JAMNAGAR,399,423,BENGALURU-JAMNAGAR,822,All
2022,8,BENGALURU,JAMNAGAR,467,490,BENGALURU-JAMNAGAR,957,All
2022,9,BENGALURU,JAMNAGAR,456,334,BENGALURU-JAMNAGAR,790,All
2022,10,BENGALURU,JAMNAGAR,493,425,BENGALURU-JAMNAGAR,918,All
2022,11,BENGALURU,JAMNAGAR,500,467,BENGALURU-JAMNAGAR,967,All
2022,12,BENGALURU,JAMNAGAR,490,512,BENGALURU-JAMNAGAR,1002,All
2023,1,BENGALURU,JAMNAGAR,405,534,BENGALURU-JAMNAGAR,939,All
2023,2,BENGALURU,JAMNAGAR,518,518,BENGALURU-JAMNAGAR,1036,All
2023,3,BENGALURU,JAMNAGAR,527,518,BENGALURU-JAMNAGAR,1045,All
2023,4,BENGALURU,JAMNAGAR,552,517,BENGALURU-JAMNAGAR,1069,All
2023,5,BENGALURU,JAMNAGAR,780,879,BENGALURU-JAMNAGAR,1659,All
2023,6,BENGALURU,JAMNAGAR,753,662,BENGALURU-JAMNAGAR,1415,All
2023,7,BENGALURU,JAMNAGAR,910,1100,BENGALURU-JAMNAGAR,2010,All
2023,8,BENGALURU,JAMNAGAR,1200,1279,BENGALURU-JAMNAGAR,2479,All
2023,9,BENGALURU,JAMNAGAR,1234,1310,BENGALURU-JAMNAGAR,2544,All
2023,10,BENGALURU,JAMNAGAR,1375,1234,BENGALURU-JAMNAGAR,2609,All
2023,11,BENGALURU,JAMNAGAR,1310,1249,BENGALURU-JAMNAGAR,2559,All
2023,12,BENGALURU,JAMNAGAR,1256,1154,BENGALURU-JAMNAGAR,2410,All
2024,1,BENGALURU,JAMNAGAR,1196,1135,BENGALURU-JAMNAGAR,2331,All
2024,2,BENGALURU,JAMNAGAR,1395,1280,BENGALURU-JAMNAGAR,2675,All
2024,3,BENGALURU,JAMNAGAR,1035,1066,BENGALURU-JAMNAGAR,2101,All
2024,4,BENGALURU,JAMNAGAR,1332,1212,BENGALURU-JAMNAGAR,2544,All
2024,6,BENGALURU,JAMNAGAR,1335,1239,BENGALURU-JAMNAGAR,2574,All
2024,7,BENGALURU,JAMNAGAR,1259,1235,BENGALURU-JAMNAGAR,2494,All
2024,8,BENGALURU,JAMNAGAR,1310,1217,BENGALURU-JAMNAGAR,2527,All
2024,9,BENGALURU,JAMNAGAR,1251,990,BENGALURU-JAMNAGAR,2241,All
2024,10,BENGALURU,JAMNAGAR,1407,1394,BENGALURU-JAMNAGAR,2801,All
2024,11,BENGALURU,JAMNAGAR,558,553,BENGALURU-JAMNAGAR,1111,All
2021,1,BENGALURU,JHARSUGUDA,1089,1465,BENGALURU-JHARSUGUDA,2554,All
2021,2,BENGALURU,JHARSUGUDA,2087,2256,BENGALURU-JHARSUGUDA,4343,All
2021,3,BENGALURU,JHARSUGUDA,2227,2439,BENGALURU-JHARSUGUDA,4666,All
2021,4,BENGALURU,JHARSUGUDA,1341,850,BENGALURU-JHARSUGUDA,2191,All
2021,6,BENGALURU,JHARSUGUDA,516,714,BENGALURU-JHARSUGUDA,1230,All
2021,7,BENGALURU,JHARSUGUDA,1570,2088,BENGALURU-JHARSUGUDA,3658,All
2021,8,BENGALURU,JHARSUGUDA,1550,1945,BENGALURU-JHARSUGUDA,3495,All
2021,9,BENGALURU,JHARSUGUDA,1598,1901,BENGALURU-JHARSUGUDA,3499,All
2021,10,BENGALURU,JHARSUGUDA,516,1010,BENGALURU-JHARSUGUDA,1526,All
2021,11,BENGALURU,JHARSUGUDA,1626,1858,BENGALURU-JHARSUGUDA,3484,All
2021,12,BENGALURU,JHARSUGUDA,1758,1919,BENGALURU-JHARSUGUDA,3677,All
2022,1,BENGALURU,JHARSUGUDA,952,895,BENGALURU-JHARSUGUDA,1847,All
2022,2,BENGALURU,JHARSUGUDA,603,914,BENGALURU-JHARSUGUDA,1517,All
2022,3,BENGALURU,JHARSUGUDA,953,1248,BENGALURU-JHARSUGUDA,2201,All
2022,4,BENGALURU,JHARSUGUDA,2617,2444,BENGALURU-JHARSUGUDA,5061,All
2022,5,BENGALURU,JHARSUGUDA,3082,4215,BENGALURU-JHARSUGUDA,7297,All
2022,6,BENGALURU,JHARSUGUDA,3151,3221,BENGALURU-JHARSUGUDA,6372,All
2022,7,BENGALURU,JHARSUGUDA,2057,2282,BENGALURU-JHARSUGUDA,4339,All
2022,8,BENGALURU,JHARSUGUDA,217,310,BENGALURU-JHARSUGUDA,527,All
2023,11,BENGALURU,JHARSUGUDA,2051,2416,BENGALURU-JHARSUGUDA,4467,All
2023,12,BENGALURU,JHARSUGUDA,5058,5168,BENGALURU-JHARSUGUDA,10226,All
2024,1,BENGALURU,JHARSUGUDA,4745,4868,BENGALURU-JHARSUGUDA,9613,All
2024,2,BENGALURU,JHARSUGUDA,4498,4472,BENGALURU-JHARSUGUDA,8970,All
2024,3,BENGALURU,JHARSUGUDA,4889,4643,BENGALURU-JHARSUGUDA,9532,All
2024,4,BENGALURU,JHARSUGUDA,5043,4318,BENGALURU-JHARSUGUDA,9361,All
2024,6,BENGALURU,JHARSUGUDA,4963,4962,BENGALURU-JHARSUGUDA,9925,All
2024,7,BENGALURU,JHARSUGUDA,4353,4977,BENGALURU-JHARSUGUDA,9330,All
2024,8,BENGALURU,JHARSUGUDA,4353,4742,BENGALURU-JHARSUGUDA,9095,All
2024,9,BENGALURU,JHARSUGUDA,4543,4448,BENGALURU-JHARSUGUDA,8991,All
2024,10,BENGALURU,JHARSUGUDA,5321,4520,BENGALURU-JHARSUGUDA,9841,All
2024,11,BENGALURU,JHARSUGUDA,4864,5177,BENGALURU-JHARSUGUDA,10041,All
2024,12,BENGALURU,JHARSUGUDA,4905,5064,BENGALURU-JHARSUGUDA,9969,All
2025,1,BENGALURU,JHARSUGUDA,5131,4995,BENGALURU-JHARSUGUDA,10126,All
2025,2,BENGALURU,JHARSUGUDA,3173,3183,BENGALURU-JHARSUGUDA,6356,All
2025,3,BENGALURU,JHARSUGUDA,4933,4748,BENGALURU-JHARSUGUDA,9681,All
2015,4,BENGALURU,JODHPUR,299,279,BENGALURU-JODHPUR,578,All
2015,5,BENGALURU,JODHPUR,522,465,BENGALURU-JODHPUR,987,All
2015,6,BENGALURU,JODHPUR,619,519,BENGALURU-JODHPUR,1138,All
2015,7,BENGALURU,JODHPUR,606,408,BENGALURU-JODHPUR,1014,All
2015,8,BENGALURU,JODHPUR,568,409,BENGALURU-JODHPUR,977,All
2015,9,BENGALURU,JODHPUR,451,302,BENGALURU-JODHPUR,753,All
2015,10,BENGALURU,JODHPUR,770,728,BENGALURU-JODHPUR,1498,All
2015,11,BENGALURU,JODHPUR,490,438,BENGALURU-JODHPUR,928,All
2015,12,BENGALURU,JODHPUR,543,680,BENGALURU-JODHPUR,1223,All
2016,1,BENGALURU,JODHPUR,589,561,BENGALURU-JODHPUR,1150,All
2016,2,BENGALURU,JODHPUR,557,595,BENGALURU-JODHPUR,1152,All
2016,3,BENGALURU,JODHPUR,718,662,BENGALURU-JODHPUR,1380,All
2016,4,BENGALURU,JODHPUR,702,941,BENGALURU-JODHPUR,1643,All
2016,5,BENGALURU,JODHPUR,357,686,BENGALURU-JODHPUR,1043,All
2016,6,BENGALURU,JODHPUR,237,197,BENGALURU-JODHPUR,434,All
2016,7,BENGALURU,JODHPUR,305,196,BENGALURU-JODHPUR,501,All
2016,8,BENGALURU,JODHPUR,318,296,BENGALURU-JODHPUR,614,All
2016,9,BENGALURU,JODHPUR,364,283,BENGALURU-JODHPUR,647,All
2016,10,BENGALURU,JODHPUR,324,414,BENGALURU-JODHPUR,738,All
2016,11,BENGALURU,JODHPUR,142,283,BENGALURU-JODHPUR,425,All
2016,12,BENGALURU,JODHPUR,240,349,BENGALURU-JODHPUR,589,All
2017,1,BENGALURU,JODHPUR,216,370,BENGALURU-JODHPUR,586,All
2017,2,BENGALURU,JODHPUR,193,241,BENGALURU-JODHPUR,434,All
2017,3,BENGALURU,JODHPUR,138,124,BENGALURU-JODHPUR,262,All
2017,4,BENGALURU,JODHPUR,127,108,BENGALURU-JODHPUR,235,All
2017,5,BENGALURU,JODHPUR,151,260,BENGALURU-JODHPUR,411,All
2017,6,BENGALURU,JODHPUR,142,133,BENGALURU-JODHPUR,275,All
2017,7,BENGALURU,JODHPUR,211,225,BENGALURU-JODHPUR,436,All
2017,8,BENGALURU,JODHPUR,355,321,BENGALURU-JODHPUR,676,All
2017,9,BENGALURU,JODHPUR,425,328,BENGALURU-JODHPUR,753,All
2017,10,BENGALURU,JODHPUR,268,533,BENGALURU-JODHPUR,801,All
2017,11,BENGALURU,JODHPUR,206,266,BENGALURU-JODHPUR,472,All
2017,12,BENGALURU,JODHPUR,409,485,BENGALURU-JODHPUR,894,All
2018,1,BENGALURU,JODHPUR,201,396,BENGALURU-JODHPUR,597,All
2018,2,BENGALURU,JODHPUR,424,472,BENGALURU-JODHPUR,896,All
2018,3,BENGALURU,JODHPUR,364,543,BENGALURU-JODHPUR,907,All
2018,4,BENGALURU,JODHPUR,400,386,BENGALURU-JODHPUR,786,All
2018,5,BENGALURU,JODHPUR,135,423,BENGALURU-JODHPUR,558,All
2018,6,BENGALURU,JODHPUR,154,296,BENGALURU-JODHPUR,450,All
2018,7,BENGALURU,JODHPUR,109,268,BENGALURU-JODHPUR,377,All
2018,8,BENGALURU,JODHPUR,164,166,BENGALURU-JODHPUR,330,All
2018,9,BENGALURU,JODHPUR,86,144,BENGALURU-JODHPUR,230,All
2018,10,BENGALURU,JODHPUR,47,75,BENGALURU-JODHPUR,122,All
2018,11,BENGALURU,JODHPUR,469,780,BENGALURU-JODHPUR,1249,All
2018,12,BENGALURU,JODHPUR,370,320,BENGALURU-JODHPUR,690,All
2019,1,BENGALURU,JODHPUR,318,270,BENGALURU-JODHPUR,588,All
2019,2,BENGALURU,JODHPUR,248,204,BENGALURU-JODHPUR,452,All
2019,3,BENGALURU,JODHPUR,118,174,BENGALURU-JODHPUR,292,All
2019,10,BENGALURU,JODHPUR,548,432,BENGALURU-JODHPUR,980,All
2019,11,BENGALURU,JODHPUR,4963,4470,BENGALURU-JODHPUR,9433,All
2019,12,BENGALURU,JODHPUR,5006,4789,BENGALURU-JODHPUR,9795,All
2020,1,BENGALURU,JODHPUR,4716,4654,BENGALURU-JODHPUR,9370,All
2020,2,BENGALURU,JODHPUR,4775,4902,BENGALURU-JODHPUR,9677,All
2020,3,BENGALURU,JODHPUR,3893,3518,BENGALURU-JODHPUR,7411,All
2020,9,BENGALURU,JODHPUR,3226,3343,BENGALURU-JODHPUR,6569,All
2020,10,BENGALURU,JODHPUR,4823,4900,BENGALURU-JODHPUR,9723,All
2020,11,BENGALURU,JODHPUR,5358,4918,BENGALURU-JODHPUR,10276,All
2020,12,BENGALURU,JODHPUR,4611,5368,BENGALURU-JODHPUR,9979,All
2021,1,BENGALURU,JODHPUR,4248,4486,BENGALURU-JODHPUR,8734,All
2021,2,BENGALURU,JODHPUR,5112,4665,BENGALURU-JODHPUR,9777,All
2021,3,BENGALURU,JODHPUR,4081,3889,BENGALURU-JODHPUR,7970,All
2021,4,BENGALURU,JODHPUR,1940,1116,BENGALURU-JODHPUR,3056,All
2021,6,BENGALURU,JODHPUR,788,1168,BENGALURU-JODHPUR,1956,All
2021,7,BENGALURU,JODHPUR,1263,1386,BENGALURU-JODHPUR,2649,All
2021,8,BENGALURU,JODHPUR,1650,1570,BENGALURU-JODHPUR,3220,All
2021,9,BENGALURU,JODHPUR,5881,5801,BENGALURU-JODHPUR,11682,All
2021,10,BENGALURU,JODHPUR,4928,4803,BENGALURU-JODHPUR,9731,All
2021,11,BENGALURU,JODHPUR,8081,7629,BENGALURU-JODHPUR,15710,All
2021,12,BENGALURU,JODHPUR,6735,8063,BENGALURU-JODHPUR,14798,All
2022,1,BENGALURU,JODHPUR,3234,3607,BENGALURU-JODHPUR,6841,All
2022,2,BENGALURU,JODHPUR,2388,2732,BENGALURU-JODHPUR,5120,All
2022,3,BENGALURU,JODHPUR,3458,3749,BENGALURU-JODHPUR,7207,All
2022,4,BENGALURU,JODHPUR,3742,3745,BENGALURU-JODHPUR,7487,All
2022,5,BENGALURU,JODHPUR,3062,3282,BENGALURU-JODHPUR,6344,All
2022,6,BENGALURU,JODHPUR,2864,3122,BENGALURU-JODHPUR,5986,All
2022,7,BENGALURU,JODHPUR,2898,3242,BENGALURU-JODHPUR,6140,All
2022,8,BENGALURU,JODHPUR,2893,3160,BENGALURU-JODHPUR,6053,All
2022,9,BENGALURU,JODHPUR,4500,4328,BENGALURU-JODHPUR,8828,All
2022,10,BENGALURU,JODHPUR,4959,4859,BENGALURU-JODHPUR,9818,All
2022,11,BENGALURU,JODHPUR,3383,3826,BENGALURU-JODHPUR,7209,All
2022,12,BENGALURU,JODHPUR,4070,4576,BENGALURU-JODHPUR,8646,All
2023,1,BENGALURU,JODHPUR,3788,4294,BENGALURU-JODHPUR,8082,All
2023,2,BENGALURU,JODHPUR,4140,4192,BENGALURU-JODHPUR,8332,All
2023,3,BENGALURU,JODHPUR,4861,4690,BENGALURU-JODHPUR,9551,All
2023,4,BENGALURU,JODHPUR,4917,4232,BENGALURU-JODHPUR,9149,All
2023,5,BENGALURU,JODHPUR,4445,4649,BENGALURU-JODHPUR,9094,All
2023,6,BENGALURU,JODHPUR,4959,5086,BENGALURU-JODHPUR,10045,All
2023,7,BENGALURU,JODHPUR,5299,5213,BENGALURU-JODHPUR,10512,All
2023,8,BENGALURU,JODHPUR,6523,6240,BENGALURU-JODHPUR,12763,All
2023,9,BENGALURU,JODHPUR,6163,5873,BENGALURU-JODHPUR,12036,All
2023,10,BENGALURU,JODHPUR,5571,5273,BENGALURU-JODHPUR,10844,All
2023,11,BENGALURU,JODHPUR,5290,4673,BENGALURU-JODHPUR,9963,All
2023,12,BENGALURU,JODHPUR,4921,4985,BENGALURU-JODHPUR,9906,All
2024,1,BENGALURU,JODHPUR,5319,5292,BENGALURU-JODHPUR,10611,All
2024,2,BENGALURU,JODHPUR,5092,4968,BENGALURU-JODHPUR,10060,All
2024,3,BENGALURU,JODHPUR,4952,4887,BENGALURU-JODHPUR,9839,All
2024,4,BENGALURU,JODHPUR,5222,4682,BENGALURU-JODHPUR,9904,All
2024,6,BENGALURU,JODHPUR,5042,4798,BENGALURU-JODHPUR,9840,All
2024,7,BENGALURU,JODHPUR,4630,4398,BENGALURU-JODHPUR,9028,All
2024,8,BENGALURU,JODHPUR,5505,4841,BENGALURU-JODHPUR,10346,All
2024,9,BENGALURU,JODHPUR,5202,5018,BENGALURU-JODHPUR,10220,All
2024,10,BENGALURU,JODHPUR,5503,4613,BENGALURU-JODHPUR,10116,All
2024,11,BENGALURU,JODHPUR,5232,5190,BENGALURU-JODHPUR,10422,All
2024,12,BENGALURU,JODHPUR,5984,5997,BENGALURU-JODHPUR,11981,All
2025,1,BENGALURU,JODHPUR,5426,5402,BENGALURU-JODHPUR,10828,All
2025,2,BENGALURU,JODHPUR,5575,5384,BENGALURU-JODHPUR,10959,All
2025,3,BENGALURU,JODHPUR,5581,5264,BENGALURU-JODHPUR,10845,All
2015,4,BENGALURU,JORHAT,182,122,BENGALURU-JORHAT,304,All
2015,5,BENGALURU,JORHAT,121,149,BENGALURU-JORHAT,270,All
2015,6,BENGALURU,JORHAT,133,124,BENGALURU-JORHAT,257,All
2015,7,BENGALURU,JORHAT,183,180,BENGALURU-JORHAT,363,All
2015,8,BENGALURU,JORHAT,111,119,BENGALURU-JORHAT,230,All
2015,9,BENGALURU,JORHAT,69,50,BENGALURU-JORHAT,119,All
2015,10,BENGALURU,JORHAT,103,107,BENGALURU-JORHAT,210,All
2015,11,BENGALURU,JORHAT,135,114,BENGALURU-JORHAT,249,All
2015,12,BENGALURU,JORHAT,141,114,BENGALURU-JORHAT,255,All
2016,1,BENGALURU,JORHAT,200,178,BENGALURU-JORHAT,378,All
2016,2,BENGALURU,JORHAT,100,114,BENGALURU-JORHAT,214,All
2016,3,BENGALURU,JORHAT,87,114,BENGALURU-JORHAT,201,All
2016,4,BENGALURU,JORHAT,96,84,BENGALURU-JORHAT,180,All
2016,5,BENGALURU,JORHAT,110,164,BENGALURU-JORHAT,274,All
2016,6,BENGALURU,JORHAT,96,119,BENGALURU-JORHAT,215,All
2016,7,BENGALURU,JORHAT,103,104,BENGALURU-JORHAT,207,All
2016,8,BENGALURU,JORHAT,83,115,BENGALURU-JORHAT,198,All
2016,9,BENGALURU,JORHAT,65,63,BENGALURU-JORHAT,128,All
2016,10,BENGALURU,JORHAT,123,86,BENGALURU-JORHAT,209,All
2016,11,BENGALURU,JORHAT,123,133,BENGALURU-JORHAT,256,All
2016,12,BENGALURU,JORHAT,181,157,BENGALURU-JORHAT,338,All
2017,1,BENGALURU,JORHAT,137,150,BENGALURU-JORHAT,287,All
2017,2,BENGALURU,JORHAT,121,92,BENGALURU-JORHAT,213,All
2017,3,BENGALURU,JORHAT,111,91,BENGALURU-JORHAT,202,All
2017,4,BENGALURU,JORHAT,231,195,BENGALURU-JORHAT,426,All
2017,5,BENGALURU,JORHAT,166,228,BENGALURU-JORHAT,394,All
2017,6,BENGALURU,JORHAT,141,105,BENGALURU-JORHAT,246,All
2017,7,BENGALURU,JORHAT,159,200,BENGALURU-JORHAT,359,All
2017,8,BENGALURU,JORHAT,213,189,BENGALURU-JORHAT,402,All
2017,9,BENGALURU,JORHAT,159,180,BENGALURU-JORHAT,339,All
2020,8,BENGALURU,JORHAT,7,7,BENGALURU-JORHAT,14,All
2020,9,BENGALURU,JORHAT,134,65,BENGALURU-JORHAT,199,All
2020,10,BENGALURU,JORHAT,177,96,BENGALURU-JORHAT,273,All
2020,11,BENGALURU,JORHAT,351,182,BENGALURU-JORHAT,533,All
2020,12,BENGALURU,JORHAT,358,236,BENGALURU-JORHAT,594,All
2021,1,BENGALURU,JORHAT,363,291,BENGALURU-JORHAT,654,All
2021,2,BENGALURU,JORHAT,300,216,BENGALURU-JORHAT,516,All
2021,3,BENGALURU,JORHAT,177,151,BENGALURU-JORHAT,328,All
2021,10,BENGALURU,JORHAT,6,16,BENGALURU-JORHAT,22,All
2021,11,BENGALURU,JORHAT,308,327,BENGALURU-JORHAT,635,All
2021,12,BENGALURU,JORHAT,347,363,BENGALURU-JORHAT,710,All
2022,1,BENGALURU,JORHAT,363,292,BENGALURU-JORHAT,655,All
2022,2,BENGALURU,JORHAT,194,208,BENGALURU-JORHAT,402,All
2022,3,BENGALURU,JORHAT,362,339,BENGALURU-JORHAT,701,All
2022,4,BENGALURU,JORHAT,657,560,BENGALURU-JORHAT,1217,All
2022,5,BENGALURU,JORHAT,556,739,BENGALURU-JORHAT,1295,All
2022,6,BENGALURU,JORHAT,644,616,BENGALURU-JORHAT,1260,All
2022,7,BENGALURU,JORHAT,769,749,BENGALURU-JORHAT,1518,All
2022,8,BENGALURU,JORHAT,826,630,BENGALURU-JORHAT,1456,All
2022,9,BENGALURU,JORHAT,649,573,BENGALURU-JORHAT,1222,All
2022,10,BENGALURU,JORHAT,687,602,BENGALURU-JORHAT,1289,All
2022,11,BENGALURU,JORHAT,262,374,BENGALURU-JORHAT,636,All
2022,12,BENGALURU,JORHAT,612,406,BENGALURU-JORHAT,1018,All
2023,1,BENGALURU,JORHAT,742,542,BENGALURU-JORHAT,1284,All
2023,2,BENGALURU,JORHAT,357,496,BENGALURU-JORHAT,853,All
2023,3,BENGALURU,JORHAT,550,437,BENGALURU-JORHAT,987,All
2023,4,BENGALURU,JORHAT,778,610,BENGALURU-JORHAT,1388,All
2023,5,BENGALURU,JORHAT,430,437,BENGALURU-JORHAT,867,All
2023,6,BENGALURU,JORHAT,367,243,BENGALURU-JORHAT,610,All
2023,7,BENGALURU,JORHAT,470,502,BENGALURU-JORHAT,972,All
2023,8,BENGALURU,JORHAT,245,226,BENGALURU-JORHAT,471,All
2023,9,BENGALURU,JORHAT,225,144,BENGALURU-JORHAT,369,All
2023,10,BENGALURU,JORHAT,162,131,BENGALURU-JORHAT,293,All
2022,3,BENGALURU,KADAPA,16,32,BENGALURU-KADAPA,48,All
2022,4,BENGALURU,KADAPA,170,237,BENGALURU-KADAPA,407,All
2022,5,BENGALURU,KADAPA,152,209,BENGALURU-KADAPA,361,All
2022,6,BENGALURU,KADAPA,281,339,BENGALURU-KADAPA,620,All
2022,7,BENGALURU,KADAPA,175,287,BENGALURU-KADAPA,462,All
2022,8,BENGALURU,KADAPA,281,341,BENGALURU-KADAPA,622,All
2022,9,BENGALURU,KADAPA,220,425,BENGALURU-KADAPA,645,All
2022,10,BENGALURU,KADAPA,237,313,BENGALURU-KADAPA,550,All
2022,11,BENGALURU,KADAPA,136,127,BENGALURU-KADAPA,263,All
2022,12,BENGALURU,KADAPA,211,297,BENGALURU-KADAPA,508,All
2023,2,BENGALURU,KADAPA,197,389,BENGALURU-KADAPA,586,All
2023,3,BENGALURU,KADAPA,318,578,BENGALURU-KADAPA,896,All
2023,4,BENGALURU,KADAPA,289,443,BENGALURU-KADAPA,732,All
2023,5,BENGALURU,KADAPA,353,445,BENGALURU-KADAPA,798,All
2022,11,BENGALURU,KALABURAGI,2716,2714,BENGALURU-KALABURAGI,5430,All
2023,1,BENGALURU,KALABURAGI,2435,2425,BENGALURU-KALABURAGI,4860,All
2023,2,BENGALURU,KALABURAGI,2077,1978,BENGALURU-KALABURAGI,4055,All
2023,3,BENGALURU,KALABURAGI,1981,2044,BENGALURU-KALABURAGI,4025,All
2023,4,BENGALURU,KALABURAGI,1802,1735,BENGALURU-KALABURAGI,3537,All
2023,5,BENGALURU,KALABURAGI,1986,2021,BENGALURU-KALABURAGI,4007,All
2023,6,BENGALURU,KALABURAGI,1813,1872,BENGALURU-KALABURAGI,3685,All
2023,7,BENGALURU,KALABURAGI,1757,1719,BENGALURU-KALABURAGI,3476,All
2023,8,BENGALURU,KALABURAGI,1714,1619,BENGALURU-KALABURAGI,3333,All
2023,9,BENGALURU,KALABURAGI,1614,1589,BENGALURU-KALABURAGI,3203,All
2023,10,BENGALURU,KALABURAGI,1705,1625,BENGALURU-KALABURAGI,3330,All
2023,11,BENGALURU,KALABURAGI,1912,1770,BENGALURU-KALABURAGI,3682,All
2023,12,BENGALURU,KALABURAGI,1728,1549,BENGALURU-KALABURAGI,3277,All
2024,1,BENGALURU,KALABURAGI,2004,2110,BENGALURU-KALABURAGI,4114,All
2024,2,BENGALURU,KALABURAGI,1779,1674,BENGALURU-KALABURAGI,3453,All
2024,3,BENGALURU,KALABURAGI,1707,1602,BENGALURU-KALABURAGI,3309,All
2024,4,BENGALURU,KALABURAGI,895,897,BENGALURU-KALABURAGI,1792,All
2024,6,BENGALURU,KALABURAGI,1594,1603,BENGALURU-KALABURAGI,3197,All
2024,7,BENGALURU,KALABURAGI,1836,1970,BENGALURU-KALABURAGI,3806,All
2024,8,BENGALURU,KALABURAGI,1886,1954,BENGALURU-KALABURAGI,3840,All
2024,9,BENGALURU,KALABURAGI,1515,1402,BENGALURU-KALABURAGI,2917,All
2024,10,BENGALURU,KALABURAGI,1286,1113,BENGALURU-KALABURAGI,2399,All
2024,11,BENGALURU,KALABURAGI,479,476,BENGALURU-KALABURAGI,955,All
2024,12,BENGALURU,KALABURAGI,783,821,BENGALURU-KALABURAGI,1604,All
2025,1,BENGALURU,KALABURAGI,632,812,BENGALURU-KALABURAGI,1444,All
2025,2,BENGALURU,KALABURAGI,621,615,BENGALURU-KALABURAGI,1236,All
2025,3,BENGALURU,KALABURAGI,721,721,BENGALURU-KALABURAGI,1442,All
2019,11,BENGALURU,"KALABURAGI, KARNATAKA",124,140,"BENGALURU-KALABURAGI, KARNATAKA",264,All
2019,12,BENGALURU,"KALABURAGI, KARNATAKA",560,579,"BENGALURU-KALABURAGI, KARNATAKA",1139,All
2020,1,BENGALURU,"KALABURAGI, KARNATAKA",2403,2290,"BENGALURU-KALABURAGI, KARNATAKA",4693,All
2020,2,BENGALURU,"KALABURAGI, KARNATAKA",2199,2199,"BENGALURU-KALABURAGI, KARNATAKA",4398,All
2020,3,BENGALURU,"KALABURAGI, KARNATAKA",1467,1250,"BENGALURU-KALABURAGI, KARNATAKA",2717,All
2020,5,BENGALURU,"KALABURAGI, KARNATAKA",201,189,"BENGALURU-KALABURAGI, KARNATAKA",390,All
2020,6,BENGALURU,"KALABURAGI, KARNATAKA",1778,1869,"BENGALURU-KALABURAGI, KARNATAKA",3647,All
2020,7,BENGALURU,"KALABURAGI, KARNATAKA",1834,1445,"BENGALURU-KALABURAGI, KARNATAKA",3279,All
2020,8,BENGALURU,"KALABURAGI, KARNATAKA",2457,2577,"BENGALURU-KALABURAGI, KARNATAKA",5034,All
2020,9,BENGALURU,"KALABURAGI, KARNATAKA",2585,2903,"BENGALURU-KALABURAGI, KARNATAKA",5488,All
2020,10,BENGALURU,"KALABURAGI, KARNATAKA",2828,2855,"BENGALURU-KALABURAGI, KARNATAKA",5683,All
2020,11,BENGALURU,"KALABURAGI, KARNATAKA",2966,3015,"BENGALURU-KALABURAGI, KARNATAKA",5981,All
2020,12,BENGALURU,"KALABURAGI, KARNATAKA",3056,3182,"BENGALURU-KALABURAGI, KARNATAKA",6238,All
2021,1,BENGALURU,"KALABURAGI, KARNATAKA",2949,3204,"BENGALURU-KALABURAGI, KARNATAKA",6153,All
2021,2,BENGALURU,"KALABURAGI, KARNATAKA",2829,2889,"BENGALURU-KALABURAGI, KARNATAKA",5718,All
2021,3,BENGALURU,"KALABURAGI, KARNATAKA",2988,2964,"BENGALURU-KALABURAGI, KARNATAKA",5952,All
2021,4,BENGALURU,"KALABURAGI, KARNATAKA",2469,2119,"BENGALURU-KALABURAGI, KARNATAKA",4588,All
2021,6,BENGALURU,"KALABURAGI, KARNATAKA",2430,2869,"BENGALURU-KALABURAGI, KARNATAKA",5299,All
2021,7,BENGALURU,"KALABURAGI, KARNATAKA",3234,3217,"BENGALURU-KALABURAGI, KARNATAKA",6451,All
2021,8,BENGALURU,"KALABURAGI, KARNATAKA",3037,2987,"BENGALURU-KALABURAGI, KARNATAKA",6024,All
2021,9,BENGALURU,"KALABURAGI, KARNATAKA",2794,2941,"BENGALURU-KALABURAGI, KARNATAKA",5735,All
2021,10,BENGALURU,"KALABURAGI, KARNATAKA",3121,3034,"BENGALURU-KALABURAGI, KARNATAKA",6155,All
2021,11,BENGALURU,"KALABURAGI, KARNATAKA",2827,2927,"BENGALURU-KALABURAGI, KARNATAKA",5754,All
2021,12,BENGALURU,"KALABURAGI, KARNATAKA",3059,2963,"BENGALURU-KALABURAGI, KARNATAKA",6022,All
2022,1,BENGALURU,"KALABURAGI, KARNATAKA",2249,2317,"BENGALURU-KALABURAGI, KARNATAKA",4566,All
2022,2,BENGALURU,"KALABURAGI, KARNATAKA",2673,2660,"BENGALURU-KALABURAGI, KARNATAKA",5333,All
2022,3,BENGALURU,"KALABURAGI, KARNATAKA",2936,3032,"BENGALURU-KALABURAGI, KARNATAKA",5968,All
2022,4,BENGALURU,"KALABURAGI, KARNATAKA",2886,2974,"BENGALURU-KALABURAGI, KARNATAKA",5860,All
2022,5,BENGALURU,"KALABURAGI, KARNATAKA",3005,3025,"BENGALURU-KALABURAGI, KARNATAKA",6030,All
2022,6,BENGALURU,"KALABURAGI, KARNATAKA",2892,2898,"BENGALURU-KALABURAGI, KARNATAKA",5790,All
2022,7,BENGALURU,"KALABURAGI, KARNATAKA",2769,2681,"BENGALURU-KALABURAGI, KARNATAKA",5450,All
2022,8,BENGALURU,"KALABURAGI, KARNATAKA",2973,2828,"BENGALURU-KALABURAGI, KARNATAKA",5801,All
2022,9,BENGALURU,"KALABURAGI, KARNATAKA",2817,2757,"BENGALURU-KALABURAGI, KARNATAKA",5574,All
2022,10,BENGALURU,"KALABURAGI, KARNATAKA",2537,2562,"BENGALURU-KALABURAGI, KARNATAKA",5099,All
2022,12,BENGALURU,"KALABURAGI, KARNATAKA",2960,2917,"BENGALURU-KALABURAGI, KARNATAKA",5877,All
2018,12,BENGALURU,KANNUR,5657,4909,BENGALURU-KANNUR,10566,All
2019,1,BENGALURU,KANNUR,7823,8054,BENGALURU-KANNUR,15877,All
2019,2,BENGALURU,KANNUR,7520,8054,BENGALURU-KANNUR,15574,All
2019,3,BENGALURU,KANNUR,9451,9718,BENGALURU-KANNUR,19169,All
2019,4,BENGALURU,KANNUR,10685,10049,BENGALURU-KANNUR,20734,All
2019,5,BENGALURU,KANNUR,10534,10600,BENGALURU-KANNUR,21134,All
2019,6,BENGALURU,KANNUR,8300,8467,BENGALURU-KANNUR,16767,All
2019,7,BENGALURU,KANNUR,9052,8250,BENGALURU-KANNUR,17302,All
2019,8,BENGALURU,KANNUR,10373,10204,BENGALURU-KANNUR,20577,All
2019,9,BENGALURU,KANNUR,6093,6338,BENGALURU-KANNUR,12431,All
2019,10,BENGALURU,KANNUR,7769,8188,BENGALURU-KANNUR,15957,All
2019,11,BENGALURU,KANNUR,7318,7922,BENGALURU-KANNUR,15240,All
2019,12,BENGALURU,KANNUR,6579,6001,BENGALURU-KANNUR,12580,All
2020,1,BENGALURU,KANNUR,4933,5289,BENGALURU-KANNUR,10222,All
2020,2,BENGALURU,KANNUR,1788,1771,BENGALURU-KANNUR,3559,All
2020,3,BENGALURU,KANNUR,1171,984,BENGALURU-KANNUR,2155,All
2020,5,BENGALURU,KANNUR,198,149,BENGALURU-KANNUR,347,All
2020,6,BENGALURU,KANNUR,1632,1505,BENGALURU-KANNUR,3137,All
2020,7,BENGALURU,KANNUR,1778,1875,BENGALURU-KANNUR,3653,All
2020,8,BENGALURU,KANNUR,2484,2200,BENGALURU-KANNUR,4684,All
2020,9,BENGALURU,KANNUR,2874,2310,BENGALURU-KANNUR,5184,All
2020,10,BENGALURU,KANNUR,3410,2496,BENGALURU-KANNUR,5906,All
2020,11,BENGALURU,KANNUR,2712,2213,BENGALURU-KANNUR,4925,All
2020,12,BENGALURU,KANNUR,5260,4946,BENGALURU-KANNUR,10206,All
2021,1,BENGALURU,KANNUR,3582,3583,BENGALURU-KANNUR,7165,All
2021,2,BENGALURU,KANNUR,2359,2815,BENGALURU-KANNUR,5174,All
2021,3,BENGALURU,KANNUR,2355,2629,BENGALURU-KANNUR,4984,All
2021,4,BENGALURU,KANNUR,2071,1804,BENGALURU-KANNUR,3875,All
2021,6,BENGALURU,KANNUR,1397,1483,BENGALURU-KANNUR,2880,All
2021,7,BENGALURU,KANNUR,1730,1931,BENGALURU-KANNUR,3661,All
2021,8,BENGALURU,KANNUR,2040,2017,BENGALURU-KANNUR,4057,All
2021,9,BENGALURU,KANNUR,1549,1924,BENGALURU-KANNUR,3473,All
2021,10,BENGALURU,KANNUR,1949,2179,BENGALURU-KANNUR,4128,All
2021,11,BENGALURU,KANNUR,2830,3170,BENGALURU-KANNUR,6000,All
2021,12,BENGALURU,KANNUR,3148,3032,BENGALURU-KANNUR,6180,All
2022,1,BENGALURU,KANNUR,2327,2635,BENGALURU-KANNUR,4962,All
2022,2,BENGALURU,KANNUR,1699,2047,BENGALURU-KANNUR,3746,All
2022,3,BENGALURU,KANNUR,2997,3216,BENGALURU-KANNUR,6213,All
2022,4,BENGALURU,KANNUR,2876,2730,BENGALURU-KANNUR,5606,All
2022,5,BENGALURU,KANNUR,2232,2192,BENGALURU-KANNUR,4424,All
2022,6,BENGALURU,KANNUR,4516,5104,BENGALURU-KANNUR,9620,All
2022,7,BENGALURU,KANNUR,3647,4373,BENGALURU-KANNUR,8020,All
2022,8,BENGALURU,KANNUR,3859,4326,BENGALURU-KANNUR,8185,All
2022,9,BENGALURU,KANNUR,3105,3165,BENGALURU-KANNUR,6270,All
2022,10,BENGALURU,KANNUR,3946,3921,BENGALURU-KANNUR,7867,All
2022,11,BENGALURU,KANNUR,3306,3855,BENGALURU-KANNUR,7161,All
2022,12,BENGALURU,KANNUR,4641,4041,BENGALURU-KANNUR,8682,All
2023,1,BENGALURU,KANNUR,3867,4335,BENGALURU-KANNUR,8202,All
2023,2,BENGALURU,KANNUR,3335,3505,BENGALURU-KANNUR,6840,All
2023,3,BENGALURU,KANNUR,4007,4311,BENGALURU-KANNUR,8318,All
2023,4,BENGALURU,KANNUR,4638,4812,BENGALURU-KANNUR,9450,All
2023,5,BENGALURU,KANNUR,5181,5314,BENGALURU-KANNUR,10495,All
2023,6,BENGALURU,KANNUR,6027,5116,BENGALURU-KANNUR,11143,All
2023,7,BENGALURU,KANNUR,6104,5522,BENGALURU-KANNUR,11626,All
2023,8,BENGALURU,KANNUR,5950,6017,BENGALURU-KANNUR,11967,All
2023,9,BENGALURU,KANNUR,4836,5651,BENGALURU-KANNUR,10487,All
2023,10,BENGALURU,KANNUR,4497,4628,BENGALURU-KANNUR,9125,All
2023,11,BENGALURU,KANNUR,5301,5978,BENGALURU-KANNUR,11279,All
2023,12,BENGALURU,KANNUR,8710,7118,BENGALURU-KANNUR,15828,All
2024,1,BENGALURU,KANNUR,7763,7959,BENGALURU-KANNUR,15722,All
2024,2,BENGALURU,KANNUR,7562,7385,BENGALURU-KANNUR,14947,All
2024,3,BENGALURU,KANNUR,6732,6293,BENGALURU-KANNUR,13025,All
2024,4,BENGALURU,KANNUR,7172,6945,BENGALURU-KANNUR,14117,All
2024,6,BENGALURU,KANNUR,3718,3627,BENGALURU-KANNUR,7345,All
2024,7,BENGALURU,KANNUR,4256,3579,BENGALURU-KANNUR,7835,All
2024,8,BENGALURU,KANNUR,4116,3868,BENGALURU-KANNUR,7984,All
2024,9,BENGALURU,KANNUR,3837,3682,BENGALURU-KANNUR,7519,All
2024,10,BENGALURU,KANNUR,3364,3132,BENGALURU-KANNUR,6496,All
2024,11,BENGALURU,KANNUR,3228,3510,BENGALURU-KANNUR,6738,All
2024,12,BENGALURU,KANNUR,4245,3688,BENGALURU-KANNUR,7933,All
2025,1,BENGALURU,KANNUR,3978,4325,BENGALURU-KANNUR,8303,All
2025,2,BENGALURU,KANNUR,3096,2999,BENGALURU-KANNUR,6095,All
2025,3,BENGALURU,KANNUR,3765,3462,BENGALURU-KANNUR,7227,All
2018,10,BENGALURU,KANPUR,152,21,BENGALURU-KANPUR,173,All
2018,11,BENGALURU,KANPUR,138,354,BENGALURU-KANPUR,492,All
2018,12,BENGALURU,KANPUR,111,247,BENGALURU-KANPUR,358,All
2019,1,BENGALURU,KANPUR,96,155,BENGALURU-KANPUR,251,All
2019,2,BENGALURU,KANPUR,91,141,BENGALURU-KANPUR,232,All
2019,3,BENGALURU,KANPUR,1917,1901,BENGALURU-KANPUR,3818,All
2021,11,BENGALURU,KANPUR,3117,3285,BENGALURU-KANPUR,6402,All
2021,12,BENGALURU,KANPUR,3280,4155,BENGALURU-KANPUR,7435,All
2022,1,BENGALURU,KANPUR,2205,1586,BENGALURU-KANPUR,3791,All
2022,2,BENGALURU,KANPUR,1354,1410,BENGALURU-KANPUR,2764,All
2022,3,BENGALURU,KANPUR,3830,4140,BENGALURU-KANPUR,7970,All
2022,4,BENGALURU,KANPUR,4005,4332,BENGALURU-KANPUR,8337,All
2022,5,BENGALURU,KANPUR,2865,3830,BENGALURU-KANPUR,6695,All
2022,6,BENGALURU,KANPUR,2682,3260,BENGALURU-KANPUR,5942,All
2022,7,BENGALURU,KANPUR,2194,2354,BENGALURU-KANPUR,4548,All
2022,8,BENGALURU,KANPUR,2130,2244,BENGALURU-KANPUR,4374,All
2022,9,BENGALURU,KANPUR,2163,2338,BENGALURU-KANPUR,4501,All
2022,10,BENGALURU,KANPUR,3428,3330,BENGALURU-KANPUR,6758,All
2022,11,BENGALURU,KANPUR,3140,4376,BENGALURU-KANPUR,7516,All
2022,12,BENGALURU,KANPUR,2708,3695,BENGALURU-KANPUR,6403,All
2023,1,BENGALURU,KANPUR,1207,1737,BENGALURU-KANPUR,2944,All
2023,2,BENGALURU,KANPUR,2829,2763,BENGALURU-KANPUR,5592,All
2023,3,BENGALURU,KANPUR,4242,4591,BENGALURU-KANPUR,8833,All
2023,4,BENGALURU,KANPUR,4524,3762,BENGALURU-KANPUR,8286,All
2023,5,BENGALURU,KANPUR,4565,4946,BENGALURU-KANPUR,9511,All
2023,6,BENGALURU,KANPUR,4130,4749,BENGALURU-KANPUR,8879,All
2023,7,BENGALURU,KANPUR,4112,4278,BENGALURU-KANPUR,8390,All
2023,8,BENGALURU,KANPUR,4471,3945,BENGALURU-KANPUR,8416,All
2023,9,BENGALURU,KANPUR,3693,3741,BENGALURU-KANPUR,7434,All
2023,10,BENGALURU,KANPUR,4155,3742,BENGALURU-KANPUR,7897,All
2023,11,BENGALURU,KANPUR,4626,4014,BENGALURU-KANPUR,8640,All
2023,12,BENGALURU,KANPUR,4748,5035,BENGALURU-KANPUR,9783,All
2024,1,BENGALURU,KANPUR,318,349,BENGALURU-KANPUR,667,All
2024,3,BENGALURU,KANPUR,843,680,BENGALURU-KANPUR,1523,All
2024,4,BENGALURU,KANPUR,2233,2088,BENGALURU-KANPUR,4321,All
2024,6,BENGALURU,KANPUR,2235,2196,BENGALURU-KANPUR,4431,All
2024,7,BENGALURU,KANPUR,2207,2199,BENGALURU-KANPUR,4406,All
2024,8,BENGALURU,KANPUR,2257,2324,BENGALURU-KANPUR,4581,All
2024,9,BENGALURU,KANPUR,2042,1880,BENGALURU-KANPUR,3922,All
2024,10,BENGALURU,KANPUR,2294,1733,BENGALURU-KANPUR,4027,All
2024,11,BENGALURU,KANPUR,2175,2219,BENGALURU-KANPUR,4394,All
2024,12,BENGALURU,KANPUR,2093,2215,BENGALURU-KANPUR,4308,All
2025,1,BENGALURU,KANPUR,2173,2225,BENGALURU-KANPUR,4398,All
2025,2,BENGALURU,KANPUR,2096,2071,BENGALURU-KANPUR,4167,All
2025,3,BENGALURU,KANPUR,2452,2257,BENGALURU-KANPUR,4709,All
2015,4,BENGALURU,KOCHI,27946,27640,BENGALURU-KOCHI,55586,All
2015,5,BENGALURU,KOCHI,28309,27351,BENGALURU-KOCHI,55660,All
2015,6,BENGALURU,KOCHI,25247,24697,BENGALURU-KOCHI,49944,All
2015,7,BENGALURU,KOCHI,34274,32650,BENGALURU-KOCHI,66924,All
2015,8,BENGALURU,KOCHI,33845,34109,BENGALURU-KOCHI,67954,All
2015,9,BENGALURU,KOCHI,12018,12323,BENGALURU-KOCHI,24341,All
2015,9,BENGALURU,KOCHI,8910,9351,BENGALURU-KOCHI,18261,All
2015,10,BENGALURU,KOCHI,22107,21537,BENGALURU-KOCHI,43644,All
2015,11,BENGALURU,KOCHI,21754,21288,BENGALURU-KOCHI,43042,All
2015,12,BENGALURU,KOCHI,30408,13036,BENGALURU-KOCHI,43444,All
2016,1,BENGALURU,KOCHI,28323,21575,BENGALURU-KOCHI,49898,All
2016,2,BENGALURU,KOCHI,26814,26991,BENGALURU-KOCHI,53805,All
2016,3,BENGALURU,KOCHI,27487,23406,BENGALURU-KOCHI,50893,All
2016,4,BENGALURU,KOCHI,25755,23834,BENGALURU-KOCHI,49589,All
2016,5,BENGALURU,KOCHI,28383,22785,BENGALURU-KOCHI,51168,All
2016,6,BENGALURU,KOCHI,26333,24731,BENGALURU-KOCHI,51064,All
2016,7,BENGALURU,KOCHI,30486,29003,BENGALURU-KOCHI,59489,All
2016,8,BENGALURU,KOCHI,27769,28599,BENGALURU-KOCHI,56368,All
2016,9,BENGALURU,KOCHI,26666,27360,BENGALURU-KOCHI,54026,All
2016,10,BENGALURU,KOCHI,34463,32672,BENGALURU-KOCHI,67135,All
2016,11,BENGALURU,KOCHI,34850,38355,BENGALURU-KOCHI,73205,All
2016,12,BENGALURU,KOCHI,35585,34709,BENGALURU-KOCHI,70294,All
2017,1,BENGALURU,KOCHI,34222,36648,BENGALURU-KOCHI,70870,All
2017,2,BENGALURU,KOCHI,27465,27204,BENGALURU-KOCHI,54669,All
2017,3,BENGALURU,KOCHI,22640,20658,BENGALURU-KOCHI,43298,All
2017,4,BENGALURU,KOCHI,25435,21058,BENGALURU-KOCHI,46493,All
2017,5,BENGALURU,KOCHI,37372,39243,BENGALURU-KOCHI,76615,All
2017,6,BENGALURU,KOCHI,36289,37782,BENGALURU-KOCHI,74071,All
2017,7,BENGALURU,KOCHI,42537,42467,BENGALURU-KOCHI,85004,All
2017,8,BENGALURU,KOCHI,42657,43440,BENGALURU-KOCHI,86097,All
2017,9,BENGALURU,KOCHI,40143,40584,BENGALURU-KOCHI,80727,All
2017,10,BENGALURU,KOCHI,44408,46537,BENGALURU-KOCHI,90945,All
2017,11,BENGALURU,KOCHI,45214,46443,BENGALURU-KOCHI,91657,All
2017,12,BENGALURU,KOCHI,55688,52906,BENGALURU-KOCHI,108594,All
2018,1,BENGALURU,KOCHI,59258,66500,BENGALURU-KOCHI,125758,All
2018,2,BENGALURU,KOCHI,52978,56355,BENGALURU-KOCHI,109333,All
2018,3,BENGALURU,KOCHI,47248,48598,BENGALURU-KOCHI,95846,All
2018,4,BENGALURU,KOCHI,50960,50972,BENGALURU-KOCHI,101932,All
2018,5,BENGALURU,KOCHI,59546,60985,BENGALURU-KOCHI,120531,All
2018,6,BENGALURU,KOCHI,47025,43873,BENGALURU-KOCHI,90898,All
2018,7,BENGALURU,KOCHI,54197,44302,BENGALURU-KOCHI,98499,All
2018,8,BENGALURU,KOCHI,31099,31250,BENGALURU-KOCHI,62349,All
2018,9,BENGALURU,KOCHI,48937,51531,BENGALURU-KOCHI,100468,All
2018,10,BENGALURU,KOCHI,52233,49346,BENGALURU-KOCHI,101579,All
2018,11,BENGALURU,KOCHI,53291,51284,BENGALURU-KOCHI,104575,All
2018,12,BENGALURU,KOCHI,62330,56015,BENGALURU-KOCHI,118345,All
2019,1,BENGALURU,KOCHI,62325,64183,BENGALURU-KOCHI,126508,All
2019,2,BENGALURU,KOCHI,47626,44291,BENGALURU-KOCHI,91917,All
2019,3,BENGALURU,KOCHI,50020,50742,BENGALURU-KOCHI,100762,All
2019,4,BENGALURU,KOCHI,43672,41212,BENGALURU-KOCHI,84884,All
2019,5,BENGALURU,KOCHI,42551,41300,BENGALURU-KOCHI,83851,All
2019,6,BENGALURU,KOCHI,37625,39438,BENGALURU-KOCHI,77063,All
2019,7,BENGALURU,KOCHI,37631,37882,BENGALURU-KOCHI,75513,All
2019,8,BENGALURU,KOCHI,32588,33900,BENGALURU-KOCHI,66488,All
2019,9,BENGALURU,KOCHI,40563,43038,BENGALURU-KOCHI,83601,All
2019,10,BENGALURU,KOCHI,38394,37829,BENGALURU-KOCHI,76223,All
2019,11,BENGALURU,KOCHI,34724,37948,BENGALURU-KOCHI,72672,All
2019,12,BENGALURU,KOCHI,41571,40145,BENGALURU-KOCHI,81716,All
2020,1,BENGALURU,KOCHI,39545,46180,BENGALURU-KOCHI,85725,All
2020,2,BENGALURU,KOCHI,34938,39892,BENGALURU-KOCHI,74830,All
2020,3,BENGALURU,KOCHI,21621,20330,BENGALURU-KOCHI,41951,All
2020,5,BENGALURU,KOCHI,1454,1209,BENGALURU-KOCHI,2663,All
2020,6,BENGALURU,KOCHI,7269,7917,BENGALURU-KOCHI,15186,All
2020,7,BENGALURU,KOCHI,9947,12927,BENGALURU-KOCHI,22874,All
2020,8,BENGALURU,KOCHI,13154,14754,BENGALURU-KOCHI,27908,All
2020,9,BENGALURU,KOCHI,22947,19531,BENGALURU-KOCHI,42478,All
2020,10,BENGALURU,KOCHI,31700,20832,BENGALURU-KOCHI,52532,All
2020,11,BENGALURU,KOCHI,31376,22712,BENGALURU-KOCHI,54088,All
2020,12,BENGALURU,KOCHI,44295,35886,BENGALURU-KOCHI,80181,All
2021,1,BENGALURU,KOCHI,38372,36921,BENGALURU-KOCHI,75293,All
2021,2,BENGALURU,KOCHI,28670,30965,BENGALURU-KOCHI,59635,All
2021,3,BENGALURU,KOCHI,28133,36129,BENGALURU-KOCHI,64262,All
2021,4,BENGALURU,KOCHI,33709,25415,BENGALURU-KOCHI,59124,All
2021,6,BENGALURU,KOCHI,14405,9178,BENGALURU-KOCHI,23583,All
2021,7,BENGALURU,KOCHI,19546,14819,BENGALURU-KOCHI,34365,All
2021,8,BENGALURU,KOCHI,29828,17862,BENGALURU-KOCHI,47690,All
2021,9,BENGALURU,KOCHI,22636,19526,BENGALURU-KOCHI,42162,All
2021,10,BENGALURU,KOCHI,29944,26250,BENGALURU-KOCHI,56194,All
2021,11,BENGALURU,KOCHI,33193,32853,BENGALURU-KOCHI,66046,All
2021,12,BENGALURU,KOCHI,47656,37077,BENGALURU-KOCHI,84733,All
2022,1,BENGALURU,KOCHI,23758,27023,BENGALURU-KOCHI,50781,All
2022,2,BENGALURU,KOCHI,24585,26921,BENGALURU-KOCHI,51506,All
2022,3,BENGALURU,KOCHI,39615,39507,BENGALURU-KOCHI,79122,All
2022,4,BENGALURU,KOCHI,42633,40724,BENGALURU-KOCHI,83357,All
2022,5,BENGALURU,KOCHI,45677,40936,BENGALURU-KOCHI,86613,All
2022,6,BENGALURU,KOCHI,32975,36204,BENGALURU-KOCHI,69179,All
2022,7,BENGALURU,KOCHI,36562,40777,BENGALURU-KOCHI,77339,All
2022,8,BENGALURU,KOCHI,51480,49574,BENGALURU-KOCHI,101054,All
2022,9,BENGALURU,KOCHI,69490,71728,BENGALURU-KOCHI,141218,All
2022,10,BENGALURU,KOCHI,70290,70434,BENGALURU-KOCHI,140724,All
2022,11,BENGALURU,KOCHI,63037,64465,BENGALURU-KOCHI,127502,All
2022,12,BENGALURU,KOCHI,71301,64838,BENGALURU-KOCHI,136139,All
2023,1,BENGALURU,KOCHI,76553,81628,BENGALURU-KOCHI,158181,All
2023,2,BENGALURU,KOCHI,69726,72041,BENGALURU-KOCHI,141767,All
2023,3,BENGALURU,KOCHI,77785,80575,BENGALURU-KOCHI,158360,All
2023,4,BENGALURU,KOCHI,80314,79487,BENGALURU-KOCHI,159801,All
2023,5,BENGALURU,KOCHI,78892,78054,BENGALURU-KOCHI,156946,All
2023,6,BENGALURU,KOCHI,70405,72347,BENGALURU-KOCHI,142752,All
2023,7,BENGALURU,KOCHI,72930,73092,BENGALURU-KOCHI,146022,All
2023,8,BENGALURU,KOCHI,64116,62006,BENGALURU-KOCHI,126122,All
2023,9,BENGALURU,KOCHI,59043,60492,BENGALURU-KOCHI,119535,All
2023,10,BENGALURU,KOCHI,64386,61297,BENGALURU-KOCHI,125683,All
2023,11,BENGALURU,KOCHI,59443,59493,BENGALURU-KOCHI,118936,All
2023,12,BENGALURU,KOCHI,62244,59561,BENGALURU-KOCHI,121805,All
2024,1,BENGALURU,KOCHI,57592,60406,BENGALURU-KOCHI,117998,All
2024,2,BENGALURU,KOCHI,50902,51689,BENGALURU-KOCHI,102591,All
2024,3,BENGALURU,KOCHI,58474,55998,BENGALURU-KOCHI,114472,All
2024,4,BENGALURU,KOCHI,71560,70860,BENGALURU-KOCHI,142420,All
2024,6,BENGALURU,KOCHI,57206,59350,BENGALURU-KOCHI,116556,All
2024,7,BENGALURU,KOCHI,59458,57164,BENGALURU-KOCHI,116622,All
2024,8,BENGALURU,KOCHI,63838,66344,BENGALURU-KOCHI,130182,All
2024,9,BENGALURU,KOCHI,70799,71511,BENGALURU-KOCHI,142310,All
2024,10,BENGALURU,KOCHI,68599,68574,BENGALURU-KOCHI,137173,All
2024,11,BENGALURU,KOCHI,62678,71060,BENGALURU-KOCHI,133738,All
2024,12,BENGALURU,KOCHI,62750,59598,BENGALURU-KOCHI,122348,All
2025,1,BENGALURU,KOCHI,57117,59807,BENGALURU-KOCHI,116924,All
2025,2,BENGALURU,KOCHI,42447,44251,BENGALURU-KOCHI,86698,All
2025,3,BENGALURU,KOCHI,55764,58113,BENGALURU-KOCHI,113877,All
2018,12,BENGALURU,KOLHAPUR,790,698,BENGALURU-KOLHAPUR,1488,All
2019,1,BENGALURU,KOLHAPUR,1138,1115,BENGALURU-KOLHAPUR,2253,All
2019,2,BENGALURU,KOLHAPUR,719,684,BENGALURU-KOLHAPUR,1403,All
2019,3,BENGALURU,KOLHAPUR,1091,901,BENGALURU-KOLHAPUR,1992,All
2019,4,BENGALURU,KOLHAPUR,1242,1040,BENGALURU-KOLHAPUR,2282,All
2019,5,BENGALURU,KOLHAPUR,1347,1231,BENGALURU-KOLHAPUR,2578,All
2019,6,BENGALURU,KOLHAPUR,1436,1258,BENGALURU-KOLHAPUR,2694,All
2019,7,BENGALURU,KOLHAPUR,1193,1051,BENGALURU-KOLHAPUR,2244,All
2019,8,BENGALURU,KOLHAPUR,1039,1069,BENGALURU-KOLHAPUR,2108,All
2019,9,BENGALURU,KOLHAPUR,1246,1196,BENGALURU-KOLHAPUR,2442,All
2019,10,BENGALURU,KOLHAPUR,990,854,BENGALURU-KOLHAPUR,1844,All
2019,11,BENGALURU,KOLHAPUR,1216,1169,BENGALURU-KOLHAPUR,2385,All
2019,12,BENGALURU,KOLHAPUR,1234,1229,BENGALURU-KOLHAPUR,2463,All
2020,1,BENGALURU,KOLHAPUR,1112,1142,BENGALURU-KOLHAPUR,2254,All
2020,2,BENGALURU,KOLHAPUR,990,962,BENGALURU-KOLHAPUR,1952,All
2020,3,BENGALURU,KOLHAPUR,787,577,BENGALURU-KOLHAPUR,1364,All
2020,6,BENGALURU,KOLHAPUR,467,376,BENGALURU-KOLHAPUR,843,All
2020,7,BENGALURU,KOLHAPUR,625,370,BENGALURU-KOLHAPUR,995,All
2020,8,BENGALURU,KOLHAPUR,597,608,BENGALURU-KOLHAPUR,1205,All
2020,9,BENGALURU,KOLHAPUR,600,772,BENGALURU-KOLHAPUR,1372,All
2020,10,BENGALURU,KOLHAPUR,701,740,BENGALURU-KOLHAPUR,1441,All
2020,11,BENGALURU,KOLHAPUR,998,964,BENGALURU-KOLHAPUR,1962,All
2020,12,BENGALURU,KOLHAPUR,1055,1027,BENGALURU-KOLHAPUR,2082,All
2021,1,BENGALURU,KOLHAPUR,521,633,BENGALURU-KOLHAPUR,1154,All
2021,2,BENGALURU,KOLHAPUR,679,636,BENGALURU-KOLHAPUR,1315,All
2021,3,BENGALURU,KOLHAPUR,409,352,BENGALURU-KOLHAPUR,761,All
2021,4,BENGALURU,KOLHAPUR,300,266,BENGALURU-KOLHAPUR,566,All
2021,6,BENGALURU,KOLHAPUR,396,478,BENGALURU-KOLHAPUR,874,All
2021,7,BENGALURU,KOLHAPUR,403,621,BENGALURU-KOLHAPUR,1024,All
2021,8,BENGALURU,KOLHAPUR,494,667,BENGALURU-KOLHAPUR,1161,All
2021,9,BENGALURU,KOLHAPUR,582,641,BENGALURU-KOLHAPUR,1223,All
2021,10,BENGALURU,KOLHAPUR,787,687,BENGALURU-KOLHAPUR,1474,All
2021,11,BENGALURU,KOLHAPUR,741,657,BENGALURU-KOLHAPUR,1398,All
2021,12,BENGALURU,KOLHAPUR,671,612,BENGALURU-KOLHAPUR,1283,All
2022,1,BENGALURU,KOLHAPUR,331,360,BENGALURU-KOLHAPUR,691,All
2022,2,BENGALURU,KOLHAPUR,494,530,BENGALURU-KOLHAPUR,1024,All
2022,3,BENGALURU,KOLHAPUR,439,461,BENGALURU-KOLHAPUR,900,All
2022,4,BENGALURU,KOLHAPUR,741,657,BENGALURU-KOLHAPUR,1398,All
2022,5,BENGALURU,KOLHAPUR,671,612,BENGALURU-KOLHAPUR,1283,All
2022,6,BENGALURU,KOLHAPUR,741,657,BENGALURU-KOLHAPUR,1398,All
2022,7,BENGALURU,KOLHAPUR,494,530,BENGALURU-KOLHAPUR,1024,All
2022,8,BENGALURU,KOLHAPUR,671,612,BENGALURU-KOLHAPUR,1283,All
2022,9,BENGALURU,KOLHAPUR,741,657,BENGALURU-KOLHAPUR,1398,All
2023,1,BENGALURU,KOLHAPUR,1012,1071,BENGALURU-KOLHAPUR,2083,All
2023,2,BENGALURU,KOLHAPUR,1029,1002,BENGALURU-KOLHAPUR,2031,All
2023,3,BENGALURU,KOLHAPUR,1808,1672,BENGALURU-KOLHAPUR,3480,All
2023,4,BENGALURU,KOLHAPUR,1751,1646,BENGALURU-KOLHAPUR,3397,All
2023,5,BENGALURU,KOLHAPUR,1841,1695,BENGALURU-KOLHAPUR,3536,All
2023,6,BENGALURU,KOLHAPUR,1735,1582,BENGALURU-KOLHAPUR,3317,All
2023,7,BENGALURU,KOLHAPUR,1773,1720,BENGALURU-KOLHAPUR,3493,All
2023,8,BENGALURU,KOLHAPUR,1916,1678,BENGALURU-KOLHAPUR,3594,All
2023,9,BENGALURU,KOLHAPUR,2055,1960,BENGALURU-KOLHAPUR,4015,All
2023,10,BENGALURU,KOLHAPUR,2316,2087,BENGALURU-KOLHAPUR,4403,All
2023,11,BENGALURU,KOLHAPUR,2698,2690,BENGALURU-KOLHAPUR,5388,All
2023,12,BENGALURU,KOLHAPUR,3563,3353,BENGALURU-KOLHAPUR,6916,All
2024,1,BENGALURU,KOLHAPUR,2944,3093,BENGALURU-KOLHAPUR,6037,All
2024,2,BENGALURU,KOLHAPUR,2882,2850,BENGALURU-KOLHAPUR,5732,All
2024,3,BENGALURU,KOLHAPUR,3184,2888,BENGALURU-KOLHAPUR,6072,All
2024,4,BENGALURU,KOLHAPUR,2910,2628,BENGALURU-KOLHAPUR,5538,All
2024,6,BENGALURU,KOLHAPUR,2481,2441,BENGALURU-KOLHAPUR,4922,All
2024,7,BENGALURU,KOLHAPUR,2016,2084,BENGALURU-KOLHAPUR,4100,All
2024,8,BENGALURU,KOLHAPUR,2031,1929,BENGALURU-KOLHAPUR,3960,All
2024,9,BENGALURU,KOLHAPUR,1985,1901,BENGALURU-KOLHAPUR,3886,All
2024,10,BENGALURU,KOLHAPUR,2127,2012,BENGALURU-KOLHAPUR,4139,All
2024,11,BENGALURU,KOLHAPUR,2113,2222,BENGALURU-KOLHAPUR,4335,All
2024,12,BENGALURU,KOLHAPUR,2253,2276,BENGALURU-KOLHAPUR,4529,All
2025,1,BENGALURU,KOLHAPUR,2082,2203,BENGALURU-KOLHAPUR,4285,All
2025,2,BENGALURU,KOLHAPUR,2022,2029,BENGALURU-KOLHAPUR,4051,All
2025,3,BENGALURU,KOLHAPUR,2292,1941,BENGALURU-KOLHAPUR,4233,All
2015,4,BENGALURU,KOLKATA,32560,28755,BENGALURU-KOLKATA,61315,All
2015,5,BENGALURU,KOLKATA,35652,38172,BENGALURU-KOLKATA,73824,All
2015,6,BENGALURU,KOLKATA,33345,33977,BENGALURU-KOLKATA,67322,All
2015,7,BENGALURU,KOLKATA,36917,34844,BENGALURU-KOLKATA,71761,All
2015,8,BENGALURU,KOLKATA,36160,37140,BENGALURU-KOLKATA,73300,All
2015,9,BENGALURU,KOLKATA,25162,21910,BENGALURU-KOLKATA,47072,All
2015,9,BENGALURU,KOLKATA,13112,12363,BENGALURU-KOLKATA,25475,All
2015,10,BENGALURU,KOLKATA,49052,40845,BENGALURU-KOLKATA,89897,All
2015,11,BENGALURU,KOLKATA,46541,44310,BENGALURU-KOLKATA,90851,All
2015,12,BENGALURU,KOLKATA,51741,48663,BENGALURU-KOLKATA,100404,All
2016,1,BENGALURU,KOLKATA,49150,49469,BENGALURU-KOLKATA,98619,All
2016,2,BENGALURU,KOLKATA,45247,43511,BENGALURU-KOLKATA,88758,All
2016,3,BENGALURU,KOLKATA,50227,45765,BENGALURU-KOLKATA,95992,All
2016,4,BENGALURU,KOLKATA,53265,45551,BENGALURU-KOLKATA,98816,All
2016,5,BENGALURU,KOLKATA,51292,58369,BENGALURU-KOLKATA,109661,All
2016,6,BENGALURU,KOLKATA,52063,48595,BENGALURU-KOLKATA,100658,All
2016,7,BENGALURU,KOLKATA,55635,55812,BENGALURU-KOLKATA,111447,All
2016,8,BENGALURU,KOLKATA,55219,55111,BENGALURU-KOLKATA,110330,All
2016,9,BENGALURU,KOLKATA,61266,48462,BENGALURU-KOLKATA,109728,All
2016,10,BENGALURU,KOLKATA,75994,63818,BENGALURU-KOLKATA,139812,All
2016,11,BENGALURU,KOLKATA,58779,64978,BENGALURU-KOLKATA,123757,All
2016,12,BENGALURU,KOLKATA,75616,71642,BENGALURU-KOLKATA,147258,All
2017,1,BENGALURU,KOLKATA,71657,71794,BENGALURU-KOLKATA,143451,All
2017,2,BENGALURU,KOLKATA,56784,56926,BENGALURU-KOLKATA,113710,All
2017,3,BENGALURU,KOLKATA,57849,56087,BENGALURU-KOLKATA,113936,All
2017,4,BENGALURU,KOLKATA,62306,55752,BENGALURU-KOLKATA,118058,All
2017,5,BENGALURU,KOLKATA,68158,75764,BENGALURU-KOLKATA,143922,All
2017,6,BENGALURU,KOLKATA,67341,65300,BENGALURU-KOLKATA,132641,All
2017,7,BENGALURU,KOLKATA,65572,68718,BENGALURU-KOLKATA,134290,All
2017,8,BENGALURU,KOLKATA,71531,65620,BENGALURU-KOLKATA,137151,All
2017,9,BENGALURU,KOLKATA,74010,61528,BENGALURU-KOLKATA,135538,All
2017,10,BENGALURU,KOLKATA,71342,72811,BENGALURU-KOLKATA,144153,All
2017,11,BENGALURU,KOLKATA,68354,67326,BENGALURU-KOLKATA,135680,All
2017,12,BENGALURU,KOLKATA,80799,76518,BENGALURU-KOLKATA,157317,All
2018,1,BENGALURU,KOLKATA,78447,77234,BENGALURU-KOLKATA,155681,All
2018,2,BENGALURU,KOLKATA,74483,73853,BENGALURU-KOLKATA,148336,All
2018,3,BENGALURU,KOLKATA,79788,77967,BENGALURU-KOLKATA,157755,All
2018,4,BENGALURU,KOLKATA,80516,74782,BENGALURU-KOLKATA,155298,All
2018,5,BENGALURU,KOLKATA,77751,85391,BENGALURU-KOLKATA,163142,All
2018,6,BENGALURU,KOLKATA,89227,74580,BENGALURU-KOLKATA,163807,All
2018,7,BENGALURU,KOLKATA,88473,81580,BENGALURU-KOLKATA,170053,All
2018,8,BENGALURU,KOLKATA,73331,68403,BENGALURU-KOLKATA,141734,All
2018,9,BENGALURU,KOLKATA,70421,67163,BENGALURU-KOLKATA,137584,All
2018,10,BENGALURU,KOLKATA,77305,69589,BENGALURU-KOLKATA,146894,All
2018,11,BENGALURU,KOLKATA,69530,67858,BENGALURU-KOLKATA,137388,All
2018,12,BENGALURU,KOLKATA,79081,72298,BENGALURU-KOLKATA,151379,All
2019,1,BENGALURU,KOLKATA,85595,80679,BENGALURU-KOLKATA,166274,All
2019,2,BENGALURU,KOLKATA,78433,78630,BENGALURU-KOLKATA,157063,All
2019,3,BENGALURU,KOLKATA,86782,82043,BENGALURU-KOLKATA,168825,All
2019,4,BENGALURU,KOLKATA,80913,73392,BENGALURU-KOLKATA,154305,All
2019,5,BENGALURU,KOLKATA,73681,76740,BENGALURU-KOLKATA,150421,All
2019,6,BENGALURU,KOLKATA,76178,77926,BENGALURU-KOLKATA,154104,All
2019,7,BENGALURU,KOLKATA,75168,74305,BENGALURU-KOLKATA,149473,All
2019,8,BENGALURU,KOLKATA,77042,74204,BENGALURU-KOLKATA,151246,All
2019,9,BENGALURU,KOLKATA,71071,67218,BENGALURU-KOLKATA,138289,All
2019,10,BENGALURU,KOLKATA,83653,79657,BENGALURU-KOLKATA,163310,All
2019,11,BENGALURU,KOLKATA,78373,78474,BENGALURU-KOLKATA,156847,All
2019,12,BENGALURU,KOLKATA,86950,84318,BENGALURU-KOLKATA,171268,All
2020,1,BENGALURU,KOLKATA,85243,82414,BENGALURU-KOLKATA,167657,All
2020,2,BENGALURU,KOLKATA,73740,72613,BENGALURU-KOLKATA,146353,All
2020,3,BENGALURU,KOLKATA,64941,44357,BENGALURU-KOLKATA,109298,All
2020,5,BENGALURU,KOLKATA,1255,670,BENGALURU-KOLKATA,1925,All
2020,6,BENGALURU,KOLKATA,41015,15265,BENGALURU-KOLKATA,56280,All
2020,7,BENGALURU,KOLKATA,47769,16715,BENGALURU-KOLKATA,64484,All
2020,8,BENGALURU,KOLKATA,40678,44945,BENGALURU-KOLKATA,85623,All
2020,9,BENGALURU,KOLKATA,37977,71899,BENGALURU-KOLKATA,109876,All
2020,10,BENGALURU,KOLKATA,62603,80605,BENGALURU-KOLKATA,143208,All
2020,11,BENGALURU,KOLKATA,64026,84346,BENGALURU-KOLKATA,148372,All
2020,12,BENGALURU,KOLKATA,67612,92348,BENGALURU-KOLKATA,159960,All
2021,1,BENGALURU,KOLKATA,81076,99864,BENGALURU-KOLKATA,180940,All
2021,2,BENGALURU,KOLKATA,79117,80425,BENGALURU-KOLKATA,159542,All
2021,3,BENGALURU,KOLKATA,80527,72043,BENGALURU-KOLKATA,152570,All
2021,4,BENGALURU,KOLKATA,65644,44091,BENGALURU-KOLKATA,109735,All
2021,6,BENGALURU,KOLKATA,20491,27399,BENGALURU-KOLKATA,47890,All
2021,7,BENGALURU,KOLKATA,35886,47054,BENGALURU-KOLKATA,82940,All
2021,8,BENGALURU,KOLKATA,42072,63182,BENGALURU-KOLKATA,105254,All
2021,9,BENGALURU,KOLKATA,48453,51372,BENGALURU-KOLKATA,99825,All
2021,10,BENGALURU,KOLKATA,82780,65033,BENGALURU-KOLKATA,147813,All
2021,11,BENGALURU,KOLKATA,78571,75914,BENGALURU-KOLKATA,154485,All
2021,12,BENGALURU,KOLKATA,89296,84942,BENGALURU-KOLKATA,174238,All
2022,1,BENGALURU,KOLKATA,63994,49870,BENGALURU-KOLKATA,113864,All
2022,2,BENGALURU,KOLKATA,45069,51093,BENGALURU-KOLKATA,96162,All
2022,3,BENGALURU,KOLKATA,70599,74869,BENGALURU-KOLKATA,145468,All
2022,4,BENGALURU,KOLKATA,78765,70490,BENGALURU-KOLKATA,149255,All
2022,5,BENGALURU,KOLKATA,77445,86681,BENGALURU-KOLKATA,164126,All
2022,6,BENGALURU,KOLKATA,72111,68679,BENGALURU-KOLKATA,140790,All
2022,7,BENGALURU,KOLKATA,68218,67150,BENGALURU-KOLKATA,135368,All
2022,8,BENGALURU,KOLKATA,64156,68274,BENGALURU-KOLKATA,132430,All
2022,9,BENGALURU,KOLKATA,67704,56397,BENGALURU-KOLKATA,124101,All
2022,10,BENGALURU,KOLKATA,93565,81701,BENGALURU-KOLKATA,175266,All
2022,11,BENGALURU,KOLKATA,62117,65641,BENGALURU-KOLKATA,127758,All
2022,12,BENGALURU,KOLKATA,75246,73121,BENGALURU-KOLKATA,148367,All
2023,1,BENGALURU,KOLKATA,75628,73204,BENGALURU-KOLKATA,148832,All
2023,2,BENGALURU,KOLKATA,73147,69832,BENGALURU-KOLKATA,142979,All
2023,3,BENGALURU,KOLKATA,78487,75063,BENGALURU-KOLKATA,153550,All
2023,4,BENGALURU,KOLKATA,73335,64806,BENGALURU-KOLKATA,138141,All
2023,5,BENGALURU,KOLKATA,69721,72250,BENGALURU-KOLKATA,141971,All
2023,6,BENGALURU,KOLKATA,74169,74166,BENGALURU-KOLKATA,148335,All
2023,7,BENGALURU,KOLKATA,64641,76286,BENGALURU-KOLKATA,140927,All
2023,8,BENGALURU,KOLKATA,72822,77392,BENGALURU-KOLKATA,150214,All
2023,9,BENGALURU,KOLKATA,72402,72498,BENGALURU-KOLKATA,144900,All
2023,10,BENGALURU,KOLKATA,85501,74389,BENGALURU-KOLKATA,159890,All
2023,11,BENGALURU,KOLKATA,94344,87486,BENGALURU-KOLKATA,181830,All
2023,12,BENGALURU,KOLKATA,98370,100081,BENGALURU-KOLKATA,198451,All
2024,1,BENGALURU,KOLKATA,97699,94467,BENGALURU-KOLKATA,192166,All
2024,2,BENGALURU,KOLKATA,86009,81968,BENGALURU-KOLKATA,167977,All
2024,3,BENGALURU,KOLKATA,103143,89254,BENGALURU-KOLKATA,192397,All
2024,4,BENGALURU,KOLKATA,103477,89286,BENGALURU-KOLKATA,192763,All
2024,6,BENGALURU,KOLKATA,95922,92626,BENGALURU-KOLKATA,188548,All
2024,7,BENGALURU,KOLKATA,90629,97230,BENGALURU-KOLKATA,187859,All
2024,8,BENGALURU,KOLKATA,89605,93598,BENGALURU-KOLKATA,183203,All
2024,9,BENGALURU,KOLKATA,100303,91148,BENGALURU-KOLKATA,191451,All
2024,10,BENGALURU,KOLKATA,122296,98086,BENGALURU-KOLKATA,220382,All
2024,11,BENGALURU,KOLKATA,108705,111734,BENGALURU-KOLKATA,220439,All
2024,12,BENGALURU,KOLKATA,106293,104541,BENGALURU-KOLKATA,210834,All
2025,1,BENGALURU,KOLKATA,99123,97630,BENGALURU-KOLKATA,196753,All
2025,2,BENGALURU,KOLKATA,80547,76476,BENGALURU-KOLKATA,157023,All
2025,3,BENGALURU,KOLKATA,98985,90965,BENGALURU-KOLKATA,189950,All
2015,4,BENGALURU,KOZHIKODE,1752,1507,BENGALURU-KOZHIKODE,3259,All
2015,5,BENGALURU,KOZHIKODE,2084,2002,BENGALURU-KOZHIKODE,4086,All
2015,6,BENGALURU,KOZHIKODE,1689,1544,BENGALURU-KOZHIKODE,3233,All
2015,7,BENGALURU,KOZHIKODE,2021,1806,BENGALURU-KOZHIKODE,3827,All
2015,8,BENGALURU,KOZHIKODE,1943,1895,BENGALURU-KOZHIKODE,3838,All
2015,9,BENGALURU,KOZHIKODE,1637,1826,BENGALURU-KOZHIKODE,3463,All
2015,10,BENGALURU,KOZHIKODE,1841,1728,BENGALURU-KOZHIKODE,3569,All
2015,11,BENGALURU,KOZHIKODE,1792,1629,BENGALURU-KOZHIKODE,3421,All
2015,12,BENGALURU,KOZHIKODE,1796,1672,BENGALURU-KOZHIKODE,3468,All
2016,1,BENGALURU,KOZHIKODE,1978,1817,BENGALURU-KOZHIKODE,3795,All
2016,2,BENGALURU,KOZHIKODE,1805,1704,BENGALURU-KOZHIKODE,3509,All
2016,3,BENGALURU,KOZHIKODE,1898,1738,BENGALURU-KOZHIKODE,3636,All
2016,4,BENGALURU,KOZHIKODE,1899,1825,BENGALURU-KOZHIKODE,3724,All
2016,5,BENGALURU,KOZHIKODE,1925,1815,BENGALURU-KOZHIKODE,3740,All
2016,6,BENGALURU,KOZHIKODE,1827,1585,BENGALURU-KOZHIKODE,3412,All
2016,7,BENGALURU,KOZHIKODE,1971,1763,BENGALURU-KOZHIKODE,3734,All
2016,8,BENGALURU,KOZHIKODE,1906,1872,BENGALURU-KOZHIKODE,3778,All
2016,9,BENGALURU,KOZHIKODE,2060,1914,BENGALURU-KOZHIKODE,3974,All
2016,10,BENGALURU,KOZHIKODE,2010,1881,BENGALURU-KOZHIKODE,3891,All
2016,11,BENGALURU,KOZHIKODE,1741,1798,BENGALURU-KOZHIKODE,3539,All
2016,12,BENGALURU,KOZHIKODE,1946,1860,BENGALURU-KOZHIKODE,3806,All
2017,1,BENGALURU,KOZHIKODE,1779,1845,BENGALURU-KOZHIKODE,3624,All
2017,2,BENGALURU,KOZHIKODE,1672,1653,BENGALURU-KOZHIKODE,3325,All
2017,3,BENGALURU,KOZHIKODE,1625,1433,BENGALURU-KOZHIKODE,3058,All
2017,4,BENGALURU,KOZHIKODE,1691,1608,BENGALURU-KOZHIKODE,3299,All
2017,5,BENGALURU,KOZHIKODE,3562,3546,BENGALURU-KOZHIKODE,7108,All
2017,6,BENGALURU,KOZHIKODE,3233,2800,BENGALURU-KOZHIKODE,6033,All
2017,7,BENGALURU,KOZHIKODE,3496,3174,BENGALURU-KOZHIKODE,6670,All
2017,8,BENGALURU,KOZHIKODE,3419,3274,BENGALURU-KOZHIKODE,6693,All
2017,9,BENGALURU,KOZHIKODE,3397,3291,BENGALURU-KOZHIKODE,6688,All
2017,10,BENGALURU,KOZHIKODE,3196,3123,BENGALURU-KOZHIKODE,6319,All
2017,11,BENGALURU,KOZHIKODE,3374,3155,BENGALURU-KOZHIKODE,6529,All
2017,12,BENGALURU,KOZHIKODE,3802,3545,BENGALURU-KOZHIKODE,7347,All
2018,1,BENGALURU,KOZHIKODE,3852,3888,BENGALURU-KOZHIKODE,7740,All
2018,2,BENGALURU,KOZHIKODE,3366,3364,BENGALURU-KOZHIKODE,6730,All
2018,3,BENGALURU,KOZHIKODE,3364,3296,BENGALURU-KOZHIKODE,6660,All
2018,4,BENGALURU,KOZHIKODE,2017,2019,BENGALURU-KOZHIKODE,4036,All
2018,5,BENGALURU,KOZHIKODE,4397,3064,BENGALURU-KOZHIKODE,7461,All
2018,6,BENGALURU,KOZHIKODE,5187,5120,BENGALURU-KOZHIKODE,10307,All
2018,7,BENGALURU,KOZHIKODE,6047,5945,BENGALURU-KOZHIKODE,11992,All
2018,8,BENGALURU,KOZHIKODE,6705,6878,BENGALURU-KOZHIKODE,13583,All
2018,9,BENGALURU,KOZHIKODE,5506,5785,BENGALURU-KOZHIKODE,11291,All
2018,10,BENGALURU,KOZHIKODE,5280,5134,BENGALURU-KOZHIKODE,10414,All
2018,11,BENGALURU,KOZHIKODE,5260,5418,BENGALURU-KOZHIKODE,10678,All
2018,12,BENGALURU,KOZHIKODE,5549,5293,BENGALURU-KOZHIKODE,10842,All
2019,1,BENGALURU,KOZHIKODE,4079,4378,BENGALURU-KOZHIKODE,8457,All
2019,2,BENGALURU,KOZHIKODE,2716,2783,BENGALURU-KOZHIKODE,5499,All
2019,3,BENGALURU,KOZHIKODE,4020,4087,BENGALURU-KOZHIKODE,8107,All
2019,4,BENGALURU,KOZHIKODE,5477,5584,BENGALURU-KOZHIKODE,11061,All
2019,5,BENGALURU,KOZHIKODE,7426,7353,BENGALURU-KOZHIKODE,14779,All
2019,6,BENGALURU,KOZHIKODE,7400,7798,BENGALURU-KOZHIKODE,15198,All
2019,7,BENGALURU,KOZHIKODE,8645,8536,BENGALURU-KOZHIKODE,17181,All
2019,8,BENGALURU,KOZHIKODE,7490,7605,BENGALURU-KOZHIKODE,15095,All
2019,9,BENGALURU,KOZHIKODE,6747,6870,BENGALURU-KOZHIKODE,13617,All
2019,10,BENGALURU,KOZHIKODE,6635,6386,BENGALURU-KOZHIKODE,13021,All
2019,11,BENGALURU,KOZHIKODE,6094,6813,BENGALURU-KOZHIKODE,12907,All
2019,12,BENGALURU,KOZHIKODE,7313,7758,BENGALURU-KOZHIKODE,15071,All
2020,1,BENGALURU,KOZHIKODE,7231,8706,BENGALURU-KOZHIKODE,15937,All
2020,2,BENGALURU,KOZHIKODE,5654,7190,BENGALURU-KOZHIKODE,12844,All
2020,3,BENGALURU,KOZHIKODE,2028,2471,BENGALURU-KOZHIKODE,4499,All
2020,5,BENGALURU,KOZHIKODE,205,169,BENGALURU-KOZHIKODE,374,All
2020,6,BENGALURU,KOZHIKODE,1331,1153,BENGALURU-KOZHIKODE,2484,All
2020,7,BENGALURU,KOZHIKODE,1668,1784,BENGALURU-KOZHIKODE,3452,All
2020,8,BENGALURU,KOZHIKODE,2219,2928,BENGALURU-KOZHIKODE,5147,All
2020,9,BENGALURU,KOZHIKODE,3502,3048,BENGALURU-KOZHIKODE,6550,All
2020,10,BENGALURU,KOZHIKODE,5945,4665,BENGALURU-KOZHIKODE,10610,All
2020,11,BENGALURU,KOZHIKODE,6764,5143,BENGALURU-KOZHIKODE,11907,All
2020,12,BENGALURU,KOZHIKODE,6709,5612,BENGALURU-KOZHIKODE,12321,All
2021,1,BENGALURU,KOZHIKODE,6920,6910,BENGALURU-KOZHIKODE,13830,All
2021,2,BENGALURU,KOZHIKODE,5105,6884,BENGALURU-KOZHIKODE,11989,All
2021,3,BENGALURU,KOZHIKODE,4081,7086,BENGALURU-KOZHIKODE,11167,All
2021,4,BENGALURU,KOZHIKODE,2232,3135,BENGALURU-KOZHIKODE,5367,All
2021,6,BENGALURU,KOZHIKODE,871,1677,BENGALURU-KOZHIKODE,2548,All
2021,7,BENGALURU,KOZHIKODE,1423,2298,BENGALURU-KOZHIKODE,3721,All
2021,8,BENGALURU,KOZHIKODE,2927,3251,BENGALURU-KOZHIKODE,6178,All
2021,9,BENGALURU,KOZHIKODE,2644,3390,BENGALURU-KOZHIKODE,6034,All
2021,10,BENGALURU,KOZHIKODE,3044,3843,BENGALURU-KOZHIKODE,6887,All
2021,11,BENGALURU,KOZHIKODE,1995,2267,BENGALURU-KOZHIKODE,4262,All
2021,12,BENGALURU,KOZHIKODE,3017,2443,BENGALURU-KOZHIKODE,5460,All
2022,1,BENGALURU,KOZHIKODE,1646,2139,BENGALURU-KOZHIKODE,3785,All
2022,2,BENGALURU,KOZHIKODE,1253,1776,BENGALURU-KOZHIKODE,3029,All
2022,3,BENGALURU,KOZHIKODE,3345,4575,BENGALURU-KOZHIKODE,7920,All
2022,4,BENGALURU,KOZHIKODE,2066,2125,BENGALURU-KOZHIKODE,4191,All
2022,5,BENGALURU,KOZHIKODE,2797,3166,BENGALURU-KOZHIKODE,5963,All
2022,6,BENGALURU,KOZHIKODE,3901,3947,BENGALURU-KOZHIKODE,7848,All
2022,7,BENGALURU,KOZHIKODE,4850,4734,BENGALURU-KOZHIKODE,9584,All
2022,8,BENGALURU,KOZHIKODE,4435,4511,BENGALURU-KOZHIKODE,8946,All
2022,9,BENGALURU,KOZHIKODE,4630,4601,BENGALURU-KOZHIKODE,9231,All
2022,10,BENGALURU,KOZHIKODE,4325,4703,BENGALURU-KOZHIKODE,9028,All
2022,11,BENGALURU,KOZHIKODE,3186,4296,BENGALURU-KOZHIKODE,7482,All
2022,12,BENGALURU,KOZHIKODE,3991,4014,BENGALURU-KOZHIKODE,8005,All
2023,1,BENGALURU,KOZHIKODE,3969,4525,BENGALURU-KOZHIKODE,8494,All
2023,2,BENGALURU,KOZHIKODE,3770,4388,BENGALURU-KOZHIKODE,8158,All
2023,3,BENGALURU,KOZHIKODE,4334,4714,BENGALURU-KOZHIKODE,9048,All
2023,4,BENGALURU,KOZHIKODE,4380,4410,BENGALURU-KOZHIKODE,8790,All
2023,5,BENGALURU,KOZHIKODE,4945,5106,BENGALURU-KOZHIKODE,10051,All
2023,6,BENGALURU,KOZHIKODE,4883,4741,BENGALURU-KOZHIKODE,9624,All
2023,7,BENGALURU,KOZHIKODE,5382,5690,BENGALURU-KOZHIKODE,11072,All
2023,8,BENGALURU,KOZHIKODE,5570,5813,BENGALURU-KOZHIKODE,11383,All
2023,9,BENGALURU,KOZHIKODE,6064,6804,BENGALURU-KOZHIKODE,12868,All
2023,10,BENGALURU,KOZHIKODE,6200,6328,BENGALURU-KOZHIKODE,12528,All
2023,11,BENGALURU,KOZHIKODE,6071,6760,BENGALURU-KOZHIKODE,12831,All
2023,12,BENGALURU,KOZHIKODE,7734,7178,BENGALURU-KOZHIKODE,14912,All
2024,1,BENGALURU,KOZHIKODE,7673,9564,BENGALURU-KOZHIKODE,17237,All
2024,2,BENGALURU,KOZHIKODE,8780,9680,BENGALURU-KOZHIKODE,18460,All
2024,3,BENGALURU,KOZHIKODE,8536,9347,BENGALURU-KOZHIKODE,17883,All
2024,4,BENGALURU,KOZHIKODE,8845,9014,BENGALURU-KOZHIKODE,17859,All
2024,6,BENGALURU,KOZHIKODE,9086,10030,BENGALURU-KOZHIKODE,19116,All
2024,7,BENGALURU,KOZHIKODE,10486,10321,BENGALURU-KOZHIKODE,20807,All
2024,8,BENGALURU,KOZHIKODE,9928,9964,BENGALURU-KOZHIKODE,19892,All
2024,9,BENGALURU,KOZHIKODE,10385,10636,BENGALURU-KOZHIKODE,21021,All
2024,10,BENGALURU,KOZHIKODE,9383,9307,BENGALURU-KOZHIKODE,18690,All
2024,11,BENGALURU,KOZHIKODE,7838,8981,BENGALURU-KOZHIKODE,16819,All
2024,12,BENGALURU,KOZHIKODE,8589,8369,BENGALURU-KOZHIKODE,16958,All
2025,1,BENGALURU,KOZHIKODE,7764,8270,BENGALURU-KOZHIKODE,16034,All
2025,2,BENGALURU,KOZHIKODE,8491,8842,BENGALURU-KOZHIKODE,17333,All
2025,3,BENGALURU,KOZHIKODE,10409,10423,BENGALURU-KOZHIKODE,20832,All
2021,3,BENGALURU,KURNOOL,97,123,BENGALURU-KURNOOL,220,All
2021,4,BENGALURU,KURNOOL,351,293,BENGALURU-KURNOOL,644,All
2021,6,BENGALURU,KURNOOL,310,319,BENGALURU-KURNOOL,629,All
2021,7,BENGALURU,KURNOOL,206,299,BENGALURU-KURNOOL,505,All
2021,8,BENGALURU,KURNOOL,291,365,BENGALURU-KURNOOL,656,All
2021,9,BENGALURU,KURNOOL,218,344,BENGALURU-KURNOOL,562,All
2021,10,BENGALURU,KURNOOL,328,457,BENGALURU-KURNOOL,785,All
2021,11,BENGALURU,KURNOOL,288,349,BENGALURU-KURNOOL,637,All
2021,12,BENGALURU,KURNOOL,352,387,BENGALURU-KURNOOL,739,All
2022,1,BENGALURU,KURNOOL,207,296,BENGALURU-KURNOOL,503,All
2022,2,BENGALURU,KURNOOL,183,307,BENGALURU-KURNOOL,490,All
2022,3,BENGALURU,KURNOOL,476,555,BENGALURU-KURNOOL,1031,All
2022,4,BENGALURU,KURNOOL,560,709,BENGALURU-KURNOOL,1269,All
2022,5,BENGALURU,KURNOOL,658,889,BENGALURU-KURNOOL,1547,All
2022,6,BENGALURU,KURNOOL,669,878,BENGALURU-KURNOOL,1547,All
2022,7,BENGALURU,KURNOOL,406,506,BENGALURU-KURNOOL,912,All
2022,8,BENGALURU,KURNOOL,365,496,BENGALURU-KURNOOL,861,All
2022,9,BENGALURU,KURNOOL,246,339,BENGALURU-KURNOOL,585,All
2022,10,BENGALURU,KURNOOL,388,482,BENGALURU-KURNOOL,870,All
2022,11,BENGALURU,KURNOOL,277,333,BENGALURU-KURNOOL,610,All
2022,12,BENGALURU,KURNOOL,350,444,BENGALURU-KURNOOL,794,All
2023,1,BENGALURU,KURNOOL,398,546,BENGALURU-KURNOOL,944,All
2023,2,BENGALURU,KURNOOL,192,323,BENGALURU-KURNOOL,515,All
2023,3,BENGALURU,KURNOOL,370,495,BENGALURU-KURNOOL,865,All
2023,4,BENGALURU,KURNOOL,360,497,BENGALURU-KURNOOL,857,All
2023,5,BENGALURU,KURNOOL,406,703,BENGALURU-KURNOOL,1109,All
2023,6,BENGALURU,KURNOOL,451,538,BENGALURU-KURNOOL,989,All
2023,7,BENGALURU,KURNOOL,366,585,BENGALURU-KURNOOL,951,All
2023,8,BENGALURU,KURNOOL,368,488,BENGALURU-KURNOOL,856,All
2023,9,BENGALURU,KURNOOL,407,509,BENGALURU-KURNOOL,916,All
2023,10,BENGALURU,KURNOOL,496,607,BENGALURU-KURNOOL,1103,All
2023,11,BENGALURU,KURNOOL,343,443,BENGALURU-KURNOOL,786,All
2023,12,BENGALURU,KURNOOL,585,619,BENGALURU-KURNOOL,1204,All
2024,1,BENGALURU,KURNOOL,405,590,BENGALURU-KURNOOL,995,All
2024,2,BENGALURU,KURNOOL,321,353,BENGALURU-KURNOOL,674,All
2024,3,BENGALURU,KURNOOL,380,405,BENGALURU-KURNOOL,785,All
2024,8,BENGALURU,KURNOOL,91,85,BENGALURU-KURNOOL,176,All
2024,9,BENGALURU,KURNOOL,173,175,BENGALURU-KURNOOL,348,All
2024,10,BENGALURU,KURNOOL,256,174,BENGALURU-KURNOOL,430,All
2024,11,BENGALURU,KURNOOL,147,213,BENGALURU-KURNOOL,360,All
2024,12,BENGALURU,KURNOOL,138,196,BENGALURU-KURNOOL,334,All
2025,1,BENGALURU,KURNOOL,189,197,BENGALURU-KURNOOL,386,All
2025,2,BENGALURU,KURNOOL,96,155,BENGALURU-KURNOOL,251,All
2025,3,BENGALURU,KURNOOL,175,181,BENGALURU-KURNOOL,356,All
2015,4,BENGALURU,LUCKNOW,5876,4546,BENGALURU-LUCKNOW,10422,All
2015,5,BENGALURU,LUCKNOW,6514,7657,BENGALURU-LUCKNOW,14171,All
2015,6,BENGALURU,LUCKNOW,5017,6189,BENGALURU-LUCKNOW,11206,All
2015,7,BENGALURU,LUCKNOW,5773,5776,BENGALURU-LUCKNOW,11549,All
2015,8,BENGALURU,LUCKNOW,5186,5424,BENGALURU-LUCKNOW,10610,All
2015,9,BENGALURU,LUCKNOW,4828,4465,BENGALURU-LUCKNOW,9293,All
2015,10,BENGALURU,LUCKNOW,5871,5282,BENGALURU-LUCKNOW,11153,All
2015,11,BENGALURU,LUCKNOW,6198,6122,BENGALURU-LUCKNOW,12320,All
2015,12,BENGALURU,LUCKNOW,7089,7142,BENGALURU-LUCKNOW,14231,All
2016,1,BENGALURU,LUCKNOW,6352,5846,BENGALURU-LUCKNOW,12198,All
2016,2,BENGALURU,LUCKNOW,5355,5104,BENGALURU-LUCKNOW,10459,All
2016,3,BENGALURU,LUCKNOW,4480,4721,BENGALURU-LUCKNOW,9201,All
2016,4,BENGALURU,LUCKNOW,7337,6653,BENGALURU-LUCKNOW,13990,All
2016,5,BENGALURU,LUCKNOW,7656,9321,BENGALURU-LUCKNOW,16977,All
2016,6,BENGALURU,LUCKNOW,7669,7686,BENGALURU-LUCKNOW,15355,All
2016,7,BENGALURU,LUCKNOW,8999,9013,BENGALURU-LUCKNOW,18012,All
2016,8,BENGALURU,LUCKNOW,9870,9472,BENGALURU-LUCKNOW,19342,All
2016,9,BENGALURU,LUCKNOW,10498,9033,BENGALURU-LUCKNOW,19531,All
2016,10,BENGALURU,LUCKNOW,15118,11626,BENGALURU-LUCKNOW,26744,All
2016,11,BENGALURU,LUCKNOW,13494,14888,BENGALURU-LUCKNOW,28382,All
2016,12,BENGALURU,LUCKNOW,9832,11842,BENGALURU-LUCKNOW,21674,All
2017,1,BENGALURU,LUCKNOW,10199,10482,BENGALURU-LUCKNOW,20681,All
2017,2,BENGALURU,LUCKNOW,9071,9356,BENGALURU-LUCKNOW,18427,All
2017,3,BENGALURU,LUCKNOW,9288,8991,BENGALURU-LUCKNOW,18279,All
2017,4,BENGALURU,LUCKNOW,10888,9347,BENGALURU-LUCKNOW,20235,All
2017,5,BENGALURU,LUCKNOW,11098,13000,BENGALURU-LUCKNOW,24098,All
2017,6,BENGALURU,LUCKNOW,11268,12382,BENGALURU-LUCKNOW,23650,All
2017,7,BENGALURU,LUCKNOW,8664,9365,BENGALURU-LUCKNOW,18029,All
2017,8,BENGALURU,LUCKNOW,9046,9145,BENGALURU-LUCKNOW,18191,All
2017,9,BENGALURU,LUCKNOW,11206,7766,BENGALURU-LUCKNOW,18972,All
2017,10,BENGALURU,LUCKNOW,10801,10878,BENGALURU-LUCKNOW,21679,All
2017,11,BENGALURU,LUCKNOW,11113,11709,BENGALURU-LUCKNOW,22822,All
2017,12,BENGALURU,LUCKNOW,18631,19013,BENGALURU-LUCKNOW,37644,All
2018,1,BENGALURU,LUCKNOW,21636,20076,BENGALURU-LUCKNOW,41712,All
2018,2,BENGALURU,LUCKNOW,22882,19242,BENGALURU-LUCKNOW,42124,All
2018,3,BENGALURU,LUCKNOW,22780,23579,BENGALURU-LUCKNOW,46359,All
2018,4,BENGALURU,LUCKNOW,23834,20706,BENGALURU-LUCKNOW,44540,All
2018,5,BENGALURU,LUCKNOW,21824,24951,BENGALURU-LUCKNOW,46775,All
2018,6,BENGALURU,LUCKNOW,24113,24215,BENGALURU-LUCKNOW,48328,All
2018,7,BENGALURU,LUCKNOW,22008,22716,BENGALURU-LUCKNOW,44724,All
2018,8,BENGALURU,LUCKNOW,26909,26063,BENGALURU-LUCKNOW,52972,All
2018,9,BENGALURU,LUCKNOW,24686,23427,BENGALURU-LUCKNOW,48113,All
2018,10,BENGALURU,LUCKNOW,32276,25311,BENGALURU-LUCKNOW,57587,All
2018,11,BENGALURU,LUCKNOW,23943,24518,BENGALURU-LUCKNOW,48461,All
2018,12,BENGALURU,LUCKNOW,29006,30709,BENGALURU-LUCKNOW,59715,All
2019,1,BENGALURU,LUCKNOW,30700,27383,BENGALURU-LUCKNOW,58083,All
2019,2,BENGALURU,LUCKNOW,28474,26973,BENGALURU-LUCKNOW,55447,All
2019,3,BENGALURU,LUCKNOW,35462,33675,BENGALURU-LUCKNOW,69137,All
2019,4,BENGALURU,LUCKNOW,34467,26851,BENGALURU-LUCKNOW,61318,All
2019,5,BENGALURU,LUCKNOW,29159,29817,BENGALURU-LUCKNOW,58976,All
2019,6,BENGALURU,LUCKNOW,28720,29044,BENGALURU-LUCKNOW,57764,All
2019,7,BENGALURU,LUCKNOW,28362,29058,BENGALURU-LUCKNOW,57420,All
2019,8,BENGALURU,LUCKNOW,25314,23723,BENGALURU-LUCKNOW,49037,All
2019,9,BENGALURU,LUCKNOW,19990,16785,BENGALURU-LUCKNOW,36775,All
2019,10,BENGALURU,LUCKNOW,29697,22222,BENGALURU-LUCKNOW,51919,All
2019,11,BENGALURU,LUCKNOW,26400,27283,BENGALURU-LUCKNOW,53683,All
2019,12,BENGALURU,LUCKNOW,26513,27651,BENGALURU-LUCKNOW,54164,All
2020,1,BENGALURU,LUCKNOW,24216,23857,BENGALURU-LUCKNOW,48073,All
2020,2,BENGALURU,LUCKNOW,23970,23110,BENGALURU-LUCKNOW,47080,All
2020,3,BENGALURU,LUCKNOW,15523,12221,BENGALURU-LUCKNOW,27744,All
2020,5,BENGALURU,LUCKNOW,2109,776,BENGALURU-LUCKNOW,2885,All
2020,6,BENGALURU,LUCKNOW,10570,6080,BENGALURU-LUCKNOW,16650,All
2020,7,BENGALURU,LUCKNOW,8129,4816,BENGALURU-LUCKNOW,12945,All
2020,8,BENGALURU,LUCKNOW,6950,16186,BENGALURU-LUCKNOW,23136,All
2020,9,BENGALURU,LUCKNOW,8417,21989,BENGALURU-LUCKNOW,30406,All
2020,10,BENGALURU,LUCKNOW,14976,15904,BENGALURU-LUCKNOW,30880,All
2020,11,BENGALURU,LUCKNOW,23065,15086,BENGALURU-LUCKNOW,38151,All
2020,12,BENGALURU,LUCKNOW,14966,22813,BENGALURU-LUCKNOW,37779,All
2021,1,BENGALURU,LUCKNOW,12335,19921,BENGALURU-LUCKNOW,32256,All
2021,2,BENGALURU,LUCKNOW,14789,14369,BENGALURU-LUCKNOW,29158,All
2021,3,BENGALURU,LUCKNOW,17476,12816,BENGALURU-LUCKNOW,30292,All
2021,4,BENGALURU,LUCKNOW,20358,10883,BENGALURU-LUCKNOW,31241,All
2021,6,BENGALURU,LUCKNOW,4862,7993,BENGALURU-LUCKNOW,12855,All
2021,7,BENGALURU,LUCKNOW,7574,11280,BENGALURU-LUCKNOW,18854,All
2021,8,BENGALURU,LUCKNOW,12685,14592,BENGALURU-LUCKNOW,27277,All
2021,9,BENGALURU,LUCKNOW,11801,12238,BENGALURU-LUCKNOW,24039,All
2021,10,BENGALURU,LUCKNOW,20786,14738,BENGALURU-LUCKNOW,35524,All
2021,11,BENGALURU,LUCKNOW,19125,20191,BENGALURU-LUCKNOW,39316,All
2021,12,BENGALURU,LUCKNOW,16629,22385,BENGALURU-LUCKNOW,39014,All
2022,1,BENGALURU,LUCKNOW,12727,10633,BENGALURU-LUCKNOW,23360,All
2022,2,BENGALURU,LUCKNOW,12362,12318,BENGALURU-LUCKNOW,24680,All
2022,3,BENGALURU,LUCKNOW,20087,19609,BENGALURU-LUCKNOW,39696,All
2022,4,BENGALURU,LUCKNOW,23492,20855,BENGALURU-LUCKNOW,44347,All
2022,5,BENGALURU,LUCKNOW,18455,22969,BENGALURU-LUCKNOW,41424,All
2022,6,BENGALURU,LUCKNOW,17062,20166,BENGALURU-LUCKNOW,37228,All
2022,7,BENGALURU,LUCKNOW,15889,19393,BENGALURU-LUCKNOW,35282,All
2022,8,BENGALURU,LUCKNOW,19420,22802,BENGALURU-LUCKNOW,42222,All
2022,9,BENGALURU,LUCKNOW,23641,20677,BENGALURU-LUCKNOW,44318,All
2022,10,BENGALURU,LUCKNOW,25684,20513,BENGALURU-LUCKNOW,46197,All
2022,11,BENGALURU,LUCKNOW,25675,30755,BENGALURU-LUCKNOW,56430,All
2022,12,BENGALURU,LUCKNOW,29454,34220,BENGALURU-LUCKNOW,63674,All
2023,1,BENGALURU,LUCKNOW,37732,37971,BENGALURU-LUCKNOW,75703,All
2023,2,BENGALURU,LUCKNOW,34275,33532,BENGALURU-LUCKNOW,67807,All
2023,3,BENGALURU,LUCKNOW,39816,41548,BENGALURU-LUCKNOW,81364,All
2023,4,BENGALURU,LUCKNOW,45444,39748,BENGALURU-LUCKNOW,85192,All
2023,5,BENGALURU,LUCKNOW,35969,36358,BENGALURU-LUCKNOW,72327,All
2023,6,BENGALURU,LUCKNOW,36661,36579,BENGALURU-LUCKNOW,73240,All
2023,7,BENGALURU,LUCKNOW,34289,35818,BENGALURU-LUCKNOW,70107,All
2023,8,BENGALURU,LUCKNOW,33017,31888,BENGALURU-LUCKNOW,64905,All
2023,9,BENGALURU,LUCKNOW,29432,29170,BENGALURU-LUCKNOW,58602,All
2023,10,BENGALURU,LUCKNOW,29885,25379,BENGALURU-LUCKNOW,55264,All
2023,11,BENGALURU,LUCKNOW,36097,30516,BENGALURU-LUCKNOW,66613,All
2023,12,BENGALURU,LUCKNOW,32977,36273,BENGALURU-LUCKNOW,69250,All
2024,1,BENGALURU,LUCKNOW,32573,33966,BENGALURU-LUCKNOW,66539,All
2024,2,BENGALURU,LUCKNOW,30919,29128,BENGALURU-LUCKNOW,60047,All
2024,3,BENGALURU,LUCKNOW,34731,32492,BENGALURU-LUCKNOW,67223,All
2024,4,BENGALURU,LUCKNOW,35024,32685,BENGALURU-LUCKNOW,67709,All
2024,6,BENGALURU,LUCKNOW,28967,30722,BENGALURU-LUCKNOW,59689,All
2024,7,BENGALURU,LUCKNOW,27662,30891,BENGALURU-LUCKNOW,58553,All
2024,8,BENGALURU,LUCKNOW,26189,27513,BENGALURU-LUCKNOW,53702,All
2024,9,BENGALURU,LUCKNOW,25419,25683,BENGALURU-LUCKNOW,51102,All
2024,10,BENGALURU,LUCKNOW,33570,26092,BENGALURU-LUCKNOW,59662,All
2024,11,BENGALURU,LUCKNOW,33751,34523,BENGALURU-LUCKNOW,68274,All
2024,12,BENGALURU,LUCKNOW,29299,31387,BENGALURU-LUCKNOW,60686,All
2025,1,BENGALURU,LUCKNOW,33846,34222,BENGALURU-LUCKNOW,68068,All
2025,2,BENGALURU,LUCKNOW,36390,35724,BENGALURU-LUCKNOW,72114,All
2025,3,BENGALURU,LUCKNOW,29840,29887,BENGALURU-LUCKNOW,59727,All
2015,6,BENGALURU,MADURAI,145,168,BENGALURU-MADURAI,313,All
2015,7,BENGALURU,MADURAI,631,544,BENGALURU-MADURAI,1175,All
2015,8,BENGALURU,MADURAI,883,945,BENGALURU-MADURAI,1828,All
2015,9,BENGALURU,MADURAI,1263,1387,BENGALURU-MADURAI,2650,All
2015,10,BENGALURU,MADURAI,1554,1575,BENGALURU-MADURAI,3129,All
2015,11,BENGALURU,MADURAI,1250,1379,BENGALURU-MADURAI,2629,All
2015,12,BENGALURU,MADURAI,1422,1233,BENGALURU-MADURAI,2655,All
2016,1,BENGALURU,MADURAI,1435,1526,BENGALURU-MADURAI,2961,All
2016,2,BENGALURU,MADURAI,1212,1258,BENGALURU-MADURAI,2470,All
2016,3,BENGALURU,MADURAI,1398,1479,BENGALURU-MADURAI,2877,All
2016,4,BENGALURU,MADURAI,2929,2860,BENGALURU-MADURAI,5789,All
2016,5,BENGALURU,MADURAI,3456,3544,BENGALURU-MADURAI,7000,All
2016,6,BENGALURU,MADURAI,3321,3141,BENGALURU-MADURAI,6462,All
2016,7,BENGALURU,MADURAI,2920,2786,BENGALURU-MADURAI,5706,All
2016,8,BENGALURU,MADURAI,1634,1776,BENGALURU-MADURAI,3410,All
2016,9,BENGALURU,MADURAI,1703,1739,BENGALURU-MADURAI,3442,All
2016,10,BENGALURU,MADURAI,1571,1351,BENGALURU-MADURAI,2922,All
2016,11,BENGALURU,MADURAI,1103,1395,BENGALURU-MADURAI,2498,All
2016,12,BENGALURU,MADURAI,1660,1427,BENGALURU-MADURAI,3087,All
2017,1,BENGALURU,MADURAI,1635,1653,BENGALURU-MADURAI,3288,All
2017,2,BENGALURU,MADURAI,1512,1480,BENGALURU-MADURAI,2992,All
2017,3,BENGALURU,MADURAI,1460,1625,BENGALURU-MADURAI,3085,All
2017,4,BENGALURU,MADURAI,1657,1709,BENGALURU-MADURAI,3366,All
2017,5,BENGALURU,MADURAI,1511,1551,BENGALURU-MADURAI,3062,All
2017,6,BENGALURU,MADURAI,1226,1217,BENGALURU-MADURAI,2443,All
2017,7,BENGALURU,MADURAI,1225,1278,BENGALURU-MADURAI,2503,All
2017,8,BENGALURU,MADURAI,1405,1514,BENGALURU-MADURAI,2919,All
2017,9,BENGALURU,MADURAI,1146,1347,BENGALURU-MADURAI,2493,All
2017,10,BENGALURU,MADURAI,3031,2908,BENGALURU-MADURAI,5939,All
2017,11,BENGALURU,MADURAI,2923,3026,BENGALURU-MADURAI,5949,All
2017,12,BENGALURU,MADURAI,4034,4188,BENGALURU-MADURAI,8222,All
2018,1,BENGALURU,MADURAI,7568,7393,BENGALURU-MADURAI,14961,All
2018,2,BENGALURU,MADURAI,7146,7317,BENGALURU-MADURAI,14463,All
2018,3,BENGALURU,MADURAI,7861,8176,BENGALURU-MADURAI,16037,All
2018,4,BENGALURU,MADURAI,7840,7606,BENGALURU-MADURAI,15446,All
2018,5,BENGALURU,MADURAI,7427,7012,BENGALURU-MADURAI,14439,All
2018,6,BENGALURU,MADURAI,5213,4815,BENGALURU-MADURAI,10028,All
2018,7,BENGALURU,MADURAI,3189,3004,BENGALURU-MADURAI,6193,All
2018,8,BENGALURU,MADURAI,4145,3796,BENGALURU-MADURAI,7941,All
2018,9,BENGALURU,MADURAI,3516,3242,BENGALURU-MADURAI,6758,All
2018,10,BENGALURU,MADURAI,5831,4757,BENGALURU-MADURAI,10588,All
2018,11,BENGALURU,MADURAI,6036,6060,BENGALURU-MADURAI,12096,All
2018,12,BENGALURU,MADURAI,6991,5751,BENGALURU-MADURAI,12742,All
2019,1,BENGALURU,MADURAI,6115,6323,BENGALURU-MADURAI,12438,All
2019,2,BENGALURU,MADURAI,3802,3594,BENGALURU-MADURAI,7396,All
2019,3,BENGALURU,MADURAI,5384,5092,BENGALURU-MADURAI,10476,All
2019,4,BENGALURU,MADURAI,3455,3387,BENGALURU-MADURAI,6842,All
2019,5,BENGALURU,MADURAI,3558,3658,BENGALURU-MADURAI,7216,All
2019,6,BENGALURU,MADURAI,3224,3521,BENGALURU-MADURAI,6745,All
2019,7,BENGALURU,MADURAI,3518,3428,BENGALURU-MADURAI,6946,All
2019,8,BENGALURU,MADURAI,3680,3669,BENGALURU-MADURAI,7349,All
2019,9,BENGALURU,MADURAI,4626,4479,BENGALURU-MADURAI,9105,All
2019,10,BENGALURU,MADURAI,4574,4213,BENGALURU-MADURAI,8787,All
2019,11,BENGALURU,MADURAI,4237,5069,BENGALURU-MADURAI,9306,All
2019,12,BENGALURU,MADURAI,4581,4640,BENGALURU-MADURAI,9221,All
2020,1,BENGALURU,MADURAI,6544,6825,BENGALURU-MADURAI,13369,All
2020,2,BENGALURU,MADURAI,7738,8014,BENGALURU-MADURAI,15752,All
2020,3,BENGALURU,MADURAI,4765,4793,BENGALURU-MADURAI,9558,All
2020,5,BENGALURU,MADURAI,364,400,BENGALURU-MADURAI,764,All
2020,6,BENGALURU,MADURAI,658,619,BENGALURU-MADURAI,1277,All
2020,7,BENGALURU,MADURAI,1689,1972,BENGALURU-MADURAI,3661,All
2020,8,BENGALURU,MADURAI,3702,3212,BENGALURU-MADURAI,6914,All
2020,9,BENGALURU,MADURAI,3601,4271,BENGALURU-MADURAI,7872,All
2020,10,BENGALURU,MADURAI,5001,5283,BENGALURU-MADURAI,10284,All
2020,11,BENGALURU,MADURAI,3408,4480,BENGALURU-MADURAI,7888,All
2020,12,BENGALURU,MADURAI,2650,3625,BENGALURU-MADURAI,6275,All
2021,1,BENGALURU,MADURAI,3586,3673,BENGALURU-MADURAI,7259,All
2021,2,BENGALURU,MADURAI,2977,3816,BENGALURU-MADURAI,6793,All
2021,3,BENGALURU,MADURAI,3243,3911,BENGALURU-MADURAI,7154,All
2021,4,BENGALURU,MADURAI,3135,2679,BENGALURU-MADURAI,5814,All
2021,6,BENGALURU,MADURAI,2345,2661,BENGALURU-MADURAI,5006,All
2021,7,BENGALURU,MADURAI,2843,2562,BENGALURU-MADURAI,5405,All
2021,8,BENGALURU,MADURAI,3319,2964,BENGALURU-MADURAI,6283,All
2021,9,BENGALURU,MADURAI,2912,2908,BENGALURU-MADURAI,5820,All
2021,10,BENGALURU,MADURAI,3846,3075,BENGALURU-MADURAI,6921,All
2021,11,BENGALURU,MADURAI,5092,5651,BENGALURU-MADURAI,10743,All
2021,12,BENGALURU,MADURAI,5654,5222,BENGALURU-MADURAI,10876,All
2022,1,BENGALURU,MADURAI,2729,3159,BENGALURU-MADURAI,5888,All
2022,2,BENGALURU,MADURAI,3704,3630,BENGALURU-MADURAI,7334,All
2022,3,BENGALURU,MADURAI,6592,6892,BENGALURU-MADURAI,13484,All
2022,4,BENGALURU,MADURAI,5638,5785,BENGALURU-MADURAI,11423,All
2022,5,BENGALURU,MADURAI,5783,5956,BENGALURU-MADURAI,11739,All
2022,6,BENGALURU,MADURAI,5348,5879,BENGALURU-MADURAI,11227,All
2022,7,BENGALURU,MADURAI,5483,5700,BENGALURU-MADURAI,11183,All
2022,8,BENGALURU,MADURAI,6149,6442,BENGALURU-MADURAI,12591,All
2022,9,BENGALURU,MADURAI,5755,5924,BENGALURU-MADURAI,11679,All
2022,10,BENGALURU,MADURAI,6419,5859,BENGALURU-MADURAI,12278,All
2022,11,BENGALURU,MADURAI,5697,6020,BENGALURU-MADURAI,11717,All
2022,12,BENGALURU,MADURAI,6253,5698,BENGALURU-MADURAI,11951,All
2023,1,BENGALURU,MADURAI,5944,6058,BENGALURU-MADURAI,12002,All
2023,2,BENGALURU,MADURAI,4223,4202,BENGALURU-MADURAI,8425,All
2023,3,BENGALURU,MADURAI,6131,5380,BENGALURU-MADURAI,11511,All
2023,4,BENGALURU,MADURAI,6026,5702,BENGALURU-MADURAI,11728,All
2023,5,BENGALURU,MADURAI,6441,6195,BENGALURU-MADURAI,12636,All
2023,6,BENGALURU,MADURAI,7914,7719,BENGALURU-MADURAI,15633,All
2023,7,BENGALURU,MADURAI,8410,8514,BENGALURU-MADURAI,16924,All
2023,8,BENGALURU,MADURAI,7720,8271,BENGALURU-MADURAI,15991,All
2023,9,BENGALURU,MADURAI,6561,6803,BENGALURU-MADURAI,13364,All
2023,10,BENGALURU,MADURAI,6443,6476,BENGALURU-MADURAI,12919,All
2023,11,BENGALURU,MADURAI,6751,6774,BENGALURU-MADURAI,13525,All
2023,12,BENGALURU,MADURAI,7778,7802,BENGALURU-MADURAI,15580,All
2024,1,BENGALURU,MADURAI,7875,8563,BENGALURU-MADURAI,16438,All
2024,2,BENGALURU,MADURAI,7758,7474,BENGALURU-MADURAI,15232,All
2024,3,BENGALURU,MADURAI,7892,7637,BENGALURU-MADURAI,15529,All
2024,4,BENGALURU,MADURAI,8386,8306,BENGALURU-MADURAI,16692,All
2024,6,BENGALURU,MADURAI,10051,9891,BENGALURU-MADURAI,19942,All
2024,7,BENGALURU,MADURAI,10097,9915,BENGALURU-MADURAI,20012,All
2024,8,BENGALURU,MADURAI,9482,8822,BENGALURU-MADURAI,18304,All
2024,9,BENGALURU,MADURAI,10067,9803,BENGALURU-MADURAI,19870,All
2024,10,BENGALURU,MADURAI,9662,7653,BENGALURU-MADURAI,17315,All
2024,11,BENGALURU,MADURAI,6980,7498,BENGALURU-MADURAI,14478,All
2024,12,BENGALURU,MADURAI,8391,7507,BENGALURU-MADURAI,15898,All
2025,1,BENGALURU,MADURAI,8368,8505,BENGALURU-MADURAI,16873,All
2025,2,BENGALURU,MADURAI,5578,5667,BENGALURU-MADURAI,11245,All
2025,3,BENGALURU,MADURAI,7748,7333,BENGALURU-MADURAI,15081,All
2015,4,BENGALURU,MANGALORE,11062,11444,BENGALURU-MANGALORE,22506,All
2015,5,BENGALURU,MANGALORE,11028,12205,BENGALURU-MANGALORE,23233,All
2015,6,BENGALURU,MANGALORE,9953,11232,BENGALURU-MANGALORE,21185,All
2015,7,BENGALURU,MANGALORE,12679,12458,BENGALURU-MANGALORE,25137,All
2015,8,BENGALURU,MANGALORE,12701,13594,BENGALURU-MANGALORE,26295,All
2015,9,BENGALURU,MANGALORE,7804,8888,BENGALURU-MANGALORE,16692,All
2015,9,BENGALURU,MANGALORE,3934,4272,BENGALURU-MANGALORE,8206,All
2015,10,BENGALURU,MANGALORE,13663,14005,BENGALURU-MANGALORE,27668,All
2015,11,BENGALURU,MANGALORE,14429,14591,BENGALURU-MANGALORE,29020,All
2015,12,BENGALURU,MANGALORE,17938,16598,BENGALURU-MANGALORE,34536,All
2016,1,BENGALURU,MANGALORE,17159,18121,BENGALURU-MANGALORE,35280,All
2016,2,BENGALURU,MANGALORE,15485,16268,BENGALURU-MANGALORE,31753,All
2016,3,BENGALURU,MANGALORE,14841,15237,BENGALURU-MANGALORE,30078,All
2016,4,BENGALURU,MANGALORE,16970,14641,BENGALURU-MANGALORE,31611,All
2016,5,BENGALURU,MANGALORE,16916,16836,BENGALURU-MANGALORE,33752,All
2016,6,BENGALURU,MANGALORE,15339,13951,BENGALURU-MANGALORE,29290,All
2016,7,BENGALURU,MANGALORE,17386,15802,BENGALURU-MANGALORE,33188,All
2016,8,BENGALURU,MANGALORE,15158,14789,BENGALURU-MANGALORE,29947,All
2016,9,BENGALURU,MANGALORE,13007,13321,BENGALURU-MANGALORE,26328,All
2016,10,BENGALURU,MANGALORE,14307,13048,BENGALURU-MANGALORE,27355,All
2016,11,BENGALURU,MANGALORE,13622,12893,BENGALURU-MANGALORE,26515,All
2016,12,BENGALURU,MANGALORE,14787,13135,BENGALURU-MANGALORE,27922,All
2017,1,BENGALURU,MANGALORE,14412,14029,BENGALURU-MANGALORE,28441,All
2017,2,BENGALURU,MANGALORE,11187,10966,BENGALURU-MANGALORE,22153,All
2017,3,BENGALURU,MANGALORE,9554,9632,BENGALURU-MANGALORE,19186,All
2017,4,BENGALURU,MANGALORE,9996,9313,BENGALURU-MANGALORE,19309,All
2017,5,BENGALURU,MANGALORE,20459,22776,BENGALURU-MANGALORE,43235,All
2017,6,BENGALURU,MANGALORE,20935,21093,BENGALURU-MANGALORE,42028,All
2017,7,BENGALURU,MANGALORE,23657,21907,BENGALURU-MANGALORE,45564,All
2017,8,BENGALURU,MANGALORE,24102,23979,BENGALURU-MANGALORE,48081,All
2017,9,BENGALURU,MANGALORE,22825,23410,BENGALURU-MANGALORE,46235,All
2017,10,BENGALURU,MANGALORE,24886,25665,BENGALURU-MANGALORE,50551,All
2017,11,BENGALURU,MANGALORE,24000,24556,BENGALURU-MANGALORE,48556,All
2017,12,BENGALURU,MANGALORE,24976,23856,BENGALURU-MANGALORE,48832,All
2018,1,BENGALURU,MANGALORE,25059,25724,BENGALURU-MANGALORE,50783,All
2018,2,BENGALURU,MANGALORE,24959,24896,BENGALURU-MANGALORE,49855,All
2018,3,BENGALURU,MANGALORE,25203,25322,BENGALURU-MANGALORE,50525,All
2018,4,BENGALURU,MANGALORE,29520,28769,BENGALURU-MANGALORE,58289,All
2018,5,BENGALURU,MANGALORE,27570,28856,BENGALURU-MANGALORE,56426,All
2018,6,BENGALURU,MANGALORE,26143,26333,BENGALURU-MANGALORE,52476,All
2018,7,BENGALURU,MANGALORE,25901,25067,BENGALURU-MANGALORE,50968,All
2018,8,BENGALURU,MANGALORE,26509,25978,BENGALURU-MANGALORE,52487,All
2018,9,BENGALURU,MANGALORE,25168,25606,BENGALURU-MANGALORE,50774,All
2018,10,BENGALURU,MANGALORE,22888,23053,BENGALURU-MANGALORE,45941,All
2018,11,BENGALURU,MANGALORE,19441,19612,BENGALURU-MANGALORE,39053,All
2018,12,BENGALURU,MANGALORE,18993,19109,BENGALURU-MANGALORE,38102,All
2019,1,BENGALURU,MANGALORE,19113,19990,BENGALURU-MANGALORE,39103,All
2019,2,BENGALURU,MANGALORE,17321,17590,BENGALURU-MANGALORE,34911,All
2019,3,BENGALURU,MANGALORE,19875,19789,BENGALURU-MANGALORE,39664,All
2019,4,BENGALURU,MANGALORE,23510,22427,BENGALURU-MANGALORE,45937,All
2019,5,BENGALURU,MANGALORE,25009,26529,BENGALURU-MANGALORE,51538,All
2019,6,BENGALURU,MANGALORE,24553,25291,BENGALURU-MANGALORE,49844,All
2019,7,BENGALURU,MANGALORE,26216,25460,BENGALURU-MANGALORE,51676,All
2019,8,BENGALURU,MANGALORE,29322,30222,BENGALURU-MANGALORE,59544,All
2019,9,BENGALURU,MANGALORE,23897,24143,BENGALURU-MANGALORE,48040,All
2019,10,BENGALURU,MANGALORE,23978,24028,BENGALURU-MANGALORE,48006,All
2019,11,BENGALURU,MANGALORE,25573,27340,BENGALURU-MANGALORE,52913,All
2019,12,BENGALURU,MANGALORE,29909,28781,BENGALURU-MANGALORE,58690,All
2020,1,BENGALURU,MANGALORE,27996,28805,BENGALURU-MANGALORE,56801,All
2020,2,BENGALURU,MANGALORE,23372,23725,BENGALURU-MANGALORE,47097,All
2020,3,BENGALURU,MANGALORE,12548,16198,BENGALURU-MANGALORE,28746,All
2020,5,BENGALURU,MANGALORE,448,332,BENGALURU-MANGALORE,780,All
2020,6,BENGALURU,MANGALORE,2607,2411,BENGALURU-MANGALORE,5018,All
2020,7,BENGALURU,MANGALORE,2152,3299,BENGALURU-MANGALORE,5451,All
2020,8,BENGALURU,MANGALORE,3982,3714,BENGALURU-MANGALORE,7696,All
2020,9,BENGALURU,MANGALORE,7990,5608,BENGALURU-MANGALORE,13598,All
2020,10,BENGALURU,MANGALORE,10206,8349,BENGALURU-MANGALORE,18555,All
2020,11,BENGALURU,MANGALORE,13393,10589,BENGALURU-MANGALORE,23982,All
2020,12,BENGALURU,MANGALORE,14131,11826,BENGALURU-MANGALORE,25957,All
2021,1,BENGALURU,MANGALORE,13446,15293,BENGALURU-MANGALORE,28739,All
2021,2,BENGALURU,MANGALORE,14837,15296,BENGALURU-MANGALORE,30133,All
2021,3,BENGALURU,MANGALORE,13344,16538,BENGALURU-MANGALORE,29882,All
2021,4,BENGALURU,MANGALORE,10470,11700,BENGALURU-MANGALORE,22170,All
2021,6,BENGALURU,MANGALORE,4468,5234,BENGALURU-MANGALORE,9702,All
2021,7,BENGALURU,MANGALORE,9230,9034,BENGALURU-MANGALORE,18264,All
2021,8,BENGALURU,MANGALORE,10066,10909,BENGALURU-MANGALORE,20975,All
2021,9,BENGALURU,MANGALORE,10950,11442,BENGALURU-MANGALORE,22392,All
2021,10,BENGALURU,MANGALORE,17087,16547,BENGALURU-MANGALORE,33634,All
2021,11,BENGALURU,MANGALORE,18659,18448,BENGALURU-MANGALORE,37107,All
2021,12,BENGALURU,MANGALORE,22787,21123,BENGALURU-MANGALORE,43910,All
2022,1,BENGALURU,MANGALORE,10364,13984,BENGALURU-MANGALORE,24348,All
2022,2,BENGALURU,MANGALORE,13741,15390,BENGALURU-MANGALORE,29131,All
2022,3,BENGALURU,MANGALORE,19185,19039,BENGALURU-MANGALORE,38224,All
2022,4,BENGALURU,MANGALORE,20191,19505,BENGALURU-MANGALORE,39696,All
2022,5,BENGALURU,MANGALORE,19850,21839,BENGALURU-MANGALORE,41689,All
2022,6,BENGALURU,MANGALORE,16506,17500,BENGALURU-MANGALORE,34006,All
2022,7,BENGALURU,MANGALORE,18386,17760,BENGALURU-MANGALORE,36146,All
2022,8,BENGALURU,MANGALORE,20345,19432,BENGALURU-MANGALORE,39777,All
2022,9,BENGALURU,MANGALORE,19870,19948,BENGALURU-MANGALORE,39818,All
2022,10,BENGALURU,MANGALORE,21138,21735,BENGALURU-MANGALORE,42873,All
2022,11,BENGALURU,MANGALORE,23353,24088,BENGALURU-MANGALORE,47441,All
2022,12,BENGALURU,MANGALORE,25709,24273,BENGALURU-MANGALORE,49982,All
2023,1,BENGALURU,MANGALORE,22900,24863,BENGALURU-MANGALORE,47763,All
2023,2,BENGALURU,MANGALORE,17374,17759,BENGALURU-MANGALORE,35133,All
2023,3,BENGALURU,MANGALORE,19452,20520,BENGALURU-MANGALORE,39972,All
2023,4,BENGALURU,MANGALORE,19937,19529,BENGALURU-MANGALORE,39466,All
2023,5,BENGALURU,MANGALORE,21170,21262,BENGALURU-MANGALORE,42432,All
2023,6,BENGALURU,MANGALORE,18447,18834,BENGALURU-MANGALORE,37281,All
2023,7,BENGALURU,MANGALORE,19694,18851,BENGALURU-MANGALORE,38545,All
2023,8,BENGALURU,MANGALORE,20655,20435,BENGALURU-MANGALORE,41090,All
2023,9,BENGALURU,MANGALORE,18999,19405,BENGALURU-MANGALORE,38404,All
2023,10,BENGALURU,MANGALORE,19717,20207,BENGALURU-MANGALORE,39924,All
2023,11,BENGALURU,MANGALORE,26107,27712,BENGALURU-MANGALORE,53819,All
2023,12,BENGALURU,MANGALORE,34570,34101,BENGALURU-MANGALORE,68671,All
2024,1,BENGALURU,MANGALORE,25564,27945,BENGALURU-MANGALORE,53509,All
2024,2,BENGALURU,MANGALORE,23339,24191,BENGALURU-MANGALORE,47530,All
2024,3,BENGALURU,MANGALORE,25399,26335,BENGALURU-MANGALORE,51734,All
2024,4,BENGALURU,MANGALORE,32738,29244,BENGALURU-MANGALORE,61982,All
2024,6,BENGALURU,MANGALORE,23469,24372,BENGALURU-MANGALORE,47841,All
2024,7,BENGALURU,MANGALORE,26134,23657,BENGALURU-MANGALORE,49791,All
2024,8,BENGALURU,MANGALORE,29426,30143,BENGALURU-MANGALORE,59569,All
2024,9,BENGALURU,MANGALORE,28152,28207,BENGALURU-MANGALORE,56359,All
2024,10,BENGALURU,MANGALORE,33398,32756,BENGALURU-MANGALORE,66154,All
2024,11,BENGALURU,MANGALORE,30120,30593,BENGALURU-MANGALORE,60713,All
2024,12,BENGALURU,MANGALORE,32340,30611,BENGALURU-MANGALORE,62951,All
2025,1,BENGALURU,MANGALORE,32710,33040,BENGALURU-MANGALORE,65750,All
2025,2,BENGALURU,MANGALORE,26653,26107,BENGALURU-MANGALORE,52760,All
2025,3,BENGALURU,MANGALORE,32744,33254,BENGALURU-MANGALORE,65998,All
2015,4,BENGALURU,MUMBAI,143226,135399,BENGALURU-MUMBAI,278625,All
2015,5,BENGALURU,MUMBAI,137305,145400,BENGALURU-MUMBAI,282705,All
2015,6,BENGALURU,MUMBAI,125043,118432,BENGALURU-MUMBAI,243475,All
2015,7,BENGALURU,MUMBAI,129383,130686,BENGALURU-MUMBAI,260069,All
2015,8,BENGALURU,MUMBAI,139388,131046,BENGALURU-MUMBAI,270434,All
2015,9,BENGALURU,MUMBAI,88959,84374,BENGALURU-MUMBAI,173333,All
2015,9,BENGALURU,MUMBAI,43194,41791,BENGALURU-MUMBAI,84985,All
2015,10,BENGALURU,MUMBAI,123526,121264,BENGALURU-MUMBAI,244790,All
2015,11,BENGALURU,MUMBAI,136605,135179,BENGALURU-MUMBAI,271784,All
2015,12,BENGALURU,MUMBAI,153489,151492,BENGALURU-MUMBAI,304981,All
2016,1,BENGALURU,MUMBAI,139605,141067,BENGALURU-MUMBAI,280672,All
2016,2,BENGALURU,MUMBAI,134564,133797,BENGALURU-MUMBAI,268361,All
2016,3,BENGALURU,MUMBAI,135692,131327,BENGALURU-MUMBAI,267019,All
2016,4,BENGALURU,MUMBAI,143493,138960,BENGALURU-MUMBAI,282453,All
2016,5,BENGALURU,MUMBAI,146979,154418,BENGALURU-MUMBAI,301397,All
2016,6,BENGALURU,MUMBAI,134582,128055,BENGALURU-MUMBAI,262637,All
2016,7,BENGALURU,MUMBAI,145777,148037,BENGALURU-MUMBAI,293814,All
2016,8,BENGALURU,MUMBAI,153249,147310,BENGALURU-MUMBAI,300559,All
2016,9,BENGALURU,MUMBAI,142448,136344,BENGALURU-MUMBAI,278792,All
2016,10,BENGALURU,MUMBAI,141348,142814,BENGALURU-MUMBAI,284162,All
2016,11,BENGALURU,MUMBAI,139660,135176,BENGALURU-MUMBAI,274836,All
2016,12,BENGALURU,MUMBAI,151171,154641,BENGALURU-MUMBAI,305812,All
2017,1,BENGALURU,MUMBAI,151185,154711,BENGALURU-MUMBAI,305896,All
2017,2,BENGALURU,MUMBAI,117086,124100,BENGALURU-MUMBAI,241186,All
2017,3,BENGALURU,MUMBAI,119166,123270,BENGALURU-MUMBAI,242436,All
2017,4,BENGALURU,MUMBAI,117104,121433,BENGALURU-MUMBAI,238537,All
2017,5,BENGALURU,MUMBAI,146212,159202,BENGALURU-MUMBAI,305414,All
2017,6,BENGALURU,MUMBAI,146059,140565,BENGALURU-MUMBAI,286624,All
2017,7,BENGALURU,MUMBAI,146518,150613,BENGALURU-MUMBAI,297131,All
2017,8,BENGALURU,MUMBAI,150359,149731,BENGALURU-MUMBAI,300090,All
2017,9,BENGALURU,MUMBAI,149687,136750,BENGALURU-MUMBAI,286437,All
2017,10,BENGALURU,MUMBAI,144824,150084,BENGALURU-MUMBAI,294908,All
2017,11,BENGALURU,MUMBAI,153517,149173,BENGALURU-MUMBAI,302690,All
2017,12,BENGALURU,MUMBAI,157264,157750,BENGALURU-MUMBAI,315014,All
2018,1,BENGALURU,MUMBAI,156070,156839,BENGALURU-MUMBAI,312909,All
2018,2,BENGALURU,MUMBAI,145722,146748,BENGALURU-MUMBAI,292470,All
2018,3,BENGALURU,MUMBAI,157133,157007,BENGALURU-MUMBAI,314140,All
2018,4,BENGALURU,MUMBAI,154994,153812,BENGALURU-MUMBAI,308806,All
2018,5,BENGALURU,MUMBAI,154352,167570,BENGALURU-MUMBAI,321922,All
2018,6,BENGALURU,MUMBAI,152319,151057,BENGALURU-MUMBAI,303376,All
2018,7,BENGALURU,MUMBAI,163011,167000,BENGALURU-MUMBAI,330011,All
2018,8,BENGALURU,MUMBAI,171549,171100,BENGALURU-MUMBAI,342649,All
2018,9,BENGALURU,MUMBAI,166269,160114,BENGALURU-MUMBAI,326383,All
2018,10,BENGALURU,MUMBAI,160842,158148,BENGALURU-MUMBAI,318990,All
2018,11,BENGALURU,MUMBAI,146481,149889,BENGALURU-MUMBAI,296370,All
2018,12,BENGALURU,MUMBAI,162026,161606,BENGALURU-MUMBAI,323632,All
2019,1,BENGALURU,MUMBAI,159090,160212,BENGALURU-MUMBAI,319302,All
2019,2,BENGALURU,MUMBAI,137465,139758,BENGALURU-MUMBAI,277223,All
2019,3,BENGALURU,MUMBAI,144276,147786,BENGALURU-MUMBAI,292062,All
2019,4,BENGALURU,MUMBAI,141510,143767,BENGALURU-MUMBAI,285277,All
2019,5,BENGALURU,MUMBAI,157076,174852,BENGALURU-MUMBAI,331928,All
2019,6,BENGALURU,MUMBAI,165196,160573,BENGALURU-MUMBAI,325769,All
2019,7,BENGALURU,MUMBAI,167511,175516,BENGALURU-MUMBAI,343027,All
2019,8,BENGALURU,MUMBAI,180602,178479,BENGALURU-MUMBAI,359081,All
2019,9,BENGALURU,MUMBAI,180199,167131,BENGALURU-MUMBAI,347330,All
2019,10,BENGALURU,MUMBAI,172008,179130,BENGALURU-MUMBAI,351138,All
2019,11,BENGALURU,MUMBAI,179893,173895,BENGALURU-MUMBAI,353788,All
2019,12,BENGALURU,MUMBAI,176750,178285,BENGALURU-MUMBAI,355035,All
2020,1,BENGALURU,MUMBAI,171926,171645,BENGALURU-MUMBAI,343571,All
2020,2,BENGALURU,MUMBAI,163411,164258,BENGALURU-MUMBAI,327669,All
2020,3,BENGALURU,MUMBAI,86053,78868,BENGALURU-MUMBAI,164921,All
2020,4,BENGALURU,MUMBAI,0,0,BENGALURU-MUMBAI,0,All
2020,5,BENGALURU,MUMBAI,1069,2176,BENGALURU-MUMBAI,3245,All
2020,6,BENGALURU,MUMBAI,4188,5694,BENGALURU-MUMBAI,9882,All
2020,7,BENGALURU,MUMBAI,8895,6838,BENGALURU-MUMBAI,15733,All
2020,8,BENGALURU,MUMBAI,14743,16283,BENGALURU-MUMBAI,31026,All
2020,9,BENGALURU,MUMBAI,22900,21911,BENGALURU-MUMBAI,44811,All
2020,10,BENGALURU,MUMBAI,35080,33695,BENGALURU-MUMBAI,68775,All
2020,11,BENGALURU,MUMBAI,46873,46349,BENGALURU-MUMBAI,93222,All
2020,12,BENGALURU,MUMBAI,47005,54304,BENGALURU-MUMBAI,101309,All
2021,1,BENGALURU,MUMBAI,56768,62029,BENGALURU-MUMBAI,118797,All
2021,2,BENGALURU,MUMBAI,58872,57622,BENGALURU-MUMBAI,116494,All
2021,3,BENGALURU,MUMBAI,46313,41991,BENGALURU-MUMBAI,88304,All
2021,4,BENGALURU,MUMBAI,36166,25236,BENGALURU-MUMBAI,61402,All
2021,6,BENGALURU,MUMBAI,20984,21838,BENGALURU-MUMBAI,42822,All
2021,7,BENGALURU,MUMBAI,37605,39635,BENGALURU-MUMBAI,77240,All
2021,8,BENGALURU,MUMBAI,54889,55318,BENGALURU-MUMBAI,110207,All
2021,9,BENGALURU,MUMBAI,64998,64626,BENGALURU-MUMBAI,129624,All
2021,10,BENGALURU,MUMBAI,88946,86763,BENGALURU-MUMBAI,175709,All
2021,11,BENGALURU,MUMBAI,95898,96612,BENGALURU-MUMBAI,192510,All
2021,12,BENGALURU,MUMBAI,99060,103561,BENGALURU-MUMBAI,202621,All
2022,1,BENGALURU,MUMBAI,49217,45396,BENGALURU-MUMBAI,94613,All
2022,2,BENGALURU,MUMBAI,76242,76057,BENGALURU-MUMBAI,152299,All
2022,3,BENGALURU,MUMBAI,113340,115181,BENGALURU-MUMBAI,228521,All
2022,4,BENGALURU,MUMBAI,127362,127193,BENGALURU-MUMBAI,254555,All
2022,5,BENGALURU,MUMBAI,126806,146805,BENGALURU-MUMBAI,273611,All
2022,6,BENGALURU,MUMBAI,114881,114374,BENGALURU-MUMBAI,229255,All
2022,7,BENGALURU,MUMBAI,112750,118257,BENGALURU-MUMBAI,231007,All
2022,8,BENGALURU,MUMBAI,135172,132193,BENGALURU-MUMBAI,267365,All
2022,9,BENGALURU,MUMBAI,160687,152658,BENGALURU-MUMBAI,313345,All
2022,10,BENGALURU,MUMBAI,156864,163901,BENGALURU-MUMBAI,320765,All
2022,11,BENGALURU,MUMBAI,169506,168688,BENGALURU-MUMBAI,338194,All
2022,12,BENGALURU,MUMBAI,185988,187448,BENGALURU-MUMBAI,373436,All
2023,1,BENGALURU,MUMBAI,192637,192693,BENGALURU-MUMBAI,385330,All
2023,2,BENGALURU,MUMBAI,168265,168184,BENGALURU-MUMBAI,336449,All
2023,3,BENGALURU,MUMBAI,169387,169085,BENGALURU-MUMBAI,338472,All
2023,4,BENGALURU,MUMBAI,186349,176152,BENGALURU-MUMBAI,362501,All
2023,5,BENGALURU,MUMBAI,186541,200784,BENGALURU-MUMBAI,387325,All
2023,6,BENGALURU,MUMBAI,178377,179795,BENGALURU-MUMBAI,358172,All
2023,7,BENGALURU,MUMBAI,177695,184417,BENGALURU-MUMBAI,362112,All
2023,8,BENGALURU,MUMBAI,195430,188182,BENGALURU-MUMBAI,383612,All
2023,9,BENGALURU,MUMBAI,186922,183940,BENGALURU-MUMBAI,370862,All
2023,10,BENGALURU,MUMBAI,184411,178894,BENGALURU-MUMBAI,363305,All
2023,11,BENGALURU,MUMBAI,175795,186642,BENGALURU-MUMBAI,362437,All
2023,12,BENGALURU,MUMBAI,190394,199287,BENGALURU-MUMBAI,389681,All
2024,1,BENGALURU,MUMBAI,185646,193499,BENGALURU-MUMBAI,379145,All
2024,2,BENGALURU,MUMBAI,185132,182819,BENGALURU-MUMBAI,367951,All
2024,3,BENGALURU,MUMBAI,174332,172311,BENGALURU-MUMBAI,346643,All
2024,4,BENGALURU,MUMBAI,176021,178804,BENGALURU-MUMBAI,354825,All
2024,6,BENGALURU,MUMBAI,161808,168200,BENGALURU-MUMBAI,330008,All
2024,7,BENGALURU,MUMBAI,165896,175751,BENGALURU-MUMBAI,341647,All
2024,8,BENGALURU,MUMBAI,181664,176390,BENGALURU-MUMBAI,358054,All
2024,9,BENGALURU,MUMBAI,176527,171363,BENGALURU-MUMBAI,347890,All
2024,10,BENGALURU,MUMBAI,173522,170143,BENGALURU-MUMBAI,343665,All
2024,11,BENGALURU,MUMBAI,169509,179437,BENGALURU-MUMBAI,348946,All
2024,12,BENGALURU,MUMBAI,171109,177501,BENGALURU-MUMBAI,348610,All
2025,1,BENGALURU,MUMBAI,171397,176799,BENGALURU-MUMBAI,348196,All
2025,2,BENGALURU,MUMBAI,145266,146794,BENGALURU-MUMBAI,292060,All
2025,3,BENGALURU,MUMBAI,160854,161483,BENGALURU-MUMBAI,322337,All
2015,9,BENGALURU,MYSORE,108,263,BENGALURU-MYSORE,371,All
2015,10,BENGALURU,MYSORE,189,352,BENGALURU-MYSORE,541,All
2015,11,BENGALURU,MYSORE,60,155,BENGALURU-MYSORE,215,All
2018,10,BENGALURU,MYSORE,347,388,BENGALURU-MYSORE,735,All
2019,6,BENGALURU,MYSORE,605,581,BENGALURU-MYSORE,1186,All
2019,7,BENGALURU,MYSORE,845,835,BENGALURU-MYSORE,1680,All
2019,8,BENGALURU,MYSORE,937,1037,BENGALURU-MYSORE,1974,All
2019,9,BENGALURU,MYSORE,982,1015,BENGALURU-MYSORE,1997,All
2019,10,BENGALURU,MYSORE,1275,1160,BENGALURU-MYSORE,2435,All
2019,11,BENGALURU,MYSORE,944,1049,BENGALURU-MYSORE,1993,All
2019,12,BENGALURU,MYSORE,1272,678,BENGALURU-MYSORE,1950,All
2020,1,BENGALURU,MYSORE,1067,888,BENGALURU-MYSORE,1955,All
2020,2,BENGALURU,MYSORE,841,790,BENGALURU-MYSORE,1631,All
2020,3,BENGALURU,MYSORE,479,444,BENGALURU-MYSORE,923,All
2020,5,BENGALURU,MYSORE,89,27,BENGALURU-MYSORE,116,All
2020,6,BENGALURU,MYSORE,280,139,BENGALURU-MYSORE,419,All
2020,7,BENGALURU,MYSORE,261,242,BENGALURU-MYSORE,503,All
2020,8,BENGALURU,MYSORE,336,216,BENGALURU-MYSORE,552,All
2020,9,BENGALURU,MYSORE,423,179,BENGALURU-MYSORE,602,All
2020,10,BENGALURU,MYSORE,383,194,BENGALURU-MYSORE,577,All
2020,11,BENGALURU,MYSORE,482,221,BENGALURU-MYSORE,703,All
2020,12,BENGALURU,MYSORE,304,400,BENGALURU-MYSORE,704,All
2021,1,BENGALURU,MYSORE,161,544,BENGALURU-MYSORE,705,All
2021,2,BENGALURU,MYSORE,251,491,BENGALURU-MYSORE,742,All
2021,3,BENGALURU,MYSORE,187,429,BENGALURU-MYSORE,616,All
2021,4,BENGALURU,MYSORE,132,366,BENGALURU-MYSORE,498,All
2021,6,BENGALURU,MYSORE,98,227,BENGALURU-MYSORE,325,All
2021,7,BENGALURU,MYSORE,174,339,BENGALURU-MYSORE,513,All
2021,8,BENGALURU,MYSORE,267,505,BENGALURU-MYSORE,772,All
2021,9,BENGALURU,MYSORE,345,634,BENGALURU-MYSORE,979,All
2021,10,BENGALURU,MYSORE,536,714,BENGALURU-MYSORE,1250,All
2021,11,BENGALURU,MYSORE,359,747,BENGALURU-MYSORE,1106,All
2021,12,BENGALURU,MYSORE,392,777,BENGALURU-MYSORE,1169,All
2022,1,BENGALURU,MYSORE,270,538,BENGALURU-MYSORE,808,All
2022,2,BENGALURU,MYSORE,320,696,BENGALURU-MYSORE,1016,All
2022,3,BENGALURU,MYSORE,562,898,BENGALURU-MYSORE,1460,All
2022,4,BENGALURU,MYSORE,359,747,BENGALURU-MYSORE,1106,All
2022,5,BENGALURU,MYSORE,392,777,BENGALURU-MYSORE,1169,All
2022,6,BENGALURU,MYSORE,421,747,BENGALURU-MYSORE,1168,All
2022,7,BENGALURU,MYSORE,320,696,BENGALURU-MYSORE,1016,All
2022,8,BENGALURU,MYSORE,392,777,BENGALURU-MYSORE,1169,All
2022,9,BENGALURU,MYSORE,359,747,BENGALURU-MYSORE,1106,All
2022,10,BENGALURU,MYSORE,640,938,BENGALURU-MYSORE,1578,All
2022,12,BENGALURU,MYSORE,0,31,BENGALURU-MYSORE,31,All
2024,3,BENGALURU,Malvan,86,61,BENGALURU-Malvan,147,All
2024,4,BENGALURU,Malvan,147,145,BENGALURU-Malvan,292,All
2024,6,BENGALURU,Malvan,180,133,BENGALURU-Malvan,313,All
2024,7,BENGALURU,Malvan,43,35,BENGALURU-Malvan,78,All
2024,8,BENGALURU,Malvan,137,93,BENGALURU-Malvan,230,All
2024,9,BENGALURU,Malvan,193,136,BENGALURU-Malvan,329,All
2024,10,BENGALURU,Malvan,199,128,BENGALURU-Malvan,327,All
2024,11,BENGALURU,Malvan,26,37,BENGALURU-Malvan,63,All
2015,4,BENGALURU,NAGPUR,3655,3474,BENGALURU-NAGPUR,7129,All
2015,5,BENGALURU,NAGPUR,4233,3828,BENGALURU-NAGPUR,8061,All
2015,6,BENGALURU,NAGPUR,4226,3739,BENGALURU-NAGPUR,7965,All
2015,7,BENGALURU,NAGPUR,3975,3621,BENGALURU-NAGPUR,7596,All
2015,8,BENGALURU,NAGPUR,3588,3382,BENGALURU-NAGPUR,6970,All
2015,9,BENGALURU,NAGPUR,3412,3316,BENGALURU-NAGPUR,6728,All
2015,10,BENGALURU,NAGPUR,3735,3455,BENGALURU-NAGPUR,7190,All
2015,11,BENGALURU,NAGPUR,4214,3749,BENGALURU-NAGPUR,7963,All
2015,12,BENGALURU,NAGPUR,4450,3964,BENGALURU-NAGPUR,8414,All
2016,1,BENGALURU,NAGPUR,4308,4023,BENGALURU-NAGPUR,8331,All
2016,2,BENGALURU,NAGPUR,4038,3601,BENGALURU-NAGPUR,7639,All
2016,3,BENGALURU,NAGPUR,3993,3834,BENGALURU-NAGPUR,7827,All
2016,4,BENGALURU,NAGPUR,4163,3970,BENGALURU-NAGPUR,8133,All
2016,5,BENGALURU,NAGPUR,4299,4581,BENGALURU-NAGPUR,8880,All
2016,6,BENGALURU,NAGPUR,5029,4980,BENGALURU-NAGPUR,10009,All
2016,7,BENGALURU,NAGPUR,4588,4728,BENGALURU-NAGPUR,9316,All
2016,8,BENGALURU,NAGPUR,4586,4732,BENGALURU-NAGPUR,9318,All
2016,9,BENGALURU,NAGPUR,3793,3901,BENGALURU-NAGPUR,7694,All
2016,10,BENGALURU,NAGPUR,6645,5968,BENGALURU-NAGPUR,12613,All
2016,11,BENGALURU,NAGPUR,7246,8662,BENGALURU-NAGPUR,15908,All
2016,12,BENGALURU,NAGPUR,8135,8678,BENGALURU-NAGPUR,16813,All
2017,1,BENGALURU,NAGPUR,7669,8291,BENGALURU-NAGPUR,15960,All
2017,2,BENGALURU,NAGPUR,5672,5949,BENGALURU-NAGPUR,11621,All
2017,3,BENGALURU,NAGPUR,4194,4474,BENGALURU-NAGPUR,8668,All
2017,4,BENGALURU,NAGPUR,3955,4229,BENGALURU-NAGPUR,8184,All
2017,5,BENGALURU,NAGPUR,7897,8784,BENGALURU-NAGPUR,16681,All
2017,6,BENGALURU,NAGPUR,7623,7951,BENGALURU-NAGPUR,15574,All
2017,7,BENGALURU,NAGPUR,6945,7738,BENGALURU-NAGPUR,14683,All
2017,8,BENGALURU,NAGPUR,8986,9238,BENGALURU-NAGPUR,18224,All
2017,9,BENGALURU,NAGPUR,7649,7635,BENGALURU-NAGPUR,15284,All
2017,10,BENGALURU,NAGPUR,8065,8635,BENGALURU-NAGPUR,16700,All
2017,11,BENGALURU,NAGPUR,8519,9006,BENGALURU-NAGPUR,17525,All
2017,12,BENGALURU,NAGPUR,12496,12569,BENGALURU-NAGPUR,25065,All
2018,1,BENGALURU,NAGPUR,12081,12608,BENGALURU-NAGPUR,24689,All
2018,2,BENGALURU,NAGPUR,12026,12331,BENGALURU-NAGPUR,24357,All
2018,3,BENGALURU,NAGPUR,14900,13881,BENGALURU-NAGPUR,28781,All
2018,4,BENGALURU,NAGPUR,18498,17017,BENGALURU-NAGPUR,35515,All
2018,5,BENGALURU,NAGPUR,16673,19626,BENGALURU-NAGPUR,36299,All
2018,6,BENGALURU,NAGPUR,24299,18881,BENGALURU-NAGPUR,43180,All
2018,7,BENGALURU,NAGPUR,23493,18769,BENGALURU-NAGPUR,42262,All
2018,8,BENGALURU,NAGPUR,20978,18096,BENGALURU-NAGPUR,39074,All
2018,9,BENGALURU,NAGPUR,19624,18374,BENGALURU-NAGPUR,37998,All
2018,10,BENGALURU,NAGPUR,23786,18315,BENGALURU-NAGPUR,42101,All
2018,11,BENGALURU,NAGPUR,23534,24357,BENGALURU-NAGPUR,47891,All
2018,12,BENGALURU,NAGPUR,26288,23630,BENGALURU-NAGPUR,49918,All
2019,1,BENGALURU,NAGPUR,21309,20480,BENGALURU-NAGPUR,41789,All
2019,2,BENGALURU,NAGPUR,17533,16225,BENGALURU-NAGPUR,33758,All
2019,3,BENGALURU,NAGPUR,21024,19855,BENGALURU-NAGPUR,40879,All
2019,4,BENGALURU,NAGPUR,20689,20174,BENGALURU-NAGPUR,40863,All
2019,5,BENGALURU,NAGPUR,21138,25338,BENGALURU-NAGPUR,46476,All
2019,6,BENGALURU,NAGPUR,21112,21201,BENGALURU-NAGPUR,42313,All
2019,7,BENGALURU,NAGPUR,17162,18057,BENGALURU-NAGPUR,35219,All
2019,8,BENGALURU,NAGPUR,17898,17332,BENGALURU-NAGPUR,35230,All
2019,9,BENGALURU,NAGPUR,16129,17011,BENGALURU-NAGPUR,33140,All
2019,10,BENGALURU,NAGPUR,20595,17785,BENGALURU-NAGPUR,38380,All
2019,11,BENGALURU,NAGPUR,17841,18588,BENGALURU-NAGPUR,36429,All
2019,12,BENGALURU,NAGPUR,19133,19719,BENGALURU-NAGPUR,38852,All
2020,1,BENGALURU,NAGPUR,18418,18393,BENGALURU-NAGPUR,36811,All
2020,2,BENGALURU,NAGPUR,15983,16550,BENGALURU-NAGPUR,32533,All
2020,3,BENGALURU,NAGPUR,10784,8513,BENGALURU-NAGPUR,19297,All
2020,5,BENGALURU,NAGPUR,524,182,BENGALURU-NAGPUR,706,All
2020,8,BENGALURU,NAGPUR,1526,1479,BENGALURU-NAGPUR,3005,All
2020,9,BENGALURU,NAGPUR,2736,3172,BENGALURU-NAGPUR,5908,All
2020,10,BENGALURU,NAGPUR,4769,4334,BENGALURU-NAGPUR,9103,All
2020,11,BENGALURU,NAGPUR,7829,7413,BENGALURU-NAGPUR,15242,All
2020,12,BENGALURU,NAGPUR,10951,8816,BENGALURU-NAGPUR,19767,All
2021,1,BENGALURU,NAGPUR,7107,7591,BENGALURU-NAGPUR,14698,All
2021,2,BENGALURU,NAGPUR,6592,6480,BENGALURU-NAGPUR,13072,All
2021,3,BENGALURU,NAGPUR,4792,4244,BENGALURU-NAGPUR,9036,All
2021,4,BENGALURU,NAGPUR,3564,2466,BENGALURU-NAGPUR,6030,All
2021,6,BENGALURU,NAGPUR,2032,2160,BENGALURU-NAGPUR,4192,All
2021,7,BENGALURU,NAGPUR,3958,4735,BENGALURU-NAGPUR,8693,All
2021,8,BENGALURU,NAGPUR,4589,4872,BENGALURU-NAGPUR,9461,All
2021,9,BENGALURU,NAGPUR,4937,5155,BENGALURU-NAGPUR,10092,All
2021,10,BENGALURU,NAGPUR,7440,6515,BENGALURU-NAGPUR,13955,All
2021,11,BENGALURU,NAGPUR,10034,10761,BENGALURU-NAGPUR,20795,All
2021,12,BENGALURU,NAGPUR,11134,11510,BENGALURU-NAGPUR,22644,All
2022,1,BENGALURU,NAGPUR,6279,5358,BENGALURU-NAGPUR,11637,All
2022,2,BENGALURU,NAGPUR,6023,5746,BENGALURU-NAGPUR,11769,All
2022,3,BENGALURU,NAGPUR,10362,10464,BENGALURU-NAGPUR,20826,All
2022,4,BENGALURU,NAGPUR,10385,11110,BENGALURU-NAGPUR,21495,All
2022,5,BENGALURU,NAGPUR,10699,13495,BENGALURU-NAGPUR,24194,All
2022,6,BENGALURU,NAGPUR,11856,12431,BENGALURU-NAGPUR,24287,All
2022,7,BENGALURU,NAGPUR,9832,10898,BENGALURU-NAGPUR,20730,All
2022,8,BENGALURU,NAGPUR,12234,12169,BENGALURU-NAGPUR,24403,All
2022,9,BENGALURU,NAGPUR,9087,8800,BENGALURU-NAGPUR,17887,All
2022,10,BENGALURU,NAGPUR,15387,14030,BENGALURU-NAGPUR,29417,All
2022,11,BENGALURU,NAGPUR,13474,14574,BENGALURU-NAGPUR,28048,All
2022,12,BENGALURU,NAGPUR,14090,14670,BENGALURU-NAGPUR,28760,All
2023,1,BENGALURU,NAGPUR,15327,16910,BENGALURU-NAGPUR,32237,All
2023,2,BENGALURU,NAGPUR,15705,16191,BENGALURU-NAGPUR,31896,All
2023,3,BENGALURU,NAGPUR,14899,16189,BENGALURU-NAGPUR,31088,All
2023,4,BENGALURU,NAGPUR,15648,15088,BENGALURU-NAGPUR,30736,All
2023,5,BENGALURU,NAGPUR,17034,18835,BENGALURU-NAGPUR,35869,All
2023,6,BENGALURU,NAGPUR,17701,18194,BENGALURU-NAGPUR,35895,All
2023,7,BENGALURU,NAGPUR,13962,16263,BENGALURU-NAGPUR,30225,All
2023,8,BENGALURU,NAGPUR,13021,13702,BENGALURU-NAGPUR,26723,All
2023,9,BENGALURU,NAGPUR,13517,15319,BENGALURU-NAGPUR,28836,All
2023,10,BENGALURU,NAGPUR,15768,14376,BENGALURU-NAGPUR,30144,All
2023,11,BENGALURU,NAGPUR,16440,15336,BENGALURU-NAGPUR,31776,All
2023,12,BENGALURU,NAGPUR,17675,18577,BENGALURU-NAGPUR,36252,All
2024,1,BENGALURU,NAGPUR,12053,12137,BENGALURU-NAGPUR,24190,All
2024,2,BENGALURU,NAGPUR,9125,9114,BENGALURU-NAGPUR,18239,All
2024,3,BENGALURU,NAGPUR,13542,13615,BENGALURU-NAGPUR,27157,All
2024,4,BENGALURU,NAGPUR,12080,11957,BENGALURU-NAGPUR,24037,All
2024,6,BENGALURU,NAGPUR,13738,14126,BENGALURU-NAGPUR,27864,All
2024,7,BENGALURU,NAGPUR,13926,14907,BENGALURU-NAGPUR,28833,All
2024,8,BENGALURU,NAGPUR,14959,15149,BENGALURU-NAGPUR,30108,All
2024,9,BENGALURU,NAGPUR,13736,14261,BENGALURU-NAGPUR,27997,All
2024,10,BENGALURU,NAGPUR,19695,12618,BENGALURU-NAGPUR,32313,All
2024,11,BENGALURU,NAGPUR,16392,19256,BENGALURU-NAGPUR,35648,All
2024,12,BENGALURU,NAGPUR,21625,21095,BENGALURU-NAGPUR,42720,All
2025,1,BENGALURU,NAGPUR,21600,22337,BENGALURU-NAGPUR,43937,All
2025,2,BENGALURU,NAGPUR,20230,19708,BENGALURU-NAGPUR,39938,All
2025,3,BENGALURU,NAGPUR,17450,17317,BENGALURU-NAGPUR,34767,All
2024,3,BENGALURU,NANDED,62,69,BENGALURU-NANDED,131,All
2024,4,BENGALURU,NANDED,1115,1134,BENGALURU-NANDED,2249,All
2024,6,BENGALURU,NANDED,1340,1237,BENGALURU-NANDED,2577,All
2024,7,BENGALURU,NANDED,1098,1218,BENGALURU-NANDED,2316,All
2024,8,BENGALURU,NANDED,1110,1195,BENGALURU-NANDED,2305,All
2024,9,BENGALURU,NANDED,1106,1164,BENGALURU-NANDED,2270,All
2024,10,BENGALURU,NANDED,1498,1254,BENGALURU-NANDED,2752,All
2024,11,BENGALURU,NANDED,1121,1606,BENGALURU-NANDED,2727,All
2024,12,BENGALURU,NANDED,1976,1488,BENGALURU-NANDED,3464,All
2025,1,BENGALURU,NANDED,1448,1646,BENGALURU-NANDED,3094,All
2025,2,BENGALURU,NANDED,1712,1642,BENGALURU-NANDED,3354,All
2025,3,BENGALURU,NANDED,1732,1651,BENGALURU-NANDED,3383,All
2020,11,BENGALURU,NASIK,477,506,BENGALURU-NASIK,983,All
2020,12,BENGALURU,NASIK,1650,1518,BENGALURU-NASIK,3168,All
2021,1,BENGALURU,NASIK,1580,1576,BENGALURU-NASIK,3156,All
2021,2,BENGALURU,NASIK,1472,1350,BENGALURU-NASIK,2822,All
2021,3,BENGALURU,NASIK,800,772,BENGALURU-NASIK,1572,All
2021,4,BENGALURU,NASIK,169,158,BENGALURU-NASIK,327,All
2021,11,BENGALURU,NASIK,69,0,BENGALURU-NASIK,69,All
2022,10,BENGALURU,NASIK,153,40,BENGALURU-NASIK,193,All
2022,11,BENGALURU,NASIK,78,78,BENGALURU-NASIK,156,All
2022,12,BENGALURU,NASIK,143,104,BENGALURU-NASIK,247,All
2023,1,BENGALURU,NASIK,151,153,BENGALURU-NASIK,304,All
2023,4,BENGALURU,NASIK,77,77,BENGALURU-NASIK,154,All
2023,5,BENGALURU,NASIK,78,78,BENGALURU-NASIK,156,All
2024,9,BENGALURU,NASIK,3763,4073,BENGALURU-NASIK,7836,All
2024,10,BENGALURU,NASIK,6100,5709,BENGALURU-NASIK,11809,All
2024,11,BENGALURU,NASIK,4760,4998,BENGALURU-NASIK,9758,All
2024,12,BENGALURU,NASIK,5128,5126,BENGALURU-NASIK,10254,All
2025,1,BENGALURU,NASIK,4825,5046,BENGALURU-NASIK,9871,All
2025,2,BENGALURU,NASIK,4218,4231,BENGALURU-NASIK,8449,All
2025,3,BENGALURU,NASIK,4722,4995,BENGALURU-NASIK,9717,All
2015,4,BENGALURU,PATNA,3253,3054,BENGALURU-PATNA,6307,All
2015,5,BENGALURU,PATNA,3327,4059,BENGALURU-PATNA,7386,All
2015,6,BENGALURU,PATNA,2611,3440,BENGALURU-PATNA,6051,All
2015,7,BENGALURU,PATNA,2326,2987,BENGALURU-PATNA,5313,All
2015,8,BENGALURU,PATNA,1930,2666,BENGALURU-PATNA,4596,All
2015,9,BENGALURU,PATNA,2118,2142,BENGALURU-PATNA,4260,All
2015,10,BENGALURU,PATNA,1425,1557,BENGALURU-PATNA,2982,All
2015,11,BENGALURU,PATNA,2702,2321,BENGALURU-PATNA,5023,All
2015,12,BENGALURU,PATNA,0,2980,BENGALURU-PATNA,2980,All
2016,1,BENGALURU,PATNA,0,2318,BENGALURU-PATNA,2318,All
2016,2,BENGALURU,PATNA,2242,3077,BENGALURU-PATNA,5319,All
2016,3,BENGALURU,PATNA,4624,3070,BENGALURU-PATNA,7694,All
2016,4,BENGALURU,PATNA,8246,3154,BENGALURU-PATNA,11400,All
2016,5,BENGALURU,PATNA,7611,3418,BENGALURU-PATNA,11029,All
2016,6,BENGALURU,PATNA,7792,2779,BENGALURU-PATNA,10571,All
2016,7,BENGALURU,PATNA,7416,2261,BENGALURU-PATNA,9677,All
2016,8,BENGALURU,PATNA,6771,1688,BENGALURU-PATNA,8459,All
2016,9,BENGALURU,PATNA,7594,1241,BENGALURU-PATNA,8835,All
2016,10,BENGALURU,PATNA,9592,1939,BENGALURU-PATNA,11531,All
2016,11,BENGALURU,PATNA,12363,7842,BENGALURU-PATNA,20205,All
2016,12,BENGALURU,PATNA,13753,9634,BENGALURU-PATNA,23387,All
2017,1,BENGALURU,PATNA,13442,9375,BENGALURU-PATNA,22817,All
2017,2,BENGALURU,PATNA,11722,8032,BENGALURU-PATNA,19754,All
2017,3,BENGALURU,PATNA,11292,7044,BENGALURU-PATNA,18336,All
2017,4,BENGALURU,PATNA,12212,7478,BENGALURU-PATNA,19690,All
2017,5,BENGALURU,PATNA,16058,9273,BENGALURU-PATNA,25331,All
2017,6,BENGALURU,PATNA,14887,8370,BENGALURU-PATNA,23257,All
2017,7,BENGALURU,PATNA,17073,12256,BENGALURU-PATNA,29329,All
2017,8,BENGALURU,PATNA,17332,11308,BENGALURU-PATNA,28640,All
2017,9,BENGALURU,PATNA,18618,10486,BENGALURU-PATNA,29104,All
2017,10,BENGALURU,PATNA,22380,13353,BENGALURU-PATNA,35733,All
2017,11,BENGALURU,PATNA,19356,13199,BENGALURU-PATNA,32555,All
2017,12,BENGALURU,PATNA,18083,16563,BENGALURU-PATNA,34646,All
2018,1,BENGALURU,PATNA,19019,16089,BENGALURU-PATNA,35108,All
2018,2,BENGALURU,PATNA,18892,12530,BENGALURU-PATNA,31422,All
2018,3,BENGALURU,PATNA,20251,14513,BENGALURU-PATNA,34764,All
2018,4,BENGALURU,PATNA,25156,15755,BENGALURU-PATNA,40911,All
2018,5,BENGALURU,PATNA,20049,17846,BENGALURU-PATNA,37895,All
2018,6,BENGALURU,PATNA,32114,28443,BENGALURU-PATNA,60557,All
2018,7,BENGALURU,PATNA,26610,28261,BENGALURU-PATNA,54871,All
2018,8,BENGALURU,PATNA,27849,24238,BENGALURU-PATNA,52087,All
2018,9,BENGALURU,PATNA,24052,20842,BENGALURU-PATNA,44894,All
2018,10,BENGALURU,PATNA,30824,22130,BENGALURU-PATNA,52954,All
2018,11,BENGALURU,PATNA,28457,25922,BENGALURU-PATNA,54379,All
2018,12,BENGALURU,PATNA,20472,18359,BENGALURU-PATNA,38831,All
2019,1,BENGALURU,PATNA,20129,16899,BENGALURU-PATNA,37028,All
2019,2,BENGALURU,PATNA,20563,17124,BENGALURU-PATNA,37687,All
2019,3,BENGALURU,PATNA,27790,22707,BENGALURU-PATNA,50497,All
2019,4,BENGALURU,PATNA,21992,17384,BENGALURU-PATNA,39376,All
2019,5,BENGALURU,PATNA,24167,21334,BENGALURU-PATNA,45501,All
2019,6,BENGALURU,PATNA,24757,22416,BENGALURU-PATNA,47173,All
2019,7,BENGALURU,PATNA,23070,21262,BENGALURU-PATNA,44332,All
2019,8,BENGALURU,PATNA,23966,20856,BENGALURU-PATNA,44822,All
2019,9,BENGALURU,PATNA,22829,17156,BENGALURU-PATNA,39985,All
2019,10,BENGALURU,PATNA,24274,16708,BENGALURU-PATNA,40982,All
2019,11,BENGALURU,PATNA,24902,25159,BENGALURU-PATNA,50061,All
2019,12,BENGALURU,PATNA,21567,20644,BENGALURU-PATNA,42211,All
2020,1,BENGALURU,PATNA,21821,20426,BENGALURU-PATNA,42247,All
2020,2,BENGALURU,PATNA,26925,22561,BENGALURU-PATNA,49486,All
2020,3,BENGALURU,PATNA,23249,16661,BENGALURU-PATNA,39910,All
2020,5,BENGALURU,PATNA,2263,1108,BENGALURU-PATNA,3371,All
2020,6,BENGALURU,PATNA,16980,7790,BENGALURU-PATNA,24770,All
2020,7,BENGALURU,PATNA,19250,8071,BENGALURU-PATNA,27321,All
2020,8,BENGALURU,PATNA,13084,21005,BENGALURU-PATNA,34089,All
2020,9,BENGALURU,PATNA,15435,25049,BENGALURU-PATNA,40484,All
2020,10,BENGALURU,PATNA,25662,27137,BENGALURU-PATNA,52799,All
2020,11,BENGALURU,PATNA,31838,22208,BENGALURU-PATNA,54046,All
2020,12,BENGALURU,PATNA,19388,24504,BENGALURU-PATNA,43892,All
2021,1,BENGALURU,PATNA,15211,27061,BENGALURU-PATNA,42272,All
2021,2,BENGALURU,PATNA,20202,24146,BENGALURU-PATNA,44348,All
2021,3,BENGALURU,PATNA,25123,18449,BENGALURU-PATNA,43572,All
2021,4,BENGALURU,PATNA,29057,14505,BENGALURU-PATNA,43562,All
2021,6,BENGALURU,PATNA,7760,14773,BENGALURU-PATNA,22533,All
2021,7,BENGALURU,PATNA,10002,18294,BENGALURU-PATNA,28296,All
2021,8,BENGALURU,PATNA,12366,17667,BENGALURU-PATNA,30033,All
2021,9,BENGALURU,PATNA,11332,14357,BENGALURU-PATNA,25689,All
2021,10,BENGALURU,PATNA,24332,15606,BENGALURU-PATNA,39938,All
2021,11,BENGALURU,PATNA,28943,29126,BENGALURU-PATNA,58069,All
2021,12,BENGALURU,PATNA,17815,27505,BENGALURU-PATNA,45320,All
2022,1,BENGALURU,PATNA,16931,13552,BENGALURU-PATNA,30483,All
2022,2,BENGALURU,PATNA,17465,18290,BENGALURU-PATNA,35755,All
2022,3,BENGALURU,PATNA,22473,21697,BENGALURU-PATNA,44170,All
2022,4,BENGALURU,PATNA,26652,22953,BENGALURU-PATNA,49605,All
2022,5,BENGALURU,PATNA,25259,30907,BENGALURU-PATNA,56166,All
2022,6,BENGALURU,PATNA,19838,24429,BENGALURU-PATNA,44267,All
2022,7,BENGALURU,PATNA,17037,19653,BENGALURU-PATNA,36690,All
2022,8,BENGALURU,PATNA,16800,18383,BENGALURU-PATNA,35183,All
2022,9,BENGALURU,PATNA,16623,15331,BENGALURU-PATNA,31954,All
2022,10,BENGALURU,PATNA,27465,17603,BENGALURU-PATNA,45068,All
2022,11,BENGALURU,PATNA,18545,21174,BENGALURU-PATNA,39719,All
2022,12,BENGALURU,PATNA,20708,21575,BENGALURU-PATNA,42283,All
2023,1,BENGALURU,PATNA,21034,21354,BENGALURU-PATNA,42388,All
2023,2,BENGALURU,PATNA,19130,18845,BENGALURU-PATNA,37975,All
2023,3,BENGALURU,PATNA,22689,22904,BENGALURU-PATNA,45593,All
2023,4,BENGALURU,PATNA,17774,16529,BENGALURU-PATNA,34303,All
2023,5,BENGALURU,PATNA,15083,15056,BENGALURU-PATNA,30139,All
2023,6,BENGALURU,PATNA,16162,16075,BENGALURU-PATNA,32237,All
2023,7,BENGALURU,PATNA,13917,15823,BENGALURU-PATNA,29740,All
2023,8,BENGALURU,PATNA,15217,15641,BENGALURU-PATNA,30858,All
2023,9,BENGALURU,PATNA,14240,14397,BENGALURU-PATNA,28637,All
2023,10,BENGALURU,PATNA,21984,17292,BENGALURU-PATNA,39276,All
2023,11,BENGALURU,PATNA,22022,20402,BENGALURU-PATNA,42424,All
2023,12,BENGALURU,PATNA,22641,23966,BENGALURU-PATNA,46607,All
2024,1,BENGALURU,PATNA,20101,20511,BENGALURU-PATNA,40612,All
2024,2,BENGALURU,PATNA,17128,16274,BENGALURU-PATNA,33402,All
2024,3,BENGALURU,PATNA,26563,23285,BENGALURU-PATNA,49848,All
2024,4,BENGALURU,PATNA,25902,23624,BENGALURU-PATNA,49526,All
2024,6,BENGALURU,PATNA,20756,20021,BENGALURU-PATNA,40777,All
2024,7,BENGALURU,PATNA,17775,18022,BENGALURU-PATNA,35797,All
2024,8,BENGALURU,PATNA,20289,20584,BENGALURU-PATNA,40873,All
2024,9,BENGALURU,PATNA,20285,18671,BENGALURU-PATNA,38956,All
2024,10,BENGALURU,PATNA,25871,16046,BENGALURU-PATNA,41917,All
2024,11,BENGALURU,PATNA,28336,28719,BENGALURU-PATNA,57055,All
2024,12,BENGALURU,PATNA,22481,22957,BENGALURU-PATNA,45438,All
2025,1,BENGALURU,PATNA,22859,23248,BENGALURU-PATNA,46107,All
2025,2,BENGALURU,PATNA,25588,24459,BENGALURU-PATNA,50047,All
2025,3,BENGALURU,PATNA,34783,32047,BENGALURU-PATNA,66830,All
2019,1,BENGALURU,PONDICHERRY,1761,1632,BENGALURU-PONDICHERRY,3393,All
2019,2,BENGALURU,PONDICHERRY,952,867,BENGALURU-PONDICHERRY,1819,All
2019,3,BENGALURU,PONDICHERRY,1659,1565,BENGALURU-PONDICHERRY,3224,All
2019,4,BENGALURU,PONDICHERRY,1294,1236,BENGALURU-PONDICHERRY,2530,All
2019,5,BENGALURU,PONDICHERRY,1303,1237,BENGALURU-PONDICHERRY,2540,All
2019,6,BENGALURU,PONDICHERRY,1238,1170,BENGALURU-PONDICHERRY,2408,All
2019,7,BENGALURU,PONDICHERRY,1394,1335,BENGALURU-PONDICHERRY,2729,All
2019,8,BENGALURU,PONDICHERRY,1609,1479,BENGALURU-PONDICHERRY,3088,All
2019,9,BENGALURU,PONDICHERRY,1521,1406,BENGALURU-PONDICHERRY,2927,All
2019,10,BENGALURU,PONDICHERRY,1374,1312,BENGALURU-PONDICHERRY,2686,All
2019,11,BENGALURU,PONDICHERRY,1139,1138,BENGALURU-PONDICHERRY,2277,All
2019,12,BENGALURU,PONDICHERRY,1584,1471,BENGALURU-PONDICHERRY,3055,All
2020,1,BENGALURU,PONDICHERRY,1630,1468,BENGALURU-PONDICHERRY,3098,All
2020,2,BENGALURU,PONDICHERRY,1397,1360,BENGALURU-PONDICHERRY,2757,All
2020,3,BENGALURU,PONDICHERRY,720,785,BENGALURU-PONDICHERRY,1505,All
2022,3,BENGALURU,PONDICHERRY,176,216,BENGALURU-PONDICHERRY,392,All
2022,4,BENGALURU,PONDICHERRY,1630,1762,BENGALURU-PONDICHERRY,3392,All
2022,5,BENGALURU,PONDICHERRY,1669,1873,BENGALURU-PONDICHERRY,3542,All
2022,6,BENGALURU,PONDICHERRY,1570,1829,BENGALURU-PONDICHERRY,3399,All
2022,7,BENGALURU,PONDICHERRY,1068,1134,BENGALURU-PONDICHERRY,2202,All
2022,8,BENGALURU,PONDICHERRY,1131,1303,BENGALURU-PONDICHERRY,2434,All
2022,9,BENGALURU,PONDICHERRY,1028,1026,BENGALURU-PONDICHERRY,2054,All
2022,10,BENGALURU,PONDICHERRY,1028,945,BENGALURU-PONDICHERRY,1973,All
2022,11,BENGALURU,PONDICHERRY,639,630,BENGALURU-PONDICHERRY,1269,All
2022,12,BENGALURU,PONDICHERRY,1505,1316,BENGALURU-PONDICHERRY,2821,All
2023,1,BENGALURU,PONDICHERRY,1674,1831,BENGALURU-PONDICHERRY,3505,All
2023,2,BENGALURU,PONDICHERRY,730,858,BENGALURU-PONDICHERRY,1588,All
2023,3,BENGALURU,PONDICHERRY,902,1025,BENGALURU-PONDICHERRY,1927,All
2023,4,BENGALURU,PONDICHERRY,1110,1204,BENGALURU-PONDICHERRY,2314,All
2023,5,BENGALURU,PONDICHERRY,852,887,BENGALURU-PONDICHERRY,1739,All
2023,6,BENGALURU,PONDICHERRY,298,311,BENGALURU-PONDICHERRY,609,All
2023,10,BENGALURU,PONDICHERRY,1284,1386,BENGALURU-PONDICHERRY,2670,All
2023,11,BENGALURU,PONDICHERRY,924,881,BENGALURU-PONDICHERRY,1805,All
2023,12,BENGALURU,PONDICHERRY,2004,1926,BENGALURU-PONDICHERRY,3930,All
2024,1,BENGALURU,PONDICHERRY,2054,2142,BENGALURU-PONDICHERRY,4196,All
2024,2,BENGALURU,PONDICHERRY,1637,1769,BENGALURU-PONDICHERRY,3406,All
2024,3,BENGALURU,PONDICHERRY,1159,1162,BENGALURU-PONDICHERRY,2321,All
2024,12,BENGALURU,PONDICHERRY,825,791,BENGALURU-PONDICHERRY,1616,All
2025,1,BENGALURU,PONDICHERRY,2103,2118,BENGALURU-PONDICHERRY,4221,All
2025,2,BENGALURU,PONDICHERRY,1825,1972,BENGALURU-PONDICHERRY,3797,All
2025,3,BENGALURU,PONDICHERRY,2105,2025,BENGALURU-PONDICHERRY,4130,All
2015,12,BENGALURU,PORT BLAIR,176,175,BENGALURU-PORT BLAIR,351,All
2016,3,BENGALURU,PORT BLAIR,721,1093,BENGALURU-PORT BLAIR,1814,All
2016,4,BENGALURU,PORT BLAIR,3976,4384,BENGALURU-PORT BLAIR,8360,All
2016,5,BENGALURU,PORT BLAIR,4142,5121,BENGALURU-PORT BLAIR,9263,All
2016,6,BENGALURU,PORT BLAIR,1175,1420,BENGALURU-PORT BLAIR,2595,All
2016,10,BENGALURU,PORT BLAIR,3616,3498,BENGALURU-PORT BLAIR,7114,All
2016,11,BENGALURU,PORT BLAIR,2232,2974,BENGALURU-PORT BLAIR,5206,All
2016,12,BENGALURU,PORT BLAIR,3764,3597,BENGALURU-PORT BLAIR,7361,All
2017,1,BENGALURU,PORT BLAIR,3955,4003,BENGALURU-PORT BLAIR,7958,All
2017,4,BENGALURU,PORT BLAIR,120,0,BENGALURU-PORT BLAIR,120,All
2017,5,BENGALURU,PORT BLAIR,4482,5280,BENGALURU-PORT BLAIR,9762,All
2017,6,BENGALURU,PORT BLAIR,325,503,BENGALURU-PORT BLAIR,828,All
2017,9,BENGALURU,PORT BLAIR,1751,1276,BENGALURU-PORT BLAIR,3027,All
2017,10,BENGALURU,PORT BLAIR,3976,4059,BENGALURU-PORT BLAIR,8035,All
2017,11,BENGALURU,PORT BLAIR,3228,3668,BENGALURU-PORT BLAIR,6896,All
2017,12,BENGALURU,PORT BLAIR,4807,4850,BENGALURU-PORT BLAIR,9657,All
2018,1,BENGALURU,PORT BLAIR,4161,4484,BENGALURU-PORT BLAIR,8645,All
2018,2,BENGALURU,PORT BLAIR,3761,4147,BENGALURU-PORT BLAIR,7908,All
2018,3,BENGALURU,PORT BLAIR,3283,3798,BENGALURU-PORT BLAIR,7081,All
2018,4,BENGALURU,PORT BLAIR,4394,4755,BENGALURU-PORT BLAIR,9149,All
2018,5,BENGALURU,PORT BLAIR,4984,5390,BENGALURU-PORT BLAIR,10374,All
2018,6,BENGALURU,PORT BLAIR,316,345,BENGALURU-PORT BLAIR,661,All
2018,9,BENGALURU,PORT BLAIR,1531,999,BENGALURU-PORT BLAIR,2530,All
2018,10,BENGALURU,PORT BLAIR,4739,4715,BENGALURU-PORT BLAIR,9454,All
2018,11,BENGALURU,PORT BLAIR,5248,5215,BENGALURU-PORT BLAIR,10463,All
2018,12,BENGALURU,PORT BLAIR,10683,9667,BENGALURU-PORT BLAIR,20350,All
2019,1,BENGALURU,PORT BLAIR,10579,11694,BENGALURU-PORT BLAIR,22273,All
2019,2,BENGALURU,PORT BLAIR,10644,10073,BENGALURU-PORT BLAIR,20717,All
2019,3,BENGALURU,PORT BLAIR,10026,10725,BENGALURU-PORT BLAIR,20751,All
2019,4,BENGALURU,PORT BLAIR,8664,8948,BENGALURU-PORT BLAIR,17612,All
2019,5,BENGALURU,PORT BLAIR,8026,9561,BENGALURU-PORT BLAIR,17587,All
2019,6,BENGALURU,PORT BLAIR,1608,2446,BENGALURU-PORT BLAIR,4054,All
2019,9,BENGALURU,PORT BLAIR,5532,4591,BENGALURU-PORT BLAIR,10123,All
2019,10,BENGALURU,PORT BLAIR,9603,9206,BENGALURU-PORT BLAIR,18809,All
2019,11,BENGALURU,PORT BLAIR,9571,9711,BENGALURU-PORT BLAIR,19282,All
2019,12,BENGALURU,PORT BLAIR,9717,8961,BENGALURU-PORT BLAIR,18678,All
2020,1,BENGALURU,PORT BLAIR,9864,9800,BENGALURU-PORT BLAIR,19664,All
2020,2,BENGALURU,PORT BLAIR,9100,9289,BENGALURU-PORT BLAIR,18389,All
2020,3,BENGALURU,PORT BLAIR,4986,5653,BENGALURU-PORT BLAIR,10639,All
2020,7,BENGALURU,PORT BLAIR,0,57,BENGALURU-PORT BLAIR,57,All
2020,11,BENGALURU,PORT BLAIR,457,737,BENGALURU-PORT BLAIR,1194,All
2020,12,BENGALURU,PORT BLAIR,3766,4247,BENGALURU-PORT BLAIR,8013,All
2021,1,BENGALURU,PORT BLAIR,1515,1899,BENGALURU-PORT BLAIR,3414,All
2021,2,BENGALURU,PORT BLAIR,2239,2460,BENGALURU-PORT BLAIR,4699,All
2021,3,BENGALURU,PORT BLAIR,2565,3425,BENGALURU-PORT BLAIR,5990,All
2021,4,BENGALURU,PORT BLAIR,2362,2068,BENGALURU-PORT BLAIR,4430,All
2021,9,BENGALURU,PORT BLAIR,598,362,BENGALURU-PORT BLAIR,960,All
2021,10,BENGALURU,PORT BLAIR,5962,5130,BENGALURU-PORT BLAIR,11092,All
2021,11,BENGALURU,PORT BLAIR,10752,9967,BENGALURU-PORT BLAIR,20719,All
2021,12,BENGALURU,PORT BLAIR,11313,9943,BENGALURU-PORT BLAIR,21256,All
2022,1,BENGALURU,PORT BLAIR,3888,4662,BENGALURU-PORT BLAIR,8550,All
2022,2,BENGALURU,PORT BLAIR,5443,4413,BENGALURU-PORT BLAIR,9856,All
2022,3,BENGALURU,PORT BLAIR,5734,5327,BENGALURU-PORT BLAIR,11061,All
2022,4,BENGALURU,PORT BLAIR,8569,8212,BENGALURU-PORT BLAIR,16781,All
2022,5,BENGALURU,PORT BLAIR,8691,9599,BENGALURU-PORT BLAIR,18290,All
2022,6,BENGALURU,PORT BLAIR,9108,8588,BENGALURU-PORT BLAIR,17696,All
2022,7,BENGALURU,PORT BLAIR,4679,3848,BENGALURU-PORT BLAIR,8527,All
2022,8,BENGALURU,PORT BLAIR,5095,4422,BENGALURU-PORT BLAIR,9517,All
2022,9,BENGALURU,PORT BLAIR,5279,4954,BENGALURU-PORT BLAIR,10233,All
2022,10,BENGALURU,PORT BLAIR,7689,7322,BENGALURU-PORT BLAIR,15011,All
2022,11,BENGALURU,PORT BLAIR,5372,4577,BENGALURU-PORT BLAIR,9949,All
2022,12,BENGALURU,PORT BLAIR,8163,7020,BENGALURU-PORT BLAIR,15183,All
2023,1,BENGALURU,PORT BLAIR,6717,6979,BENGALURU-PORT BLAIR,13696,All
2023,2,BENGALURU,PORT BLAIR,5170,5827,BENGALURU-PORT BLAIR,10997,All
2023,3,BENGALURU,PORT BLAIR,6398,6471,BENGALURU-PORT BLAIR,12869,All
2023,4,BENGALURU,PORT BLAIR,6713,7159,BENGALURU-PORT BLAIR,13872,All
2023,5,BENGALURU,PORT BLAIR,4005,4306,BENGALURU-PORT BLAIR,8311,All
2023,6,BENGALURU,PORT BLAIR,1817,1977,BENGALURU-PORT BLAIR,3794,All
2023,9,BENGALURU,PORT BLAIR,1755,1560,BENGALURU-PORT BLAIR,3315,All
2023,10,BENGALURU,PORT BLAIR,4562,4432,BENGALURU-PORT BLAIR,8994,All
2023,11,BENGALURU,PORT BLAIR,8788,8139,BENGALURU-PORT BLAIR,16927,All
2023,12,BENGALURU,PORT BLAIR,9920,9524,BENGALURU-PORT BLAIR,19444,All
2024,1,BENGALURU,PORT BLAIR,8952,9441,BENGALURU-PORT BLAIR,18393,All
2024,2,BENGALURU,PORT BLAIR,8743,9447,BENGALURU-PORT BLAIR,18190,All
2024,3,BENGALURU,PORT BLAIR,9717,9835,BENGALURU-PORT BLAIR,19552,All
2024,4,BENGALURU,PORT BLAIR,7996,8453,BENGALURU-PORT BLAIR,16449,All
2024,6,BENGALURU,PORT BLAIR,8930,7919,BENGALURU-PORT BLAIR,16849,All
2024,7,BENGALURU,PORT BLAIR,4340,3763,BENGALURU-PORT BLAIR,8103,All
2024,8,BENGALURU,PORT BLAIR,6055,5491,BENGALURU-PORT BLAIR,11546,All
2024,9,BENGALURU,PORT BLAIR,8662,7468,BENGALURU-PORT BLAIR,16130,All
2024,10,BENGALURU,PORT BLAIR,10281,8790,BENGALURU-PORT BLAIR,19071,All
2024,11,BENGALURU,PORT BLAIR,9213,10374,BENGALURU-PORT BLAIR,19587,All
2024,12,BENGALURU,PORT BLAIR,13881,12554,BENGALURU-PORT BLAIR,26435,All
2025,1,BENGALURU,PORT BLAIR,13864,15522,BENGALURU-PORT BLAIR,29386,All
2025,2,BENGALURU,PORT BLAIR,9867,10070,BENGALURU-PORT BLAIR,19937,All
2025,3,BENGALURU,PORT BLAIR,10815,11811,BENGALURU-PORT BLAIR,22626,All
2015,4,BENGALURU,PUDUCHERRY,255,294,BENGALURU-PUDUCHERRY,549,All
2015,5,BENGALURU,PUDUCHERRY,327,461,BENGALURU-PUDUCHERRY,788,All
2015,6,BENGALURU,PUDUCHERRY,390,381,BENGALURU-PUDUCHERRY,771,All
2015,7,BENGALURU,PUDUCHERRY,453,509,BENGALURU-PUDUCHERRY,962,All
2015,8,BENGALURU,PUDUCHERRY,457,493,BENGALURU-PUDUCHERRY,950,All
2015,9,BENGALURU,PUDUCHERRY,315,388,BENGALURU-PUDUCHERRY,703,All
2015,10,BENGALURU,PUDUCHERRY,199,204,BENGALURU-PUDUCHERRY,403,All
2018,2,BENGALURU,PUDUCHERRY,996,949,BENGALURU-PUDUCHERRY,1945,All
2018,3,BENGALURU,PUDUCHERRY,2008,2067,BENGALURU-PUDUCHERRY,4075,All
2018,4,BENGALURU,PUDUCHERRY,2141,2095,BENGALURU-PUDUCHERRY,4236,All
2018,5,BENGALURU,PUDUCHERRY,2100,2100,BENGALURU-PUDUCHERRY,4200,All
2018,6,BENGALURU,PUDUCHERRY,2146,2030,BENGALURU-PUDUCHERRY,4176,All
2018,7,BENGALURU,PUDUCHERRY,2013,1913,BENGALURU-PUDUCHERRY,3926,All
2018,8,BENGALURU,PUDUCHERRY,1965,1858,BENGALURU-PUDUCHERRY,3823,All
2018,9,BENGALURU,PUDUCHERRY,1828,1741,BENGALURU-PUDUCHERRY,3569,All
2018,10,BENGALURU,PUDUCHERRY,1720,1543,BENGALURU-PUDUCHERRY,3263,All
2018,11,BENGALURU,PUDUCHERRY,1226,1151,BENGALURU-PUDUCHERRY,2377,All
2018,12,BENGALURU,PUDUCHERRY,1857,1713,BENGALURU-PUDUCHERRY,3570,All
2015,4,BENGALURU,PUNE,46977,47942,BENGALURU-PUNE,94919,All
2015,5,BENGALURU,PUNE,47382,50631,BENGALURU-PUNE,98013,All
2015,6,BENGALURU,PUNE,45411,45342,BENGALURU-PUNE,90753,All
2015,7,BENGALURU,PUNE,50316,51519,BENGALURU-PUNE,101835,All
2015,8,BENGALURU,PUNE,49822,50820,BENGALURU-PUNE,100642,All
2015,9,BENGALURU,PUNE,24285,24486,BENGALURU-PUNE,48771,All
2015,9,BENGALURU,PUNE,21451,22209,BENGALURU-PUNE,43660,All
2015,10,BENGALURU,PUNE,59209,51024,BENGALURU-PUNE,110233,All
2015,11,BENGALURU,PUNE,45292,45988,BENGALURU-PUNE,91280,All
2015,12,BENGALURU,PUNE,49311,49752,BENGALURU-PUNE,99063,All
2016,1,BENGALURU,PUNE,48389,50234,BENGALURU-PUNE,98623,All
2016,2,BENGALURU,PUNE,49848,50612,BENGALURU-PUNE,100460,All
2016,3,BENGALURU,PUNE,51155,57431,BENGALURU-PUNE,108586,All
2016,4,BENGALURU,PUNE,55270,54198,BENGALURU-PUNE,109468,All
2016,5,BENGALURU,PUNE,60803,68435,BENGALURU-PUNE,129238,All
2016,6,BENGALURU,PUNE,55209,53906,BENGALURU-PUNE,109115,All
2016,7,BENGALURU,PUNE,61033,62122,BENGALURU-PUNE,123155,All
2016,8,BENGALURU,PUNE,59584,60655,BENGALURU-PUNE,120239,All
2016,9,BENGALURU,PUNE,57058,56690,BENGALURU-PUNE,113748,All
2016,10,BENGALURU,PUNE,58632,60917,BENGALURU-PUNE,119549,All
2016,11,BENGALURU,PUNE,59394,59185,BENGALURU-PUNE,118579,All
2016,12,BENGALURU,PUNE,63048,64193,BENGALURU-PUNE,127241,All
2017,1,BENGALURU,PUNE,65330,67389,BENGALURU-PUNE,132719,All
2017,2,BENGALURU,PUNE,53540,53419,BENGALURU-PUNE,106959,All
2017,3,BENGALURU,PUNE,48724,49838,BENGALURU-PUNE,98562,All
2017,4,BENGALURU,PUNE,50617,49972,BENGALURU-PUNE,100589,All
2017,5,BENGALURU,PUNE,61343,66013,BENGALURU-PUNE,127356,All
2017,6,BENGALURU,PUNE,61735,60595,BENGALURU-PUNE,122330,All
2017,7,BENGALURU,PUNE,62496,65239,BENGALURU-PUNE,127735,All
2017,8,BENGALURU,PUNE,67366,68373,BENGALURU-PUNE,135739,All
2017,9,BENGALURU,PUNE,66045,63031,BENGALURU-PUNE,129076,All
2017,10,BENGALURU,PUNE,67245,70343,BENGALURU-PUNE,137588,All
2017,11,BENGALURU,PUNE,68325,68370,BENGALURU-PUNE,136695,All
2017,12,BENGALURU,PUNE,70546,73074,BENGALURU-PUNE,143620,All
2018,1,BENGALURU,PUNE,69646,71621,BENGALURU-PUNE,141267,All
2018,2,BENGALURU,PUNE,65349,65886,BENGALURU-PUNE,131235,All
2018,3,BENGALURU,PUNE,70284,70439,BENGALURU-PUNE,140723,All
2018,4,BENGALURU,PUNE,73465,73993,BENGALURU-PUNE,147458,All
2018,5,BENGALURU,PUNE,74296,78641,BENGALURU-PUNE,152937,All
2018,6,BENGALURU,PUNE,65669,62206,BENGALURU-PUNE,127875,All
2018,7,BENGALURU,PUNE,69223,71599,BENGALURU-PUNE,140822,All
2018,8,BENGALURU,PUNE,74914,77184,BENGALURU-PUNE,152098,All
2018,9,BENGALURU,PUNE,72868,74293,BENGALURU-PUNE,147161,All
2018,10,BENGALURU,PUNE,75249,77082,BENGALURU-PUNE,152331,All
2018,11,BENGALURU,PUNE,80297,83954,BENGALURU-PUNE,164251,All
2018,12,BENGALURU,PUNE,83304,86091,BENGALURU-PUNE,169395,All
2019,1,BENGALURU,PUNE,81800,83859,BENGALURU-PUNE,165659,All
2019,2,BENGALURU,PUNE,72142,73891,BENGALURU-PUNE,146033,All
2019,3,BENGALURU,PUNE,74762,75098,BENGALURU-PUNE,149860,All
2019,4,BENGALURU,PUNE,71911,73882,BENGALURU-PUNE,145793,All
2019,5,BENGALURU,PUNE,77023,82126,BENGALURU-PUNE,159149,All
2019,6,BENGALURU,PUNE,75841,76004,BENGALURU-PUNE,151845,All
2019,7,BENGALURU,PUNE,77851,79073,BENGALURU-PUNE,156924,All
2019,8,BENGALURU,PUNE,78941,78944,BENGALURU-PUNE,157885,All
2019,9,BENGALURU,PUNE,76120,75482,BENGALURU-PUNE,151602,All
2019,10,BENGALURU,PUNE,74644,77078,BENGALURU-PUNE,151722,All
2019,11,BENGALURU,PUNE,78685,78561,BENGALURU-PUNE,157246,All
2019,12,BENGALURU,PUNE,79810,80090,BENGALURU-PUNE,159900,All
2020,1,BENGALURU,PUNE,79015,79788,BENGALURU-PUNE,158803,All
2020,2,BENGALURU,PUNE,75235,76240,BENGALURU-PUNE,151475,All
2020,3,BENGALURU,PUNE,41156,40990,BENGALURU-PUNE,82146,All
2020,5,BENGALURU,PUNE,1461,1311,BENGALURU-PUNE,2772,All
2020,6,BENGALURU,PUNE,6562,4773,BENGALURU-PUNE,11335,All
2020,7,BENGALURU,PUNE,7333,4450,BENGALURU-PUNE,11783,All
2020,8,BENGALURU,PUNE,12027,9323,BENGALURU-PUNE,21350,All
2020,9,BENGALURU,PUNE,12705,12063,BENGALURU-PUNE,24768,All
2020,10,BENGALURU,PUNE,17543,16393,BENGALURU-PUNE,33936,All
2020,11,BENGALURU,PUNE,23378,19639,BENGALURU-PUNE,43017,All
2020,12,BENGALURU,PUNE,27414,20086,BENGALURU-PUNE,47500,All
2021,1,BENGALURU,PUNE,26276,25425,BENGALURU-PUNE,51701,All
2021,2,BENGALURU,PUNE,24165,23484,BENGALURU-PUNE,47649,All
2021,3,BENGALURU,PUNE,17462,16093,BENGALURU-PUNE,33555,All
2021,4,BENGALURU,PUNE,10284,9006,BENGALURU-PUNE,19290,All
2021,6,BENGALURU,PUNE,7408,8299,BENGALURU-PUNE,15707,All
2021,7,BENGALURU,PUNE,12332,15135,BENGALURU-PUNE,27467,All
2021,8,BENGALURU,PUNE,21707,22198,BENGALURU-PUNE,43905,All
2021,9,BENGALURU,PUNE,22656,22374,BENGALURU-PUNE,45030,All
2021,10,BENGALURU,PUNE,17107,16247,BENGALURU-PUNE,33354,All
2021,11,BENGALURU,PUNE,39009,37036,BENGALURU-PUNE,76045,All
2021,12,BENGALURU,PUNE,46674,43255,BENGALURU-PUNE,89929,All
2022,1,BENGALURU,PUNE,25643,24415,BENGALURU-PUNE,50058,All
2022,2,BENGALURU,PUNE,28866,29010,BENGALURU-PUNE,57876,All
2022,3,BENGALURU,PUNE,45683,43381,BENGALURU-PUNE,89064,All
2022,4,BENGALURU,PUNE,44107,45005,BENGALURU-PUNE,89112,All
2022,5,BENGALURU,PUNE,46483,52349,BENGALURU-PUNE,98832,All
2022,6,BENGALURU,PUNE,43245,41723,BENGALURU-PUNE,84968,All
2022,7,BENGALURU,PUNE,45256,48026,BENGALURU-PUNE,93282,All
2022,8,BENGALURU,PUNE,56104,57626,BENGALURU-PUNE,113730,All
2022,9,BENGALURU,PUNE,56823,57108,BENGALURU-PUNE,113931,All
2022,10,BENGALURU,PUNE,57015,63372,BENGALURU-PUNE,120387,All
2022,11,BENGALURU,PUNE,68683,69925,BENGALURU-PUNE,138608,All
2022,12,BENGALURU,PUNE,83504,85997,BENGALURU-PUNE,169501,All
2023,1,BENGALURU,PUNE,84767,88063,BENGALURU-PUNE,172830,All
2023,2,BENGALURU,PUNE,76766,78089,BENGALURU-PUNE,154855,All
2023,3,BENGALURU,PUNE,80759,82121,BENGALURU-PUNE,162880,All
2023,4,BENGALURU,PUNE,68621,69083,BENGALURU-PUNE,137704,All
2023,5,BENGALURU,PUNE,65955,68417,BENGALURU-PUNE,134372,All
2023,6,BENGALURU,PUNE,70557,70690,BENGALURU-PUNE,141247,All
2023,7,BENGALURU,PUNE,72502,75784,BENGALURU-PUNE,148286,All
2023,8,BENGALURU,PUNE,75961,75358,BENGALURU-PUNE,151319,All
2023,9,BENGALURU,PUNE,72505,70983,BENGALURU-PUNE,143488,All
2023,10,BENGALURU,PUNE,72534,70630,BENGALURU-PUNE,143164,All
2023,11,BENGALURU,PUNE,71596,72940,BENGALURU-PUNE,144536,All
2023,12,BENGALURU,PUNE,82795,83116,BENGALURU-PUNE,165911,All
2024,1,BENGALURU,PUNE,78547,80425,BENGALURU-PUNE,158972,All
2024,2,BENGALURU,PUNE,78466,77626,BENGALURU-PUNE,156092,All
2024,3,BENGALURU,PUNE,79286,79193,BENGALURU-PUNE,158479,All
2024,4,BENGALURU,PUNE,80466,80236,BENGALURU-PUNE,160702,All
2024,6,BENGALURU,PUNE,82652,81709,BENGALURU-PUNE,164361,All
2024,7,BENGALURU,PUNE,78135,82085,BENGALURU-PUNE,160220,All
2024,8,BENGALURU,PUNE,80701,83059,BENGALURU-PUNE,163760,All
2024,9,BENGALURU,PUNE,83060,83501,BENGALURU-PUNE,166561,All
2024,10,BENGALURU,PUNE,85876,82614,BENGALURU-PUNE,168490,All
2024,11,BENGALURU,PUNE,71294,71824,BENGALURU-PUNE,143118,All
2024,12,BENGALURU,PUNE,74399,73139,BENGALURU-PUNE,147538,All
2025,1,BENGALURU,PUNE,77990,76123,BENGALURU-PUNE,154113,All
2025,2,BENGALURU,PUNE,65898,63744,BENGALURU-PUNE,129642,All
2025,3,BENGALURU,PUNE,77626,74794,BENGALURU-PUNE,152420,All
2015,4,BENGALURU,RAIPUR,1797,1731,BENGALURU-RAIPUR,3528,All
2015,5,BENGALURU,RAIPUR,2312,3063,BENGALURU-RAIPUR,5375,All
2015,6,BENGALURU,RAIPUR,1909,2097,BENGALURU-RAIPUR,4006,All
2015,7,BENGALURU,RAIPUR,1663,1843,BENGALURU-RAIPUR,3506,All
2015,8,BENGALURU,RAIPUR,1698,1949,BENGALURU-RAIPUR,3647,All
2015,9,BENGALURU,RAIPUR,1356,1556,BENGALURU-RAIPUR,2912,All
2015,10,BENGALURU,RAIPUR,2025,1803,BENGALURU-RAIPUR,3828,All
2015,11,BENGALURU,RAIPUR,2251,2345,BENGALURU-RAIPUR,4596,All
2015,12,BENGALURU,RAIPUR,2686,2520,BENGALURU-RAIPUR,5206,All
2016,1,BENGALURU,RAIPUR,2025,2292,BENGALURU-RAIPUR,4317,All
2016,2,BENGALURU,RAIPUR,1821,1932,BENGALURU-RAIPUR,3753,All
2016,3,BENGALURU,RAIPUR,1880,1708,BENGALURU-RAIPUR,3588,All
2016,4,BENGALURU,RAIPUR,2436,2345,BENGALURU-RAIPUR,4781,All
2016,5,BENGALURU,RAIPUR,2185,2811,BENGALURU-RAIPUR,4996,All
2016,6,BENGALURU,RAIPUR,2569,2533,BENGALURU-RAIPUR,5102,All
2016,7,BENGALURU,RAIPUR,2465,2470,BENGALURU-RAIPUR,4935,All
2016,8,BENGALURU,RAIPUR,2430,2457,BENGALURU-RAIPUR,4887,All
2016,9,BENGALURU,RAIPUR,2287,2259,BENGALURU-RAIPUR,4546,All
2016,10,BENGALURU,RAIPUR,2535,1872,BENGALURU-RAIPUR,4407,All
2016,11,BENGALURU,RAIPUR,2638,2327,BENGALURU-RAIPUR,4965,All
2016,12,BENGALURU,RAIPUR,3783,3327,BENGALURU-RAIPUR,7110,All
2017,1,BENGALURU,RAIPUR,3821,4007,BENGALURU-RAIPUR,7828,All
2017,2,BENGALURU,RAIPUR,2193,2425,BENGALURU-RAIPUR,4618,All
2017,3,BENGALURU,RAIPUR,1046,1612,BENGALURU-RAIPUR,2658,All
2017,4,BENGALURU,RAIPUR,1568,1745,BENGALURU-RAIPUR,3313,All
2017,5,BENGALURU,RAIPUR,3083,3392,BENGALURU-RAIPUR,6475,All
2017,6,BENGALURU,RAIPUR,3063,3022,BENGALURU-RAIPUR,6085,All
2017,7,BENGALURU,RAIPUR,2554,2302,BENGALURU-RAIPUR,4856,All
2017,8,BENGALURU,RAIPUR,2515,1864,BENGALURU-RAIPUR,4379,All
2017,9,BENGALURU,RAIPUR,2773,1446,BENGALURU-RAIPUR,4219,All
2017,10,BENGALURU,RAIPUR,2316,1505,BENGALURU-RAIPUR,3821,All
2017,11,BENGALURU,RAIPUR,2310,1400,BENGALURU-RAIPUR,3710,All
2017,12,BENGALURU,RAIPUR,2951,1453,BENGALURU-RAIPUR,4404,All
2018,1,BENGALURU,RAIPUR,2758,1762,BENGALURU-RAIPUR,4520,All
2018,2,BENGALURU,RAIPUR,2304,1309,BENGALURU-RAIPUR,3613,All
2018,3,BENGALURU,RAIPUR,2090,1817,BENGALURU-RAIPUR,3907,All
2018,4,BENGALURU,RAIPUR,3156,2302,BENGALURU-RAIPUR,5458,All
2018,5,BENGALURU,RAIPUR,2927,2158,BENGALURU-RAIPUR,5085,All
2018,6,BENGALURU,RAIPUR,2833,1269,BENGALURU-RAIPUR,4102,All
2018,7,BENGALURU,RAIPUR,2302,1248,BENGALURU-RAIPUR,3550,All
2018,8,BENGALURU,RAIPUR,5357,5919,BENGALURU-RAIPUR,11276,All
2018,9,BENGALURU,RAIPUR,4281,4553,BENGALURU-RAIPUR,8834,All
2018,10,BENGALURU,RAIPUR,7529,6333,BENGALURU-RAIPUR,13862,All
2018,11,BENGALURU,RAIPUR,9756,10360,BENGALURU-RAIPUR,20116,All
2018,12,BENGALURU,RAIPUR,10934,9917,BENGALURU-RAIPUR,20851,All
2019,1,BENGALURU,RAIPUR,9043,9661,BENGALURU-RAIPUR,18704,All
2019,2,BENGALURU,RAIPUR,7832,7928,BENGALURU-RAIPUR,15760,All
2019,3,BENGALURU,RAIPUR,9848,9485,BENGALURU-RAIPUR,19333,All
2019,4,BENGALURU,RAIPUR,10662,9064,BENGALURU-RAIPUR,19726,All
2019,5,BENGALURU,RAIPUR,10754,13511,BENGALURU-RAIPUR,24265,All
2019,6,BENGALURU,RAIPUR,7012,7199,BENGALURU-RAIPUR,14211,All
2019,7,BENGALURU,RAIPUR,7846,8818,BENGALURU-RAIPUR,16664,All
2019,8,BENGALURU,RAIPUR,6265,6647,BENGALURU-RAIPUR,12912,All
2019,9,BENGALURU,RAIPUR,5999,5872,BENGALURU-RAIPUR,11871,All
2019,10,BENGALURU,RAIPUR,10095,8601,BENGALURU-RAIPUR,18696,All
2019,11,BENGALURU,RAIPUR,8587,10438,BENGALURU-RAIPUR,19025,All
2019,12,BENGALURU,RAIPUR,7643,7481,BENGALURU-RAIPUR,15124,All
2020,1,BENGALURU,RAIPUR,10164,9977,BENGALURU-RAIPUR,20141,All
2020,2,BENGALURU,RAIPUR,7307,7703,BENGALURU-RAIPUR,15010,All
2020,3,BENGALURU,RAIPUR,7705,4473,BENGALURU-RAIPUR,12178,All
2020,5,BENGALURU,RAIPUR,807,335,BENGALURU-RAIPUR,1142,All
2020,6,BENGALURU,RAIPUR,3720,1789,BENGALURU-RAIPUR,5509,All
2020,7,BENGALURU,RAIPUR,4235,1525,BENGALURU-RAIPUR,5760,All
2020,8,BENGALURU,RAIPUR,3550,2553,BENGALURU-RAIPUR,6103,All
2020,9,BENGALURU,RAIPUR,3537,4423,BENGALURU-RAIPUR,7960,All
2020,10,BENGALURU,RAIPUR,5388,5270,BENGALURU-RAIPUR,10658,All
2020,11,BENGALURU,RAIPUR,7578,7116,BENGALURU-RAIPUR,14694,All
2020,12,BENGALURU,RAIPUR,7513,8332,BENGALURU-RAIPUR,15845,All
2021,1,BENGALURU,RAIPUR,6447,7849,BENGALURU-RAIPUR,14296,All
2021,2,BENGALURU,RAIPUR,7430,7616,BENGALURU-RAIPUR,15046,All
2021,3,BENGALURU,RAIPUR,6917,6321,BENGALURU-RAIPUR,13238,All
2021,4,BENGALURU,RAIPUR,4461,2713,BENGALURU-RAIPUR,7174,All
2021,6,BENGALURU,RAIPUR,2022,2563,BENGALURU-RAIPUR,4585,All
2021,7,BENGALURU,RAIPUR,3448,5130,BENGALURU-RAIPUR,8578,All
2021,8,BENGALURU,RAIPUR,4270,5620,BENGALURU-RAIPUR,9890,All
2021,9,BENGALURU,RAIPUR,4582,5847,BENGALURU-RAIPUR,10429,All
2021,10,BENGALURU,RAIPUR,7998,6872,BENGALURU-RAIPUR,14870,All
2021,11,BENGALURU,RAIPUR,8027,8512,BENGALURU-RAIPUR,16539,All
2021,12,BENGALURU,RAIPUR,8172,9000,BENGALURU-RAIPUR,17172,All
2022,1,BENGALURU,RAIPUR,4797,4026,BENGALURU-RAIPUR,8823,All
2022,2,BENGALURU,RAIPUR,3406,4571,BENGALURU-RAIPUR,7977,All
2022,3,BENGALURU,RAIPUR,6943,7705,BENGALURU-RAIPUR,14648,All
2022,4,BENGALURU,RAIPUR,7680,7793,BENGALURU-RAIPUR,15473,All
2022,5,BENGALURU,RAIPUR,7927,10142,BENGALURU-RAIPUR,18069,All
2022,6,BENGALURU,RAIPUR,9723,9520,BENGALURU-RAIPUR,19243,All
2022,7,BENGALURU,RAIPUR,9332,9796,BENGALURU-RAIPUR,19128,All
2022,8,BENGALURU,RAIPUR,9941,9923,BENGALURU-RAIPUR,19864,All
2022,9,BENGALURU,RAIPUR,9389,8019,BENGALURU-RAIPUR,17408,All
2022,10,BENGALURU,RAIPUR,10893,9096,BENGALURU-RAIPUR,19989,All
2022,11,BENGALURU,RAIPUR,9841,9986,BENGALURU-RAIPUR,19827,All
2022,12,BENGALURU,RAIPUR,10148,9993,BENGALURU-RAIPUR,20141,All
2023,1,BENGALURU,RAIPUR,9695,10030,BENGALURU-RAIPUR,19725,All
2023,2,BENGALURU,RAIPUR,8138,8020,BENGALURU-RAIPUR,16158,All
2023,3,BENGALURU,RAIPUR,9443,8782,BENGALURU-RAIPUR,18225,All
2023,4,BENGALURU,RAIPUR,9805,9066,BENGALURU-RAIPUR,18871,All
2023,5,BENGALURU,RAIPUR,10358,10731,BENGALURU-RAIPUR,21089,All
2023,6,BENGALURU,RAIPUR,10787,10565,BENGALURU-RAIPUR,21352,All
2023,7,BENGALURU,RAIPUR,8673,8576,BENGALURU-RAIPUR,17249,All
2023,8,BENGALURU,RAIPUR,11539,11070,BENGALURU-RAIPUR,22609,All
2023,9,BENGALURU,RAIPUR,11494,11183,BENGALURU-RAIPUR,22677,All
2023,10,BENGALURU,RAIPUR,12149,10601,BENGALURU-RAIPUR,22750,All
2023,11,BENGALURU,RAIPUR,10414,9628,BENGALURU-RAIPUR,20042,All
2023,12,BENGALURU,RAIPUR,10300,10400,BENGALURU-RAIPUR,20700,All
2024,1,BENGALURU,RAIPUR,9562,9868,BENGALURU-RAIPUR,19430,All
2024,2,BENGALURU,RAIPUR,9390,9369,BENGALURU-RAIPUR,18759,All
2024,3,BENGALURU,RAIPUR,10324,9758,BENGALURU-RAIPUR,20082,All
2024,4,BENGALURU,RAIPUR,10811,9929,BENGALURU-RAIPUR,20740,All
2024,6,BENGALURU,RAIPUR,10726,10303,BENGALURU-RAIPUR,21029,All
2024,7,BENGALURU,RAIPUR,9511,9846,BENGALURU-RAIPUR,19357,All
2024,8,BENGALURU,RAIPUR,10344,10441,BENGALURU-RAIPUR,20785,All
2024,9,BENGALURU,RAIPUR,9767,9000,BENGALURU-RAIPUR,18767,All
2024,10,BENGALURU,RAIPUR,11115,8829,BENGALURU-RAIPUR,19944,All
2024,11,BENGALURU,RAIPUR,9922,11792,BENGALURU-RAIPUR,21714,All
2024,12,BENGALURU,RAIPUR,11732,11616,BENGALURU-RAIPUR,23348,All
2025,1,BENGALURU,RAIPUR,11217,11871,BENGALURU-RAIPUR,23088,All
2025,2,BENGALURU,RAIPUR,8731,8898,BENGALURU-RAIPUR,17629,All
2025,3,BENGALURU,RAIPUR,11328,11358,BENGALURU-RAIPUR,22686,All
2015,4,BENGALURU,RAJAHMUNDRY,389,0,BENGALURU-RAJAHMUNDRY,389,All
2015,5,BENGALURU,RAJAHMUNDRY,399,0,BENGALURU-RAJAHMUNDRY,399,All
2015,6,BENGALURU,RAJAHMUNDRY,308,0,BENGALURU-RAJAHMUNDRY,308,All
2015,7,BENGALURU,RAJAHMUNDRY,426,219,BENGALURU-RAJAHMUNDRY,645,All
2015,8,BENGALURU,RAJAHMUNDRY,339,236,BENGALURU-RAJAHMUNDRY,575,All
2015,9,BENGALURU,RAJAHMUNDRY,369,224,BENGALURU-RAJAHMUNDRY,593,All
2015,10,BENGALURU,RAJAHMUNDRY,468,347,BENGALURU-RAJAHMUNDRY,815,All
2015,11,BENGALURU,RAJAHMUNDRY,369,299,BENGALURU-RAJAHMUNDRY,668,All
2015,12,BENGALURU,RAJAHMUNDRY,344,302,BENGALURU-RAJAHMUNDRY,646,All
2016,1,BENGALURU,RAJAHMUNDRY,385,260,BENGALURU-RAJAHMUNDRY,645,All
2016,2,BENGALURU,RAJAHMUNDRY,303,204,BENGALURU-RAJAHMUNDRY,507,All
2016,3,BENGALURU,RAJAHMUNDRY,256,127,BENGALURU-RAJAHMUNDRY,383,All
2016,9,BENGALURU,RAJAHMUNDRY,32,32,BENGALURU-RAJAHMUNDRY,64,All
2016,10,BENGALURU,RAJAHMUNDRY,970,829,BENGALURU-RAJAHMUNDRY,1799,All
2016,11,BENGALURU,RAJAHMUNDRY,1115,804,BENGALURU-RAJAHMUNDRY,1919,All
2016,12,BENGALURU,RAJAHMUNDRY,614,83,BENGALURU-RAJAHMUNDRY,697,All
2017,1,BENGALURU,RAJAHMUNDRY,1168,1014,BENGALURU-RAJAHMUNDRY,2182,All
2017,2,BENGALURU,RAJAHMUNDRY,662,514,BENGALURU-RAJAHMUNDRY,1176,All
2017,3,BENGALURU,RAJAHMUNDRY,192,0,BENGALURU-RAJAHMUNDRY,192,All
2017,5,BENGALURU,RAJAHMUNDRY,1614,1898,BENGALURU-RAJAHMUNDRY,3512,All
2017,6,BENGALURU,RAJAHMUNDRY,1523,1514,BENGALURU-RAJAHMUNDRY,3037,All
2017,7,BENGALURU,RAJAHMUNDRY,1534,1676,BENGALURU-RAJAHMUNDRY,3210,All
2017,8,BENGALURU,RAJAHMUNDRY,1516,1678,BENGALURU-RAJAHMUNDRY,3194,All
2017,9,BENGALURU,RAJAHMUNDRY,999,990,BENGALURU-RAJAHMUNDRY,1989,All
2018,1,BENGALURU,RAJAHMUNDRY,1355,1407,BENGALURU-RAJAHMUNDRY,2762,All
2018,2,BENGALURU,RAJAHMUNDRY,2587,2558,BENGALURU-RAJAHMUNDRY,5145,All
2018,3,BENGALURU,RAJAHMUNDRY,3986,4084,BENGALURU-RAJAHMUNDRY,8070,All
2018,4,BENGALURU,RAJAHMUNDRY,4128,4191,BENGALURU-RAJAHMUNDRY,8319,All
2018,5,BENGALURU,RAJAHMUNDRY,4064,6174,BENGALURU-RAJAHMUNDRY,10238,All
2018,6,BENGALURU,RAJAHMUNDRY,4268,3957,BENGALURU-RAJAHMUNDRY,8225,All
2018,7,BENGALURU,RAJAHMUNDRY,4567,5146,BENGALURU-RAJAHMUNDRY,9713,All
2018,8,BENGALURU,RAJAHMUNDRY,5239,5131,BENGALURU-RAJAHMUNDRY,10370,All
2018,9,BENGALURU,RAJAHMUNDRY,4911,5500,BENGALURU-RAJAHMUNDRY,10411,All
2018,10,BENGALURU,RAJAHMUNDRY,4381,4352,BENGALURU-RAJAHMUNDRY,8733,All
2018,11,BENGALURU,RAJAHMUNDRY,3809,3883,BENGALURU-RAJAHMUNDRY,7692,All
2018,12,BENGALURU,RAJAHMUNDRY,3861,3597,BENGALURU-RAJAHMUNDRY,7458,All
2019,1,BENGALURU,RAJAHMUNDRY,1802,1885,BENGALURU-RAJAHMUNDRY,3687,All
2019,2,BENGALURU,RAJAHMUNDRY,1346,1334,BENGALURU-RAJAHMUNDRY,2680,All
2019,3,BENGALURU,RAJAHMUNDRY,1908,1958,BENGALURU-RAJAHMUNDRY,3866,All
2019,4,BENGALURU,RAJAHMUNDRY,1894,1856,BENGALURU-RAJAHMUNDRY,3750,All
2019,5,BENGALURU,RAJAHMUNDRY,1892,2027,BENGALURU-RAJAHMUNDRY,3919,All
2019,6,BENGALURU,RAJAHMUNDRY,1975,1976,BENGALURU-RAJAHMUNDRY,3951,All
2019,7,BENGALURU,RAJAHMUNDRY,1963,2040,BENGALURU-RAJAHMUNDRY,4003,All
2019,8,BENGALURU,RAJAHMUNDRY,2058,2022,BENGALURU-RAJAHMUNDRY,4080,All
2019,9,BENGALURU,RAJAHMUNDRY,2555,2285,BENGALURU-RAJAHMUNDRY,4840,All
2019,10,BENGALURU,RAJAHMUNDRY,4050,3530,BENGALURU-RAJAHMUNDRY,7580,All
2019,11,BENGALURU,RAJAHMUNDRY,3542,3627,BENGALURU-RAJAHMUNDRY,7169,All
2019,12,BENGALURU,RAJAHMUNDRY,3876,3535,BENGALURU-RAJAHMUNDRY,7411,All
2020,1,BENGALURU,RAJAHMUNDRY,2832,3696,BENGALURU-RAJAHMUNDRY,6528,All
2020,2,BENGALURU,RAJAHMUNDRY,3136,3199,BENGALURU-RAJAHMUNDRY,6335,All
2020,3,BENGALURU,RAJAHMUNDRY,2705,1720,BENGALURU-RAJAHMUNDRY,4425,All
2020,7,BENGALURU,RAJAHMUNDRY,1180,590,BENGALURU-RAJAHMUNDRY,1770,All
2020,8,BENGALURU,RAJAHMUNDRY,1813,1731,BENGALURU-RAJAHMUNDRY,3544,All
2020,9,BENGALURU,RAJAHMUNDRY,2033,2339,BENGALURU-RAJAHMUNDRY,4372,All
2020,10,BENGALURU,RAJAHMUNDRY,2735,2861,BENGALURU-RAJAHMUNDRY,5596,All
2020,11,BENGALURU,RAJAHMUNDRY,3092,3209,BENGALURU-RAJAHMUNDRY,6301,All
2020,12,BENGALURU,RAJAHMUNDRY,3664,3639,BENGALURU-RAJAHMUNDRY,7303,All
2021,1,BENGALURU,RAJAHMUNDRY,3494,3789,BENGALURU-RAJAHMUNDRY,7283,All
2021,2,BENGALURU,RAJAHMUNDRY,2847,3023,BENGALURU-RAJAHMUNDRY,5870,All
2021,3,BENGALURU,RAJAHMUNDRY,2915,3156,BENGALURU-RAJAHMUNDRY,6071,All
2021,4,BENGALURU,RAJAHMUNDRY,2228,1760,BENGALURU-RAJAHMUNDRY,3988,All
2021,6,BENGALURU,RAJAHMUNDRY,1172,1692,BENGALURU-RAJAHMUNDRY,2864,All
2021,7,BENGALURU,RAJAHMUNDRY,2318,2568,BENGALURU-RAJAHMUNDRY,4886,All
2021,8,BENGALURU,RAJAHMUNDRY,3112,3267,BENGALURU-RAJAHMUNDRY,6379,All
2021,9,BENGALURU,RAJAHMUNDRY,2709,3000,BENGALURU-RAJAHMUNDRY,5709,All
2021,10,BENGALURU,RAJAHMUNDRY,3910,3816,BENGALURU-RAJAHMUNDRY,7726,All
2021,11,BENGALURU,RAJAHMUNDRY,3519,3780,BENGALURU-RAJAHMUNDRY,7299,All
2021,12,BENGALURU,RAJAHMUNDRY,3656,3716,BENGALURU-RAJAHMUNDRY,7372,All
2022,1,BENGALURU,RAJAHMUNDRY,2165,2183,BENGALURU-RAJAHMUNDRY,4348,All
2022,2,BENGALURU,RAJAHMUNDRY,1240,1329,BENGALURU-RAJAHMUNDRY,2569,All
2022,3,BENGALURU,RAJAHMUNDRY,2636,2770,BENGALURU-RAJAHMUNDRY,5406,All
2022,4,BENGALURU,RAJAHMUNDRY,3716,4033,BENGALURU-RAJAHMUNDRY,7749,All
2022,5,BENGALURU,RAJAHMUNDRY,3567,4209,BENGALURU-RAJAHMUNDRY,7776,All
2022,6,BENGALURU,RAJAHMUNDRY,3583,3846,BENGALURU-RAJAHMUNDRY,7429,All
2022,7,BENGALURU,RAJAHMUNDRY,3441,3593,BENGALURU-RAJAHMUNDRY,7034,All
2022,8,BENGALURU,RAJAHMUNDRY,3480,3974,BENGALURU-RAJAHMUNDRY,7454,All
2022,9,BENGALURU,RAJAHMUNDRY,3105,3270,BENGALURU-RAJAHMUNDRY,6375,All
2022,10,BENGALURU,RAJAHMUNDRY,4150,4110,BENGALURU-RAJAHMUNDRY,8260,All
2022,11,BENGALURU,RAJAHMUNDRY,3725,4104,BENGALURU-RAJAHMUNDRY,7829,All
2022,12,BENGALURU,RAJAHMUNDRY,4132,3937,BENGALURU-RAJAHMUNDRY,8069,All
2023,1,BENGALURU,RAJAHMUNDRY,3844,4120,BENGALURU-RAJAHMUNDRY,7964,All
2023,2,BENGALURU,RAJAHMUNDRY,3062,3224,BENGALURU-RAJAHMUNDRY,6286,All
2023,3,BENGALURU,RAJAHMUNDRY,3763,3988,BENGALURU-RAJAHMUNDRY,7751,All
2023,4,BENGALURU,RAJAHMUNDRY,3771,3983,BENGALURU-RAJAHMUNDRY,7754,All
2023,5,BENGALURU,RAJAHMUNDRY,3739,4117,BENGALURU-RAJAHMUNDRY,7856,All
2023,6,BENGALURU,RAJAHMUNDRY,4128,4260,BENGALURU-RAJAHMUNDRY,8388,All
2023,7,BENGALURU,RAJAHMUNDRY,4462,4586,BENGALURU-RAJAHMUNDRY,9048,All
2023,8,BENGALURU,RAJAHMUNDRY,4579,4593,BENGALURU-RAJAHMUNDRY,9172,All
2023,9,BENGALURU,RAJAHMUNDRY,3807,3929,BENGALURU-RAJAHMUNDRY,7736,All
2023,10,BENGALURU,RAJAHMUNDRY,3817,3737,BENGALURU-RAJAHMUNDRY,7554,All
2023,11,BENGALURU,RAJAHMUNDRY,3567,3465,BENGALURU-RAJAHMUNDRY,7032,All
2023,12,BENGALURU,RAJAHMUNDRY,4264,4018,BENGALURU-RAJAHMUNDRY,8282,All
2024,1,BENGALURU,RAJAHMUNDRY,4040,4463,BENGALURU-RAJAHMUNDRY,8503,All
2024,2,BENGALURU,RAJAHMUNDRY,3746,3730,BENGALURU-RAJAHMUNDRY,7476,All
2024,3,BENGALURU,RAJAHMUNDRY,3954,3870,BENGALURU-RAJAHMUNDRY,7824,All
2024,4,BENGALURU,RAJAHMUNDRY,3571,3932,BENGALURU-RAJAHMUNDRY,7503,All
2024,6,BENGALURU,RAJAHMUNDRY,3752,3759,BENGALURU-RAJAHMUNDRY,7511,All
2024,7,BENGALURU,RAJAHMUNDRY,3425,3768,BENGALURU-RAJAHMUNDRY,7193,All
2024,8,BENGALURU,RAJAHMUNDRY,3882,3966,BENGALURU-RAJAHMUNDRY,7848,All
2024,9,BENGALURU,RAJAHMUNDRY,3231,3417,BENGALURU-RAJAHMUNDRY,6648,All
2024,10,BENGALURU,RAJAHMUNDRY,3568,3130,BENGALURU-RAJAHMUNDRY,6698,All
2024,11,BENGALURU,RAJAHMUNDRY,3369,3691,BENGALURU-RAJAHMUNDRY,7060,All
2024,12,BENGALURU,RAJAHMUNDRY,3838,3659,BENGALURU-RAJAHMUNDRY,7497,All
2025,1,BENGALURU,RAJAHMUNDRY,3692,3908,BENGALURU-RAJAHMUNDRY,7600,All
2025,2,BENGALURU,RAJAHMUNDRY,2964,3143,BENGALURU-RAJAHMUNDRY,6107,All
2025,3,BENGALURU,RAJAHMUNDRY,3689,3574,BENGALURU-RAJAHMUNDRY,7263,All
2015,4,BENGALURU,RAJKOT,672,429,BENGALURU-RAJKOT,1101,All
2015,5,BENGALURU,RAJKOT,359,561,BENGALURU-RAJKOT,920,All
2015,6,BENGALURU,RAJKOT,351,287,BENGALURU-RAJKOT,638,All
2015,7,BENGALURU,RAJKOT,155,142,BENGALURU-RAJKOT,297,All
2015,8,BENGALURU,RAJKOT,172,140,BENGALURU-RAJKOT,312,All
2015,9,BENGALURU,RAJKOT,214,204,BENGALURU-RAJKOT,418,All
2015,10,BENGALURU,RAJKOT,406,351,BENGALURU-RAJKOT,757,All
2015,11,BENGALURU,RAJKOT,409,580,BENGALURU-RAJKOT,989,All
2015,12,BENGALURU,RAJKOT,562,537,BENGALURU-RAJKOT,1099,All
2016,1,BENGALURU,RAJKOT,520,583,BENGALURU-RAJKOT,1103,All
2016,2,BENGALURU,RAJKOT,456,461,BENGALURU-RAJKOT,917,All
2016,3,BENGALURU,RAJKOT,351,326,BENGALURU-RAJKOT,677,All
2016,4,BENGALURU,RAJKOT,377,345,BENGALURU-RAJKOT,722,All
2016,5,BENGALURU,RAJKOT,305,356,BENGALURU-RAJKOT,661,All
2016,6,BENGALURU,RAJKOT,189,123,BENGALURU-RAJKOT,312,All
2016,7,BENGALURU,RAJKOT,137,128,BENGALURU-RAJKOT,265,All
2016,8,BENGALURU,RAJKOT,228,155,BENGALURU-RAJKOT,383,All
2016,9,BENGALURU,RAJKOT,204,127,BENGALURU-RAJKOT,331,All
2016,10,BENGALURU,RAJKOT,283,158,BENGALURU-RAJKOT,441,All
2016,11,BENGALURU,RAJKOT,183,158,BENGALURU-RAJKOT,341,All
2016,12,BENGALURU,RAJKOT,302,187,BENGALURU-RAJKOT,489,All
2017,1,BENGALURU,RAJKOT,250,217,BENGALURU-RAJKOT,467,All
2017,2,BENGALURU,RAJKOT,254,133,BENGALURU-RAJKOT,387,All
2017,3,BENGALURU,RAJKOT,189,134,BENGALURU-RAJKOT,323,All
2021,2,BENGALURU,RAJKOT,432,504,BENGALURU-RAJKOT,936,All
2021,3,BENGALURU,RAJKOT,2418,2158,BENGALURU-RAJKOT,4576,All
2021,4,BENGALURU,RAJKOT,1156,808,BENGALURU-RAJKOT,1964,All
2021,11,BENGALURU,RAJKOT,1988,1861,BENGALURU-RAJKOT,3849,All
2021,12,BENGALURU,RAJKOT,2062,2066,BENGALURU-RAJKOT,4128,All
2022,1,BENGALURU,RAJKOT,1851,1377,BENGALURU-RAJKOT,3228,All
2022,2,BENGALURU,RAJKOT,2022,1884,BENGALURU-RAJKOT,3906,All
2022,3,BENGALURU,RAJKOT,3936,4077,BENGALURU-RAJKOT,8013,All
2022,4,BENGALURU,RAJKOT,3850,4315,BENGALURU-RAJKOT,8165,All
2022,5,BENGALURU,RAJKOT,4670,5288,BENGALURU-RAJKOT,9958,All
2022,6,BENGALURU,RAJKOT,4639,4877,BENGALURU-RAJKOT,9516,All
2022,7,BENGALURU,RAJKOT,3807,4258,BENGALURU-RAJKOT,8065,All
2022,8,BENGALURU,RAJKOT,4231,4352,BENGALURU-RAJKOT,8583,All
2022,9,BENGALURU,RAJKOT,3950,3319,BENGALURU-RAJKOT,7269,All
2022,10,BENGALURU,RAJKOT,4728,4998,BENGALURU-RAJKOT,9726,All
2022,11,BENGALURU,RAJKOT,2964,3015,BENGALURU-RAJKOT,5979,All
2022,12,BENGALURU,RAJKOT,2729,2825,BENGALURU-RAJKOT,5554,All
2023,1,BENGALURU,RAJKOT,2810,2855,BENGALURU-RAJKOT,5665,All
2023,2,BENGALURU,RAJKOT,3025,3141,BENGALURU-RAJKOT,6166,All
2023,3,BENGALURU,RAJKOT,3512,3526,BENGALURU-RAJKOT,7038,All
2023,4,BENGALURU,RAJKOT,4490,4377,BENGALURU-RAJKOT,8867,All
2023,5,BENGALURU,RAJKOT,4549,5191,BENGALURU-RAJKOT,9740,All
2023,6,BENGALURU,RAJKOT,4223,4216,BENGALURU-RAJKOT,8439,All
2023,7,BENGALURU,RAJKOT,4272,4476,BENGALURU-RAJKOT,8748,All
2023,8,BENGALURU,RAJKOT,4517,4656,BENGALURU-RAJKOT,9173,All
2023,9,BENGALURU,RAJKOT,1172,1364,BENGALURU-RAJKOT,2536,All
2015,4,BENGALURU,RANCHI,2410,2183,BENGALURU-RANCHI,4593,All
2015,5,BENGALURU,RANCHI,3073,3610,BENGALURU-RANCHI,6683,All
2015,6,BENGALURU,RANCHI,2736,3048,BENGALURU-RANCHI,5784,All
2015,7,BENGALURU,RANCHI,2557,2913,BENGALURU-RANCHI,5470,All
2015,8,BENGALURU,RANCHI,2174,2505,BENGALURU-RANCHI,4679,All
2015,9,BENGALURU,RANCHI,1977,1781,BENGALURU-RANCHI,3758,All
2015,10,BENGALURU,RANCHI,2581,2239,BENGALURU-RANCHI,4820,All
2015,11,BENGALURU,RANCHI,3081,2675,BENGALURU-RANCHI,5756,All
2015,12,BENGALURU,RANCHI,3007,3028,BENGALURU-RANCHI,6035,All
2016,1,BENGALURU,RANCHI,2766,3005,BENGALURU-RANCHI,5771,All
2016,2,BENGALURU,RANCHI,2906,2973,BENGALURU-RANCHI,5879,All
2016,3,BENGALURU,RANCHI,3551,4207,BENGALURU-RANCHI,7758,All
2016,4,BENGALURU,RANCHI,3687,7620,BENGALURU-RANCHI,11307,All
2016,5,BENGALURU,RANCHI,2877,7876,BENGALURU-RANCHI,10753,All
2016,6,BENGALURU,RANCHI,3085,6880,BENGALURU-RANCHI,9965,All
2016,7,BENGALURU,RANCHI,3233,8364,BENGALURU-RANCHI,11597,All
2016,8,BENGALURU,RANCHI,2640,6791,BENGALURU-RANCHI,9431,All
2016,9,BENGALURU,RANCHI,2028,5947,BENGALURU-RANCHI,7975,All
2016,10,BENGALURU,RANCHI,3319,6882,BENGALURU-RANCHI,10201,All
2016,11,BENGALURU,RANCHI,3137,8757,BENGALURU-RANCHI,11894,All
2016,12,BENGALURU,RANCHI,3428,8965,BENGALURU-RANCHI,12393,All
2017,1,BENGALURU,RANCHI,3324,8613,BENGALURU-RANCHI,11937,All
2017,2,BENGALURU,RANCHI,3603,7595,BENGALURU-RANCHI,11198,All
2017,3,BENGALURU,RANCHI,6291,9181,BENGALURU-RANCHI,15472,All
2017,4,BENGALURU,RANCHI,6003,7159,BENGALURU-RANCHI,13162,All
2017,5,BENGALURU,RANCHI,3193,9868,BENGALURU-RANCHI,13061,All
2017,6,BENGALURU,RANCHI,4779,10805,BENGALURU-RANCHI,15584,All
2017,7,BENGALURU,RANCHI,6650,13726,BENGALURU-RANCHI,20376,All
2017,8,BENGALURU,RANCHI,7014,13072,BENGALURU-RANCHI,20086,All
2017,9,BENGALURU,RANCHI,7021,11236,BENGALURU-RANCHI,18257,All
2017,10,BENGALURU,RANCHI,11284,16650,BENGALURU-RANCHI,27934,All
2017,11,BENGALURU,RANCHI,11575,17808,BENGALURU-RANCHI,29383,All
2017,12,BENGALURU,RANCHI,12747,14712,BENGALURU-RANCHI,27459,All
2018,1,BENGALURU,RANCHI,11830,14035,BENGALURU-RANCHI,25865,All
2018,2,BENGALURU,RANCHI,10771,14586,BENGALURU-RANCHI,25357,All
2018,3,BENGALURU,RANCHI,10919,15841,BENGALURU-RANCHI,26760,All
2018,4,BENGALURU,RANCHI,11824,14919,BENGALURU-RANCHI,26743,All
2018,5,BENGALURU,RANCHI,11156,18657,BENGALURU-RANCHI,29813,All
2018,6,BENGALURU,RANCHI,22417,18870,BENGALURU-RANCHI,41287,All
2018,7,BENGALURU,RANCHI,25181,22301,BENGALURU-RANCHI,47482,All
2018,8,BENGALURU,RANCHI,16699,19650,BENGALURU-RANCHI,36349,All
2018,9,BENGALURU,RANCHI,16190,16419,BENGALURU-RANCHI,32609,All
2018,10,BENGALURU,RANCHI,21555,20692,BENGALURU-RANCHI,42247,All
2018,11,BENGALURU,RANCHI,19928,21709,BENGALURU-RANCHI,41637,All
2018,12,BENGALURU,RANCHI,19838,22013,BENGALURU-RANCHI,41851,All
2019,1,BENGALURU,RANCHI,21828,24079,BENGALURU-RANCHI,45907,All
2019,2,BENGALURU,RANCHI,17998,18077,BENGALURU-RANCHI,36075,All
2019,3,BENGALURU,RANCHI,18397,17939,BENGALURU-RANCHI,36336,All
2019,4,BENGALURU,RANCHI,16290,16410,BENGALURU-RANCHI,32700,All
2019,5,BENGALURU,RANCHI,16663,19227,BENGALURU-RANCHI,35890,All
2019,6,BENGALURU,RANCHI,16183,18726,BENGALURU-RANCHI,34909,All
2019,7,BENGALURU,RANCHI,15794,18797,BENGALURU-RANCHI,34591,All
2019,8,BENGALURU,RANCHI,15690,17942,BENGALURU-RANCHI,33632,All
2019,9,BENGALURU,RANCHI,15139,15782,BENGALURU-RANCHI,30921,All
2019,10,BENGALURU,RANCHI,16161,15305,BENGALURU-RANCHI,31466,All
2019,11,BENGALURU,RANCHI,15185,16789,BENGALURU-RANCHI,31974,All
2019,12,BENGALURU,RANCHI,15329,17200,BENGALURU-RANCHI,32529,All
2020,1,BENGALURU,RANCHI,16079,16185,BENGALURU-RANCHI,32264,All
2020,2,BENGALURU,RANCHI,14537,14598,BENGALURU-RANCHI,29135,All
2020,3,BENGALURU,RANCHI,12521,9243,BENGALURU-RANCHI,21764,All
2020,5,BENGALURU,RANCHI,521,333,BENGALURU-RANCHI,854,All
2020,6,BENGALURU,RANCHI,4943,3311,BENGALURU-RANCHI,8254,All
2020,7,BENGALURU,RANCHI,11531,3501,BENGALURU-RANCHI,15032,All
2020,8,BENGALURU,RANCHI,8940,11495,BENGALURU-RANCHI,20435,All
2020,9,BENGALURU,RANCHI,8786,12161,BENGALURU-RANCHI,20947,All
2020,10,BENGALURU,RANCHI,12919,12919,BENGALURU-RANCHI,25838,All
2020,11,BENGALURU,RANCHI,13318,12958,BENGALURU-RANCHI,26276,All
2020,12,BENGALURU,RANCHI,13458,12704,BENGALURU-RANCHI,26162,All
2021,1,BENGALURU,RANCHI,10935,13996,BENGALURU-RANCHI,24931,All
2021,2,BENGALURU,RANCHI,10746,12862,BENGALURU-RANCHI,23608,All
2021,3,BENGALURU,RANCHI,13326,10915,BENGALURU-RANCHI,24241,All
2021,4,BENGALURU,RANCHI,13246,8261,BENGALURU-RANCHI,21507,All
2021,6,BENGALURU,RANCHI,3751,5484,BENGALURU-RANCHI,9235,All
2021,7,BENGALURU,RANCHI,6509,9945,BENGALURU-RANCHI,16454,All
2021,8,BENGALURU,RANCHI,9154,12864,BENGALURU-RANCHI,22018,All
2021,9,BENGALURU,RANCHI,8116,10450,BENGALURU-RANCHI,18566,All
2021,10,BENGALURU,RANCHI,16006,13566,BENGALURU-RANCHI,29572,All
2021,11,BENGALURU,RANCHI,14185,16199,BENGALURU-RANCHI,30384,All
2021,12,BENGALURU,RANCHI,12891,18320,BENGALURU-RANCHI,31211,All
2022,1,BENGALURU,RANCHI,9806,8324,BENGALURU-RANCHI,18130,All
2022,2,BENGALURU,RANCHI,10778,12497,BENGALURU-RANCHI,23275,All
2022,3,BENGALURU,RANCHI,14652,16440,BENGALURU-RANCHI,31092,All
2022,4,BENGALURU,RANCHI,16244,15040,BENGALURU-RANCHI,31284,All
2022,5,BENGALURU,RANCHI,14594,21312,BENGALURU-RANCHI,35906,All
2022,6,BENGALURU,RANCHI,14830,15306,BENGALURU-RANCHI,30136,All
2022,7,BENGALURU,RANCHI,12737,14957,BENGALURU-RANCHI,27694,All
2022,8,BENGALURU,RANCHI,13767,16691,BENGALURU-RANCHI,30458,All
2022,9,BENGALURU,RANCHI,17293,13076,BENGALURU-RANCHI,30369,All
2022,10,BENGALURU,RANCHI,24690,18624,BENGALURU-RANCHI,43314,All
2022,11,BENGALURU,RANCHI,16150,22335,BENGALURU-RANCHI,38485,All
2022,12,BENGALURU,RANCHI,21902,22691,BENGALURU-RANCHI,44593,All
2023,1,BENGALURU,RANCHI,22041,22091,BENGALURU-RANCHI,44132,All
2023,2,BENGALURU,RANCHI,19905,18255,BENGALURU-RANCHI,38160,All
2023,3,BENGALURU,RANCHI,24027,22906,BENGALURU-RANCHI,46933,All
2023,4,BENGALURU,RANCHI,25309,20635,BENGALURU-RANCHI,45944,All
2023,5,BENGALURU,RANCHI,20736,22447,BENGALURU-RANCHI,43183,All
2023,6,BENGALURU,RANCHI,20781,21005,BENGALURU-RANCHI,41786,All
2023,7,BENGALURU,RANCHI,16368,20281,BENGALURU-RANCHI,36649,All
2023,8,BENGALURU,RANCHI,18144,18233,BENGALURU-RANCHI,36377,All
2023,9,BENGALURU,RANCHI,14785,15001,BENGALURU-RANCHI,29786,All
2023,10,BENGALURU,RANCHI,16885,13779,BENGALURU-RANCHI,30664,All
2023,11,BENGALURU,RANCHI,19341,16800,BENGALURU-RANCHI,36141,All
2023,12,BENGALURU,RANCHI,19554,20121,BENGALURU-RANCHI,39675,All
2024,1,BENGALURU,RANCHI,17519,18653,BENGALURU-RANCHI,36172,All
2024,2,BENGALURU,RANCHI,18489,18216,BENGALURU-RANCHI,36705,All
2024,3,BENGALURU,RANCHI,20100,17112,BENGALURU-RANCHI,37212,All
2024,4,BENGALURU,RANCHI,19845,18360,BENGALURU-RANCHI,38205,All
2024,6,BENGALURU,RANCHI,19667,19255,BENGALURU-RANCHI,38922,All
2024,7,BENGALURU,RANCHI,18087,20101,BENGALURU-RANCHI,38188,All
2024,8,BENGALURU,RANCHI,17507,19328,BENGALURU-RANCHI,36835,All
2024,9,BENGALURU,RANCHI,17140,15251,BENGALURU-RANCHI,32391,All
2024,10,BENGALURU,RANCHI,20426,14822,BENGALURU-RANCHI,35248,All
2024,11,BENGALURU,RANCHI,19067,20633,BENGALURU-RANCHI,39700,All
2024,12,BENGALURU,RANCHI,20620,21177,BENGALURU-RANCHI,41797,All
2025,1,BENGALURU,RANCHI,20493,20402,BENGALURU-RANCHI,40895,All
2025,2,BENGALURU,RANCHI,19649,18678,BENGALURU-RANCHI,38327,All
2025,3,BENGALURU,RANCHI,23185,20976,BENGALURU-RANCHI,44161,All
2023,11,BENGALURU,Rajkot International Airport,4938,4743,BENGALURU-Rajkot International Airport,9681,All
2023,12,BENGALURU,Rajkot International Airport,5148,5154,BENGALURU-Rajkot International Airport,10302,All
2024,1,BENGALURU,Rajkot International Airport,2898,2909,BENGALURU-Rajkot International Airport,5807,All
2024,2,BENGALURU,Rajkot International Airport,2675,2581,BENGALURU-Rajkot International Airport,5256,All
2024,3,BENGALURU,Rajkot International Airport,4750,4533,BENGALURU-Rajkot International Airport,9283,All
2024,4,BENGALURU,Rajkot International Airport,4672,4285,BENGALURU-Rajkot International Airport,8957,All
2024,6,BENGALURU,Rajkot International Airport,4540,4425,BENGALURU-Rajkot International Airport,8965,All
2024,7,BENGALURU,Rajkot International Airport,4672,4462,BENGALURU-Rajkot International Airport,9134,All
2024,8,BENGALURU,Rajkot International Airport,4580,4316,BENGALURU-Rajkot International Airport,8896,All
2024,9,BENGALURU,Rajkot International Airport,4987,4360,BENGALURU-Rajkot International Airport,9347,All
2024,10,BENGALURU,Rajkot International Airport,4865,4501,BENGALURU-Rajkot International Airport,9366,All
2024,11,BENGALURU,Rajkot International Airport,4990,4920,BENGALURU-Rajkot International Airport,9910,All
2024,12,BENGALURU,Rajkot International Airport,5207,5148,BENGALURU-Rajkot International Airport,10355,All
2025,1,BENGALURU,Rajkot International Airport,5203,5418,BENGALURU-Rajkot International Airport,10621,All
2025,2,BENGALURU,Rajkot International Airport,4743,4737,BENGALURU-Rajkot International Airport,9480,All
2025,3,BENGALURU,Rajkot International Airport,4747,4673,BENGALURU-Rajkot International Airport,9420,All
2023,10,BENGALURU,SALEM,225,259,BENGALURU-SALEM,484,All
2023,11,BENGALURU,SALEM,750,1078,BENGALURU-SALEM,1828,All
2023,12,BENGALURU,SALEM,934,1222,BENGALURU-SALEM,2156,All
2024,1,BENGALURU,SALEM,1080,1589,BENGALURU-SALEM,2669,All
2024,2,BENGALURU,SALEM,1484,1691,BENGALURU-SALEM,3175,All
2024,3,BENGALURU,SALEM,1588,1748,BENGALURU-SALEM,3336,All
2024,4,BENGALURU,SALEM,2043,1925,BENGALURU-SALEM,3968,All
2024,6,BENGALURU,SALEM,1968,2055,BENGALURU-SALEM,4023,All
2024,7,BENGALURU,SALEM,2000,2144,BENGALURU-SALEM,4144,All
2024,8,BENGALURU,SALEM,1919,2120,BENGALURU-SALEM,4039,All
2024,9,BENGALURU,SALEM,1814,2081,BENGALURU-SALEM,3895,All
2024,10,BENGALURU,SALEM,2041,2041,BENGALURU-SALEM,4082,All
2024,11,BENGALURU,SALEM,1571,1953,BENGALURU-SALEM,3524,All
2024,12,BENGALURU,SALEM,1733,1740,BENGALURU-SALEM,3473,All
2025,1,BENGALURU,SALEM,1828,2041,BENGALURU-SALEM,3869,All
2025,2,BENGALURU,SALEM,1025,1241,BENGALURU-SALEM,2266,All
2025,3,BENGALURU,SALEM,1725,2059,BENGALURU-SALEM,3784,All
2019,1,BENGALURU,SHIRDI,1482,1470,BENGALURU-SHIRDI,2952,All
2019,2,BENGALURU,SHIRDI,925,903,BENGALURU-SHIRDI,1828,All
2019,3,BENGALURU,SHIRDI,1797,1661,BENGALURU-SHIRDI,3458,All
2019,4,BENGALURU,SHIRDI,1688,1646,BENGALURU-SHIRDI,3334,All
2019,5,BENGALURU,SHIRDI,1859,1864,BENGALURU-SHIRDI,3723,All
2019,6,BENGALURU,SHIRDI,1756,1590,BENGALURU-SHIRDI,3346,All
2019,7,BENGALURU,SHIRDI,1797,1794,BENGALURU-SHIRDI,3591,All
2019,8,BENGALURU,SHIRDI,1889,1830,BENGALURU-SHIRDI,3719,All
2019,9,BENGALURU,SHIRDI,1685,1661,BENGALURU-SHIRDI,3346,All
2019,10,BENGALURU,SHIRDI,2109,2219,BENGALURU-SHIRDI,4328,All
2019,11,BENGALURU,SHIRDI,2063,2098,BENGALURU-SHIRDI,4161,All
2019,12,BENGALURU,SHIRDI,2495,2506,BENGALURU-SHIRDI,5001,All
2020,1,BENGALURU,SHIRDI,3926,3864,BENGALURU-SHIRDI,7790,All
2020,2,BENGALURU,SHIRDI,5536,5479,BENGALURU-SHIRDI,11015,All
2020,3,BENGALURU,SHIRDI,2704,2680,BENGALURU-SHIRDI,5384,All
2020,12,BENGALURU,SHIRDI,1957,1751,BENGALURU-SHIRDI,3708,All
2021,1,BENGALURU,SHIRDI,2587,3135,BENGALURU-SHIRDI,5722,All
2021,2,BENGALURU,SHIRDI,2855,2967,BENGALURU-SHIRDI,5822,All
2021,3,BENGALURU,SHIRDI,1536,1522,BENGALURU-SHIRDI,3058,All
2021,4,BENGALURU,SHIRDI,157,175,BENGALURU-SHIRDI,332,All
2021,10,BENGALURU,SHIRDI,897,867,BENGALURU-SHIRDI,1764,All
2021,11,BENGALURU,SHIRDI,2519,2522,BENGALURU-SHIRDI,5041,All
2021,12,BENGALURU,SHIRDI,2257,2242,BENGALURU-SHIRDI,4499,All
2022,1,BENGALURU,SHIRDI,1669,1512,BENGALURU-SHIRDI,3181,All
2022,2,BENGALURU,SHIRDI,2821,2680,BENGALURU-SHIRDI,5501,All
2022,3,BENGALURU,SHIRDI,5415,5136,BENGALURU-SHIRDI,10551,All
2022,4,BENGALURU,SHIRDI,7428,7238,BENGALURU-SHIRDI,14666,All
2022,5,BENGALURU,SHIRDI,6760,7330,BENGALURU-SHIRDI,14090,All
2022,6,BENGALURU,SHIRDI,6682,6444,BENGALURU-SHIRDI,13126,All
2022,7,BENGALURU,SHIRDI,7625,7284,BENGALURU-SHIRDI,14909,All
2022,8,BENGALURU,SHIRDI,6332,6331,BENGALURU-SHIRDI,12663,All
2022,9,BENGALURU,SHIRDI,6834,6299,BENGALURU-SHIRDI,13133,All
2022,10,BENGALURU,SHIRDI,8623,8491,BENGALURU-SHIRDI,17114,All
2022,11,BENGALURU,SHIRDI,6258,6345,BENGALURU-SHIRDI,12603,All
2022,12,BENGALURU,SHIRDI,6439,6737,BENGALURU-SHIRDI,13176,All
2023,1,BENGALURU,SHIRDI,6094,6183,BENGALURU-SHIRDI,12277,All
2023,2,BENGALURU,SHIRDI,4908,4820,BENGALURU-SHIRDI,9728,All
2023,3,BENGALURU,SHIRDI,6839,6729,BENGALURU-SHIRDI,13568,All
2023,4,BENGALURU,SHIRDI,7450,7473,BENGALURU-SHIRDI,14923,All
2023,5,BENGALURU,SHIRDI,7794,8009,BENGALURU-SHIRDI,15803,All
2023,6,BENGALURU,SHIRDI,6247,6273,BENGALURU-SHIRDI,12520,All
2023,7,BENGALURU,SHIRDI,5901,5976,BENGALURU-SHIRDI,11877,All
2023,8,BENGALURU,SHIRDI,5995,6056,BENGALURU-SHIRDI,12051,All
2023,9,BENGALURU,SHIRDI,5234,4974,BENGALURU-SHIRDI,10208,All
2023,10,BENGALURU,SHIRDI,5836,5687,BENGALURU-SHIRDI,11523,All
2023,11,BENGALURU,SHIRDI,5962,5897,BENGALURU-SHIRDI,11859,All
2023,12,BENGALURU,SHIRDI,6892,7015,BENGALURU-SHIRDI,13907,All
2024,1,BENGALURU,SHIRDI,7547,7580,BENGALURU-SHIRDI,15127,All
2024,2,BENGALURU,SHIRDI,7205,6870,BENGALURU-SHIRDI,14075,All
2024,3,BENGALURU,SHIRDI,7605,7390,BENGALURU-SHIRDI,14995,All
2024,4,BENGALURU,SHIRDI,6733,6641,BENGALURU-SHIRDI,13374,All
2024,6,BENGALURU,SHIRDI,7171,6883,BENGALURU-SHIRDI,14054,All
2024,7,BENGALURU,SHIRDI,7738,7663,BENGALURU-SHIRDI,15401,All
2024,8,BENGALURU,SHIRDI,6687,6867,BENGALURU-SHIRDI,13554,All
2024,9,BENGALURU,SHIRDI,5527,5452,BENGALURU-SHIRDI,10979,All
2024,10,BENGALURU,SHIRDI,6488,5602,BENGALURU-SHIRDI,12090,All
2024,11,BENGALURU,SHIRDI,6225,7068,BENGALURU-SHIRDI,13293,All
2024,12,BENGALURU,SHIRDI,7102,7195,BENGALURU-SHIRDI,14297,All
2025,1,BENGALURU,SHIRDI,6629,6797,BENGALURU-SHIRDI,13426,All
2025,2,BENGALURU,SHIRDI,4115,4132,BENGALURU-SHIRDI,8247,All
2025,3,BENGALURU,SHIRDI,7386,7057,BENGALURU-SHIRDI,14443,All
2017,10,BENGALURU,SILCHAR,591,351,BENGALURU-SILCHAR,942,All
2017,11,BENGALURU,SILCHAR,371,228,BENGALURU-SILCHAR,599,All
2017,12,BENGALURU,SILCHAR,410,605,BENGALURU-SILCHAR,1015,All
2018,1,BENGALURU,SILCHAR,852,471,BENGALURU-SILCHAR,1323,All
2018,2,BENGALURU,SILCHAR,690,372,BENGALURU-SILCHAR,1062,All
2018,3,BENGALURU,SILCHAR,581,267,BENGALURU-SILCHAR,848,All
2020,7,BENGALURU,SILCHAR,27,0,BENGALURU-SILCHAR,27,All
2020,8,BENGALURU,SILCHAR,1415,153,BENGALURU-SILCHAR,1568,All
2020,9,BENGALURU,SILCHAR,1505,1797,BENGALURU-SILCHAR,3302,All
2020,10,BENGALURU,SILCHAR,1598,2837,BENGALURU-SILCHAR,4435,All
2020,11,BENGALURU,SILCHAR,1871,2722,BENGALURU-SILCHAR,4593,All
2020,12,BENGALURU,SILCHAR,1966,2238,BENGALURU-SILCHAR,4204,All
2021,1,BENGALURU,SILCHAR,2348,1708,BENGALURU-SILCHAR,4056,All
2021,2,BENGALURU,SILCHAR,2175,1044,BENGALURU-SILCHAR,3219,All
2021,3,BENGALURU,SILCHAR,3837,3957,BENGALURU-SILCHAR,7794,All
2021,4,BENGALURU,SILCHAR,2584,2249,BENGALURU-SILCHAR,4833,All
2021,6,BENGALURU,SILCHAR,170,225,BENGALURU-SILCHAR,395,All
2021,7,BENGALURU,SILCHAR,1279,2198,BENGALURU-SILCHAR,3477,All
2021,8,BENGALURU,SILCHAR,1117,1443,BENGALURU-SILCHAR,2560,All
2021,9,BENGALURU,SILCHAR,1930,1897,BENGALURU-SILCHAR,3827,All
2021,10,BENGALURU,SILCHAR,2201,2271,BENGALURU-SILCHAR,4472,All
2022,1,BENGALURU,SILCHAR,309,175,BENGALURU-SILCHAR,484,All
2022,3,BENGALURU,SILCHAR,1673,1619,BENGALURU-SILCHAR,3292,All
2022,10,BENGALURU,SILCHAR,0,16,BENGALURU-SILCHAR,16,All
2022,11,BENGALURU,SILCHAR,325,376,BENGALURU-SILCHAR,701,All
2022,12,BENGALURU,SILCHAR,344,436,BENGALURU-SILCHAR,780,All
2023,1,BENGALURU,SILCHAR,759,508,BENGALURU-SILCHAR,1267,All
2023,2,BENGALURU,SILCHAR,533,461,BENGALURU-SILCHAR,994,All
2023,3,BENGALURU,SILCHAR,597,491,BENGALURU-SILCHAR,1088,All
2023,4,BENGALURU,SILCHAR,563,386,BENGALURU-SILCHAR,949,All
2023,5,BENGALURU,SILCHAR,363,463,BENGALURU-SILCHAR,826,All
2023,6,BENGALURU,SILCHAR,407,189,BENGALURU-SILCHAR,596,All
2023,7,BENGALURU,SILCHAR,285,435,BENGALURU-SILCHAR,720,All
2023,8,BENGALURU,SILCHAR,266,225,BENGALURU-SILCHAR,491,All
2023,9,BENGALURU,SILCHAR,261,168,BENGALURU-SILCHAR,429,All
2023,10,BENGALURU,SILCHAR,276,112,BENGALURU-SILCHAR,388,All
2015,4,BENGALURU,SRINAGAR,792,782,BENGALURU-SRINAGAR,1574,All
2015,5,BENGALURU,SRINAGAR,803,881,BENGALURU-SRINAGAR,1684,All
2015,6,BENGALURU,SRINAGAR,240,512,BENGALURU-SRINAGAR,752,All
2015,7,BENGALURU,SRINAGAR,1396,1011,BENGALURU-SRINAGAR,2407,All
2015,8,BENGALURU,SRINAGAR,1051,1265,BENGALURU-SRINAGAR,2316,All
2015,9,BENGALURU,SRINAGAR,1265,1143,BENGALURU-SRINAGAR,2408,All
2015,9,BENGALURU,SRINAGAR,58,44,BENGALURU-SRINAGAR,102,All
2015,10,BENGALURU,SRINAGAR,1043,1361,BENGALURU-SRINAGAR,2404,All
2015,11,BENGALURU,SRINAGAR,408,862,BENGALURU-SRINAGAR,1270,All
2015,12,BENGALURU,SRINAGAR,729,890,BENGALURU-SRINAGAR,1619,All
2016,1,BENGALURU,SRINAGAR,663,1056,BENGALURU-SRINAGAR,1719,All
2016,2,BENGALURU,SRINAGAR,601,675,BENGALURU-SRINAGAR,1276,All
2016,3,BENGALURU,SRINAGAR,773,692,BENGALURU-SRINAGAR,1465,All
2016,4,BENGALURU,SRINAGAR,1171,899,BENGALURU-SRINAGAR,2070,All
2016,5,BENGALURU,SRINAGAR,849,1096,BENGALURU-SRINAGAR,1945,All
2016,6,BENGALURU,SRINAGAR,145,210,BENGALURU-SRINAGAR,355,All
2016,7,BENGALURU,SRINAGAR,177,166,BENGALURU-SRINAGAR,343,All
2016,8,BENGALURU,SRINAGAR,170,271,BENGALURU-SRINAGAR,441,All
2016,9,BENGALURU,SRINAGAR,191,180,BENGALURU-SRINAGAR,371,All
2016,10,BENGALURU,SRINAGAR,197,280,BENGALURU-SRINAGAR,477,All
2016,11,BENGALURU,SRINAGAR,332,297,BENGALURU-SRINAGAR,629,All
2016,12,BENGALURU,SRINAGAR,598,650,BENGALURU-SRINAGAR,1248,All
2017,1,BENGALURU,SRINAGAR,710,452,BENGALURU-SRINAGAR,1162,All
2017,2,BENGALURU,SRINAGAR,1107,606,BENGALURU-SRINAGAR,1713,All
2017,3,BENGALURU,SRINAGAR,1019,680,BENGALURU-SRINAGAR,1699,All
2017,4,BENGALURU,SRINAGAR,884,495,BENGALURU-SRINAGAR,1379,All
2017,5,BENGALURU,SRINAGAR,602,394,BENGALURU-SRINAGAR,996,All
2017,6,BENGALURU,SRINAGAR,399,259,BENGALURU-SRINAGAR,658,All
2017,7,BENGALURU,SRINAGAR,739,663,BENGALURU-SRINAGAR,1402,All
2017,8,BENGALURU,SRINAGAR,930,1026,BENGALURU-SRINAGAR,1956,All
2017,9,BENGALURU,SRINAGAR,1100,876,BENGALURU-SRINAGAR,1976,All
2017,10,BENGALURU,SRINAGAR,1437,1822,BENGALURU-SRINAGAR,3259,All
2017,11,BENGALURU,SRINAGAR,1578,1971,BENGALURU-SRINAGAR,3549,All
2017,12,BENGALURU,SRINAGAR,1778,2362,BENGALURU-SRINAGAR,4140,All
2018,1,BENGALURU,SRINAGAR,1758,2112,BENGALURU-SRINAGAR,3870,All
2018,2,BENGALURU,SRINAGAR,1761,938,BENGALURU-SRINAGAR,2699,All
2018,3,BENGALURU,SRINAGAR,1904,652,BENGALURU-SRINAGAR,2556,All
2018,4,BENGALURU,SRINAGAR,2784,2010,BENGALURU-SRINAGAR,4794,All
2018,5,BENGALURU,SRINAGAR,2461,2422,BENGALURU-SRINAGAR,4883,All
2018,6,BENGALURU,SRINAGAR,1977,1598,BENGALURU-SRINAGAR,3575,All
2018,7,BENGALURU,SRINAGAR,2052,1034,BENGALURU-SRINAGAR,3086,All
2018,8,BENGALURU,SRINAGAR,2260,1466,BENGALURU-SRINAGAR,3726,All
2018,9,BENGALURU,SRINAGAR,1447,1123,BENGALURU-SRINAGAR,2570,All
2018,10,BENGALURU,SRINAGAR,2374,1877,BENGALURU-SRINAGAR,4251,All
2018,11,BENGALURU,SRINAGAR,2216,1882,BENGALURU-SRINAGAR,4098,All
2018,12,BENGALURU,SRINAGAR,2508,2430,BENGALURU-SRINAGAR,4938,All
2019,1,BENGALURU,SRINAGAR,1502,1831,BENGALURU-SRINAGAR,3333,All
2019,2,BENGALURU,SRINAGAR,3429,2239,BENGALURU-SRINAGAR,5668,All
2019,3,BENGALURU,SRINAGAR,5151,2938,BENGALURU-SRINAGAR,8089,All
2019,4,BENGALURU,SRINAGAR,5315,4261,BENGALURU-SRINAGAR,9576,All
2019,5,BENGALURU,SRINAGAR,5778,5129,BENGALURU-SRINAGAR,10907,All
2019,6,BENGALURU,SRINAGAR,6048,5528,BENGALURU-SRINAGAR,11576,All
2019,7,BENGALURU,SRINAGAR,6207,6004,BENGALURU-SRINAGAR,12211,All
2019,8,BENGALURU,SRINAGAR,1864,3028,BENGALURU-SRINAGAR,4892,All
2019,9,BENGALURU,SRINAGAR,643,965,BENGALURU-SRINAGAR,1608,All
2019,10,BENGALURU,SRINAGAR,726,893,BENGALURU-SRINAGAR,1619,All
2019,11,BENGALURU,SRINAGAR,1124,1112,BENGALURU-SRINAGAR,2236,All
2019,12,BENGALURU,SRINAGAR,999,1417,BENGALURU-SRINAGAR,2416,All
2020,1,BENGALURU,SRINAGAR,1782,1687,BENGALURU-SRINAGAR,3469,All
2020,2,BENGALURU,SRINAGAR,2275,1568,BENGALURU-SRINAGAR,3843,All
2020,3,BENGALURU,SRINAGAR,2667,548,BENGALURU-SRINAGAR,3215,All
2020,6,BENGALURU,SRINAGAR,307,0,BENGALURU-SRINAGAR,307,All
2021,3,BENGALURU,SRINAGAR,811,233,BENGALURU-SRINAGAR,1044,All
2021,4,BENGALURU,SRINAGAR,2840,1867,BENGALURU-SRINAGAR,4707,All
2021,6,BENGALURU,SRINAGAR,294,216,BENGALURU-SRINAGAR,510,All
2021,7,BENGALURU,SRINAGAR,1585,1366,BENGALURU-SRINAGAR,2951,All
2021,8,BENGALURU,SRINAGAR,1758,1787,BENGALURU-SRINAGAR,3545,All
2021,9,BENGALURU,SRINAGAR,1544,934,BENGALURU-SRINAGAR,2478,All
2021,10,BENGALURU,SRINAGAR,1513,917,BENGALURU-SRINAGAR,2430,All
2021,11,BENGALURU,SRINAGAR,1163,876,BENGALURU-SRINAGAR,2039,All
2021,12,BENGALURU,SRINAGAR,1178,957,BENGALURU-SRINAGAR,2135,All
2022,1,BENGALURU,SRINAGAR,1651,1116,BENGALURU-SRINAGAR,2767,All
2022,2,BENGALURU,SRINAGAR,1421,948,BENGALURU-SRINAGAR,2369,All
2022,3,BENGALURU,SRINAGAR,1561,1564,BENGALURU-SRINAGAR,3125,All
2022,4,BENGALURU,SRINAGAR,1738,2134,BENGALURU-SRINAGAR,3872,All
2022,5,BENGALURU,SRINAGAR,2493,2281,BENGALURU-SRINAGAR,4774,All
2022,6,BENGALURU,SRINAGAR,2145,1528,BENGALURU-SRINAGAR,3673,All
2022,7,BENGALURU,SRINAGAR,2114,1900,BENGALURU-SRINAGAR,4014,All
2022,8,BENGALURU,SRINAGAR,1195,1387,BENGALURU-SRINAGAR,2582,All
2022,9,BENGALURU,SRINAGAR,850,902,BENGALURU-SRINAGAR,1752,All
2022,10,BENGALURU,SRINAGAR,930,1622,BENGALURU-SRINAGAR,2552,All
2022,11,BENGALURU,SRINAGAR,681,1367,BENGALURU-SRINAGAR,2048,All
2022,12,BENGALURU,SRINAGAR,1422,1908,BENGALURU-SRINAGAR,3330,All
2023,1,BENGALURU,SRINAGAR,1206,1827,BENGALURU-SRINAGAR,3033,All
2023,2,BENGALURU,SRINAGAR,1096,1400,BENGALURU-SRINAGAR,2496,All
2023,3,BENGALURU,SRINAGAR,2046,1541,BENGALURU-SRINAGAR,3587,All
2023,4,BENGALURU,SRINAGAR,3214,2598,BENGALURU-SRINAGAR,5812,All
2023,5,BENGALURU,SRINAGAR,3626,3778,BENGALURU-SRINAGAR,7404,All
2023,6,BENGALURU,SRINAGAR,2961,2854,BENGALURU-SRINAGAR,5815,All
2023,7,BENGALURU,SRINAGAR,2331,2502,BENGALURU-SRINAGAR,4833,All
2023,8,BENGALURU,SRINAGAR,1658,1786,BENGALURU-SRINAGAR,3444,All
2023,9,BENGALURU,SRINAGAR,1114,1184,BENGALURU-SRINAGAR,2298,All
2023,10,BENGALURU,SRINAGAR,1741,2185,BENGALURU-SRINAGAR,3926,All
2023,11,BENGALURU,SRINAGAR,1307,2046,BENGALURU-SRINAGAR,3353,All
2023,12,BENGALURU,SRINAGAR,1722,2563,BENGALURU-SRINAGAR,4285,All
2024,1,BENGALURU,SRINAGAR,1281,1538,BENGALURU-SRINAGAR,2819,All
2024,2,BENGALURU,SRINAGAR,1439,971,BENGALURU-SRINAGAR,2410,All
2024,3,BENGALURU,SRINAGAR,1550,1240,BENGALURU-SRINAGAR,2790,All
2024,4,BENGALURU,SRINAGAR,8268,8145,BENGALURU-SRINAGAR,16413,All
2024,6,BENGALURU,SRINAGAR,6885,7698,BENGALURU-SRINAGAR,14583,All
2024,7,BENGALURU,SRINAGAR,5495,6765,BENGALURU-SRINAGAR,12260,All
2024,8,BENGALURU,SRINAGAR,5040,5579,BENGALURU-SRINAGAR,10619,All
2024,9,BENGALURU,SRINAGAR,5516,5439,BENGALURU-SRINAGAR,10955,All
2024,10,BENGALURU,SRINAGAR,5339,5334,BENGALURU-SRINAGAR,10673,All
2024,11,BENGALURU,SRINAGAR,4547,5687,BENGALURU-SRINAGAR,10234,All
2024,12,BENGALURU,SRINAGAR,5704,6175,BENGALURU-SRINAGAR,11879,All
2025,1,BENGALURU,SRINAGAR,5958,6036,BENGALURU-SRINAGAR,11994,All
2025,2,BENGALURU,SRINAGAR,6123,5958,BENGALURU-SRINAGAR,12081,All
2025,3,BENGALURU,SRINAGAR,9276,8186,BENGALURU-SRINAGAR,17462,All
2018,3,BENGALURU,SURAT,0,78,BENGALURU-SURAT,78,All
2018,6,BENGALURU,SURAT,8148,4571,BENGALURU-SURAT,12719,All
2018,7,BENGALURU,SURAT,10140,3932,BENGALURU-SURAT,14072,All
2018,8,BENGALURU,SURAT,4877,4996,BENGALURU-SURAT,9873,All
2018,9,BENGALURU,SURAT,5174,5829,BENGALURU-SURAT,11003,All
2018,10,BENGALURU,SURAT,6635,7093,BENGALURU-SURAT,13728,All
2018,11,BENGALURU,SURAT,8208,8501,BENGALURU-SURAT,16709,All
2018,12,BENGALURU,SURAT,8272,8611,BENGALURU-SURAT,16883,All
2019,1,BENGALURU,SURAT,5914,6377,BENGALURU-SURAT,12291,All
2019,2,BENGALURU,SURAT,4376,4847,BENGALURU-SURAT,9223,All
2019,3,BENGALURU,SURAT,6458,6445,BENGALURU-SURAT,12903,All
2019,4,BENGALURU,SURAT,7954,6984,BENGALURU-SURAT,14938,All
2019,5,BENGALURU,SURAT,9030,10512,BENGALURU-SURAT,19542,All
2019,6,BENGALURU,SURAT,7209,7314,BENGALURU-SURAT,14523,All
2019,7,BENGALURU,SURAT,5571,6252,BENGALURU-SURAT,11823,All
2019,8,BENGALURU,SURAT,7505,7013,BENGALURU-SURAT,14518,All
2019,9,BENGALURU,SURAT,4065,3927,BENGALURU-SURAT,7992,All
2019,10,BENGALURU,SURAT,5576,6566,BENGALURU-SURAT,12142,All
2019,11,BENGALURU,SURAT,9413,6989,BENGALURU-SURAT,16402,All
2019,12,BENGALURU,SURAT,4975,4651,BENGALURU-SURAT,9626,All
2020,1,BENGALURU,SURAT,5535,5365,BENGALURU-SURAT,10900,All
2020,2,BENGALURU,SURAT,5958,5808,BENGALURU-SURAT,11766,All
2020,3,BENGALURU,SURAT,4215,2911,BENGALURU-SURAT,7126,All
2020,6,BENGALURU,SURAT,0,0,BENGALURU-SURAT,0,All
2020,7,BENGALURU,SURAT,253,166,BENGALURU-SURAT,419,All
2020,8,BENGALURU,SURAT,1508,1616,BENGALURU-SURAT,3124,All
2020,9,BENGALURU,SURAT,3524,3581,BENGALURU-SURAT,7105,All
2020,10,BENGALURU,SURAT,4824,4922,BENGALURU-SURAT,9746,All
2020,11,BENGALURU,SURAT,4737,5520,BENGALURU-SURAT,10257,All
2020,12,BENGALURU,SURAT,4310,4788,BENGALURU-SURAT,9098,All
2021,1,BENGALURU,SURAT,7177,6705,BENGALURU-SURAT,13882,All
2021,2,BENGALURU,SURAT,7578,6773,BENGALURU-SURAT,14351,All
2021,3,BENGALURU,SURAT,6876,6013,BENGALURU-SURAT,12889,All
2021,4,BENGALURU,SURAT,3929,2031,BENGALURU-SURAT,5960,All
2021,6,BENGALURU,SURAT,1472,2446,BENGALURU-SURAT,3918,All
2021,7,BENGALURU,SURAT,3174,4759,BENGALURU-SURAT,7933,All
2021,8,BENGALURU,SURAT,4838,4405,BENGALURU-SURAT,9243,All
2021,9,BENGALURU,SURAT,4501,4282,BENGALURU-SURAT,8783,All
2021,10,BENGALURU,SURAT,5010,4515,BENGALURU-SURAT,9525,All
2021,11,BENGALURU,SURAT,7424,5957,BENGALURU-SURAT,13381,All
2021,12,BENGALURU,SURAT,7787,9129,BENGALURU-SURAT,16916,All
2022,1,BENGALURU,SURAT,4840,4460,BENGALURU-SURAT,9300,All
2022,2,BENGALURU,SURAT,3413,3401,BENGALURU-SURAT,6814,All
2022,3,BENGALURU,SURAT,5843,6059,BENGALURU-SURAT,11902,All
2022,4,BENGALURU,SURAT,6375,6461,BENGALURU-SURAT,12836,All
2022,5,BENGALURU,SURAT,6437,8178,BENGALURU-SURAT,14615,All
2022,6,BENGALURU,SURAT,5698,5507,BENGALURU-SURAT,11205,All
2022,7,BENGALURU,SURAT,5180,4989,BENGALURU-SURAT,10169,All
2022,8,BENGALURU,SURAT,5247,5152,BENGALURU-SURAT,10399,All
2022,9,BENGALURU,SURAT,4608,4002,BENGALURU-SURAT,8610,All
2022,10,BENGALURU,SURAT,4893,4894,BENGALURU-SURAT,9787,All
2022,11,BENGALURU,SURAT,6382,5431,BENGALURU-SURAT,11813,All
2022,12,BENGALURU,SURAT,5831,6246,BENGALURU-SURAT,12077,All
2023,1,BENGALURU,SURAT,5866,6562,BENGALURU-SURAT,12428,All
2023,2,BENGALURU,SURAT,6449,6291,BENGALURU-SURAT,12740,All
2023,3,BENGALURU,SURAT,11684,10534,BENGALURU-SURAT,22218,All
2023,4,BENGALURU,SURAT,11456,9572,BENGALURU-SURAT,21028,All
2023,5,BENGALURU,SURAT,10646,12276,BENGALURU-SURAT,22922,All
2023,6,BENGALURU,SURAT,10876,10093,BENGALURU-SURAT,20969,All
2023,7,BENGALURU,SURAT,7730,8464,BENGALURU-SURAT,16194,All
2023,8,BENGALURU,SURAT,10207,8864,BENGALURU-SURAT,19071,All
2023,9,BENGALURU,SURAT,9946,9240,BENGALURU-SURAT,19186,All
2023,10,BENGALURU,SURAT,10058,8815,BENGALURU-SURAT,18873,All
2023,11,BENGALURU,SURAT,10266,9622,BENGALURU-SURAT,19888,All
2023,12,BENGALURU,SURAT,10283,10636,BENGALURU-SURAT,20919,All
2024,1,BENGALURU,SURAT,10367,10536,BENGALURU-SURAT,20903,All
2024,2,BENGALURU,SURAT,10366,10370,BENGALURU-SURAT,20736,All
2024,3,BENGALURU,SURAT,10384,10145,BENGALURU-SURAT,20529,All
2024,4,BENGALURU,SURAT,10679,10528,BENGALURU-SURAT,21207,All
2024,6,BENGALURU,SURAT,11272,10790,BENGALURU-SURAT,22062,All
2024,7,BENGALURU,SURAT,11545,10929,BENGALURU-SURAT,22474,All
2024,8,BENGALURU,SURAT,11142,10610,BENGALURU-SURAT,21752,All
2024,9,BENGALURU,SURAT,11827,11149,BENGALURU-SURAT,22976,All
2024,10,BENGALURU,SURAT,11580,11143,BENGALURU-SURAT,22723,All
2024,11,BENGALURU,SURAT,10531,10688,BENGALURU-SURAT,21219,All
2024,12,BENGALURU,SURAT,10386,10481,BENGALURU-SURAT,20867,All
2025,1,BENGALURU,SURAT,14663,15358,BENGALURU-SURAT,30021,All
2025,2,BENGALURU,SURAT,12021,11908,BENGALURU-SURAT,23929,All
2025,3,BENGALURU,SURAT,13414,12917,BENGALURU-SURAT,26331,All
2023,11,BENGALURU,Shivamogga Airport,1379,1356,BENGALURU-Shivamogga Airport,2735,All
2023,12,BENGALURU,Shivamogga Airport,1655,1593,BENGALURU-Shivamogga Airport,3248,All
2024,1,BENGALURU,Shivamogga Airport,1354,1564,BENGALURU-Shivamogga Airport,2918,All
2024,2,BENGALURU,Shivamogga Airport,1576,1539,BENGALURU-Shivamogga Airport,3115,All
2024,3,BENGALURU,Shivamogga Airport,1428,1267,BENGALURU-Shivamogga Airport,2695,All
2024,4,BENGALURU,Shivamogga Airport,1580,1705,BENGALURU-Shivamogga Airport,3285,All
2024,6,BENGALURU,Shivamogga Airport,1010,958,BENGALURU-Shivamogga Airport,1968,All
2024,7,BENGALURU,Shivamogga Airport,1260,1287,BENGALURU-Shivamogga Airport,2547,All
2024,8,BENGALURU,Shivamogga Airport,1381,1249,BENGALURU-Shivamogga Airport,2630,All
2024,9,BENGALURU,Shivamogga Airport,1347,1436,BENGALURU-Shivamogga Airport,2783,All
2024,10,BENGALURU,Shivamogga Airport,1575,1408,BENGALURU-Shivamogga Airport,2983,All
2024,11,BENGALURU,Shivamogga Airport,1512,1557,BENGALURU-Shivamogga Airport,3069,All
2024,12,BENGALURU,Shivamogga Airport,1695,1535,BENGALURU-Shivamogga Airport,3230,All
2025,1,BENGALURU,Shivamogga Airport,1469,1622,BENGALURU-Shivamogga Airport,3091,All
2025,2,BENGALURU,Shivamogga Airport,936,1077,BENGALURU-Shivamogga Airport,2013,All
2025,3,BENGALURU,Shivamogga Airport,1603,1703,BENGALURU-Shivamogga Airport,3306,All
2018,6,BENGALURU,TIRUCHIRAPALLY,148,55,BENGALURU-TIRUCHIRAPALLY,203,All
2018,7,BENGALURU,TIRUCHIRAPALLY,1351,1178,BENGALURU-TIRUCHIRAPALLY,2529,All
2018,8,BENGALURU,TIRUCHIRAPALLY,849,808,BENGALURU-TIRUCHIRAPALLY,1657,All
2018,9,BENGALURU,TIRUCHIRAPALLY,1585,1798,BENGALURU-TIRUCHIRAPALLY,3383,All
2018,10,BENGALURU,TIRUCHIRAPALLY,1665,1444,BENGALURU-TIRUCHIRAPALLY,3109,All
2018,11,BENGALURU,TIRUCHIRAPALLY,1745,1725,BENGALURU-TIRUCHIRAPALLY,3470,All
2018,12,BENGALURU,TIRUCHIRAPALLY,2134,2014,BENGALURU-TIRUCHIRAPALLY,4148,All
2019,1,BENGALURU,TIRUCHIRAPALLY,1958,2004,BENGALURU-TIRUCHIRAPALLY,3962,All
2019,2,BENGALURU,TIRUCHIRAPALLY,1351,1347,BENGALURU-TIRUCHIRAPALLY,2698,All
2019,3,BENGALURU,TIRUCHIRAPALLY,2011,2000,BENGALURU-TIRUCHIRAPALLY,4011,All
2019,4,BENGALURU,TIRUCHIRAPALLY,1955,1852,BENGALURU-TIRUCHIRAPALLY,3807,All
2019,5,BENGALURU,TIRUCHIRAPALLY,2095,2111,BENGALURU-TIRUCHIRAPALLY,4206,All
2019,6,BENGALURU,TIRUCHIRAPALLY,1902,1867,BENGALURU-TIRUCHIRAPALLY,3769,All
2019,7,BENGALURU,TIRUCHIRAPALLY,2073,2073,BENGALURU-TIRUCHIRAPALLY,4146,All
2019,8,BENGALURU,TIRUCHIRAPALLY,1936,1923,BENGALURU-TIRUCHIRAPALLY,3859,All
2019,9,BENGALURU,TIRUCHIRAPALLY,1893,2049,BENGALURU-TIRUCHIRAPALLY,3942,All
2019,10,BENGALURU,TIRUCHIRAPALLY,1814,1729,BENGALURU-TIRUCHIRAPALLY,3543,All
2019,11,BENGALURU,TIRUCHIRAPALLY,2283,2471,BENGALURU-TIRUCHIRAPALLY,4754,All
2019,12,BENGALURU,TIRUCHIRAPALLY,3654,3870,BENGALURU-TIRUCHIRAPALLY,7524,All
2020,1,BENGALURU,TIRUCHIRAPALLY,4202,3944,BENGALURU-TIRUCHIRAPALLY,8146,All
2020,2,BENGALURU,TIRUCHIRAPALLY,3442,3532,BENGALURU-TIRUCHIRAPALLY,6974,All
2020,3,BENGALURU,TIRUCHIRAPALLY,2197,1899,BENGALURU-TIRUCHIRAPALLY,4096,All
2020,5,BENGALURU,TIRUCHIRAPALLY,491,286,BENGALURU-TIRUCHIRAPALLY,777,All
2020,6,BENGALURU,TIRUCHIRAPALLY,815,559,BENGALURU-TIRUCHIRAPALLY,1374,All
2020,7,BENGALURU,TIRUCHIRAPALLY,1544,948,BENGALURU-TIRUCHIRAPALLY,2492,All
2020,8,BENGALURU,TIRUCHIRAPALLY,3456,1771,BENGALURU-TIRUCHIRAPALLY,5227,All
2020,9,BENGALURU,TIRUCHIRAPALLY,4298,2973,BENGALURU-TIRUCHIRAPALLY,7271,All
2020,10,BENGALURU,TIRUCHIRAPALLY,5136,3358,BENGALURU-TIRUCHIRAPALLY,8494,All
2020,11,BENGALURU,TIRUCHIRAPALLY,3794,2577,BENGALURU-TIRUCHIRAPALLY,6371,All
2020,12,BENGALURU,TIRUCHIRAPALLY,4167,2666,BENGALURU-TIRUCHIRAPALLY,6833,All
2021,1,BENGALURU,TIRUCHIRAPALLY,4006,3019,BENGALURU-TIRUCHIRAPALLY,7025,All
2021,2,BENGALURU,TIRUCHIRAPALLY,2570,2072,BENGALURU-TIRUCHIRAPALLY,4642,All
2021,3,BENGALURU,TIRUCHIRAPALLY,2163,1654,BENGALURU-TIRUCHIRAPALLY,3817,All
2021,4,BENGALURU,TIRUCHIRAPALLY,1675,1458,BENGALURU-TIRUCHIRAPALLY,3133,All
2021,6,BENGALURU,TIRUCHIRAPALLY,1312,593,BENGALURU-TIRUCHIRAPALLY,1905,All
2021,7,BENGALURU,TIRUCHIRAPALLY,1687,1197,BENGALURU-TIRUCHIRAPALLY,2884,All
2021,8,BENGALURU,TIRUCHIRAPALLY,2054,1645,BENGALURU-TIRUCHIRAPALLY,3699,All
2021,9,BENGALURU,TIRUCHIRAPALLY,1709,1519,BENGALURU-TIRUCHIRAPALLY,3228,All
2021,10,BENGALURU,TIRUCHIRAPALLY,2383,2182,BENGALURU-TIRUCHIRAPALLY,4565,All
2021,11,BENGALURU,TIRUCHIRAPALLY,2670,2930,BENGALURU-TIRUCHIRAPALLY,5600,All
2021,12,BENGALURU,TIRUCHIRAPALLY,3307,2777,BENGALURU-TIRUCHIRAPALLY,6084,All
2022,1,BENGALURU,TIRUCHIRAPALLY,1959,1384,BENGALURU-TIRUCHIRAPALLY,3343,All
2022,2,BENGALURU,TIRUCHIRAPALLY,1514,1164,BENGALURU-TIRUCHIRAPALLY,2678,All
2022,3,BENGALURU,TIRUCHIRAPALLY,3971,3695,BENGALURU-TIRUCHIRAPALLY,7666,All
2022,4,BENGALURU,TIRUCHIRAPALLY,3341,3176,BENGALURU-TIRUCHIRAPALLY,6517,All
2022,5,BENGALURU,TIRUCHIRAPALLY,3871,3527,BENGALURU-TIRUCHIRAPALLY,7398,All
2022,6,BENGALURU,TIRUCHIRAPALLY,4025,3657,BENGALURU-TIRUCHIRAPALLY,7682,All
2022,7,BENGALURU,TIRUCHIRAPALLY,3932,3699,BENGALURU-TIRUCHIRAPALLY,7631,All
2022,8,BENGALURU,TIRUCHIRAPALLY,4111,3795,BENGALURU-TIRUCHIRAPALLY,7906,All
2022,9,BENGALURU,TIRUCHIRAPALLY,3878,3828,BENGALURU-TIRUCHIRAPALLY,7706,All
2022,10,BENGALURU,TIRUCHIRAPALLY,4062,3709,BENGALURU-TIRUCHIRAPALLY,7771,All
2022,11,BENGALURU,TIRUCHIRAPALLY,4615,5631,BENGALURU-TIRUCHIRAPALLY,10246,All
2022,12,BENGALURU,TIRUCHIRAPALLY,5799,5411,BENGALURU-TIRUCHIRAPALLY,11210,All
2023,1,BENGALURU,TIRUCHIRAPALLY,5977,5425,BENGALURU-TIRUCHIRAPALLY,11402,All
2023,2,BENGALURU,TIRUCHIRAPALLY,4895,4624,BENGALURU-TIRUCHIRAPALLY,9519,All
2023,3,BENGALURU,TIRUCHIRAPALLY,5676,5259,BENGALURU-TIRUCHIRAPALLY,10935,All
2023,4,BENGALURU,TIRUCHIRAPALLY,3992,3681,BENGALURU-TIRUCHIRAPALLY,7673,All
2023,5,BENGALURU,TIRUCHIRAPALLY,4286,4107,BENGALURU-TIRUCHIRAPALLY,8393,All
2023,6,BENGALURU,TIRUCHIRAPALLY,4160,3940,BENGALURU-TIRUCHIRAPALLY,8100,All
2023,7,BENGALURU,TIRUCHIRAPALLY,5761,5705,BENGALURU-TIRUCHIRAPALLY,11466,All
2023,8,BENGALURU,TIRUCHIRAPALLY,6061,5909,BENGALURU-TIRUCHIRAPALLY,11970,All
2023,9,BENGALURU,TIRUCHIRAPALLY,5561,5511,BENGALURU-TIRUCHIRAPALLY,11072,All
2023,10,BENGALURU,TIRUCHIRAPALLY,5657,5286,BENGALURU-TIRUCHIRAPALLY,10943,All
2023,11,BENGALURU,TIRUCHIRAPALLY,4855,5103,BENGALURU-TIRUCHIRAPALLY,9958,All
2023,12,BENGALURU,TIRUCHIRAPALLY,5799,5989,BENGALURU-TIRUCHIRAPALLY,11788,All
2024,1,BENGALURU,TIRUCHIRAPALLY,6035,6138,BENGALURU-TIRUCHIRAPALLY,12173,All
2024,2,BENGALURU,TIRUCHIRAPALLY,5457,5473,BENGALURU-TIRUCHIRAPALLY,10930,All
2024,3,BENGALURU,TIRUCHIRAPALLY,5718,5408,BENGALURU-TIRUCHIRAPALLY,11126,All
2024,4,BENGALURU,TIRUCHIRAPALLY,6470,6341,BENGALURU-TIRUCHIRAPALLY,12811,All
2024,6,BENGALURU,TIRUCHIRAPALLY,7211,6804,BENGALURU-TIRUCHIRAPALLY,14015,All
2024,7,BENGALURU,TIRUCHIRAPALLY,7193,7065,BENGALURU-TIRUCHIRAPALLY,14258,All
2024,8,BENGALURU,TIRUCHIRAPALLY,7248,7158,BENGALURU-TIRUCHIRAPALLY,14406,All
2024,9,BENGALURU,TIRUCHIRAPALLY,6479,6920,BENGALURU-TIRUCHIRAPALLY,13399,All
2024,10,BENGALURU,TIRUCHIRAPALLY,5645,4429,BENGALURU-TIRUCHIRAPALLY,10074,All
2024,11,BENGALURU,TIRUCHIRAPALLY,4632,5343,BENGALURU-TIRUCHIRAPALLY,9975,All
2024,12,BENGALURU,TIRUCHIRAPALLY,5935,5233,BENGALURU-TIRUCHIRAPALLY,11168,All
2025,1,BENGALURU,TIRUCHIRAPALLY,6135,5668,BENGALURU-TIRUCHIRAPALLY,11803,All
2025,2,BENGALURU,TIRUCHIRAPALLY,3987,4122,BENGALURU-TIRUCHIRAPALLY,8109,All
2025,3,BENGALURU,TIRUCHIRAPALLY,5485,5210,BENGALURU-TIRUCHIRAPALLY,10695,All
2015,12,BENGALURU,TIRUPATI,9,58,BENGALURU-TIRUPATI,67,All
2018,1,BENGALURU,TIRUPATI,2569,2407,BENGALURU-TIRUPATI,4976,All
2018,2,BENGALURU,TIRUPATI,2858,2691,BENGALURU-TIRUPATI,5549,All
2018,3,BENGALURU,TIRUPATI,5917,5689,BENGALURU-TIRUPATI,11606,All
2018,4,BENGALURU,TIRUPATI,4889,4734,BENGALURU-TIRUPATI,9623,All
2018,5,BENGALURU,TIRUPATI,4148,4273,BENGALURU-TIRUPATI,8421,All
2018,6,BENGALURU,TIRUPATI,4162,4117,BENGALURU-TIRUPATI,8279,All
2018,7,BENGALURU,TIRUPATI,4120,3969,BENGALURU-TIRUPATI,8089,All
2018,8,BENGALURU,TIRUPATI,3497,3360,BENGALURU-TIRUPATI,6857,All
2018,9,BENGALURU,TIRUPATI,3091,3069,BENGALURU-TIRUPATI,6160,All
2018,10,BENGALURU,TIRUPATI,2969,2933,BENGALURU-TIRUPATI,5902,All
2018,11,BENGALURU,TIRUPATI,3032,3103,BENGALURU-TIRUPATI,6135,All
2018,12,BENGALURU,TIRUPATI,3768,3307,BENGALURU-TIRUPATI,7075,All
2019,1,BENGALURU,TIRUPATI,3203,3412,BENGALURU-TIRUPATI,6615,All
2019,2,BENGALURU,TIRUPATI,2875,2919,BENGALURU-TIRUPATI,5794,All
2019,3,BENGALURU,TIRUPATI,4011,3899,BENGALURU-TIRUPATI,7910,All
2019,4,BENGALURU,TIRUPATI,3893,3782,BENGALURU-TIRUPATI,7675,All
2019,5,BENGALURU,TIRUPATI,3767,3786,BENGALURU-TIRUPATI,7553,All
2019,6,BENGALURU,TIRUPATI,3973,3769,BENGALURU-TIRUPATI,7742,All
2019,7,BENGALURU,TIRUPATI,3764,3900,BENGALURU-TIRUPATI,7664,All
2019,8,BENGALURU,TIRUPATI,3930,3897,BENGALURU-TIRUPATI,7827,All
2019,9,BENGALURU,TIRUPATI,3519,3426,BENGALURU-TIRUPATI,6945,All
2019,10,BENGALURU,TIRUPATI,3649,3191,BENGALURU-TIRUPATI,6840,All
2019,11,BENGALURU,TIRUPATI,1956,2058,BENGALURU-TIRUPATI,4014,All
2019,12,BENGALURU,TIRUPATI,2202,2130,BENGALURU-TIRUPATI,4332,All
2020,1,BENGALURU,TIRUPATI,2156,1181,BENGALURU-TIRUPATI,3337,All
2020,2,BENGALURU,TIRUPATI,2103,2102,BENGALURU-TIRUPATI,4205,All
2020,3,BENGALURU,TIRUPATI,1373,1433,BENGALURU-TIRUPATI,2806,All
2020,5,BENGALURU,TIRUPATI,177,123,BENGALURU-TIRUPATI,300,All
2020,6,BENGALURU,TIRUPATI,394,515,BENGALURU-TIRUPATI,909,All
2020,7,BENGALURU,TIRUPATI,302,571,BENGALURU-TIRUPATI,873,All
2020,8,BENGALURU,TIRUPATI,247,522,BENGALURU-TIRUPATI,769,All
2020,9,BENGALURU,TIRUPATI,300,405,BENGALURU-TIRUPATI,705,All
2020,12,BENGALURU,TIRUPATI,1157,1154,BENGALURU-TIRUPATI,2311,All
2021,1,BENGALURU,TIRUPATI,986,990,BENGALURU-TIRUPATI,1976,All
2021,2,BENGALURU,TIRUPATI,1420,1077,BENGALURU-TIRUPATI,2497,All
2021,3,BENGALURU,TIRUPATI,1274,1091,BENGALURU-TIRUPATI,2365,All
2021,4,BENGALURU,TIRUPATI,891,1000,BENGALURU-TIRUPATI,1891,All
2021,8,BENGALURU,TIRUPATI,472,690,BENGALURU-TIRUPATI,1162,All
2021,9,BENGALURU,TIRUPATI,438,667,BENGALURU-TIRUPATI,1105,All
2021,10,BENGALURU,TIRUPATI,559,778,BENGALURU-TIRUPATI,1337,All
2021,11,BENGALURU,TIRUPATI,721,940,BENGALURU-TIRUPATI,1661,All
2021,12,BENGALURU,TIRUPATI,1428,1789,BENGALURU-TIRUPATI,3217,All
2022,1,BENGALURU,TIRUPATI,1278,1121,BENGALURU-TIRUPATI,2399,All
2022,2,BENGALURU,TIRUPATI,944,881,BENGALURU-TIRUPATI,1825,All
2022,3,BENGALURU,TIRUPATI,1401,1363,BENGALURU-TIRUPATI,2764,All
2022,4,BENGALURU,TIRUPATI,2014,1924,BENGALURU-TIRUPATI,3938,All
2022,5,BENGALURU,TIRUPATI,1813,1913,BENGALURU-TIRUPATI,3726,All
2022,6,BENGALURU,TIRUPATI,2196,2138,BENGALURU-TIRUPATI,4334,All
2022,7,BENGALURU,TIRUPATI,2235,2285,BENGALURU-TIRUPATI,4520,All
2022,8,BENGALURU,TIRUPATI,2306,2331,BENGALURU-TIRUPATI,4637,All
2022,9,BENGALURU,TIRUPATI,2020,1977,BENGALURU-TIRUPATI,3997,All
2022,10,BENGALURU,TIRUPATI,2112,1911,BENGALURU-TIRUPATI,4023,All
2022,11,BENGALURU,TIRUPATI,1968,1919,BENGALURU-TIRUPATI,3887,All
2022,12,BENGALURU,TIRUPATI,1858,1966,BENGALURU-TIRUPATI,3824,All
2023,1,BENGALURU,TIRUPATI,1807,1891,BENGALURU-TIRUPATI,3698,All
2023,2,BENGALURU,TIRUPATI,1686,1561,BENGALURU-TIRUPATI,3247,All
2023,3,BENGALURU,TIRUPATI,1922,1944,BENGALURU-TIRUPATI,3866,All
2023,4,BENGALURU,TIRUPATI,1638,1874,BENGALURU-TIRUPATI,3512,All
2023,5,BENGALURU,TIRUPATI,1692,1996,BENGALURU-TIRUPATI,3688,All
2023,6,BENGALURU,TIRUPATI,1934,1945,BENGALURU-TIRUPATI,3879,All
2023,7,BENGALURU,TIRUPATI,1893,1999,BENGALURU-TIRUPATI,3892,All
2023,8,BENGALURU,TIRUPATI,1910,1950,BENGALURU-TIRUPATI,3860,All
2023,9,BENGALURU,TIRUPATI,1796,1903,BENGALURU-TIRUPATI,3699,All
2023,10,BENGALURU,TIRUPATI,1657,1668,BENGALURU-TIRUPATI,3325,All
2023,11,BENGALURU,TIRUPATI,1868,1659,BENGALURU-TIRUPATI,3527,All
2023,12,BENGALURU,TIRUPATI,1907,1776,BENGALURU-TIRUPATI,3683,All
2024,1,BENGALURU,TIRUPATI,1948,2078,BENGALURU-TIRUPATI,4026,All
2024,2,BENGALURU,TIRUPATI,1972,1786,BENGALURU-TIRUPATI,3758,All
2024,3,BENGALURU,TIRUPATI,2140,1867,BENGALURU-TIRUPATI,4007,All
2024,4,BENGALURU,TIRUPATI,1945,1842,BENGALURU-TIRUPATI,3787,All
2024,6,BENGALURU,TIRUPATI,2035,1972,BENGALURU-TIRUPATI,4007,All
2024,7,BENGALURU,TIRUPATI,2134,2029,BENGALURU-TIRUPATI,4163,All
2024,8,BENGALURU,TIRUPATI,2097,2093,BENGALURU-TIRUPATI,4190,All
2024,9,BENGALURU,TIRUPATI,2001,1798,BENGALURU-TIRUPATI,3799,All
2024,10,BENGALURU,TIRUPATI,1926,1549,BENGALURU-TIRUPATI,3475,All
2024,11,BENGALURU,TIRUPATI,1758,1950,BENGALURU-TIRUPATI,3708,All
2024,12,BENGALURU,TIRUPATI,2142,2124,BENGALURU-TIRUPATI,4266,All
2025,1,BENGALURU,TIRUPATI,1960,2073,BENGALURU-TIRUPATI,4033,All
2025,2,BENGALURU,TIRUPATI,1453,1792,BENGALURU-TIRUPATI,3245,All
2025,3,BENGALURU,TIRUPATI,2169,2157,BENGALURU-TIRUPATI,4326,All
2015,4,BENGALURU,TRIVANDRUM,12087,12151,BENGALURU-TRIVANDRUM,24238,All
2015,5,BENGALURU,TRIVANDRUM,14528,15383,BENGALURU-TRIVANDRUM,29911,All
2015,6,BENGALURU,TRIVANDRUM,13755,14799,BENGALURU-TRIVANDRUM,28554,All
2015,7,BENGALURU,TRIVANDRUM,15308,14998,BENGALURU-TRIVANDRUM,30306,All
2015,8,BENGALURU,TRIVANDRUM,17156,17639,BENGALURU-TRIVANDRUM,34795,All
2015,9,BENGALURU,TRIVANDRUM,10740,11149,BENGALURU-TRIVANDRUM,21889,All
2015,9,BENGALURU,TRIVANDRUM,4447,5494,BENGALURU-TRIVANDRUM,9941,All
2015,10,BENGALURU,TRIVANDRUM,16142,17174,BENGALURU-TRIVANDRUM,33316,All
2015,11,BENGALURU,TRIVANDRUM,14255,14228,BENGALURU-TRIVANDRUM,28483,All
2015,12,BENGALURU,TRIVANDRUM,14922,14591,BENGALURU-TRIVANDRUM,29513,All
2016,1,BENGALURU,TRIVANDRUM,14934,15255,BENGALURU-TRIVANDRUM,30189,All
2016,2,BENGALURU,TRIVANDRUM,14175,14787,BENGALURU-TRIVANDRUM,28962,All
2016,3,BENGALURU,TRIVANDRUM,17358,18329,BENGALURU-TRIVANDRUM,35687,All
2016,4,BENGALURU,TRIVANDRUM,21038,20648,BENGALURU-TRIVANDRUM,41686,All
2016,5,BENGALURU,TRIVANDRUM,23304,23334,BENGALURU-TRIVANDRUM,46638,All
2016,6,BENGALURU,TRIVANDRUM,17870,19411,BENGALURU-TRIVANDRUM,37281,All
2016,7,BENGALURU,TRIVANDRUM,21260,21527,BENGALURU-TRIVANDRUM,42787,All
2016,8,BENGALURU,TRIVANDRUM,20170,20992,BENGALURU-TRIVANDRUM,41162,All
2016,9,BENGALURU,TRIVANDRUM,19863,20395,BENGALURU-TRIVANDRUM,40258,All
2016,10,BENGALURU,TRIVANDRUM,21440,20887,BENGALURU-TRIVANDRUM,42327,All
2016,11,BENGALURU,TRIVANDRUM,18666,23600,BENGALURU-TRIVANDRUM,42266,All
2016,12,BENGALURU,TRIVANDRUM,23815,23055,BENGALURU-TRIVANDRUM,46870,All
2017,1,BENGALURU,TRIVANDRUM,21449,27021,BENGALURU-TRIVANDRUM,48470,All
2017,2,BENGALURU,TRIVANDRUM,18125,21054,BENGALURU-TRIVANDRUM,39179,All
2017,3,BENGALURU,TRIVANDRUM,17439,18401,BENGALURU-TRIVANDRUM,35840,All
2017,4,BENGALURU,TRIVANDRUM,19842,18186,BENGALURU-TRIVANDRUM,38028,All
2017,5,BENGALURU,TRIVANDRUM,22240,22791,BENGALURU-TRIVANDRUM,45031,All
2017,6,BENGALURU,TRIVANDRUM,19545,21514,BENGALURU-TRIVANDRUM,41059,All
2017,7,BENGALURU,TRIVANDRUM,21775,22545,BENGALURU-TRIVANDRUM,44320,All
2017,8,BENGALURU,TRIVANDRUM,20952,19879,BENGALURU-TRIVANDRUM,40831,All
2017,9,BENGALURU,TRIVANDRUM,21050,21214,BENGALURU-TRIVANDRUM,42264,All
2017,10,BENGALURU,TRIVANDRUM,22362,22066,BENGALURU-TRIVANDRUM,44428,All
2017,11,BENGALURU,TRIVANDRUM,22284,23311,BENGALURU-TRIVANDRUM,45595,All
2017,12,BENGALURU,TRIVANDRUM,27697,26710,BENGALURU-TRIVANDRUM,54407,All
2018,1,BENGALURU,TRIVANDRUM,27515,30401,BENGALURU-TRIVANDRUM,57916,All
2018,2,BENGALURU,TRIVANDRUM,25684,26464,BENGALURU-TRIVANDRUM,52148,All
2018,3,BENGALURU,TRIVANDRUM,23281,24233,BENGALURU-TRIVANDRUM,47514,All
2018,4,BENGALURU,TRIVANDRUM,28504,28292,BENGALURU-TRIVANDRUM,56796,All
2018,5,BENGALURU,TRIVANDRUM,31491,31503,BENGALURU-TRIVANDRUM,62994,All
2018,6,BENGALURU,TRIVANDRUM,24151,26687,BENGALURU-TRIVANDRUM,50838,All
2018,7,BENGALURU,TRIVANDRUM,32025,31276,BENGALURU-TRIVANDRUM,63301,All
2018,8,BENGALURU,TRIVANDRUM,32696,32653,BENGALURU-TRIVANDRUM,65349,All
2018,9,BENGALURU,TRIVANDRUM,22684,23093,BENGALURU-TRIVANDRUM,45777,All
2018,10,BENGALURU,TRIVANDRUM,22501,20452,BENGALURU-TRIVANDRUM,42953,All
2018,11,BENGALURU,TRIVANDRUM,20992,19783,BENGALURU-TRIVANDRUM,40775,All
2018,12,BENGALURU,TRIVANDRUM,20381,18425,BENGALURU-TRIVANDRUM,38806,All
2019,1,BENGALURU,TRIVANDRUM,17647,18882,BENGALURU-TRIVANDRUM,36529,All
2019,2,BENGALURU,TRIVANDRUM,17000,17913,BENGALURU-TRIVANDRUM,34913,All
2019,3,BENGALURU,TRIVANDRUM,16047,15483,BENGALURU-TRIVANDRUM,31530,All
2019,4,BENGALURU,TRIVANDRUM,19641,18381,BENGALURU-TRIVANDRUM,38022,All
2019,5,BENGALURU,TRIVANDRUM,20056,18748,BENGALURU-TRIVANDRUM,38804,All
2019,6,BENGALURU,TRIVANDRUM,17258,18024,BENGALURU-TRIVANDRUM,35282,All
2019,7,BENGALURU,TRIVANDRUM,16489,15607,BENGALURU-TRIVANDRUM,32096,All
2019,8,BENGALURU,TRIVANDRUM,19618,19163,BENGALURU-TRIVANDRUM,38781,All
2019,9,BENGALURU,TRIVANDRUM,18168,18711,BENGALURU-TRIVANDRUM,36879,All
2019,10,BENGALURU,TRIVANDRUM,17399,17277,BENGALURU-TRIVANDRUM,34676,All
2019,11,BENGALURU,TRIVANDRUM,18732,19767,BENGALURU-TRIVANDRUM,38499,All
2019,12,BENGALURU,TRIVANDRUM,23042,22159,BENGALURU-TRIVANDRUM,45201,All
2020,1,BENGALURU,TRIVANDRUM,20852,23072,BENGALURU-TRIVANDRUM,43924,All
2020,2,BENGALURU,TRIVANDRUM,16716,17902,BENGALURU-TRIVANDRUM,34618,All
2020,3,BENGALURU,TRIVANDRUM,9595,8888,BENGALURU-TRIVANDRUM,18483,All
2020,5,BENGALURU,TRIVANDRUM,933,414,BENGALURU-TRIVANDRUM,1347,All
2020,6,BENGALURU,TRIVANDRUM,3818,3364,BENGALURU-TRIVANDRUM,7182,All
2020,7,BENGALURU,TRIVANDRUM,5009,3271,BENGALURU-TRIVANDRUM,8280,All
2020,8,BENGALURU,TRIVANDRUM,5768,4393,BENGALURU-TRIVANDRUM,10161,All
2020,9,BENGALURU,TRIVANDRUM,6239,6438,BENGALURU-TRIVANDRUM,12677,All
2020,10,BENGALURU,TRIVANDRUM,10119,7568,BENGALURU-TRIVANDRUM,17687,All
2020,11,BENGALURU,TRIVANDRUM,8975,7098,BENGALURU-TRIVANDRUM,16073,All
2020,12,BENGALURU,TRIVANDRUM,9243,7843,BENGALURU-TRIVANDRUM,17086,All
2021,1,BENGALURU,TRIVANDRUM,8448,8707,BENGALURU-TRIVANDRUM,17155,All
2021,2,BENGALURU,TRIVANDRUM,8117,7947,BENGALURU-TRIVANDRUM,16064,All
2021,3,BENGALURU,TRIVANDRUM,7858,7234,BENGALURU-TRIVANDRUM,15092,All
2021,4,BENGALURU,TRIVANDRUM,8992,7313,BENGALURU-TRIVANDRUM,16305,All
2021,6,BENGALURU,TRIVANDRUM,2738,3105,BENGALURU-TRIVANDRUM,5843,All
2021,7,BENGALURU,TRIVANDRUM,4601,4474,BENGALURU-TRIVANDRUM,9075,All
2021,8,BENGALURU,TRIVANDRUM,9844,7503,BENGALURU-TRIVANDRUM,17347,All
2021,9,BENGALURU,TRIVANDRUM,6156,5957,BENGALURU-TRIVANDRUM,12113,All
2021,10,BENGALURU,TRIVANDRUM,8011,7183,BENGALURU-TRIVANDRUM,15194,All
2021,11,BENGALURU,TRIVANDRUM,12448,13094,BENGALURU-TRIVANDRUM,25542,All
2021,12,BENGALURU,TRIVANDRUM,15539,13563,BENGALURU-TRIVANDRUM,29102,All
2022,1,BENGALURU,TRIVANDRUM,7307,8142,BENGALURU-TRIVANDRUM,15449,All
2022,2,BENGALURU,TRIVANDRUM,4969,4656,BENGALURU-TRIVANDRUM,9625,All
2022,3,BENGALURU,TRIVANDRUM,14527,15653,BENGALURU-TRIVANDRUM,30180,All
2022,4,BENGALURU,TRIVANDRUM,17238,17295,BENGALURU-TRIVANDRUM,34533,All
2022,5,BENGALURU,TRIVANDRUM,20305,20904,BENGALURU-TRIVANDRUM,41209,All
2022,6,BENGALURU,TRIVANDRUM,15278,16336,BENGALURU-TRIVANDRUM,31614,All
2022,7,BENGALURU,TRIVANDRUM,15081,15604,BENGALURU-TRIVANDRUM,30685,All
2022,8,BENGALURU,TRIVANDRUM,15768,16002,BENGALURU-TRIVANDRUM,31770,All
2022,9,BENGALURU,TRIVANDRUM,16369,16627,BENGALURU-TRIVANDRUM,32996,All
2022,10,BENGALURU,TRIVANDRUM,14775,16099,BENGALURU-TRIVANDRUM,30874,All
2022,11,BENGALURU,TRIVANDRUM,20874,24253,BENGALURU-TRIVANDRUM,45127,All
2022,12,BENGALURU,TRIVANDRUM,25826,24452,BENGALURU-TRIVANDRUM,50278,All
2023,1,BENGALURU,TRIVANDRUM,19220,26098,BENGALURU-TRIVANDRUM,45318,All
2023,2,BENGALURU,TRIVANDRUM,18860,21661,BENGALURU-TRIVANDRUM,40521,All
2023,3,BENGALURU,TRIVANDRUM,18513,21012,BENGALURU-TRIVANDRUM,39525,All
2023,4,BENGALURU,TRIVANDRUM,18365,18474,BENGALURU-TRIVANDRUM,36839,All
2023,5,BENGALURU,TRIVANDRUM,19795,20925,BENGALURU-TRIVANDRUM,40720,All
2023,6,BENGALURU,TRIVANDRUM,15378,16459,BENGALURU-TRIVANDRUM,31837,All
2023,7,BENGALURU,TRIVANDRUM,18317,20304,BENGALURU-TRIVANDRUM,38621,All
2023,8,BENGALURU,TRIVANDRUM,21497,22128,BENGALURU-TRIVANDRUM,43625,All
2023,9,BENGALURU,TRIVANDRUM,18827,21634,BENGALURU-TRIVANDRUM,40461,All
2023,10,BENGALURU,TRIVANDRUM,20694,22017,BENGALURU-TRIVANDRUM,42711,All
2023,11,BENGALURU,TRIVANDRUM,25825,30097,BENGALURU-TRIVANDRUM,55922,All
2023,12,BENGALURU,TRIVANDRUM,34925,34655,BENGALURU-TRIVANDRUM,69580,All
2024,1,BENGALURU,TRIVANDRUM,29573,34642,BENGALURU-TRIVANDRUM,64215,All
2024,2,BENGALURU,TRIVANDRUM,26360,28956,BENGALURU-TRIVANDRUM,55316,All
2024,3,BENGALURU,TRIVANDRUM,29341,29920,BENGALURU-TRIVANDRUM,59261,All
2024,4,BENGALURU,TRIVANDRUM,37831,38282,BENGALURU-TRIVANDRUM,76113,All
2024,6,BENGALURU,TRIVANDRUM,30726,32805,BENGALURU-TRIVANDRUM,63531,All
2024,7,BENGALURU,TRIVANDRUM,33216,32757,BENGALURU-TRIVANDRUM,65973,All
2024,8,BENGALURU,TRIVANDRUM,35423,36356,BENGALURU-TRIVANDRUM,71779,All
2024,9,BENGALURU,TRIVANDRUM,38821,39164,BENGALURU-TRIVANDRUM,77985,All
2024,10,BENGALURU,TRIVANDRUM,41046,39926,BENGALURU-TRIVANDRUM,80972,All
2024,11,BENGALURU,TRIVANDRUM,36790,42524,BENGALURU-TRIVANDRUM,79314,All
2024,12,BENGALURU,TRIVANDRUM,43761,42208,BENGALURU-TRIVANDRUM,85969,All
2025,1,BENGALURU,TRIVANDRUM,27716,28911,BENGALURU-TRIVANDRUM,56627,All
2025,2,BENGALURU,TRIVANDRUM,21743,22426,BENGALURU-TRIVANDRUM,44169,All
2025,3,BENGALURU,TRIVANDRUM,25571,26193,BENGALURU-TRIVANDRUM,51764,All
2018,7,BENGALURU,TUTICORIN,1511,1598,BENGALURU-TUTICORIN,3109,All
2018,8,BENGALURU,TUTICORIN,1350,1383,BENGALURU-TUTICORIN,2733,All
2018,9,BENGALURU,TUTICORIN,1335,1631,BENGALURU-TUTICORIN,2966,All
2018,10,BENGALURU,TUTICORIN,1318,1267,BENGALURU-TUTICORIN,2585,All
2019,9,BENGALURU,TUTICORIN,0,1,BENGALURU-TUTICORIN,1,All
2019,10,BENGALURU,TUTICORIN,236,221,BENGALURU-TUTICORIN,457,All
2019,11,BENGALURU,TUTICORIN,1584,1619,BENGALURU-TUTICORIN,3203,All
2019,12,BENGALURU,TUTICORIN,1711,1434,BENGALURU-TUTICORIN,3145,All
2020,1,BENGALURU,TUTICORIN,1742,1775,BENGALURU-TUTICORIN,3517,All
2020,2,BENGALURU,TUTICORIN,1601,1501,BENGALURU-TUTICORIN,3102,All
2020,3,BENGALURU,TUTICORIN,1181,850,BENGALURU-TUTICORIN,2031,All
2020,8,BENGALURU,TUTICORIN,831,948,BENGALURU-TUTICORIN,1779,All
2020,9,BENGALURU,TUTICORIN,1879,1940,BENGALURU-TUTICORIN,3819,All
2020,10,BENGALURU,TUTICORIN,1824,1962,BENGALURU-TUTICORIN,3786,All
2020,11,BENGALURU,TUTICORIN,1668,1866,BENGALURU-TUTICORIN,3534,All
2020,12,BENGALURU,TUTICORIN,1545,1460,BENGALURU-TUTICORIN,3005,All
2021,1,BENGALURU,TUTICORIN,1504,1899,BENGALURU-TUTICORIN,3403,All
2021,2,BENGALURU,TUTICORIN,1205,1725,BENGALURU-TUTICORIN,2930,All
2021,3,BENGALURU,TUTICORIN,1064,1262,BENGALURU-TUTICORIN,2326,All
2021,4,BENGALURU,TUTICORIN,406,417,BENGALURU-TUTICORIN,823,All
2021,7,BENGALURU,TUTICORIN,341,477,BENGALURU-TUTICORIN,818,All
2021,8,BENGALURU,TUTICORIN,396,476,BENGALURU-TUTICORIN,872,All
2021,9,BENGALURU,TUTICORIN,378,497,BENGALURU-TUTICORIN,875,All
2021,10,BENGALURU,TUTICORIN,679,689,BENGALURU-TUTICORIN,1368,All
2021,11,BENGALURU,TUTICORIN,632,664,BENGALURU-TUTICORIN,1296,All
2021,12,BENGALURU,TUTICORIN,697,542,BENGALURU-TUTICORIN,1239,All
2022,1,BENGALURU,TUTICORIN,409,424,BENGALURU-TUTICORIN,833,All
2022,2,BENGALURU,TUTICORIN,597,593,BENGALURU-TUTICORIN,1190,All
2022,3,BENGALURU,TUTICORIN,980,1011,BENGALURU-TUTICORIN,1991,All
2022,4,BENGALURU,TUTICORIN,1663,1547,BENGALURU-TUTICORIN,3210,All
2022,5,BENGALURU,TUTICORIN,1845,1873,BENGALURU-TUTICORIN,3718,All
2022,6,BENGALURU,TUTICORIN,1850,1886,BENGALURU-TUTICORIN,3736,All
2022,7,BENGALURU,TUTICORIN,2044,1952,BENGALURU-TUTICORIN,3996,All
2022,8,BENGALURU,TUTICORIN,2133,1975,BENGALURU-TUTICORIN,4108,All
2022,9,BENGALURU,TUTICORIN,1885,1714,BENGALURU-TUTICORIN,3599,All
2022,10,BENGALURU,TUTICORIN,1640,1557,BENGALURU-TUTICORIN,3197,All
2022,11,BENGALURU,TUTICORIN,1465,1428,BENGALURU-TUTICORIN,2893,All
2022,12,BENGALURU,TUTICORIN,1965,1413,BENGALURU-TUTICORIN,3378,All
2023,1,BENGALURU,TUTICORIN,1761,1590,BENGALURU-TUTICORIN,3351,All
2023,2,BENGALURU,TUTICORIN,1265,1164,BENGALURU-TUTICORIN,2429,All
2023,3,BENGALURU,TUTICORIN,1956,1720,BENGALURU-TUTICORIN,3676,All
2023,4,BENGALURU,TUTICORIN,1872,1761,BENGALURU-TUTICORIN,3633,All
2023,5,BENGALURU,TUTICORIN,2144,1910,BENGALURU-TUTICORIN,4054,All
2023,6,BENGALURU,TUTICORIN,2067,1634,BENGALURU-TUTICORIN,3701,All
2023,7,BENGALURU,TUTICORIN,2148,1943,BENGALURU-TUTICORIN,4091,All
2023,8,BENGALURU,TUTICORIN,2206,1972,BENGALURU-TUTICORIN,4178,All
2023,9,BENGALURU,TUTICORIN,1913,1703,BENGALURU-TUTICORIN,3616,All
2023,10,BENGALURU,TUTICORIN,1892,1482,BENGALURU-TUTICORIN,3374,All
2023,11,BENGALURU,TUTICORIN,1783,1640,BENGALURU-TUTICORIN,3423,All
2023,12,BENGALURU,TUTICORIN,2032,1605,BENGALURU-TUTICORIN,3637,All
2024,1,BENGALURU,TUTICORIN,2227,2107,BENGALURU-TUTICORIN,4334,All
2024,2,BENGALURU,TUTICORIN,1918,1821,BENGALURU-TUTICORIN,3739,All
2024,3,BENGALURU,TUTICORIN,2018,1541,BENGALURU-TUTICORIN,3559,All
2024,4,BENGALURU,TUTICORIN,2263,1890,BENGALURU-TUTICORIN,4153,All
2024,6,BENGALURU,TUTICORIN,2690,2310,BENGALURU-TUTICORIN,5000,All
2024,7,BENGALURU,TUTICORIN,2775,2338,BENGALURU-TUTICORIN,5113,All
2024,8,BENGALURU,TUTICORIN,2442,2257,BENGALURU-TUTICORIN,4699,All
2024,9,BENGALURU,TUTICORIN,2334,2165,BENGALURU-TUTICORIN,4499,All
2024,10,BENGALURU,TUTICORIN,1885,1738,BENGALURU-TUTICORIN,3623,All
2024,11,BENGALURU,TUTICORIN,1514,1732,BENGALURU-TUTICORIN,3246,All
2024,12,BENGALURU,TUTICORIN,1929,1598,BENGALURU-TUTICORIN,3527,All
2025,1,BENGALURU,TUTICORIN,1963,1841,BENGALURU-TUTICORIN,3804,All
2025,2,BENGALURU,TUTICORIN,1145,1183,BENGALURU-TUTICORIN,2328,All
2025,3,BENGALURU,TUTICORIN,1929,1768,BENGALURU-TUTICORIN,3697,All
2017,2,BENGALURU,UDAIPUR,93,82,BENGALURU-UDAIPUR,175,All
2017,3,BENGALURU,UDAIPUR,415,297,BENGALURU-UDAIPUR,712,All
2017,4,BENGALURU,UDAIPUR,869,308,BENGALURU-UDAIPUR,1177,All
2017,5,BENGALURU,UDAIPUR,642,544,BENGALURU-UDAIPUR,1186,All
2017,6,BENGALURU,UDAIPUR,405,368,BENGALURU-UDAIPUR,773,All
2017,7,BENGALURU,UDAIPUR,303,276,BENGALURU-UDAIPUR,579,All
2017,8,BENGALURU,UDAIPUR,331,164,BENGALURU-UDAIPUR,495,All
2017,9,BENGALURU,UDAIPUR,458,222,BENGALURU-UDAIPUR,680,All
2017,10,BENGALURU,UDAIPUR,527,406,BENGALURU-UDAIPUR,933,All
2017,11,BENGALURU,UDAIPUR,166,97,BENGALURU-UDAIPUR,263,All
2017,12,BENGALURU,UDAIPUR,136,149,BENGALURU-UDAIPUR,285,All
2018,1,BENGALURU,UDAIPUR,61,65,BENGALURU-UDAIPUR,126,All
2018,2,BENGALURU,UDAIPUR,461,422,BENGALURU-UDAIPUR,883,All
2018,3,BENGALURU,UDAIPUR,266,329,BENGALURU-UDAIPUR,595,All
2018,11,BENGALURU,UDAIPUR,6883,7776,BENGALURU-UDAIPUR,14659,All
2018,12,BENGALURU,UDAIPUR,8172,8580,BENGALURU-UDAIPUR,16752,All
2019,1,BENGALURU,UDAIPUR,8478,8429,BENGALURU-UDAIPUR,16907,All
2019,2,BENGALURU,UDAIPUR,6535,6481,BENGALURU-UDAIPUR,13016,All
2019,3,BENGALURU,UDAIPUR,4052,3993,BENGALURU-UDAIPUR,8045,All
2019,4,BENGALURU,UDAIPUR,8023,6329,BENGALURU-UDAIPUR,14352,All
2019,5,BENGALURU,UDAIPUR,8079,9982,BENGALURU-UDAIPUR,18061,All
2019,6,BENGALURU,UDAIPUR,5876,6033,BENGALURU-UDAIPUR,11909,All
2019,7,BENGALURU,UDAIPUR,4100,3945,BENGALURU-UDAIPUR,8045,All
2019,8,BENGALURU,UDAIPUR,4605,4551,BENGALURU-UDAIPUR,9156,All
2019,9,BENGALURU,UDAIPUR,4567,3959,BENGALURU-UDAIPUR,8526,All
2019,10,BENGALURU,UDAIPUR,4098,4280,BENGALURU-UDAIPUR,8378,All
2019,11,BENGALURU,UDAIPUR,4857,4944,BENGALURU-UDAIPUR,9801,All
2019,12,BENGALURU,UDAIPUR,4965,5151,BENGALURU-UDAIPUR,10116,All
2020,1,BENGALURU,UDAIPUR,4527,4618,BENGALURU-UDAIPUR,9145,All
2020,2,BENGALURU,UDAIPUR,4784,4874,BENGALURU-UDAIPUR,9658,All
2020,3,BENGALURU,UDAIPUR,3279,2617,BENGALURU-UDAIPUR,5896,All
2020,8,BENGALURU,UDAIPUR,1295,1248,BENGALURU-UDAIPUR,2543,All
2020,9,BENGALURU,UDAIPUR,2126,2080,BENGALURU-UDAIPUR,4206,All
2020,10,BENGALURU,UDAIPUR,2687,2401,BENGALURU-UDAIPUR,5088,All
2020,11,BENGALURU,UDAIPUR,4023,3243,BENGALURU-UDAIPUR,7266,All
2020,12,BENGALURU,UDAIPUR,3234,4051,BENGALURU-UDAIPUR,7285,All
2021,1,BENGALURU,UDAIPUR,2618,3278,BENGALURU-UDAIPUR,5896,All
2021,2,BENGALURU,UDAIPUR,3329,3234,BENGALURU-UDAIPUR,6563,All
2021,3,BENGALURU,UDAIPUR,2824,2774,BENGALURU-UDAIPUR,5598,All
2021,4,BENGALURU,UDAIPUR,4342,2816,BENGALURU-UDAIPUR,7158,All
2021,6,BENGALURU,UDAIPUR,1590,3184,BENGALURU-UDAIPUR,4774,All
2021,7,BENGALURU,UDAIPUR,3711,4362,BENGALURU-UDAIPUR,8073,All
2021,8,BENGALURU,UDAIPUR,4447,4447,BENGALURU-UDAIPUR,8894,All
2021,9,BENGALURU,UDAIPUR,3956,3916,BENGALURU-UDAIPUR,7872,All
2021,10,BENGALURU,UDAIPUR,4836,4356,BENGALURU-UDAIPUR,9192,All
2021,11,BENGALURU,UDAIPUR,6766,6397,BENGALURU-UDAIPUR,13163,All
2021,12,BENGALURU,UDAIPUR,6667,7552,BENGALURU-UDAIPUR,14219,All
2022,1,BENGALURU,UDAIPUR,2934,2788,BENGALURU-UDAIPUR,5722,All
2022,2,BENGALURU,UDAIPUR,2864,2952,BENGALURU-UDAIPUR,5816,All
2022,3,BENGALURU,UDAIPUR,3738,4359,BENGALURU-UDAIPUR,8097,All
2022,4,BENGALURU,UDAIPUR,3175,3206,BENGALURU-UDAIPUR,6381,All
2022,5,BENGALURU,UDAIPUR,1713,1897,BENGALURU-UDAIPUR,3610,All
2022,6,BENGALURU,UDAIPUR,1788,1688,BENGALURU-UDAIPUR,3476,All
2022,7,BENGALURU,UDAIPUR,2042,1764,BENGALURU-UDAIPUR,3806,All
2022,8,BENGALURU,UDAIPUR,2077,1965,BENGALURU-UDAIPUR,4042,All
2022,9,BENGALURU,UDAIPUR,3727,3152,BENGALURU-UDAIPUR,6879,All
2022,10,BENGALURU,UDAIPUR,4691,4641,BENGALURU-UDAIPUR,9332,All
2022,11,BENGALURU,UDAIPUR,5868,6180,BENGALURU-UDAIPUR,12048,All
2022,12,BENGALURU,UDAIPUR,5394,5834,BENGALURU-UDAIPUR,11228,All
2023,1,BENGALURU,UDAIPUR,5158,5597,BENGALURU-UDAIPUR,10755,All
2023,2,BENGALURU,UDAIPUR,5179,5166,BENGALURU-UDAIPUR,10345,All
2023,3,BENGALURU,UDAIPUR,4769,5117,BENGALURU-UDAIPUR,9886,All
2023,4,BENGALURU,UDAIPUR,5883,5025,BENGALURU-UDAIPUR,10908,All
2023,5,BENGALURU,UDAIPUR,5802,6323,BENGALURU-UDAIPUR,12125,All
2023,6,BENGALURU,UDAIPUR,5981,5387,BENGALURU-UDAIPUR,11368,All
2023,7,BENGALURU,UDAIPUR,5687,5148,BENGALURU-UDAIPUR,10835,All
2023,8,BENGALURU,UDAIPUR,6077,5405,BENGALURU-UDAIPUR,11482,All
2023,9,BENGALURU,UDAIPUR,6294,6240,BENGALURU-UDAIPUR,12534,All
2023,10,BENGALURU,UDAIPUR,6504,6114,BENGALURU-UDAIPUR,12618,All
2023,11,BENGALURU,UDAIPUR,5053,4856,BENGALURU-UDAIPUR,9909,All
2023,12,BENGALURU,UDAIPUR,5323,5608,BENGALURU-UDAIPUR,10931,All
2024,1,BENGALURU,UDAIPUR,5480,5197,BENGALURU-UDAIPUR,10677,All
2024,2,BENGALURU,UDAIPUR,4805,4760,BENGALURU-UDAIPUR,9565,All
2024,3,BENGALURU,UDAIPUR,4986,4884,BENGALURU-UDAIPUR,9870,All
2024,4,BENGALURU,UDAIPUR,9532,8198,BENGALURU-UDAIPUR,17730,All
2024,6,BENGALURU,UDAIPUR,8371,8426,BENGALURU-UDAIPUR,16797,All
2024,7,BENGALURU,UDAIPUR,6529,6489,BENGALURU-UDAIPUR,13018,All
2024,8,BENGALURU,UDAIPUR,9092,9077,BENGALURU-UDAIPUR,18169,All
2024,9,BENGALURU,UDAIPUR,8709,8010,BENGALURU-UDAIPUR,16719,All
2024,10,BENGALURU,UDAIPUR,10062,8256,BENGALURU-UDAIPUR,18318,All
2024,11,BENGALURU,UDAIPUR,9729,9788,BENGALURU-UDAIPUR,19517,All
2024,12,BENGALURU,UDAIPUR,11333,11589,BENGALURU-UDAIPUR,22922,All
2025,1,BENGALURU,UDAIPUR,11475,11649,BENGALURU-UDAIPUR,23124,All
2025,2,BENGALURU,UDAIPUR,8584,8542,BENGALURU-UDAIPUR,17126,All
2025,3,BENGALURU,UDAIPUR,7125,6917,BENGALURU-UDAIPUR,14042,All
2019,5,BENGALURU,VADODARA,5430,5459,BENGALURU-VADODARA,10889,All
2019,6,BENGALURU,VADODARA,4851,4480,BENGALURU-VADODARA,9331,All
2019,7,BENGALURU,VADODARA,4075,4158,BENGALURU-VADODARA,8233,All
2019,8,BENGALURU,VADODARA,4309,4164,BENGALURU-VADODARA,8473,All
2019,9,BENGALURU,VADODARA,4815,4339,BENGALURU-VADODARA,9154,All
2019,10,BENGALURU,VADODARA,4031,4515,BENGALURU-VADODARA,8546,All
2019,11,BENGALURU,VADODARA,5130,4419,BENGALURU-VADODARA,9549,All
2019,12,BENGALURU,VADODARA,6916,7412,BENGALURU-VADODARA,14328,All
2020,1,BENGALURU,VADODARA,8166,8565,BENGALURU-VADODARA,16731,All
2020,2,BENGALURU,VADODARA,8196,8788,BENGALURU-VADODARA,16984,All
2020,3,BENGALURU,VADODARA,4615,3725,BENGALURU-VADODARA,8340,All
2020,5,BENGALURU,VADODARA,258,91,BENGALURU-VADODARA,349,All
2020,7,BENGALURU,VADODARA,482,280,BENGALURU-VADODARA,762,All
2020,8,BENGALURU,VADODARA,1052,1132,BENGALURU-VADODARA,2184,All
2020,9,BENGALURU,VADODARA,966,1346,BENGALURU-VADODARA,2312,All
2020,10,BENGALURU,VADODARA,1484,2108,BENGALURU-VADODARA,3592,All
2020,11,BENGALURU,VADODARA,3003,3206,BENGALURU-VADODARA,6209,All
2020,12,BENGALURU,VADODARA,2969,3894,BENGALURU-VADODARA,6863,All
2021,1,BENGALURU,VADODARA,2860,3432,BENGALURU-VADODARA,6292,All
2021,2,BENGALURU,VADODARA,2505,2800,BENGALURU-VADODARA,5305,All
2021,3,BENGALURU,VADODARA,2754,3406,BENGALURU-VADODARA,6160,All
2021,4,BENGALURU,VADODARA,1173,1386,BENGALURU-VADODARA,2559,All
2021,7,BENGALURU,VADODARA,1868,2118,BENGALURU-VADODARA,3986,All
2021,8,BENGALURU,VADODARA,2776,2774,BENGALURU-VADODARA,5550,All
2021,9,BENGALURU,VADODARA,2107,2208,BENGALURU-VADODARA,4315,All
2021,10,BENGALURU,VADODARA,3920,3812,BENGALURU-VADODARA,7732,All
2021,11,BENGALURU,VADODARA,4678,4848,BENGALURU-VADODARA,9526,All
2021,12,BENGALURU,VADODARA,4740,4930,BENGALURU-VADODARA,9670,All
2022,1,BENGALURU,VADODARA,2332,2415,BENGALURU-VADODARA,4747,All
2022,2,BENGALURU,VADODARA,2037,2426,BENGALURU-VADODARA,4463,All
2022,3,BENGALURU,VADODARA,4638,4872,BENGALURU-VADODARA,9510,All
2022,4,BENGALURU,VADODARA,5867,5689,BENGALURU-VADODARA,11556,All
2022,5,BENGALURU,VADODARA,6072,6455,BENGALURU-VADODARA,12527,All
2022,6,BENGALURU,VADODARA,5710,5147,BENGALURU-VADODARA,10857,All
2022,7,BENGALURU,VADODARA,5516,5111,BENGALURU-VADODARA,10627,All
2022,8,BENGALURU,VADODARA,5676,5415,BENGALURU-VADODARA,11091,All
2022,9,BENGALURU,VADODARA,5416,4524,BENGALURU-VADODARA,9940,All
2022,10,BENGALURU,VADODARA,6311,6274,BENGALURU-VADODARA,12585,All
2022,11,BENGALURU,VADODARA,4999,4900,BENGALURU-VADODARA,9899,All
2022,12,BENGALURU,VADODARA,5359,5199,BENGALURU-VADODARA,10558,All
2023,1,BENGALURU,VADODARA,5532,5604,BENGALURU-VADODARA,11136,All
2023,2,BENGALURU,VADODARA,4997,5415,BENGALURU-VADODARA,10412,All
2023,3,BENGALURU,VADODARA,5507,5340,BENGALURU-VADODARA,10847,All
2023,4,BENGALURU,VADODARA,5796,5388,BENGALURU-VADODARA,11184,All
2023,5,BENGALURU,VADODARA,5667,6419,BENGALURU-VADODARA,12086,All
2023,6,BENGALURU,VADODARA,5677,5575,BENGALURU-VADODARA,11252,All
2023,7,BENGALURU,VADODARA,5521,5361,BENGALURU-VADODARA,10882,All
2023,8,BENGALURU,VADODARA,5934,5523,BENGALURU-VADODARA,11457,All
2023,9,BENGALURU,VADODARA,6151,5902,BENGALURU-VADODARA,12053,All
2023,10,BENGALURU,VADODARA,5944,5465,BENGALURU-VADODARA,11409,All
2023,11,BENGALURU,VADODARA,4903,4896,BENGALURU-VADODARA,9799,All
2023,12,BENGALURU,VADODARA,5311,5247,BENGALURU-VADODARA,10558,All
2024,1,BENGALURU,VADODARA,1910,1870,BENGALURU-VADODARA,3780,All
2024,2,BENGALURU,VADODARA,2133,2120,BENGALURU-VADODARA,4253,All
2024,3,BENGALURU,VADODARA,5135,5033,BENGALURU-VADODARA,10168,All
2024,4,BENGALURU,VADODARA,4798,4587,BENGALURU-VADODARA,9385,All
2024,6,BENGALURU,VADODARA,4815,4686,BENGALURU-VADODARA,9501,All
2024,7,BENGALURU,VADODARA,5069,4937,BENGALURU-VADODARA,10006,All
2024,8,BENGALURU,VADODARA,4812,4464,BENGALURU-VADODARA,9276,All
2024,9,BENGALURU,VADODARA,4748,4551,BENGALURU-VADODARA,9299,All
2024,10,BENGALURU,VADODARA,4729,4657,BENGALURU-VADODARA,9386,All
2024,11,BENGALURU,VADODARA,4886,4756,BENGALURU-VADODARA,9642,All
2024,12,BENGALURU,VADODARA,4791,4822,BENGALURU-VADODARA,9613,All
2025,1,BENGALURU,VADODARA,5015,4967,BENGALURU-VADODARA,9982,All
2025,2,BENGALURU,VADODARA,4616,4595,BENGALURU-VADODARA,9211,All
2025,3,BENGALURU,VADODARA,4757,4635,BENGALURU-VADODARA,9392,All
2015,4,BENGALURU,VARANASI,2769,2301,BENGALURU-VARANASI,5070,All
2015,5,BENGALURU,VARANASI,2486,2663,BENGALURU-VARANASI,5149,All
2015,6,BENGALURU,VARANASI,1908,2116,BENGALURU-VARANASI,4024,All
2015,7,BENGALURU,VARANASI,1604,1682,BENGALURU-VARANASI,3286,All
2015,8,BENGALURU,VARANASI,1445,1444,BENGALURU-VARANASI,2889,All
2015,9,BENGALURU,VARANASI,2597,2304,BENGALURU-VARANASI,4901,All
2015,10,BENGALURU,VARANASI,3401,3211,BENGALURU-VARANASI,6612,All
2015,11,BENGALURU,VARANASI,4776,4352,BENGALURU-VARANASI,9128,All
2015,12,BENGALURU,VARANASI,3415,4072,BENGALURU-VARANASI,7487,All
2016,1,BENGALURU,VARANASI,2723,2156,BENGALURU-VARANASI,4879,All
2016,2,BENGALURU,VARANASI,3715,3436,BENGALURU-VARANASI,7151,All
2016,3,BENGALURU,VARANASI,4235,3906,BENGALURU-VARANASI,8141,All
2016,4,BENGALURU,VARANASI,3635,3601,BENGALURU-VARANASI,7236,All
2016,5,BENGALURU,VARANASI,3532,4549,BENGALURU-VARANASI,8081,All
2016,6,BENGALURU,VARANASI,3259,3720,BENGALURU-VARANASI,6979,All
2016,7,BENGALURU,VARANASI,3823,4014,BENGALURU-VARANASI,7837,All
2016,8,BENGALURU,VARANASI,3009,3385,BENGALURU-VARANASI,6394,All
2016,9,BENGALURU,VARANASI,2950,3315,BENGALURU-VARANASI,6265,All
2016,10,BENGALURU,VARANASI,5250,3147,BENGALURU-VARANASI,8397,All
2016,11,BENGALURU,VARANASI,6973,8489,BENGALURU-VARANASI,15462,All
2016,12,BENGALURU,VARANASI,6111,5768,BENGALURU-VARANASI,11879,All
2017,1,BENGALURU,VARANASI,6372,5474,BENGALURU-VARANASI,11846,All
2017,2,BENGALURU,VARANASI,6778,5417,BENGALURU-VARANASI,12195,All
2017,3,BENGALURU,VARANASI,7113,5770,BENGALURU-VARANASI,12883,All
2017,4,BENGALURU,VARANASI,7220,5895,BENGALURU-VARANASI,13115,All
2017,5,BENGALURU,VARANASI,7544,7543,BENGALURU-VARANASI,15087,All
2017,6,BENGALURU,VARANASI,5346,5624,BENGALURU-VARANASI,10970,All
2017,7,BENGALURU,VARANASI,5334,5614,BENGALURU-VARANASI,10948,All
2017,8,BENGALURU,VARANASI,5650,4728,BENGALURU-VARANASI,10378,All
2017,9,BENGALURU,VARANASI,6100,4956,BENGALURU-VARANASI,11056,All
2017,10,BENGALURU,VARANASI,7837,6588,BENGALURU-VARANASI,14425,All
2017,11,BENGALURU,VARANASI,7843,7187,BENGALURU-VARANASI,15030,All
2017,12,BENGALURU,VARANASI,5067,5216,BENGALURU-VARANASI,10283,All
2018,1,BENGALURU,VARANASI,4310,4638,BENGALURU-VARANASI,8948,All
2018,2,BENGALURU,VARANASI,6359,5680,BENGALURU-VARANASI,12039,All
2018,3,BENGALURU,VARANASI,7700,6975,BENGALURU-VARANASI,14675,All
2018,4,BENGALURU,VARANASI,7892,5607,BENGALURU-VARANASI,13499,All
2018,5,BENGALURU,VARANASI,6555,8677,BENGALURU-VARANASI,15232,All
2018,6,BENGALURU,VARANASI,7074,5766,BENGALURU-VARANASI,12840,All
2018,7,BENGALURU,VARANASI,6046,7152,BENGALURU-VARANASI,13198,All
2018,8,BENGALURU,VARANASI,6812,6121,BENGALURU-VARANASI,12933,All
2018,9,BENGALURU,VARANASI,7622,5832,BENGALURU-VARANASI,13454,All
2018,10,BENGALURU,VARANASI,10350,7663,BENGALURU-VARANASI,18013,All
2018,11,BENGALURU,VARANASI,12738,13716,BENGALURU-VARANASI,26454,All
2018,12,BENGALURU,VARANASI,9677,10063,BENGALURU-VARANASI,19740,All
2019,1,BENGALURU,VARANASI,8829,8235,BENGALURU-VARANASI,17064,All
2019,2,BENGALURU,VARANASI,10968,10545,BENGALURU-VARANASI,21513,All
2019,3,BENGALURU,VARANASI,14077,14111,BENGALURU-VARANASI,28188,All
2019,4,BENGALURU,VARANASI,9788,7609,BENGALURU-VARANASI,17397,All
2019,5,BENGALURU,VARANASI,7866,8827,BENGALURU-VARANASI,16693,All
2019,6,BENGALURU,VARANASI,5192,5625,BENGALURU-VARANASI,10817,All
2019,7,BENGALURU,VARANASI,7795,8907,BENGALURU-VARANASI,16702,All
2019,8,BENGALURU,VARANASI,7490,7492,BENGALURU-VARANASI,14982,All
2019,9,BENGALURU,VARANASI,9058,7735,BENGALURU-VARANASI,16793,All
2019,10,BENGALURU,VARANASI,10769,7592,BENGALURU-VARANASI,18361,All
2019,11,BENGALURU,VARANASI,14748,15278,BENGALURU-VARANASI,30026,All
2019,12,BENGALURU,VARANASI,13257,15402,BENGALURU-VARANASI,28659,All
2020,1,BENGALURU,VARANASI,13661,15676,BENGALURU-VARANASI,29337,All
2020,2,BENGALURU,VARANASI,14101,13226,BENGALURU-VARANASI,27327,All
2020,3,BENGALURU,VARANASI,12099,10002,BENGALURU-VARANASI,22101,All
2020,5,BENGALURU,VARANASI,577,272,BENGALURU-VARANASI,849,All
2020,6,BENGALURU,VARANASI,3993,1886,BENGALURU-VARANASI,5879,All
2020,7,BENGALURU,VARANASI,4616,2670,BENGALURU-VARANASI,7286,All
2020,8,BENGALURU,VARANASI,2642,5448,BENGALURU-VARANASI,8090,All
2020,9,BENGALURU,VARANASI,3365,10978,BENGALURU-VARANASI,14343,All
2020,10,BENGALURU,VARANASI,4480,7586,BENGALURU-VARANASI,12066,All
2020,11,BENGALURU,VARANASI,10545,8122,BENGALURU-VARANASI,18667,All
2020,12,BENGALURU,VARANASI,7020,11167,BENGALURU-VARANASI,18187,All
2021,1,BENGALURU,VARANASI,4889,9101,BENGALURU-VARANASI,13990,All
2021,2,BENGALURU,VARANASI,6090,7194,BENGALURU-VARANASI,13284,All
2021,3,BENGALURU,VARANASI,7944,8288,BENGALURU-VARANASI,16232,All
2021,4,BENGALURU,VARANASI,11162,5832,BENGALURU-VARANASI,16994,All
2021,6,BENGALURU,VARANASI,1706,3577,BENGALURU-VARANASI,5283,All
2021,7,BENGALURU,VARANASI,3007,5037,BENGALURU-VARANASI,8044,All
2021,8,BENGALURU,VARANASI,4133,5900,BENGALURU-VARANASI,10033,All
2021,9,BENGALURU,VARANASI,3962,4751,BENGALURU-VARANASI,8713,All
2021,10,BENGALURU,VARANASI,8266,7094,BENGALURU-VARANASI,15360,All
2021,11,BENGALURU,VARANASI,14524,13223,BENGALURU-VARANASI,27747,All
2021,12,BENGALURU,VARANASI,9551,14123,BENGALURU-VARANASI,23674,All
2022,1,BENGALURU,VARANASI,6780,6006,BENGALURU-VARANASI,12786,All
2022,2,BENGALURU,VARANASI,8156,7668,BENGALURU-VARANASI,15824,All
2022,3,BENGALURU,VARANASI,13174,13809,BENGALURU-VARANASI,26983,All
2022,4,BENGALURU,VARANASI,15967,16042,BENGALURU-VARANASI,32009,All
2022,5,BENGALURU,VARANASI,12391,16832,BENGALURU-VARANASI,29223,All
2022,6,BENGALURU,VARANASI,10321,17191,BENGALURU-VARANASI,27512,All
2022,7,BENGALURU,VARANASI,10576,12544,BENGALURU-VARANASI,23120,All
2022,8,BENGALURU,VARANASI,9514,11005,BENGALURU-VARANASI,20519,All
2022,9,BENGALURU,VARANASI,12321,10455,BENGALURU-VARANASI,22776,All
2022,10,BENGALURU,VARANASI,16935,13540,BENGALURU-VARANASI,30475,All
2022,11,BENGALURU,VARANASI,14495,15243,BENGALURU-VARANASI,29738,All
2022,12,BENGALURU,VARANASI,12693,13501,BENGALURU-VARANASI,26194,All
2023,1,BENGALURU,VARANASI,12847,13130,BENGALURU-VARANASI,25977,All
2023,2,BENGALURU,VARANASI,16239,15739,BENGALURU-VARANASI,31978,All
2023,3,BENGALURU,VARANASI,21168,22668,BENGALURU-VARANASI,43836,All
2023,4,BENGALURU,VARANASI,21774,19422,BENGALURU-VARANASI,41196,All
2023,5,BENGALURU,VARANASI,16938,17686,BENGALURU-VARANASI,34624,All
2023,6,BENGALURU,VARANASI,17452,18430,BENGALURU-VARANASI,35882,All
2023,7,BENGALURU,VARANASI,15892,18297,BENGALURU-VARANASI,34189,All
2023,8,BENGALURU,VARANASI,16410,16791,BENGALURU-VARANASI,33201,All
2023,9,BENGALURU,VARANASI,16093,16594,BENGALURU-VARANASI,32687,All
2023,10,BENGALURU,VARANASI,17872,16702,BENGALURU-VARANASI,34574,All
2023,11,BENGALURU,VARANASI,24101,20129,BENGALURU-VARANASI,44230,All
2023,12,BENGALURU,VARANASI,24437,25937,BENGALURU-VARANASI,50374,All
2024,1,BENGALURU,VARANASI,20582,20453,BENGALURU-VARANASI,41035,All
2024,2,BENGALURU,VARANASI,24743,23857,BENGALURU-VARANASI,48600,All
2024,3,BENGALURU,VARANASI,30259,28125,BENGALURU-VARANASI,58384,All
2024,4,BENGALURU,VARANASI,29900,27250,BENGALURU-VARANASI,57150,All
2024,6,BENGALURU,VARANASI,30608,32069,BENGALURU-VARANASI,62677,All
2024,7,BENGALURU,VARANASI,29398,31739,BENGALURU-VARANASI,61137,All
2024,8,BENGALURU,VARANASI,29853,31490,BENGALURU-VARANASI,61343,All
2024,9,BENGALURU,VARANASI,31928,31725,BENGALURU-VARANASI,63653,All
2024,10,BENGALURU,VARANASI,42539,28704,BENGALURU-VARANASI,71243,All
2024,11,BENGALURU,VARANASI,43231,45280,BENGALURU-VARANASI,88511,All
2024,12,BENGALURU,VARANASI,37882,40439,BENGALURU-VARANASI,78321,All
2025,1,BENGALURU,VARANASI,39857,38542,BENGALURU-VARANASI,78399,All
2025,2,BENGALURU,VARANASI,52974,52524,BENGALURU-VARANASI,105498,All
2025,3,BENGALURU,VARANASI,48169,48785,BENGALURU-VARANASI,96954,All
2018,2,BENGALURU,VIDYANAGAR,0,60,BENGALURU-VIDYANAGAR,60,All
2018,3,BENGALURU,VIDYANAGAR,1326,1494,BENGALURU-VIDYANAGAR,2820,All
2018,4,BENGALURU,VIDYANAGAR,1576,1575,BENGALURU-VIDYANAGAR,3151,All
2018,5,BENGALURU,VIDYANAGAR,1458,1588,BENGALURU-VIDYANAGAR,3046,All
2018,6,BENGALURU,VIDYANAGAR,1595,1559,BENGALURU-VIDYANAGAR,3154,All
2018,7,BENGALURU,VIDYANAGAR,1518,1636,BENGALURU-VIDYANAGAR,3154,All
2018,8,BENGALURU,VIDYANAGAR,1629,1760,BENGALURU-VIDYANAGAR,3389,All
2018,9,BENGALURU,VIDYANAGAR,1540,1809,BENGALURU-VIDYANAGAR,3349,All
2018,10,BENGALURU,VIDYANAGAR,1690,1707,BENGALURU-VIDYANAGAR,3397,All
2018,11,BENGALURU,VIDYANAGAR,1546,1671,BENGALURU-VIDYANAGAR,3217,All
2018,12,BENGALURU,VIDYANAGAR,1670,1634,BENGALURU-VIDYANAGAR,3304,All
2019,1,BENGALURU,VIDYANAGAR,1651,1626,BENGALURU-VIDYANAGAR,3277,All
2019,2,BENGALURU,VIDYANAGAR,1416,1467,BENGALURU-VIDYANAGAR,2883,All
2019,3,BENGALURU,VIDYANAGAR,1409,1551,BENGALURU-VIDYANAGAR,2960,All
2019,4,BENGALURU,VIDYANAGAR,1406,1461,BENGALURU-VIDYANAGAR,2867,All
2019,5,BENGALURU,VIDYANAGAR,1376,1509,BENGALURU-VIDYANAGAR,2885,All
2019,6,BENGALURU,VIDYANAGAR,1615,1551,BENGALURU-VIDYANAGAR,3166,All
2019,7,BENGALURU,VIDYANAGAR,1521,1650,BENGALURU-VIDYANAGAR,3171,All
2019,8,BENGALURU,VIDYANAGAR,1483,1526,BENGALURU-VIDYANAGAR,3009,All
2019,9,BENGALURU,VIDYANAGAR,1059,1107,BENGALURU-VIDYANAGAR,2166,All
2019,10,BENGALURU,VIDYANAGAR,1216,1257,BENGALURU-VIDYANAGAR,2473,All
2019,11,BENGALURU,VIDYANAGAR,1597,1606,BENGALURU-VIDYANAGAR,3203,All
2019,12,BENGALURU,VIDYANAGAR,1686,1602,BENGALURU-VIDYANAGAR,3288,All
2020,1,BENGALURU,VIDYANAGAR,1450,1489,BENGALURU-VIDYANAGAR,2939,All
2020,2,BENGALURU,VIDYANAGAR,1655,1604,BENGALURU-VIDYANAGAR,3259,All
2020,3,BENGALURU,VIDYANAGAR,1067,882,BENGALURU-VIDYANAGAR,1949,All
2020,5,BENGALURU,VIDYANAGAR,76,42,BENGALURU-VIDYANAGAR,118,All
2020,6,BENGALURU,VIDYANAGAR,659,617,BENGALURU-VIDYANAGAR,1276,All
2020,7,BENGALURU,VIDYANAGAR,642,621,BENGALURU-VIDYANAGAR,1263,All
2020,8,BENGALURU,VIDYANAGAR,272,313,BENGALURU-VIDYANAGAR,585,All
2020,9,BENGALURU,VIDYANAGAR,214,182,BENGALURU-VIDYANAGAR,396,All
2020,10,BENGALURU,VIDYANAGAR,517,513,BENGALURU-VIDYANAGAR,1030,All
2020,11,BENGALURU,VIDYANAGAR,524,483,BENGALURU-VIDYANAGAR,1007,All
2020,12,BENGALURU,VIDYANAGAR,762,520,BENGALURU-VIDYANAGAR,1282,All
2021,1,BENGALURU,VIDYANAGAR,773,749,BENGALURU-VIDYANAGAR,1522,All
2021,2,BENGALURU,VIDYANAGAR,689,785,BENGALURU-VIDYANAGAR,1474,All
2021,3,BENGALURU,VIDYANAGAR,784,818,BENGALURU-VIDYANAGAR,1602,All
2021,4,BENGALURU,VIDYANAGAR,390,279,BENGALURU-VIDYANAGAR,669,All
2021,6,BENGALURU,VIDYANAGAR,133,158,BENGALURU-VIDYANAGAR,291,All
2021,7,BENGALURU,VIDYANAGAR,44,76,BENGALURU-VIDYANAGAR,120,All
2021,8,BENGALURU,VIDYANAGAR,650,667,BENGALURU-VIDYANAGAR,1317,All
2021,9,BENGALURU,VIDYANAGAR,218,153,BENGALURU-VIDYANAGAR,371,All
2021,10,BENGALURU,VIDYANAGAR,171,155,BENGALURU-VIDYANAGAR,326,All
2021,11,BENGALURU,VIDYANAGAR,103,54,BENGALURU-VIDYANAGAR,157,All
2022,2,BENGALURU,VIDYANAGAR,47,56,BENGALURU-VIDYANAGAR,103,All
2022,10,BENGALURU,VIDYANAGAR,26,50,BENGALURU-VIDYANAGAR,76,All
2022,11,BENGALURU,VIDYANAGAR,1012,1141,BENGALURU-VIDYANAGAR,2153,All
2022,12,BENGALURU,VIDYANAGAR,1311,1380,BENGALURU-VIDYANAGAR,2691,All
2023,1,BENGALURU,VIDYANAGAR,1462,1544,BENGALURU-VIDYANAGAR,3006,All
2023,2,BENGALURU,VIDYANAGAR,1374,1403,BENGALURU-VIDYANAGAR,2777,All
2023,3,BENGALURU,VIDYANAGAR,1126,1183,BENGALURU-VIDYANAGAR,2309,All
2023,4,BENGALURU,VIDYANAGAR,1142,1147,BENGALURU-VIDYANAGAR,2289,All
2023,5,BENGALURU,VIDYANAGAR,1446,1423,BENGALURU-VIDYANAGAR,2869,All
2023,6,BENGALURU,VIDYANAGAR,1269,1323,BENGALURU-VIDYANAGAR,2592,All
2023,7,BENGALURU,VIDYANAGAR,1442,1439,BENGALURU-VIDYANAGAR,2881,All
2023,8,BENGALURU,VIDYANAGAR,1223,1411,BENGALURU-VIDYANAGAR,2634,All
2023,9,BENGALURU,VIDYANAGAR,1361,1445,BENGALURU-VIDYANAGAR,2806,All
2023,10,BENGALURU,VIDYANAGAR,1428,1519,BENGALURU-VIDYANAGAR,2947,All
2023,11,BENGALURU,VIDYANAGAR,1220,1362,BENGALURU-VIDYANAGAR,2582,All
2023,12,BENGALURU,VIDYANAGAR,1361,1588,BENGALURU-VIDYANAGAR,2949,All
2024,1,BENGALURU,VIDYANAGAR,1497,1743,BENGALURU-VIDYANAGAR,3240,All
2024,2,BENGALURU,VIDYANAGAR,1296,1395,BENGALURU-VIDYANAGAR,2691,All
2024,3,BENGALURU,VIDYANAGAR,1342,1491,BENGALURU-VIDYANAGAR,2833,All
2024,4,BENGALURU,VIDYANAGAR,1063,1160,BENGALURU-VIDYANAGAR,2223,All
2024,6,BENGALURU,VIDYANAGAR,1382,1412,BENGALURU-VIDYANAGAR,2794,All
2024,7,BENGALURU,VIDYANAGAR,1230,1267,BENGALURU-VIDYANAGAR,2497,All
2024,8,BENGALURU,VIDYANAGAR,1227,1318,BENGALURU-VIDYANAGAR,2545,All
2024,9,BENGALURU,VIDYANAGAR,1090,1080,BENGALURU-VIDYANAGAR,2170,All
2024,10,BENGALURU,VIDYANAGAR,929,936,BENGALURU-VIDYANAGAR,1865,All
2024,11,BENGALURU,VIDYANAGAR,829,918,BENGALURU-VIDYANAGAR,1747,All
2024,12,BENGALURU,VIDYANAGAR,1019,994,BENGALURU-VIDYANAGAR,2013,All
2025,1,BENGALURU,VIDYANAGAR,662,782,BENGALURU-VIDYANAGAR,1444,All
2025,3,BENGALURU,VIDYANAGAR,564,566,BENGALURU-VIDYANAGAR,1130,All
2015,4,BENGALURU,VIJAYAWADA,4806,4751,BENGALURU-VIJAYAWADA,9557,All
2015,5,BENGALURU,VIJAYAWADA,4035,4348,BENGALURU-VIJAYAWADA,8383,All
2015,6,BENGALURU,VIJAYAWADA,4608,4449,BENGALURU-VIJAYAWADA,9057,All
2015,7,BENGALURU,VIJAYAWADA,4977,4875,BENGALURU-VIJAYAWADA,9852,All
2015,8,BENGALURU,VIJAYAWADA,3786,3748,BENGALURU-VIJAYAWADA,7534,All
2015,9,BENGALURU,VIJAYAWADA,3672,3426,BENGALURU-VIJAYAWADA,7098,All
2015,10,BENGALURU,VIJAYAWADA,3798,3536,BENGALURU-VIJAYAWADA,7334,All
2015,11,BENGALURU,VIJAYAWADA,3200,3273,BENGALURU-VIJAYAWADA,6473,All
2015,12,BENGALURU,VIJAYAWADA,3648,3503,BENGALURU-VIJAYAWADA,7151,All
2016,1,BENGALURU,VIJAYAWADA,5699,6183,BENGALURU-VIJAYAWADA,11882,All
2016,2,BENGALURU,VIJAYAWADA,6040,6048,BENGALURU-VIJAYAWADA,12088,All
2016,3,BENGALURU,VIJAYAWADA,6081,6011,BENGALURU-VIJAYAWADA,12092,All
2016,4,BENGALURU,VIJAYAWADA,6994,7069,BENGALURU-VIJAYAWADA,14063,All
2016,5,BENGALURU,VIJAYAWADA,6782,7433,BENGALURU-VIJAYAWADA,14215,All
2016,6,BENGALURU,VIJAYAWADA,6791,6612,BENGALURU-VIJAYAWADA,13403,All
2016,7,BENGALURU,VIJAYAWADA,6456,6571,BENGALURU-VIJAYAWADA,13027,All
2016,8,BENGALURU,VIJAYAWADA,5969,6276,BENGALURU-VIJAYAWADA,12245,All
2016,9,BENGALURU,VIJAYAWADA,7533,7604,BENGALURU-VIJAYAWADA,15137,All
2016,10,BENGALURU,VIJAYAWADA,8521,7883,BENGALURU-VIJAYAWADA,16404,All
2016,11,BENGALURU,VIJAYAWADA,7983,8246,BENGALURU-VIJAYAWADA,16229,All
2016,12,BENGALURU,VIJAYAWADA,7760,7767,BENGALURU-VIJAYAWADA,15527,All
2017,1,BENGALURU,VIJAYAWADA,6730,6566,BENGALURU-VIJAYAWADA,13296,All
2017,2,BENGALURU,VIJAYAWADA,6030,6100,BENGALURU-VIJAYAWADA,12130,All
2017,3,BENGALURU,VIJAYAWADA,4106,3987,BENGALURU-VIJAYAWADA,8093,All
2017,4,BENGALURU,VIJAYAWADA,4080,4024,BENGALURU-VIJAYAWADA,8104,All
2017,5,BENGALURU,VIJAYAWADA,5462,5598,BENGALURU-VIJAYAWADA,11060,All
2017,6,BENGALURU,VIJAYAWADA,6952,6814,BENGALURU-VIJAYAWADA,13766,All
2017,7,BENGALURU,VIJAYAWADA,7505,7424,BENGALURU-VIJAYAWADA,14929,All
2017,8,BENGALURU,VIJAYAWADA,7649,7645,BENGALURU-VIJAYAWADA,15294,All
2017,9,BENGALURU,VIJAYAWADA,7880,7807,BENGALURU-VIJAYAWADA,15687,All
2017,10,BENGALURU,VIJAYAWADA,7519,7323,BENGALURU-VIJAYAWADA,14842,All
2017,11,BENGALURU,VIJAYAWADA,6991,6960,BENGALURU-VIJAYAWADA,13951,All
2017,12,BENGALURU,VIJAYAWADA,5890,5917,BENGALURU-VIJAYAWADA,11807,All
2018,1,BENGALURU,VIJAYAWADA,5950,5823,BENGALURU-VIJAYAWADA,11773,All
2018,2,BENGALURU,VIJAYAWADA,6464,6472,BENGALURU-VIJAYAWADA,12936,All
2018,3,BENGALURU,VIJAYAWADA,9905,9836,BENGALURU-VIJAYAWADA,19741,All
2018,4,BENGALURU,VIJAYAWADA,11357,11598,BENGALURU-VIJAYAWADA,22955,All
2018,5,BENGALURU,VIJAYAWADA,12594,13774,BENGALURU-VIJAYAWADA,26368,All
2018,6,BENGALURU,VIJAYAWADA,12345,12240,BENGALURU-VIJAYAWADA,24585,All
2018,7,BENGALURU,VIJAYAWADA,12356,12609,BENGALURU-VIJAYAWADA,24965,All
2018,8,BENGALURU,VIJAYAWADA,12399,12373,BENGALURU-VIJAYAWADA,24772,All
2018,9,BENGALURU,VIJAYAWADA,11417,11361,BENGALURU-VIJAYAWADA,22778,All
2018,10,BENGALURU,VIJAYAWADA,10526,10200,BENGALURU-VIJAYAWADA,20726,All
2018,11,BENGALURU,VIJAYAWADA,12396,10093,BENGALURU-VIJAYAWADA,22489,All
2018,12,BENGALURU,VIJAYAWADA,13556,10645,BENGALURU-VIJAYAWADA,24201,All
2019,1,BENGALURU,VIJAYAWADA,11556,12007,BENGALURU-VIJAYAWADA,23563,All
2019,2,BENGALURU,VIJAYAWADA,11576,8901,BENGALURU-VIJAYAWADA,20477,All
2019,3,BENGALURU,VIJAYAWADA,13416,13019,BENGALURU-VIJAYAWADA,26435,All
2019,4,BENGALURU,VIJAYAWADA,11738,11354,BENGALURU-VIJAYAWADA,23092,All
2019,5,BENGALURU,VIJAYAWADA,12278,12612,BENGALURU-VIJAYAWADA,24890,All
2019,6,BENGALURU,VIJAYAWADA,12338,11985,BENGALURU-VIJAYAWADA,24323,All
2019,7,BENGALURU,VIJAYAWADA,11736,11497,BENGALURU-VIJAYAWADA,23233,All
2019,8,BENGALURU,VIJAYAWADA,11373,11094,BENGALURU-VIJAYAWADA,22467,All
2019,9,BENGALURU,VIJAYAWADA,10519,10019,BENGALURU-VIJAYAWADA,20538,All
2019,10,BENGALURU,VIJAYAWADA,11543,10682,BENGALURU-VIJAYAWADA,22225,All
2019,11,BENGALURU,VIJAYAWADA,10728,11044,BENGALURU-VIJAYAWADA,21772,All
2019,12,BENGALURU,VIJAYAWADA,11153,10997,BENGALURU-VIJAYAWADA,22150,All
2020,1,BENGALURU,VIJAYAWADA,11076,11528,BENGALURU-VIJAYAWADA,22604,All
2020,2,BENGALURU,VIJAYAWADA,12128,12333,BENGALURU-VIJAYAWADA,24461,All
2020,3,BENGALURU,VIJAYAWADA,8815,7685,BENGALURU-VIJAYAWADA,16500,All
2020,5,BENGALURU,VIJAYAWADA,1251,1177,BENGALURU-VIJAYAWADA,2428,All
2020,6,BENGALURU,VIJAYAWADA,3873,4241,BENGALURU-VIJAYAWADA,8114,All
2020,7,BENGALURU,VIJAYAWADA,2753,2198,BENGALURU-VIJAYAWADA,4951,All
2020,8,BENGALURU,VIJAYAWADA,4143,4249,BENGALURU-VIJAYAWADA,8392,All
2020,9,BENGALURU,VIJAYAWADA,5306,6048,BENGALURU-VIJAYAWADA,11354,All
2020,10,BENGALURU,VIJAYAWADA,7999,7540,BENGALURU-VIJAYAWADA,15539,All
2020,11,BENGALURU,VIJAYAWADA,7732,8132,BENGALURU-VIJAYAWADA,15864,All
2020,12,BENGALURU,VIJAYAWADA,8563,8144,BENGALURU-VIJAYAWADA,16707,All
2021,1,BENGALURU,VIJAYAWADA,7820,8744,BENGALURU-VIJAYAWADA,16564,All
2021,2,BENGALURU,VIJAYAWADA,6601,7333,BENGALURU-VIJAYAWADA,13934,All
2021,3,BENGALURU,VIJAYAWADA,6230,6879,BENGALURU-VIJAYAWADA,13109,All
2021,4,BENGALURU,VIJAYAWADA,4960,4543,BENGALURU-VIJAYAWADA,9503,All
2021,6,BENGALURU,VIJAYAWADA,3630,4509,BENGALURU-VIJAYAWADA,8139,All
2021,7,BENGALURU,VIJAYAWADA,6472,6846,BENGALURU-VIJAYAWADA,13318,All
2021,8,BENGALURU,VIJAYAWADA,7211,7507,BENGALURU-VIJAYAWADA,14718,All
2021,9,BENGALURU,VIJAYAWADA,5221,5336,BENGALURU-VIJAYAWADA,10557,All
2021,10,BENGALURU,VIJAYAWADA,5961,5647,BENGALURU-VIJAYAWADA,11608,All
2021,11,BENGALURU,VIJAYAWADA,6581,7039,BENGALURU-VIJAYAWADA,13620,All
2021,12,BENGALURU,VIJAYAWADA,8433,8619,BENGALURU-VIJAYAWADA,17052,All
2022,1,BENGALURU,VIJAYAWADA,4999,5060,BENGALURU-VIJAYAWADA,10059,All
2022,2,BENGALURU,VIJAYAWADA,4377,4625,BENGALURU-VIJAYAWADA,9002,All
2022,3,BENGALURU,VIJAYAWADA,8548,9358,BENGALURU-VIJAYAWADA,17906,All
2022,4,BENGALURU,VIJAYAWADA,7553,8227,BENGALURU-VIJAYAWADA,15780,All
2022,5,BENGALURU,VIJAYAWADA,8767,9455,BENGALURU-VIJAYAWADA,18222,All
2022,6,BENGALURU,VIJAYAWADA,7078,7200,BENGALURU-VIJAYAWADA,14278,All
2022,7,BENGALURU,VIJAYAWADA,8853,9500,BENGALURU-VIJAYAWADA,18353,All
2022,8,BENGALURU,VIJAYAWADA,9028,10010,BENGALURU-VIJAYAWADA,19038,All
2022,9,BENGALURU,VIJAYAWADA,7132,7983,BENGALURU-VIJAYAWADA,15115,All
2022,10,BENGALURU,VIJAYAWADA,9921,9991,BENGALURU-VIJAYAWADA,19912,All
2022,11,BENGALURU,VIJAYAWADA,9723,10016,BENGALURU-VIJAYAWADA,19739,All
2022,12,BENGALURU,VIJAYAWADA,10027,9936,BENGALURU-VIJAYAWADA,19963,All
2023,1,BENGALURU,VIJAYAWADA,9579,10064,BENGALURU-VIJAYAWADA,19643,All
2023,2,BENGALURU,VIJAYAWADA,8113,8322,BENGALURU-VIJAYAWADA,16435,All
2023,3,BENGALURU,VIJAYAWADA,9578,9624,BENGALURU-VIJAYAWADA,19202,All
2023,4,BENGALURU,VIJAYAWADA,9967,9699,BENGALURU-VIJAYAWADA,19666,All
2023,5,BENGALURU,VIJAYAWADA,10377,10249,BENGALURU-VIJAYAWADA,20626,All
2023,6,BENGALURU,VIJAYAWADA,10543,10196,BENGALURU-VIJAYAWADA,20739,All
2023,7,BENGALURU,VIJAYAWADA,10051,9996,BENGALURU-VIJAYAWADA,20047,All
2023,8,BENGALURU,VIJAYAWADA,10061,9841,BENGALURU-VIJAYAWADA,19902,All
2023,9,BENGALURU,VIJAYAWADA,10143,10745,BENGALURU-VIJAYAWADA,20888,All
2023,10,BENGALURU,VIJAYAWADA,11802,11103,BENGALURU-VIJAYAWADA,22905,All
2023,11,BENGALURU,VIJAYAWADA,10216,10297,BENGALURU-VIJAYAWADA,20513,All
2023,12,BENGALURU,VIJAYAWADA,10766,10865,BENGALURU-VIJAYAWADA,21631,All
2024,1,BENGALURU,VIJAYAWADA,10835,11485,BENGALURU-VIJAYAWADA,22320,All
2024,2,BENGALURU,VIJAYAWADA,10058,9970,BENGALURU-VIJAYAWADA,20028,All
2024,3,BENGALURU,VIJAYAWADA,10437,10381,BENGALURU-VIJAYAWADA,20818,All
2024,4,BENGALURU,VIJAYAWADA,10462,10630,BENGALURU-VIJAYAWADA,21092,All
2024,6,BENGALURU,VIJAYAWADA,12280,11457,BENGALURU-VIJAYAWADA,23737,All
2024,7,BENGALURU,VIJAYAWADA,11699,11762,BENGALURU-VIJAYAWADA,23461,All
2024,8,BENGALURU,VIJAYAWADA,12417,12772,BENGALURU-VIJAYAWADA,25189,All
2024,9,BENGALURU,VIJAYAWADA,12666,12365,BENGALURU-VIJAYAWADA,25031,All
2024,10,BENGALURU,VIJAYAWADA,14010,12264,BENGALURU-VIJAYAWADA,26274,All
2024,11,BENGALURU,VIJAYAWADA,12247,13214,BENGALURU-VIJAYAWADA,25461,All
2024,12,BENGALURU,VIJAYAWADA,13840,13738,BENGALURU-VIJAYAWADA,27578,All
2025,1,BENGALURU,VIJAYAWADA,14246,15696,BENGALURU-VIJAYAWADA,29942,All
2025,2,BENGALURU,VIJAYAWADA,11866,12191,BENGALURU-VIJAYAWADA,24057,All
2025,3,BENGALURU,VIJAYAWADA,13737,13637,BENGALURU-VIJAYAWADA,27374,All
2015,4,BENGALURU,VISAKHAPATNAM,10307,10019,BENGALURU-VISAKHAPATNAM,20326,All
2015,5,BENGALURU,VISAKHAPATNAM,10536,11301,BENGALURU-VISAKHAPATNAM,21837,All
2015,6,BENGALURU,VISAKHAPATNAM,11152,11405,BENGALURU-VISAKHAPATNAM,22557,All
2015,7,BENGALURU,VISAKHAPATNAM,16536,16098,BENGALURU-VISAKHAPATNAM,32634,All
2015,8,BENGALURU,VISAKHAPATNAM,16479,17062,BENGALURU-VISAKHAPATNAM,33541,All
2015,9,BENGALURU,VISAKHAPATNAM,12936,12691,BENGALURU-VISAKHAPATNAM,25627,All
2015,9,BENGALURU,VISAKHAPATNAM,4949,4664,BENGALURU-VISAKHAPATNAM,9613,All
2015,10,BENGALURU,VISAKHAPATNAM,20013,18810,BENGALURU-VISAKHAPATNAM,38823,All
2015,11,BENGALURU,VISAKHAPATNAM,15054,14563,BENGALURU-VISAKHAPATNAM,29617,All
2015,12,BENGALURU,VISAKHAPATNAM,17172,16212,BENGALURU-VISAKHAPATNAM,33384,All
2016,1,BENGALURU,VISAKHAPATNAM,19060,19317,BENGALURU-VISAKHAPATNAM,38377,All
2016,2,BENGALURU,VISAKHAPATNAM,19265,19638,BENGALURU-VISAKHAPATNAM,38903,All
2016,3,BENGALURU,VISAKHAPATNAM,16505,16847,BENGALURU-VISAKHAPATNAM,33352,All
2016,4,BENGALURU,VISAKHAPATNAM,20261,19995,BENGALURU-VISAKHAPATNAM,40256,All
2016,5,BENGALURU,VISAKHAPATNAM,16917,17748,BENGALURU-VISAKHAPATNAM,34665,All
2016,6,BENGALURU,VISAKHAPATNAM,19080,18619,BENGALURU-VISAKHAPATNAM,37699,All
2016,7,BENGALURU,VISAKHAPATNAM,21438,21280,BENGALURU-VISAKHAPATNAM,42718,All
2016,8,BENGALURU,VISAKHAPATNAM,21551,21785,BENGALURU-VISAKHAPATNAM,43336,All
2016,9,BENGALURU,VISAKHAPATNAM,21901,20878,BENGALURU-VISAKHAPATNAM,42779,All
2016,10,BENGALURU,VISAKHAPATNAM,24732,22223,BENGALURU-VISAKHAPATNAM,46955,All
2016,11,BENGALURU,VISAKHAPATNAM,22261,23728,BENGALURU-VISAKHAPATNAM,45989,All
2016,12,BENGALURU,VISAKHAPATNAM,22869,22315,BENGALURU-VISAKHAPATNAM,45184,All
2017,1,BENGALURU,VISAKHAPATNAM,22224,22187,BENGALURU-VISAKHAPATNAM,44411,All
2017,2,BENGALURU,VISAKHAPATNAM,18979,18872,BENGALURU-VISAKHAPATNAM,37851,All
2017,3,BENGALURU,VISAKHAPATNAM,18584,17793,BENGALURU-VISAKHAPATNAM,36377,All
2017,4,BENGALURU,VISAKHAPATNAM,20451,18569,BENGALURU-VISAKHAPATNAM,39020,All
2017,5,BENGALURU,VISAKHAPATNAM,20809,21381,BENGALURU-VISAKHAPATNAM,42190,All
2017,6,BENGALURU,VISAKHAPATNAM,20444,19072,BENGALURU-VISAKHAPATNAM,39516,All
2017,7,BENGALURU,VISAKHAPATNAM,19583,19152,BENGALURU-VISAKHAPATNAM,38735,All
2017,8,BENGALURU,VISAKHAPATNAM,20457,20494,BENGALURU-VISAKHAPATNAM,40951,All
2017,9,BENGALURU,VISAKHAPATNAM,19559,18532,BENGALURU-VISAKHAPATNAM,38091,All
2017,10,BENGALURU,VISAKHAPATNAM,19707,19132,BENGALURU-VISAKHAPATNAM,38839,All
2017,11,BENGALURU,VISAKHAPATNAM,17406,17564,BENGALURU-VISAKHAPATNAM,34970,All
2017,12,BENGALURU,VISAKHAPATNAM,20271,19757,BENGALURU-VISAKHAPATNAM,40028,All
2018,1,BENGALURU,VISAKHAPATNAM,20650,21383,BENGALURU-VISAKHAPATNAM,42033,All
2018,2,BENGALURU,VISAKHAPATNAM,21364,19660,BENGALURU-VISAKHAPATNAM,41024,All
2018,3,BENGALURU,VISAKHAPATNAM,24345,23484,BENGALURU-VISAKHAPATNAM,47829,All
2018,4,BENGALURU,VISAKHAPATNAM,24795,22853,BENGALURU-VISAKHAPATNAM,47648,All
2018,5,BENGALURU,VISAKHAPATNAM,23306,27068,BENGALURU-VISAKHAPATNAM,50374,All
2018,6,BENGALURU,VISAKHAPATNAM,24699,17360,BENGALURU-VISAKHAPATNAM,42059,All
2018,7,BENGALURU,VISAKHAPATNAM,22510,15885,BENGALURU-VISAKHAPATNAM,38395,All
2018,8,BENGALURU,VISAKHAPATNAM,25954,24792,BENGALURU-VISAKHAPATNAM,50746,All
2018,9,BENGALURU,VISAKHAPATNAM,23975,24065,BENGALURU-VISAKHAPATNAM,48040,All
2018,10,BENGALURU,VISAKHAPATNAM,31220,28847,BENGALURU-VISAKHAPATNAM,60067,All
2018,11,BENGALURU,VISAKHAPATNAM,26691,27269,BENGALURU-VISAKHAPATNAM,53960,All
2018,12,BENGALURU,VISAKHAPATNAM,31239,29510,BENGALURU-VISAKHAPATNAM,60749,All
2019,1,BENGALURU,VISAKHAPATNAM,26926,27697,BENGALURU-VISAKHAPATNAM,54623,All
2019,2,BENGALURU,VISAKHAPATNAM,22399,22208,BENGALURU-VISAKHAPATNAM,44607,All
2019,3,BENGALURU,VISAKHAPATNAM,25564,25140,BENGALURU-VISAKHAPATNAM,50704,All
2019,4,BENGALURU,VISAKHAPATNAM,23628,22649,BENGALURU-VISAKHAPATNAM,46277,All
2019,5,BENGALURU,VISAKHAPATNAM,23457,24839,BENGALURU-VISAKHAPATNAM,48296,All
2019,6,BENGALURU,VISAKHAPATNAM,19070,19192,BENGALURU-VISAKHAPATNAM,38262,All
2019,7,BENGALURU,VISAKHAPATNAM,16560,17374,BENGALURU-VISAKHAPATNAM,33934,All
2019,8,BENGALURU,VISAKHAPATNAM,15261,15073,BENGALURU-VISAKHAPATNAM,30334,All
2019,9,BENGALURU,VISAKHAPATNAM,12826,13014,BENGALURU-VISAKHAPATNAM,25840,All
2019,10,BENGALURU,VISAKHAPATNAM,15393,14869,BENGALURU-VISAKHAPATNAM,30262,All
2019,11,BENGALURU,VISAKHAPATNAM,19793,20045,BENGALURU-VISAKHAPATNAM,39838,All
2019,12,BENGALURU,VISAKHAPATNAM,25925,23935,BENGALURU-VISAKHAPATNAM,49860,All
2020,1,BENGALURU,VISAKHAPATNAM,23246,23326,BENGALURU-VISAKHAPATNAM,46572,All
2020,2,BENGALURU,VISAKHAPATNAM,20950,20460,BENGALURU-VISAKHAPATNAM,41410,All
2020,3,BENGALURU,VISAKHAPATNAM,16423,11183,BENGALURU-VISAKHAPATNAM,27606,All
2020,5,BENGALURU,VISAKHAPATNAM,1742,1140,BENGALURU-VISAKHAPATNAM,2882,All
2020,6,BENGALURU,VISAKHAPATNAM,6579,5004,BENGALURU-VISAKHAPATNAM,11583,All
2020,7,BENGALURU,VISAKHAPATNAM,4891,3689,BENGALURU-VISAKHAPATNAM,8580,All
2020,8,BENGALURU,VISAKHAPATNAM,5800,6216,BENGALURU-VISAKHAPATNAM,12016,All
2020,9,BENGALURU,VISAKHAPATNAM,6643,7845,BENGALURU-VISAKHAPATNAM,14488,All
2020,10,BENGALURU,VISAKHAPATNAM,9440,9789,BENGALURU-VISAKHAPATNAM,19229,All
2020,11,BENGALURU,VISAKHAPATNAM,10235,10665,BENGALURU-VISAKHAPATNAM,20900,All
2020,12,BENGALURU,VISAKHAPATNAM,16080,14251,BENGALURU-VISAKHAPATNAM,30331,All
2021,1,BENGALURU,VISAKHAPATNAM,17714,19386,BENGALURU-VISAKHAPATNAM,37100,All
2021,2,BENGALURU,VISAKHAPATNAM,13026,14683,BENGALURU-VISAKHAPATNAM,27709,All
2021,3,BENGALURU,VISAKHAPATNAM,13245,13454,BENGALURU-VISAKHAPATNAM,26699,All
2021,4,BENGALURU,VISAKHAPATNAM,11589,8244,BENGALURU-VISAKHAPATNAM,19833,All
2021,6,BENGALURU,VISAKHAPATNAM,3951,4952,BENGALURU-VISAKHAPATNAM,8903,All
2021,7,BENGALURU,VISAKHAPATNAM,8837,9061,BENGALURU-VISAKHAPATNAM,17898,All
2021,8,BENGALURU,VISAKHAPATNAM,13991,13339,BENGALURU-VISAKHAPATNAM,27330,All
2021,9,BENGALURU,VISAKHAPATNAM,12609,12912,BENGALURU-VISAKHAPATNAM,25521,All
2021,10,BENGALURU,VISAKHAPATNAM,18261,17211,BENGALURU-VISAKHAPATNAM,35472,All
2021,11,BENGALURU,VISAKHAPATNAM,17935,18591,BENGALURU-VISAKHAPATNAM,36526,All
2021,12,BENGALURU,VISAKHAPATNAM,20916,19491,BENGALURU-VISAKHAPATNAM,40407,All
2022,1,BENGALURU,VISAKHAPATNAM,13407,11926,BENGALURU-VISAKHAPATNAM,25333,All
2022,2,BENGALURU,VISAKHAPATNAM,11913,13406,BENGALURU-VISAKHAPATNAM,25319,All
2022,3,BENGALURU,VISAKHAPATNAM,14885,15754,BENGALURU-VISAKHAPATNAM,30639,All
2022,4,BENGALURU,VISAKHAPATNAM,16004,16796,BENGALURU-VISAKHAPATNAM,32800,All
2022,5,BENGALURU,VISAKHAPATNAM,14503,19251,BENGALURU-VISAKHAPATNAM,33754,All
2022,6,BENGALURU,VISAKHAPATNAM,15624,17202,BENGALURU-VISAKHAPATNAM,32826,All
2022,7,BENGALURU,VISAKHAPATNAM,13967,15149,BENGALURU-VISAKHAPATNAM,29116,All
2022,8,BENGALURU,VISAKHAPATNAM,17465,20398,BENGALURU-VISAKHAPATNAM,37863,All
2022,9,BENGALURU,VISAKHAPATNAM,15216,15696,BENGALURU-VISAKHAPATNAM,30912,All
2022,10,BENGALURU,VISAKHAPATNAM,20502,20153,BENGALURU-VISAKHAPATNAM,40655,All
2022,11,BENGALURU,VISAKHAPATNAM,16887,19673,BENGALURU-VISAKHAPATNAM,36560,All
2022,12,BENGALURU,VISAKHAPATNAM,31121,30363,BENGALURU-VISAKHAPATNAM,61484,All
2023,1,BENGALURU,VISAKHAPATNAM,33678,35019,BENGALURU-VISAKHAPATNAM,68697,All
2023,2,BENGALURU,VISAKHAPATNAM,27343,27847,BENGALURU-VISAKHAPATNAM,55190,All
2023,3,BENGALURU,VISAKHAPATNAM,32134,31602,BENGALURU-VISAKHAPATNAM,63736,All
2023,4,BENGALURU,VISAKHAPATNAM,36445,34241,BENGALURU-VISAKHAPATNAM,70686,All
2023,5,BENGALURU,VISAKHAPATNAM,36262,39680,BENGALURU-VISAKHAPATNAM,75942,All
2023,6,BENGALURU,VISAKHAPATNAM,27496,27617,BENGALURU-VISAKHAPATNAM,55113,All
2023,7,BENGALURU,VISAKHAPATNAM,23011,23033,BENGALURU-VISAKHAPATNAM,46044,All
2023,8,BENGALURU,VISAKHAPATNAM,24654,23546,BENGALURU-VISAKHAPATNAM,48200,All
2023,9,BENGALURU,VISAKHAPATNAM,20844,21566,BENGALURU-VISAKHAPATNAM,42410,All
2023,10,BENGALURU,VISAKHAPATNAM,24555,22661,BENGALURU-VISAKHAPATNAM,47216,All
2023,11,BENGALURU,VISAKHAPATNAM,20134,20004,BENGALURU-VISAKHAPATNAM,40138,All
2023,12,BENGALURU,VISAKHAPATNAM,20342,19488,BENGALURU-VISAKHAPATNAM,39830,All
2024,1,BENGALURU,VISAKHAPATNAM,19905,20830,BENGALURU-VISAKHAPATNAM,40735,All
2024,2,BENGALURU,VISAKHAPATNAM,19592,19476,BENGALURU-VISAKHAPATNAM,39068,All
2024,3,BENGALURU,VISAKHAPATNAM,24734,24073,BENGALURU-VISAKHAPATNAM,48807,All
2024,4,BENGALURU,VISAKHAPATNAM,25093,25045,BENGALURU-VISAKHAPATNAM,50138,All
2024,6,BENGALURU,VISAKHAPATNAM,22760,22399,BENGALURU-VISAKHAPATNAM,45159,All
2024,7,BENGALURU,VISAKHAPATNAM,20389,22973,BENGALURU-VISAKHAPATNAM,43362,All
2024,8,BENGALURU,VISAKHAPATNAM,24213,26134,BENGALURU-VISAKHAPATNAM,50347,All
2024,9,BENGALURU,VISAKHAPATNAM,21277,21201,BENGALURU-VISAKHAPATNAM,42478,All
2024,10,BENGALURU,VISAKHAPATNAM,25886,22605,BENGALURU-VISAKHAPATNAM,48491,All
2024,11,BENGALURU,VISAKHAPATNAM,16830,17878,BENGALURU-VISAKHAPATNAM,34708,All
2024,12,BENGALURU,VISAKHAPATNAM,20732,20268,BENGALURU-VISAKHAPATNAM,41000,All
2025,1,BENGALURU,VISAKHAPATNAM,19458,20777,BENGALURU-VISAKHAPATNAM,40235,All
2025,2,BENGALURU,VISAKHAPATNAM,17975,17358,BENGALURU-VISAKHAPATNAM,35333,All
2025,3,BENGALURU,VISAKHAPATNAM,20386,19948,BENGALURU-VISAKHAPATNAM,40334,All
2025,1,BHATINDA,CHANDIGARH,34,0,BHATINDA-CHANDIGARH,34,All
2016,12,BHATINDA,DELHI,290,321,BHATINDA-DELHI,611,All
2017,1,BHATINDA,DELHI,406,528,BHATINDA-DELHI,934,All
2017,2,BHATINDA,DELHI,391,402,BHATINDA-DELHI,793,All
2017,3,BHATINDA,DELHI,438,453,BHATINDA-DELHI,891,All
2017,4,BHATINDA,DELHI,397,431,BHATINDA-DELHI,828,All
2017,5,BHATINDA,DELHI,608,624,BHATINDA-DELHI,1232,All
2017,6,BHATINDA,DELHI,662,581,BHATINDA-DELHI,1243,All
2017,7,BHATINDA,DELHI,542,540,BHATINDA-DELHI,1082,All
2017,8,BHATINDA,DELHI,616,622,BHATINDA-DELHI,1238,All
2017,9,BHATINDA,DELHI,578,699,BHATINDA-DELHI,1277,All
2017,10,BHATINDA,DELHI,680,712,BHATINDA-DELHI,1392,All
2017,11,BHATINDA,DELHI,438,540,BHATINDA-DELHI,978,All
2017,12,BHATINDA,DELHI,762,748,BHATINDA-DELHI,1510,All
2018,1,BHATINDA,DELHI,472,485,BHATINDA-DELHI,957,All
2018,2,BHATINDA,DELHI,624,669,BHATINDA-DELHI,1293,All
2018,3,BHATINDA,DELHI,740,756,BHATINDA-DELHI,1496,All
2018,4,BHATINDA,DELHI,672,623,BHATINDA-DELHI,1295,All
2018,5,BHATINDA,DELHI,771,716,BHATINDA-DELHI,1487,All
2018,6,BHATINDA,DELHI,551,534,BHATINDA-DELHI,1085,All
2018,7,BHATINDA,DELHI,644,618,BHATINDA-DELHI,1262,All
2018,8,BHATINDA,DELHI,757,790,BHATINDA-DELHI,1547,All
2018,9,BHATINDA,DELHI,767,714,BHATINDA-DELHI,1481,All
2018,10,BHATINDA,DELHI,828,760,BHATINDA-DELHI,1588,All
2018,11,BHATINDA,DELHI,794,619,BHATINDA-DELHI,1413,All
2018,12,BHATINDA,DELHI,825,677,BHATINDA-DELHI,1502,All
2019,1,BHATINDA,DELHI,844,661,BHATINDA-DELHI,1505,All
2019,2,BHATINDA,DELHI,579,638,BHATINDA-DELHI,1217,All
2019,3,BHATINDA,DELHI,695,633,BHATINDA-DELHI,1328,All
2019,4,BHATINDA,DELHI,774,696,BHATINDA-DELHI,1470,All
2019,5,BHATINDA,DELHI,792,702,BHATINDA-DELHI,1494,All
2019,6,BHATINDA,DELHI,859,760,BHATINDA-DELHI,1619,All
2019,7,BHATINDA,DELHI,904,788,BHATINDA-DELHI,1692,All
2019,8,BHATINDA,DELHI,613,650,BHATINDA-DELHI,1263,All
2019,9,BHATINDA,DELHI,644,615,BHATINDA-DELHI,1259,All
2019,10,BHATINDA,DELHI,628,675,BHATINDA-DELHI,1303,All
2019,11,BHATINDA,DELHI,441,494,BHATINDA-DELHI,935,All
2019,12,BHATINDA,DELHI,438,549,BHATINDA-DELHI,987,All
2020,1,BHATINDA,DELHI,382,477,BHATINDA-DELHI,859,All
2020,2,BHATINDA,DELHI,539,651,BHATINDA-DELHI,1190,All
2020,3,BHATINDA,DELHI,340,407,BHATINDA-DELHI,747,All
2023,10,BHATINDA,DELHI,309,289,BHATINDA-DELHI,598,All
2023,11,BHATINDA,DELHI,391,366,BHATINDA-DELHI,757,All
2023,12,BHATINDA,DELHI,470,495,BHATINDA-DELHI,965,All
2024,1,BHATINDA,DELHI,553,603,BHATINDA-DELHI,1156,All
2024,2,BHATINDA,DELHI,941,931,BHATINDA-DELHI,1872,All
2024,3,BHATINDA,DELHI,971,1065,BHATINDA-DELHI,2036,All
2024,4,BHATINDA,DELHI,937,940,BHATINDA-DELHI,1877,All
2024,6,BHATINDA,DELHI,1226,1213,BHATINDA-DELHI,2439,All
2024,7,BHATINDA,DELHI,1240,1238,BHATINDA-DELHI,2478,All
2024,8,BHATINDA,DELHI,1330,1302,BHATINDA-DELHI,2632,All
2024,9,BHATINDA,DELHI,1205,1129,BHATINDA-DELHI,2334,All
2024,10,BHATINDA,DELHI,1078,1248,BHATINDA-DELHI,2326,All
2024,11,BHATINDA,DELHI,1279,1248,BHATINDA-DELHI,2527,All
2024,12,BHATINDA,DELHI,1243,1217,BHATINDA-DELHI,2460,All
2025,1,BHATINDA,DELHI,1114,1115,BHATINDA-DELHI,2229,All
2025,2,BHATINDA,DELHI,1120,1124,BHATINDA-DELHI,2244,All
2025,3,BHATINDA,DELHI,1095,1099,BHATINDA-DELHI,2194,All
2023,9,BHATINDA,GHAZIABAD,42,45,BHATINDA-GHAZIABAD,87,All
2023,10,BHATINDA,GHAZIABAD,97,78,BHATINDA-GHAZIABAD,175,All
2023,11,BHATINDA,GHAZIABAD,102,97,BHATINDA-GHAZIABAD,199,All
2023,12,BHATINDA,GHAZIABAD,83,85,BHATINDA-GHAZIABAD,168,All
2024,1,BHATINDA,GHAZIABAD,52,30,BHATINDA-GHAZIABAD,82,All
2024,2,BHATINDA,HINDON AIRPORT,22,20,BHATINDA-HINDON AIRPORT,42,All
2024,3,BHATINDA,HINDON AIRPORT,20,15,BHATINDA-HINDON AIRPORT,35,All
2024,4,BHATINDA,HINDON AIRPORT,14,21,BHATINDA-HINDON AIRPORT,35,All
2024,6,BHATINDA,HINDON AIRPORT,107,84,BHATINDA-HINDON AIRPORT,191,All
2024,7,BHATINDA,HINDON AIRPORT,65,53,BHATINDA-HINDON AIRPORT,118,All
2024,8,BHATINDA,HINDON AIRPORT,155,107,BHATINDA-HINDON AIRPORT,262,All
2024,9,BHATINDA,HINDON AIRPORT,118,97,BHATINDA-HINDON AIRPORT,215,All
2024,10,BHATINDA,HINDON AIRPORT,116,116,BHATINDA-HINDON AIRPORT,232,All
2024,11,BHATINDA,HINDON AIRPORT,77,84,BHATINDA-HINDON AIRPORT,161,All
2024,12,BHATINDA,HINDON AIRPORT,90,70,BHATINDA-HINDON AIRPORT,160,All
2025,1,BHATINDA,HINDON AIRPORT,102,100,BHATINDA-HINDON AIRPORT,202,All
2025,2,BHATINDA,HINDON AIRPORT,16,15,BHATINDA-HINDON AIRPORT,31,All
2025,3,BHATINDA,HINDON AIRPORT,39,32,BHATINDA-HINDON AIRPORT,71,All
2018,2,BHATINDA,JAMMU,66,29,BHATINDA-JAMMU,95,All
2018,3,BHATINDA,JAMMU,1625,1301,BHATINDA-JAMMU,2926,All
2018,4,BHATINDA,JAMMU,1453,1278,BHATINDA-JAMMU,2731,All
2018,5,BHATINDA,JAMMU,1261,1047,BHATINDA-JAMMU,2308,All
2018,6,BHATINDA,JAMMU,1434,1179,BHATINDA-JAMMU,2613,All
2018,7,BHATINDA,JAMMU,1321,1183,BHATINDA-JAMMU,2504,All
2018,8,BHATINDA,JAMMU,822,593,BHATINDA-JAMMU,1415,All
2018,9,BHATINDA,JAMMU,1009,902,BHATINDA-JAMMU,1911,All
2018,10,BHATINDA,JAMMU,998,1017,BHATINDA-JAMMU,2015,All
2018,11,BHATINDA,JAMMU,697,863,BHATINDA-JAMMU,1560,All
2018,12,BHATINDA,JAMMU,838,921,BHATINDA-JAMMU,1759,All
2019,1,BHATINDA,JAMMU,898,948,BHATINDA-JAMMU,1846,All
2019,2,BHATINDA,JAMMU,176,233,BHATINDA-JAMMU,409,All
2019,3,BHATINDA,JAMMU,660,513,BHATINDA-JAMMU,1173,All
2019,4,BHATINDA,JAMMU,898,913,BHATINDA-JAMMU,1811,All
2019,5,BHATINDA,JAMMU,875,741,BHATINDA-JAMMU,1616,All
2019,6,BHATINDA,JAMMU,1226,1096,BHATINDA-JAMMU,2322,All
2019,7,BHATINDA,JAMMU,988,898,BHATINDA-JAMMU,1886,All
2019,8,BHATINDA,JAMMU,607,466,BHATINDA-JAMMU,1073,All
2019,9,BHATINDA,JAMMU,627,412,BHATINDA-JAMMU,1039,All
2019,10,BHATINDA,JAMMU,204,189,BHATINDA-JAMMU,393,All
2020,12,BHAVNAGAR,BHUJ,29,21,BHAVNAGAR-BHUJ,50,All
2021,1,BHAVNAGAR,BHUJ,80,72,BHAVNAGAR-BHUJ,152,All
2021,8,BHAVNAGAR,DELHI,224,202,BHAVNAGAR-DELHI,426,All
2021,9,BHAVNAGAR,DELHI,453,486,BHAVNAGAR-DELHI,939,All
2021,10,BHAVNAGAR,DELHI,528,469,BHAVNAGAR-DELHI,997,All
2021,11,BHAVNAGAR,DELHI,790,1009,BHAVNAGAR-DELHI,1799,All
2020,9,BHAVNAGAR,DIU,0,2,BHAVNAGAR-DIU,2,All
2015,4,BHAVNAGAR,MUMBAI,1768,1738,BHAVNAGAR-MUMBAI,3506,All
2015,5,BHAVNAGAR,MUMBAI,1603,1620,BHAVNAGAR-MUMBAI,3223,All
2015,6,BHAVNAGAR,MUMBAI,1454,1384,BHAVNAGAR-MUMBAI,2838,All
2015,7,BHAVNAGAR,MUMBAI,1532,1653,BHAVNAGAR-MUMBAI,3185,All
2015,8,BHAVNAGAR,MUMBAI,1631,1686,BHAVNAGAR-MUMBAI,3317,All
2015,9,BHAVNAGAR,MUMBAI,1621,1650,BHAVNAGAR-MUMBAI,3271,All
2015,10,BHAVNAGAR,MUMBAI,1343,1458,BHAVNAGAR-MUMBAI,2801,All
2015,11,BHAVNAGAR,MUMBAI,1391,1654,BHAVNAGAR-MUMBAI,3045,All
2015,12,BHAVNAGAR,MUMBAI,1647,1793,BHAVNAGAR-MUMBAI,3440,All
2016,1,BHAVNAGAR,MUMBAI,1841,1734,BHAVNAGAR-MUMBAI,3575,All
2016,2,BHAVNAGAR,MUMBAI,1474,1532,BHAVNAGAR-MUMBAI,3006,All
2016,3,BHAVNAGAR,MUMBAI,1210,1251,BHAVNAGAR-MUMBAI,2461,All
2016,4,BHAVNAGAR,MUMBAI,257,263,BHAVNAGAR-MUMBAI,520,All
2016,5,BHAVNAGAR,MUMBAI,851,801,BHAVNAGAR-MUMBAI,1652,All
2016,8,BHAVNAGAR,MUMBAI,767,766,BHAVNAGAR-MUMBAI,1533,All
2016,9,BHAVNAGAR,MUMBAI,715,705,BHAVNAGAR-MUMBAI,1420,All
2016,10,BHAVNAGAR,MUMBAI,702,753,BHAVNAGAR-MUMBAI,1455,All
2016,11,BHAVNAGAR,MUMBAI,959,938,BHAVNAGAR-MUMBAI,1897,All
2016,12,BHAVNAGAR,MUMBAI,872,845,BHAVNAGAR-MUMBAI,1717,All
2017,1,BHAVNAGAR,MUMBAI,893,911,BHAVNAGAR-MUMBAI,1804,All
2017,2,BHAVNAGAR,MUMBAI,811,771,BHAVNAGAR-MUMBAI,1582,All
2017,3,BHAVNAGAR,MUMBAI,762,723,BHAVNAGAR-MUMBAI,1485,All
2017,4,BHAVNAGAR,MUMBAI,872,856,BHAVNAGAR-MUMBAI,1728,All
2017,5,BHAVNAGAR,MUMBAI,960,927,BHAVNAGAR-MUMBAI,1887,All
2017,6,BHAVNAGAR,MUMBAI,922,934,BHAVNAGAR-MUMBAI,1856,All
2017,7,BHAVNAGAR,MUMBAI,1021,1018,BHAVNAGAR-MUMBAI,2039,All
2017,8,BHAVNAGAR,MUMBAI,1062,1050,BHAVNAGAR-MUMBAI,2112,All
2017,9,BHAVNAGAR,MUMBAI,989,1021,BHAVNAGAR-MUMBAI,2010,All
2017,10,BHAVNAGAR,MUMBAI,1019,1097,BHAVNAGAR-MUMBAI,2116,All
2017,11,BHAVNAGAR,MUMBAI,976,996,BHAVNAGAR-MUMBAI,1972,All
2017,12,BHAVNAGAR,MUMBAI,888,903,BHAVNAGAR-MUMBAI,1791,All
2018,1,BHAVNAGAR,MUMBAI,1195,1224,BHAVNAGAR-MUMBAI,2419,All
2018,2,BHAVNAGAR,MUMBAI,1730,1669,BHAVNAGAR-MUMBAI,3399,All
2018,3,BHAVNAGAR,MUMBAI,1607,1582,BHAVNAGAR-MUMBAI,3189,All
2018,4,BHAVNAGAR,MUMBAI,1462,1542,BHAVNAGAR-MUMBAI,3004,All
2018,5,BHAVNAGAR,MUMBAI,1615,1506,BHAVNAGAR-MUMBAI,3121,All
2018,6,BHAVNAGAR,MUMBAI,1628,1661,BHAVNAGAR-MUMBAI,3289,All
2018,7,BHAVNAGAR,MUMBAI,1550,1594,BHAVNAGAR-MUMBAI,3144,All
2018,8,BHAVNAGAR,MUMBAI,1434,1377,BHAVNAGAR-MUMBAI,2811,All
2018,9,BHAVNAGAR,MUMBAI,1452,1422,BHAVNAGAR-MUMBAI,2874,All
2018,10,BHAVNAGAR,MUMBAI,1249,1341,BHAVNAGAR-MUMBAI,2590,All
2018,11,BHAVNAGAR,MUMBAI,1597,1605,BHAVNAGAR-MUMBAI,3202,All
2018,12,BHAVNAGAR,MUMBAI,1598,1638,BHAVNAGAR-MUMBAI,3236,All
2019,1,BHAVNAGAR,MUMBAI,1504,1584,BHAVNAGAR-MUMBAI,3088,All
2019,2,BHAVNAGAR,MUMBAI,1524,1434,BHAVNAGAR-MUMBAI,2958,All
2019,3,BHAVNAGAR,MUMBAI,1525,1401,BHAVNAGAR-MUMBAI,2926,All
2019,4,BHAVNAGAR,MUMBAI,1487,1542,BHAVNAGAR-MUMBAI,3029,All
2019,5,BHAVNAGAR,MUMBAI,1528,1552,BHAVNAGAR-MUMBAI,3080,All
2019,6,BHAVNAGAR,MUMBAI,1309,1300,BHAVNAGAR-MUMBAI,2609,All
2019,7,BHAVNAGAR,MUMBAI,1343,1363,BHAVNAGAR-MUMBAI,2706,All
2019,8,BHAVNAGAR,MUMBAI,1587,1513,BHAVNAGAR-MUMBAI,3100,All
2019,9,BHAVNAGAR,MUMBAI,1457,1332,BHAVNAGAR-MUMBAI,2789,All
2019,10,BHAVNAGAR,MUMBAI,1446,1456,BHAVNAGAR-MUMBAI,2902,All
2019,11,BHAVNAGAR,MUMBAI,1513,1575,BHAVNAGAR-MUMBAI,3088,All
2019,12,BHAVNAGAR,MUMBAI,1652,1551,BHAVNAGAR-MUMBAI,3203,All
2020,1,BHAVNAGAR,MUMBAI,1679,1607,BHAVNAGAR-MUMBAI,3286,All
2020,2,BHAVNAGAR,MUMBAI,1699,1596,BHAVNAGAR-MUMBAI,3295,All
2020,3,BHAVNAGAR,MUMBAI,976,1077,BHAVNAGAR-MUMBAI,2053,All
2020,7,BHAVNAGAR,MUMBAI,1,40,BHAVNAGAR-MUMBAI,41,All
2020,8,BHAVNAGAR,MUMBAI,183,225,BHAVNAGAR-MUMBAI,408,All
2020,9,BHAVNAGAR,MUMBAI,234,228,BHAVNAGAR-MUMBAI,462,All
2020,10,BHAVNAGAR,MUMBAI,392,392,BHAVNAGAR-MUMBAI,784,All
2020,11,BHAVNAGAR,MUMBAI,573,619,BHAVNAGAR-MUMBAI,1192,All
2020,12,BHAVNAGAR,MUMBAI,658,741,BHAVNAGAR-MUMBAI,1399,All
2021,1,BHAVNAGAR,MUMBAI,748,775,BHAVNAGAR-MUMBAI,1523,All
2021,2,BHAVNAGAR,MUMBAI,946,1026,BHAVNAGAR-MUMBAI,1972,All
2021,3,BHAVNAGAR,MUMBAI,900,996,BHAVNAGAR-MUMBAI,1896,All
2021,4,BHAVNAGAR,MUMBAI,160,167,BHAVNAGAR-MUMBAI,327,All
2021,6,BHAVNAGAR,MUMBAI,367,444,BHAVNAGAR-MUMBAI,811,All
2021,7,BHAVNAGAR,MUMBAI,599,725,BHAVNAGAR-MUMBAI,1324,All
2021,8,BHAVNAGAR,MUMBAI,1158,1254,BHAVNAGAR-MUMBAI,2412,All
2021,9,BHAVNAGAR,MUMBAI,1657,1665,BHAVNAGAR-MUMBAI,3322,All
2021,10,BHAVNAGAR,MUMBAI,1290,1577,BHAVNAGAR-MUMBAI,2867,All
2021,11,BHAVNAGAR,MUMBAI,2108,2301,BHAVNAGAR-MUMBAI,4409,All
2021,12,BHAVNAGAR,MUMBAI,1613,1799,BHAVNAGAR-MUMBAI,3412,All
2022,1,BHAVNAGAR,MUMBAI,987,1292,BHAVNAGAR-MUMBAI,2279,All
2022,2,BHAVNAGAR,MUMBAI,1446,1532,BHAVNAGAR-MUMBAI,2978,All
2022,3,BHAVNAGAR,MUMBAI,1080,1117,BHAVNAGAR-MUMBAI,2197,All
2022,4,BHAVNAGAR,MUMBAI,490,632,BHAVNAGAR-MUMBAI,1122,All
2022,5,BHAVNAGAR,MUMBAI,2097,2036,BHAVNAGAR-MUMBAI,4133,All
2022,6,BHAVNAGAR,MUMBAI,1977,2136,BHAVNAGAR-MUMBAI,4113,All
2022,7,BHAVNAGAR,MUMBAI,1420,1665,BHAVNAGAR-MUMBAI,3085,All
2022,8,BHAVNAGAR,MUMBAI,2131,2230,BHAVNAGAR-MUMBAI,4361,All
2022,9,BHAVNAGAR,MUMBAI,1763,1951,BHAVNAGAR-MUMBAI,3714,All
2022,10,BHAVNAGAR,MUMBAI,1207,1231,BHAVNAGAR-MUMBAI,2438,All
2022,11,BHAVNAGAR,MUMBAI,1264,1316,BHAVNAGAR-MUMBAI,2580,All
2022,12,BHAVNAGAR,MUMBAI,1859,1952,BHAVNAGAR-MUMBAI,3811,All
2023,1,BHAVNAGAR,MUMBAI,2168,2195,BHAVNAGAR-MUMBAI,4363,All
2023,2,BHAVNAGAR,MUMBAI,2010,2032,BHAVNAGAR-MUMBAI,4042,All
2023,3,BHAVNAGAR,MUMBAI,1620,1768,BHAVNAGAR-MUMBAI,3388,All
2023,4,BHAVNAGAR,MUMBAI,1581,1659,BHAVNAGAR-MUMBAI,3240,All
2023,5,BHAVNAGAR,MUMBAI,1848,1732,BHAVNAGAR-MUMBAI,3580,All
2023,6,BHAVNAGAR,MUMBAI,1281,1327,BHAVNAGAR-MUMBAI,2608,All
2023,7,BHAVNAGAR,MUMBAI,1420,1439,BHAVNAGAR-MUMBAI,2859,All
2023,8,BHAVNAGAR,MUMBAI,1781,1652,BHAVNAGAR-MUMBAI,3433,All
2023,9,BHAVNAGAR,MUMBAI,2042,1926,BHAVNAGAR-MUMBAI,3968,All
2023,10,BHAVNAGAR,MUMBAI,915,978,BHAVNAGAR-MUMBAI,1893,All
2023,11,BHAVNAGAR,MUMBAI,1646,1668,BHAVNAGAR-MUMBAI,3314,All
2023,12,BHAVNAGAR,MUMBAI,2082,2082,BHAVNAGAR-MUMBAI,4164,All
2024,1,BHAVNAGAR,MUMBAI,2166,2088,BHAVNAGAR-MUMBAI,4254,All
2024,2,BHAVNAGAR,MUMBAI,1961,1962,BHAVNAGAR-MUMBAI,3923,All
2024,3,BHAVNAGAR,MUMBAI,1880,1819,BHAVNAGAR-MUMBAI,3699,All
2024,4,BHAVNAGAR,MUMBAI,1697,1704,BHAVNAGAR-MUMBAI,3401,All
2024,6,BHAVNAGAR,MUMBAI,783,857,BHAVNAGAR-MUMBAI,1640,All
2024,7,BHAVNAGAR,MUMBAI,1692,1924,BHAVNAGAR-MUMBAI,3616,All
2024,8,BHAVNAGAR,MUMBAI,1671,1613,BHAVNAGAR-MUMBAI,3284,All
2024,9,BHAVNAGAR,MUMBAI,1128,1016,BHAVNAGAR-MUMBAI,2144,All
2024,10,BHAVNAGAR,MUMBAI,1410,1615,BHAVNAGAR-MUMBAI,3025,All
2024,11,BHAVNAGAR,MUMBAI,1901,1820,BHAVNAGAR-MUMBAI,3721,All
2024,12,BHAVNAGAR,MUMBAI,1954,1987,BHAVNAGAR-MUMBAI,3941,All
2025,1,BHAVNAGAR,MUMBAI,1957,1875,BHAVNAGAR-MUMBAI,3832,All
2025,2,BHAVNAGAR,MUMBAI,1476,1524,BHAVNAGAR-MUMBAI,3000,All
2025,3,BHAVNAGAR,MUMBAI,1702,1648,BHAVNAGAR-MUMBAI,3350,All
2021,9,BHAVNAGAR,PUNE,0,3,BHAVNAGAR-PUNE,3,All
2021,10,BHAVNAGAR,PUNE,0,7,BHAVNAGAR-PUNE,7,All
2022,5,BHAVNAGAR,PUNE,945,791,BHAVNAGAR-PUNE,1736,All
2022,6,BHAVNAGAR,PUNE,1116,1067,BHAVNAGAR-PUNE,2183,All
2022,7,BHAVNAGAR,PUNE,804,773,BHAVNAGAR-PUNE,1577,All
2022,8,BHAVNAGAR,PUNE,1203,1301,BHAVNAGAR-PUNE,2504,All
2022,9,BHAVNAGAR,PUNE,1020,896,BHAVNAGAR-PUNE,1916,All
2022,10,BHAVNAGAR,PUNE,1338,1447,BHAVNAGAR-PUNE,2785,All
2022,11,BHAVNAGAR,PUNE,1260,1259,BHAVNAGAR-PUNE,2519,All
2022,12,BHAVNAGAR,PUNE,1748,1763,BHAVNAGAR-PUNE,3511,All
2023,1,BHAVNAGAR,PUNE,1994,1997,BHAVNAGAR-PUNE,3991,All
2023,2,BHAVNAGAR,PUNE,1491,1586,BHAVNAGAR-PUNE,3077,All
2023,3,BHAVNAGAR,PUNE,1549,1340,BHAVNAGAR-PUNE,2889,All
2023,4,BHAVNAGAR,PUNE,1607,1714,BHAVNAGAR-PUNE,3321,All
2023,5,BHAVNAGAR,PUNE,2126,1998,BHAVNAGAR-PUNE,4124,All
2023,6,BHAVNAGAR,PUNE,1384,1466,BHAVNAGAR-PUNE,2850,All
2023,7,BHAVNAGAR,PUNE,1133,1075,BHAVNAGAR-PUNE,2208,All
2023,8,BHAVNAGAR,PUNE,1256,1469,BHAVNAGAR-PUNE,2725,All
2023,9,BHAVNAGAR,PUNE,1559,1481,BHAVNAGAR-PUNE,3040,All
2023,10,BHAVNAGAR,PUNE,829,849,BHAVNAGAR-PUNE,1678,All
2023,11,BHAVNAGAR,PUNE,1619,1647,BHAVNAGAR-PUNE,3266,All
2023,12,BHAVNAGAR,PUNE,2025,2035,BHAVNAGAR-PUNE,4060,All
2024,1,BHAVNAGAR,PUNE,2165,2088,BHAVNAGAR-PUNE,4253,All
2024,2,BHAVNAGAR,PUNE,1818,1657,BHAVNAGAR-PUNE,3475,All
2024,3,BHAVNAGAR,PUNE,1535,1538,BHAVNAGAR-PUNE,3073,All
2024,4,BHAVNAGAR,PUNE,1411,1331,BHAVNAGAR-PUNE,2742,All
2024,6,BHAVNAGAR,PUNE,608,618,BHAVNAGAR-PUNE,1226,All
2024,7,BHAVNAGAR,PUNE,1458,1422,BHAVNAGAR-PUNE,2880,All
2024,8,BHAVNAGAR,PUNE,1350,1406,BHAVNAGAR-PUNE,2756,All
2024,9,BHAVNAGAR,PUNE,800,908,BHAVNAGAR-PUNE,1708,All
2024,10,BHAVNAGAR,PUNE,1036,1320,BHAVNAGAR-PUNE,2356,All
2024,11,BHAVNAGAR,PUNE,1670,1660,BHAVNAGAR-PUNE,3330,All
2024,12,BHAVNAGAR,PUNE,1803,1840,BHAVNAGAR-PUNE,3643,All
2025,1,BHAVNAGAR,PUNE,1725,1638,BHAVNAGAR-PUNE,3363,All
2025,2,BHAVNAGAR,PUNE,1394,1336,BHAVNAGAR-PUNE,2730,All
2025,3,BHAVNAGAR,PUNE,1537,1377,BHAVNAGAR-PUNE,2914,All
2018,4,BHAVNAGAR,SURAT,94,147,BHAVNAGAR-SURAT,241,All
2018,5,BHAVNAGAR,SURAT,127,126,BHAVNAGAR-SURAT,253,All
2018,8,BHAVNAGAR,SURAT,58,58,BHAVNAGAR-SURAT,116,All
2018,9,BHAVNAGAR,SURAT,53,47,BHAVNAGAR-SURAT,100,All
2018,10,BHAVNAGAR,SURAT,5,19,BHAVNAGAR-SURAT,24,All
2021,8,BHAVNAGAR,SURAT,224,219,BHAVNAGAR-SURAT,443,All
2021,9,BHAVNAGAR,SURAT,579,499,BHAVNAGAR-SURAT,1078,All
2021,10,BHAVNAGAR,SURAT,440,422,BHAVNAGAR-SURAT,862,All
2021,12,BHAVNAGAR,SURAT,302,359,BHAVNAGAR-SURAT,661,All
2022,1,BHAVNAGAR,SURAT,87,95,BHAVNAGAR-SURAT,182,All
2019,1,BHOPAL,BENGALURU,120,118,BENGALURU-BHOPAL,238,All
2019,2,BHOPAL,BENGALURU,64,97,BENGALURU-BHOPAL,161,All
2019,3,BHOPAL,BENGALURU,3990,4324,BENGALURU-BHOPAL,8314,All
2019,4,BHOPAL,BENGALURU,4258,4784,BENGALURU-BHOPAL,9042,All
2022,10,BHOPAL,BILASPUR,13,21,BHOPAL-BILASPUR,34,All
2015,4,BHOPAL,CHANDIGARH,0,225,BHOPAL-CHANDIGARH,225,All
2015,5,BHOPAL,CHANDIGARH,0,284,BHOPAL-CHANDIGARH,284,All
2015,6,BHOPAL,CHANDIGARH,0,272,BHOPAL-CHANDIGARH,272,All
2015,7,BHOPAL,CHANDIGARH,0,159,BHOPAL-CHANDIGARH,159,All
2015,8,BHOPAL,CHANDIGARH,0,143,BHOPAL-CHANDIGARH,143,All
2015,9,BHOPAL,CHANDIGARH,0,186,BHOPAL-CHANDIGARH,186,All
2015,10,BHOPAL,CHANDIGARH,46,162,BHOPAL-CHANDIGARH,208,All
2015,11,BHOPAL,CHANDIGARH,118,187,BHOPAL-CHANDIGARH,305,All
2015,12,BHOPAL,CHANDIGARH,0,56,BHOPAL-CHANDIGARH,56,All
2016,2,BHOPAL,CHANDIGARH,84,123,BHOPAL-CHANDIGARH,207,All
2016,3,BHOPAL,CHANDIGARH,113,214,BHOPAL-CHANDIGARH,327,All
2019,1,BHOPAL,CHANDIGARH,0,8,BHOPAL-CHANDIGARH,8,All
2019,2,BHOPAL,CHANDIGARH,0,28,BHOPAL-CHANDIGARH,28,All
2019,3,BHOPAL,CHANDIGARH,0,38,BHOPAL-CHANDIGARH,38,All
2019,4,BHOPAL,CHANDIGARH,0,56,BHOPAL-CHANDIGARH,56,All
2019,5,BHOPAL,CHANDIGARH,0,45,BHOPAL-CHANDIGARH,45,All
2019,6,BHOPAL,CHANDIGARH,0,37,BHOPAL-CHANDIGARH,37,All
2019,7,BHOPAL,CHANDIGARH,0,22,BHOPAL-CHANDIGARH,22,All
2019,8,BHOPAL,CHANDIGARH,0,17,BHOPAL-CHANDIGARH,17,All
2019,9,BHOPAL,CHANDIGARH,0,31,BHOPAL-CHANDIGARH,31,All
2019,10,BHOPAL,CHANDIGARH,0,34,BHOPAL-CHANDIGARH,34,All
2019,11,BHOPAL,CHANDIGARH,0,27,BHOPAL-CHANDIGARH,27,All
2019,12,BHOPAL,CHANDIGARH,0,48,BHOPAL-CHANDIGARH,48,All
2020,1,BHOPAL,CHANDIGARH,0,31,BHOPAL-CHANDIGARH,31,All
2020,2,BHOPAL,CHANDIGARH,0,30,BHOPAL-CHANDIGARH,30,All
2020,3,BHOPAL,CHANDIGARH,0,22,BHOPAL-CHANDIGARH,22,All
2020,9,BHOPAL,CHANDIGARH,0,2,BHOPAL-CHANDIGARH,2,All
2020,12,BHOPAL,CHENNAI,74,83,BHOPAL-CHENNAI,157,All
2021,1,BHOPAL,CHENNAI,207,229,BHOPAL-CHENNAI,436,All
2021,2,BHOPAL,CHENNAI,251,328,BHOPAL-CHENNAI,579,All
2021,3,BHOPAL,CHENNAI,201,243,BHOPAL-CHENNAI,444,All
2021,7,BHOPAL,CHENNAI,100,156,BHOPAL-CHENNAI,256,All
2021,8,BHOPAL,CHENNAI,207,254,BHOPAL-CHENNAI,461,All
2021,9,BHOPAL,CHENNAI,242,312,BHOPAL-CHENNAI,554,All
2021,10,BHOPAL,CHENNAI,238,275,BHOPAL-CHENNAI,513,All
2022,3,BHOPAL,CHENNAI,95,162,BHOPAL-CHENNAI,257,All
2022,4,BHOPAL,CHENNAI,1090,1628,BHOPAL-CHENNAI,2718,All
2022,5,BHOPAL,CHENNAI,1204,1246,BHOPAL-CHENNAI,2450,All
2022,6,BHOPAL,CHENNAI,1407,1518,BHOPAL-CHENNAI,2925,All
2022,7,BHOPAL,CHENNAI,688,856,BHOPAL-CHENNAI,1544,All
2022,10,BHOPAL,CHENNAI,122,114,BHOPAL-CHENNAI,236,All
2024,12,BHOPAL,DABOLIM,4363,4104,BHOPAL-DABOLIM,8467,All
2025,1,BHOPAL,DABOLIM,4524,4628,BHOPAL-DABOLIM,9152,All
2025,2,BHOPAL,DABOLIM,3882,4026,BHOPAL-DABOLIM,7908,All
2025,3,BHOPAL,DABOLIM,4089,4015,BHOPAL-DABOLIM,8104,All
2018,7,BHOPAL,DEHRA DUN,0,11,BHOPAL-DEHRA DUN,11,All
2018,8,BHOPAL,DEHRA DUN,0,78,BHOPAL-DEHRA DUN,78,All
2018,9,BHOPAL,DEHRA DUN,0,50,BHOPAL-DEHRA DUN,50,All
2018,10,BHOPAL,DEHRA DUN,0,693,BHOPAL-DEHRA DUN,693,All
2015,4,BHOPAL,DELHI,11442,9941,BHOPAL-DELHI,21383,All
2015,5,BHOPAL,DELHI,12813,11964,BHOPAL-DELHI,24777,All
2015,6,BHOPAL,DELHI,12059,12209,BHOPAL-DELHI,24268,All
2015,7,BHOPAL,DELHI,12743,12800,BHOPAL-DELHI,25543,All
2015,8,BHOPAL,DELHI,14472,13259,BHOPAL-DELHI,27731,All
2015,9,BHOPAL,DELHI,14950,13635,BHOPAL-DELHI,28585,All
2015,10,BHOPAL,DELHI,4777,5679,BHOPAL-DELHI,10456,All
2015,11,BHOPAL,DELHI,15932,15533,BHOPAL-DELHI,31465,All
2015,12,BHOPAL,DELHI,17911,18084,BHOPAL-DELHI,35995,All
2016,1,BHOPAL,DELHI,16887,15427,BHOPAL-DELHI,32314,All
2016,2,BHOPAL,DELHI,15018,13797,BHOPAL-DELHI,28815,All
2016,3,BHOPAL,DELHI,13512,13638,BHOPAL-DELHI,27150,All
2016,4,BHOPAL,DELHI,16783,14832,BHOPAL-DELHI,31615,All
2016,5,BHOPAL,DELHI,19559,18439,BHOPAL-DELHI,37998,All
2016,6,BHOPAL,DELHI,13309,15819,BHOPAL-DELHI,29128,All
2016,7,BHOPAL,DELHI,13436,13657,BHOPAL-DELHI,27093,All
2016,8,BHOPAL,DELHI,13189,12502,BHOPAL-DELHI,25691,All
2016,9,BHOPAL,DELHI,12986,12822,BHOPAL-DELHI,25808,All
2016,10,BHOPAL,DELHI,11971,12239,BHOPAL-DELHI,24210,All
2016,11,BHOPAL,DELHI,10740,10738,BHOPAL-DELHI,21478,All
2016,12,BHOPAL,DELHI,10649,10770,BHOPAL-DELHI,21419,All
2017,1,BHOPAL,DELHI,10820,10566,BHOPAL-DELHI,21386,All
2017,2,BHOPAL,DELHI,9992,9950,BHOPAL-DELHI,19942,All
2017,3,BHOPAL,DELHI,11829,11469,BHOPAL-DELHI,23298,All
2017,4,BHOPAL,DELHI,11956,10982,BHOPAL-DELHI,22938,All
2017,5,BHOPAL,DELHI,14375,14926,BHOPAL-DELHI,29301,All
2017,6,BHOPAL,DELHI,13259,15419,BHOPAL-DELHI,28678,All
2017,7,BHOPAL,DELHI,13203,13198,BHOPAL-DELHI,26401,All
2017,8,BHOPAL,DELHI,14970,14455,BHOPAL-DELHI,29425,All
2017,9,BHOPAL,DELHI,13624,13145,BHOPAL-DELHI,26769,All
2017,10,BHOPAL,DELHI,15638,15354,BHOPAL-DELHI,30992,All
2017,11,BHOPAL,DELHI,14278,14653,BHOPAL-DELHI,28931,All
2017,12,BHOPAL,DELHI,14537,14722,BHOPAL-DELHI,29259,All
2018,1,BHOPAL,DELHI,16441,15886,BHOPAL-DELHI,32327,All
2018,2,BHOPAL,DELHI,14904,14669,BHOPAL-DELHI,29573,All
2018,3,BHOPAL,DELHI,16592,16828,BHOPAL-DELHI,33420,All
2018,4,BHOPAL,DELHI,18133,16319,BHOPAL-DELHI,34452,All
2018,5,BHOPAL,DELHI,17726,17273,BHOPAL-DELHI,34999,All
2018,6,BHOPAL,DELHI,13720,15543,BHOPAL-DELHI,29263,All
2018,7,BHOPAL,DELHI,13301,12824,BHOPAL-DELHI,26125,All
2018,8,BHOPAL,DELHI,15200,13761,BHOPAL-DELHI,28961,All
2018,9,BHOPAL,DELHI,14755,13961,BHOPAL-DELHI,28716,All
2018,10,BHOPAL,DELHI,14641,13926,BHOPAL-DELHI,28567,All
2018,11,BHOPAL,DELHI,14409,15832,BHOPAL-DELHI,30241,All
2018,12,BHOPAL,DELHI,16645,17607,BHOPAL-DELHI,34252,All
2019,1,BHOPAL,DELHI,15916,14878,BHOPAL-DELHI,30794,All
2019,2,BHOPAL,DELHI,12063,11825,BHOPAL-DELHI,23888,All
2019,3,BHOPAL,DELHI,12635,12879,BHOPAL-DELHI,25514,All
2019,4,BHOPAL,DELHI,13310,13412,BHOPAL-DELHI,26722,All
2019,5,BHOPAL,DELHI,17432,18347,BHOPAL-DELHI,35779,All
2019,6,BHOPAL,DELHI,21481,24291,BHOPAL-DELHI,45772,All
2019,7,BHOPAL,DELHI,23992,22957,BHOPAL-DELHI,46949,All
2019,8,BHOPAL,DELHI,23618,21836,BHOPAL-DELHI,45454,All
2019,9,BHOPAL,DELHI,23734,21778,BHOPAL-DELHI,45512,All
2019,10,BHOPAL,DELHI,25842,24974,BHOPAL-DELHI,50816,All
2019,11,BHOPAL,DELHI,25138,24355,BHOPAL-DELHI,49493,All
2019,12,BHOPAL,DELHI,25190,26454,BHOPAL-DELHI,51644,All
2020,1,BHOPAL,DELHI,23970,21767,BHOPAL-DELHI,45737,All
2020,2,BHOPAL,DELHI,25742,23997,BHOPAL-DELHI,49739,All
2020,3,BHOPAL,DELHI,14650,14541,BHOPAL-DELHI,29191,All
2020,5,BHOPAL,DELHI,740,1000,BHOPAL-DELHI,1740,All
2020,6,BHOPAL,DELHI,4624,5391,BHOPAL-DELHI,10015,All
2020,7,BHOPAL,DELHI,4056,4270,BHOPAL-DELHI,8326,All
2020,8,BHOPAL,DELHI,5825,5557,BHOPAL-DELHI,11382,All
2020,9,BHOPAL,DELHI,7376,7149,BHOPAL-DELHI,14525,All
2020,10,BHOPAL,DELHI,10335,9526,BHOPAL-DELHI,19861,All
2020,11,BHOPAL,DELHI,12823,12780,BHOPAL-DELHI,25603,All
2020,12,BHOPAL,DELHI,14410,15040,BHOPAL-DELHI,29450,All
2021,1,BHOPAL,DELHI,15314,15002,BHOPAL-DELHI,30316,All
2021,2,BHOPAL,DELHI,16557,16036,BHOPAL-DELHI,32593,All
2021,3,BHOPAL,DELHI,15801,15519,BHOPAL-DELHI,31320,All
2021,4,BHOPAL,DELHI,9239,8586,BHOPAL-DELHI,17825,All
2021,6,BHOPAL,DELHI,6690,5873,BHOPAL-DELHI,12563,All
2021,7,BHOPAL,DELHI,11711,10090,BHOPAL-DELHI,21801,All
2021,8,BHOPAL,DELHI,14579,12980,BHOPAL-DELHI,27559,All
2021,9,BHOPAL,DELHI,13093,11483,BHOPAL-DELHI,24576,All
2021,10,BHOPAL,DELHI,15982,15455,BHOPAL-DELHI,31437,All
2021,11,BHOPAL,DELHI,20830,19617,BHOPAL-DELHI,40447,All
2021,12,BHOPAL,DELHI,20364,21013,BHOPAL-DELHI,41377,All
2022,1,BHOPAL,DELHI,10424,9739,BHOPAL-DELHI,20163,All
2022,2,BHOPAL,DELHI,13355,12776,BHOPAL-DELHI,26131,All
2022,3,BHOPAL,DELHI,20187,19243,BHOPAL-DELHI,39430,All
2022,4,BHOPAL,DELHI,18260,16243,BHOPAL-DELHI,34503,All
2022,5,BHOPAL,DELHI,18954,16404,BHOPAL-DELHI,35358,All
2022,6,BHOPAL,DELHI,18180,19694,BHOPAL-DELHI,37874,All
2022,7,BHOPAL,DELHI,17382,16670,BHOPAL-DELHI,34052,All
2022,8,BHOPAL,DELHI,18526,17395,BHOPAL-DELHI,35921,All
2022,9,BHOPAL,DELHI,18470,17390,BHOPAL-DELHI,35860,All
2022,10,BHOPAL,DELHI,20195,21080,BHOPAL-DELHI,41275,All
2022,11,BHOPAL,DELHI,21673,21972,BHOPAL-DELHI,43645,All
2022,12,BHOPAL,DELHI,23874,24272,BHOPAL-DELHI,48146,All
2023,1,BHOPAL,DELHI,24594,22355,BHOPAL-DELHI,46949,All
2023,2,BHOPAL,DELHI,23914,22313,BHOPAL-DELHI,46227,All
2023,3,BHOPAL,DELHI,24442,23372,BHOPAL-DELHI,47814,All
2023,4,BHOPAL,DELHI,26010,22355,BHOPAL-DELHI,48365,All
2023,5,BHOPAL,DELHI,25106,24998,BHOPAL-DELHI,50104,All
2023,6,BHOPAL,DELHI,23094,26137,BHOPAL-DELHI,49231,All
2023,7,BHOPAL,DELHI,23345,22850,BHOPAL-DELHI,46195,All
2023,8,BHOPAL,DELHI,24616,24735,BHOPAL-DELHI,49351,All
2023,9,BHOPAL,DELHI,23560,23183,BHOPAL-DELHI,46743,All
2023,10,BHOPAL,DELHI,22167,23113,BHOPAL-DELHI,45280,All
2023,11,BHOPAL,DELHI,24591,24717,BHOPAL-DELHI,49308,All
2023,12,BHOPAL,DELHI,26834,28419,BHOPAL-DELHI,55253,All
2024,1,BHOPAL,DELHI,27621,26147,BHOPAL-DELHI,53768,All
2024,2,BHOPAL,DELHI,24607,24265,BHOPAL-DELHI,48872,All
2024,3,BHOPAL,DELHI,23966,25114,BHOPAL-DELHI,49080,All
2024,4,BHOPAL,DELHI,24082,24139,BHOPAL-DELHI,48221,All
2024,6,BHOPAL,DELHI,24312,27019,BHOPAL-DELHI,51331,All
2024,7,BHOPAL,DELHI,24862,25921,BHOPAL-DELHI,50783,All
2024,8,BHOPAL,DELHI,26097,26458,BHOPAL-DELHI,52555,All
2024,9,BHOPAL,DELHI,24787,24511,BHOPAL-DELHI,49298,All
2024,10,BHOPAL,DELHI,21575,24434,BHOPAL-DELHI,46009,All
2024,11,BHOPAL,DELHI,27691,26600,BHOPAL-DELHI,54291,All
2024,12,BHOPAL,DELHI,25448,26998,BHOPAL-DELHI,52446,All
2025,1,BHOPAL,DELHI,24713,23026,BHOPAL-DELHI,47739,All
2025,2,BHOPAL,DELHI,27471,25376,BHOPAL-DELHI,52847,All
2025,3,BHOPAL,DELHI,26828,27311,BHOPAL-DELHI,54139,All
2022,2,BHOPAL,GWALIOR,0,5,BHOPAL-GWALIOR,5,All
2022,10,BHOPAL,GWALIOR,1,0,BHOPAL-GWALIOR,1,All
2024,1,BHOPAL,GWALIOR,166,0,BHOPAL-GWALIOR,166,All
2023,11,BHOPAL,Goa,2080,2021,BHOPAL-Goa,4101,All
2023,12,BHOPAL,Goa,2306,2185,BHOPAL-Goa,4491,All
2024,1,BHOPAL,Goa,1165,1195,BHOPAL-Goa,2360,All
2024,2,BHOPAL,Goa,2186,2112,BHOPAL-Goa,4298,All
2024,3,BHOPAL,Goa,2091,2035,BHOPAL-Goa,4126,All
2015,7,BHOPAL,HYDERABAD,331,377,BHOPAL-HYDERABAD,708,All
2015,8,BHOPAL,HYDERABAD,567,584,BHOPAL-HYDERABAD,1151,All
2015,9,BHOPAL,HYDERABAD,316,609,BHOPAL-HYDERABAD,925,All
2015,10,BHOPAL,HYDERABAD,306,788,BHOPAL-HYDERABAD,1094,All
2015,11,BHOPAL,HYDERABAD,828,857,BHOPAL-HYDERABAD,1685,All
2015,12,BHOPAL,HYDERABAD,798,620,BHOPAL-HYDERABAD,1418,All
2016,1,BHOPAL,HYDERABAD,584,561,BHOPAL-HYDERABAD,1145,All
2016,2,BHOPAL,HYDERABAD,383,452,BHOPAL-HYDERABAD,835,All
2016,3,BHOPAL,HYDERABAD,63,45,BHOPAL-HYDERABAD,108,All
2016,4,BHOPAL,HYDERABAD,319,252,BHOPAL-HYDERABAD,571,All
2016,5,BHOPAL,HYDERABAD,338,226,BHOPAL-HYDERABAD,564,All
2016,6,BHOPAL,HYDERABAD,274,154,BHOPAL-HYDERABAD,428,All
2016,7,BHOPAL,HYDERABAD,205,219,BHOPAL-HYDERABAD,424,All
2016,8,BHOPAL,HYDERABAD,236,237,BHOPAL-HYDERABAD,473,All
2016,9,BHOPAL,HYDERABAD,189,148,BHOPAL-HYDERABAD,337,All
2016,10,BHOPAL,HYDERABAD,174,256,BHOPAL-HYDERABAD,430,All
2017,4,BHOPAL,HYDERABAD,0,1124,BHOPAL-HYDERABAD,1124,All
2017,5,BHOPAL,HYDERABAD,147,1689,BHOPAL-HYDERABAD,1836,All
2017,6,BHOPAL,HYDERABAD,934,451,BHOPAL-HYDERABAD,1385,All
2017,7,BHOPAL,HYDERABAD,882,183,BHOPAL-HYDERABAD,1065,All
2017,8,BHOPAL,HYDERABAD,766,711,BHOPAL-HYDERABAD,1477,All
2017,9,BHOPAL,HYDERABAD,136,62,BHOPAL-HYDERABAD,198,All
2018,5,BHOPAL,HYDERABAD,672,548,BHOPAL-HYDERABAD,1220,All
2018,6,BHOPAL,HYDERABAD,566,505,BHOPAL-HYDERABAD,1071,All
2018,7,BHOPAL,HYDERABAD,713,731,BHOPAL-HYDERABAD,1444,All
2018,8,BHOPAL,HYDERABAD,632,657,BHOPAL-HYDERABAD,1289,All
2018,9,BHOPAL,HYDERABAD,442,454,BHOPAL-HYDERABAD,896,All
2018,10,BHOPAL,HYDERABAD,130,107,BHOPAL-HYDERABAD,237,All
2019,1,BHOPAL,HYDERABAD,4885,4216,BHOPAL-HYDERABAD,9101,All
2019,2,BHOPAL,HYDERABAD,5913,4622,BHOPAL-HYDERABAD,10535,All
2019,3,BHOPAL,HYDERABAD,6297,4807,BHOPAL-HYDERABAD,11104,All
2019,4,BHOPAL,HYDERABAD,5634,4882,BHOPAL-HYDERABAD,10516,All
2019,5,BHOPAL,HYDERABAD,6336,4580,BHOPAL-HYDERABAD,10916,All
2019,6,BHOPAL,HYDERABAD,6206,5392,BHOPAL-HYDERABAD,11598,All
2019,7,BHOPAL,HYDERABAD,5929,5152,BHOPAL-HYDERABAD,11081,All
2019,8,BHOPAL,HYDERABAD,5733,5163,BHOPAL-HYDERABAD,10896,All
2019,9,BHOPAL,HYDERABAD,3022,3153,BHOPAL-HYDERABAD,6175,All
2019,10,BHOPAL,HYDERABAD,5143,4836,BHOPAL-HYDERABAD,9979,All
2019,11,BHOPAL,HYDERABAD,4111,3998,BHOPAL-HYDERABAD,8109,All
2019,12,BHOPAL,HYDERABAD,4223,4124,BHOPAL-HYDERABAD,8347,All
2020,1,BHOPAL,HYDERABAD,3028,2986,BHOPAL-HYDERABAD,6014,All
2020,2,BHOPAL,HYDERABAD,2074,2128,BHOPAL-HYDERABAD,4202,All
2020,3,BHOPAL,HYDERABAD,1429,1613,BHOPAL-HYDERABAD,3042,All
2020,5,BHOPAL,HYDERABAD,16,60,BHOPAL-HYDERABAD,76,All
2020,6,BHOPAL,HYDERABAD,476,1305,BHOPAL-HYDERABAD,1781,All
2020,7,BHOPAL,HYDERABAD,1358,2081,BHOPAL-HYDERABAD,3439,All
2020,8,BHOPAL,HYDERABAD,1322,1381,BHOPAL-HYDERABAD,2703,All
2020,9,BHOPAL,HYDERABAD,1375,1431,BHOPAL-HYDERABAD,2806,All
2020,10,BHOPAL,HYDERABAD,1849,1861,BHOPAL-HYDERABAD,3710,All
2020,11,BHOPAL,HYDERABAD,1883,1944,BHOPAL-HYDERABAD,3827,All
2020,12,BHOPAL,HYDERABAD,2213,1867,BHOPAL-HYDERABAD,4080,All
2021,1,BHOPAL,HYDERABAD,1793,1609,BHOPAL-HYDERABAD,3402,All
2021,2,BHOPAL,HYDERABAD,1822,1754,BHOPAL-HYDERABAD,3576,All
2021,3,BHOPAL,HYDERABAD,1610,1639,BHOPAL-HYDERABAD,3249,All
2021,4,BHOPAL,HYDERABAD,1509,1073,BHOPAL-HYDERABAD,2582,All
2021,6,BHOPAL,HYDERABAD,1693,975,BHOPAL-HYDERABAD,2668,All
2021,7,BHOPAL,HYDERABAD,1901,1366,BHOPAL-HYDERABAD,3267,All
2021,8,BHOPAL,HYDERABAD,1947,1588,BHOPAL-HYDERABAD,3535,All
2021,9,BHOPAL,HYDERABAD,1696,1203,BHOPAL-HYDERABAD,2899,All
2021,10,BHOPAL,HYDERABAD,2048,1706,BHOPAL-HYDERABAD,3754,All
2021,11,BHOPAL,HYDERABAD,2059,1804,BHOPAL-HYDERABAD,3863,All
2021,12,BHOPAL,HYDERABAD,2256,1758,BHOPAL-HYDERABAD,4014,All
2022,1,BHOPAL,HYDERABAD,1675,1241,BHOPAL-HYDERABAD,2916,All
2022,2,BHOPAL,HYDERABAD,2126,1554,BHOPAL-HYDERABAD,3680,All
2022,3,BHOPAL,HYDERABAD,2260,1914,BHOPAL-HYDERABAD,4174,All
2022,4,BHOPAL,HYDERABAD,2783,2422,BHOPAL-HYDERABAD,5205,All
2022,5,BHOPAL,HYDERABAD,2791,2345,BHOPAL-HYDERABAD,5136,All
2022,6,BHOPAL,HYDERABAD,2855,2583,BHOPAL-HYDERABAD,5438,All
2022,7,BHOPAL,HYDERABAD,2499,2310,BHOPAL-HYDERABAD,4809,All
2022,8,BHOPAL,HYDERABAD,1921,1857,BHOPAL-HYDERABAD,3778,All
2022,9,BHOPAL,HYDERABAD,2089,2099,BHOPAL-HYDERABAD,4188,All
2022,10,BHOPAL,HYDERABAD,2017,2089,BHOPAL-HYDERABAD,4106,All
2022,11,BHOPAL,HYDERABAD,2168,2118,BHOPAL-HYDERABAD,4286,All
2022,12,BHOPAL,HYDERABAD,2325,2178,BHOPAL-HYDERABAD,4503,All
2023,1,BHOPAL,HYDERABAD,2255,2163,BHOPAL-HYDERABAD,4418,All
2023,2,BHOPAL,HYDERABAD,2106,2057,BHOPAL-HYDERABAD,4163,All
2023,3,BHOPAL,HYDERABAD,2266,2172,BHOPAL-HYDERABAD,4438,All
2023,4,BHOPAL,HYDERABAD,2177,2209,BHOPAL-HYDERABAD,4386,All
2023,5,BHOPAL,HYDERABAD,2196,2307,BHOPAL-HYDERABAD,4503,All
2023,6,BHOPAL,HYDERABAD,1956,2199,BHOPAL-HYDERABAD,4155,All
2023,7,BHOPAL,HYDERABAD,2156,1956,BHOPAL-HYDERABAD,4112,All
2023,8,BHOPAL,HYDERABAD,2193,2146,BHOPAL-HYDERABAD,4339,All
2023,9,BHOPAL,HYDERABAD,2179,1832,BHOPAL-HYDERABAD,4011,All
2023,10,BHOPAL,HYDERABAD,2105,2214,BHOPAL-HYDERABAD,4319,All
2023,11,BHOPAL,HYDERABAD,1956,2087,BHOPAL-HYDERABAD,4043,All
2023,12,BHOPAL,HYDERABAD,2293,2144,BHOPAL-HYDERABAD,4437,All
2024,1,BHOPAL,HYDERABAD,2211,2213,BHOPAL-HYDERABAD,4424,All
2024,2,BHOPAL,HYDERABAD,2032,2014,BHOPAL-HYDERABAD,4046,All
2024,3,BHOPAL,HYDERABAD,2071,2077,BHOPAL-HYDERABAD,4148,All
2024,4,BHOPAL,HYDERABAD,1984,2173,BHOPAL-HYDERABAD,4157,All
2024,6,BHOPAL,HYDERABAD,1765,1827,BHOPAL-HYDERABAD,3592,All
2024,7,BHOPAL,HYDERABAD,2162,1975,BHOPAL-HYDERABAD,4137,All
2024,8,BHOPAL,HYDERABAD,1986,1907,BHOPAL-HYDERABAD,3893,All
2024,9,BHOPAL,HYDERABAD,1941,1896,BHOPAL-HYDERABAD,3837,All
2024,10,BHOPAL,HYDERABAD,1965,2162,BHOPAL-HYDERABAD,4127,All
2024,11,BHOPAL,HYDERABAD,2236,2136,BHOPAL-HYDERABAD,4372,All
2024,12,BHOPAL,HYDERABAD,2294,2232,BHOPAL-HYDERABAD,4526,All
2025,1,BHOPAL,HYDERABAD,3652,3666,BHOPAL-HYDERABAD,7318,All
2025,2,BHOPAL,HYDERABAD,4040,4014,BHOPAL-HYDERABAD,8054,All
2025,3,BHOPAL,HYDERABAD,4145,4387,BHOPAL-HYDERABAD,8532,All
2015,4,BHOPAL,INDORE,33,0,BHOPAL-INDORE,33,All
2015,5,BHOPAL,INDORE,121,0,BHOPAL-INDORE,121,All
2015,6,BHOPAL,INDORE,109,0,BHOPAL-INDORE,109,All
2015,7,BHOPAL,INDORE,102,0,BHOPAL-INDORE,102,All
2015,8,BHOPAL,INDORE,97,0,BHOPAL-INDORE,97,All
2015,9,BHOPAL,INDORE,105,0,BHOPAL-INDORE,105,All
2015,10,BHOPAL,INDORE,84,0,BHOPAL-INDORE,84,All
2015,11,BHOPAL,INDORE,90,0,BHOPAL-INDORE,90,All
2015,12,BHOPAL,INDORE,85,0,BHOPAL-INDORE,85,All
2016,1,BHOPAL,INDORE,99,0,BHOPAL-INDORE,99,All
2016,2,BHOPAL,INDORE,111,0,BHOPAL-INDORE,111,All
2016,3,BHOPAL,INDORE,86,0,BHOPAL-INDORE,86,All
2018,8,BHOPAL,INDORE,1,0,BHOPAL-INDORE,1,All
2019,2,BHOPAL,INDORE,103,0,BHOPAL-INDORE,103,All
2019,3,BHOPAL,INDORE,16,0,BHOPAL-INDORE,16,All
2019,7,BHOPAL,INDORE,80,0,BHOPAL-INDORE,80,All
2019,10,BHOPAL,INDORE,0,8,BHOPAL-INDORE,8,All
2019,12,BHOPAL,INDORE,0,2,BHOPAL-INDORE,2,All
2020,2,BHOPAL,INDORE,0,61,BHOPAL-INDORE,61,All
2020,10,BHOPAL,INDORE,0,1,BHOPAL-INDORE,1,All
2020,12,BHOPAL,INDORE,0,52,BHOPAL-INDORE,52,All
2021,1,BHOPAL,INDORE,0,156,BHOPAL-INDORE,156,All
2021,7,BHOPAL,INDORE,0,84,BHOPAL-INDORE,84,All
2021,8,BHOPAL,INDORE,0,208,BHOPAL-INDORE,208,All
2021,9,BHOPAL,INDORE,118,0,BHOPAL-INDORE,118,All
2021,10,BHOPAL,INDORE,0,107,BHOPAL-INDORE,107,All
2022,7,BHOPAL,INDORE,0,40,BHOPAL-INDORE,40,All
2022,9,BHOPAL,INDORE,107,0,BHOPAL-INDORE,107,All
2023,1,BHOPAL,INDORE,0,117,BHOPAL-INDORE,117,All
2023,4,BHOPAL,INDORE,0,152,BHOPAL-INDORE,152,All
2023,5,BHOPAL,INDORE,0,26,BHOPAL-INDORE,26,All
2023,7,BHOPAL,INDORE,0,154,BHOPAL-INDORE,154,All
2024,2,BHOPAL,INDORE,0,115,BHOPAL-INDORE,115,All
2024,8,BHOPAL,INDORE,104,104,BHOPAL-INDORE,208,All
2016,5,BHOPAL,JABALPUR,463,0,BHOPAL-JABALPUR,463,All
2016,6,BHOPAL,JABALPUR,1134,0,BHOPAL-JABALPUR,1134,All
2016,7,BHOPAL,JABALPUR,1111,0,BHOPAL-JABALPUR,1111,All
2016,8,BHOPAL,JABALPUR,544,703,BHOPAL-JABALPUR,1247,All
2016,9,BHOPAL,JABALPUR,582,729,BHOPAL-JABALPUR,1311,All
2016,10,BHOPAL,JABALPUR,1193,0,BHOPAL-JABALPUR,1193,All
2016,11,BHOPAL,JABALPUR,734,398,BHOPAL-JABALPUR,1132,All
2016,12,BHOPAL,JABALPUR,768,801,BHOPAL-JABALPUR,1569,All
2017,1,BHOPAL,JABALPUR,774,811,BHOPAL-JABALPUR,1585,All
2017,2,BHOPAL,JABALPUR,706,257,BHOPAL-JABALPUR,963,All
2017,3,BHOPAL,JABALPUR,744,768,BHOPAL-JABALPUR,1512,All
2017,4,BHOPAL,JABALPUR,1112,0,BHOPAL-JABALPUR,1112,All
2017,5,BHOPAL,JABALPUR,476,22,BHOPAL-JABALPUR,498,All
2017,6,BHOPAL,JABALPUR,225,90,BHOPAL-JABALPUR,315,All
2017,7,BHOPAL,JABALPUR,70,14,BHOPAL-JABALPUR,84,All
2017,9,BHOPAL,JABALPUR,48,0,BHOPAL-JABALPUR,48,All
2025,3,BHOPAL,JABALPUR,498,811,BHOPAL-JABALPUR,1309,All
2018,5,BHOPAL,JAIPUR,138,0,BHOPAL-JAIPUR,138,All
2018,6,BHOPAL,JAIPUR,130,0,BHOPAL-JAIPUR,130,All
2018,7,BHOPAL,JAIPUR,93,0,BHOPAL-JAIPUR,93,All
2018,8,BHOPAL,JAIPUR,98,0,BHOPAL-JAIPUR,98,All
2018,9,BHOPAL,JAIPUR,63,0,BHOPAL-JAIPUR,63,All
2018,10,BHOPAL,JAIPUR,1152,0,BHOPAL-JAIPUR,1152,All
2018,11,BHOPAL,JAIPUR,0,2350,BHOPAL-JAIPUR,2350,All
2018,12,BHOPAL,JAIPUR,0,2547,BHOPAL-JAIPUR,2547,All
2019,1,BHOPAL,JAIPUR,2805,2163,BHOPAL-JAIPUR,4968,All
2019,2,BHOPAL,JAIPUR,1992,4363,BHOPAL-JAIPUR,6355,All
2019,3,BHOPAL,JAIPUR,2403,2236,BHOPAL-JAIPUR,4639,All
2019,4,BHOPAL,JAIPUR,1278,1103,BHOPAL-JAIPUR,2381,All
2019,5,BHOPAL,JAIPUR,1387,1244,BHOPAL-JAIPUR,2631,All
2019,6,BHOPAL,JAIPUR,1258,1188,BHOPAL-JAIPUR,2446,All
2019,7,BHOPAL,JAIPUR,1129,910,BHOPAL-JAIPUR,2039,All
2019,8,BHOPAL,JAIPUR,1142,972,BHOPAL-JAIPUR,2114,All
2019,9,BHOPAL,JAIPUR,1105,865,BHOPAL-JAIPUR,1970,All
2019,10,BHOPAL,JAIPUR,2463,2158,BHOPAL-JAIPUR,4621,All
2019,11,BHOPAL,JAIPUR,972,884,BHOPAL-JAIPUR,1856,All
2019,12,BHOPAL,JAIPUR,2006,1776,BHOPAL-JAIPUR,3782,All
2020,1,BHOPAL,JAIPUR,2578,2199,BHOPAL-JAIPUR,4777,All
2020,2,BHOPAL,JAIPUR,3012,2607,BHOPAL-JAIPUR,5619,All
2020,3,BHOPAL,JAIPUR,1745,1567,BHOPAL-JAIPUR,3312,All
2021,12,BHOPAL,JAIPUR,0,65,BHOPAL-JAIPUR,65,All
2023,4,BHOPAL,JAIPUR,547,432,BHOPAL-JAIPUR,979,All
2023,5,BHOPAL,JAIPUR,848,799,BHOPAL-JAIPUR,1647,All
2023,6,BHOPAL,JAIPUR,803,808,BHOPAL-JAIPUR,1611,All
2023,7,BHOPAL,JAIPUR,878,714,BHOPAL-JAIPUR,1592,All
2023,8,BHOPAL,JAIPUR,954,831,BHOPAL-JAIPUR,1785,All
2023,9,BHOPAL,JAIPUR,911,858,BHOPAL-JAIPUR,1769,All
2023,10,BHOPAL,JAIPUR,874,1025,BHOPAL-JAIPUR,1899,All
2023,11,BHOPAL,JAIPUR,1859,1777,BHOPAL-JAIPUR,3636,All
2023,12,BHOPAL,JAIPUR,2219,2166,BHOPAL-JAIPUR,4385,All
2024,1,BHOPAL,JAIPUR,2139,1925,BHOPAL-JAIPUR,4064,All
2024,2,BHOPAL,JAIPUR,1888,1753,BHOPAL-JAIPUR,3641,All
2024,3,BHOPAL,JAIPUR,1446,1503,BHOPAL-JAIPUR,2949,All
2024,4,BHOPAL,JAIPUR,1055,1117,BHOPAL-JAIPUR,2172,All
2024,6,BHOPAL,JAIPUR,1043,1207,BHOPAL-JAIPUR,2250,All
2024,7,BHOPAL,JAIPUR,955,1068,BHOPAL-JAIPUR,2023,All
2024,8,BHOPAL,JAIPUR,1176,1071,BHOPAL-JAIPUR,2247,All
2024,9,BHOPAL,JAIPUR,1201,1056,BHOPAL-JAIPUR,2257,All
2024,10,BHOPAL,JAIPUR,1077,940,BHOPAL-JAIPUR,2017,All
2024,11,BHOPAL,JAIPUR,1141,1067,BHOPAL-JAIPUR,2208,All
2024,12,BHOPAL,JAIPUR,1272,1277,BHOPAL-JAIPUR,2549,All
2025,1,BHOPAL,JAIPUR,1227,1261,BHOPAL-JAIPUR,2488,All
2025,2,BHOPAL,JAIPUR,1104,971,BHOPAL-JAIPUR,2075,All
2025,3,BHOPAL,JAIPUR,1049,912,BHOPAL-JAIPUR,1961,All
2025,3,BHOPAL,KANNUR,143,0,BHOPAL-KANNUR,143,All
2019,1,BHOPAL,KOCHI,0,16,BHOPAL-KOCHI,16,All
2019,2,BHOPAL,KOCHI,0,49,BHOPAL-KOCHI,49,All
2019,3,BHOPAL,KOCHI,0,32,BHOPAL-KOCHI,32,All
2019,4,BHOPAL,KOCHI,0,56,BHOPAL-KOCHI,56,All
2019,5,BHOPAL,KOCHI,0,5,BHOPAL-KOCHI,5,All
2019,6,BHOPAL,KOCHI,0,106,BHOPAL-KOCHI,106,All
2019,7,BHOPAL,KOCHI,0,84,BHOPAL-KOCHI,84,All
2019,8,BHOPAL,KOCHI,0,28,BHOPAL-KOCHI,28,All
2019,9,BHOPAL,KOCHI,0,74,BHOPAL-KOCHI,74,All
2019,10,BHOPAL,KOCHI,0,86,BHOPAL-KOCHI,86,All
2021,10,BHOPAL,KOCHI,9,4,BHOPAL-KOCHI,13,All
2021,11,BHOPAL,KOCHI,370,368,BHOPAL-KOCHI,738,All
2021,12,BHOPAL,KOCHI,549,417,BHOPAL-KOCHI,966,All
2022,1,BHOPAL,KOCHI,376,447,BHOPAL-KOCHI,823,All
2022,2,BHOPAL,KOCHI,198,263,BHOPAL-KOCHI,461,All
2022,3,BHOPAL,KOCHI,421,478,BHOPAL-KOCHI,899,All
2022,4,BHOPAL,KOCHI,429,441,BHOPAL-KOCHI,870,All
2022,5,BHOPAL,KOCHI,759,763,BHOPAL-KOCHI,1522,All
2022,6,BHOPAL,KOCHI,674,740,BHOPAL-KOCHI,1414,All
2022,7,BHOPAL,KOCHI,527,665,BHOPAL-KOCHI,1192,All
2022,8,BHOPAL,KOCHI,667,655,BHOPAL-KOCHI,1322,All
2022,9,BHOPAL,KOCHI,635,687,BHOPAL-KOCHI,1322,All
2022,10,BHOPAL,KOCHI,726,683,BHOPAL-KOCHI,1409,All
2022,11,BHOPAL,KOCHI,584,752,BHOPAL-KOCHI,1336,All
2022,12,BHOPAL,KOCHI,765,698,BHOPAL-KOCHI,1463,All
2023,1,BHOPAL,KOCHI,456,656,BHOPAL-KOCHI,1112,All
2023,2,BHOPAL,KOCHI,523,512,BHOPAL-KOCHI,1035,All
2023,3,BHOPAL,KOCHI,394,430,BHOPAL-KOCHI,824,All
2023,4,BHOPAL,KOCHI,667,585,BHOPAL-KOCHI,1252,All
2023,5,BHOPAL,KOCHI,780,682,BHOPAL-KOCHI,1462,All
2023,6,BHOPAL,KOCHI,478,556,BHOPAL-KOCHI,1034,All
2023,7,BHOPAL,KOCHI,324,317,BHOPAL-KOCHI,641,All
2023,8,BHOPAL,KOCHI,402,373,BHOPAL-KOCHI,775,All
2023,9,BHOPAL,KOCHI,391,295,BHOPAL-KOCHI,686,All
2023,10,BHOPAL,KOCHI,488,471,BHOPAL-KOCHI,959,All
2023,11,BHOPAL,KOCHI,306,305,BHOPAL-KOCHI,611,All
2023,12,BHOPAL,KOCHI,356,210,BHOPAL-KOCHI,566,All
2024,1,BHOPAL,KOCHI,260,358,BHOPAL-KOCHI,618,All
2024,2,BHOPAL,KOCHI,348,274,BHOPAL-KOCHI,622,All
2024,3,BHOPAL,KOCHI,600,382,BHOPAL-KOCHI,982,All
2020,9,BHOPAL,KOLKATA,513,801,BHOPAL-KOLKATA,1314,All
2020,10,BHOPAL,KOLKATA,847,1086,BHOPAL-KOLKATA,1933,All
2021,1,BHOPAL,KOLKATA,151,0,BHOPAL-KOLKATA,151,All
2023,10,BHOPAL,KOLKATA,164,0,BHOPAL-KOLKATA,164,All
2015,7,BHOPAL,LUCKNOW,58,0,BHOPAL-LUCKNOW,58,All
2015,8,BHOPAL,LUCKNOW,65,0,BHOPAL-LUCKNOW,65,All
2015,9,BHOPAL,LUCKNOW,76,0,BHOPAL-LUCKNOW,76,All
2015,10,BHOPAL,LUCKNOW,90,0,BHOPAL-LUCKNOW,90,All
2015,11,BHOPAL,LUCKNOW,204,0,BHOPAL-LUCKNOW,204,All
2016,3,BHOPAL,LUCKNOW,43,0,BHOPAL-LUCKNOW,43,All
2017,7,BHOPAL,LUCKNOW,1206,1021,BHOPAL-LUCKNOW,2227,All
2017,8,BHOPAL,LUCKNOW,1547,1117,BHOPAL-LUCKNOW,2664,All
2017,9,BHOPAL,LUCKNOW,1328,1603,BHOPAL-LUCKNOW,2931,All
2017,10,BHOPAL,LUCKNOW,1519,1118,BHOPAL-LUCKNOW,2637,All
2017,11,BHOPAL,LUCKNOW,1642,1179,BHOPAL-LUCKNOW,2821,All
2017,12,BHOPAL,LUCKNOW,1650,1232,BHOPAL-LUCKNOW,2882,All
2018,1,BHOPAL,LUCKNOW,1916,1612,BHOPAL-LUCKNOW,3528,All
2018,2,BHOPAL,LUCKNOW,1618,988,BHOPAL-LUCKNOW,2606,All
2018,3,BHOPAL,LUCKNOW,1762,1301,BHOPAL-LUCKNOW,3063,All
2018,4,BHOPAL,LUCKNOW,1548,912,BHOPAL-LUCKNOW,2460,All
2018,5,BHOPAL,LUCKNOW,1536,1515,BHOPAL-LUCKNOW,3051,All
2018,6,BHOPAL,LUCKNOW,1451,1445,BHOPAL-LUCKNOW,2896,All
2018,7,BHOPAL,LUCKNOW,1493,778,BHOPAL-LUCKNOW,2271,All
2018,8,BHOPAL,LUCKNOW,908,1407,BHOPAL-LUCKNOW,2315,All
2018,9,BHOPAL,LUCKNOW,811,825,BHOPAL-LUCKNOW,1636,All
2018,11,BHOPAL,LUCKNOW,1412,0,BHOPAL-LUCKNOW,1412,All
2020,9,BHOPAL,LUCKNOW,47,72,BHOPAL-LUCKNOW,119,All
2021,2,BHOPAL,LUCKNOW,892,1164,BHOPAL-LUCKNOW,2056,All
2021,3,BHOPAL,LUCKNOW,954,961,BHOPAL-LUCKNOW,1915,All
2022,2,BHOPAL,LUCKNOW,167,0,BHOPAL-LUCKNOW,167,All
2022,7,BHOPAL,LUCKNOW,160,0,BHOPAL-LUCKNOW,160,All
2023,10,BHOPAL,LUCKNOW,0,123,BHOPAL-LUCKNOW,123,All
2023,12,BHOPAL,LUCKNOW,12,0,BHOPAL-LUCKNOW,12,All
2024,1,BHOPAL,LUCKNOW,7,5,BHOPAL-LUCKNOW,12,All
2024,3,BHOPAL,LUCKNOW,72,78,BHOPAL-LUCKNOW,150,All
2024,4,BHOPAL,LUCKNOW,1216,1092,BHOPAL-LUCKNOW,2308,All
2024,6,BHOPAL,LUCKNOW,971,1205,BHOPAL-LUCKNOW,2176,All
2024,7,BHOPAL,LUCKNOW,1163,1134,BHOPAL-LUCKNOW,2297,All
2024,8,BHOPAL,LUCKNOW,1099,1187,BHOPAL-LUCKNOW,2286,All
2024,9,BHOPAL,LUCKNOW,1236,1165,BHOPAL-LUCKNOW,2401,All
2024,10,BHOPAL,LUCKNOW,1206,1018,BHOPAL-LUCKNOW,2224,All
2024,11,BHOPAL,LUCKNOW,1236,1263,BHOPAL-LUCKNOW,2499,All
2024,12,BHOPAL,LUCKNOW,1223,1366,BHOPAL-LUCKNOW,2589,All
2025,1,BHOPAL,LUCKNOW,1322,1301,BHOPAL-LUCKNOW,2623,All
2025,2,BHOPAL,LUCKNOW,1205,1208,BHOPAL-LUCKNOW,2413,All
2025,3,BHOPAL,LUCKNOW,1123,1107,BHOPAL-LUCKNOW,2230,All
2015,4,BHOPAL,MUMBAI,12475,12034,BHOPAL-MUMBAI,24509,All
2015,5,BHOPAL,MUMBAI,12950,10936,BHOPAL-MUMBAI,23886,All
2015,6,BHOPAL,MUMBAI,12166,10576,BHOPAL-MUMBAI,22742,All
2015,7,BHOPAL,MUMBAI,12816,11203,BHOPAL-MUMBAI,24019,All
2015,8,BHOPAL,MUMBAI,12302,10677,BHOPAL-MUMBAI,22979,All
2015,9,BHOPAL,MUMBAI,11268,9531,BHOPAL-MUMBAI,20799,All
2015,10,BHOPAL,MUMBAI,21197,9888,BHOPAL-MUMBAI,31085,All
2015,11,BHOPAL,MUMBAI,12732,10985,BHOPAL-MUMBAI,23717,All
2015,12,BHOPAL,MUMBAI,15000,12247,BHOPAL-MUMBAI,27247,All
2016,1,BHOPAL,MUMBAI,14089,11848,BHOPAL-MUMBAI,25937,All
2016,2,BHOPAL,MUMBAI,13189,10842,BHOPAL-MUMBAI,24031,All
2016,3,BHOPAL,MUMBAI,12457,9972,BHOPAL-MUMBAI,22429,All
2016,4,BHOPAL,MUMBAI,12836,12920,BHOPAL-MUMBAI,25756,All
2016,5,BHOPAL,MUMBAI,16440,12628,BHOPAL-MUMBAI,29068,All
2016,6,BHOPAL,MUMBAI,14647,12219,BHOPAL-MUMBAI,26866,All
2016,7,BHOPAL,MUMBAI,15831,14327,BHOPAL-MUMBAI,30158,All
2016,8,BHOPAL,MUMBAI,16055,13249,BHOPAL-MUMBAI,29304,All
2016,9,BHOPAL,MUMBAI,14979,12769,BHOPAL-MUMBAI,27748,All
2016,10,BHOPAL,MUMBAI,12898,13666,BHOPAL-MUMBAI,26564,All
2016,11,BHOPAL,MUMBAI,13656,11008,BHOPAL-MUMBAI,24664,All
2016,12,BHOPAL,MUMBAI,14054,12303,BHOPAL-MUMBAI,26357,All
2017,1,BHOPAL,MUMBAI,13167,11906,BHOPAL-MUMBAI,25073,All
2017,2,BHOPAL,MUMBAI,11905,10711,BHOPAL-MUMBAI,22616,All
2017,3,BHOPAL,MUMBAI,12418,11119,BHOPAL-MUMBAI,23537,All
2017,4,BHOPAL,MUMBAI,11629,11121,BHOPAL-MUMBAI,22750,All
2017,5,BHOPAL,MUMBAI,14289,11696,BHOPAL-MUMBAI,25985,All
2017,6,BHOPAL,MUMBAI,12849,11210,BHOPAL-MUMBAI,24059,All
2017,7,BHOPAL,MUMBAI,13091,10974,BHOPAL-MUMBAI,24065,All
2017,8,BHOPAL,MUMBAI,12839,11149,BHOPAL-MUMBAI,23988,All
2017,9,BHOPAL,MUMBAI,11767,10214,BHOPAL-MUMBAI,21981,All
2017,10,BHOPAL,MUMBAI,12258,11241,BHOPAL-MUMBAI,23499,All
2017,11,BHOPAL,MUMBAI,12883,10642,BHOPAL-MUMBAI,23525,All
2017,12,BHOPAL,MUMBAI,13883,11753,BHOPAL-MUMBAI,25636,All
2018,1,BHOPAL,MUMBAI,13259,11456,BHOPAL-MUMBAI,24715,All
2018,2,BHOPAL,MUMBAI,11792,10523,BHOPAL-MUMBAI,22315,All
2018,3,BHOPAL,MUMBAI,12670,10863,BHOPAL-MUMBAI,23533,All
2018,4,BHOPAL,MUMBAI,13104,14073,BHOPAL-MUMBAI,27177,All
2018,5,BHOPAL,MUMBAI,14625,11802,BHOPAL-MUMBAI,26427,All
2018,6,BHOPAL,MUMBAI,13803,13194,BHOPAL-MUMBAI,26997,All
2018,7,BHOPAL,MUMBAI,11603,11399,BHOPAL-MUMBAI,23002,All
2018,8,BHOPAL,MUMBAI,11272,11031,BHOPAL-MUMBAI,22303,All
2018,9,BHOPAL,MUMBAI,11520,11084,BHOPAL-MUMBAI,22604,All
2018,10,BHOPAL,MUMBAI,12640,13121,BHOPAL-MUMBAI,25761,All
2018,11,BHOPAL,MUMBAI,14386,12544,BHOPAL-MUMBAI,26930,All
2018,12,BHOPAL,MUMBAI,16141,15048,BHOPAL-MUMBAI,31189,All
2019,1,BHOPAL,MUMBAI,15629,15412,BHOPAL-MUMBAI,31041,All
2019,2,BHOPAL,MUMBAI,14770,15056,BHOPAL-MUMBAI,29826,All
2019,3,BHOPAL,MUMBAI,12186,11823,BHOPAL-MUMBAI,24009,All
2019,4,BHOPAL,MUMBAI,18323,19267,BHOPAL-MUMBAI,37590,All
2019,5,BHOPAL,MUMBAI,25719,24948,BHOPAL-MUMBAI,50667,All
2019,6,BHOPAL,MUMBAI,22929,21632,BHOPAL-MUMBAI,44561,All
2019,7,BHOPAL,MUMBAI,18413,18680,BHOPAL-MUMBAI,37093,All
2019,8,BHOPAL,MUMBAI,19094,19175,BHOPAL-MUMBAI,38269,All
2019,9,BHOPAL,MUMBAI,18005,17214,BHOPAL-MUMBAI,35219,All
2019,10,BHOPAL,MUMBAI,18054,20960,BHOPAL-MUMBAI,39014,All
2019,11,BHOPAL,MUMBAI,16557,15408,BHOPAL-MUMBAI,31965,All
2019,12,BHOPAL,MUMBAI,16442,15535,BHOPAL-MUMBAI,31977,All
2020,1,BHOPAL,MUMBAI,15638,15127,BHOPAL-MUMBAI,30765,All
2020,2,BHOPAL,MUMBAI,15032,14699,BHOPAL-MUMBAI,29731,All
2020,3,BHOPAL,MUMBAI,8544,9833,BHOPAL-MUMBAI,18377,All
2020,5,BHOPAL,MUMBAI,41,180,BHOPAL-MUMBAI,221,All
2020,6,BHOPAL,MUMBAI,581,807,BHOPAL-MUMBAI,1388,All
2020,7,BHOPAL,MUMBAI,979,1506,BHOPAL-MUMBAI,2485,All
2020,8,BHOPAL,MUMBAI,2244,1866,BHOPAL-MUMBAI,4110,All
2020,9,BHOPAL,MUMBAI,3103,2710,BHOPAL-MUMBAI,5813,All
2020,10,BHOPAL,MUMBAI,5231,5573,BHOPAL-MUMBAI,10804,All
2020,11,BHOPAL,MUMBAI,9715,10335,BHOPAL-MUMBAI,20050,All
2020,12,BHOPAL,MUMBAI,12953,9536,BHOPAL-MUMBAI,22489,All
2021,1,BHOPAL,MUMBAI,12677,10348,BHOPAL-MUMBAI,23025,All
2021,2,BHOPAL,MUMBAI,11888,10265,BHOPAL-MUMBAI,22153,All
2021,3,BHOPAL,MUMBAI,9312,8092,BHOPAL-MUMBAI,17404,All
2021,4,BHOPAL,MUMBAI,3672,4414,BHOPAL-MUMBAI,8086,All
2021,6,BHOPAL,MUMBAI,4144,4904,BHOPAL-MUMBAI,9048,All
2021,7,BHOPAL,MUMBAI,7692,7646,BHOPAL-MUMBAI,15338,All
2021,8,BHOPAL,MUMBAI,10291,9732,BHOPAL-MUMBAI,20023,All
2021,9,BHOPAL,MUMBAI,11032,9323,BHOPAL-MUMBAI,20355,All
2021,10,BHOPAL,MUMBAI,13140,13957,BHOPAL-MUMBAI,27097,All
2021,11,BHOPAL,MUMBAI,14431,13369,BHOPAL-MUMBAI,27800,All
2021,12,BHOPAL,MUMBAI,15664,13605,BHOPAL-MUMBAI,29269,All
2022,1,BHOPAL,MUMBAI,6929,7545,BHOPAL-MUMBAI,14474,All
2022,2,BHOPAL,MUMBAI,9444,9468,BHOPAL-MUMBAI,18912,All
2022,3,BHOPAL,MUMBAI,15027,14961,BHOPAL-MUMBAI,29988,All
2022,4,BHOPAL,MUMBAI,12782,12663,BHOPAL-MUMBAI,25445,All
2022,5,BHOPAL,MUMBAI,14316,12928,BHOPAL-MUMBAI,27244,All
2022,6,BHOPAL,MUMBAI,12842,11251,BHOPAL-MUMBAI,24093,All
2022,7,BHOPAL,MUMBAI,12079,11142,BHOPAL-MUMBAI,23221,All
2022,8,BHOPAL,MUMBAI,13248,11887,BHOPAL-MUMBAI,25135,All
2022,9,BHOPAL,MUMBAI,12693,12117,BHOPAL-MUMBAI,24810,All
2022,10,BHOPAL,MUMBAI,11771,13254,BHOPAL-MUMBAI,25025,All
2022,11,BHOPAL,MUMBAI,14878,13239,BHOPAL-MUMBAI,28117,All
2022,12,BHOPAL,MUMBAI,14976,14486,BHOPAL-MUMBAI,29462,All
2023,1,BHOPAL,MUMBAI,14149,14037,BHOPAL-MUMBAI,28186,All
2023,2,BHOPAL,MUMBAI,13779,14062,BHOPAL-MUMBAI,27841,All
2023,3,BHOPAL,MUMBAI,14547,14367,BHOPAL-MUMBAI,28914,All
2023,4,BHOPAL,MUMBAI,13326,13755,BHOPAL-MUMBAI,27081,All
2023,5,BHOPAL,MUMBAI,13621,13527,BHOPAL-MUMBAI,27148,All
2023,6,BHOPAL,MUMBAI,13721,13055,BHOPAL-MUMBAI,26776,All
2023,7,BHOPAL,MUMBAI,13360,13415,BHOPAL-MUMBAI,26775,All
2023,8,BHOPAL,MUMBAI,13315,13439,BHOPAL-MUMBAI,26754,All
2023,9,BHOPAL,MUMBAI,12486,12180,BHOPAL-MUMBAI,24666,All
2023,10,BHOPAL,MUMBAI,11721,13048,BHOPAL-MUMBAI,24769,All
2023,11,BHOPAL,MUMBAI,12721,13988,BHOPAL-MUMBAI,26709,All
2023,12,BHOPAL,MUMBAI,14957,14428,BHOPAL-MUMBAI,29385,All
2024,1,BHOPAL,MUMBAI,13911,13667,BHOPAL-MUMBAI,27578,All
2024,2,BHOPAL,MUMBAI,14831,14950,BHOPAL-MUMBAI,29781,All
2024,3,BHOPAL,MUMBAI,14294,14901,BHOPAL-MUMBAI,29195,All
2024,4,BHOPAL,MUMBAI,13637,15365,BHOPAL-MUMBAI,29002,All
2024,6,BHOPAL,MUMBAI,14992,14263,BHOPAL-MUMBAI,29255,All
2024,7,BHOPAL,MUMBAI,13837,13526,BHOPAL-MUMBAI,27363,All
2024,8,BHOPAL,MUMBAI,14880,13634,BHOPAL-MUMBAI,28514,All
2024,9,BHOPAL,MUMBAI,13190,13142,BHOPAL-MUMBAI,26332,All
2024,10,BHOPAL,MUMBAI,11832,15128,BHOPAL-MUMBAI,26960,All
2024,11,BHOPAL,MUMBAI,15956,13929,BHOPAL-MUMBAI,29885,All
2024,12,BHOPAL,MUMBAI,16532,14950,BHOPAL-MUMBAI,31482,All
2025,1,BHOPAL,MUMBAI,15082,15132,BHOPAL-MUMBAI,30214,All
2025,2,BHOPAL,MUMBAI,15092,15930,BHOPAL-MUMBAI,31022,All
2025,3,BHOPAL,MUMBAI,15028,15059,BHOPAL-MUMBAI,30087,All
2018,10,BHOPAL,NAGPUR,0,0,BHOPAL-NAGPUR,0,All
2019,5,BHOPAL,NAGPUR,0,2,BHOPAL-NAGPUR,2,All
2019,10,BHOPAL,NAGPUR,0,0,BHOPAL-NAGPUR,0,All
2022,1,BHOPAL,NAGPUR,0,1,BHOPAL-NAGPUR,1,All
2023,4,BHOPAL,NAGPUR,175,0,BHOPAL-NAGPUR,175,All
2023,5,BHOPAL,NAGPUR,6,0,BHOPAL-NAGPUR,6,All
2024,7,BHOPAL,NAGPUR,31,0,BHOPAL-NAGPUR,31,All
2018,5,BHOPAL,PATNA,0,387,BHOPAL-PATNA,387,All
2018,6,BHOPAL,PATNA,0,387,BHOPAL-PATNA,387,All
2018,7,BHOPAL,PATNA,0,202,BHOPAL-PATNA,202,All
2018,8,BHOPAL,PATNA,0,152,BHOPAL-PATNA,152,All
2020,9,BHOPAL,PATNA,5,0,BHOPAL-PATNA,5,All
2019,3,BHOPAL,PUNE,269,248,BHOPAL-PUNE,517,All
2019,6,BHOPAL,PUNE,1804,1639,BHOPAL-PUNE,3443,All
2019,7,BHOPAL,PUNE,2128,1911,BHOPAL-PUNE,4039,All
2019,8,BHOPAL,PUNE,2251,2196,BHOPAL-PUNE,4447,All
2019,9,BHOPAL,PUNE,2203,2075,BHOPAL-PUNE,4278,All
2019,10,BHOPAL,PUNE,2232,2312,BHOPAL-PUNE,4544,All
2019,11,BHOPAL,PUNE,1781,1786,BHOPAL-PUNE,3567,All
2019,12,BHOPAL,PUNE,1634,1685,BHOPAL-PUNE,3319,All
2020,1,BHOPAL,PUNE,1436,1411,BHOPAL-PUNE,2847,All
2020,2,BHOPAL,PUNE,1278,1189,BHOPAL-PUNE,2467,All
2020,3,BHOPAL,PUNE,791,963,BHOPAL-PUNE,1754,All
2021,3,BHOPAL,PUNE,167,166,BHOPAL-PUNE,333,All
2021,4,BHOPAL,PUNE,577,928,BHOPAL-PUNE,1505,All
2021,8,BHOPAL,PUNE,1024,971,BHOPAL-PUNE,1995,All
2021,9,BHOPAL,PUNE,1059,882,BHOPAL-PUNE,1941,All
2021,10,BHOPAL,PUNE,673,731,BHOPAL-PUNE,1404,All
2021,11,BHOPAL,PUNE,1543,1579,BHOPAL-PUNE,3122,All
2021,12,BHOPAL,PUNE,1602,1439,BHOPAL-PUNE,3041,All
2022,1,BHOPAL,PUNE,1082,1140,BHOPAL-PUNE,2222,All
2022,2,BHOPAL,PUNE,1433,1398,BHOPAL-PUNE,2831,All
2022,3,BHOPAL,PUNE,1654,1409,BHOPAL-PUNE,3063,All
2022,4,BHOPAL,PUNE,1326,1169,BHOPAL-PUNE,2495,All
2022,6,BHOPAL,PUNE,2181,1831,BHOPAL-PUNE,4012,All
2022,7,BHOPAL,PUNE,1371,1196,BHOPAL-PUNE,2567,All
2022,8,BHOPAL,PUNE,1242,1198,BHOPAL-PUNE,2440,All
2024,10,BHOPAL,PUNE,317,713,BHOPAL-PUNE,1030,All
2024,11,BHOPAL,PUNE,5104,4536,BHOPAL-PUNE,9640,All
2024,12,BHOPAL,PUNE,5197,4789,BHOPAL-PUNE,9986,All
2025,1,BHOPAL,PUNE,4812,4778,BHOPAL-PUNE,9590,All
2025,2,BHOPAL,PUNE,4596,4788,BHOPAL-PUNE,9384,All
2025,3,BHOPAL,PUNE,4568,4961,BHOPAL-PUNE,9529,All
2015,4,BHOPAL,RAIPUR,0,870,BHOPAL-RAIPUR,870,All
2015,5,BHOPAL,RAIPUR,0,986,BHOPAL-RAIPUR,986,All
2015,6,BHOPAL,RAIPUR,0,972,BHOPAL-RAIPUR,972,All
2015,7,BHOPAL,RAIPUR,0,963,BHOPAL-RAIPUR,963,All
2015,8,BHOPAL,RAIPUR,0,925,BHOPAL-RAIPUR,925,All
2015,9,BHOPAL,RAIPUR,0,689,BHOPAL-RAIPUR,689,All
2015,10,BHOPAL,RAIPUR,0,751,BHOPAL-RAIPUR,751,All
2015,11,BHOPAL,RAIPUR,0,722,BHOPAL-RAIPUR,722,All
2015,12,BHOPAL,RAIPUR,0,843,BHOPAL-RAIPUR,843,All
2016,1,BHOPAL,RAIPUR,0,861,BHOPAL-RAIPUR,861,All
2016,2,BHOPAL,RAIPUR,0,723,BHOPAL-RAIPUR,723,All
2016,3,BHOPAL,RAIPUR,1,742,BHOPAL-RAIPUR,743,All
2016,4,BHOPAL,RAIPUR,421,801,BHOPAL-RAIPUR,1222,All
2016,5,BHOPAL,RAIPUR,326,944,BHOPAL-RAIPUR,1270,All
2016,6,BHOPAL,RAIPUR,616,946,BHOPAL-RAIPUR,1562,All
2016,7,BHOPAL,RAIPUR,615,1093,BHOPAL-RAIPUR,1708,All
2016,8,BHOPAL,RAIPUR,802,1623,BHOPAL-RAIPUR,2425,All
2016,9,BHOPAL,RAIPUR,671,1516,BHOPAL-RAIPUR,2187,All
2016,10,BHOPAL,RAIPUR,1154,1012,BHOPAL-RAIPUR,2166,All
2016,11,BHOPAL,RAIPUR,762,1341,BHOPAL-RAIPUR,2103,All
2016,12,BHOPAL,RAIPUR,752,1561,BHOPAL-RAIPUR,2313,All
2017,1,BHOPAL,RAIPUR,715,1506,BHOPAL-RAIPUR,2221,All
2017,2,BHOPAL,RAIPUR,713,1200,BHOPAL-RAIPUR,1913,All
2017,3,BHOPAL,RAIPUR,785,1298,BHOPAL-RAIPUR,2083,All
2017,4,BHOPAL,RAIPUR,158,1016,BHOPAL-RAIPUR,1174,All
2017,5,BHOPAL,RAIPUR,0,1258,BHOPAL-RAIPUR,1258,All
2017,6,BHOPAL,RAIPUR,0,919,BHOPAL-RAIPUR,919,All
2017,7,BHOPAL,RAIPUR,0,864,BHOPAL-RAIPUR,864,All
2017,8,BHOPAL,RAIPUR,0,848,BHOPAL-RAIPUR,848,All
2017,9,BHOPAL,RAIPUR,580,982,BHOPAL-RAIPUR,1562,All
2017,10,BHOPAL,RAIPUR,510,1228,BHOPAL-RAIPUR,1738,All
2017,11,BHOPAL,RAIPUR,1141,1925,BHOPAL-RAIPUR,3066,All
2017,12,BHOPAL,RAIPUR,1155,2186,BHOPAL-RAIPUR,3341,All
2018,1,BHOPAL,RAIPUR,1177,1885,BHOPAL-RAIPUR,3062,All
2018,2,BHOPAL,RAIPUR,1105,1873,BHOPAL-RAIPUR,2978,All
2018,3,BHOPAL,RAIPUR,1153,1790,BHOPAL-RAIPUR,2943,All
2018,4,BHOPAL,RAIPUR,1188,1077,BHOPAL-RAIPUR,2265,All
2018,5,BHOPAL,RAIPUR,1245,1165,BHOPAL-RAIPUR,2410,All
2018,6,BHOPAL,RAIPUR,1208,1067,BHOPAL-RAIPUR,2275,All
2018,7,BHOPAL,RAIPUR,1193,1066,BHOPAL-RAIPUR,2259,All
2018,8,BHOPAL,RAIPUR,1017,1153,BHOPAL-RAIPUR,2170,All
2018,9,BHOPAL,RAIPUR,1074,1014,BHOPAL-RAIPUR,2088,All
2018,10,BHOPAL,RAIPUR,0,310,BHOPAL-RAIPUR,310,All
2018,11,BHOPAL,RAIPUR,0,2608,BHOPAL-RAIPUR,2608,All
2018,12,BHOPAL,RAIPUR,0,2554,BHOPAL-RAIPUR,2554,All
2019,1,BHOPAL,RAIPUR,1232,1265,BHOPAL-RAIPUR,2497,All
2019,2,BHOPAL,RAIPUR,0,2530,BHOPAL-RAIPUR,2530,All
2019,3,BHOPAL,RAIPUR,982,1072,BHOPAL-RAIPUR,2054,All
2019,4,BHOPAL,RAIPUR,1165,1277,BHOPAL-RAIPUR,2442,All
2019,5,BHOPAL,RAIPUR,1471,1470,BHOPAL-RAIPUR,2941,All
2019,6,BHOPAL,RAIPUR,1252,1357,BHOPAL-RAIPUR,2609,All
2019,7,BHOPAL,RAIPUR,1149,1159,BHOPAL-RAIPUR,2308,All
2019,8,BHOPAL,RAIPUR,1152,1202,BHOPAL-RAIPUR,2354,All
2019,9,BHOPAL,RAIPUR,948,984,BHOPAL-RAIPUR,1932,All
2019,10,BHOPAL,RAIPUR,952,899,BHOPAL-RAIPUR,1851,All
2019,11,BHOPAL,RAIPUR,937,987,BHOPAL-RAIPUR,1924,All
2019,12,BHOPAL,RAIPUR,1106,1094,BHOPAL-RAIPUR,2200,All
2020,1,BHOPAL,RAIPUR,984,993,BHOPAL-RAIPUR,1977,All
2020,2,BHOPAL,RAIPUR,983,1028,BHOPAL-RAIPUR,2011,All
2020,3,BHOPAL,RAIPUR,388,369,BHOPAL-RAIPUR,757,All
2020,5,BHOPAL,RAIPUR,1,0,BHOPAL-RAIPUR,1,All
2020,6,BHOPAL,RAIPUR,0,1,BHOPAL-RAIPUR,1,All
2020,7,BHOPAL,RAIPUR,0,38,BHOPAL-RAIPUR,38,All
2020,8,BHOPAL,RAIPUR,0,8,BHOPAL-RAIPUR,8,All
2021,3,BHOPAL,RAIPUR,2,0,BHOPAL-RAIPUR,2,All
2021,10,BHOPAL,RAIPUR,236,224,BHOPAL-RAIPUR,460,All
2021,11,BHOPAL,RAIPUR,852,871,BHOPAL-RAIPUR,1723,All
2021,12,BHOPAL,RAIPUR,911,900,BHOPAL-RAIPUR,1811,All
2022,1,BHOPAL,RAIPUR,563,583,BHOPAL-RAIPUR,1146,All
2022,2,BHOPAL,RAIPUR,871,886,BHOPAL-RAIPUR,1757,All
2022,3,BHOPAL,RAIPUR,1160,1180,BHOPAL-RAIPUR,2340,All
2022,4,BHOPAL,RAIPUR,1867,2023,BHOPAL-RAIPUR,3890,All
2022,5,BHOPAL,RAIPUR,2153,2161,BHOPAL-RAIPUR,4314,All
2022,6,BHOPAL,RAIPUR,1741,1616,BHOPAL-RAIPUR,3357,All
2022,7,BHOPAL,RAIPUR,1638,1550,BHOPAL-RAIPUR,3188,All
2022,8,BHOPAL,RAIPUR,2056,1827,BHOPAL-RAIPUR,3883,All
2022,9,BHOPAL,RAIPUR,1879,1835,BHOPAL-RAIPUR,3714,All
2022,10,BHOPAL,RAIPUR,1974,2027,BHOPAL-RAIPUR,4001,All
2022,11,BHOPAL,RAIPUR,916,987,BHOPAL-RAIPUR,1903,All
2022,12,BHOPAL,RAIPUR,942,940,BHOPAL-RAIPUR,1882,All
2023,1,BHOPAL,RAIPUR,867,957,BHOPAL-RAIPUR,1824,All
2023,2,BHOPAL,RAIPUR,915,1010,BHOPAL-RAIPUR,1925,All
2023,3,BHOPAL,RAIPUR,963,1122,BHOPAL-RAIPUR,2085,All
2023,4,BHOPAL,RAIPUR,1435,1845,BHOPAL-RAIPUR,3280,All
2023,5,BHOPAL,RAIPUR,1641,1740,BHOPAL-RAIPUR,3381,All
2023,6,BHOPAL,RAIPUR,1624,1700,BHOPAL-RAIPUR,3324,All
2023,7,BHOPAL,RAIPUR,1605,1747,BHOPAL-RAIPUR,3352,All
2023,8,BHOPAL,RAIPUR,1584,1789,BHOPAL-RAIPUR,3373,All
2023,9,BHOPAL,RAIPUR,1524,1778,BHOPAL-RAIPUR,3302,All
2023,10,BHOPAL,RAIPUR,1550,1712,BHOPAL-RAIPUR,3262,All
2023,11,BHOPAL,RAIPUR,1863,2038,BHOPAL-RAIPUR,3901,All
2023,12,BHOPAL,RAIPUR,2312,2244,BHOPAL-RAIPUR,4556,All
2024,1,BHOPAL,RAIPUR,2195,2218,BHOPAL-RAIPUR,4413,All
2024,2,BHOPAL,RAIPUR,1990,1946,BHOPAL-RAIPUR,3936,All
2024,3,BHOPAL,RAIPUR,2084,2088,BHOPAL-RAIPUR,4172,All
2024,4,BHOPAL,RAIPUR,1846,1892,BHOPAL-RAIPUR,3738,All
2024,6,BHOPAL,RAIPUR,1956,2000,BHOPAL-RAIPUR,3956,All
2024,7,BHOPAL,RAIPUR,1975,1977,BHOPAL-RAIPUR,3952,All
2024,8,BHOPAL,RAIPUR,1945,1935,BHOPAL-RAIPUR,3880,All
2024,9,BHOPAL,RAIPUR,1900,1942,BHOPAL-RAIPUR,3842,All
2024,10,BHOPAL,RAIPUR,1748,1809,BHOPAL-RAIPUR,3557,All
2024,11,BHOPAL,RAIPUR,1978,2071,BHOPAL-RAIPUR,4049,All
2024,12,BHOPAL,RAIPUR,2257,2196,BHOPAL-RAIPUR,4453,All
2025,1,BHOPAL,RAIPUR,2148,2195,BHOPAL-RAIPUR,4343,All
2025,2,BHOPAL,RAIPUR,1885,2026,BHOPAL-RAIPUR,3911,All
2025,3,BHOPAL,RAIPUR,1893,1959,BHOPAL-RAIPUR,3852,All
2024,11,BHOPAL,REWA,34,31,BHOPAL-REWA,65,All
2024,12,BHOPAL,REWA,82,96,BHOPAL-REWA,178,All
2025,1,BHOPAL,REWA,99,111,BHOPAL-REWA,210,All
2025,2,BHOPAL,REWA,75,94,BHOPAL-REWA,169,All
2025,3,BHOPAL,REWA,62,85,BHOPAL-REWA,147,All
2019,1,BHOPAL,SHIRDI,775,758,BHOPAL-SHIRDI,1533,All
2019,2,BHOPAL,SHIRDI,681,696,BHOPAL-SHIRDI,1377,All
2019,3,BHOPAL,SHIRDI,1104,910,BHOPAL-SHIRDI,2014,All
2019,4,BHOPAL,SHIRDI,1196,1228,BHOPAL-SHIRDI,2424,All
2019,5,BHOPAL,SHIRDI,1541,1297,BHOPAL-SHIRDI,2838,All
2019,6,BHOPAL,SHIRDI,1793,1419,BHOPAL-SHIRDI,3212,All
2019,7,BHOPAL,SHIRDI,1454,1245,BHOPAL-SHIRDI,2699,All
2019,8,BHOPAL,SHIRDI,1530,1269,BHOPAL-SHIRDI,2799,All
2019,9,BHOPAL,SHIRDI,1236,1070,BHOPAL-SHIRDI,2306,All
2019,10,BHOPAL,SHIRDI,1242,1242,BHOPAL-SHIRDI,2484,All
2019,3,BHOPAL,SURAT,34,18,BHOPAL-SURAT,52,All
2019,4,BHOPAL,SURAT,605,841,BHOPAL-SURAT,1446,All
2019,5,BHOPAL,SURAT,1418,1249,BHOPAL-SURAT,2667,All
2019,6,BHOPAL,SURAT,942,692,BHOPAL-SURAT,1634,All
2019,7,BHOPAL,SURAT,474,431,BHOPAL-SURAT,905,All
2019,8,BHOPAL,SURAT,885,896,BHOPAL-SURAT,1781,All
2019,9,BHOPAL,SURAT,533,469,BHOPAL-SURAT,1002,All
2019,10,BHOPAL,SURAT,654,923,BHOPAL-SURAT,1577,All
2019,11,BHOPAL,SURAT,608,519,BHOPAL-SURAT,1127,All
2019,12,BHOPAL,SURAT,575,488,BHOPAL-SURAT,1063,All
2020,1,BHOPAL,SURAT,539,479,BHOPAL-SURAT,1018,All
2020,2,BHOPAL,SURAT,476,402,BHOPAL-SURAT,878,All
2020,3,BHOPAL,SURAT,282,223,BHOPAL-SURAT,505,All
2021,1,BHOPAL,SURAT,0,17,BHOPAL-SURAT,17,All
2022,2,BHOPAL,SURAT,61,0,BHOPAL-SURAT,61,All
2019,10,BHOPAL,TRIVANDRUM,4,0,BHOPAL-TRIVANDRUM,4,All
2019,11,BHOPAL,TRIVANDRUM,112,0,BHOPAL-TRIVANDRUM,112,All
2019,12,BHOPAL,TRIVANDRUM,188,0,BHOPAL-TRIVANDRUM,188,All
2020,1,BHOPAL,TRIVANDRUM,167,0,BHOPAL-TRIVANDRUM,167,All
2020,2,BHOPAL,TRIVANDRUM,191,0,BHOPAL-TRIVANDRUM,191,All
2020,3,BHOPAL,TRIVANDRUM,133,0,BHOPAL-TRIVANDRUM,133,All
2015,11,BHOPAL,UDAIPUR,0,7,BHOPAL-UDAIPUR,7,All
2019,3,BHOPAL,UDAIPUR,47,23,BHOPAL-UDAIPUR,70,All
2019,4,BHOPAL,UDAIPUR,741,656,BHOPAL-UDAIPUR,1397,All
2019,5,BHOPAL,UDAIPUR,743,723,BHOPAL-UDAIPUR,1466,All
2019,6,BHOPAL,UDAIPUR,723,733,BHOPAL-UDAIPUR,1456,All
2019,7,BHOPAL,UDAIPUR,394,461,BHOPAL-UDAIPUR,855,All
2019,8,BHOPAL,UDAIPUR,922,951,BHOPAL-UDAIPUR,1873,All
2019,9,BHOPAL,UDAIPUR,562,509,BHOPAL-UDAIPUR,1071,All
2019,10,BHOPAL,UDAIPUR,766,791,BHOPAL-UDAIPUR,1557,All
2019,11,BHOPAL,UDAIPUR,787,770,BHOPAL-UDAIPUR,1557,All
2019,12,BHOPAL,UDAIPUR,1043,1043,BHOPAL-UDAIPUR,2086,All
2020,1,BHOPAL,UDAIPUR,776,816,BHOPAL-UDAIPUR,1592,All
2020,2,BHOPAL,UDAIPUR,788,875,BHOPAL-UDAIPUR,1663,All
2020,3,BHOPAL,UDAIPUR,437,572,BHOPAL-UDAIPUR,1009,All
2022,11,BHOPAL,UDAIPUR,597,566,BHOPAL-UDAIPUR,1163,All
2022,12,BHOPAL,UDAIPUR,645,639,BHOPAL-UDAIPUR,1284,All
2023,1,BHOPAL,UDAIPUR,494,536,BHOPAL-UDAIPUR,1030,All
2023,2,BHOPAL,UDAIPUR,462,527,BHOPAL-UDAIPUR,989,All
2023,3,BHOPAL,UDAIPUR,343,373,BHOPAL-UDAIPUR,716,All
2023,4,BHOPAL,UDAIPUR,476,347,BHOPAL-UDAIPUR,823,All
2023,5,BHOPAL,UDAIPUR,395,437,BHOPAL-UDAIPUR,832,All
2023,6,BHOPAL,UDAIPUR,404,327,BHOPAL-UDAIPUR,731,All
2023,7,BHOPAL,UDAIPUR,465,381,BHOPAL-UDAIPUR,846,All
2023,8,BHOPAL,UDAIPUR,579,490,BHOPAL-UDAIPUR,1069,All
2023,9,BHOPAL,UDAIPUR,631,329,BHOPAL-UDAIPUR,960,All
2023,10,BHOPAL,UDAIPUR,618,639,BHOPAL-UDAIPUR,1257,All
2023,11,BHOPAL,UDAIPUR,632,833,BHOPAL-UDAIPUR,1465,All
2023,12,BHOPAL,UDAIPUR,861,908,BHOPAL-UDAIPUR,1769,All
2024,1,BHOPAL,UDAIPUR,513,489,BHOPAL-UDAIPUR,1002,All
2024,2,BHOPAL,UDAIPUR,818,822,BHOPAL-UDAIPUR,1640,All
2024,3,BHOPAL,UDAIPUR,757,775,BHOPAL-UDAIPUR,1532,All
2024,4,BHOPAL,UDAIPUR,713,710,BHOPAL-UDAIPUR,1423,All
2024,6,BHOPAL,UDAIPUR,558,526,BHOPAL-UDAIPUR,1084,All
2024,7,BHOPAL,UDAIPUR,708,850,BHOPAL-UDAIPUR,1558,All
2024,8,BHOPAL,UDAIPUR,912,789,BHOPAL-UDAIPUR,1701,All
2024,9,BHOPAL,UDAIPUR,705,714,BHOPAL-UDAIPUR,1419,All
2024,10,BHOPAL,UDAIPUR,796,915,BHOPAL-UDAIPUR,1711,All
2024,11,BHOPAL,UDAIPUR,930,960,BHOPAL-UDAIPUR,1890,All
2024,12,BHOPAL,UDAIPUR,929,925,BHOPAL-UDAIPUR,1854,All
2025,1,BHOPAL,UDAIPUR,946,911,BHOPAL-UDAIPUR,1857,All
2025,2,BHOPAL,UDAIPUR,805,879,BHOPAL-UDAIPUR,1684,All
2019,11,BHOPAL,VARANASI,0,11,BHOPAL-VARANASI,11,All
2019,12,BHOPAL,VARANASI,0,20,BHOPAL-VARANASI,20,All
2020,1,BHOPAL,VARANASI,0,4,BHOPAL-VARANASI,4,All
2020,2,BHOPAL,VARANASI,0,2,BHOPAL-VARANASI,2,All
2020,3,BHOPAL,VARANASI,0,1,BHOPAL-VARANASI,1,All
2020,6,BHOPAL,VARANASI,0,1,BHOPAL-VARANASI,1,All
2020,8,BHOPAL,VARANASI,3,0,BHOPAL-VARANASI,3,All
2021,3,BHOPAL,VARANASI,113,0,BHOPAL-VARANASI,113,All
2018,3,BHUBANESWAR,AGARTALA,8,0,AGARTALA-BHUBANESWAR,8,All
2018,4,BHUBANESWAR,AGARTALA,70,0,AGARTALA-BHUBANESWAR,70,All
2018,5,BHUBANESWAR,AGARTALA,156,0,AGARTALA-BHUBANESWAR,156,All
2018,6,BHUBANESWAR,AGARTALA,21,0,AGARTALA-BHUBANESWAR,21,All
2019,3,BHUBANESWAR,AGARTALA,0,7,AGARTALA-BHUBANESWAR,7,All
2019,4,BHUBANESWAR,AGARTALA,0,26,AGARTALA-BHUBANESWAR,26,All
2015,4,BHUBANESWAR,BENGALURU,5493,6196,BENGALURU-BHUBANESWAR,11689,All
2015,5,BHUBANESWAR,BENGALURU,7869,6993,BENGALURU-BHUBANESWAR,14862,All
2015,6,BHUBANESWAR,BENGALURU,6573,6385,BENGALURU-BHUBANESWAR,12958,All
2015,7,BHUBANESWAR,BENGALURU,5683,5816,BENGALURU-BHUBANESWAR,11499,All
2015,8,BHUBANESWAR,BENGALURU,5858,5654,BENGALURU-BHUBANESWAR,11512,All
2015,9,BHUBANESWAR,BENGALURU,5706,5833,BENGALURU-BHUBANESWAR,11539,All
2015,10,BHUBANESWAR,BENGALURU,6781,6962,BENGALURU-BHUBANESWAR,13743,All
2015,11,BHUBANESWAR,BENGALURU,7082,7191,BENGALURU-BHUBANESWAR,14273,All
2015,12,BHUBANESWAR,BENGALURU,7851,8008,BENGALURU-BHUBANESWAR,15859,All
2016,1,BHUBANESWAR,BENGALURU,9575,9296,BENGALURU-BHUBANESWAR,18871,All
2016,2,BHUBANESWAR,BENGALURU,8805,8579,BENGALURU-BHUBANESWAR,17384,All
2016,3,BHUBANESWAR,BENGALURU,8638,8921,BENGALURU-BHUBANESWAR,17559,All
2016,4,BHUBANESWAR,BENGALURU,8058,9224,BENGALURU-BHUBANESWAR,17282,All
2016,5,BHUBANESWAR,BENGALURU,10372,8652,BENGALURU-BHUBANESWAR,19024,All
2016,6,BHUBANESWAR,BENGALURU,7886,9149,BENGALURU-BHUBANESWAR,17035,All
2016,7,BHUBANESWAR,BENGALURU,8719,8828,BENGALURU-BHUBANESWAR,17547,All
2016,8,BHUBANESWAR,BENGALURU,7769,7794,BENGALURU-BHUBANESWAR,15563,All
2016,9,BHUBANESWAR,BENGALURU,6841,7298,BENGALURU-BHUBANESWAR,14139,All
2016,10,BHUBANESWAR,BENGALURU,11930,14917,BENGALURU-BHUBANESWAR,26847,All
2016,11,BHUBANESWAR,BENGALURU,15813,14451,BENGALURU-BHUBANESWAR,30264,All
2016,12,BHUBANESWAR,BENGALURU,16678,16444,BENGALURU-BHUBANESWAR,33122,All
2017,1,BHUBANESWAR,BENGALURU,15038,14174,BENGALURU-BHUBANESWAR,29212,All
2017,2,BHUBANESWAR,BENGALURU,10733,9546,BENGALURU-BHUBANESWAR,20279,All
2017,3,BHUBANESWAR,BENGALURU,11752,9709,BENGALURU-BHUBANESWAR,21461,All
2017,4,BHUBANESWAR,BENGALURU,13257,11850,BENGALURU-BHUBANESWAR,25107,All
2017,5,BHUBANESWAR,BENGALURU,13156,11922,BENGALURU-BHUBANESWAR,25078,All
2017,6,BHUBANESWAR,BENGALURU,11482,12212,BENGALURU-BHUBANESWAR,23694,All
2017,7,BHUBANESWAR,BENGALURU,11470,10970,BENGALURU-BHUBANESWAR,22440,All
2017,8,BHUBANESWAR,BENGALURU,15719,17043,BENGALURU-BHUBANESWAR,32762,All
2017,9,BHUBANESWAR,BENGALURU,19763,22328,BENGALURU-BHUBANESWAR,42091,All
2017,10,BHUBANESWAR,BENGALURU,21780,23062,BENGALURU-BHUBANESWAR,44842,All
2017,11,BHUBANESWAR,BENGALURU,21506,22567,BENGALURU-BHUBANESWAR,44073,All
2017,12,BHUBANESWAR,BENGALURU,25341,25574,BENGALURU-BHUBANESWAR,50915,All
2018,1,BHUBANESWAR,BENGALURU,32063,31513,BENGALURU-BHUBANESWAR,63576,All
2018,2,BHUBANESWAR,BENGALURU,30154,32916,BENGALURU-BHUBANESWAR,63070,All
2018,3,BHUBANESWAR,BENGALURU,31290,30880,BENGALURU-BHUBANESWAR,62170,All
2018,4,BHUBANESWAR,BENGALURU,29223,34644,BENGALURU-BHUBANESWAR,63867,All
2018,5,BHUBANESWAR,BENGALURU,38941,31863,BENGALURU-BHUBANESWAR,70804,All
2018,6,BHUBANESWAR,BENGALURU,33958,28313,BENGALURU-BHUBANESWAR,62271,All
2018,7,BHUBANESWAR,BENGALURU,34609,26423,BENGALURU-BHUBANESWAR,61032,All
2018,8,BHUBANESWAR,BENGALURU,26507,29399,BENGALURU-BHUBANESWAR,55906,All
2018,9,BHUBANESWAR,BENGALURU,25816,28248,BENGALURU-BHUBANESWAR,54064,All
2018,10,BHUBANESWAR,BENGALURU,34751,37833,BENGALURU-BHUBANESWAR,72584,All
2018,11,BHUBANESWAR,BENGALURU,34906,34417,BENGALURU-BHUBANESWAR,69323,All
2018,12,BHUBANESWAR,BENGALURU,43407,44179,BENGALURU-BHUBANESWAR,87586,All
2019,1,BHUBANESWAR,BENGALURU,39346,40069,BENGALURU-BHUBANESWAR,79415,All
2019,2,BHUBANESWAR,BENGALURU,26181,26993,BENGALURU-BHUBANESWAR,53174,All
2019,3,BHUBANESWAR,BENGALURU,31454,33628,BENGALURU-BHUBANESWAR,65082,All
2019,4,BHUBANESWAR,BENGALURU,25996,30969,BENGALURU-BHUBANESWAR,56965,All
2022,3,BHUBANESWAR,CHANDIGARH,68,50,BHUBANESWAR-CHANDIGARH,118,All
2022,4,BHUBANESWAR,CHANDIGARH,640,494,BHUBANESWAR-CHANDIGARH,1134,All
2022,5,BHUBANESWAR,CHANDIGARH,979,735,BHUBANESWAR-CHANDIGARH,1714,All
2022,6,BHUBANESWAR,CHANDIGARH,1057,1026,BHUBANESWAR-CHANDIGARH,2083,All
2022,7,BHUBANESWAR,CHANDIGARH,765,590,BHUBANESWAR-CHANDIGARH,1355,All
2022,8,BHUBANESWAR,CHANDIGARH,683,680,BHUBANESWAR-CHANDIGARH,1363,All
2022,9,BHUBANESWAR,CHANDIGARH,567,539,BHUBANESWAR-CHANDIGARH,1106,All
2022,10,BHUBANESWAR,CHANDIGARH,513,567,BHUBANESWAR-CHANDIGARH,1080,All
2022,11,BHUBANESWAR,CHANDIGARH,682,761,BHUBANESWAR-CHANDIGARH,1443,All
2023,2,BHUBANESWAR,CHANDIGARH,249,288,BHUBANESWAR-CHANDIGARH,537,All
2023,3,BHUBANESWAR,CHANDIGARH,628,582,BHUBANESWAR-CHANDIGARH,1210,All
2023,4,BHUBANESWAR,CHANDIGARH,656,617,BHUBANESWAR-CHANDIGARH,1273,All
2023,5,BHUBANESWAR,CHANDIGARH,573,367,BHUBANESWAR-CHANDIGARH,940,All
2023,6,BHUBANESWAR,CHANDIGARH,207,225,BHUBANESWAR-CHANDIGARH,432,All
2023,7,BHUBANESWAR,CHANDIGARH,152,123,BHUBANESWAR-CHANDIGARH,275,All
2023,8,BHUBANESWAR,CHANDIGARH,96,103,BHUBANESWAR-CHANDIGARH,199,All
2023,9,BHUBANESWAR,CHANDIGARH,109,126,BHUBANESWAR-CHANDIGARH,235,All
2023,10,BHUBANESWAR,CHANDIGARH,427,250,BHUBANESWAR-CHANDIGARH,677,All
2023,11,BHUBANESWAR,CHANDIGARH,533,352,BHUBANESWAR-CHANDIGARH,885,All
2023,12,BHUBANESWAR,CHANDIGARH,410,339,BHUBANESWAR-CHANDIGARH,749,All
2024,2,BHUBANESWAR,CHANDIGARH,144,120,BHUBANESWAR-CHANDIGARH,264,All
2024,3,BHUBANESWAR,CHANDIGARH,830,938,BHUBANESWAR-CHANDIGARH,1768,All
2024,4,BHUBANESWAR,CHANDIGARH,657,491,BHUBANESWAR-CHANDIGARH,1148,All
2024,6,BHUBANESWAR,CHANDIGARH,1146,742,BHUBANESWAR-CHANDIGARH,1888,All
2024,7,BHUBANESWAR,CHANDIGARH,1005,681,BHUBANESWAR-CHANDIGARH,1686,All
2024,8,BHUBANESWAR,CHANDIGARH,894,701,BHUBANESWAR-CHANDIGARH,1595,All
2024,9,BHUBANESWAR,CHANDIGARH,935,703,BHUBANESWAR-CHANDIGARH,1638,All
2024,10,BHUBANESWAR,CHANDIGARH,516,331,BHUBANESWAR-CHANDIGARH,847,All
2024,11,BHUBANESWAR,CHANDIGARH,397,593,BHUBANESWAR-CHANDIGARH,990,All
2024,12,BHUBANESWAR,CHANDIGARH,382,383,BHUBANESWAR-CHANDIGARH,765,All
2025,3,BHUBANESWAR,CHANDIGARH,607,588,BHUBANESWAR-CHANDIGARH,1195,All
2015,4,BHUBANESWAR,CHENNAI,1589,1739,BHUBANESWAR-CHENNAI,3328,All
2015,5,BHUBANESWAR,CHENNAI,2214,2042,BHUBANESWAR-CHENNAI,4256,All
2015,6,BHUBANESWAR,CHENNAI,1924,1778,BHUBANESWAR-CHENNAI,3702,All
2015,7,BHUBANESWAR,CHENNAI,1861,1813,BHUBANESWAR-CHENNAI,3674,All
2015,8,BHUBANESWAR,CHENNAI,2068,2069,BHUBANESWAR-CHENNAI,4137,All
2015,9,BHUBANESWAR,CHENNAI,2096,2108,BHUBANESWAR-CHENNAI,4204,All
2015,10,BHUBANESWAR,CHENNAI,2485,2268,BHUBANESWAR-CHENNAI,4753,All
2015,11,BHUBANESWAR,CHENNAI,1994,2032,BHUBANESWAR-CHENNAI,4026,All
2015,12,BHUBANESWAR,CHENNAI,1935,1816,BHUBANESWAR-CHENNAI,3751,All
2016,1,BHUBANESWAR,CHENNAI,2491,2262,BHUBANESWAR-CHENNAI,4753,All
2016,2,BHUBANESWAR,CHENNAI,1999,1850,BHUBANESWAR-CHENNAI,3849,All
2016,3,BHUBANESWAR,CHENNAI,1974,1912,BHUBANESWAR-CHENNAI,3886,All
2016,4,BHUBANESWAR,CHENNAI,1744,1779,BHUBANESWAR-CHENNAI,3523,All
2016,5,BHUBANESWAR,CHENNAI,1982,1658,BHUBANESWAR-CHENNAI,3640,All
2016,6,BHUBANESWAR,CHENNAI,1900,1751,BHUBANESWAR-CHENNAI,3651,All
2016,7,BHUBANESWAR,CHENNAI,2031,1868,BHUBANESWAR-CHENNAI,3899,All
2016,8,BHUBANESWAR,CHENNAI,1970,1825,BHUBANESWAR-CHENNAI,3795,All
2016,9,BHUBANESWAR,CHENNAI,2110,1789,BHUBANESWAR-CHENNAI,3899,All
2016,10,BHUBANESWAR,CHENNAI,2232,1663,BHUBANESWAR-CHENNAI,3895,All
2016,11,BHUBANESWAR,CHENNAI,2647,2272,BHUBANESWAR-CHENNAI,4919,All
2016,12,BHUBANESWAR,CHENNAI,2968,2392,BHUBANESWAR-CHENNAI,5360,All
2017,1,BHUBANESWAR,CHENNAI,2731,2156,BHUBANESWAR-CHENNAI,4887,All
2017,2,BHUBANESWAR,CHENNAI,2170,1845,BHUBANESWAR-CHENNAI,4015,All
2017,3,BHUBANESWAR,CHENNAI,1660,1332,BHUBANESWAR-CHENNAI,2992,All
2017,4,BHUBANESWAR,CHENNAI,3882,4512,BHUBANESWAR-CHENNAI,8394,All
2017,5,BHUBANESWAR,CHENNAI,6063,4787,BHUBANESWAR-CHENNAI,10850,All
2017,6,BHUBANESWAR,CHENNAI,3886,3700,BHUBANESWAR-CHENNAI,7586,All
2017,7,BHUBANESWAR,CHENNAI,3995,3287,BHUBANESWAR-CHENNAI,7282,All
2017,8,BHUBANESWAR,CHENNAI,2018,1226,BHUBANESWAR-CHENNAI,3244,All
2017,9,BHUBANESWAR,CHENNAI,2102,1673,BHUBANESWAR-CHENNAI,3775,All
2017,10,BHUBANESWAR,CHENNAI,2574,1612,BHUBANESWAR-CHENNAI,4186,All
2017,11,BHUBANESWAR,CHENNAI,2570,2342,BHUBANESWAR-CHENNAI,4912,All
2017,12,BHUBANESWAR,CHENNAI,5760,5924,BHUBANESWAR-CHENNAI,11684,All
2018,1,BHUBANESWAR,CHENNAI,5420,5566,BHUBANESWAR-CHENNAI,10986,All
2018,2,BHUBANESWAR,CHENNAI,8102,9206,BHUBANESWAR-CHENNAI,17308,All
2018,3,BHUBANESWAR,CHENNAI,13429,13320,BHUBANESWAR-CHENNAI,26749,All
2018,4,BHUBANESWAR,CHENNAI,11725,13941,BHUBANESWAR-CHENNAI,25666,All
2018,5,BHUBANESWAR,CHENNAI,17526,14547,BHUBANESWAR-CHENNAI,32073,All
2018,6,BHUBANESWAR,CHENNAI,22604,21090,BHUBANESWAR-CHENNAI,43694,All
2018,7,BHUBANESWAR,CHENNAI,20292,18791,BHUBANESWAR-CHENNAI,39083,All
2018,8,BHUBANESWAR,CHENNAI,10307,10531,BHUBANESWAR-CHENNAI,20838,All
2018,9,BHUBANESWAR,CHENNAI,11367,11001,BHUBANESWAR-CHENNAI,22368,All
2018,10,BHUBANESWAR,CHENNAI,13417,13565,BHUBANESWAR-CHENNAI,26982,All
2018,11,BHUBANESWAR,CHENNAI,8724,9612,BHUBANESWAR-CHENNAI,18336,All
2018,12,BHUBANESWAR,CHENNAI,10233,10893,BHUBANESWAR-CHENNAI,21126,All
2019,1,BHUBANESWAR,CHENNAI,10448,10128,BHUBANESWAR-CHENNAI,20576,All
2019,2,BHUBANESWAR,CHENNAI,8313,8900,BHUBANESWAR-CHENNAI,17213,All
2019,3,BHUBANESWAR,CHENNAI,6810,8557,BHUBANESWAR-CHENNAI,15367,All
2019,4,BHUBANESWAR,CHENNAI,6471,8731,BHUBANESWAR-CHENNAI,15202,All
2019,5,BHUBANESWAR,CHENNAI,9934,8283,BHUBANESWAR-CHENNAI,18217,All
2019,6,BHUBANESWAR,CHENNAI,9623,8604,BHUBANESWAR-CHENNAI,18227,All
2019,7,BHUBANESWAR,CHENNAI,9471,7923,BHUBANESWAR-CHENNAI,17394,All
2019,8,BHUBANESWAR,CHENNAI,8027,8080,BHUBANESWAR-CHENNAI,16107,All
2019,9,BHUBANESWAR,CHENNAI,6599,7466,BHUBANESWAR-CHENNAI,14065,All
2019,10,BHUBANESWAR,CHENNAI,8249,8956,BHUBANESWAR-CHENNAI,17205,All
2019,11,BHUBANESWAR,CHENNAI,9108,8799,BHUBANESWAR-CHENNAI,17907,All
2019,12,BHUBANESWAR,CHENNAI,10666,10196,BHUBANESWAR-CHENNAI,20862,All
2020,1,BHUBANESWAR,CHENNAI,9707,9757,BHUBANESWAR-CHENNAI,19464,All
2020,2,BHUBANESWAR,CHENNAI,8796,8683,BHUBANESWAR-CHENNAI,17479,All
2020,3,BHUBANESWAR,CHENNAI,6111,7572,BHUBANESWAR-CHENNAI,13683,All
2020,5,BHUBANESWAR,CHENNAI,137,516,BHUBANESWAR-CHENNAI,653,All
2020,6,BHUBANESWAR,CHENNAI,903,2251,BHUBANESWAR-CHENNAI,3154,All
2020,7,BHUBANESWAR,CHENNAI,1403,5099,BHUBANESWAR-CHENNAI,6502,All
2020,8,BHUBANESWAR,CHENNAI,4186,3762,BHUBANESWAR-CHENNAI,7948,All
2020,9,BHUBANESWAR,CHENNAI,5167,3705,BHUBANESWAR-CHENNAI,8872,All
2020,10,BHUBANESWAR,CHENNAI,4773,3774,BHUBANESWAR-CHENNAI,8547,All
2020,11,BHUBANESWAR,CHENNAI,4783,4686,BHUBANESWAR-CHENNAI,9469,All
2020,12,BHUBANESWAR,CHENNAI,8603,6677,BHUBANESWAR-CHENNAI,15280,All
2021,1,BHUBANESWAR,CHENNAI,7671,6023,BHUBANESWAR-CHENNAI,13694,All
2021,2,BHUBANESWAR,CHENNAI,7253,6265,BHUBANESWAR-CHENNAI,13518,All
2021,3,BHUBANESWAR,CHENNAI,6478,6353,BHUBANESWAR-CHENNAI,12831,All
2021,4,BHUBANESWAR,CHENNAI,3767,4254,BHUBANESWAR-CHENNAI,8021,All
2021,6,BHUBANESWAR,CHENNAI,631,503,BHUBANESWAR-CHENNAI,1134,All
2021,7,BHUBANESWAR,CHENNAI,3543,2660,BHUBANESWAR-CHENNAI,6203,All
2021,8,BHUBANESWAR,CHENNAI,4093,3286,BHUBANESWAR-CHENNAI,7379,All
2021,9,BHUBANESWAR,CHENNAI,4152,3631,BHUBANESWAR-CHENNAI,7783,All
2021,10,BHUBANESWAR,CHENNAI,4554,4571,BHUBANESWAR-CHENNAI,9125,All
2021,11,BHUBANESWAR,CHENNAI,4004,4398,BHUBANESWAR-CHENNAI,8402,All
2021,12,BHUBANESWAR,CHENNAI,4628,4897,BHUBANESWAR-CHENNAI,9525,All
2022,1,BHUBANESWAR,CHENNAI,2619,2744,BHUBANESWAR-CHENNAI,5363,All
2022,2,BHUBANESWAR,CHENNAI,2406,2332,BHUBANESWAR-CHENNAI,4738,All
2022,3,BHUBANESWAR,CHENNAI,5305,4898,BHUBANESWAR-CHENNAI,10203,All
2022,4,BHUBANESWAR,CHENNAI,7640,8508,BHUBANESWAR-CHENNAI,16148,All
2022,5,BHUBANESWAR,CHENNAI,9219,7933,BHUBANESWAR-CHENNAI,17152,All
2022,6,BHUBANESWAR,CHENNAI,8843,8759,BHUBANESWAR-CHENNAI,17602,All
2022,7,BHUBANESWAR,CHENNAI,8101,8101,BHUBANESWAR-CHENNAI,16202,All
2022,8,BHUBANESWAR,CHENNAI,7857,7759,BHUBANESWAR-CHENNAI,15616,All
2022,9,BHUBANESWAR,CHENNAI,7570,7945,BHUBANESWAR-CHENNAI,15515,All
2022,10,BHUBANESWAR,CHENNAI,8069,7789,BHUBANESWAR-CHENNAI,15858,All
2022,11,BHUBANESWAR,CHENNAI,7561,6159,BHUBANESWAR-CHENNAI,13720,All
2022,12,BHUBANESWAR,CHENNAI,8522,7764,BHUBANESWAR-CHENNAI,16286,All
2023,1,BHUBANESWAR,CHENNAI,8286,7175,BHUBANESWAR-CHENNAI,15461,All
2023,2,BHUBANESWAR,CHENNAI,7308,7464,BHUBANESWAR-CHENNAI,14772,All
2023,3,BHUBANESWAR,CHENNAI,7072,7669,BHUBANESWAR-CHENNAI,14741,All
2023,4,BHUBANESWAR,CHENNAI,7926,9494,BHUBANESWAR-CHENNAI,17420,All
2023,5,BHUBANESWAR,CHENNAI,10248,9303,BHUBANESWAR-CHENNAI,19551,All
2023,6,BHUBANESWAR,CHENNAI,9471,9821,BHUBANESWAR-CHENNAI,19292,All
2023,7,BHUBANESWAR,CHENNAI,8780,8128,BHUBANESWAR-CHENNAI,16908,All
2023,8,BHUBANESWAR,CHENNAI,7008,7412,BHUBANESWAR-CHENNAI,14420,All
2023,9,BHUBANESWAR,CHENNAI,8308,9343,BHUBANESWAR-CHENNAI,17651,All
2023,10,BHUBANESWAR,CHENNAI,8097,9529,BHUBANESWAR-CHENNAI,17626,All
2023,11,BHUBANESWAR,CHENNAI,8219,9760,BHUBANESWAR-CHENNAI,17979,All
2023,12,BHUBANESWAR,CHENNAI,9562,9662,BHUBANESWAR-CHENNAI,19224,All
2024,1,BHUBANESWAR,CHENNAI,9926,9133,BHUBANESWAR-CHENNAI,19059,All
2024,2,BHUBANESWAR,CHENNAI,8515,8941,BHUBANESWAR-CHENNAI,17456,All
2024,3,BHUBANESWAR,CHENNAI,8345,9172,BHUBANESWAR-CHENNAI,17517,All
2024,4,BHUBANESWAR,CHENNAI,7325,9401,BHUBANESWAR-CHENNAI,16726,All
2024,6,BHUBANESWAR,CHENNAI,8191,8086,BHUBANESWAR-CHENNAI,16277,All
2024,7,BHUBANESWAR,CHENNAI,6009,5392,BHUBANESWAR-CHENNAI,11401,All
2024,8,BHUBANESWAR,CHENNAI,10779,9626,BHUBANESWAR-CHENNAI,20405,All
2024,9,BHUBANESWAR,CHENNAI,9639,11527,BHUBANESWAR-CHENNAI,21166,All
2024,10,BHUBANESWAR,CHENNAI,11195,14552,BHUBANESWAR-CHENNAI,25747,All
2024,11,BHUBANESWAR,CHENNAI,10861,10824,BHUBANESWAR-CHENNAI,21685,All
2024,12,BHUBANESWAR,CHENNAI,11873,11686,BHUBANESWAR-CHENNAI,23559,All
2025,1,BHUBANESWAR,CHENNAI,13632,13435,BHUBANESWAR-CHENNAI,27067,All
2025,2,BHUBANESWAR,CHENNAI,11432,13641,BHUBANESWAR-CHENNAI,25073,All
2025,3,BHUBANESWAR,CHENNAI,12015,13716,BHUBANESWAR-CHENNAI,25731,All
2015,4,BHUBANESWAR,COIMBATORE,266,286,BHUBANESWAR-COIMBATORE,552,All
2015,5,BHUBANESWAR,COIMBATORE,400,390,BHUBANESWAR-COIMBATORE,790,All
2015,6,BHUBANESWAR,COIMBATORE,336,318,BHUBANESWAR-COIMBATORE,654,All
2015,7,BHUBANESWAR,COIMBATORE,208,199,BHUBANESWAR-COIMBATORE,407,All
2015,8,BHUBANESWAR,COIMBATORE,297,265,BHUBANESWAR-COIMBATORE,562,All
2015,9,BHUBANESWAR,COIMBATORE,351,341,BHUBANESWAR-COIMBATORE,692,All
2015,10,BHUBANESWAR,COIMBATORE,501,580,BHUBANESWAR-COIMBATORE,1081,All
2015,11,BHUBANESWAR,COIMBATORE,313,362,BHUBANESWAR-COIMBATORE,675,All
2015,12,BHUBANESWAR,COIMBATORE,547,565,BHUBANESWAR-COIMBATORE,1112,All
2016,1,BHUBANESWAR,COIMBATORE,616,616,BHUBANESWAR-COIMBATORE,1232,All
2016,2,BHUBANESWAR,COIMBATORE,307,335,BHUBANESWAR-COIMBATORE,642,All
2016,3,BHUBANESWAR,COIMBATORE,304,322,BHUBANESWAR-COIMBATORE,626,All
2016,4,BHUBANESWAR,COIMBATORE,348,399,BHUBANESWAR-COIMBATORE,747,All
2016,5,BHUBANESWAR,COIMBATORE,386,365,BHUBANESWAR-COIMBATORE,751,All
2016,6,BHUBANESWAR,COIMBATORE,482,497,BHUBANESWAR-COIMBATORE,979,All
2016,7,BHUBANESWAR,COIMBATORE,349,345,BHUBANESWAR-COIMBATORE,694,All
2016,8,BHUBANESWAR,COIMBATORE,314,285,BHUBANESWAR-COIMBATORE,599,All
2016,9,BHUBANESWAR,COIMBATORE,261,279,BHUBANESWAR-COIMBATORE,540,All
2016,10,BHUBANESWAR,COIMBATORE,435,405,BHUBANESWAR-COIMBATORE,840,All
2016,11,BHUBANESWAR,COIMBATORE,229,241,BHUBANESWAR-COIMBATORE,470,All
2016,12,BHUBANESWAR,COIMBATORE,393,346,BHUBANESWAR-COIMBATORE,739,All
2017,1,BHUBANESWAR,COIMBATORE,391,256,BHUBANESWAR-COIMBATORE,647,All
2017,2,BHUBANESWAR,COIMBATORE,254,258,BHUBANESWAR-COIMBATORE,512,All
2017,3,BHUBANESWAR,COIMBATORE,423,299,BHUBANESWAR-COIMBATORE,722,All
2017,4,BHUBANESWAR,COIMBATORE,315,224,BHUBANESWAR-COIMBATORE,539,All
2017,5,BHUBANESWAR,COIMBATORE,318,269,BHUBANESWAR-COIMBATORE,587,All
2017,6,BHUBANESWAR,COIMBATORE,340,383,BHUBANESWAR-COIMBATORE,723,All
2017,7,BHUBANESWAR,COIMBATORE,303,304,BHUBANESWAR-COIMBATORE,607,All
2017,8,BHUBANESWAR,COIMBATORE,270,212,BHUBANESWAR-COIMBATORE,482,All
2017,9,BHUBANESWAR,COIMBATORE,306,212,BHUBANESWAR-COIMBATORE,518,All
2017,10,BHUBANESWAR,COIMBATORE,242,301,BHUBANESWAR-COIMBATORE,543,All
2017,11,BHUBANESWAR,COIMBATORE,198,225,BHUBANESWAR-COIMBATORE,423,All
2017,12,BHUBANESWAR,COIMBATORE,157,283,BHUBANESWAR-COIMBATORE,440,All
2018,1,BHUBANESWAR,COIMBATORE,259,341,BHUBANESWAR-COIMBATORE,600,All
2018,2,BHUBANESWAR,COIMBATORE,184,238,BHUBANESWAR-COIMBATORE,422,All
2018,3,BHUBANESWAR,COIMBATORE,251,144,BHUBANESWAR-COIMBATORE,395,All
2018,4,BHUBANESWAR,COIMBATORE,247,228,BHUBANESWAR-COIMBATORE,475,All
2018,5,BHUBANESWAR,COIMBATORE,407,198,BHUBANESWAR-COIMBATORE,605,All
2018,6,BHUBANESWAR,COIMBATORE,419,387,BHUBANESWAR-COIMBATORE,806,All
2018,7,BHUBANESWAR,COIMBATORE,322,262,BHUBANESWAR-COIMBATORE,584,All
2018,8,BHUBANESWAR,COIMBATORE,286,188,BHUBANESWAR-COIMBATORE,474,All
2018,9,BHUBANESWAR,COIMBATORE,412,132,BHUBANESWAR-COIMBATORE,544,All
2018,10,BHUBANESWAR,COIMBATORE,355,194,BHUBANESWAR-COIMBATORE,549,All
2018,11,BHUBANESWAR,COIMBATORE,471,93,BHUBANESWAR-COIMBATORE,564,All
2018,12,BHUBANESWAR,COIMBATORE,404,123,BHUBANESWAR-COIMBATORE,527,All
2019,1,BHUBANESWAR,COIMBATORE,417,75,BHUBANESWAR-COIMBATORE,492,All
2019,2,BHUBANESWAR,COIMBATORE,259,94,BHUBANESWAR-COIMBATORE,353,All
2019,3,BHUBANESWAR,COIMBATORE,304,48,BHUBANESWAR-COIMBATORE,352,All
2019,4,BHUBANESWAR,COIMBATORE,190,73,BHUBANESWAR-COIMBATORE,263,All
2019,5,BHUBANESWAR,COIMBATORE,179,69,BHUBANESWAR-COIMBATORE,248,All
2019,6,BHUBANESWAR,COIMBATORE,299,149,BHUBANESWAR-COIMBATORE,448,All
2019,7,BHUBANESWAR,COIMBATORE,123,48,BHUBANESWAR-COIMBATORE,171,All
2019,8,BHUBANESWAR,COIMBATORE,118,50,BHUBANESWAR-COIMBATORE,168,All
2019,9,BHUBANESWAR,COIMBATORE,72,61,BHUBANESWAR-COIMBATORE,133,All
2019,10,BHUBANESWAR,COIMBATORE,221,122,BHUBANESWAR-COIMBATORE,343,All
2019,11,BHUBANESWAR,COIMBATORE,69,50,BHUBANESWAR-COIMBATORE,119,All
2019,12,BHUBANESWAR,COIMBATORE,66,69,BHUBANESWAR-COIMBATORE,135,All
2020,1,BHUBANESWAR,COIMBATORE,54,24,BHUBANESWAR-COIMBATORE,78,All
2020,2,BHUBANESWAR,COIMBATORE,25,22,BHUBANESWAR-COIMBATORE,47,All
2020,3,BHUBANESWAR,COIMBATORE,24,72,BHUBANESWAR-COIMBATORE,96,All
2021,3,BHUBANESWAR,DABOLIM,11,48,BHUBANESWAR-DABOLIM,59,All
2021,4,BHUBANESWAR,DABOLIM,191,217,BHUBANESWAR-DABOLIM,408,All
2021,6,BHUBANESWAR,DABOLIM,0,164,BHUBANESWAR-DABOLIM,164,All
2021,7,BHUBANESWAR,DABOLIM,344,0,BHUBANESWAR-DABOLIM,344,All
2021,12,BHUBANESWAR,DABOLIM,3825,3074,BHUBANESWAR-DABOLIM,6899,All
2022,1,BHUBANESWAR,DABOLIM,515,1264,BHUBANESWAR-DABOLIM,1779,All
2023,1,BHUBANESWAR,DABOLIM,0,3,BHUBANESWAR-DABOLIM,3,All
2022,4,BHUBANESWAR,DEHRA DUN,0,59,BHUBANESWAR-DEHRA DUN,59,All
2022,5,BHUBANESWAR,DEHRA DUN,0,67,BHUBANESWAR-DEHRA DUN,67,All
2022,6,BHUBANESWAR,DEHRA DUN,0,101,BHUBANESWAR-DEHRA DUN,101,All
2022,7,BHUBANESWAR,DEHRA DUN,0,99,BHUBANESWAR-DEHRA DUN,99,All
2022,8,BHUBANESWAR,DEHRA DUN,0,41,BHUBANESWAR-DEHRA DUN,41,All
2022,9,BHUBANESWAR,DEHRA DUN,0,78,BHUBANESWAR-DEHRA DUN,78,All
2022,10,BHUBANESWAR,DEHRA DUN,0,107,BHUBANESWAR-DEHRA DUN,107,All
2015,4,BHUBANESWAR,DELHI,23076,24982,BHUBANESWAR-DELHI,48058,All
2015,5,BHUBANESWAR,DELHI,23026,24047,BHUBANESWAR-DELHI,47073,All
2015,6,BHUBANESWAR,DELHI,23017,24418,BHUBANESWAR-DELHI,47435,All
2015,7,BHUBANESWAR,DELHI,23238,24302,BHUBANESWAR-DELHI,47540,All
2015,8,BHUBANESWAR,DELHI,23904,23728,BHUBANESWAR-DELHI,47632,All
2015,9,BHUBANESWAR,DELHI,22920,23867,BHUBANESWAR-DELHI,46787,All
2015,10,BHUBANESWAR,DELHI,22727,19780,BHUBANESWAR-DELHI,42507,All
2015,11,BHUBANESWAR,DELHI,29275,32839,BHUBANESWAR-DELHI,62114,All
2015,12,BHUBANESWAR,DELHI,32723,36751,BHUBANESWAR-DELHI,69474,All
2016,1,BHUBANESWAR,DELHI,33497,31407,BHUBANESWAR-DELHI,64904,All
2016,2,BHUBANESWAR,DELHI,30420,29553,BHUBANESWAR-DELHI,59973,All
2016,3,BHUBANESWAR,DELHI,32006,33198,BHUBANESWAR-DELHI,65204,All
2016,4,BHUBANESWAR,DELHI,28422,30276,BHUBANESWAR-DELHI,58698,All
2016,5,BHUBANESWAR,DELHI,31346,32386,BHUBANESWAR-DELHI,63732,All
2016,6,BHUBANESWAR,DELHI,28072,31782,BHUBANESWAR-DELHI,59854,All
2016,7,BHUBANESWAR,DELHI,29134,30042,BHUBANESWAR-DELHI,59176,All
2016,8,BHUBANESWAR,DELHI,28957,28654,BHUBANESWAR-DELHI,57611,All
2016,9,BHUBANESWAR,DELHI,29778,29888,BHUBANESWAR-DELHI,59666,All
2016,10,BHUBANESWAR,DELHI,33729,37107,BHUBANESWAR-DELHI,70836,All
2016,11,BHUBANESWAR,DELHI,35116,36581,BHUBANESWAR-DELHI,71697,All
2016,12,BHUBANESWAR,DELHI,42914,47816,BHUBANESWAR-DELHI,90730,All
2017,1,BHUBANESWAR,DELHI,43968,42993,BHUBANESWAR-DELHI,86961,All
2017,2,BHUBANESWAR,DELHI,36636,36745,BHUBANESWAR-DELHI,73381,All
2017,3,BHUBANESWAR,DELHI,37793,38525,BHUBANESWAR-DELHI,76318,All
2017,4,BHUBANESWAR,DELHI,37619,38362,BHUBANESWAR-DELHI,75981,All
2017,5,BHUBANESWAR,DELHI,43257,44158,BHUBANESWAR-DELHI,87415,All
2017,6,BHUBANESWAR,DELHI,40292,45240,BHUBANESWAR-DELHI,85532,All
2017,7,BHUBANESWAR,DELHI,38167,36305,BHUBANESWAR-DELHI,74472,All
2017,8,BHUBANESWAR,DELHI,36663,36880,BHUBANESWAR-DELHI,73543,All
2017,9,BHUBANESWAR,DELHI,37300,36876,BHUBANESWAR-DELHI,74176,All
2017,10,BHUBANESWAR,DELHI,42458,45823,BHUBANESWAR-DELHI,88281,All
2017,11,BHUBANESWAR,DELHI,39488,42084,BHUBANESWAR-DELHI,81572,All
2017,12,BHUBANESWAR,DELHI,42343,45850,BHUBANESWAR-DELHI,88193,All
2018,1,BHUBANESWAR,DELHI,45273,44378,BHUBANESWAR-DELHI,89651,All
2018,2,BHUBANESWAR,DELHI,41592,42859,BHUBANESWAR-DELHI,84451,All
2018,3,BHUBANESWAR,DELHI,46690,48203,BHUBANESWAR-DELHI,94893,All
2018,4,BHUBANESWAR,DELHI,43321,43657,BHUBANESWAR-DELHI,86978,All
2018,5,BHUBANESWAR,DELHI,46491,45831,BHUBANESWAR-DELHI,92322,All
2018,6,BHUBANESWAR,DELHI,46321,51584,BHUBANESWAR-DELHI,97905,All
2018,7,BHUBANESWAR,DELHI,50261,49358,BHUBANESWAR-DELHI,99619,All
2018,8,BHUBANESWAR,DELHI,44993,46560,BHUBANESWAR-DELHI,91553,All
2018,9,BHUBANESWAR,DELHI,45997,46307,BHUBANESWAR-DELHI,92304,All
2018,10,BHUBANESWAR,DELHI,45587,46806,BHUBANESWAR-DELHI,92393,All
2018,11,BHUBANESWAR,DELHI,38433,42833,BHUBANESWAR-DELHI,81266,All
2018,12,BHUBANESWAR,DELHI,42225,47192,BHUBANESWAR-DELHI,89417,All
2019,1,BHUBANESWAR,DELHI,45860,44400,BHUBANESWAR-DELHI,90260,All
2019,2,BHUBANESWAR,DELHI,45892,45414,BHUBANESWAR-DELHI,91306,All
2019,3,BHUBANESWAR,DELHI,47899,49552,BHUBANESWAR-DELHI,97451,All
2019,4,BHUBANESWAR,DELHI,41932,43395,BHUBANESWAR-DELHI,85327,All
2019,5,BHUBANESWAR,DELHI,51115,54490,BHUBANESWAR-DELHI,105605,All
2019,6,BHUBANESWAR,DELHI,53731,57274,BHUBANESWAR-DELHI,111005,All
2019,7,BHUBANESWAR,DELHI,53085,52228,BHUBANESWAR-DELHI,105313,All
2019,8,BHUBANESWAR,DELHI,48951,53309,BHUBANESWAR-DELHI,102260,All
2019,9,BHUBANESWAR,DELHI,50357,52285,BHUBANESWAR-DELHI,102642,All
2019,10,BHUBANESWAR,DELHI,46076,51094,BHUBANESWAR-DELHI,97170,All
2019,11,BHUBANESWAR,DELHI,44686,47215,BHUBANESWAR-DELHI,91901,All
2019,12,BHUBANESWAR,DELHI,45639,48862,BHUBANESWAR-DELHI,94501,All
2020,1,BHUBANESWAR,DELHI,46688,45887,BHUBANESWAR-DELHI,92575,All
2020,2,BHUBANESWAR,DELHI,44085,45340,BHUBANESWAR-DELHI,89425,All
2020,3,BHUBANESWAR,DELHI,26637,29178,BHUBANESWAR-DELHI,55815,All
2020,5,BHUBANESWAR,DELHI,1300,2552,BHUBANESWAR-DELHI,3852,All
2020,6,BHUBANESWAR,DELHI,7103,17898,BHUBANESWAR-DELHI,25001,All
2020,7,BHUBANESWAR,DELHI,8437,11183,BHUBANESWAR-DELHI,19620,All
2020,8,BHUBANESWAR,DELHI,16810,12409,BHUBANESWAR-DELHI,29219,All
2020,9,BHUBANESWAR,DELHI,26668,15536,BHUBANESWAR-DELHI,42204,All
2020,10,BHUBANESWAR,DELHI,23824,22329,BHUBANESWAR-DELHI,46153,All
2020,11,BHUBANESWAR,DELHI,22579,29001,BHUBANESWAR-DELHI,51580,All
2020,12,BHUBANESWAR,DELHI,25896,32971,BHUBANESWAR-DELHI,58867,All
2021,1,BHUBANESWAR,DELHI,29861,28644,BHUBANESWAR-DELHI,58505,All
2021,2,BHUBANESWAR,DELHI,32524,32991,BHUBANESWAR-DELHI,65515,All
2021,3,BHUBANESWAR,DELHI,34101,32016,BHUBANESWAR-DELHI,66117,All
2021,4,BHUBANESWAR,DELHI,20934,23550,BHUBANESWAR-DELHI,44484,All
2021,6,BHUBANESWAR,DELHI,11567,11492,BHUBANESWAR-DELHI,23059,All
2021,7,BHUBANESWAR,DELHI,17878,17921,BHUBANESWAR-DELHI,35799,All
2021,8,BHUBANESWAR,DELHI,24627,25703,BHUBANESWAR-DELHI,50330,All
2021,9,BHUBANESWAR,DELHI,28384,29657,BHUBANESWAR-DELHI,58041,All
2021,10,BHUBANESWAR,DELHI,35718,37229,BHUBANESWAR-DELHI,72947,All
2021,11,BHUBANESWAR,DELHI,39649,42543,BHUBANESWAR-DELHI,82192,All
2021,12,BHUBANESWAR,DELHI,44019,46697,BHUBANESWAR-DELHI,90716,All
2022,1,BHUBANESWAR,DELHI,25703,24595,BHUBANESWAR-DELHI,50298,All
2022,2,BHUBANESWAR,DELHI,35269,35819,BHUBANESWAR-DELHI,71088,All
2022,3,BHUBANESWAR,DELHI,45822,44728,BHUBANESWAR-DELHI,90550,All
2022,4,BHUBANESWAR,DELHI,39496,40408,BHUBANESWAR-DELHI,79904,All
2022,5,BHUBANESWAR,DELHI,36976,38311,BHUBANESWAR-DELHI,75287,All
2022,6,BHUBANESWAR,DELHI,37873,42824,BHUBANESWAR-DELHI,80697,All
2022,7,BHUBANESWAR,DELHI,34837,33591,BHUBANESWAR-DELHI,68428,All
2022,8,BHUBANESWAR,DELHI,35262,34961,BHUBANESWAR-DELHI,70223,All
2022,9,BHUBANESWAR,DELHI,37829,37847,BHUBANESWAR-DELHI,75676,All
2022,10,BHUBANESWAR,DELHI,41234,45659,BHUBANESWAR-DELHI,86893,All
2022,11,BHUBANESWAR,DELHI,44233,48800,BHUBANESWAR-DELHI,93033,All
2022,12,BHUBANESWAR,DELHI,52356,55950,BHUBANESWAR-DELHI,108306,All
2023,1,BHUBANESWAR,DELHI,50312,49042,BHUBANESWAR-DELHI,99354,All
2023,2,BHUBANESWAR,DELHI,49311,47850,BHUBANESWAR-DELHI,97161,All
2023,3,BHUBANESWAR,DELHI,53131,52237,BHUBANESWAR-DELHI,105368,All
2023,4,BHUBANESWAR,DELHI,53830,50419,BHUBANESWAR-DELHI,104249,All
2023,5,BHUBANESWAR,DELHI,54600,55175,BHUBANESWAR-DELHI,109775,All
2023,6,BHUBANESWAR,DELHI,48877,52156,BHUBANESWAR-DELHI,101033,All
2023,7,BHUBANESWAR,DELHI,45395,41675,BHUBANESWAR-DELHI,87070,All
2023,8,BHUBANESWAR,DELHI,45674,45925,BHUBANESWAR-DELHI,91599,All
2023,9,BHUBANESWAR,DELHI,44875,46449,BHUBANESWAR-DELHI,91324,All
2023,10,BHUBANESWAR,DELHI,49074,50065,BHUBANESWAR-DELHI,99139,All
2023,11,BHUBANESWAR,DELHI,46997,51914,BHUBANESWAR-DELHI,98911,All
2023,12,BHUBANESWAR,DELHI,51226,52796,BHUBANESWAR-DELHI,104022,All
2024,1,BHUBANESWAR,DELHI,48161,47695,BHUBANESWAR-DELHI,95856,All
2024,2,BHUBANESWAR,DELHI,49254,48071,BHUBANESWAR-DELHI,97325,All
2024,3,BHUBANESWAR,DELHI,51325,51180,BHUBANESWAR-DELHI,102505,All
2024,4,BHUBANESWAR,DELHI,46402,47169,BHUBANESWAR-DELHI,93571,All
2024,6,BHUBANESWAR,DELHI,44484,48199,BHUBANESWAR-DELHI,92683,All
2024,7,BHUBANESWAR,DELHI,39111,40905,BHUBANESWAR-DELHI,80016,All
2024,8,BHUBANESWAR,DELHI,44769,46498,BHUBANESWAR-DELHI,91267,All
2024,9,BHUBANESWAR,DELHI,43113,44641,BHUBANESWAR-DELHI,87754,All
2024,10,BHUBANESWAR,DELHI,46137,50646,BHUBANESWAR-DELHI,96783,All
2024,11,BHUBANESWAR,DELHI,46993,48869,BHUBANESWAR-DELHI,95862,All
2024,12,BHUBANESWAR,DELHI,49836,51798,BHUBANESWAR-DELHI,101634,All
2025,1,BHUBANESWAR,DELHI,48812,48712,BHUBANESWAR-DELHI,97524,All
2025,2,BHUBANESWAR,DELHI,48139,47509,BHUBANESWAR-DELHI,95648,All
2025,3,BHUBANESWAR,DELHI,49345,50661,BHUBANESWAR-DELHI,100006,All
2021,7,BHUBANESWAR,DIBRUGARH,0,17,BHUBANESWAR-DIBRUGARH,17,All
2021,6,BHUBANESWAR,DIMAPUR,0,7,BHUBANESWAR-DIMAPUR,7,All
2024,8,BHUBANESWAR,DURGAPUR,38,60,BHUBANESWAR-DURGAPUR,98,All
2024,9,BHUBANESWAR,DURGAPUR,807,879,BHUBANESWAR-DURGAPUR,1686,All
2024,10,BHUBANESWAR,DURGAPUR,857,617,BHUBANESWAR-DURGAPUR,1474,All
2024,11,BHUBANESWAR,DURGAPUR,744,1131,BHUBANESWAR-DURGAPUR,1875,All
2024,12,BHUBANESWAR,DURGAPUR,903,835,BHUBANESWAR-DURGAPUR,1738,All
2025,1,BHUBANESWAR,DURGAPUR,744,751,BHUBANESWAR-DURGAPUR,1495,All
2025,2,BHUBANESWAR,DURGAPUR,998,642,BHUBANESWAR-DURGAPUR,1640,All
2025,3,BHUBANESWAR,DURGAPUR,704,691,BHUBANESWAR-DURGAPUR,1395,All
2025,2,BHUBANESWAR,DehraDun,1019,1081,BHUBANESWAR-DehraDun,2100,All
2025,3,BHUBANESWAR,DehraDun,1392,1530,BHUBANESWAR-DehraDun,2922,All
2018,6,BHUBANESWAR,GUWAHATI,207,0,BHUBANESWAR-GUWAHATI,207,All
2018,7,BHUBANESWAR,GUWAHATI,453,0,BHUBANESWAR-GUWAHATI,453,All
2018,8,BHUBANESWAR,GUWAHATI,474,0,BHUBANESWAR-GUWAHATI,474,All
2018,9,BHUBANESWAR,GUWAHATI,637,0,BHUBANESWAR-GUWAHATI,637,All
2018,10,BHUBANESWAR,GUWAHATI,1016,437,BHUBANESWAR-GUWAHATI,1453,All
2018,11,BHUBANESWAR,GUWAHATI,4017,3467,BHUBANESWAR-GUWAHATI,7484,All
2018,12,BHUBANESWAR,GUWAHATI,6508,5046,BHUBANESWAR-GUWAHATI,11554,All
2019,1,BHUBANESWAR,GUWAHATI,5852,4502,BHUBANESWAR-GUWAHATI,10354,All
2019,2,BHUBANESWAR,GUWAHATI,3926,3061,BHUBANESWAR-GUWAHATI,6987,All
2019,3,BHUBANESWAR,GUWAHATI,5312,3738,BHUBANESWAR-GUWAHATI,9050,All
2019,4,BHUBANESWAR,GUWAHATI,5605,3642,BHUBANESWAR-GUWAHATI,9247,All
2019,5,BHUBANESWAR,GUWAHATI,5360,4239,BHUBANESWAR-GUWAHATI,9599,All
2019,6,BHUBANESWAR,GUWAHATI,4541,4603,BHUBANESWAR-GUWAHATI,9144,All
2019,7,BHUBANESWAR,GUWAHATI,5420,4836,BHUBANESWAR-GUWAHATI,10256,All
2019,8,BHUBANESWAR,GUWAHATI,3617,3730,BHUBANESWAR-GUWAHATI,7347,All
2019,9,BHUBANESWAR,GUWAHATI,3142,1916,BHUBANESWAR-GUWAHATI,5058,All
2019,10,BHUBANESWAR,GUWAHATI,4767,4308,BHUBANESWAR-GUWAHATI,9075,All
2019,11,BHUBANESWAR,GUWAHATI,4591,4515,BHUBANESWAR-GUWAHATI,9106,All
2019,12,BHUBANESWAR,GUWAHATI,5491,4304,BHUBANESWAR-GUWAHATI,9795,All
2020,1,BHUBANESWAR,GUWAHATI,5565,4948,BHUBANESWAR-GUWAHATI,10513,All
2020,2,BHUBANESWAR,GUWAHATI,4971,4233,BHUBANESWAR-GUWAHATI,9204,All
2020,3,BHUBANESWAR,GUWAHATI,3695,2780,BHUBANESWAR-GUWAHATI,6475,All
2020,6,BHUBANESWAR,GUWAHATI,0,93,BHUBANESWAR-GUWAHATI,93,All
2021,6,BHUBANESWAR,GUWAHATI,0,32,BHUBANESWAR-GUWAHATI,32,All
2021,10,BHUBANESWAR,GUWAHATI,29,0,BHUBANESWAR-GUWAHATI,29,All
2021,11,BHUBANESWAR,GUWAHATI,556,0,BHUBANESWAR-GUWAHATI,556,All
2021,12,BHUBANESWAR,GUWAHATI,309,0,BHUBANESWAR-GUWAHATI,309,All
2023,1,BHUBANESWAR,GUWAHATI,0,35,BHUBANESWAR-GUWAHATI,35,All
2023,4,BHUBANESWAR,GUWAHATI,0,18,BHUBANESWAR-GUWAHATI,18,All
2023,5,BHUBANESWAR,GUWAHATI,0,21,BHUBANESWAR-GUWAHATI,21,All
2023,9,BHUBANESWAR,GUWAHATI,0,20,BHUBANESWAR-GUWAHATI,20,All
2023,10,BHUBANESWAR,GUWAHATI,441,472,BHUBANESWAR-GUWAHATI,913,All
2023,11,BHUBANESWAR,GUWAHATI,4746,4486,BHUBANESWAR-GUWAHATI,9232,All
2023,12,BHUBANESWAR,GUWAHATI,4910,5024,BHUBANESWAR-GUWAHATI,9934,All
2024,1,BHUBANESWAR,GUWAHATI,5135,5056,BHUBANESWAR-GUWAHATI,10191,All
2024,2,BHUBANESWAR,GUWAHATI,4536,4171,BHUBANESWAR-GUWAHATI,8707,All
2024,3,BHUBANESWAR,GUWAHATI,5139,4735,BHUBANESWAR-GUWAHATI,9874,All
2024,4,BHUBANESWAR,GUWAHATI,4219,3647,BHUBANESWAR-GUWAHATI,7866,All
2024,6,BHUBANESWAR,GUWAHATI,4125,3781,BHUBANESWAR-GUWAHATI,7906,All
2024,7,BHUBANESWAR,GUWAHATI,3987,3933,BHUBANESWAR-GUWAHATI,7920,All
2024,8,BHUBANESWAR,GUWAHATI,3640,3040,BHUBANESWAR-GUWAHATI,6680,All
2024,9,BHUBANESWAR,GUWAHATI,3099,2602,BHUBANESWAR-GUWAHATI,5701,All
2024,10,BHUBANESWAR,GUWAHATI,4875,4718,BHUBANESWAR-GUWAHATI,9593,All
2024,11,BHUBANESWAR,GUWAHATI,4850,4814,BHUBANESWAR-GUWAHATI,9664,All
2024,12,BHUBANESWAR,GUWAHATI,5139,5011,BHUBANESWAR-GUWAHATI,10150,All
2025,1,BHUBANESWAR,GUWAHATI,5178,5065,BHUBANESWAR-GUWAHATI,10243,All
2025,2,BHUBANESWAR,GUWAHATI,4062,3564,BHUBANESWAR-GUWAHATI,7626,All
2025,3,BHUBANESWAR,GUWAHATI,5396,5152,BHUBANESWAR-GUWAHATI,10548,All
2023,11,BHUBANESWAR,Goa,2711,2913,BHUBANESWAR-Goa,5624,All
2023,12,BHUBANESWAR,Goa,3031,2966,BHUBANESWAR-Goa,5997,All
2024,1,BHUBANESWAR,Goa,1564,1653,BHUBANESWAR-Goa,3217,All
2025,3,BHUBANESWAR,HINDON AIRPORT,293,227,BHUBANESWAR-HINDON AIRPORT,520,All
2015,4,BHUBANESWAR,HYDERABAD,6505,6955,BHUBANESWAR-HYDERABAD,13460,All
2015,5,BHUBANESWAR,HYDERABAD,7538,7541,BHUBANESWAR-HYDERABAD,15079,All
2015,6,BHUBANESWAR,HYDERABAD,7067,6624,BHUBANESWAR-HYDERABAD,13691,All
2015,7,BHUBANESWAR,HYDERABAD,6634,6519,BHUBANESWAR-HYDERABAD,13153,All
2015,8,BHUBANESWAR,HYDERABAD,6751,6369,BHUBANESWAR-HYDERABAD,13120,All
2015,9,BHUBANESWAR,HYDERABAD,5797,5822,BHUBANESWAR-HYDERABAD,11619,All
2015,10,BHUBANESWAR,HYDERABAD,6906,7379,BHUBANESWAR-HYDERABAD,14285,All
2015,11,BHUBANESWAR,HYDERABAD,5855,6248,BHUBANESWAR-HYDERABAD,12103,All
2015,12,BHUBANESWAR,HYDERABAD,6711,6797,BHUBANESWAR-HYDERABAD,13508,All
2016,1,BHUBANESWAR,HYDERABAD,7004,7124,BHUBANESWAR-HYDERABAD,14128,All
2016,2,BHUBANESWAR,HYDERABAD,6172,6123,BHUBANESWAR-HYDERABAD,12295,All
2016,3,BHUBANESWAR,HYDERABAD,6210,6873,BHUBANESWAR-HYDERABAD,13083,All
2016,4,BHUBANESWAR,HYDERABAD,6705,6553,BHUBANESWAR-HYDERABAD,13258,All
2016,5,BHUBANESWAR,HYDERABAD,7005,6005,BHUBANESWAR-HYDERABAD,13010,All
2016,6,BHUBANESWAR,HYDERABAD,6672,5774,BHUBANESWAR-HYDERABAD,12446,All
2016,7,BHUBANESWAR,HYDERABAD,7178,6214,BHUBANESWAR-HYDERABAD,13392,All
2016,8,BHUBANESWAR,HYDERABAD,6687,6124,BHUBANESWAR-HYDERABAD,12811,All
2016,9,BHUBANESWAR,HYDERABAD,6172,6312,BHUBANESWAR-HYDERABAD,12484,All
2016,10,BHUBANESWAR,HYDERABAD,7331,7883,BHUBANESWAR-HYDERABAD,15214,All
2016,11,BHUBANESWAR,HYDERABAD,9071,9503,BHUBANESWAR-HYDERABAD,18574,All
2016,12,BHUBANESWAR,HYDERABAD,15489,16168,BHUBANESWAR-HYDERABAD,31657,All
2017,1,BHUBANESWAR,HYDERABAD,21074,23403,BHUBANESWAR-HYDERABAD,44477,All
2017,2,BHUBANESWAR,HYDERABAD,19644,21261,BHUBANESWAR-HYDERABAD,40905,All
2017,3,BHUBANESWAR,HYDERABAD,21941,24537,BHUBANESWAR-HYDERABAD,46478,All
2017,4,BHUBANESWAR,HYDERABAD,21998,26488,BHUBANESWAR-HYDERABAD,48486,All
2017,5,BHUBANESWAR,HYDERABAD,18872,18143,BHUBANESWAR-HYDERABAD,37015,All
2017,6,BHUBANESWAR,HYDERABAD,19141,18417,BHUBANESWAR-HYDERABAD,37558,All
2017,7,BHUBANESWAR,HYDERABAD,17214,13196,BHUBANESWAR-HYDERABAD,30410,All
2017,8,BHUBANESWAR,HYDERABAD,13343,12764,BHUBANESWAR-HYDERABAD,26107,All
2017,9,BHUBANESWAR,HYDERABAD,12782,13099,BHUBANESWAR-HYDERABAD,25881,All
2017,10,BHUBANESWAR,HYDERABAD,19799,18858,BHUBANESWAR-HYDERABAD,38657,All
2017,11,BHUBANESWAR,HYDERABAD,24411,22877,BHUBANESWAR-HYDERABAD,47288,All
2017,12,BHUBANESWAR,HYDERABAD,23489,22337,BHUBANESWAR-HYDERABAD,45826,All
2018,1,BHUBANESWAR,HYDERABAD,28225,30043,BHUBANESWAR-HYDERABAD,58268,All
2018,2,BHUBANESWAR,HYDERABAD,24603,25252,BHUBANESWAR-HYDERABAD,49855,All
2018,3,BHUBANESWAR,HYDERABAD,25446,23752,BHUBANESWAR-HYDERABAD,49198,All
2018,4,BHUBANESWAR,HYDERABAD,21997,22968,BHUBANESWAR-HYDERABAD,44965,All
2018,5,BHUBANESWAR,HYDERABAD,26943,22313,BHUBANESWAR-HYDERABAD,49256,All
2018,6,BHUBANESWAR,HYDERABAD,22880,21662,BHUBANESWAR-HYDERABAD,44542,All
2018,7,BHUBANESWAR,HYDERABAD,24004,20145,BHUBANESWAR-HYDERABAD,44149,All
2018,8,BHUBANESWAR,HYDERABAD,20957,20301,BHUBANESWAR-HYDERABAD,41258,All
2018,9,BHUBANESWAR,HYDERABAD,22867,22426,BHUBANESWAR-HYDERABAD,45293,All
2018,10,BHUBANESWAR,HYDERABAD,25231,25283,BHUBANESWAR-HYDERABAD,50514,All
2018,11,BHUBANESWAR,HYDERABAD,18559,18184,BHUBANESWAR-HYDERABAD,36743,All
2018,12,BHUBANESWAR,HYDERABAD,22791,22656,BHUBANESWAR-HYDERABAD,45447,All
2019,1,BHUBANESWAR,HYDERABAD,24402,25505,BHUBANESWAR-HYDERABAD,49907,All
2019,2,BHUBANESWAR,HYDERABAD,22181,19918,BHUBANESWAR-HYDERABAD,42099,All
2019,3,BHUBANESWAR,HYDERABAD,22123,20308,BHUBANESWAR-HYDERABAD,42431,All
2019,4,BHUBANESWAR,HYDERABAD,17488,20618,BHUBANESWAR-HYDERABAD,38106,All
2019,5,BHUBANESWAR,HYDERABAD,21155,18468,BHUBANESWAR-HYDERABAD,39623,All
2019,6,BHUBANESWAR,HYDERABAD,12787,12673,BHUBANESWAR-HYDERABAD,25460,All
2019,7,BHUBANESWAR,HYDERABAD,13182,12339,BHUBANESWAR-HYDERABAD,25521,All
2019,8,BHUBANESWAR,HYDERABAD,13625,12523,BHUBANESWAR-HYDERABAD,26148,All
2019,9,BHUBANESWAR,HYDERABAD,12892,12360,BHUBANESWAR-HYDERABAD,25252,All
2019,10,BHUBANESWAR,HYDERABAD,14557,15238,BHUBANESWAR-HYDERABAD,29795,All
2019,11,BHUBANESWAR,HYDERABAD,15929,16692,BHUBANESWAR-HYDERABAD,32621,All
2019,12,BHUBANESWAR,HYDERABAD,20833,20863,BHUBANESWAR-HYDERABAD,41696,All
2020,1,BHUBANESWAR,HYDERABAD,18842,19439,BHUBANESWAR-HYDERABAD,38281,All
2020,2,BHUBANESWAR,HYDERABAD,18340,18103,BHUBANESWAR-HYDERABAD,36443,All
2020,3,BHUBANESWAR,HYDERABAD,11883,13611,BHUBANESWAR-HYDERABAD,25494,All
2020,5,BHUBANESWAR,HYDERABAD,284,551,BHUBANESWAR-HYDERABAD,835,All
2020,6,BHUBANESWAR,HYDERABAD,3752,5652,BHUBANESWAR-HYDERABAD,9404,All
2020,7,BHUBANESWAR,HYDERABAD,4026,6535,BHUBANESWAR-HYDERABAD,10561,All
2020,8,BHUBANESWAR,HYDERABAD,6981,5545,BHUBANESWAR-HYDERABAD,12526,All
2020,9,BHUBANESWAR,HYDERABAD,11196,6122,BHUBANESWAR-HYDERABAD,17318,All
2020,10,BHUBANESWAR,HYDERABAD,11014,7148,BHUBANESWAR-HYDERABAD,18162,All
2020,11,BHUBANESWAR,HYDERABAD,10780,11505,BHUBANESWAR-HYDERABAD,22285,All
2020,12,BHUBANESWAR,HYDERABAD,12280,12118,BHUBANESWAR-HYDERABAD,24398,All
2021,1,BHUBANESWAR,HYDERABAD,11192,11007,BHUBANESWAR-HYDERABAD,22199,All
2021,2,BHUBANESWAR,HYDERABAD,10780,11498,BHUBANESWAR-HYDERABAD,22278,All
2021,3,BHUBANESWAR,HYDERABAD,10079,10323,BHUBANESWAR-HYDERABAD,20402,All
2021,4,BHUBANESWAR,HYDERABAD,7916,9450,BHUBANESWAR-HYDERABAD,17366,All
2021,6,BHUBANESWAR,HYDERABAD,4465,3552,BHUBANESWAR-HYDERABAD,8017,All
2021,7,BHUBANESWAR,HYDERABAD,6803,5301,BHUBANESWAR-HYDERABAD,12104,All
2021,8,BHUBANESWAR,HYDERABAD,8584,6981,BHUBANESWAR-HYDERABAD,15565,All
2021,9,BHUBANESWAR,HYDERABAD,9316,7763,BHUBANESWAR-HYDERABAD,17079,All
2021,10,BHUBANESWAR,HYDERABAD,11184,11485,BHUBANESWAR-HYDERABAD,22669,All
2021,11,BHUBANESWAR,HYDERABAD,12000,13922,BHUBANESWAR-HYDERABAD,25922,All
2021,12,BHUBANESWAR,HYDERABAD,14503,14430,BHUBANESWAR-HYDERABAD,28933,All
2022,1,BHUBANESWAR,HYDERABAD,8019,8214,BHUBANESWAR-HYDERABAD,16233,All
2022,2,BHUBANESWAR,HYDERABAD,8373,8982,BHUBANESWAR-HYDERABAD,17355,All
2022,3,BHUBANESWAR,HYDERABAD,13859,13413,BHUBANESWAR-HYDERABAD,27272,All
2022,4,BHUBANESWAR,HYDERABAD,13204,14678,BHUBANESWAR-HYDERABAD,27882,All
2022,5,BHUBANESWAR,HYDERABAD,16363,13908,BHUBANESWAR-HYDERABAD,30271,All
2022,6,BHUBANESWAR,HYDERABAD,14956,13115,BHUBANESWAR-HYDERABAD,28071,All
2022,7,BHUBANESWAR,HYDERABAD,13868,11386,BHUBANESWAR-HYDERABAD,25254,All
2022,8,BHUBANESWAR,HYDERABAD,12577,11721,BHUBANESWAR-HYDERABAD,24298,All
2022,9,BHUBANESWAR,HYDERABAD,10463,11175,BHUBANESWAR-HYDERABAD,21638,All
2022,10,BHUBANESWAR,HYDERABAD,14155,15175,BHUBANESWAR-HYDERABAD,29330,All
2022,11,BHUBANESWAR,HYDERABAD,14021,13655,BHUBANESWAR-HYDERABAD,27676,All
2022,12,BHUBANESWAR,HYDERABAD,14937,14906,BHUBANESWAR-HYDERABAD,29843,All
2023,1,BHUBANESWAR,HYDERABAD,15129,15363,BHUBANESWAR-HYDERABAD,30492,All
2023,2,BHUBANESWAR,HYDERABAD,13998,14154,BHUBANESWAR-HYDERABAD,28152,All
2023,3,BHUBANESWAR,HYDERABAD,14862,15168,BHUBANESWAR-HYDERABAD,30030,All
2023,4,BHUBANESWAR,HYDERABAD,17215,19565,BHUBANESWAR-HYDERABAD,36780,All
2023,5,BHUBANESWAR,HYDERABAD,16346,16058,BHUBANESWAR-HYDERABAD,32404,All
2023,6,BHUBANESWAR,HYDERABAD,16480,16443,BHUBANESWAR-HYDERABAD,32923,All
2023,7,BHUBANESWAR,HYDERABAD,15836,15042,BHUBANESWAR-HYDERABAD,30878,All
2023,8,BHUBANESWAR,HYDERABAD,15578,16277,BHUBANESWAR-HYDERABAD,31855,All
2023,9,BHUBANESWAR,HYDERABAD,16672,17542,BHUBANESWAR-HYDERABAD,34214,All
2023,10,BHUBANESWAR,HYDERABAD,16011,17293,BHUBANESWAR-HYDERABAD,33304,All
2023,11,BHUBANESWAR,HYDERABAD,14214,15229,BHUBANESWAR-HYDERABAD,29443,All
2023,12,BHUBANESWAR,HYDERABAD,15371,15092,BHUBANESWAR-HYDERABAD,30463,All
2024,1,BHUBANESWAR,HYDERABAD,13820,14315,BHUBANESWAR-HYDERABAD,28135,All
2024,2,BHUBANESWAR,HYDERABAD,12813,13039,BHUBANESWAR-HYDERABAD,25852,All
2024,3,BHUBANESWAR,HYDERABAD,13116,13917,BHUBANESWAR-HYDERABAD,27033,All
2024,4,BHUBANESWAR,HYDERABAD,13154,14040,BHUBANESWAR-HYDERABAD,27194,All
2024,6,BHUBANESWAR,HYDERABAD,13449,13930,BHUBANESWAR-HYDERABAD,27379,All
2024,7,BHUBANESWAR,HYDERABAD,14038,13878,BHUBANESWAR-HYDERABAD,27916,All
2024,8,BHUBANESWAR,HYDERABAD,17500,17087,BHUBANESWAR-HYDERABAD,34587,All
2024,9,BHUBANESWAR,HYDERABAD,17441,18935,BHUBANESWAR-HYDERABAD,36376,All
2024,10,BHUBANESWAR,HYDERABAD,20408,25260,BHUBANESWAR-HYDERABAD,45668,All
2024,11,BHUBANESWAR,HYDERABAD,24270,23510,BHUBANESWAR-HYDERABAD,47780,All
2024,12,BHUBANESWAR,HYDERABAD,27157,26958,BHUBANESWAR-HYDERABAD,54115,All
2025,1,BHUBANESWAR,HYDERABAD,26307,26457,BHUBANESWAR-HYDERABAD,52764,All
2025,2,BHUBANESWAR,HYDERABAD,21874,23285,BHUBANESWAR-HYDERABAD,45159,All
2025,3,BHUBANESWAR,HYDERABAD,23425,25060,BHUBANESWAR-HYDERABAD,48485,All
2019,7,BHUBANESWAR,IMPHAL,0,34,BHUBANESWAR-IMPHAL,34,All
2019,10,BHUBANESWAR,IMPHAL,3,0,BHUBANESWAR-IMPHAL,3,All
2019,11,BHUBANESWAR,IMPHAL,154,0,BHUBANESWAR-IMPHAL,154,All
2020,2,BHUBANESWAR,IMPHAL,78,0,BHUBANESWAR-IMPHAL,78,All
2020,3,BHUBANESWAR,IMPHAL,169,0,BHUBANESWAR-IMPHAL,169,All
2021,6,BHUBANESWAR,IMPHAL,0,5,BHUBANESWAR-IMPHAL,5,All
2021,9,BHUBANESWAR,IMPHAL,0,1,BHUBANESWAR-IMPHAL,1,All
2023,4,BHUBANESWAR,IMPHAL,0,1,BHUBANESWAR-IMPHAL,1,All
2024,6,BHUBANESWAR,IMPHAL,46,0,BHUBANESWAR-IMPHAL,46,All
2017,3,BHUBANESWAR,INDORE,8,0,BHUBANESWAR-INDORE,8,All
2017,4,BHUBANESWAR,INDORE,52,0,BHUBANESWAR-INDORE,52,All
2017,7,BHUBANESWAR,INDORE,26,0,BHUBANESWAR-INDORE,26,All
2017,8,BHUBANESWAR,INDORE,90,0,BHUBANESWAR-INDORE,90,All
2017,9,BHUBANESWAR,INDORE,231,0,BHUBANESWAR-INDORE,231,All
2017,10,BHUBANESWAR,INDORE,152,0,BHUBANESWAR-INDORE,152,All
2017,11,BHUBANESWAR,INDORE,119,0,BHUBANESWAR-INDORE,119,All
2017,12,BHUBANESWAR,INDORE,70,0,BHUBANESWAR-INDORE,70,All
2018,1,BHUBANESWAR,INDORE,42,0,BHUBANESWAR-INDORE,42,All
2018,2,BHUBANESWAR,INDORE,8,0,BHUBANESWAR-INDORE,8,All
2018,3,BHUBANESWAR,INDORE,6,0,BHUBANESWAR-INDORE,6,All
2023,11,BHUBANESWAR,INDORE,1,0,BHUBANESWAR-INDORE,1,All
2025,2,BHUBANESWAR,INDORE,2013,2160,BHUBANESWAR-INDORE,4173,All
2025,3,BHUBANESWAR,INDORE,2632,2687,BHUBANESWAR-INDORE,5319,All
2017,4,BHUBANESWAR,JAIPUR,0,1,BHUBANESWAR-JAIPUR,1,All
2021,11,BHUBANESWAR,JAIPUR,1809,1823,BHUBANESWAR-JAIPUR,3632,All
2021,12,BHUBANESWAR,JAIPUR,1604,1847,BHUBANESWAR-JAIPUR,3451,All
2022,1,BHUBANESWAR,JAIPUR,810,921,BHUBANESWAR-JAIPUR,1731,All
2022,2,BHUBANESWAR,JAIPUR,1674,1495,BHUBANESWAR-JAIPUR,3169,All
2022,3,BHUBANESWAR,JAIPUR,2324,2345,BHUBANESWAR-JAIPUR,4669,All
2022,4,BHUBANESWAR,JAIPUR,2106,2147,BHUBANESWAR-JAIPUR,4253,All
2022,5,BHUBANESWAR,JAIPUR,1833,2080,BHUBANESWAR-JAIPUR,3913,All
2022,6,BHUBANESWAR,JAIPUR,1909,1996,BHUBANESWAR-JAIPUR,3905,All
2022,7,BHUBANESWAR,JAIPUR,1403,1577,BHUBANESWAR-JAIPUR,2980,All
2022,8,BHUBANESWAR,JAIPUR,1585,1842,BHUBANESWAR-JAIPUR,3427,All
2022,9,BHUBANESWAR,JAIPUR,1619,1862,BHUBANESWAR-JAIPUR,3481,All
2022,10,BHUBANESWAR,JAIPUR,2046,2173,BHUBANESWAR-JAIPUR,4219,All
2022,11,BHUBANESWAR,JAIPUR,1709,1821,BHUBANESWAR-JAIPUR,3530,All
2022,12,BHUBANESWAR,JAIPUR,1845,2078,BHUBANESWAR-JAIPUR,3923,All
2023,1,BHUBANESWAR,JAIPUR,1558,1671,BHUBANESWAR-JAIPUR,3229,All
2023,2,BHUBANESWAR,JAIPUR,1574,1756,BHUBANESWAR-JAIPUR,3330,All
2023,3,BHUBANESWAR,JAIPUR,1653,1610,BHUBANESWAR-JAIPUR,3263,All
2023,4,BHUBANESWAR,JAIPUR,1868,1616,BHUBANESWAR-JAIPUR,3484,All
2023,5,BHUBANESWAR,JAIPUR,1992,1929,BHUBANESWAR-JAIPUR,3921,All
2023,6,BHUBANESWAR,JAIPUR,1952,2115,BHUBANESWAR-JAIPUR,4067,All
2023,7,BHUBANESWAR,JAIPUR,2017,1860,BHUBANESWAR-JAIPUR,3877,All
2023,8,BHUBANESWAR,JAIPUR,2186,2088,BHUBANESWAR-JAIPUR,4274,All
2023,9,BHUBANESWAR,JAIPUR,2074,2018,BHUBANESWAR-JAIPUR,4092,All
2023,10,BHUBANESWAR,JAIPUR,1946,1887,BHUBANESWAR-JAIPUR,3833,All
2025,1,BHUBANESWAR,JAIPUR,2550,2484,BHUBANESWAR-JAIPUR,5034,All
2025,2,BHUBANESWAR,JAIPUR,2292,2323,BHUBANESWAR-JAIPUR,4615,All
2025,3,BHUBANESWAR,JAIPUR,2482,2539,BHUBANESWAR-JAIPUR,5021,All
2025,3,BHUBANESWAR,JAMMU,242,210,BHUBANESWAR-JAMMU,452,All
2023,1,BHUBANESWAR,JAMSHEDPUR,5,5,BHUBANESWAR-JAMSHEDPUR,10,All
2023,2,BHUBANESWAR,JAMSHEDPUR,135,163,BHUBANESWAR-JAMSHEDPUR,298,All
2023,3,BHUBANESWAR,JAMSHEDPUR,84,121,BHUBANESWAR-JAMSHEDPUR,205,All
2023,4,BHUBANESWAR,JAMSHEDPUR,168,158,BHUBANESWAR-JAMSHEDPUR,326,All
2023,5,BHUBANESWAR,JAMSHEDPUR,121,154,BHUBANESWAR-JAMSHEDPUR,275,All
2023,6,BHUBANESWAR,JAMSHEDPUR,106,139,BHUBANESWAR-JAMSHEDPUR,245,All
2023,7,BHUBANESWAR,JAMSHEDPUR,79,90,BHUBANESWAR-JAMSHEDPUR,169,All
2023,8,BHUBANESWAR,JAMSHEDPUR,132,150,BHUBANESWAR-JAMSHEDPUR,282,All
2023,9,BHUBANESWAR,JAMSHEDPUR,132,153,BHUBANESWAR-JAMSHEDPUR,285,All
2023,10,BHUBANESWAR,JAMSHEDPUR,119,163,BHUBANESWAR-JAMSHEDPUR,282,All
2023,11,BHUBANESWAR,JAMSHEDPUR,206,248,BHUBANESWAR-JAMSHEDPUR,454,All
2023,12,BHUBANESWAR,JAMSHEDPUR,222,223,BHUBANESWAR-JAMSHEDPUR,445,All
2024,1,BHUBANESWAR,JAMSHEDPUR,190,185,BHUBANESWAR-JAMSHEDPUR,375,All
2024,2,BHUBANESWAR,JAMSHEDPUR,181,208,BHUBANESWAR-JAMSHEDPUR,389,All
2024,3,BHUBANESWAR,JAMSHEDPUR,207,251,BHUBANESWAR-JAMSHEDPUR,458,All
2024,4,BHUBANESWAR,JAMSHEDPUR,145,168,BHUBANESWAR-JAMSHEDPUR,313,All
2024,6,BHUBANESWAR,JAMSHEDPUR,145,137,BHUBANESWAR-JAMSHEDPUR,282,All
2024,7,BHUBANESWAR,JAMSHEDPUR,134,177,BHUBANESWAR-JAMSHEDPUR,311,All
2024,8,BHUBANESWAR,JAMSHEDPUR,192,231,BHUBANESWAR-JAMSHEDPUR,423,All
2024,9,BHUBANESWAR,JAMSHEDPUR,151,198,BHUBANESWAR-JAMSHEDPUR,349,All
2024,10,BHUBANESWAR,JAMSHEDPUR,170,183,BHUBANESWAR-JAMSHEDPUR,353,All
2024,11,BHUBANESWAR,JAMSHEDPUR,166,215,BHUBANESWAR-JAMSHEDPUR,381,All
2024,12,BHUBANESWAR,JAMSHEDPUR,230,233,BHUBANESWAR-JAMSHEDPUR,463,All
2025,1,BHUBANESWAR,JAMSHEDPUR,142,160,BHUBANESWAR-JAMSHEDPUR,302,All
2025,2,BHUBANESWAR,JAMSHEDPUR,164,176,BHUBANESWAR-JAMSHEDPUR,340,All
2025,3,BHUBANESWAR,JAMSHEDPUR,183,215,BHUBANESWAR-JAMSHEDPUR,398,All
2022,10,BHUBANESWAR,JEYPORE,8,9,BHUBANESWAR-JEYPORE,17,All
2022,11,BHUBANESWAR,JEYPORE,172,169,BHUBANESWAR-JEYPORE,341,All
2022,12,BHUBANESWAR,JEYPORE,130,134,BHUBANESWAR-JEYPORE,264,All
2023,1,BHUBANESWAR,JEYPORE,254,264,BHUBANESWAR-JEYPORE,518,All
2023,2,BHUBANESWAR,JEYPORE,233,244,BHUBANESWAR-JEYPORE,477,All
2023,3,BHUBANESWAR,JEYPORE,262,261,BHUBANESWAR-JEYPORE,523,All
2023,4,BHUBANESWAR,JEYPORE,250,261,BHUBANESWAR-JEYPORE,511,All
2023,5,BHUBANESWAR,JEYPORE,198,198,BHUBANESWAR-JEYPORE,396,All
2023,6,BHUBANESWAR,JEYPORE,0,226,BHUBANESWAR-JEYPORE,226,All
2023,7,BHUBANESWAR,JEYPORE,101,114,BHUBANESWAR-JEYPORE,215,All
2023,8,BHUBANESWAR,JEYPORE,164,188,BHUBANESWAR-JEYPORE,352,All
2023,9,BHUBANESWAR,JEYPORE,220,215,BHUBANESWAR-JEYPORE,435,All
2023,10,BHUBANESWAR,JEYPORE,264,264,BHUBANESWAR-JEYPORE,528,All
2023,11,BHUBANESWAR,JEYPORE,299,302,BHUBANESWAR-JEYPORE,601,All
2023,12,BHUBANESWAR,JEYPORE,330,337,BHUBANESWAR-JEYPORE,667,All
2024,1,BHUBANESWAR,JEYPORE,341,340,BHUBANESWAR-JEYPORE,681,All
2024,2,BHUBANESWAR,JEYPORE,293,314,BHUBANESWAR-JEYPORE,607,All
2024,3,BHUBANESWAR,JEYPORE,330,341,BHUBANESWAR-JEYPORE,671,All
2024,4,BHUBANESWAR,JEYPORE,311,331,BHUBANESWAR-JEYPORE,642,All
2024,6,BHUBANESWAR,JEYPORE,281,268,BHUBANESWAR-JEYPORE,549,All
2024,7,BHUBANESWAR,JEYPORE,232,223,BHUBANESWAR-JEYPORE,455,All
2024,8,BHUBANESWAR,JEYPORE,279,323,BHUBANESWAR-JEYPORE,602,All
2024,9,BHUBANESWAR,JEYPORE,349,372,BHUBANESWAR-JEYPORE,721,All
2024,10,BHUBANESWAR,JEYPORE,346,349,BHUBANESWAR-JEYPORE,695,All
2024,11,BHUBANESWAR,JEYPORE,375,372,BHUBANESWAR-JEYPORE,747,All
2024,12,BHUBANESWAR,JEYPORE,520,509,BHUBANESWAR-JEYPORE,1029,All
2025,1,BHUBANESWAR,JEYPORE,514,539,BHUBANESWAR-JEYPORE,1053,All
2025,2,BHUBANESWAR,JEYPORE,466,465,BHUBANESWAR-JEYPORE,931,All
2025,3,BHUBANESWAR,JEYPORE,518,521,BHUBANESWAR-JEYPORE,1039,All
2019,6,BHUBANESWAR,JHARSUGUDA,1152,1298,BHUBANESWAR-JHARSUGUDA,2450,All
2019,7,BHUBANESWAR,JHARSUGUDA,1136,1227,BHUBANESWAR-JHARSUGUDA,2363,All
2019,8,BHUBANESWAR,JHARSUGUDA,1073,1129,BHUBANESWAR-JHARSUGUDA,2202,All
2019,9,BHUBANESWAR,JHARSUGUDA,1241,1353,BHUBANESWAR-JHARSUGUDA,2594,All
2019,10,BHUBANESWAR,JHARSUGUDA,1439,1558,BHUBANESWAR-JHARSUGUDA,2997,All
2019,11,BHUBANESWAR,JHARSUGUDA,1213,1361,BHUBANESWAR-JHARSUGUDA,2574,All
2019,12,BHUBANESWAR,JHARSUGUDA,1381,1426,BHUBANESWAR-JHARSUGUDA,2807,All
2020,1,BHUBANESWAR,JHARSUGUDA,1186,1304,BHUBANESWAR-JHARSUGUDA,2490,All
2020,2,BHUBANESWAR,JHARSUGUDA,1153,1378,BHUBANESWAR-JHARSUGUDA,2531,All
2020,3,BHUBANESWAR,JHARSUGUDA,1078,899,BHUBANESWAR-JHARSUGUDA,1977,All
2020,6,BHUBANESWAR,JHARSUGUDA,493,456,BHUBANESWAR-JHARSUGUDA,949,All
2020,7,BHUBANESWAR,JHARSUGUDA,566,551,BHUBANESWAR-JHARSUGUDA,1117,All
2020,8,BHUBANESWAR,JHARSUGUDA,487,389,BHUBANESWAR-JHARSUGUDA,876,All
2020,9,BHUBANESWAR,JHARSUGUDA,701,695,BHUBANESWAR-JHARSUGUDA,1396,All
2020,10,BHUBANESWAR,JHARSUGUDA,1080,1159,BHUBANESWAR-JHARSUGUDA,2239,All
2020,11,BHUBANESWAR,JHARSUGUDA,1423,1460,BHUBANESWAR-JHARSUGUDA,2883,All
2020,12,BHUBANESWAR,JHARSUGUDA,1475,1474,BHUBANESWAR-JHARSUGUDA,2949,All
2021,1,BHUBANESWAR,JHARSUGUDA,1361,1411,BHUBANESWAR-JHARSUGUDA,2772,All
2021,2,BHUBANESWAR,JHARSUGUDA,1316,1431,BHUBANESWAR-JHARSUGUDA,2747,All
2021,3,BHUBANESWAR,JHARSUGUDA,1365,1384,BHUBANESWAR-JHARSUGUDA,2749,All
2021,4,BHUBANESWAR,JHARSUGUDA,709,732,BHUBANESWAR-JHARSUGUDA,1441,All
2021,6,BHUBANESWAR,JHARSUGUDA,492,532,BHUBANESWAR-JHARSUGUDA,1024,All
2021,7,BHUBANESWAR,JHARSUGUDA,1137,1305,BHUBANESWAR-JHARSUGUDA,2442,All
2021,8,BHUBANESWAR,JHARSUGUDA,1267,1386,BHUBANESWAR-JHARSUGUDA,2653,All
2021,9,BHUBANESWAR,JHARSUGUDA,1271,1391,BHUBANESWAR-JHARSUGUDA,2662,All
2021,10,BHUBANESWAR,JHARSUGUDA,1389,1393,BHUBANESWAR-JHARSUGUDA,2782,All
2021,11,BHUBANESWAR,JHARSUGUDA,1211,1239,BHUBANESWAR-JHARSUGUDA,2450,All
2021,12,BHUBANESWAR,JHARSUGUDA,1402,1372,BHUBANESWAR-JHARSUGUDA,2774,All
2022,1,BHUBANESWAR,JHARSUGUDA,798,840,BHUBANESWAR-JHARSUGUDA,1638,All
2022,2,BHUBANESWAR,JHARSUGUDA,1126,1103,BHUBANESWAR-JHARSUGUDA,2229,All
2022,3,BHUBANESWAR,JHARSUGUDA,1383,1224,BHUBANESWAR-JHARSUGUDA,2607,All
2022,4,BHUBANESWAR,JHARSUGUDA,1211,1239,BHUBANESWAR-JHARSUGUDA,2450,All
2022,5,BHUBANESWAR,JHARSUGUDA,1402,1372,BHUBANESWAR-JHARSUGUDA,2774,All
2022,6,BHUBANESWAR,JHARSUGUDA,1211,1239,BHUBANESWAR-JHARSUGUDA,2450,All
2022,7,BHUBANESWAR,JHARSUGUDA,1126,1103,BHUBANESWAR-JHARSUGUDA,2229,All
2022,8,BHUBANESWAR,JHARSUGUDA,1402,1372,BHUBANESWAR-JHARSUGUDA,2774,All
2022,9,BHUBANESWAR,JHARSUGUDA,1211,1239,BHUBANESWAR-JHARSUGUDA,2450,All
2022,10,BHUBANESWAR,JHARSUGUDA,1269,1350,BHUBANESWAR-JHARSUGUDA,2619,All
2022,11,BHUBANESWAR,JHARSUGUDA,1280,1396,BHUBANESWAR-JHARSUGUDA,2676,All
2022,12,BHUBANESWAR,JHARSUGUDA,1426,1465,BHUBANESWAR-JHARSUGUDA,2891,All
2023,1,BHUBANESWAR,JHARSUGUDA,1271,1607,BHUBANESWAR-JHARSUGUDA,2878,All
2023,2,BHUBANESWAR,JHARSUGUDA,1001,1124,BHUBANESWAR-JHARSUGUDA,2125,All
2023,3,BHUBANESWAR,JHARSUGUDA,1150,1287,BHUBANESWAR-JHARSUGUDA,2437,All
2023,4,BHUBANESWAR,JHARSUGUDA,1233,1239,BHUBANESWAR-JHARSUGUDA,2472,All
2023,5,BHUBANESWAR,JHARSUGUDA,1662,1754,BHUBANESWAR-JHARSUGUDA,3416,All
2023,6,BHUBANESWAR,JHARSUGUDA,1420,1438,BHUBANESWAR-JHARSUGUDA,2858,All
2023,7,BHUBANESWAR,JHARSUGUDA,1269,1336,BHUBANESWAR-JHARSUGUDA,2605,All
2023,8,BHUBANESWAR,JHARSUGUDA,1573,1459,BHUBANESWAR-JHARSUGUDA,3032,All
2023,9,BHUBANESWAR,JHARSUGUDA,1231,1398,BHUBANESWAR-JHARSUGUDA,2629,All
2023,10,BHUBANESWAR,JHARSUGUDA,1081,1176,BHUBANESWAR-JHARSUGUDA,2257,All
2023,11,BHUBANESWAR,JHARSUGUDA,45,0,BHUBANESWAR-JHARSUGUDA,45,All
2023,12,BHUBANESWAR,JHARSUGUDA,188,177,BHUBANESWAR-JHARSUGUDA,365,All
2024,1,BHUBANESWAR,JHARSUGUDA,671,621,BHUBANESWAR-JHARSUGUDA,1292,All
2024,2,BHUBANESWAR,JHARSUGUDA,545,544,BHUBANESWAR-JHARSUGUDA,1089,All
2024,3,BHUBANESWAR,JHARSUGUDA,840,707,BHUBANESWAR-JHARSUGUDA,1547,All
2024,4,BHUBANESWAR,JHARSUGUDA,623,775,BHUBANESWAR-JHARSUGUDA,1398,All
2024,6,BHUBANESWAR,JHARSUGUDA,713,838,BHUBANESWAR-JHARSUGUDA,1551,All
2024,7,BHUBANESWAR,JHARSUGUDA,502,693,BHUBANESWAR-JHARSUGUDA,1195,All
2024,8,BHUBANESWAR,JHARSUGUDA,608,774,BHUBANESWAR-JHARSUGUDA,1382,All
2024,9,BHUBANESWAR,JHARSUGUDA,553,671,BHUBANESWAR-JHARSUGUDA,1224,All
2024,10,BHUBANESWAR,JHARSUGUDA,652,722,BHUBANESWAR-JHARSUGUDA,1374,All
2024,11,BHUBANESWAR,JHARSUGUDA,666,816,BHUBANESWAR-JHARSUGUDA,1482,All
2024,12,BHUBANESWAR,JHARSUGUDA,777,942,BHUBANESWAR-JHARSUGUDA,1719,All
2025,1,BHUBANESWAR,JHARSUGUDA,361,437,BHUBANESWAR-JHARSUGUDA,798,All
2025,2,BHUBANESWAR,JHARSUGUDA,436,523,BHUBANESWAR-JHARSUGUDA,959,All
2025,3,BHUBANESWAR,JHARSUGUDA,566,599,BHUBANESWAR-JHARSUGUDA,1165,All
2024,12,BHUBANESWAR,JODHPUR,60,58,BHUBANESWAR-JODHPUR,118,All
2018,9,BHUBANESWAR,KOCHI,0,66,BHUBANESWAR-KOCHI,66,All
2018,10,BHUBANESWAR,KOCHI,0,445,BHUBANESWAR-KOCHI,445,All
2018,11,BHUBANESWAR,KOCHI,0,689,BHUBANESWAR-KOCHI,689,All
2018,12,BHUBANESWAR,KOCHI,4076,3698,BHUBANESWAR-KOCHI,7774,All
2019,1,BHUBANESWAR,KOCHI,2990,3457,BHUBANESWAR-KOCHI,6447,All
2019,2,BHUBANESWAR,KOCHI,2773,3301,BHUBANESWAR-KOCHI,6074,All
2019,3,BHUBANESWAR,KOCHI,1709,3192,BHUBANESWAR-KOCHI,4901,All
2019,4,BHUBANESWAR,KOCHI,2391,3658,BHUBANESWAR-KOCHI,6049,All
2019,5,BHUBANESWAR,KOCHI,4444,3788,BHUBANESWAR-KOCHI,8232,All
2019,6,BHUBANESWAR,KOCHI,2670,3799,BHUBANESWAR-KOCHI,6469,All
2019,7,BHUBANESWAR,KOCHI,0,1211,BHUBANESWAR-KOCHI,1211,All
2019,8,BHUBANESWAR,KOCHI,0,1203,BHUBANESWAR-KOCHI,1203,All
2019,9,BHUBANESWAR,KOCHI,0,1445,BHUBANESWAR-KOCHI,1445,All
2021,1,BHUBANESWAR,KOCHI,233,169,BHUBANESWAR-KOCHI,402,All
2021,2,BHUBANESWAR,KOCHI,328,347,BHUBANESWAR-KOCHI,675,All
2021,3,BHUBANESWAR,KOCHI,213,270,BHUBANESWAR-KOCHI,483,All
2021,6,BHUBANESWAR,KOCHI,263,154,BHUBANESWAR-KOCHI,417,All
2021,7,BHUBANESWAR,KOCHI,525,275,BHUBANESWAR-KOCHI,800,All
2021,8,BHUBANESWAR,KOCHI,589,495,BHUBANESWAR-KOCHI,1084,All
2021,9,BHUBANESWAR,KOCHI,510,379,BHUBANESWAR-KOCHI,889,All
2021,10,BHUBANESWAR,KOCHI,499,443,BHUBANESWAR-KOCHI,942,All
2023,3,BHUBANESWAR,KOCHI,12,10,BHUBANESWAR-KOCHI,22,All
2023,4,BHUBANESWAR,KOCHI,163,103,BHUBANESWAR-KOCHI,266,All
2023,5,BHUBANESWAR,KOCHI,172,112,BHUBANESWAR-KOCHI,284,All
2023,6,BHUBANESWAR,KOCHI,103,112,BHUBANESWAR-KOCHI,215,All
2023,7,BHUBANESWAR,KOCHI,119,54,BHUBANESWAR-KOCHI,173,All
2023,8,BHUBANESWAR,KOCHI,198,215,BHUBANESWAR-KOCHI,413,All
2023,9,BHUBANESWAR,KOCHI,58,131,BHUBANESWAR-KOCHI,189,All
2023,10,BHUBANESWAR,KOCHI,350,330,BHUBANESWAR-KOCHI,680,All
2024,3,BHUBANESWAR,KOCHI,30,0,BHUBANESWAR-KOCHI,30,All
2024,4,BHUBANESWAR,KOCHI,321,36,BHUBANESWAR-KOCHI,357,All
2024,6,BHUBANESWAR,KOCHI,494,63,BHUBANESWAR-KOCHI,557,All
2024,7,BHUBANESWAR,KOCHI,330,0,BHUBANESWAR-KOCHI,330,All
2024,8,BHUBANESWAR,KOCHI,269,0,BHUBANESWAR-KOCHI,269,All
2024,9,BHUBANESWAR,KOCHI,276,135,BHUBANESWAR-KOCHI,411,All
2024,10,BHUBANESWAR,KOCHI,225,113,BHUBANESWAR-KOCHI,338,All
2024,11,BHUBANESWAR,KOCHI,393,319,BHUBANESWAR-KOCHI,712,All
2024,12,BHUBANESWAR,KOCHI,371,305,BHUBANESWAR-KOCHI,676,All
2025,1,BHUBANESWAR,KOCHI,3851,3780,BHUBANESWAR-KOCHI,7631,All
2025,2,BHUBANESWAR,KOCHI,3727,3142,BHUBANESWAR-KOCHI,6869,All
2025,3,BHUBANESWAR,KOCHI,3232,2420,BHUBANESWAR-KOCHI,5652,All
2015,4,BHUBANESWAR,KOLKATA,12964,11703,BHUBANESWAR-KOLKATA,24667,All
2015,5,BHUBANESWAR,KOLKATA,17044,15709,BHUBANESWAR-KOLKATA,32753,All
2015,6,BHUBANESWAR,KOLKATA,14742,13783,BHUBANESWAR-KOLKATA,28525,All
2015,7,BHUBANESWAR,KOLKATA,12406,11832,BHUBANESWAR-KOLKATA,24238,All
2015,8,BHUBANESWAR,KOLKATA,11979,10845,BHUBANESWAR-KOLKATA,22824,All
2015,9,BHUBANESWAR,KOLKATA,12450,11052,BHUBANESWAR-KOLKATA,23502,All
2015,10,BHUBANESWAR,KOLKATA,11707,11077,BHUBANESWAR-KOLKATA,22784,All
2015,11,BHUBANESWAR,KOLKATA,12428,11581,BHUBANESWAR-KOLKATA,24009,All
2015,12,BHUBANESWAR,KOLKATA,14041,13165,BHUBANESWAR-KOLKATA,27206,All
2016,1,BHUBANESWAR,KOLKATA,15909,15679,BHUBANESWAR-KOLKATA,31588,All
2016,2,BHUBANESWAR,KOLKATA,16193,15000,BHUBANESWAR-KOLKATA,31193,All
2016,3,BHUBANESWAR,KOLKATA,17134,16970,BHUBANESWAR-KOLKATA,34104,All
2016,4,BHUBANESWAR,KOLKATA,11997,10756,BHUBANESWAR-KOLKATA,22753,All
2016,5,BHUBANESWAR,KOLKATA,12578,11947,BHUBANESWAR-KOLKATA,24525,All
2016,6,BHUBANESWAR,KOLKATA,11282,10960,BHUBANESWAR-KOLKATA,22242,All
2016,7,BHUBANESWAR,KOLKATA,11647,11129,BHUBANESWAR-KOLKATA,22776,All
2016,8,BHUBANESWAR,KOLKATA,11370,10354,BHUBANESWAR-KOLKATA,21724,All
2016,9,BHUBANESWAR,KOLKATA,12188,11135,BHUBANESWAR-KOLKATA,23323,All
2016,10,BHUBANESWAR,KOLKATA,17823,16052,BHUBANESWAR-KOLKATA,33875,All
2016,11,BHUBANESWAR,KOLKATA,17052,15518,BHUBANESWAR-KOLKATA,32570,All
2016,12,BHUBANESWAR,KOLKATA,21741,19503,BHUBANESWAR-KOLKATA,41244,All
2017,1,BHUBANESWAR,KOLKATA,21749,20571,BHUBANESWAR-KOLKATA,42320,All
2017,2,BHUBANESWAR,KOLKATA,18246,18212,BHUBANESWAR-KOLKATA,36458,All
2017,3,BHUBANESWAR,KOLKATA,19422,19672,BHUBANESWAR-KOLKATA,39094,All
2017,4,BHUBANESWAR,KOLKATA,18169,18041,BHUBANESWAR-KOLKATA,36210,All
2017,5,BHUBANESWAR,KOLKATA,14770,14719,BHUBANESWAR-KOLKATA,29489,All
2017,6,BHUBANESWAR,KOLKATA,14417,15131,BHUBANESWAR-KOLKATA,29548,All
2017,7,BHUBANESWAR,KOLKATA,16657,15115,BHUBANESWAR-KOLKATA,31772,All
2017,8,BHUBANESWAR,KOLKATA,19571,18206,BHUBANESWAR-KOLKATA,37777,All
2017,9,BHUBANESWAR,KOLKATA,24452,22444,BHUBANESWAR-KOLKATA,46896,All
2017,10,BHUBANESWAR,KOLKATA,27873,26983,BHUBANESWAR-KOLKATA,54856,All
2017,11,BHUBANESWAR,KOLKATA,29038,28836,BHUBANESWAR-KOLKATA,57874,All
2017,12,BHUBANESWAR,KOLKATA,30233,28376,BHUBANESWAR-KOLKATA,58609,All
2018,1,BHUBANESWAR,KOLKATA,31056,29036,BHUBANESWAR-KOLKATA,60092,All
2018,2,BHUBANESWAR,KOLKATA,28552,26240,BHUBANESWAR-KOLKATA,54792,All
2018,3,BHUBANESWAR,KOLKATA,29070,28739,BHUBANESWAR-KOLKATA,57809,All
2018,4,BHUBANESWAR,KOLKATA,30072,25946,BHUBANESWAR-KOLKATA,56018,All
2018,5,BHUBANESWAR,KOLKATA,31700,29592,BHUBANESWAR-KOLKATA,61292,All
2018,6,BHUBANESWAR,KOLKATA,30405,29742,BHUBANESWAR-KOLKATA,60147,All
2018,7,BHUBANESWAR,KOLKATA,29682,28941,BHUBANESWAR-KOLKATA,58623,All
2018,8,BHUBANESWAR,KOLKATA,28997,29981,BHUBANESWAR-KOLKATA,58978,All
2018,9,BHUBANESWAR,KOLKATA,29095,28617,BHUBANESWAR-KOLKATA,57712,All
2018,10,BHUBANESWAR,KOLKATA,34008,33121,BHUBANESWAR-KOLKATA,67129,All
2018,11,BHUBANESWAR,KOLKATA,36087,32923,BHUBANESWAR-KOLKATA,69010,All
2018,12,BHUBANESWAR,KOLKATA,35898,39469,BHUBANESWAR-KOLKATA,75367,All
2019,1,BHUBANESWAR,KOLKATA,36803,35561,BHUBANESWAR-KOLKATA,72364,All
2019,2,BHUBANESWAR,KOLKATA,30684,31945,BHUBANESWAR-KOLKATA,62629,All
2019,3,BHUBANESWAR,KOLKATA,36796,35046,BHUBANESWAR-KOLKATA,71842,All
2019,4,BHUBANESWAR,KOLKATA,31367,27405,BHUBANESWAR-KOLKATA,58772,All
2019,5,BHUBANESWAR,KOLKATA,28994,26974,BHUBANESWAR-KOLKATA,55968,All
2019,6,BHUBANESWAR,KOLKATA,26403,27069,BHUBANESWAR-KOLKATA,53472,All
2019,7,BHUBANESWAR,KOLKATA,24709,25498,BHUBANESWAR-KOLKATA,50207,All
2019,8,BHUBANESWAR,KOLKATA,26390,23825,BHUBANESWAR-KOLKATA,50215,All
2019,9,BHUBANESWAR,KOLKATA,26722,25213,BHUBANESWAR-KOLKATA,51935,All
2019,10,BHUBANESWAR,KOLKATA,29046,27503,BHUBANESWAR-KOLKATA,56549,All
2019,11,BHUBANESWAR,KOLKATA,30646,30840,BHUBANESWAR-KOLKATA,61486,All
2019,12,BHUBANESWAR,KOLKATA,28710,28818,BHUBANESWAR-KOLKATA,57528,All
2020,1,BHUBANESWAR,KOLKATA,26904,27390,BHUBANESWAR-KOLKATA,54294,All
2020,2,BHUBANESWAR,KOLKATA,25103,25426,BHUBANESWAR-KOLKATA,50529,All
2020,3,BHUBANESWAR,KOLKATA,23160,18477,BHUBANESWAR-KOLKATA,41637,All
2020,5,BHUBANESWAR,KOLKATA,32,0,BHUBANESWAR-KOLKATA,32,All
2020,6,BHUBANESWAR,KOLKATA,1454,2733,BHUBANESWAR-KOLKATA,4187,All
2020,7,BHUBANESWAR,KOLKATA,956,2269,BHUBANESWAR-KOLKATA,3225,All
2020,8,BHUBANESWAR,KOLKATA,1713,2913,BHUBANESWAR-KOLKATA,4626,All
2020,9,BHUBANESWAR,KOLKATA,3418,4458,BHUBANESWAR-KOLKATA,7876,All
2020,10,BHUBANESWAR,KOLKATA,7862,7357,BHUBANESWAR-KOLKATA,15219,All
2020,11,BHUBANESWAR,KOLKATA,9753,9065,BHUBANESWAR-KOLKATA,18818,All
2020,12,BHUBANESWAR,KOLKATA,11377,12652,BHUBANESWAR-KOLKATA,24029,All
2021,1,BHUBANESWAR,KOLKATA,12002,14996,BHUBANESWAR-KOLKATA,26998,All
2021,2,BHUBANESWAR,KOLKATA,14360,16931,BHUBANESWAR-KOLKATA,31291,All
2021,3,BHUBANESWAR,KOLKATA,15520,16509,BHUBANESWAR-KOLKATA,32029,All
2021,4,BHUBANESWAR,KOLKATA,10264,8764,BHUBANESWAR-KOLKATA,19028,All
2021,6,BHUBANESWAR,KOLKATA,2747,2833,BHUBANESWAR-KOLKATA,5580,All
2021,7,BHUBANESWAR,KOLKATA,5640,5488,BHUBANESWAR-KOLKATA,11128,All
2021,8,BHUBANESWAR,KOLKATA,11798,11193,BHUBANESWAR-KOLKATA,22991,All
2021,9,BHUBANESWAR,KOLKATA,13883,11858,BHUBANESWAR-KOLKATA,25741,All
2021,10,BHUBANESWAR,KOLKATA,16977,14766,BHUBANESWAR-KOLKATA,31743,All
2021,11,BHUBANESWAR,KOLKATA,15349,16756,BHUBANESWAR-KOLKATA,32105,All
2021,12,BHUBANESWAR,KOLKATA,17562,19828,BHUBANESWAR-KOLKATA,37390,All
2022,1,BHUBANESWAR,KOLKATA,10170,8163,BHUBANESWAR-KOLKATA,18333,All
2022,2,BHUBANESWAR,KOLKATA,15570,13618,BHUBANESWAR-KOLKATA,29188,All
2022,3,BHUBANESWAR,KOLKATA,21365,21081,BHUBANESWAR-KOLKATA,42446,All
2022,4,BHUBANESWAR,KOLKATA,19465,19294,BHUBANESWAR-KOLKATA,38759,All
2022,5,BHUBANESWAR,KOLKATA,16327,19290,BHUBANESWAR-KOLKATA,35617,All
2022,6,BHUBANESWAR,KOLKATA,15568,17286,BHUBANESWAR-KOLKATA,32854,All
2022,7,BHUBANESWAR,KOLKATA,17050,17377,BHUBANESWAR-KOLKATA,34427,All
2022,8,BHUBANESWAR,KOLKATA,13373,14411,BHUBANESWAR-KOLKATA,27784,All
2022,9,BHUBANESWAR,KOLKATA,17094,16973,BHUBANESWAR-KOLKATA,34067,All
2022,10,BHUBANESWAR,KOLKATA,18956,20896,BHUBANESWAR-KOLKATA,39852,All
2022,11,BHUBANESWAR,KOLKATA,20147,23385,BHUBANESWAR-KOLKATA,43532,All
2022,12,BHUBANESWAR,KOLKATA,29115,26907,BHUBANESWAR-KOLKATA,56022,All
2023,1,BHUBANESWAR,KOLKATA,27082,23507,BHUBANESWAR-KOLKATA,50589,All
2023,2,BHUBANESWAR,KOLKATA,23376,21790,BHUBANESWAR-KOLKATA,45166,All
2023,3,BHUBANESWAR,KOLKATA,27980,25273,BHUBANESWAR-KOLKATA,53253,All
2023,4,BHUBANESWAR,KOLKATA,30160,25486,BHUBANESWAR-KOLKATA,55646,All
2023,5,BHUBANESWAR,KOLKATA,26212,25384,BHUBANESWAR-KOLKATA,51596,All
2023,6,BHUBANESWAR,KOLKATA,25715,25390,BHUBANESWAR-KOLKATA,51105,All
2023,7,BHUBANESWAR,KOLKATA,24022,23180,BHUBANESWAR-KOLKATA,47202,All
2023,8,BHUBANESWAR,KOLKATA,24196,23611,BHUBANESWAR-KOLKATA,47807,All
2023,9,BHUBANESWAR,KOLKATA,22460,20049,BHUBANESWAR-KOLKATA,42509,All
2023,10,BHUBANESWAR,KOLKATA,24995,22183,BHUBANESWAR-KOLKATA,47178,All
2023,11,BHUBANESWAR,KOLKATA,23732,22313,BHUBANESWAR-KOLKATA,46045,All
2023,12,BHUBANESWAR,KOLKATA,23721,24203,BHUBANESWAR-KOLKATA,47924,All
2024,1,BHUBANESWAR,KOLKATA,24102,23692,BHUBANESWAR-KOLKATA,47794,All
2024,2,BHUBANESWAR,KOLKATA,21978,20804,BHUBANESWAR-KOLKATA,42782,All
2024,3,BHUBANESWAR,KOLKATA,24745,22921,BHUBANESWAR-KOLKATA,47666,All
2024,4,BHUBANESWAR,KOLKATA,26044,21444,BHUBANESWAR-KOLKATA,47488,All
2024,6,BHUBANESWAR,KOLKATA,24007,25429,BHUBANESWAR-KOLKATA,49436,All
2024,7,BHUBANESWAR,KOLKATA,22795,27129,BHUBANESWAR-KOLKATA,49924,All
2024,8,BHUBANESWAR,KOLKATA,23561,25688,BHUBANESWAR-KOLKATA,49249,All
2024,9,BHUBANESWAR,KOLKATA,23222,21609,BHUBANESWAR-KOLKATA,44831,All
2024,10,BHUBANESWAR,KOLKATA,25089,22213,BHUBANESWAR-KOLKATA,47302,All
2024,11,BHUBANESWAR,KOLKATA,20846,21481,BHUBANESWAR-KOLKATA,42327,All
2024,12,BHUBANESWAR,KOLKATA,22364,22802,BHUBANESWAR-KOLKATA,45166,All
2025,1,BHUBANESWAR,KOLKATA,26756,26845,BHUBANESWAR-KOLKATA,53601,All
2025,2,BHUBANESWAR,KOLKATA,22719,23320,BHUBANESWAR-KOLKATA,46039,All
2025,3,BHUBANESWAR,KOLKATA,25621,26026,BHUBANESWAR-KOLKATA,51647,All
2020,12,BHUBANESWAR,LUCKNOW,2927,0,BHUBANESWAR-LUCKNOW,2927,All
2021,1,BHUBANESWAR,LUCKNOW,36,0,BHUBANESWAR-LUCKNOW,36,All
2021,2,BHUBANESWAR,LUCKNOW,0,581,BHUBANESWAR-LUCKNOW,581,All
2021,3,BHUBANESWAR,LUCKNOW,0,135,BHUBANESWAR-LUCKNOW,135,All
2021,11,BHUBANESWAR,LUCKNOW,554,639,BHUBANESWAR-LUCKNOW,1193,All
2021,12,BHUBANESWAR,LUCKNOW,512,666,BHUBANESWAR-LUCKNOW,1178,All
2022,1,BHUBANESWAR,LUCKNOW,346,276,BHUBANESWAR-LUCKNOW,622,All
2022,3,BHUBANESWAR,LUCKNOW,677,635,BHUBANESWAR-LUCKNOW,1312,All
2022,4,BHUBANESWAR,LUCKNOW,305,345,BHUBANESWAR-LUCKNOW,650,All
2022,5,BHUBANESWAR,LUCKNOW,425,572,BHUBANESWAR-LUCKNOW,997,All
2022,7,BHUBANESWAR,LUCKNOW,146,167,BHUBANESWAR-LUCKNOW,313,All
2022,8,BHUBANESWAR,LUCKNOW,210,428,BHUBANESWAR-LUCKNOW,638,All
2022,9,BHUBANESWAR,LUCKNOW,84,78,BHUBANESWAR-LUCKNOW,162,All
2022,10,BHUBANESWAR,LUCKNOW,489,433,BHUBANESWAR-LUCKNOW,922,All
2022,11,BHUBANESWAR,LUCKNOW,1123,583,BHUBANESWAR-LUCKNOW,1706,All
2022,12,BHUBANESWAR,LUCKNOW,1678,1365,BHUBANESWAR-LUCKNOW,3043,All
2023,1,BHUBANESWAR,LUCKNOW,1379,884,BHUBANESWAR-LUCKNOW,2263,All
2023,2,BHUBANESWAR,LUCKNOW,963,466,BHUBANESWAR-LUCKNOW,1429,All
2023,3,BHUBANESWAR,LUCKNOW,1192,639,BHUBANESWAR-LUCKNOW,1831,All
2023,4,BHUBANESWAR,LUCKNOW,665,457,BHUBANESWAR-LUCKNOW,1122,All
2023,6,BHUBANESWAR,LUCKNOW,688,765,BHUBANESWAR-LUCKNOW,1453,All
2023,7,BHUBANESWAR,LUCKNOW,984,950,BHUBANESWAR-LUCKNOW,1934,All
2023,8,BHUBANESWAR,LUCKNOW,762,798,BHUBANESWAR-LUCKNOW,1560,All
2023,9,BHUBANESWAR,LUCKNOW,633,783,BHUBANESWAR-LUCKNOW,1416,All
2023,10,BHUBANESWAR,LUCKNOW,925,1066,BHUBANESWAR-LUCKNOW,1991,All
2023,11,BHUBANESWAR,LUCKNOW,963,1106,BHUBANESWAR-LUCKNOW,2069,All
2023,12,BHUBANESWAR,LUCKNOW,1633,1679,BHUBANESWAR-LUCKNOW,3312,All
2024,1,BHUBANESWAR,LUCKNOW,1548,1565,BHUBANESWAR-LUCKNOW,3113,All
2024,2,BHUBANESWAR,LUCKNOW,1341,1388,BHUBANESWAR-LUCKNOW,2729,All
2024,3,BHUBANESWAR,LUCKNOW,1398,1510,BHUBANESWAR-LUCKNOW,2908,All
2024,4,BHUBANESWAR,LUCKNOW,1581,1619,BHUBANESWAR-LUCKNOW,3200,All
2024,6,BHUBANESWAR,LUCKNOW,1343,1151,BHUBANESWAR-LUCKNOW,2494,All
2024,7,BHUBANESWAR,LUCKNOW,1106,1204,BHUBANESWAR-LUCKNOW,2310,All
2024,8,BHUBANESWAR,LUCKNOW,1242,1263,BHUBANESWAR-LUCKNOW,2505,All
2024,9,BHUBANESWAR,LUCKNOW,1715,1426,BHUBANESWAR-LUCKNOW,3141,All
2024,10,BHUBANESWAR,LUCKNOW,1481,1723,BHUBANESWAR-LUCKNOW,3204,All
2024,11,BHUBANESWAR,LUCKNOW,1135,1285,BHUBANESWAR-LUCKNOW,2420,All
2024,12,BHUBANESWAR,LUCKNOW,1865,1791,BHUBANESWAR-LUCKNOW,3656,All
2025,1,BHUBANESWAR,LUCKNOW,1736,1773,BHUBANESWAR-LUCKNOW,3509,All
2025,2,BHUBANESWAR,LUCKNOW,1851,1891,BHUBANESWAR-LUCKNOW,3742,All
2025,3,BHUBANESWAR,LUCKNOW,3697,3752,BHUBANESWAR-LUCKNOW,7449,All
2017,6,BHUBANESWAR,MADURAI,0,11,BHUBANESWAR-MADURAI,11,All
2017,7,BHUBANESWAR,MADURAI,0,55,BHUBANESWAR-MADURAI,55,All
2017,11,BHUBANESWAR,MADURAI,0,73,BHUBANESWAR-MADURAI,73,All
2017,12,BHUBANESWAR,MADURAI,0,245,BHUBANESWAR-MADURAI,245,All
2018,1,BHUBANESWAR,MADURAI,0,317,BHUBANESWAR-MADURAI,317,All
2018,2,BHUBANESWAR,MADURAI,0,128,BHUBANESWAR-MADURAI,128,All
2018,3,BHUBANESWAR,MADURAI,0,334,BHUBANESWAR-MADURAI,334,All
2018,4,BHUBANESWAR,MADURAI,0,143,BHUBANESWAR-MADURAI,143,All
2018,5,BHUBANESWAR,MADURAI,0,383,BHUBANESWAR-MADURAI,383,All
2018,6,BHUBANESWAR,MADURAI,0,244,BHUBANESWAR-MADURAI,244,All
2018,7,BHUBANESWAR,MADURAI,0,242,BHUBANESWAR-MADURAI,242,All
2018,8,BHUBANESWAR,MADURAI,0,227,BHUBANESWAR-MADURAI,227,All
2018,9,BHUBANESWAR,MADURAI,0,64,BHUBANESWAR-MADURAI,64,All
2015,4,BHUBANESWAR,MUMBAI,15237,16776,BHUBANESWAR-MUMBAI,32013,All
2015,5,BHUBANESWAR,MUMBAI,17865,17172,BHUBANESWAR-MUMBAI,35037,All
2015,6,BHUBANESWAR,MUMBAI,16109,14546,BHUBANESWAR-MUMBAI,30655,All
2015,7,BHUBANESWAR,MUMBAI,14957,14638,BHUBANESWAR-MUMBAI,29595,All
2015,8,BHUBANESWAR,MUMBAI,15255,14980,BHUBANESWAR-MUMBAI,30235,All
2015,9,BHUBANESWAR,MUMBAI,15542,15739,BHUBANESWAR-MUMBAI,31281,All
2015,10,BHUBANESWAR,MUMBAI,14448,15349,BHUBANESWAR-MUMBAI,29797,All
2015,11,BHUBANESWAR,MUMBAI,18202,18691,BHUBANESWAR-MUMBAI,36893,All
2015,12,BHUBANESWAR,MUMBAI,20229,20413,BHUBANESWAR-MUMBAI,40642,All
2016,1,BHUBANESWAR,MUMBAI,19283,19374,BHUBANESWAR-MUMBAI,38657,All
2016,2,BHUBANESWAR,MUMBAI,17946,17924,BHUBANESWAR-MUMBAI,35870,All
2016,3,BHUBANESWAR,MUMBAI,18770,18679,BHUBANESWAR-MUMBAI,37449,All
2016,4,BHUBANESWAR,MUMBAI,17584,18955,BHUBANESWAR-MUMBAI,36539,All
2016,5,BHUBANESWAR,MUMBAI,20779,19481,BHUBANESWAR-MUMBAI,40260,All
2016,6,BHUBANESWAR,MUMBAI,18292,17906,BHUBANESWAR-MUMBAI,36198,All
2016,7,BHUBANESWAR,MUMBAI,19047,18173,BHUBANESWAR-MUMBAI,37220,All
2016,8,BHUBANESWAR,MUMBAI,18012,17200,BHUBANESWAR-MUMBAI,35212,All
2016,9,BHUBANESWAR,MUMBAI,18113,18872,BHUBANESWAR-MUMBAI,36985,All
2016,10,BHUBANESWAR,MUMBAI,17139,21209,BHUBANESWAR-MUMBAI,38348,All
2016,11,BHUBANESWAR,MUMBAI,17039,16545,BHUBANESWAR-MUMBAI,33584,All
2016,12,BHUBANESWAR,MUMBAI,22086,21211,BHUBANESWAR-MUMBAI,43297,All
2017,1,BHUBANESWAR,MUMBAI,20491,20324,BHUBANESWAR-MUMBAI,40815,All
2017,2,BHUBANESWAR,MUMBAI,16686,16753,BHUBANESWAR-MUMBAI,33439,All
2017,3,BHUBANESWAR,MUMBAI,15714,15812,BHUBANESWAR-MUMBAI,31526,All
2017,4,BHUBANESWAR,MUMBAI,15142,17942,BHUBANESWAR-MUMBAI,33084,All
2017,5,BHUBANESWAR,MUMBAI,21247,20365,BHUBANESWAR-MUMBAI,41612,All
2017,6,BHUBANESWAR,MUMBAI,18383,19105,BHUBANESWAR-MUMBAI,37488,All
2017,7,BHUBANESWAR,MUMBAI,18502,16531,BHUBANESWAR-MUMBAI,35033,All
2017,8,BHUBANESWAR,MUMBAI,18112,18643,BHUBANESWAR-MUMBAI,36755,All
2017,9,BHUBANESWAR,MUMBAI,17856,17688,BHUBANESWAR-MUMBAI,35544,All
2017,10,BHUBANESWAR,MUMBAI,18606,20708,BHUBANESWAR-MUMBAI,39314,All
2017,11,BHUBANESWAR,MUMBAI,19250,19513,BHUBANESWAR-MUMBAI,38763,All
2017,12,BHUBANESWAR,MUMBAI,21833,20450,BHUBANESWAR-MUMBAI,42283,All
2018,1,BHUBANESWAR,MUMBAI,20567,20377,BHUBANESWAR-MUMBAI,40944,All
2018,2,BHUBANESWAR,MUMBAI,18356,19163,BHUBANESWAR-MUMBAI,37519,All
2018,3,BHUBANESWAR,MUMBAI,18982,20123,BHUBANESWAR-MUMBAI,39105,All
2018,4,BHUBANESWAR,MUMBAI,18607,20698,BHUBANESWAR-MUMBAI,39305,All
2018,5,BHUBANESWAR,MUMBAI,21036,19886,BHUBANESWAR-MUMBAI,40922,All
2018,6,BHUBANESWAR,MUMBAI,18120,19399,BHUBANESWAR-MUMBAI,37519,All
2018,7,BHUBANESWAR,MUMBAI,19264,18545,BHUBANESWAR-MUMBAI,37809,All
2018,8,BHUBANESWAR,MUMBAI,17687,17495,BHUBANESWAR-MUMBAI,35182,All
2018,9,BHUBANESWAR,MUMBAI,17549,17049,BHUBANESWAR-MUMBAI,34598,All
2018,10,BHUBANESWAR,MUMBAI,18077,18936,BHUBANESWAR-MUMBAI,37013,All
2018,11,BHUBANESWAR,MUMBAI,18383,18352,BHUBANESWAR-MUMBAI,36735,All
2018,12,BHUBANESWAR,MUMBAI,20358,19717,BHUBANESWAR-MUMBAI,40075,All
2019,1,BHUBANESWAR,MUMBAI,20550,19346,BHUBANESWAR-MUMBAI,39896,All
2019,2,BHUBANESWAR,MUMBAI,16382,16538,BHUBANESWAR-MUMBAI,32920,All
2019,3,BHUBANESWAR,MUMBAI,16554,17814,BHUBANESWAR-MUMBAI,34368,All
2019,4,BHUBANESWAR,MUMBAI,17274,19205,BHUBANESWAR-MUMBAI,36479,All
2019,5,BHUBANESWAR,MUMBAI,19961,17985,BHUBANESWAR-MUMBAI,37946,All
2019,6,BHUBANESWAR,MUMBAI,20372,19332,BHUBANESWAR-MUMBAI,39704,All
2019,7,BHUBANESWAR,MUMBAI,19623,17461,BHUBANESWAR-MUMBAI,37084,All
2019,8,BHUBANESWAR,MUMBAI,18990,19405,BHUBANESWAR-MUMBAI,38395,All
2019,9,BHUBANESWAR,MUMBAI,18332,18378,BHUBANESWAR-MUMBAI,36710,All
2019,10,BHUBANESWAR,MUMBAI,17711,20402,BHUBANESWAR-MUMBAI,38113,All
2019,11,BHUBANESWAR,MUMBAI,20406,19671,BHUBANESWAR-MUMBAI,40077,All
2019,12,BHUBANESWAR,MUMBAI,20538,20549,BHUBANESWAR-MUMBAI,41087,All
2020,1,BHUBANESWAR,MUMBAI,19615,20447,BHUBANESWAR-MUMBAI,40062,All
2020,2,BHUBANESWAR,MUMBAI,18342,19359,BHUBANESWAR-MUMBAI,37701,All
2020,3,BHUBANESWAR,MUMBAI,10803,13378,BHUBANESWAR-MUMBAI,24181,All
2020,5,BHUBANESWAR,MUMBAI,205,791,BHUBANESWAR-MUMBAI,996,All
2020,6,BHUBANESWAR,MUMBAI,1492,3232,BHUBANESWAR-MUMBAI,4724,All
2020,7,BHUBANESWAR,MUMBAI,2323,4484,BHUBANESWAR-MUMBAI,6807,All
2020,8,BHUBANESWAR,MUMBAI,9709,4629,BHUBANESWAR-MUMBAI,14338,All
2020,9,BHUBANESWAR,MUMBAI,17969,5917,BHUBANESWAR-MUMBAI,23886,All
2020,10,BHUBANESWAR,MUMBAI,19626,8633,BHUBANESWAR-MUMBAI,28259,All
2020,11,BHUBANESWAR,MUMBAI,14424,12389,BHUBANESWAR-MUMBAI,26813,All
2020,12,BHUBANESWAR,MUMBAI,17812,12921,BHUBANESWAR-MUMBAI,30733,All
2021,1,BHUBANESWAR,MUMBAI,17004,14039,BHUBANESWAR-MUMBAI,31043,All
2021,2,BHUBANESWAR,MUMBAI,15117,14990,BHUBANESWAR-MUMBAI,30107,All
2021,3,BHUBANESWAR,MUMBAI,11894,11227,BHUBANESWAR-MUMBAI,23121,All
2021,4,BHUBANESWAR,MUMBAI,6972,9144,BHUBANESWAR-MUMBAI,16116,All
2021,6,BHUBANESWAR,MUMBAI,5022,4933,BHUBANESWAR-MUMBAI,9955,All
2021,7,BHUBANESWAR,MUMBAI,8090,7185,BHUBANESWAR-MUMBAI,15275,All
2021,8,BHUBANESWAR,MUMBAI,8811,10400,BHUBANESWAR-MUMBAI,19211,All
2021,9,BHUBANESWAR,MUMBAI,9575,11138,BHUBANESWAR-MUMBAI,20713,All
2021,10,BHUBANESWAR,MUMBAI,13289,17138,BHUBANESWAR-MUMBAI,30427,All
2021,11,BHUBANESWAR,MUMBAI,18327,18708,BHUBANESWAR-MUMBAI,37035,All
2021,12,BHUBANESWAR,MUMBAI,19828,18800,BHUBANESWAR-MUMBAI,38628,All
2022,1,BHUBANESWAR,MUMBAI,11739,12594,BHUBANESWAR-MUMBAI,24333,All
2022,2,BHUBANESWAR,MUMBAI,14100,14325,BHUBANESWAR-MUMBAI,28425,All
2022,3,BHUBANESWAR,MUMBAI,20880,19887,BHUBANESWAR-MUMBAI,40767,All
2022,4,BHUBANESWAR,MUMBAI,18624,19122,BHUBANESWAR-MUMBAI,37746,All
2022,5,BHUBANESWAR,MUMBAI,20264,19126,BHUBANESWAR-MUMBAI,39390,All
2022,6,BHUBANESWAR,MUMBAI,20436,19238,BHUBANESWAR-MUMBAI,39674,All
2022,7,BHUBANESWAR,MUMBAI,18575,16889,BHUBANESWAR-MUMBAI,35464,All
2022,8,BHUBANESWAR,MUMBAI,20207,18740,BHUBANESWAR-MUMBAI,38947,All
2022,9,BHUBANESWAR,MUMBAI,22355,22042,BHUBANESWAR-MUMBAI,44397,All
2022,10,BHUBANESWAR,MUMBAI,20898,24487,BHUBANESWAR-MUMBAI,45385,All
2022,11,BHUBANESWAR,MUMBAI,22866,20242,BHUBANESWAR-MUMBAI,43108,All
2022,12,BHUBANESWAR,MUMBAI,26797,27086,BHUBANESWAR-MUMBAI,53883,All
2023,1,BHUBANESWAR,MUMBAI,26531,27206,BHUBANESWAR-MUMBAI,53737,All
2023,2,BHUBANESWAR,MUMBAI,25152,25890,BHUBANESWAR-MUMBAI,51042,All
2023,3,BHUBANESWAR,MUMBAI,30488,29785,BHUBANESWAR-MUMBAI,60273,All
2023,4,BHUBANESWAR,MUMBAI,28345,30857,BHUBANESWAR-MUMBAI,59202,All
2023,5,BHUBANESWAR,MUMBAI,28598,28000,BHUBANESWAR-MUMBAI,56598,All
2023,6,BHUBANESWAR,MUMBAI,30004,30101,BHUBANESWAR-MUMBAI,60105,All
2023,7,BHUBANESWAR,MUMBAI,28447,23058,BHUBANESWAR-MUMBAI,51505,All
2023,8,BHUBANESWAR,MUMBAI,28184,25813,BHUBANESWAR-MUMBAI,53997,All
2023,9,BHUBANESWAR,MUMBAI,26566,26231,BHUBANESWAR-MUMBAI,52797,All
2023,10,BHUBANESWAR,MUMBAI,25046,27126,BHUBANESWAR-MUMBAI,52172,All
2023,11,BHUBANESWAR,MUMBAI,21500,24981,BHUBANESWAR-MUMBAI,46481,All
2023,12,BHUBANESWAR,MUMBAI,25410,25697,BHUBANESWAR-MUMBAI,51107,All
2024,1,BHUBANESWAR,MUMBAI,24522,24798,BHUBANESWAR-MUMBAI,49320,All
2024,2,BHUBANESWAR,MUMBAI,24417,24836,BHUBANESWAR-MUMBAI,49253,All
2024,3,BHUBANESWAR,MUMBAI,26283,25765,BHUBANESWAR-MUMBAI,52048,All
2024,4,BHUBANESWAR,MUMBAI,21098,21952,BHUBANESWAR-MUMBAI,43050,All
2024,6,BHUBANESWAR,MUMBAI,22903,23307,BHUBANESWAR-MUMBAI,46210,All
2024,7,BHUBANESWAR,MUMBAI,22551,20768,BHUBANESWAR-MUMBAI,43319,All
2024,8,BHUBANESWAR,MUMBAI,24331,21681,BHUBANESWAR-MUMBAI,46012,All
2024,9,BHUBANESWAR,MUMBAI,24910,25179,BHUBANESWAR-MUMBAI,50089,All
2024,10,BHUBANESWAR,MUMBAI,22874,26709,BHUBANESWAR-MUMBAI,49583,All
2024,11,BHUBANESWAR,MUMBAI,25751,26088,BHUBANESWAR-MUMBAI,51839,All
2024,12,BHUBANESWAR,MUMBAI,27147,28146,BHUBANESWAR-MUMBAI,55293,All
2025,1,BHUBANESWAR,MUMBAI,27072,27715,BHUBANESWAR-MUMBAI,54787,All
2025,2,BHUBANESWAR,MUMBAI,23298,24765,BHUBANESWAR-MUMBAI,48063,All
2025,3,BHUBANESWAR,MUMBAI,23913,25152,BHUBANESWAR-MUMBAI,49065,All
2019,4,BHUBANESWAR,NAGPUR,0,3,BHUBANESWAR-NAGPUR,3,All
2020,8,BHUBANESWAR,NAGPUR,151,140,BHUBANESWAR-NAGPUR,291,All
2020,9,BHUBANESWAR,NAGPUR,957,366,BHUBANESWAR-NAGPUR,1323,All
2020,10,BHUBANESWAR,NAGPUR,955,452,BHUBANESWAR-NAGPUR,1407,All
2020,5,BHUBANESWAR,PATNA,0,0,BHUBANESWAR-PATNA,0,All
2020,12,BHUBANESWAR,PATNA,167,174,BHUBANESWAR-PATNA,341,All
2021,2,BHUBANESWAR,PATNA,0,60,BHUBANESWAR-PATNA,60,All
2021,3,BHUBANESWAR,PATNA,0,85,BHUBANESWAR-PATNA,85,All
2021,8,BHUBANESWAR,PATNA,76,106,BHUBANESWAR-PATNA,182,All
2022,3,BHUBANESWAR,PATNA,486,607,BHUBANESWAR-PATNA,1093,All
2022,4,BHUBANESWAR,PATNA,3365,3105,BHUBANESWAR-PATNA,6470,All
2022,5,BHUBANESWAR,PATNA,2603,2668,BHUBANESWAR-PATNA,5271,All
2022,6,BHUBANESWAR,PATNA,2586,2858,BHUBANESWAR-PATNA,5444,All
2022,7,BHUBANESWAR,PATNA,2953,2773,BHUBANESWAR-PATNA,5726,All
2022,8,BHUBANESWAR,PATNA,3273,3059,BHUBANESWAR-PATNA,6332,All
2022,9,BHUBANESWAR,PATNA,3236,2649,BHUBANESWAR-PATNA,5885,All
2022,10,BHUBANESWAR,PATNA,3771,2968,BHUBANESWAR-PATNA,6739,All
2022,11,BHUBANESWAR,PATNA,3010,4139,BHUBANESWAR-PATNA,7149,All
2022,12,BHUBANESWAR,PATNA,182,0,BHUBANESWAR-PATNA,182,All
2023,2,BHUBANESWAR,PATNA,1757,1282,BHUBANESWAR-PATNA,3039,All
2023,3,BHUBANESWAR,PATNA,3209,3698,BHUBANESWAR-PATNA,6907,All
2023,4,BHUBANESWAR,PATNA,3845,3613,BHUBANESWAR-PATNA,7458,All
2023,5,BHUBANESWAR,PATNA,3558,3565,BHUBANESWAR-PATNA,7123,All
2023,6,BHUBANESWAR,PATNA,1871,1939,BHUBANESWAR-PATNA,3810,All
2023,7,BHUBANESWAR,PATNA,1795,1955,BHUBANESWAR-PATNA,3750,All
2023,8,BHUBANESWAR,PATNA,2071,2120,BHUBANESWAR-PATNA,4191,All
2023,9,BHUBANESWAR,PATNA,1885,1945,BHUBANESWAR-PATNA,3830,All
2023,10,BHUBANESWAR,PATNA,4048,3754,BHUBANESWAR-PATNA,7802,All
2023,11,BHUBANESWAR,PATNA,3758,3346,BHUBANESWAR-PATNA,7104,All
2023,12,BHUBANESWAR,PATNA,1742,2142,BHUBANESWAR-PATNA,3884,All
2024,2,BHUBANESWAR,PATNA,1977,1920,BHUBANESWAR-PATNA,3897,All
2024,3,BHUBANESWAR,PATNA,4255,3878,BHUBANESWAR-PATNA,8133,All
2024,4,BHUBANESWAR,PATNA,4460,4006,BHUBANESWAR-PATNA,8466,All
2024,6,BHUBANESWAR,PATNA,3732,4000,BHUBANESWAR-PATNA,7732,All
2024,7,BHUBANESWAR,PATNA,3739,3965,BHUBANESWAR-PATNA,7704,All
2024,8,BHUBANESWAR,PATNA,4080,4057,BHUBANESWAR-PATNA,8137,All
2024,9,BHUBANESWAR,PATNA,3975,3868,BHUBANESWAR-PATNA,7843,All
2024,10,BHUBANESWAR,PATNA,4670,3927,BHUBANESWAR-PATNA,8597,All
2024,11,BHUBANESWAR,PATNA,4588,4513,BHUBANESWAR-PATNA,9101,All
2024,12,BHUBANESWAR,PATNA,1947,2057,BHUBANESWAR-PATNA,4004,All
2025,1,BHUBANESWAR,PATNA,2730,2536,BHUBANESWAR-PATNA,5266,All
2025,2,BHUBANESWAR,PATNA,8324,7789,BHUBANESWAR-PATNA,16113,All
2025,3,BHUBANESWAR,PATNA,8460,7736,BHUBANESWAR-PATNA,16196,All
2015,4,BHUBANESWAR,PORT BLAIR,113,0,BHUBANESWAR-PORT BLAIR,113,All
2015,5,BHUBANESWAR,PORT BLAIR,116,0,BHUBANESWAR-PORT BLAIR,116,All
2015,6,BHUBANESWAR,PORT BLAIR,53,0,BHUBANESWAR-PORT BLAIR,53,All
2015,7,BHUBANESWAR,PORT BLAIR,41,0,BHUBANESWAR-PORT BLAIR,41,All
2015,8,BHUBANESWAR,PORT BLAIR,122,0,BHUBANESWAR-PORT BLAIR,122,All
2015,9,BHUBANESWAR,PORT BLAIR,54,0,BHUBANESWAR-PORT BLAIR,54,All
2015,10,BHUBANESWAR,PORT BLAIR,41,0,BHUBANESWAR-PORT BLAIR,41,All
2015,11,BHUBANESWAR,PORT BLAIR,183,0,BHUBANESWAR-PORT BLAIR,183,All
2015,12,BHUBANESWAR,PORT BLAIR,41,0,BHUBANESWAR-PORT BLAIR,41,All
2016,1,BHUBANESWAR,PORT BLAIR,155,0,BHUBANESWAR-PORT BLAIR,155,All
2016,2,BHUBANESWAR,PORT BLAIR,74,0,BHUBANESWAR-PORT BLAIR,74,All
2021,7,BHUBANESWAR,PORT BLAIR,0,24,BHUBANESWAR-PORT BLAIR,24,All
2025,3,BHUBANESWAR,PORT BLAIR,251,317,BHUBANESWAR-PORT BLAIR,568,All
2021,1,BHUBANESWAR,PUNE,912,668,BHUBANESWAR-PUNE,1580,All
2021,2,BHUBANESWAR,PUNE,3818,3450,BHUBANESWAR-PUNE,7268,All
2021,3,BHUBANESWAR,PUNE,3528,3166,BHUBANESWAR-PUNE,6694,All
2021,4,BHUBANESWAR,PUNE,1593,2215,BHUBANESWAR-PUNE,3808,All
2021,6,BHUBANESWAR,PUNE,1258,931,BHUBANESWAR-PUNE,2189,All
2021,7,BHUBANESWAR,PUNE,1842,1517,BHUBANESWAR-PUNE,3359,All
2021,8,BHUBANESWAR,PUNE,2546,2265,BHUBANESWAR-PUNE,4811,All
2021,9,BHUBANESWAR,PUNE,3176,2773,BHUBANESWAR-PUNE,5949,All
2021,10,BHUBANESWAR,PUNE,1868,2398,BHUBANESWAR-PUNE,4266,All
2021,11,BHUBANESWAR,PUNE,3633,3739,BHUBANESWAR-PUNE,7372,All
2021,12,BHUBANESWAR,PUNE,5908,5635,BHUBANESWAR-PUNE,11543,All
2022,1,BHUBANESWAR,PUNE,3266,3083,BHUBANESWAR-PUNE,6349,All
2022,2,BHUBANESWAR,PUNE,3920,3866,BHUBANESWAR-PUNE,7786,All
2022,3,BHUBANESWAR,PUNE,5302,4366,BHUBANESWAR-PUNE,9668,All
2022,4,BHUBANESWAR,PUNE,5242,4945,BHUBANESWAR-PUNE,10187,All
2022,5,BHUBANESWAR,PUNE,6498,5348,BHUBANESWAR-PUNE,11846,All
2022,6,BHUBANESWAR,PUNE,4159,3392,BHUBANESWAR-PUNE,7551,All
2022,7,BHUBANESWAR,PUNE,3881,3483,BHUBANESWAR-PUNE,7364,All
2022,8,BHUBANESWAR,PUNE,3715,3338,BHUBANESWAR-PUNE,7053,All
2022,9,BHUBANESWAR,PUNE,2732,3130,BHUBANESWAR-PUNE,5862,All
2022,10,BHUBANESWAR,PUNE,5233,5777,BHUBANESWAR-PUNE,11010,All
2022,11,BHUBANESWAR,PUNE,7529,6154,BHUBANESWAR-PUNE,13683,All
2022,12,BHUBANESWAR,PUNE,7921,8245,BHUBANESWAR-PUNE,16166,All
2023,1,BHUBANESWAR,PUNE,7862,7992,BHUBANESWAR-PUNE,15854,All
2023,2,BHUBANESWAR,PUNE,5793,5514,BHUBANESWAR-PUNE,11307,All
2023,3,BHUBANESWAR,PUNE,3944,3482,BHUBANESWAR-PUNE,7426,All
2023,4,BHUBANESWAR,PUNE,6034,6797,BHUBANESWAR-PUNE,12831,All
2023,5,BHUBANESWAR,PUNE,9455,9845,BHUBANESWAR-PUNE,19300,All
2023,6,BHUBANESWAR,PUNE,8909,9705,BHUBANESWAR-PUNE,18614,All
2023,7,BHUBANESWAR,PUNE,9415,8031,BHUBANESWAR-PUNE,17446,All
2023,8,BHUBANESWAR,PUNE,7066,8261,BHUBANESWAR-PUNE,15327,All
2023,9,BHUBANESWAR,PUNE,8910,8962,BHUBANESWAR-PUNE,17872,All
2023,10,BHUBANESWAR,PUNE,8644,9570,BHUBANESWAR-PUNE,18214,All
2023,11,BHUBANESWAR,PUNE,8551,9504,BHUBANESWAR-PUNE,18055,All
2023,12,BHUBANESWAR,PUNE,8844,9504,BHUBANESWAR-PUNE,18348,All
2024,1,BHUBANESWAR,PUNE,9041,9115,BHUBANESWAR-PUNE,18156,All
2024,2,BHUBANESWAR,PUNE,8557,8966,BHUBANESWAR-PUNE,17523,All
2024,3,BHUBANESWAR,PUNE,8733,9821,BHUBANESWAR-PUNE,18554,All
2024,4,BHUBANESWAR,PUNE,8121,8926,BHUBANESWAR-PUNE,17047,All
2024,6,BHUBANESWAR,PUNE,4908,4729,BHUBANESWAR-PUNE,9637,All
2024,7,BHUBANESWAR,PUNE,5048,4496,BHUBANESWAR-PUNE,9544,All
2024,8,BHUBANESWAR,PUNE,4887,4514,BHUBANESWAR-PUNE,9401,All
2024,9,BHUBANESWAR,PUNE,4346,4494,BHUBANESWAR-PUNE,8840,All
2024,10,BHUBANESWAR,PUNE,3987,4777,BHUBANESWAR-PUNE,8764,All
2024,11,BHUBANESWAR,PUNE,4065,4217,BHUBANESWAR-PUNE,8282,All
2024,12,BHUBANESWAR,PUNE,5141,4622,BHUBANESWAR-PUNE,9763,All
2025,1,BHUBANESWAR,PUNE,4938,4368,BHUBANESWAR-PUNE,9306,All
2025,2,BHUBANESWAR,PUNE,4605,3967,BHUBANESWAR-PUNE,8572,All
2025,3,BHUBANESWAR,PUNE,4800,3929,BHUBANESWAR-PUNE,8729,All
2018,6,BHUBANESWAR,RAIPUR,38,29,BHUBANESWAR-RAIPUR,67,All
2018,7,BHUBANESWAR,RAIPUR,24,17,BHUBANESWAR-RAIPUR,41,All
2018,8,BHUBANESWAR,RAIPUR,3,15,BHUBANESWAR-RAIPUR,18,All
2018,9,BHUBANESWAR,RAIPUR,65,80,BHUBANESWAR-RAIPUR,145,All
2019,1,BHUBANESWAR,RAIPUR,290,0,BHUBANESWAR-RAIPUR,290,All
2019,2,BHUBANESWAR,RAIPUR,51,0,BHUBANESWAR-RAIPUR,51,All
2019,3,BHUBANESWAR,RAIPUR,322,0,BHUBANESWAR-RAIPUR,322,All
2019,4,BHUBANESWAR,RAIPUR,219,0,BHUBANESWAR-RAIPUR,219,All
2019,5,BHUBANESWAR,RAIPUR,159,0,BHUBANESWAR-RAIPUR,159,All
2019,6,BHUBANESWAR,RAIPUR,5,0,BHUBANESWAR-RAIPUR,5,All
2020,1,BHUBANESWAR,RAIPUR,131,0,BHUBANESWAR-RAIPUR,131,All
2020,6,BHUBANESWAR,RAIPUR,0,0,BHUBANESWAR-RAIPUR,0,All
2020,7,BHUBANESWAR,RAIPUR,10,0,BHUBANESWAR-RAIPUR,10,All
2020,8,BHUBANESWAR,RAIPUR,301,84,BHUBANESWAR-RAIPUR,385,All
2020,9,BHUBANESWAR,RAIPUR,984,382,BHUBANESWAR-RAIPUR,1366,All
2020,10,BHUBANESWAR,RAIPUR,998,581,BHUBANESWAR-RAIPUR,1579,All
2020,11,BHUBANESWAR,RAIPUR,289,13,BHUBANESWAR-RAIPUR,302,All
2020,12,BHUBANESWAR,RAIPUR,377,0,BHUBANESWAR-RAIPUR,377,All
2021,1,BHUBANESWAR,RAIPUR,372,0,BHUBANESWAR-RAIPUR,372,All
2021,2,BHUBANESWAR,RAIPUR,351,0,BHUBANESWAR-RAIPUR,351,All
2021,3,BHUBANESWAR,RAIPUR,192,0,BHUBANESWAR-RAIPUR,192,All
2021,4,BHUBANESWAR,RAIPUR,75,0,BHUBANESWAR-RAIPUR,75,All
2021,6,BHUBANESWAR,RAIPUR,170,0,BHUBANESWAR-RAIPUR,170,All
2021,7,BHUBANESWAR,RAIPUR,356,0,BHUBANESWAR-RAIPUR,356,All
2021,8,BHUBANESWAR,RAIPUR,401,0,BHUBANESWAR-RAIPUR,401,All
2021,9,BHUBANESWAR,RAIPUR,292,0,BHUBANESWAR-RAIPUR,292,All
2021,10,BHUBANESWAR,RAIPUR,357,0,BHUBANESWAR-RAIPUR,357,All
2021,11,BHUBANESWAR,RAIPUR,1459,1304,BHUBANESWAR-RAIPUR,2763,All
2021,12,BHUBANESWAR,RAIPUR,2375,2033,BHUBANESWAR-RAIPUR,4408,All
2022,1,BHUBANESWAR,RAIPUR,942,764,BHUBANESWAR-RAIPUR,1706,All
2022,2,BHUBANESWAR,RAIPUR,368,9,BHUBANESWAR-RAIPUR,377,All
2022,3,BHUBANESWAR,RAIPUR,1705,1456,BHUBANESWAR-RAIPUR,3161,All
2022,4,BHUBANESWAR,RAIPUR,1994,1609,BHUBANESWAR-RAIPUR,3603,All
2022,5,BHUBANESWAR,RAIPUR,2061,1573,BHUBANESWAR-RAIPUR,3634,All
2022,6,BHUBANESWAR,RAIPUR,2107,1858,BHUBANESWAR-RAIPUR,3965,All
2022,7,BHUBANESWAR,RAIPUR,862,687,BHUBANESWAR-RAIPUR,1549,All
2022,8,BHUBANESWAR,RAIPUR,1398,1264,BHUBANESWAR-RAIPUR,2662,All
2022,9,BHUBANESWAR,RAIPUR,296,206,BHUBANESWAR-RAIPUR,502,All
2022,10,BHUBANESWAR,RAIPUR,1830,1842,BHUBANESWAR-RAIPUR,3672,All
2022,11,BHUBANESWAR,RAIPUR,1967,2163,BHUBANESWAR-RAIPUR,4130,All
2022,12,BHUBANESWAR,RAIPUR,1786,2060,BHUBANESWAR-RAIPUR,3846,All
2023,1,BHUBANESWAR,RAIPUR,1638,1986,BHUBANESWAR-RAIPUR,3624,All
2023,2,BHUBANESWAR,RAIPUR,1792,1919,BHUBANESWAR-RAIPUR,3711,All
2023,3,BHUBANESWAR,RAIPUR,1954,1962,BHUBANESWAR-RAIPUR,3916,All
2023,4,BHUBANESWAR,RAIPUR,1451,1563,BHUBANESWAR-RAIPUR,3014,All
2023,6,BHUBANESWAR,RAIPUR,1201,1132,BHUBANESWAR-RAIPUR,2333,All
2023,7,BHUBANESWAR,RAIPUR,2046,2113,BHUBANESWAR-RAIPUR,4159,All
2023,8,BHUBANESWAR,RAIPUR,2227,2235,BHUBANESWAR-RAIPUR,4462,All
2023,9,BHUBANESWAR,RAIPUR,2134,2335,BHUBANESWAR-RAIPUR,4469,All
2023,10,BHUBANESWAR,RAIPUR,2239,2094,BHUBANESWAR-RAIPUR,4333,All
2023,11,BHUBANESWAR,RAIPUR,2064,2108,BHUBANESWAR-RAIPUR,4172,All
2023,12,BHUBANESWAR,RAIPUR,1828,1781,BHUBANESWAR-RAIPUR,3609,All
2024,1,BHUBANESWAR,RAIPUR,2062,1987,BHUBANESWAR-RAIPUR,4049,All
2024,2,BHUBANESWAR,RAIPUR,1772,1738,BHUBANESWAR-RAIPUR,3510,All
2024,3,BHUBANESWAR,RAIPUR,1998,2104,BHUBANESWAR-RAIPUR,4102,All
2024,4,BHUBANESWAR,RAIPUR,2588,2936,BHUBANESWAR-RAIPUR,5524,All
2024,6,BHUBANESWAR,RAIPUR,2851,3603,BHUBANESWAR-RAIPUR,6454,All
2024,7,BHUBANESWAR,RAIPUR,2864,3415,BHUBANESWAR-RAIPUR,6279,All
2024,8,BHUBANESWAR,RAIPUR,3053,3401,BHUBANESWAR-RAIPUR,6454,All
2024,9,BHUBANESWAR,RAIPUR,2884,3406,BHUBANESWAR-RAIPUR,6290,All
2024,10,BHUBANESWAR,RAIPUR,3219,3088,BHUBANESWAR-RAIPUR,6307,All
2024,11,BHUBANESWAR,RAIPUR,3529,3820,BHUBANESWAR-RAIPUR,7349,All
2024,12,BHUBANESWAR,RAIPUR,3354,3421,BHUBANESWAR-RAIPUR,6775,All
2025,1,BHUBANESWAR,RAIPUR,3466,3463,BHUBANESWAR-RAIPUR,6929,All
2025,2,BHUBANESWAR,RAIPUR,3746,3328,BHUBANESWAR-RAIPUR,7074,All
2025,3,BHUBANESWAR,RAIPUR,2989,3033,BHUBANESWAR-RAIPUR,6022,All
2017,10,BHUBANESWAR,RANCHI,2002,2257,BHUBANESWAR-RANCHI,4259,All
2017,11,BHUBANESWAR,RANCHI,3620,4024,BHUBANESWAR-RANCHI,7644,All
2017,12,BHUBANESWAR,RANCHI,3484,3731,BHUBANESWAR-RANCHI,7215,All
2018,1,BHUBANESWAR,RANCHI,3481,3712,BHUBANESWAR-RANCHI,7193,All
2018,2,BHUBANESWAR,RANCHI,3142,2942,BHUBANESWAR-RANCHI,6084,All
2018,3,BHUBANESWAR,RANCHI,3140,3599,BHUBANESWAR-RANCHI,6739,All
2018,4,BHUBANESWAR,RANCHI,3599,3112,BHUBANESWAR-RANCHI,6711,All
2018,5,BHUBANESWAR,RANCHI,3362,3607,BHUBANESWAR-RANCHI,6969,All
2018,6,BHUBANESWAR,RANCHI,4080,4517,BHUBANESWAR-RANCHI,8597,All
2018,7,BHUBANESWAR,RANCHI,3803,3659,BHUBANESWAR-RANCHI,7462,All
2019,1,BHUBANESWAR,RANCHI,1402,1492,BHUBANESWAR-RANCHI,2894,All
2019,3,BHUBANESWAR,RANCHI,1037,1119,BHUBANESWAR-RANCHI,2156,All
2019,4,BHUBANESWAR,RANCHI,1039,1159,BHUBANESWAR-RANCHI,2198,All
2019,5,BHUBANESWAR,RANCHI,1040,1225,BHUBANESWAR-RANCHI,2265,All
2019,6,BHUBANESWAR,RANCHI,1210,1240,BHUBANESWAR-RANCHI,2450,All
2019,7,BHUBANESWAR,RANCHI,1047,1161,BHUBANESWAR-RANCHI,2208,All
2019,8,BHUBANESWAR,RANCHI,1059,1202,BHUBANESWAR-RANCHI,2261,All
2019,9,BHUBANESWAR,RANCHI,1012,1137,BHUBANESWAR-RANCHI,2149,All
2019,10,BHUBANESWAR,RANCHI,1273,1145,BHUBANESWAR-RANCHI,2418,All
2019,11,BHUBANESWAR,RANCHI,959,1023,BHUBANESWAR-RANCHI,1982,All
2019,12,BHUBANESWAR,RANCHI,1137,1107,BHUBANESWAR-RANCHI,2244,All
2020,1,BHUBANESWAR,RANCHI,1130,1227,BHUBANESWAR-RANCHI,2357,All
2020,2,BHUBANESWAR,RANCHI,650,733,BHUBANESWAR-RANCHI,1383,All
2020,3,BHUBANESWAR,RANCHI,588,452,BHUBANESWAR-RANCHI,1040,All
2020,6,BHUBANESWAR,RANCHI,0,0,BHUBANESWAR-RANCHI,0,All
2021,8,BHUBANESWAR,RANCHI,263,369,BHUBANESWAR-RANCHI,632,All
2021,9,BHUBANESWAR,RANCHI,543,578,BHUBANESWAR-RANCHI,1121,All
2021,10,BHUBANESWAR,RANCHI,553,524,BHUBANESWAR-RANCHI,1077,All
2021,11,BHUBANESWAR,RANCHI,362,411,BHUBANESWAR-RANCHI,773,All
2021,12,BHUBANESWAR,RANCHI,494,529,BHUBANESWAR-RANCHI,1023,All
2022,1,BHUBANESWAR,RANCHI,263,206,BHUBANESWAR-RANCHI,469,All
2022,2,BHUBANESWAR,RANCHI,337,441,BHUBANESWAR-RANCHI,778,All
2022,3,BHUBANESWAR,RANCHI,369,422,BHUBANESWAR-RANCHI,791,All
2022,4,BHUBANESWAR,RANCHI,362,418,BHUBANESWAR-RANCHI,780,All
2022,5,BHUBANESWAR,RANCHI,494,529,BHUBANESWAR-RANCHI,1023,All
2022,6,BHUBANESWAR,RANCHI,362,411,BHUBANESWAR-RANCHI,773,All
2022,7,BHUBANESWAR,RANCHI,337,441,BHUBANESWAR-RANCHI,778,All
2022,8,BHUBANESWAR,RANCHI,610,529,BHUBANESWAR-RANCHI,1139,All
2022,9,BHUBANESWAR,RANCHI,362,411,BHUBANESWAR-RANCHI,773,All
2022,10,BHUBANESWAR,RANCHI,443,510,BHUBANESWAR-RANCHI,953,All
2022,11,BHUBANESWAR,RANCHI,1531,2123,BHUBANESWAR-RANCHI,3654,All
2022,12,BHUBANESWAR,RANCHI,1987,2025,BHUBANESWAR-RANCHI,4012,All
2023,1,BHUBANESWAR,RANCHI,1648,1867,BHUBANESWAR-RANCHI,3515,All
2023,2,BHUBANESWAR,RANCHI,1565,1687,BHUBANESWAR-RANCHI,3252,All
2023,3,BHUBANESWAR,RANCHI,1491,1683,BHUBANESWAR-RANCHI,3174,All
2023,4,BHUBANESWAR,RANCHI,1317,1304,BHUBANESWAR-RANCHI,2621,All
2023,6,BHUBANESWAR,RANCHI,686,763,BHUBANESWAR-RANCHI,1449,All
2023,7,BHUBANESWAR,RANCHI,1070,1121,BHUBANESWAR-RANCHI,2191,All
2023,8,BHUBANESWAR,RANCHI,1538,1313,BHUBANESWAR-RANCHI,2851,All
2023,9,BHUBANESWAR,RANCHI,1648,1557,BHUBANESWAR-RANCHI,3205,All
2023,10,BHUBANESWAR,RANCHI,1630,1353,BHUBANESWAR-RANCHI,2983,All
2023,11,BHUBANESWAR,RANCHI,1336,1497,BHUBANESWAR-RANCHI,2833,All
2023,12,BHUBANESWAR,RANCHI,1380,1517,BHUBANESWAR-RANCHI,2897,All
2024,1,BHUBANESWAR,RANCHI,1317,1295,BHUBANESWAR-RANCHI,2612,All
2024,2,BHUBANESWAR,RANCHI,1244,1432,BHUBANESWAR-RANCHI,2676,All
2024,3,BHUBANESWAR,RANCHI,1460,1461,BHUBANESWAR-RANCHI,2921,All
2024,4,BHUBANESWAR,RANCHI,869,788,BHUBANESWAR-RANCHI,1657,All
2024,6,BHUBANESWAR,RANCHI,667,678,BHUBANESWAR-RANCHI,1345,All
2024,7,BHUBANESWAR,RANCHI,1194,1184,BHUBANESWAR-RANCHI,2378,All
2024,8,BHUBANESWAR,RANCHI,1449,1296,BHUBANESWAR-RANCHI,2745,All
2024,9,BHUBANESWAR,RANCHI,1260,1139,BHUBANESWAR-RANCHI,2399,All
2024,10,BHUBANESWAR,RANCHI,1717,1365,BHUBANESWAR-RANCHI,3082,All
2024,11,BHUBANESWAR,RANCHI,1576,1923,BHUBANESWAR-RANCHI,3499,All
2024,12,BHUBANESWAR,RANCHI,1850,2086,BHUBANESWAR-RANCHI,3936,All
2025,1,BHUBANESWAR,RANCHI,1877,1919,BHUBANESWAR-RANCHI,3796,All
2025,2,BHUBANESWAR,RANCHI,1848,1757,BHUBANESWAR-RANCHI,3605,All
2025,3,BHUBANESWAR,RANCHI,1938,1794,BHUBANESWAR-RANCHI,3732,All
2023,1,BHUBANESWAR,ROURKELA,1028,1170,BHUBANESWAR-ROURKELA,2198,All
2023,2,BHUBANESWAR,ROURKELA,1295,1296,BHUBANESWAR-ROURKELA,2591,All
2023,3,BHUBANESWAR,ROURKELA,1172,1181,BHUBANESWAR-ROURKELA,2353,All
2023,4,BHUBANESWAR,ROURKELA,1245,1284,BHUBANESWAR-ROURKELA,2529,All
2023,5,BHUBANESWAR,ROURKELA,1344,1314,BHUBANESWAR-ROURKELA,2658,All
2023,6,BHUBANESWAR,ROURKELA,1325,1291,BHUBANESWAR-ROURKELA,2616,All
2023,7,BHUBANESWAR,ROURKELA,951,813,BHUBANESWAR-ROURKELA,1764,All
2023,8,BHUBANESWAR,ROURKELA,1077,1067,BHUBANESWAR-ROURKELA,2144,All
2023,9,BHUBANESWAR,ROURKELA,1227,1162,BHUBANESWAR-ROURKELA,2389,All
2023,10,BHUBANESWAR,ROURKELA,879,807,BHUBANESWAR-ROURKELA,1686,All
2023,11,BHUBANESWAR,ROURKELA,1146,1078,BHUBANESWAR-ROURKELA,2224,All
2023,12,BHUBANESWAR,ROURKELA,1034,988,BHUBANESWAR-ROURKELA,2022,All
2024,1,BHUBANESWAR,ROURKELA,36,85,BHUBANESWAR-ROURKELA,121,All
2024,2,BHUBANESWAR,ROURKELA,760,809,BHUBANESWAR-ROURKELA,1569,All
2024,3,BHUBANESWAR,ROURKELA,1368,1471,BHUBANESWAR-ROURKELA,2839,All
2024,4,BHUBANESWAR,ROURKELA,1742,1654,BHUBANESWAR-ROURKELA,3396,All
2024,6,BHUBANESWAR,ROURKELA,1679,1597,BHUBANESWAR-ROURKELA,3276,All
2024,7,BHUBANESWAR,ROURKELA,1479,1397,BHUBANESWAR-ROURKELA,2876,All
2024,8,BHUBANESWAR,ROURKELA,1680,1811,BHUBANESWAR-ROURKELA,3491,All
2024,9,BHUBANESWAR,ROURKELA,1429,1525,BHUBANESWAR-ROURKELA,2954,All
2024,10,BHUBANESWAR,ROURKELA,1295,1392,BHUBANESWAR-ROURKELA,2687,All
2024,11,BHUBANESWAR,ROURKELA,1075,1223,BHUBANESWAR-ROURKELA,2298,All
2024,12,BHUBANESWAR,ROURKELA,986,941,BHUBANESWAR-ROURKELA,1927,All
2025,1,BHUBANESWAR,ROURKELA,847,893,BHUBANESWAR-ROURKELA,1740,All
2025,2,BHUBANESWAR,ROURKELA,876,846,BHUBANESWAR-ROURKELA,1722,All
2025,3,BHUBANESWAR,ROURKELA,883,1013,BHUBANESWAR-ROURKELA,1896,All
2019,10,BHUBANESWAR,SILCHAR,67,69,BHUBANESWAR-SILCHAR,136,All
2019,11,BHUBANESWAR,SILCHAR,22,18,BHUBANESWAR-SILCHAR,40,All
2019,12,BHUBANESWAR,SILCHAR,144,154,BHUBANESWAR-SILCHAR,298,All
2020,1,BHUBANESWAR,SILCHAR,195,194,BHUBANESWAR-SILCHAR,389,All
2020,2,BHUBANESWAR,SILCHAR,123,125,BHUBANESWAR-SILCHAR,248,All
2020,3,BHUBANESWAR,SILCHAR,140,153,BHUBANESWAR-SILCHAR,293,All
2017,12,BHUBANESWAR,SRINAGAR,0,5,BHUBANESWAR-SRINAGAR,5,All
2018,1,BHUBANESWAR,SRINAGAR,0,47,BHUBANESWAR-SRINAGAR,47,All
2025,3,BHUBANESWAR,SRINAGAR,630,499,BHUBANESWAR-SRINAGAR,1129,All
2018,10,BHUBANESWAR,SURAT,4,0,BHUBANESWAR-SURAT,4,All
2018,11,BHUBANESWAR,SURAT,88,0,BHUBANESWAR-SURAT,88,All
2018,12,BHUBANESWAR,SURAT,213,0,BHUBANESWAR-SURAT,213,All
2019,1,BHUBANESWAR,SURAT,214,0,BHUBANESWAR-SURAT,214,All
2019,2,BHUBANESWAR,SURAT,166,0,BHUBANESWAR-SURAT,166,All
2019,3,BHUBANESWAR,SURAT,217,0,BHUBANESWAR-SURAT,217,All
2019,4,BHUBANESWAR,SURAT,191,0,BHUBANESWAR-SURAT,191,All
2019,5,BHUBANESWAR,SURAT,142,0,BHUBANESWAR-SURAT,142,All
2019,6,BHUBANESWAR,SURAT,282,0,BHUBANESWAR-SURAT,282,All
2019,7,BHUBANESWAR,SURAT,158,0,BHUBANESWAR-SURAT,158,All
2019,8,BHUBANESWAR,SURAT,176,0,BHUBANESWAR-SURAT,176,All
2019,9,BHUBANESWAR,SURAT,0,67,BHUBANESWAR-SURAT,67,All
2019,10,BHUBANESWAR,SURAT,171,199,BHUBANESWAR-SURAT,370,All
2019,11,BHUBANESWAR,SURAT,282,89,BHUBANESWAR-SURAT,371,All
2019,12,BHUBANESWAR,SURAT,477,87,BHUBANESWAR-SURAT,564,All
2020,1,BHUBANESWAR,SURAT,695,318,BHUBANESWAR-SURAT,1013,All
2020,2,BHUBANESWAR,SURAT,708,604,BHUBANESWAR-SURAT,1312,All
2020,3,BHUBANESWAR,SURAT,442,515,BHUBANESWAR-SURAT,957,All
2020,5,BHUBANESWAR,SURAT,0,0,BHUBANESWAR-SURAT,0,All
2020,9,BHUBANESWAR,SURAT,669,472,BHUBANESWAR-SURAT,1141,All
2020,10,BHUBANESWAR,SURAT,1043,763,BHUBANESWAR-SURAT,1806,All
2020,11,BHUBANESWAR,SURAT,1022,998,BHUBANESWAR-SURAT,2020,All
2020,12,BHUBANESWAR,SURAT,1011,887,BHUBANESWAR-SURAT,1898,All
2021,1,BHUBANESWAR,SURAT,914,750,BHUBANESWAR-SURAT,1664,All
2021,2,BHUBANESWAR,SURAT,893,1025,BHUBANESWAR-SURAT,1918,All
2021,3,BHUBANESWAR,SURAT,936,1039,BHUBANESWAR-SURAT,1975,All
2021,4,BHUBANESWAR,SURAT,408,745,BHUBANESWAR-SURAT,1153,All
2021,6,BHUBANESWAR,SURAT,564,505,BHUBANESWAR-SURAT,1069,All
2021,7,BHUBANESWAR,SURAT,632,524,BHUBANESWAR-SURAT,1156,All
2021,8,BHUBANESWAR,SURAT,651,688,BHUBANESWAR-SURAT,1339,All
2021,9,BHUBANESWAR,SURAT,634,670,BHUBANESWAR-SURAT,1304,All
2021,10,BHUBANESWAR,SURAT,548,768,BHUBANESWAR-SURAT,1316,All
2021,11,BHUBANESWAR,SURAT,796,1173,BHUBANESWAR-SURAT,1969,All
2021,12,BHUBANESWAR,SURAT,787,683,BHUBANESWAR-SURAT,1470,All
2022,1,BHUBANESWAR,SURAT,554,470,BHUBANESWAR-SURAT,1024,All
2022,2,BHUBANESWAR,SURAT,419,346,BHUBANESWAR-SURAT,765,All
2022,3,BHUBANESWAR,SURAT,210,272,BHUBANESWAR-SURAT,482,All
2019,10,BHUBANESWAR,TRIVANDRUM,0,21,BHUBANESWAR-TRIVANDRUM,21,All
2019,11,BHUBANESWAR,TRIVANDRUM,0,248,BHUBANESWAR-TRIVANDRUM,248,All
2019,12,BHUBANESWAR,TRIVANDRUM,0,332,BHUBANESWAR-TRIVANDRUM,332,All
2020,1,BHUBANESWAR,TRIVANDRUM,0,492,BHUBANESWAR-TRIVANDRUM,492,All
2020,2,BHUBANESWAR,TRIVANDRUM,0,384,BHUBANESWAR-TRIVANDRUM,384,All
2020,3,BHUBANESWAR,TRIVANDRUM,0,197,BHUBANESWAR-TRIVANDRUM,197,All
2023,8,BHUBANESWAR,Utkela,9,6,BHUBANESWAR-Utkela,15,All
2023,9,BHUBANESWAR,Utkela,41,62,BHUBANESWAR-Utkela,103,All
2023,11,BHUBANESWAR,Utkela,61,93,BHUBANESWAR-Utkela,154,All
2023,12,BHUBANESWAR,Utkela,62,103,BHUBANESWAR-Utkela,165,All
2024,1,BHUBANESWAR,Utkela,59,98,BHUBANESWAR-Utkela,157,All
2024,2,BHUBANESWAR,Utkela,64,96,BHUBANESWAR-Utkela,160,All
2024,3,BHUBANESWAR,Utkela,62,97,BHUBANESWAR-Utkela,159,All
2024,4,BHUBANESWAR,Utkela,64,85,BHUBANESWAR-Utkela,149,All
2024,6,BHUBANESWAR,Utkela,46,69,BHUBANESWAR-Utkela,115,All
2024,7,BHUBANESWAR,Utkela,61,84,BHUBANESWAR-Utkela,145,All
2024,8,BHUBANESWAR,Utkela,60,94,BHUBANESWAR-Utkela,154,All
2024,9,BHUBANESWAR,Utkela,79,114,BHUBANESWAR-Utkela,193,All
2024,10,BHUBANESWAR,Utkela,97,111,BHUBANESWAR-Utkela,208,All
2024,11,BHUBANESWAR,Utkela,96,143,BHUBANESWAR-Utkela,239,All
2024,12,BHUBANESWAR,Utkela,138,188,BHUBANESWAR-Utkela,326,All
2025,1,BHUBANESWAR,Utkela,128,152,BHUBANESWAR-Utkela,280,All
2025,2,BHUBANESWAR,Utkela,123,146,BHUBANESWAR-Utkela,269,All
2025,3,BHUBANESWAR,Utkela,118,147,BHUBANESWAR-Utkela,265,All
2017,6,BHUBANESWAR,VADODARA,0,38,BHUBANESWAR-VADODARA,38,All
2017,10,BHUBANESWAR,VADODARA,0,89,BHUBANESWAR-VADODARA,89,All
2017,11,BHUBANESWAR,VADODARA,0,117,BHUBANESWAR-VADODARA,117,All
2017,12,BHUBANESWAR,VADODARA,0,80,BHUBANESWAR-VADODARA,80,All
2018,2,BHUBANESWAR,VADODARA,0,229,BHUBANESWAR-VADODARA,229,All
2018,3,BHUBANESWAR,VADODARA,0,208,BHUBANESWAR-VADODARA,208,All
2018,4,BHUBANESWAR,VADODARA,0,263,BHUBANESWAR-VADODARA,263,All
2018,5,BHUBANESWAR,VADODARA,0,245,BHUBANESWAR-VADODARA,245,All
2018,6,BHUBANESWAR,VADODARA,0,216,BHUBANESWAR-VADODARA,216,All
2018,7,BHUBANESWAR,VADODARA,0,147,BHUBANESWAR-VADODARA,147,All
2018,8,BHUBANESWAR,VADODARA,0,151,BHUBANESWAR-VADODARA,151,All
2018,9,BHUBANESWAR,VADODARA,0,112,BHUBANESWAR-VADODARA,112,All
2018,10,BHUBANESWAR,VADODARA,0,157,BHUBANESWAR-VADODARA,157,All
2018,11,BHUBANESWAR,VADODARA,0,208,BHUBANESWAR-VADODARA,208,All
2018,12,BHUBANESWAR,VADODARA,0,162,BHUBANESWAR-VADODARA,162,All
2015,11,BHUBANESWAR,VARANASI,562,591,BHUBANESWAR-VARANASI,1153,All
2015,12,BHUBANESWAR,VARANASI,1043,1330,BHUBANESWAR-VARANASI,2373,All
2016,1,BHUBANESWAR,VARANASI,1046,1051,BHUBANESWAR-VARANASI,2097,All
2016,2,BHUBANESWAR,VARANASI,949,869,BHUBANESWAR-VARANASI,1818,All
2016,3,BHUBANESWAR,VARANASI,1190,1251,BHUBANESWAR-VARANASI,2441,All
2016,4,BHUBANESWAR,VARANASI,1398,1164,BHUBANESWAR-VARANASI,2562,All
2016,5,BHUBANESWAR,VARANASI,1269,1306,BHUBANESWAR-VARANASI,2575,All
2016,6,BHUBANESWAR,VARANASI,825,1103,BHUBANESWAR-VARANASI,1928,All
2016,7,BHUBANESWAR,VARANASI,1310,1562,BHUBANESWAR-VARANASI,2872,All
2016,8,BHUBANESWAR,VARANASI,1277,1408,BHUBANESWAR-VARANASI,2685,All
2016,9,BHUBANESWAR,VARANASI,1372,1386,BHUBANESWAR-VARANASI,2758,All
2016,10,BHUBANESWAR,VARANASI,1210,1083,BHUBANESWAR-VARANASI,2293,All
2016,11,BHUBANESWAR,VARANASI,1030,1112,BHUBANESWAR-VARANASI,2142,All
2016,12,BHUBANESWAR,VARANASI,1529,1849,BHUBANESWAR-VARANASI,3378,All
2017,1,BHUBANESWAR,VARANASI,1453,1556,BHUBANESWAR-VARANASI,3009,All
2017,2,BHUBANESWAR,VARANASI,1288,1286,BHUBANESWAR-VARANASI,2574,All
2017,3,BHUBANESWAR,VARANASI,421,392,BHUBANESWAR-VARANASI,813,All
2018,12,BHUBANESWAR,VARANASI,37,75,BHUBANESWAR-VARANASI,112,All
2019,1,BHUBANESWAR,VARANASI,368,385,BHUBANESWAR-VARANASI,753,All
2019,2,BHUBANESWAR,VARANASI,431,410,BHUBANESWAR-VARANASI,841,All
2019,3,BHUBANESWAR,VARANASI,399,394,BHUBANESWAR-VARANASI,793,All
2019,4,BHUBANESWAR,VARANASI,168,174,BHUBANESWAR-VARANASI,342,All
2019,5,BHUBANESWAR,VARANASI,119,124,BHUBANESWAR-VARANASI,243,All
2019,6,BHUBANESWAR,VARANASI,314,205,BHUBANESWAR-VARANASI,519,All
2019,7,BHUBANESWAR,VARANASI,241,156,BHUBANESWAR-VARANASI,397,All
2019,8,BHUBANESWAR,VARANASI,248,241,BHUBANESWAR-VARANASI,489,All
2020,1,BHUBANESWAR,VARANASI,35,35,BHUBANESWAR-VARANASI,70,All
2020,2,BHUBANESWAR,VARANASI,1324,1265,BHUBANESWAR-VARANASI,2589,All
2020,3,BHUBANESWAR,VARANASI,2317,2070,BHUBANESWAR-VARANASI,4387,All
2020,11,BHUBANESWAR,VARANASI,0,102,BHUBANESWAR-VARANASI,102,All
2020,12,BHUBANESWAR,VARANASI,3568,943,BHUBANESWAR-VARANASI,4511,All
2021,1,BHUBANESWAR,VARANASI,0,345,BHUBANESWAR-VARANASI,345,All
2021,2,BHUBANESWAR,VARANASI,0,84,BHUBANESWAR-VARANASI,84,All
2021,3,BHUBANESWAR,VARANASI,211,267,BHUBANESWAR-VARANASI,478,All
2021,4,BHUBANESWAR,VARANASI,842,692,BHUBANESWAR-VARANASI,1534,All
2021,6,BHUBANESWAR,VARANASI,378,388,BHUBANESWAR-VARANASI,766,All
2021,7,BHUBANESWAR,VARANASI,966,657,BHUBANESWAR-VARANASI,1623,All
2021,8,BHUBANESWAR,VARANASI,1132,959,BHUBANESWAR-VARANASI,2091,All
2021,9,BHUBANESWAR,VARANASI,1167,1196,BHUBANESWAR-VARANASI,2363,All
2021,10,BHUBANESWAR,VARANASI,1571,1673,BHUBANESWAR-VARANASI,3244,All
2021,11,BHUBANESWAR,VARANASI,1990,2037,BHUBANESWAR-VARANASI,4027,All
2021,12,BHUBANESWAR,VARANASI,1754,2010,BHUBANESWAR-VARANASI,3764,All
2022,1,BHUBANESWAR,VARANASI,769,636,BHUBANESWAR-VARANASI,1405,All
2022,2,BHUBANESWAR,VARANASI,1004,985,BHUBANESWAR-VARANASI,1989,All
2022,3,BHUBANESWAR,VARANASI,1898,1886,BHUBANESWAR-VARANASI,3784,All
2022,4,BHUBANESWAR,VARANASI,1817,1964,BHUBANESWAR-VARANASI,3781,All
2022,5,BHUBANESWAR,VARANASI,1556,1863,BHUBANESWAR-VARANASI,3419,All
2022,6,BHUBANESWAR,VARANASI,748,896,BHUBANESWAR-VARANASI,1644,All
2022,7,BHUBANESWAR,VARANASI,1436,1561,BHUBANESWAR-VARANASI,2997,All
2022,8,BHUBANESWAR,VARANASI,1525,1527,BHUBANESWAR-VARANASI,3052,All
2022,9,BHUBANESWAR,VARANASI,1624,1601,BHUBANESWAR-VARANASI,3225,All
2022,10,BHUBANESWAR,VARANASI,2022,1995,BHUBANESWAR-VARANASI,4017,All
2022,11,BHUBANESWAR,VARANASI,1985,2091,BHUBANESWAR-VARANASI,4076,All
2022,12,BHUBANESWAR,VARANASI,1789,2021,BHUBANESWAR-VARANASI,3810,All
2023,1,BHUBANESWAR,VARANASI,1656,1608,BHUBANESWAR-VARANASI,3264,All
2023,2,BHUBANESWAR,VARANASI,1702,1741,BHUBANESWAR-VARANASI,3443,All
2023,3,BHUBANESWAR,VARANASI,1909,1947,BHUBANESWAR-VARANASI,3856,All
2023,4,BHUBANESWAR,VARANASI,1851,1863,BHUBANESWAR-VARANASI,3714,All
2023,5,BHUBANESWAR,VARANASI,2041,1985,BHUBANESWAR-VARANASI,4026,All
2023,6,BHUBANESWAR,VARANASI,1883,2097,BHUBANESWAR-VARANASI,3980,All
2023,7,BHUBANESWAR,VARANASI,1727,1823,BHUBANESWAR-VARANASI,3550,All
2023,8,BHUBANESWAR,VARANASI,1945,1984,BHUBANESWAR-VARANASI,3929,All
2023,9,BHUBANESWAR,VARANASI,1976,2002,BHUBANESWAR-VARANASI,3978,All
2023,10,BHUBANESWAR,VARANASI,2117,2086,BHUBANESWAR-VARANASI,4203,All
2023,11,BHUBANESWAR,VARANASI,2011,2001,BHUBANESWAR-VARANASI,4012,All
2023,12,BHUBANESWAR,VARANASI,1722,1740,BHUBANESWAR-VARANASI,3462,All
2024,1,BHUBANESWAR,VARANASI,749,491,BHUBANESWAR-VARANASI,1240,All
2024,2,BHUBANESWAR,VARANASI,1962,1914,BHUBANESWAR-VARANASI,3876,All
2024,3,BHUBANESWAR,VARANASI,2180,2189,BHUBANESWAR-VARANASI,4369,All
2024,4,BHUBANESWAR,VARANASI,2195,2122,BHUBANESWAR-VARANASI,4317,All
2024,6,BHUBANESWAR,VARANASI,1991,2058,BHUBANESWAR-VARANASI,4049,All
2024,7,BHUBANESWAR,VARANASI,1972,1999,BHUBANESWAR-VARANASI,3971,All
2024,8,BHUBANESWAR,VARANASI,1986,2051,BHUBANESWAR-VARANASI,4037,All
2024,9,BHUBANESWAR,VARANASI,1237,1205,BHUBANESWAR-VARANASI,2442,All
2024,10,BHUBANESWAR,VARANASI,1162,1148,BHUBANESWAR-VARANASI,2310,All
2024,11,BHUBANESWAR,VARANASI,1210,1289,BHUBANESWAR-VARANASI,2499,All
2024,12,BHUBANESWAR,VARANASI,1282,1349,BHUBANESWAR-VARANASI,2631,All
2025,1,BHUBANESWAR,VARANASI,1343,1341,BHUBANESWAR-VARANASI,2684,All
2025,2,BHUBANESWAR,VARANASI,1185,1214,BHUBANESWAR-VARANASI,2399,All
2025,3,BHUBANESWAR,VARANASI,1347,1372,BHUBANESWAR-VARANASI,2719,All
2015,4,BHUBANESWAR,VISAKHAPATNAM,413,554,BHUBANESWAR-VISAKHAPATNAM,967,All
2015,5,BHUBANESWAR,VISAKHAPATNAM,588,729,BHUBANESWAR-VISAKHAPATNAM,1317,All
2015,6,BHUBANESWAR,VISAKHAPATNAM,497,624,BHUBANESWAR-VISAKHAPATNAM,1121,All
2015,7,BHUBANESWAR,VISAKHAPATNAM,537,625,BHUBANESWAR-VISAKHAPATNAM,1162,All
2015,8,BHUBANESWAR,VISAKHAPATNAM,769,673,BHUBANESWAR-VISAKHAPATNAM,1442,All
2015,9,BHUBANESWAR,VISAKHAPATNAM,616,635,BHUBANESWAR-VISAKHAPATNAM,1251,All
2015,10,BHUBANESWAR,VISAKHAPATNAM,861,756,BHUBANESWAR-VISAKHAPATNAM,1617,All
2015,11,BHUBANESWAR,VISAKHAPATNAM,693,654,BHUBANESWAR-VISAKHAPATNAM,1347,All
2015,12,BHUBANESWAR,VISAKHAPATNAM,730,800,BHUBANESWAR-VISAKHAPATNAM,1530,All
2016,1,BHUBANESWAR,VISAKHAPATNAM,677,561,BHUBANESWAR-VISAKHAPATNAM,1238,All
2016,2,BHUBANESWAR,VISAKHAPATNAM,735,729,BHUBANESWAR-VISAKHAPATNAM,1464,All
2016,3,BHUBANESWAR,VISAKHAPATNAM,723,798,BHUBANESWAR-VISAKHAPATNAM,1521,All
2016,4,BHUBANESWAR,VISAKHAPATNAM,666,827,BHUBANESWAR-VISAKHAPATNAM,1493,All
2016,5,BHUBANESWAR,VISAKHAPATNAM,791,730,BHUBANESWAR-VISAKHAPATNAM,1521,All
2016,6,BHUBANESWAR,VISAKHAPATNAM,681,776,BHUBANESWAR-VISAKHAPATNAM,1457,All
2016,7,BHUBANESWAR,VISAKHAPATNAM,647,732,BHUBANESWAR-VISAKHAPATNAM,1379,All
2016,8,BHUBANESWAR,VISAKHAPATNAM,634,739,BHUBANESWAR-VISAKHAPATNAM,1373,All
2016,9,BHUBANESWAR,VISAKHAPATNAM,539,990,BHUBANESWAR-VISAKHAPATNAM,1529,All
2016,10,BHUBANESWAR,VISAKHAPATNAM,811,1258,BHUBANESWAR-VISAKHAPATNAM,2069,All
2016,11,BHUBANESWAR,VISAKHAPATNAM,951,940,BHUBANESWAR-VISAKHAPATNAM,1891,All
2016,12,BHUBANESWAR,VISAKHAPATNAM,827,925,BHUBANESWAR-VISAKHAPATNAM,1752,All
2017,1,BHUBANESWAR,VISAKHAPATNAM,703,817,BHUBANESWAR-VISAKHAPATNAM,1520,All
2017,2,BHUBANESWAR,VISAKHAPATNAM,674,907,BHUBANESWAR-VISAKHAPATNAM,1581,All
2017,3,BHUBANESWAR,VISAKHAPATNAM,532,1075,BHUBANESWAR-VISAKHAPATNAM,1607,All
2017,4,BHUBANESWAR,VISAKHAPATNAM,503,1615,BHUBANESWAR-VISAKHAPATNAM,2118,All
2017,5,BHUBANESWAR,VISAKHAPATNAM,1455,2122,BHUBANESWAR-VISAKHAPATNAM,3577,All
2017,6,BHUBANESWAR,VISAKHAPATNAM,1082,2619,BHUBANESWAR-VISAKHAPATNAM,3701,All
2017,7,BHUBANESWAR,VISAKHAPATNAM,817,1306,BHUBANESWAR-VISAKHAPATNAM,2123,All
2017,8,BHUBANESWAR,VISAKHAPATNAM,673,1138,BHUBANESWAR-VISAKHAPATNAM,1811,All
2017,9,BHUBANESWAR,VISAKHAPATNAM,772,1578,BHUBANESWAR-VISAKHAPATNAM,2350,All
2017,10,BHUBANESWAR,VISAKHAPATNAM,745,1523,BHUBANESWAR-VISAKHAPATNAM,2268,All
2017,11,BHUBANESWAR,VISAKHAPATNAM,888,1713,BHUBANESWAR-VISAKHAPATNAM,2601,All
2017,12,BHUBANESWAR,VISAKHAPATNAM,1956,994,BHUBANESWAR-VISAKHAPATNAM,2950,All
2018,1,BHUBANESWAR,VISAKHAPATNAM,2111,1267,BHUBANESWAR-VISAKHAPATNAM,3378,All
2018,2,BHUBANESWAR,VISAKHAPATNAM,787,1819,BHUBANESWAR-VISAKHAPATNAM,2606,All
2018,3,BHUBANESWAR,VISAKHAPATNAM,767,1745,BHUBANESWAR-VISAKHAPATNAM,2512,All
2018,4,BHUBANESWAR,VISAKHAPATNAM,897,1311,BHUBANESWAR-VISAKHAPATNAM,2208,All
2018,5,BHUBANESWAR,VISAKHAPATNAM,1495,1470,BHUBANESWAR-VISAKHAPATNAM,2965,All
2018,6,BHUBANESWAR,VISAKHAPATNAM,1039,1234,BHUBANESWAR-VISAKHAPATNAM,2273,All
2018,7,BHUBANESWAR,VISAKHAPATNAM,721,788,BHUBANESWAR-VISAKHAPATNAM,1509,All
2018,8,BHUBANESWAR,VISAKHAPATNAM,751,867,BHUBANESWAR-VISAKHAPATNAM,1618,All
2018,9,BHUBANESWAR,VISAKHAPATNAM,806,1005,BHUBANESWAR-VISAKHAPATNAM,1811,All
2018,10,BHUBANESWAR,VISAKHAPATNAM,1300,1474,BHUBANESWAR-VISAKHAPATNAM,2774,All
2018,11,BHUBANESWAR,VISAKHAPATNAM,1019,1035,BHUBANESWAR-VISAKHAPATNAM,2054,All
2018,12,BHUBANESWAR,VISAKHAPATNAM,1803,1589,BHUBANESWAR-VISAKHAPATNAM,3392,All
2019,1,BHUBANESWAR,VISAKHAPATNAM,1565,1684,BHUBANESWAR-VISAKHAPATNAM,3249,All
2019,2,BHUBANESWAR,VISAKHAPATNAM,1490,1627,BHUBANESWAR-VISAKHAPATNAM,3117,All
2019,3,BHUBANESWAR,VISAKHAPATNAM,1083,1243,BHUBANESWAR-VISAKHAPATNAM,2326,All
2020,7,BHUBANESWAR,VISAKHAPATNAM,6,8,BHUBANESWAR-VISAKHAPATNAM,14,All
2020,8,BHUBANESWAR,VISAKHAPATNAM,27,0,BHUBANESWAR-VISAKHAPATNAM,27,All
2020,9,BHUBANESWAR,VISAKHAPATNAM,0,3,BHUBANESWAR-VISAKHAPATNAM,3,All
2024,12,BHUBANESWAR,VISAKHAPATNAM,219,0,BHUBANESWAR-VISAKHAPATNAM,219,All
2015,4,BHUJ,DELHI,236,211,BHUJ-DELHI,447,All
2015,5,BHUJ,DELHI,312,308,BHUJ-DELHI,620,All
2015,6,BHUJ,DELHI,266,346,BHUJ-DELHI,612,All
2015,7,BHUJ,DELHI,309,367,BHUJ-DELHI,676,All
2015,8,BHUJ,DELHI,447,432,BHUJ-DELHI,879,All
2015,9,BHUJ,DELHI,335,403,BHUJ-DELHI,738,All
2015,10,BHUJ,DELHI,309,311,BHUJ-DELHI,620,All
2015,11,BHUJ,DELHI,365,372,BHUJ-DELHI,737,All
2015,12,BHUJ,DELHI,435,533,BHUJ-DELHI,968,All
2016,1,BHUJ,DELHI,405,491,BHUJ-DELHI,896,All
2016,2,BHUJ,DELHI,387,387,BHUJ-DELHI,774,All
2016,3,BHUJ,DELHI,354,426,BHUJ-DELHI,780,All
2016,4,BHUJ,DELHI,334,435,BHUJ-DELHI,769,All
2016,5,BHUJ,DELHI,528,466,BHUJ-DELHI,994,All
2016,6,BHUJ,DELHI,233,414,BHUJ-DELHI,647,All
2016,7,BHUJ,DELHI,291,310,BHUJ-DELHI,601,All
2016,8,BHUJ,DELHI,299,274,BHUJ-DELHI,573,All
2016,9,BHUJ,DELHI,367,333,BHUJ-DELHI,700,All
2016,10,BHUJ,DELHI,410,311,BHUJ-DELHI,721,All
2016,11,BHUJ,DELHI,364,440,BHUJ-DELHI,804,All
2016,12,BHUJ,DELHI,443,452,BHUJ-DELHI,895,All
2017,1,BHUJ,DELHI,455,422,BHUJ-DELHI,877,All
2017,2,BHUJ,DELHI,445,341,BHUJ-DELHI,786,All
2017,3,BHUJ,DELHI,420,299,BHUJ-DELHI,719,All
2017,6,BHUJ,DELHI,137,254,BHUJ-DELHI,391,All
2017,7,BHUJ,DELHI,201,245,BHUJ-DELHI,446,All
2017,8,BHUJ,DELHI,262,282,BHUJ-DELHI,544,All
2017,9,BHUJ,DELHI,207,241,BHUJ-DELHI,448,All
2017,10,BHUJ,DELHI,267,383,BHUJ-DELHI,650,All
2017,11,BHUJ,DELHI,356,387,BHUJ-DELHI,743,All
2017,12,BHUJ,DELHI,375,433,BHUJ-DELHI,808,All
2018,1,BHUJ,DELHI,372,356,BHUJ-DELHI,728,All
2018,2,BHUJ,DELHI,374,287,BHUJ-DELHI,661,All
2018,3,BHUJ,DELHI,227,182,BHUJ-DELHI,409,All
2025,2,BHUJ,DELHI,4889,4839,BHUJ-DELHI,9728,All
2025,3,BHUJ,DELHI,4522,4602,BHUJ-DELHI,9124,All
2020,6,BHUJ,DIU,1,1,BHUJ-DIU,2,All
2020,7,BHUJ,DIU,1,0,BHUJ-DIU,1,All
2020,8,BHUJ,DIU,2,2,BHUJ-DIU,4,All
2020,9,BHUJ,DIU,6,6,BHUJ-DIU,12,All
2023,5,BHUJ,DIU,0,38,BHUJ-DIU,38,All
2020,7,BHUJ,JAMNAGAR,19,0,BHUJ-JAMNAGAR,19,All
2015,4,BHUJ,MUMBAI,6275,5988,BHUJ-MUMBAI,12263,All
2015,5,BHUJ,MUMBAI,6163,4878,BHUJ-MUMBAI,11041,All
2015,6,BHUJ,MUMBAI,4759,4230,BHUJ-MUMBAI,8989,All
2015,7,BHUJ,MUMBAI,5083,4952,BHUJ-MUMBAI,10035,All
2015,8,BHUJ,MUMBAI,5675,5098,BHUJ-MUMBAI,10773,All
2015,9,BHUJ,MUMBAI,5532,5134,BHUJ-MUMBAI,10666,All
2015,10,BHUJ,MUMBAI,5958,5672,BHUJ-MUMBAI,11630,All
2015,11,BHUJ,MUMBAI,6021,6343,BHUJ-MUMBAI,12364,All
2015,12,BHUJ,MUMBAI,6801,6163,BHUJ-MUMBAI,12964,All
2016,1,BHUJ,MUMBAI,6580,5709,BHUJ-MUMBAI,12289,All
2016,2,BHUJ,MUMBAI,6101,5815,BHUJ-MUMBAI,11916,All
2016,3,BHUJ,MUMBAI,5889,5436,BHUJ-MUMBAI,11325,All
2016,4,BHUJ,MUMBAI,7336,6727,BHUJ-MUMBAI,14063,All
2016,5,BHUJ,MUMBAI,8007,6888,BHUJ-MUMBAI,14895,All
2016,6,BHUJ,MUMBAI,5927,5475,BHUJ-MUMBAI,11402,All
2016,7,BHUJ,MUMBAI,6726,6704,BHUJ-MUMBAI,13430,All
2016,8,BHUJ,MUMBAI,7318,6820,BHUJ-MUMBAI,14138,All
2016,9,BHUJ,MUMBAI,7108,7020,BHUJ-MUMBAI,14128,All
2016,10,BHUJ,MUMBAI,6880,7042,BHUJ-MUMBAI,13922,All
2016,11,BHUJ,MUMBAI,7492,7279,BHUJ-MUMBAI,14771,All
2016,12,BHUJ,MUMBAI,8412,8808,BHUJ-MUMBAI,17220,All
2017,1,BHUJ,MUMBAI,8975,8490,BHUJ-MUMBAI,17465,All
2017,2,BHUJ,MUMBAI,8151,8182,BHUJ-MUMBAI,16333,All
2017,3,BHUJ,MUMBAI,7100,6816,BHUJ-MUMBAI,13916,All
2017,4,BHUJ,MUMBAI,5115,5075,BHUJ-MUMBAI,10190,All
2017,5,BHUJ,MUMBAI,5380,4712,BHUJ-MUMBAI,10092,All
2017,6,BHUJ,MUMBAI,6096,6018,BHUJ-MUMBAI,12114,All
2017,7,BHUJ,MUMBAI,6639,6522,BHUJ-MUMBAI,13161,All
2017,8,BHUJ,MUMBAI,7078,6420,BHUJ-MUMBAI,13498,All
2017,9,BHUJ,MUMBAI,6572,6719,BHUJ-MUMBAI,13291,All
2017,10,BHUJ,MUMBAI,6714,7227,BHUJ-MUMBAI,13941,All
2017,11,BHUJ,MUMBAI,7457,8179,BHUJ-MUMBAI,15636,All
2017,12,BHUJ,MUMBAI,8240,8449,BHUJ-MUMBAI,16689,All
2018,1,BHUJ,MUMBAI,8983,8362,BHUJ-MUMBAI,17345,All
2018,2,BHUJ,MUMBAI,8202,8062,BHUJ-MUMBAI,16264,All
2018,3,BHUJ,MUMBAI,7943,8085,BHUJ-MUMBAI,16028,All
2018,4,BHUJ,MUMBAI,8074,7637,BHUJ-MUMBAI,15711,All
2018,5,BHUJ,MUMBAI,8268,6878,BHUJ-MUMBAI,15146,All
2018,6,BHUJ,MUMBAI,6922,6505,BHUJ-MUMBAI,13427,All
2018,7,BHUJ,MUMBAI,6492,7180,BHUJ-MUMBAI,13672,All
2018,8,BHUJ,MUMBAI,6476,6205,BHUJ-MUMBAI,12681,All
2018,9,BHUJ,MUMBAI,6967,6491,BHUJ-MUMBAI,13458,All
2018,10,BHUJ,MUMBAI,7954,8370,BHUJ-MUMBAI,16324,All
2018,11,BHUJ,MUMBAI,8390,9624,BHUJ-MUMBAI,18014,All
2018,12,BHUJ,MUMBAI,9185,9880,BHUJ-MUMBAI,19065,All
2019,1,BHUJ,MUMBAI,9561,9157,BHUJ-MUMBAI,18718,All
2019,2,BHUJ,MUMBAI,6719,7005,BHUJ-MUMBAI,13724,All
2019,3,BHUJ,MUMBAI,3095,3038,BHUJ-MUMBAI,6133,All
2019,4,BHUJ,MUMBAI,1088,1122,BHUJ-MUMBAI,2210,All
2019,5,BHUJ,MUMBAI,1070,1062,BHUJ-MUMBAI,2132,All
2019,6,BHUJ,MUMBAI,892,959,BHUJ-MUMBAI,1851,All
2019,7,BHUJ,MUMBAI,910,956,BHUJ-MUMBAI,1866,All
2019,8,BHUJ,MUMBAI,989,1030,BHUJ-MUMBAI,2019,All
2019,9,BHUJ,MUMBAI,994,1079,BHUJ-MUMBAI,2073,All
2019,10,BHUJ,MUMBAI,1146,1283,BHUJ-MUMBAI,2429,All
2019,11,BHUJ,MUMBAI,1697,1767,BHUJ-MUMBAI,3464,All
2019,12,BHUJ,MUMBAI,1664,1815,BHUJ-MUMBAI,3479,All
2020,1,BHUJ,MUMBAI,1674,1779,BHUJ-MUMBAI,3453,All
2020,2,BHUJ,MUMBAI,1859,1852,BHUJ-MUMBAI,3711,All
2020,3,BHUJ,MUMBAI,1269,1168,BHUJ-MUMBAI,2437,All
2020,5,BHUJ,MUMBAI,30,29,BHUJ-MUMBAI,59,All
2020,6,BHUJ,MUMBAI,349,392,BHUJ-MUMBAI,741,All
2020,7,BHUJ,MUMBAI,623,820,BHUJ-MUMBAI,1443,All
2020,8,BHUJ,MUMBAI,573,562,BHUJ-MUMBAI,1135,All
2020,9,BHUJ,MUMBAI,422,354,BHUJ-MUMBAI,776,All
2020,10,BHUJ,MUMBAI,420,478,BHUJ-MUMBAI,898,All
2020,11,BHUJ,MUMBAI,679,751,BHUJ-MUMBAI,1430,All
2020,12,BHUJ,MUMBAI,750,879,BHUJ-MUMBAI,1629,All
2021,1,BHUJ,MUMBAI,828,900,BHUJ-MUMBAI,1728,All
2021,2,BHUJ,MUMBAI,1237,1340,BHUJ-MUMBAI,2577,All
2021,3,BHUJ,MUMBAI,398,411,BHUJ-MUMBAI,809,All
2021,6,BHUJ,MUMBAI,299,305,BHUJ-MUMBAI,604,All
2021,7,BHUJ,MUMBAI,581,698,BHUJ-MUMBAI,1279,All
2021,8,BHUJ,MUMBAI,876,851,BHUJ-MUMBAI,1727,All
2021,9,BHUJ,MUMBAI,839,750,BHUJ-MUMBAI,1589,All
2021,10,BHUJ,MUMBAI,915,964,BHUJ-MUMBAI,1879,All
2021,11,BHUJ,MUMBAI,1091,1128,BHUJ-MUMBAI,2219,All
2021,12,BHUJ,MUMBAI,1007,1010,BHUJ-MUMBAI,2017,All
2022,1,BHUJ,MUMBAI,1010,882,BHUJ-MUMBAI,1892,All
2022,2,BHUJ,MUMBAI,910,1088,BHUJ-MUMBAI,1998,All
2022,3,BHUJ,MUMBAI,1145,1200,BHUJ-MUMBAI,2345,All
2022,4,BHUJ,MUMBAI,1091,1128,BHUJ-MUMBAI,2219,All
2022,5,BHUJ,MUMBAI,1007,1010,BHUJ-MUMBAI,2017,All
2022,6,BHUJ,MUMBAI,1091,1128,BHUJ-MUMBAI,2219,All
2022,7,BHUJ,MUMBAI,910,1088,BHUJ-MUMBAI,1998,All
2022,8,BHUJ,MUMBAI,1007,1010,BHUJ-MUMBAI,2017,All
2022,9,BHUJ,MUMBAI,1091,1128,BHUJ-MUMBAI,2219,All
2022,10,BHUJ,MUMBAI,936,1035,BHUJ-MUMBAI,1971,All
2022,11,BHUJ,MUMBAI,1227,1328,BHUJ-MUMBAI,2555,All
2022,12,BHUJ,MUMBAI,1855,1868,BHUJ-MUMBAI,3723,All
2023,1,BHUJ,MUMBAI,1815,1786,BHUJ-MUMBAI,3601,All
2023,2,BHUJ,MUMBAI,1459,1540,BHUJ-MUMBAI,2999,All
2023,3,BHUJ,MUMBAI,1468,1430,BHUJ-MUMBAI,2898,All
2023,4,BHUJ,MUMBAI,1244,1554,BHUJ-MUMBAI,2798,All
2023,5,BHUJ,MUMBAI,1835,1557,BHUJ-MUMBAI,3392,All
2023,6,BHUJ,MUMBAI,1028,1128,BHUJ-MUMBAI,2156,All
2023,7,BHUJ,MUMBAI,1175,1217,BHUJ-MUMBAI,2392,All
2023,8,BHUJ,MUMBAI,1399,1385,BHUJ-MUMBAI,2784,All
2023,9,BHUJ,MUMBAI,1366,1416,BHUJ-MUMBAI,2782,All
2023,10,BHUJ,MUMBAI,1568,1504,BHUJ-MUMBAI,3072,All
2023,11,BHUJ,MUMBAI,1313,1767,BHUJ-MUMBAI,3080,All
2023,12,BHUJ,MUMBAI,1710,1885,BHUJ-MUMBAI,3595,All
2024,1,BHUJ,MUMBAI,1581,1792,BHUJ-MUMBAI,3373,All
2024,2,BHUJ,MUMBAI,1596,1791,BHUJ-MUMBAI,3387,All
2024,3,BHUJ,MUMBAI,4562,4695,BHUJ-MUMBAI,9257,All
2024,4,BHUJ,MUMBAI,5941,6331,BHUJ-MUMBAI,12272,All
2024,6,BHUJ,MUMBAI,6173,6006,BHUJ-MUMBAI,12179,All
2024,7,BHUJ,MUMBAI,5656,5974,BHUJ-MUMBAI,11630,All
2024,8,BHUJ,MUMBAI,5815,5931,BHUJ-MUMBAI,11746,All
2024,9,BHUJ,MUMBAI,5779,5911,BHUJ-MUMBAI,11690,All
2024,10,BHUJ,MUMBAI,5414,5813,BHUJ-MUMBAI,11227,All
2024,11,BHUJ,MUMBAI,4937,5014,BHUJ-MUMBAI,9951,All
2024,12,BHUJ,MUMBAI,5949,6167,BHUJ-MUMBAI,12116,All
2025,1,BHUJ,MUMBAI,5785,5854,BHUJ-MUMBAI,11639,All
2025,2,BHUJ,MUMBAI,3948,4014,BHUJ-MUMBAI,7962,All
2025,3,BHUJ,MUMBAI,5590,5568,BHUJ-MUMBAI,11158,All
2020,3,"BIDAR AIRPORT, KARNATAKA",BENGALURU,1266,1287,"BENGALURU-BIDAR AIRPORT, KARNATAKA",2553,All
2020,5,"BIDAR AIRPORT, KARNATAKA",BENGALURU,91,68,"BENGALURU-BIDAR AIRPORT, KARNATAKA",159,All
2020,6,"BIDAR AIRPORT, KARNATAKA",BENGALURU,754,727,"BENGALURU-BIDAR AIRPORT, KARNATAKA",1481,All
2017,9,BIKANER,DELHI,268,311,BIKANER-DELHI,579,All
2017,10,BIKANER,DELHI,1690,1579,BIKANER-DELHI,3269,All
2017,11,BIKANER,DELHI,1477,1495,BIKANER-DELHI,2972,All
2017,12,BIKANER,DELHI,1834,1817,BIKANER-DELHI,3651,All
2018,1,BIKANER,DELHI,1703,1590,BIKANER-DELHI,3293,All
2018,2,BIKANER,DELHI,1551,1607,BIKANER-DELHI,3158,All
2018,3,BIKANER,DELHI,1558,1574,BIKANER-DELHI,3132,All
2018,4,BIKANER,DELHI,1614,1449,BIKANER-DELHI,3063,All
2018,5,BIKANER,DELHI,1317,1254,BIKANER-DELHI,2571,All
2018,6,BIKANER,DELHI,1293,1460,BIKANER-DELHI,2753,All
2018,7,BIKANER,DELHI,1651,1653,BIKANER-DELHI,3304,All
2018,8,BIKANER,DELHI,1710,1642,BIKANER-DELHI,3352,All
2018,9,BIKANER,DELHI,1467,1454,BIKANER-DELHI,2921,All
2018,10,BIKANER,DELHI,1739,1562,BIKANER-DELHI,3301,All
2018,11,BIKANER,DELHI,1639,1513,BIKANER-DELHI,3152,All
2018,12,BIKANER,DELHI,1360,1486,BIKANER-DELHI,2846,All
2019,1,BIKANER,DELHI,1635,1482,BIKANER-DELHI,3117,All
2019,2,BIKANER,DELHI,1507,1504,BIKANER-DELHI,3011,All
2019,3,BIKANER,DELHI,1456,1479,BIKANER-DELHI,2935,All
2019,4,BIKANER,DELHI,1563,1599,BIKANER-DELHI,3162,All
2019,5,BIKANER,DELHI,1654,1503,BIKANER-DELHI,3157,All
2019,6,BIKANER,DELHI,496,523,BIKANER-DELHI,1019,All
2019,7,BIKANER,DELHI,1145,1296,BIKANER-DELHI,2441,All
2019,8,BIKANER,DELHI,1621,1654,BIKANER-DELHI,3275,All
2019,9,BIKANER,DELHI,1625,1595,BIKANER-DELHI,3220,All
2019,10,BIKANER,DELHI,1680,1685,BIKANER-DELHI,3365,All
2019,11,BIKANER,DELHI,1425,1589,BIKANER-DELHI,3014,All
2019,12,BIKANER,DELHI,1458,1654,BIKANER-DELHI,3112,All
2020,1,BIKANER,DELHI,1690,1743,BIKANER-DELHI,3433,All
2020,2,BIKANER,DELHI,1642,1691,BIKANER-DELHI,3333,All
2020,3,BIKANER,DELHI,951,970,BIKANER-DELHI,1921,All
2020,5,BIKANER,DELHI,226,228,BIKANER-DELHI,454,All
2020,6,BIKANER,DELHI,1126,1034,BIKANER-DELHI,2160,All
2020,7,BIKANER,DELHI,991,894,BIKANER-DELHI,1885,All
2020,8,BIKANER,DELHI,1243,1199,BIKANER-DELHI,2442,All
2020,9,BIKANER,DELHI,1143,1217,BIKANER-DELHI,2360,All
2020,10,BIKANER,DELHI,1027,1080,BIKANER-DELHI,2107,All
2020,11,BIKANER,DELHI,861,984,BIKANER-DELHI,1845,All
2020,12,BIKANER,DELHI,1262,1209,BIKANER-DELHI,2471,All
2021,1,BIKANER,DELHI,835,825,BIKANER-DELHI,1660,All
2021,2,BIKANER,DELHI,1243,1328,BIKANER-DELHI,2571,All
2021,3,BIKANER,DELHI,1030,1121,BIKANER-DELHI,2151,All
2021,4,BIKANER,DELHI,394,567,BIKANER-DELHI,961,All
2021,6,BIKANER,DELHI,153,327,BIKANER-DELHI,480,All
2021,7,BIKANER,DELHI,338,371,BIKANER-DELHI,709,All
2021,8,BIKANER,DELHI,375,492,BIKANER-DELHI,867,All
2021,9,BIKANER,DELHI,537,657,BIKANER-DELHI,1194,All
2021,10,BIKANER,DELHI,611,794,BIKANER-DELHI,1405,All
2021,11,BIKANER,DELHI,1237,1359,BIKANER-DELHI,2596,All
2021,12,BIKANER,DELHI,1265,1342,BIKANER-DELHI,2607,All
2022,1,BIKANER,DELHI,401,411,BIKANER-DELHI,812,All
2022,2,BIKANER,DELHI,759,829,BIKANER-DELHI,1588,All
2022,3,BIKANER,DELHI,1189,1206,BIKANER-DELHI,2395,All
2022,4,BIKANER,DELHI,1237,1359,BIKANER-DELHI,2596,All
2022,5,BIKANER,DELHI,1265,1342,BIKANER-DELHI,2607,All
2022,6,BIKANER,DELHI,1237,1359,BIKANER-DELHI,2596,All
2022,7,BIKANER,DELHI,759,829,BIKANER-DELHI,1588,All
2022,8,BIKANER,DELHI,1265,1342,BIKANER-DELHI,2607,All
2022,9,BIKANER,DELHI,1237,1359,BIKANER-DELHI,2596,All
2022,10,BIKANER,DELHI,1131,1192,BIKANER-DELHI,2323,All
2022,11,BIKANER,DELHI,1427,1459,BIKANER-DELHI,2886,All
2022,12,BIKANER,DELHI,1360,1448,BIKANER-DELHI,2808,All
2023,1,BIKANER,DELHI,819,786,BIKANER-DELHI,1605,All
2023,2,BIKANER,DELHI,774,819,BIKANER-DELHI,1593,All
2023,3,BIKANER,DELHI,484,449,BIKANER-DELHI,933,All
2023,4,BIKANER,DELHI,239,269,BIKANER-DELHI,508,All
2023,5,BIKANER,DELHI,141,140,BIKANER-DELHI,281,All
2023,10,BIKANER,DELHI,163,127,BIKANER-DELHI,290,All
2023,11,BIKANER,DELHI,224,276,BIKANER-DELHI,500,All
2023,12,BIKANER,DELHI,275,315,BIKANER-DELHI,590,All
2024,1,BIKANER,DELHI,272,281,BIKANER-DELHI,553,All
2024,2,BIKANER,DELHI,288,294,BIKANER-DELHI,582,All
2024,3,BIKANER,DELHI,261,325,BIKANER-DELHI,586,All
2024,4,BIKANER,DELHI,168,238,BIKANER-DELHI,406,All
2024,6,BIKANER,DELHI,42,47,BIKANER-DELHI,89,All
2024,10,BIKANER,DELHI,44,69,BIKANER-DELHI,113,All
2024,11,BIKANER,DELHI,509,409,BIKANER-DELHI,918,All
2024,12,BIKANER,DELHI,128,146,BIKANER-DELHI,274,All
2025,1,BIKANER,DELHI,83,102,BIKANER-DELHI,185,All
2025,2,BIKANER,DELHI,1543,1348,BIKANER-DELHI,2891,All
2025,3,BIKANER,DELHI,1722,1535,BIKANER-DELHI,3257,All
2018,3,BIKANER,JAIPUR,229,203,BIKANER-JAIPUR,432,All
2018,4,BIKANER,JAIPUR,1111,1150,BIKANER-JAIPUR,2261,All
2018,5,BIKANER,JAIPUR,718,764,BIKANER-JAIPUR,1482,All
2018,6,BIKANER,JAIPUR,619,678,BIKANER-JAIPUR,1297,All
2018,7,BIKANER,JAIPUR,736,850,BIKANER-JAIPUR,1586,All
2018,8,BIKANER,JAIPUR,751,905,BIKANER-JAIPUR,1656,All
2018,9,BIKANER,JAIPUR,966,1027,BIKANER-JAIPUR,1993,All
2018,10,BIKANER,JAIPUR,981,1232,BIKANER-JAIPUR,2213,All
2018,11,BIKANER,JAIPUR,954,1176,BIKANER-JAIPUR,2130,All
2018,12,BIKANER,JAIPUR,800,1021,BIKANER-JAIPUR,1821,All
2019,1,BIKANER,JAIPUR,866,1209,BIKANER-JAIPUR,2075,All
2019,2,BIKANER,JAIPUR,1039,1141,BIKANER-JAIPUR,2180,All
2019,3,BIKANER,JAIPUR,909,1099,BIKANER-JAIPUR,2008,All
2019,4,BIKANER,JAIPUR,911,1127,BIKANER-JAIPUR,2038,All
2019,5,BIKANER,JAIPUR,874,987,BIKANER-JAIPUR,1861,All
2019,6,BIKANER,JAIPUR,270,317,BIKANER-JAIPUR,587,All
2019,7,BIKANER,JAIPUR,419,471,BIKANER-JAIPUR,890,All
2019,8,BIKANER,JAIPUR,676,907,BIKANER-JAIPUR,1583,All
2019,9,BIKANER,JAIPUR,821,1155,BIKANER-JAIPUR,1976,All
2019,10,BIKANER,JAIPUR,786,972,BIKANER-JAIPUR,1758,All
2019,12,BIKANER,JAIPUR,34,0,BIKANER-JAIPUR,34,All
2024,6,BIKANER,JAIPUR,161,158,BIKANER-JAIPUR,319,All
2024,7,BIKANER,JAIPUR,304,337,BIKANER-JAIPUR,641,All
2024,8,BIKANER,JAIPUR,323,325,BIKANER-JAIPUR,648,All
2024,9,BIKANER,JAIPUR,397,427,BIKANER-JAIPUR,824,All
2024,10,BIKANER,JAIPUR,397,492,BIKANER-JAIPUR,889,All
2024,11,BIKANER,JAIPUR,426,561,BIKANER-JAIPUR,987,All
2024,12,BIKANER,JAIPUR,150,125,BIKANER-JAIPUR,275,All
2025,3,BIKANER,JAIPUR,20,26,BIKANER-JAIPUR,46,All
2024,12,BILASPUR,Ambikapur Airport,19,19,Ambikapur Airport-BILASPUR,38,All
2025,1,BILASPUR,Ambikapur Airport,33,37,Ambikapur Airport-BILASPUR,70,All
2025,2,BILASPUR,Ambikapur Airport,14,35,Ambikapur Airport-BILASPUR,49,All
2025,3,BILASPUR,Ambikapur Airport,23,22,Ambikapur Airport-BILASPUR,45,All
2021,3,BILASPUR,DELHI,603,548,BILASPUR-DELHI,1151,All
2021,4,BILASPUR,DELHI,312,447,BILASPUR-DELHI,759,All
2021,6,BILASPUR,DELHI,653,506,BILASPUR-DELHI,1159,All
2021,7,BILASPUR,DELHI,655,549,BILASPUR-DELHI,1204,All
2021,8,BILASPUR,DELHI,679,575,BILASPUR-DELHI,1254,All
2021,9,BILASPUR,DELHI,616,520,BILASPUR-DELHI,1136,All
2021,10,BILASPUR,DELHI,511,489,BILASPUR-DELHI,1000,All
2021,11,BILASPUR,DELHI,437,468,BILASPUR-DELHI,905,All
2021,12,BILASPUR,DELHI,329,347,BILASPUR-DELHI,676,All
2022,1,BILASPUR,DELHI,342,372,BILASPUR-DELHI,714,All
2022,2,BILASPUR,DELHI,503,371,BILASPUR-DELHI,874,All
2022,3,BILASPUR,DELHI,513,516,BILASPUR-DELHI,1029,All
2022,4,BILASPUR,DELHI,437,468,BILASPUR-DELHI,905,All
2022,5,BILASPUR,DELHI,329,347,BILASPUR-DELHI,676,All
2022,6,BILASPUR,DELHI,437,468,BILASPUR-DELHI,905,All
2022,7,BILASPUR,DELHI,503,371,BILASPUR-DELHI,874,All
2022,8,BILASPUR,DELHI,329,347,BILASPUR-DELHI,676,All
2022,9,BILASPUR,DELHI,437,468,BILASPUR-DELHI,905,All
2022,10,BILASPUR,DELHI,453,489,BILASPUR-DELHI,942,All
2022,11,BILASPUR,DELHI,550,549,BILASPUR-DELHI,1099,All
2022,12,BILASPUR,DELHI,494,558,BILASPUR-DELHI,1052,All
2023,1,BILASPUR,DELHI,16,0,BILASPUR-DELHI,16,All
2023,2,BILASPUR,DELHI,454,420,BILASPUR-DELHI,874,All
2023,3,BILASPUR,DELHI,266,276,BILASPUR-DELHI,542,All
2023,10,BILASPUR,DELHI,186,83,BILASPUR-DELHI,269,All
2023,11,BILASPUR,DELHI,41,51,BILASPUR-DELHI,92,All
2023,12,BILASPUR,DELHI,37,0,BILASPUR-DELHI,37,All
2024,1,BILASPUR,DELHI,0,69,BILASPUR-DELHI,69,All
2024,2,BILASPUR,DELHI,13,0,BILASPUR-DELHI,13,All
2024,3,BILASPUR,DELHI,59,64,BILASPUR-DELHI,123,All
2024,4,BILASPUR,DELHI,436,296,BILASPUR-DELHI,732,All
2024,6,BILASPUR,DELHI,751,603,BILASPUR-DELHI,1354,All
2024,7,BILASPUR,DELHI,594,392,BILASPUR-DELHI,986,All
2024,8,BILASPUR,DELHI,642,451,BILASPUR-DELHI,1093,All
2024,9,BILASPUR,DELHI,693,412,BILASPUR-DELHI,1105,All
2024,10,BILASPUR,DELHI,729,537,BILASPUR-DELHI,1266,All
2024,11,BILASPUR,DELHI,805,474,BILASPUR-DELHI,1279,All
2024,12,BILASPUR,DELHI,671,406,BILASPUR-DELHI,1077,All
2025,1,BILASPUR,DELHI,735,545,BILASPUR-DELHI,1280,All
2025,2,BILASPUR,DELHI,716,487,BILASPUR-DELHI,1203,All
2025,3,BILASPUR,DELHI,833,577,BILASPUR-DELHI,1410,All
2023,8,BILASPUR,HYDERABAD,5,0,BILASPUR-HYDERABAD,5,All
2025,3,BILASPUR,HYDERABAD,18,1,BILASPUR-HYDERABAD,19,All
2022,10,BILASPUR,INDORE,479,410,BILASPUR-INDORE,889,All
2022,11,BILASPUR,INDORE,724,505,BILASPUR-INDORE,1229,All
2022,12,BILASPUR,INDORE,667,540,BILASPUR-INDORE,1207,All
2023,1,BILASPUR,INDORE,716,366,BILASPUR-INDORE,1082,All
2023,2,BILASPUR,INDORE,509,394,BILASPUR-INDORE,903,All
2023,3,BILASPUR,INDORE,273,258,BILASPUR-INDORE,531,All
2025,1,BILASPUR,INDORE,0,18,BILASPUR-INDORE,18,All
2021,3,BILASPUR,JABALPUR,457,367,BILASPUR-JABALPUR,824,All
2021,4,BILASPUR,JABALPUR,181,176,BILASPUR-JABALPUR,357,All
2021,6,BILASPUR,JABALPUR,218,205,BILASPUR-JABALPUR,423,All
2021,7,BILASPUR,JABALPUR,318,297,BILASPUR-JABALPUR,615,All
2021,8,BILASPUR,JABALPUR,364,330,BILASPUR-JABALPUR,694,All
2021,9,BILASPUR,JABALPUR,267,281,BILASPUR-JABALPUR,548,All
2021,10,BILASPUR,JABALPUR,251,261,BILASPUR-JABALPUR,512,All
2021,11,BILASPUR,JABALPUR,271,410,BILASPUR-JABALPUR,681,All
2021,12,BILASPUR,JABALPUR,303,424,BILASPUR-JABALPUR,727,All
2022,1,BILASPUR,JABALPUR,192,189,BILASPUR-JABALPUR,381,All
2022,2,BILASPUR,JABALPUR,332,321,BILASPUR-JABALPUR,653,All
2022,3,BILASPUR,JABALPUR,328,317,BILASPUR-JABALPUR,645,All
2022,4,BILASPUR,JABALPUR,271,410,BILASPUR-JABALPUR,681,All
2022,5,BILASPUR,JABALPUR,303,424,BILASPUR-JABALPUR,727,All
2022,6,BILASPUR,JABALPUR,271,410,BILASPUR-JABALPUR,681,All
2022,7,BILASPUR,JABALPUR,332,321,BILASPUR-JABALPUR,653,All
2022,8,BILASPUR,JABALPUR,303,424,BILASPUR-JABALPUR,727,All
2022,9,BILASPUR,JABALPUR,271,410,BILASPUR-JABALPUR,681,All
2022,10,BILASPUR,JABALPUR,283,388,BILASPUR-JABALPUR,671,All
2022,11,BILASPUR,JABALPUR,303,322,BILASPUR-JABALPUR,625,All
2022,12,BILASPUR,JABALPUR,334,472,BILASPUR-JABALPUR,806,All
2023,1,BILASPUR,JABALPUR,531,587,BILASPUR-JABALPUR,1118,All
2023,2,BILASPUR,JABALPUR,403,351,BILASPUR-JABALPUR,754,All
2023,3,BILASPUR,JABALPUR,383,430,BILASPUR-JABALPUR,813,All
2023,4,BILASPUR,JABALPUR,611,407,BILASPUR-JABALPUR,1018,All
2023,5,BILASPUR,JABALPUR,797,851,BILASPUR-JABALPUR,1648,All
2023,6,BILASPUR,JABALPUR,500,736,BILASPUR-JABALPUR,1236,All
2023,7,BILASPUR,JABALPUR,347,414,BILASPUR-JABALPUR,761,All
2023,8,BILASPUR,JABALPUR,427,364,BILASPUR-JABALPUR,791,All
2023,9,BILASPUR,JABALPUR,538,469,BILASPUR-JABALPUR,1007,All
2023,10,BILASPUR,JABALPUR,572,499,BILASPUR-JABALPUR,1071,All
2023,11,BILASPUR,JABALPUR,692,595,BILASPUR-JABALPUR,1287,All
2023,12,BILASPUR,JABALPUR,733,841,BILASPUR-JABALPUR,1574,All
2024,1,BILASPUR,JABALPUR,620,675,BILASPUR-JABALPUR,1295,All
2024,2,BILASPUR,JABALPUR,746,812,BILASPUR-JABALPUR,1558,All
2024,3,BILASPUR,JABALPUR,414,293,BILASPUR-JABALPUR,707,All
2024,4,BILASPUR,JABALPUR,106,50,BILASPUR-JABALPUR,156,All
2024,6,BILASPUR,JABALPUR,426,323,BILASPUR-JABALPUR,749,All
2024,7,BILASPUR,JABALPUR,340,290,BILASPUR-JABALPUR,630,All
2024,8,BILASPUR,JABALPUR,496,292,BILASPUR-JABALPUR,788,All
2024,9,BILASPUR,JABALPUR,491,380,BILASPUR-JABALPUR,871,All
2024,10,BILASPUR,JABALPUR,484,374,BILASPUR-JABALPUR,858,All
2024,11,BILASPUR,JABALPUR,472,412,BILASPUR-JABALPUR,884,All
2024,12,BILASPUR,JABALPUR,416,396,BILASPUR-JABALPUR,812,All
2025,1,BILASPUR,JABALPUR,376,348,BILASPUR-JABALPUR,724,All
2025,2,BILASPUR,JABALPUR,449,394,BILASPUR-JABALPUR,843,All
2025,3,BILASPUR,JABALPUR,442,390,BILASPUR-JABALPUR,832,All
2024,6,BILASPUR,JAGDALPUR,135,260,BILASPUR-JAGDALPUR,395,All
2024,7,BILASPUR,JAGDALPUR,124,129,BILASPUR-JAGDALPUR,253,All
2024,8,BILASPUR,JAGDALPUR,122,239,BILASPUR-JAGDALPUR,361,All
2024,9,BILASPUR,JAGDALPUR,122,188,BILASPUR-JAGDALPUR,310,All
2024,10,BILASPUR,JAGDALPUR,229,338,BILASPUR-JAGDALPUR,567,All
2024,11,BILASPUR,JAGDALPUR,232,276,BILASPUR-JAGDALPUR,508,All
2024,12,BILASPUR,JAGDALPUR,219,346,BILASPUR-JAGDALPUR,565,All
2025,1,BILASPUR,JAGDALPUR,228,213,BILASPUR-JAGDALPUR,441,All
2025,2,BILASPUR,JAGDALPUR,140,255,BILASPUR-JAGDALPUR,395,All
2025,3,BILASPUR,JAGDALPUR,182,264,BILASPUR-JAGDALPUR,446,All
2024,3,BILASPUR,KOLKATA,49,21,BILASPUR-KOLKATA,70,All
2024,4,BILASPUR,KOLKATA,105,46,BILASPUR-KOLKATA,151,All
2024,6,BILASPUR,KOLKATA,266,224,BILASPUR-KOLKATA,490,All
2024,7,BILASPUR,KOLKATA,187,219,BILASPUR-KOLKATA,406,All
2024,8,BILASPUR,KOLKATA,215,218,BILASPUR-KOLKATA,433,All
2024,9,BILASPUR,KOLKATA,154,129,BILASPUR-KOLKATA,283,All
2024,10,BILASPUR,KOLKATA,370,265,BILASPUR-KOLKATA,635,All
2024,11,BILASPUR,KOLKATA,297,276,BILASPUR-KOLKATA,573,All
2024,12,BILASPUR,KOLKATA,363,364,BILASPUR-KOLKATA,727,All
2025,1,BILASPUR,KOLKATA,124,129,BILASPUR-KOLKATA,253,All
2025,2,BILASPUR,KOLKATA,263,213,BILASPUR-KOLKATA,476,All
2025,3,BILASPUR,KOLKATA,285,283,BILASPUR-KOLKATA,568,All
2021,3,BILASPUR,LUCKNOW,22,0,BILASPUR-LUCKNOW,22,All
2024,4,CHANDIGARH,Ayodhya International Airport ,0,8,Ayodhya International Airport -CHANDIGARH,8,All
2015,4,CHANDIGARH,CHENNAI,1314,921,CHANDIGARH-CHENNAI,2235,All
2015,5,CHANDIGARH,CHENNAI,1707,797,CHANDIGARH-CHENNAI,2504,All
2015,6,CHANDIGARH,CHENNAI,1330,1071,CHANDIGARH-CHENNAI,2401,All
2015,7,CHANDIGARH,CHENNAI,1354,1278,CHANDIGARH-CHENNAI,2632,All
2015,8,CHANDIGARH,CHENNAI,1106,904,CHANDIGARH-CHENNAI,2010,All
2015,9,CHANDIGARH,CHENNAI,1052,925,CHANDIGARH-CHENNAI,1977,All
2015,10,CHANDIGARH,CHENNAI,1218,966,CHANDIGARH-CHENNAI,2184,All
2015,11,CHANDIGARH,CHENNAI,627,661,CHANDIGARH-CHENNAI,1288,All
2015,12,CHANDIGARH,CHENNAI,56,268,CHANDIGARH-CHENNAI,324,All
2016,1,CHANDIGARH,CHENNAI,94,304,CHANDIGARH-CHENNAI,398,All
2016,2,CHANDIGARH,CHENNAI,498,540,CHANDIGARH-CHENNAI,1038,All
2016,3,CHANDIGARH,CHENNAI,592,577,CHANDIGARH-CHENNAI,1169,All
2016,4,CHANDIGARH,CHENNAI,762,692,CHANDIGARH-CHENNAI,1454,All
2016,5,CHANDIGARH,CHENNAI,746,838,CHANDIGARH-CHENNAI,1584,All
2016,6,CHANDIGARH,CHENNAI,775,642,CHANDIGARH-CHENNAI,1417,All
2016,7,CHANDIGARH,CHENNAI,661,460,CHANDIGARH-CHENNAI,1121,All
2016,8,CHANDIGARH,CHENNAI,503,387,CHANDIGARH-CHENNAI,890,All
2016,9,CHANDIGARH,CHENNAI,385,303,CHANDIGARH-CHENNAI,688,All
2016,10,CHANDIGARH,CHENNAI,535,548,CHANDIGARH-CHENNAI,1083,All
2016,11,CHANDIGARH,CHENNAI,555,711,CHANDIGARH-CHENNAI,1266,All
2016,12,CHANDIGARH,CHENNAI,66,220,CHANDIGARH-CHENNAI,286,All
2017,1,CHANDIGARH,CHENNAI,0,488,CHANDIGARH-CHENNAI,488,All
2017,2,CHANDIGARH,CHENNAI,635,1072,CHANDIGARH-CHENNAI,1707,All
2017,3,CHANDIGARH,CHENNAI,1375,1597,CHANDIGARH-CHENNAI,2972,All
2017,4,CHANDIGARH,CHENNAI,1359,1346,CHANDIGARH-CHENNAI,2705,All
2017,5,CHANDIGARH,CHENNAI,1733,1709,CHANDIGARH-CHENNAI,3442,All
2017,6,CHANDIGARH,CHENNAI,1500,1689,CHANDIGARH-CHENNAI,3189,All
2017,7,CHANDIGARH,CHENNAI,1734,2040,CHANDIGARH-CHENNAI,3774,All
2017,8,CHANDIGARH,CHENNAI,1257,1643,CHANDIGARH-CHENNAI,2900,All
2017,9,CHANDIGARH,CHENNAI,1114,1520,CHANDIGARH-CHENNAI,2634,All
2017,10,CHANDIGARH,CHENNAI,683,741,CHANDIGARH-CHENNAI,1424,All
2017,11,CHANDIGARH,CHENNAI,745,1012,CHANDIGARH-CHENNAI,1757,All
2017,12,CHANDIGARH,CHENNAI,813,1022,CHANDIGARH-CHENNAI,1835,All
2018,1,CHANDIGARH,CHENNAI,687,1155,CHANDIGARH-CHENNAI,1842,All
2018,2,CHANDIGARH,CHENNAI,211,437,CHANDIGARH-CHENNAI,648,All
2018,3,CHANDIGARH,CHENNAI,679,935,CHANDIGARH-CHENNAI,1614,All
2018,4,CHANDIGARH,CHENNAI,642,627,CHANDIGARH-CHENNAI,1269,All
2018,5,CHANDIGARH,CHENNAI,364,246,CHANDIGARH-CHENNAI,610,All
2018,6,CHANDIGARH,CHENNAI,582,640,CHANDIGARH-CHENNAI,1222,All
2018,7,CHANDIGARH,CHENNAI,432,444,CHANDIGARH-CHENNAI,876,All
2018,8,CHANDIGARH,CHENNAI,384,644,CHANDIGARH-CHENNAI,1028,All
2018,9,CHANDIGARH,CHENNAI,543,948,CHANDIGARH-CHENNAI,1491,All
2018,10,CHANDIGARH,CHENNAI,652,1023,CHANDIGARH-CHENNAI,1675,All
2018,11,CHANDIGARH,CHENNAI,805,1138,CHANDIGARH-CHENNAI,1943,All
2018,12,CHANDIGARH,CHENNAI,726,1148,CHANDIGARH-CHENNAI,1874,All
2019,1,CHANDIGARH,CHENNAI,937,1319,CHANDIGARH-CHENNAI,2256,All
2019,2,CHANDIGARH,CHENNAI,618,723,CHANDIGARH-CHENNAI,1341,All
2019,3,CHANDIGARH,CHENNAI,954,969,CHANDIGARH-CHENNAI,1923,All
2019,4,CHANDIGARH,CHENNAI,1114,999,CHANDIGARH-CHENNAI,2113,All
2019,5,CHANDIGARH,CHENNAI,1333,1832,CHANDIGARH-CHENNAI,3165,All
2019,6,CHANDIGARH,CHENNAI,1113,1526,CHANDIGARH-CHENNAI,2639,All
2019,7,CHANDIGARH,CHENNAI,1030,1064,CHANDIGARH-CHENNAI,2094,All
2019,8,CHANDIGARH,CHENNAI,677,993,CHANDIGARH-CHENNAI,1670,All
2019,9,CHANDIGARH,CHENNAI,551,986,CHANDIGARH-CHENNAI,1537,All
2019,10,CHANDIGARH,CHENNAI,977,1040,CHANDIGARH-CHENNAI,2017,All
2019,11,CHANDIGARH,CHENNAI,889,1132,CHANDIGARH-CHENNAI,2021,All
2019,12,CHANDIGARH,CHENNAI,1269,1293,CHANDIGARH-CHENNAI,2562,All
2020,1,CHANDIGARH,CHENNAI,995,1153,CHANDIGARH-CHENNAI,2148,All
2020,2,CHANDIGARH,CHENNAI,667,959,CHANDIGARH-CHENNAI,1626,All
2020,3,CHANDIGARH,CHENNAI,653,745,CHANDIGARH-CHENNAI,1398,All
2020,6,CHANDIGARH,CHENNAI,20,0,CHANDIGARH-CHENNAI,20,All
2020,8,CHANDIGARH,CHENNAI,217,251,CHANDIGARH-CHENNAI,468,All
2020,9,CHANDIGARH,CHENNAI,666,906,CHANDIGARH-CHENNAI,1572,All
2020,10,CHANDIGARH,CHENNAI,1073,1451,CHANDIGARH-CHENNAI,2524,All
2020,11,CHANDIGARH,CHENNAI,1923,2295,CHANDIGARH-CHENNAI,4218,All
2020,12,CHANDIGARH,CHENNAI,4019,4064,CHANDIGARH-CHENNAI,8083,All
2021,1,CHANDIGARH,CHENNAI,4211,4247,CHANDIGARH-CHENNAI,8458,All
2021,2,CHANDIGARH,CHENNAI,3734,4410,CHANDIGARH-CHENNAI,8144,All
2021,3,CHANDIGARH,CHENNAI,3579,4066,CHANDIGARH-CHENNAI,7645,All
2021,4,CHANDIGARH,CHENNAI,2665,3100,CHANDIGARH-CHENNAI,5765,All
2021,7,CHANDIGARH,CHENNAI,1809,1662,CHANDIGARH-CHENNAI,3471,All
2021,8,CHANDIGARH,CHENNAI,1428,1372,CHANDIGARH-CHENNAI,2800,All
2021,9,CHANDIGARH,CHENNAI,1200,1470,CHANDIGARH-CHENNAI,2670,All
2021,10,CHANDIGARH,CHENNAI,1013,784,CHANDIGARH-CHENNAI,1797,All
2022,3,CHANDIGARH,CHENNAI,678,843,CHANDIGARH-CHENNAI,1521,All
2022,4,CHANDIGARH,CHENNAI,3561,5055,CHANDIGARH-CHENNAI,8616,All
2022,5,CHANDIGARH,CHENNAI,4301,5154,CHANDIGARH-CHENNAI,9455,All
2022,6,CHANDIGARH,CHENNAI,4795,4596,CHANDIGARH-CHENNAI,9391,All
2022,7,CHANDIGARH,CHENNAI,3868,4551,CHANDIGARH-CHENNAI,8419,All
2022,8,CHANDIGARH,CHENNAI,3830,4254,CHANDIGARH-CHENNAI,8084,All
2022,9,CHANDIGARH,CHENNAI,3446,4321,CHANDIGARH-CHENNAI,7767,All
2022,10,CHANDIGARH,CHENNAI,5186,5992,CHANDIGARH-CHENNAI,11178,All
2022,11,CHANDIGARH,CHENNAI,3885,3766,CHANDIGARH-CHENNAI,7651,All
2022,12,CHANDIGARH,CHENNAI,4098,4227,CHANDIGARH-CHENNAI,8325,All
2023,1,CHANDIGARH,CHENNAI,3502,4188,CHANDIGARH-CHENNAI,7690,All
2023,2,CHANDIGARH,CHENNAI,3832,4198,CHANDIGARH-CHENNAI,8030,All
2023,3,CHANDIGARH,CHENNAI,4242,4451,CHANDIGARH-CHENNAI,8693,All
2023,4,CHANDIGARH,CHENNAI,4183,5071,CHANDIGARH-CHENNAI,9254,All
2023,5,CHANDIGARH,CHENNAI,5356,5161,CHANDIGARH-CHENNAI,10517,All
2023,6,CHANDIGARH,CHENNAI,5097,4536,CHANDIGARH-CHENNAI,9633,All
2023,7,CHANDIGARH,CHENNAI,4778,4648,CHANDIGARH-CHENNAI,9426,All
2023,8,CHANDIGARH,CHENNAI,4614,5046,CHANDIGARH-CHENNAI,9660,All
2023,9,CHANDIGARH,CHENNAI,4733,4878,CHANDIGARH-CHENNAI,9611,All
2023,10,CHANDIGARH,CHENNAI,4848,4911,CHANDIGARH-CHENNAI,9759,All
2023,11,CHANDIGARH,CHENNAI,4836,4797,CHANDIGARH-CHENNAI,9633,All
2023,12,CHANDIGARH,CHENNAI,4825,5096,CHANDIGARH-CHENNAI,9921,All
2024,1,CHANDIGARH,CHENNAI,4838,5442,CHANDIGARH-CHENNAI,10280,All
2024,2,CHANDIGARH,CHENNAI,4978,5045,CHANDIGARH-CHENNAI,10023,All
2024,3,CHANDIGARH,CHENNAI,5094,5186,CHANDIGARH-CHENNAI,10280,All
2024,4,CHANDIGARH,CHENNAI,4753,4927,CHANDIGARH-CHENNAI,9680,All
2024,6,CHANDIGARH,CHENNAI,4952,4819,CHANDIGARH-CHENNAI,9771,All
2024,7,CHANDIGARH,CHENNAI,5029,5040,CHANDIGARH-CHENNAI,10069,All
2024,8,CHANDIGARH,CHENNAI,4693,4790,CHANDIGARH-CHENNAI,9483,All
2024,9,CHANDIGARH,CHENNAI,4383,4845,CHANDIGARH-CHENNAI,9228,All
2024,10,CHANDIGARH,CHENNAI,4585,5167,CHANDIGARH-CHENNAI,9752,All
2024,11,CHANDIGARH,CHENNAI,5805,5982,CHANDIGARH-CHENNAI,11787,All
2024,12,CHANDIGARH,CHENNAI,6214,5771,CHANDIGARH-CHENNAI,11985,All
2025,1,CHANDIGARH,CHENNAI,4784,5049,CHANDIGARH-CHENNAI,9833,All
2025,2,CHANDIGARH,CHENNAI,5603,5848,CHANDIGARH-CHENNAI,11451,All
2025,3,CHANDIGARH,CHENNAI,5648,5856,CHANDIGARH-CHENNAI,11504,All
2020,2,CHANDIGARH,DABOLIM,1551,1728,CHANDIGARH-DABOLIM,3279,All
2020,3,CHANDIGARH,DABOLIM,2349,3214,CHANDIGARH-DABOLIM,5563,All
2020,10,CHANDIGARH,DABOLIM,574,474,CHANDIGARH-DABOLIM,1048,All
2020,11,CHANDIGARH,DABOLIM,3740,3538,CHANDIGARH-DABOLIM,7278,All
2020,12,CHANDIGARH,DABOLIM,5130,4454,CHANDIGARH-DABOLIM,9584,All
2021,1,CHANDIGARH,DABOLIM,5049,4920,CHANDIGARH-DABOLIM,9969,All
2021,2,CHANDIGARH,DABOLIM,4734,4756,CHANDIGARH-DABOLIM,9490,All
2021,3,CHANDIGARH,DABOLIM,4693,5119,CHANDIGARH-DABOLIM,9812,All
2021,4,CHANDIGARH,DABOLIM,2439,3881,CHANDIGARH-DABOLIM,6320,All
2021,7,CHANDIGARH,DABOLIM,1510,1421,CHANDIGARH-DABOLIM,2931,All
2021,8,CHANDIGARH,DABOLIM,2534,2401,CHANDIGARH-DABOLIM,4935,All
2021,9,CHANDIGARH,DABOLIM,3993,3921,CHANDIGARH-DABOLIM,7914,All
2021,10,CHANDIGARH,DABOLIM,4349,4682,CHANDIGARH-DABOLIM,9031,All
2021,11,CHANDIGARH,DABOLIM,5265,5259,CHANDIGARH-DABOLIM,10524,All
2021,12,CHANDIGARH,DABOLIM,6163,6133,CHANDIGARH-DABOLIM,12296,All
2022,1,CHANDIGARH,DABOLIM,4744,5144,CHANDIGARH-DABOLIM,9888,All
2022,2,CHANDIGARH,DABOLIM,4719,4675,CHANDIGARH-DABOLIM,9394,All
2022,3,CHANDIGARH,DABOLIM,6130,6526,CHANDIGARH-DABOLIM,12656,All
2022,4,CHANDIGARH,DABOLIM,5884,6400,CHANDIGARH-DABOLIM,12284,All
2022,5,CHANDIGARH,DABOLIM,6743,7350,CHANDIGARH-DABOLIM,14093,All
2022,6,CHANDIGARH,DABOLIM,7171,7178,CHANDIGARH-DABOLIM,14349,All
2022,7,CHANDIGARH,DABOLIM,6223,6910,CHANDIGARH-DABOLIM,13133,All
2022,8,CHANDIGARH,DABOLIM,6617,7075,CHANDIGARH-DABOLIM,13692,All
2022,9,CHANDIGARH,DABOLIM,6457,6829,CHANDIGARH-DABOLIM,13286,All
2022,10,CHANDIGARH,DABOLIM,6940,7453,CHANDIGARH-DABOLIM,14393,All
2022,11,CHANDIGARH,DABOLIM,4366,4379,CHANDIGARH-DABOLIM,8745,All
2022,12,CHANDIGARH,DABOLIM,5435,5438,CHANDIGARH-DABOLIM,10873,All
2023,1,CHANDIGARH,DABOLIM,5420,5517,CHANDIGARH-DABOLIM,10937,All
2023,2,CHANDIGARH,DABOLIM,4717,4703,CHANDIGARH-DABOLIM,9420,All
2023,3,CHANDIGARH,DABOLIM,5201,5157,CHANDIGARH-DABOLIM,10358,All
2023,4,CHANDIGARH,DABOLIM,4837,5122,CHANDIGARH-DABOLIM,9959,All
2023,5,CHANDIGARH,DABOLIM,5293,5154,CHANDIGARH-DABOLIM,10447,All
2023,6,CHANDIGARH,DABOLIM,5359,5056,CHANDIGARH-DABOLIM,10415,All
2023,7,CHANDIGARH,DABOLIM,4839,4935,CHANDIGARH-DABOLIM,9774,All
2023,8,CHANDIGARH,DABOLIM,4438,4819,CHANDIGARH-DABOLIM,9257,All
2023,9,CHANDIGARH,DABOLIM,5004,4718,CHANDIGARH-DABOLIM,9722,All
2023,10,CHANDIGARH,DABOLIM,5028,5129,CHANDIGARH-DABOLIM,10157,All
2023,11,CHANDIGARH,DABOLIM,4818,4805,CHANDIGARH-DABOLIM,9623,All
2023,12,CHANDIGARH,DABOLIM,6149,5182,CHANDIGARH-DABOLIM,11331,All
2024,1,CHANDIGARH,DABOLIM,5709,5142,CHANDIGARH-DABOLIM,10851,All
2024,2,CHANDIGARH,DABOLIM,5387,5535,CHANDIGARH-DABOLIM,10922,All
2024,3,CHANDIGARH,DABOLIM,5837,5969,CHANDIGARH-DABOLIM,11806,All
2024,4,CHANDIGARH,DABOLIM,5099,5562,CHANDIGARH-DABOLIM,10661,All
2024,6,CHANDIGARH,DABOLIM,6250,5898,CHANDIGARH-DABOLIM,12148,All
2024,7,CHANDIGARH,DABOLIM,4786,5504,CHANDIGARH-DABOLIM,10290,All
2024,8,CHANDIGARH,DABOLIM,5188,5747,CHANDIGARH-DABOLIM,10935,All
2024,9,CHANDIGARH,DABOLIM,5519,5881,CHANDIGARH-DABOLIM,11400,All
2024,10,CHANDIGARH,DABOLIM,4583,5884,CHANDIGARH-DABOLIM,10467,All
2024,11,CHANDIGARH,DABOLIM,7377,6422,CHANDIGARH-DABOLIM,13799,All
2024,12,CHANDIGARH,DABOLIM,11642,10889,CHANDIGARH-DABOLIM,22531,All
2025,1,CHANDIGARH,DABOLIM,11360,11584,CHANDIGARH-DABOLIM,22944,All
2025,2,CHANDIGARH,DABOLIM,10315,10908,CHANDIGARH-DABOLIM,21223,All
2025,3,CHANDIGARH,DABOLIM,10940,11447,CHANDIGARH-DABOLIM,22387,All
2021,2,CHANDIGARH,DEHRA DUN,3,4,CHANDIGARH-DEHRA DUN,7,All
2021,3,CHANDIGARH,DEHRA DUN,2,4,CHANDIGARH-DEHRA DUN,6,All
2022,1,CHANDIGARH,DEHRA DUN,101,118,CHANDIGARH-DEHRA DUN,219,All
2022,5,CHANDIGARH,DEHRA DUN,52,45,CHANDIGARH-DEHRA DUN,97,All
2022,6,CHANDIGARH,DEHRA DUN,78,221,CHANDIGARH-DEHRA DUN,299,All
2022,7,CHANDIGARH,DEHRA DUN,0,1131,CHANDIGARH-DEHRA DUN,1131,All
2022,8,CHANDIGARH,DEHRA DUN,0,280,CHANDIGARH-DEHRA DUN,280,All
2022,10,CHANDIGARH,DEHRA DUN,73,85,CHANDIGARH-DEHRA DUN,158,All
2022,11,CHANDIGARH,DEHRA DUN,0,115,CHANDIGARH-DEHRA DUN,115,All
2019,5,CHANDIGARH,DELHI,25490,26359,CHANDIGARH-DELHI,51849,All
2019,6,CHANDIGARH,DELHI,25407,25876,CHANDIGARH-DELHI,51283,All
2019,7,CHANDIGARH,DELHI,30345,33016,CHANDIGARH-DELHI,63361,All
2019,8,CHANDIGARH,DELHI,30214,32867,CHANDIGARH-DELHI,63081,All
2019,9,CHANDIGARH,DELHI,32264,35017,CHANDIGARH-DELHI,67281,All
2019,10,CHANDIGARH,DELHI,34174,37144,CHANDIGARH-DELHI,71318,All
2019,11,CHANDIGARH,DELHI,38169,39820,CHANDIGARH-DELHI,77989,All
2019,12,CHANDIGARH,DELHI,31884,33039,CHANDIGARH-DELHI,64923,All
2020,1,CHANDIGARH,DELHI,31678,31859,CHANDIGARH-DELHI,63537,All
2020,2,CHANDIGARH,DELHI,36733,40485,CHANDIGARH-DELHI,77218,All
2020,3,CHANDIGARH,DELHI,19718,20556,CHANDIGARH-DELHI,40274,All
2020,5,CHANDIGARH,DELHI,1360,1649,CHANDIGARH-DELHI,3009,All
2020,6,CHANDIGARH,DELHI,7167,6929,CHANDIGARH-DELHI,14096,All
2020,7,CHANDIGARH,DELHI,4845,6297,CHANDIGARH-DELHI,11142,All
2020,8,CHANDIGARH,DELHI,6250,6418,CHANDIGARH-DELHI,12668,All
2020,9,CHANDIGARH,DELHI,8169,10261,CHANDIGARH-DELHI,18430,All
2020,10,CHANDIGARH,DELHI,14673,16759,CHANDIGARH-DELHI,31432,All
2020,11,CHANDIGARH,DELHI,18520,17563,CHANDIGARH-DELHI,36083,All
2020,12,CHANDIGARH,DELHI,33470,31128,CHANDIGARH-DELHI,64598,All
2021,1,CHANDIGARH,DELHI,33306,30699,CHANDIGARH-DELHI,64005,All
2021,2,CHANDIGARH,DELHI,29207,30223,CHANDIGARH-DELHI,59430,All
2021,3,CHANDIGARH,DELHI,27460,27824,CHANDIGARH-DELHI,55284,All
2021,4,CHANDIGARH,DELHI,18800,16912,CHANDIGARH-DELHI,35712,All
2021,6,CHANDIGARH,DELHI,14827,15589,CHANDIGARH-DELHI,30416,All
2021,7,CHANDIGARH,DELHI,18152,20040,CHANDIGARH-DELHI,38192,All
2021,8,CHANDIGARH,DELHI,24501,25632,CHANDIGARH-DELHI,50133,All
2021,9,CHANDIGARH,DELHI,29190,28956,CHANDIGARH-DELHI,58146,All
2021,10,CHANDIGARH,DELHI,32258,32553,CHANDIGARH-DELHI,64811,All
2021,11,CHANDIGARH,DELHI,35942,34264,CHANDIGARH-DELHI,70206,All
2021,12,CHANDIGARH,DELHI,38525,38873,CHANDIGARH-DELHI,77398,All
2022,1,CHANDIGARH,DELHI,22478,19406,CHANDIGARH-DELHI,41884,All
2022,2,CHANDIGARH,DELHI,25983,25592,CHANDIGARH-DELHI,51575,All
2022,3,CHANDIGARH,DELHI,29740,31274,CHANDIGARH-DELHI,61014,All
2022,4,CHANDIGARH,DELHI,33001,34508,CHANDIGARH-DELHI,67509,All
2022,5,CHANDIGARH,DELHI,34116,33828,CHANDIGARH-DELHI,67944,All
2022,6,CHANDIGARH,DELHI,32309,30309,CHANDIGARH-DELHI,62618,All
2022,7,CHANDIGARH,DELHI,28261,28848,CHANDIGARH-DELHI,57109,All
2022,8,CHANDIGARH,DELHI,29706,30989,CHANDIGARH-DELHI,60695,All
2022,9,CHANDIGARH,DELHI,30407,32416,CHANDIGARH-DELHI,62823,All
2022,10,CHANDIGARH,DELHI,30397,32133,CHANDIGARH-DELHI,62530,All
2022,11,CHANDIGARH,DELHI,31607,31169,CHANDIGARH-DELHI,62776,All
2022,12,CHANDIGARH,DELHI,31518,32451,CHANDIGARH-DELHI,63969,All
2023,1,CHANDIGARH,DELHI,29157,30286,CHANDIGARH-DELHI,59443,All
2023,2,CHANDIGARH,DELHI,28595,30011,CHANDIGARH-DELHI,58606,All
2023,3,CHANDIGARH,DELHI,32089,32961,CHANDIGARH-DELHI,65050,All
2023,4,CHANDIGARH,DELHI,36189,37149,CHANDIGARH-DELHI,73338,All
2023,5,CHANDIGARH,DELHI,37806,39150,CHANDIGARH-DELHI,76956,All
2023,6,CHANDIGARH,DELHI,35806,35634,CHANDIGARH-DELHI,71440,All
2023,7,CHANDIGARH,DELHI,33854,34453,CHANDIGARH-DELHI,68307,All
2023,8,CHANDIGARH,DELHI,32211,33443,CHANDIGARH-DELHI,65654,All
2023,9,CHANDIGARH,DELHI,31443,32956,CHANDIGARH-DELHI,64399,All
2023,10,CHANDIGARH,DELHI,33184,34981,CHANDIGARH-DELHI,68165,All
2023,11,CHANDIGARH,DELHI,30238,31304,CHANDIGARH-DELHI,61542,All
2023,12,CHANDIGARH,DELHI,29910,30466,CHANDIGARH-DELHI,60376,All
2024,1,CHANDIGARH,DELHI,26291,26657,CHANDIGARH-DELHI,52948,All
2024,2,CHANDIGARH,DELHI,32753,32493,CHANDIGARH-DELHI,65246,All
2024,3,CHANDIGARH,DELHI,31632,31628,CHANDIGARH-DELHI,63260,All
2024,4,CHANDIGARH,DELHI,38374,37896,CHANDIGARH-DELHI,76270,All
2024,6,CHANDIGARH,DELHI,43631,40269,CHANDIGARH-DELHI,83900,All
2024,7,CHANDIGARH,DELHI,37846,37441,CHANDIGARH-DELHI,75287,All
2024,8,CHANDIGARH,DELHI,38154,37337,CHANDIGARH-DELHI,75491,All
2024,9,CHANDIGARH,DELHI,35614,35932,CHANDIGARH-DELHI,71546,All
2024,10,CHANDIGARH,DELHI,37339,40862,CHANDIGARH-DELHI,78201,All
2024,11,CHANDIGARH,DELHI,37263,36782,CHANDIGARH-DELHI,74045,All
2024,12,CHANDIGARH,DELHI,39039,40684,CHANDIGARH-DELHI,79723,All
2025,1,CHANDIGARH,DELHI,36747,38173,CHANDIGARH-DELHI,74920,All
2025,2,CHANDIGARH,DELHI,39331,42201,CHANDIGARH-DELHI,81532,All
2025,3,CHANDIGARH,DELHI,47817,45381,CHANDIGARH-DELHI,93198,All
2019,11,CHANDIGARH,DHARAMSALA,431,512,CHANDIGARH-DHARAMSALA,943,All
2019,12,CHANDIGARH,DHARAMSALA,607,648,CHANDIGARH-DHARAMSALA,1255,All
2020,1,CHANDIGARH,DHARAMSALA,578,736,CHANDIGARH-DHARAMSALA,1314,All
2020,2,CHANDIGARH,DHARAMSALA,689,754,CHANDIGARH-DHARAMSALA,1443,All
2020,3,CHANDIGARH,DHARAMSALA,574,585,CHANDIGARH-DHARAMSALA,1159,All
2020,5,CHANDIGARH,DHARAMSALA,34,35,CHANDIGARH-DHARAMSALA,69,All
2020,6,CHANDIGARH,DHARAMSALA,488,246,CHANDIGARH-DHARAMSALA,734,All
2020,7,CHANDIGARH,DHARAMSALA,618,378,CHANDIGARH-DHARAMSALA,996,All
2020,8,CHANDIGARH,DHARAMSALA,524,606,CHANDIGARH-DHARAMSALA,1130,All
2020,9,CHANDIGARH,DHARAMSALA,748,583,CHANDIGARH-DHARAMSALA,1331,All
2020,10,CHANDIGARH,DHARAMSALA,1169,785,CHANDIGARH-DHARAMSALA,1954,All
2020,11,CHANDIGARH,DHARAMSALA,975,979,CHANDIGARH-DHARAMSALA,1954,All
2020,12,CHANDIGARH,DHARAMSALA,1022,1008,CHANDIGARH-DHARAMSALA,2030,All
2021,1,CHANDIGARH,DHARAMSALA,835,946,CHANDIGARH-DHARAMSALA,1781,All
2021,2,CHANDIGARH,DHARAMSALA,1092,1062,CHANDIGARH-DHARAMSALA,2154,All
2021,3,CHANDIGARH,DHARAMSALA,1262,1169,CHANDIGARH-DHARAMSALA,2431,All
2021,4,CHANDIGARH,DHARAMSALA,774,781,CHANDIGARH-DHARAMSALA,1555,All
2021,6,CHANDIGARH,DHARAMSALA,604,927,CHANDIGARH-DHARAMSALA,1531,All
2021,7,CHANDIGARH,DHARAMSALA,455,758,CHANDIGARH-DHARAMSALA,1213,All
2021,8,CHANDIGARH,DHARAMSALA,434,572,CHANDIGARH-DHARAMSALA,1006,All
2021,9,CHANDIGARH,DHARAMSALA,515,663,CHANDIGARH-DHARAMSALA,1178,All
2021,10,CHANDIGARH,DHARAMSALA,843,999,CHANDIGARH-DHARAMSALA,1842,All
2021,11,CHANDIGARH,DHARAMSALA,1016,1092,CHANDIGARH-DHARAMSALA,2108,All
2021,12,CHANDIGARH,DHARAMSALA,896,953,CHANDIGARH-DHARAMSALA,1849,All
2022,1,CHANDIGARH,DHARAMSALA,365,496,CHANDIGARH-DHARAMSALA,861,All
2022,2,CHANDIGARH,DHARAMSALA,638,648,CHANDIGARH-DHARAMSALA,1286,All
2022,3,CHANDIGARH,DHARAMSALA,956,1068,CHANDIGARH-DHARAMSALA,2024,All
2022,4,CHANDIGARH,DHARAMSALA,1016,1092,CHANDIGARH-DHARAMSALA,2108,All
2022,5,CHANDIGARH,DHARAMSALA,896,953,CHANDIGARH-DHARAMSALA,1849,All
2022,6,CHANDIGARH,DHARAMSALA,1016,1092,CHANDIGARH-DHARAMSALA,2108,All
2022,7,CHANDIGARH,DHARAMSALA,638,648,CHANDIGARH-DHARAMSALA,1286,All
2022,8,CHANDIGARH,DHARAMSALA,896,953,CHANDIGARH-DHARAMSALA,1849,All
2022,9,CHANDIGARH,DHARAMSALA,1016,1092,CHANDIGARH-DHARAMSALA,2108,All
2022,10,CHANDIGARH,DHARAMSALA,1156,1362,CHANDIGARH-DHARAMSALA,2518,All
2022,11,CHANDIGARH,DHARAMSALA,733,1179,CHANDIGARH-DHARAMSALA,1912,All
2022,12,CHANDIGARH,DHARAMSALA,767,1051,CHANDIGARH-DHARAMSALA,1818,All
2023,1,CHANDIGARH,DHARAMSALA,738,1006,CHANDIGARH-DHARAMSALA,1744,All
2023,2,CHANDIGARH,DHARAMSALA,646,831,CHANDIGARH-DHARAMSALA,1477,All
2023,3,CHANDIGARH,DHARAMSALA,750,1016,CHANDIGARH-DHARAMSALA,1766,All
2023,4,CHANDIGARH,DHARAMSALA,840,1070,CHANDIGARH-DHARAMSALA,1910,All
2023,5,CHANDIGARH,DHARAMSALA,974,1138,CHANDIGARH-DHARAMSALA,2112,All
2023,6,CHANDIGARH,DHARAMSALA,687,939,CHANDIGARH-DHARAMSALA,1626,All
2023,7,CHANDIGARH,DHARAMSALA,327,373,CHANDIGARH-DHARAMSALA,700,All
2023,9,CHANDIGARH,DHARAMSALA,199,161,CHANDIGARH-DHARAMSALA,360,All
2023,10,CHANDIGARH,DHARAMSALA,66,33,CHANDIGARH-DHARAMSALA,99,All
2023,11,CHANDIGARH,DHARAMSALA,161,191,CHANDIGARH-DHARAMSALA,352,All
2024,4,CHANDIGARH,DHARAMSALA,636,725,CHANDIGARH-DHARAMSALA,1361,All
2024,6,CHANDIGARH,DHARAMSALA,550,531,CHANDIGARH-DHARAMSALA,1081,All
2024,7,CHANDIGARH,DHARAMSALA,323,531,CHANDIGARH-DHARAMSALA,854,All
2024,8,CHANDIGARH,DHARAMSALA,322,360,CHANDIGARH-DHARAMSALA,682,All
2024,9,CHANDIGARH,DHARAMSALA,566,512,CHANDIGARH-DHARAMSALA,1078,All
2024,10,CHANDIGARH,DHARAMSALA,736,807,CHANDIGARH-DHARAMSALA,1543,All
2024,11,CHANDIGARH,DHARAMSALA,1068,1352,CHANDIGARH-DHARAMSALA,2420,All
2024,12,CHANDIGARH,DHARAMSALA,1206,1394,CHANDIGARH-DHARAMSALA,2600,All
2025,1,CHANDIGARH,DHARAMSALA,925,1199,CHANDIGARH-DHARAMSALA,2124,All
2025,2,CHANDIGARH,DHARAMSALA,1248,1305,CHANDIGARH-DHARAMSALA,2553,All
2025,3,CHANDIGARH,DHARAMSALA,1497,1407,CHANDIGARH-DHARAMSALA,2904,All
2024,1,CHANDIGARH,DehraDun,0,77,CHANDIGARH-DehraDun,77,All
2023,3,CHANDIGARH,GORAKHPUR,0,6,CHANDIGARH-GORAKHPUR,6,All
2020,3,CHANDIGARH,GUWAHATI,660,189,CHANDIGARH-GUWAHATI,849,All
2021,1,CHANDIGARH,GUWAHATI,280,273,CHANDIGARH-GUWAHATI,553,All
2021,2,CHANDIGARH,GUWAHATI,807,699,CHANDIGARH-GUWAHATI,1506,All
2021,3,CHANDIGARH,GUWAHATI,650,472,CHANDIGARH-GUWAHATI,1122,All
2021,6,CHANDIGARH,GUWAHATI,22,25,CHANDIGARH-GUWAHATI,47,All
2021,7,CHANDIGARH,GUWAHATI,384,455,CHANDIGARH-GUWAHATI,839,All
2021,8,CHANDIGARH,GUWAHATI,356,519,CHANDIGARH-GUWAHATI,875,All
2021,11,CHANDIGARH,GUWAHATI,587,683,CHANDIGARH-GUWAHATI,1270,All
2021,12,CHANDIGARH,GUWAHATI,935,959,CHANDIGARH-GUWAHATI,1894,All
2022,1,CHANDIGARH,GUWAHATI,798,827,CHANDIGARH-GUWAHATI,1625,All
2022,2,CHANDIGARH,GUWAHATI,523,663,CHANDIGARH-GUWAHATI,1186,All
2022,3,CHANDIGARH,GUWAHATI,792,772,CHANDIGARH-GUWAHATI,1564,All
2022,4,CHANDIGARH,GUWAHATI,57,103,CHANDIGARH-GUWAHATI,160,All
2022,5,CHANDIGARH,GUWAHATI,849,833,CHANDIGARH-GUWAHATI,1682,All
2022,6,CHANDIGARH,GUWAHATI,950,833,CHANDIGARH-GUWAHATI,1783,All
2022,7,CHANDIGARH,GUWAHATI,1368,1452,CHANDIGARH-GUWAHATI,2820,All
2022,8,CHANDIGARH,GUWAHATI,1262,1414,CHANDIGARH-GUWAHATI,2676,All
2022,9,CHANDIGARH,GUWAHATI,1267,727,CHANDIGARH-GUWAHATI,1994,All
2022,10,CHANDIGARH,GUWAHATI,987,800,CHANDIGARH-GUWAHATI,1787,All
2022,11,CHANDIGARH,GUWAHATI,1185,821,CHANDIGARH-GUWAHATI,2006,All
2022,12,CHANDIGARH,GUWAHATI,1367,841,CHANDIGARH-GUWAHATI,2208,All
2023,1,CHANDIGARH,GUWAHATI,1180,1144,CHANDIGARH-GUWAHATI,2324,All
2023,2,CHANDIGARH,GUWAHATI,873,1008,CHANDIGARH-GUWAHATI,1881,All
2023,3,CHANDIGARH,GUWAHATI,1169,1181,CHANDIGARH-GUWAHATI,2350,All
2023,4,CHANDIGARH,GUWAHATI,1481,1524,CHANDIGARH-GUWAHATI,3005,All
2023,5,CHANDIGARH,GUWAHATI,968,1000,CHANDIGARH-GUWAHATI,1968,All
2023,6,CHANDIGARH,GUWAHATI,789,750,CHANDIGARH-GUWAHATI,1539,All
2023,7,CHANDIGARH,GUWAHATI,762,782,CHANDIGARH-GUWAHATI,1544,All
2023,8,CHANDIGARH,GUWAHATI,367,596,CHANDIGARH-GUWAHATI,963,All
2023,9,CHANDIGARH,GUWAHATI,517,548,CHANDIGARH-GUWAHATI,1065,All
2023,10,CHANDIGARH,GUWAHATI,958,1178,CHANDIGARH-GUWAHATI,2136,All
2023,11,CHANDIGARH,GUWAHATI,923,897,CHANDIGARH-GUWAHATI,1820,All
2023,12,CHANDIGARH,GUWAHATI,1559,1161,CHANDIGARH-GUWAHATI,2720,All
2024,1,CHANDIGARH,GUWAHATI,520,702,CHANDIGARH-GUWAHATI,1222,All
2024,2,CHANDIGARH,GUWAHATI,570,652,CHANDIGARH-GUWAHATI,1222,All
2024,3,CHANDIGARH,GUWAHATI,1005,1098,CHANDIGARH-GUWAHATI,2103,All
2024,4,CHANDIGARH,GUWAHATI,913,835,CHANDIGARH-GUWAHATI,1748,All
2024,6,CHANDIGARH,GUWAHATI,790,813,CHANDIGARH-GUWAHATI,1603,All
2024,7,CHANDIGARH,GUWAHATI,1364,1540,CHANDIGARH-GUWAHATI,2904,All
2024,8,CHANDIGARH,GUWAHATI,946,1281,CHANDIGARH-GUWAHATI,2227,All
2024,9,CHANDIGARH,GUWAHATI,949,1276,CHANDIGARH-GUWAHATI,2225,All
2024,10,CHANDIGARH,GUWAHATI,1055,1009,CHANDIGARH-GUWAHATI,2064,All
2024,11,CHANDIGARH,GUWAHATI,712,880,CHANDIGARH-GUWAHATI,1592,All
2024,12,CHANDIGARH,GUWAHATI,910,1057,CHANDIGARH-GUWAHATI,1967,All
2025,3,CHANDIGARH,GUWAHATI,1025,921,CHANDIGARH-GUWAHATI,1946,All
2023,11,CHANDIGARH,Goa,3700,3650,CHANDIGARH-Goa,7350,All
2023,12,CHANDIGARH,Goa,4079,3961,CHANDIGARH-Goa,8040,All
2024,1,CHANDIGARH,Goa,4621,4697,CHANDIGARH-Goa,9318,All
2024,2,CHANDIGARH,Goa,4031,4243,CHANDIGARH-Goa,8274,All
2024,3,CHANDIGARH,Goa,4224,4352,CHANDIGARH-Goa,8576,All
2024,10,CHANDIGARH,Goa,399,780,CHANDIGARH-Goa,1179,All
2024,11,CHANDIGARH,Goa,3426,3121,CHANDIGARH-Goa,6547,All
2021,1,CHANDIGARH,HISSAR,11,16,CHANDIGARH-HISSAR,27,All
2021,2,CHANDIGARH,HISSAR,25,21,CHANDIGARH-HISSAR,46,All
2021,3,CHANDIGARH,HISSAR,30,22,CHANDIGARH-HISSAR,52,All
2021,4,CHANDIGARH,HISSAR,6,9,CHANDIGARH-HISSAR,15,All
2021,6,CHANDIGARH,HISSAR,8,14,CHANDIGARH-HISSAR,22,All
2021,7,CHANDIGARH,HISSAR,10,16,CHANDIGARH-HISSAR,26,All
2019,5,CHANDIGARH,HYDERABAD,4051,3739,CHANDIGARH-HYDERABAD,7790,All
2019,6,CHANDIGARH,HYDERABAD,4081,3734,CHANDIGARH-HYDERABAD,7815,All
2019,7,CHANDIGARH,HYDERABAD,3783,3344,CHANDIGARH-HYDERABAD,7127,All
2019,8,CHANDIGARH,HYDERABAD,5763,5505,CHANDIGARH-HYDERABAD,11268,All
2019,9,CHANDIGARH,HYDERABAD,6535,6592,CHANDIGARH-HYDERABAD,13127,All
2019,10,CHANDIGARH,HYDERABAD,6179,6813,CHANDIGARH-HYDERABAD,12992,All
2019,11,CHANDIGARH,HYDERABAD,7307,6973,CHANDIGARH-HYDERABAD,14280,All
2019,12,CHANDIGARH,HYDERABAD,7772,8295,CHANDIGARH-HYDERABAD,16067,All
2020,1,CHANDIGARH,HYDERABAD,6107,6514,CHANDIGARH-HYDERABAD,12621,All
2020,2,CHANDIGARH,HYDERABAD,4344,4545,CHANDIGARH-HYDERABAD,8889,All
2020,3,CHANDIGARH,HYDERABAD,3720,4144,CHANDIGARH-HYDERABAD,7864,All
2020,6,CHANDIGARH,HYDERABAD,323,590,CHANDIGARH-HYDERABAD,913,All
2020,7,CHANDIGARH,HYDERABAD,1321,2572,CHANDIGARH-HYDERABAD,3893,All
2020,8,CHANDIGARH,HYDERABAD,1740,2862,CHANDIGARH-HYDERABAD,4602,All
2020,9,CHANDIGARH,HYDERABAD,1732,3092,CHANDIGARH-HYDERABAD,4824,All
2020,10,CHANDIGARH,HYDERABAD,2326,3627,CHANDIGARH-HYDERABAD,5953,All
2020,11,CHANDIGARH,HYDERABAD,3933,4110,CHANDIGARH-HYDERABAD,8043,All
2020,12,CHANDIGARH,HYDERABAD,5085,4696,CHANDIGARH-HYDERABAD,9781,All
2021,1,CHANDIGARH,HYDERABAD,4250,4377,CHANDIGARH-HYDERABAD,8627,All
2021,2,CHANDIGARH,HYDERABAD,4405,5097,CHANDIGARH-HYDERABAD,9502,All
2021,3,CHANDIGARH,HYDERABAD,4968,5889,CHANDIGARH-HYDERABAD,10857,All
2021,4,CHANDIGARH,HYDERABAD,3606,4206,CHANDIGARH-HYDERABAD,7812,All
2021,6,CHANDIGARH,HYDERABAD,994,1226,CHANDIGARH-HYDERABAD,2220,All
2021,7,CHANDIGARH,HYDERABAD,2165,2747,CHANDIGARH-HYDERABAD,4912,All
2021,8,CHANDIGARH,HYDERABAD,2148,2683,CHANDIGARH-HYDERABAD,4831,All
2021,9,CHANDIGARH,HYDERABAD,2515,3492,CHANDIGARH-HYDERABAD,6007,All
2021,10,CHANDIGARH,HYDERABAD,4433,4774,CHANDIGARH-HYDERABAD,9207,All
2021,11,CHANDIGARH,HYDERABAD,4651,5062,CHANDIGARH-HYDERABAD,9713,All
2021,12,CHANDIGARH,HYDERABAD,5113,5329,CHANDIGARH-HYDERABAD,10442,All
2022,1,CHANDIGARH,HYDERABAD,3222,4588,CHANDIGARH-HYDERABAD,7810,All
2022,2,CHANDIGARH,HYDERABAD,4348,5302,CHANDIGARH-HYDERABAD,9650,All
2022,3,CHANDIGARH,HYDERABAD,9963,11326,CHANDIGARH-HYDERABAD,21289,All
2022,4,CHANDIGARH,HYDERABAD,12953,15759,CHANDIGARH-HYDERABAD,28712,All
2022,5,CHANDIGARH,HYDERABAD,14446,15317,CHANDIGARH-HYDERABAD,29763,All
2022,6,CHANDIGARH,HYDERABAD,13438,12014,CHANDIGARH-HYDERABAD,25452,All
2022,7,CHANDIGARH,HYDERABAD,8388,8545,CHANDIGARH-HYDERABAD,16933,All
2022,8,CHANDIGARH,HYDERABAD,7314,8609,CHANDIGARH-HYDERABAD,15923,All
2022,9,CHANDIGARH,HYDERABAD,6911,9471,CHANDIGARH-HYDERABAD,16382,All
2022,10,CHANDIGARH,HYDERABAD,10180,11838,CHANDIGARH-HYDERABAD,22018,All
2022,11,CHANDIGARH,HYDERABAD,8858,8459,CHANDIGARH-HYDERABAD,17317,All
2022,12,CHANDIGARH,HYDERABAD,4608,4750,CHANDIGARH-HYDERABAD,9358,All
2023,1,CHANDIGARH,HYDERABAD,4178,4603,CHANDIGARH-HYDERABAD,8781,All
2023,2,CHANDIGARH,HYDERABAD,7271,8781,CHANDIGARH-HYDERABAD,16052,All
2023,3,CHANDIGARH,HYDERABAD,7882,8697,CHANDIGARH-HYDERABAD,16579,All
2023,4,CHANDIGARH,HYDERABAD,7509,9100,CHANDIGARH-HYDERABAD,16609,All
2023,5,CHANDIGARH,HYDERABAD,10249,10627,CHANDIGARH-HYDERABAD,20876,All
2023,6,CHANDIGARH,HYDERABAD,10367,9904,CHANDIGARH-HYDERABAD,20271,All
2023,7,CHANDIGARH,HYDERABAD,7071,6908,CHANDIGARH-HYDERABAD,13979,All
2023,8,CHANDIGARH,HYDERABAD,7192,8518,CHANDIGARH-HYDERABAD,15710,All
2023,9,CHANDIGARH,HYDERABAD,8675,8938,CHANDIGARH-HYDERABAD,17613,All
2023,10,CHANDIGARH,HYDERABAD,9820,10703,CHANDIGARH-HYDERABAD,20523,All
2023,11,CHANDIGARH,HYDERABAD,9015,8347,CHANDIGARH-HYDERABAD,17362,All
2023,12,CHANDIGARH,HYDERABAD,9221,8100,CHANDIGARH-HYDERABAD,17321,All
2024,1,CHANDIGARH,HYDERABAD,5925,6076,CHANDIGARH-HYDERABAD,12001,All
2024,2,CHANDIGARH,HYDERABAD,6363,6748,CHANDIGARH-HYDERABAD,13111,All
2024,3,CHANDIGARH,HYDERABAD,9080,9301,CHANDIGARH-HYDERABAD,18381,All
2024,4,CHANDIGARH,HYDERABAD,11129,12076,CHANDIGARH-HYDERABAD,23205,All
2024,6,CHANDIGARH,HYDERABAD,11968,10166,CHANDIGARH-HYDERABAD,22134,All
2024,7,CHANDIGARH,HYDERABAD,10348,9691,CHANDIGARH-HYDERABAD,20039,All
2024,8,CHANDIGARH,HYDERABAD,9554,10212,CHANDIGARH-HYDERABAD,19766,All
2024,9,CHANDIGARH,HYDERABAD,9329,9716,CHANDIGARH-HYDERABAD,19045,All
2024,10,CHANDIGARH,HYDERABAD,10790,11561,CHANDIGARH-HYDERABAD,22351,All
2024,11,CHANDIGARH,HYDERABAD,10179,9836,CHANDIGARH-HYDERABAD,20015,All
2024,12,CHANDIGARH,HYDERABAD,11623,11698,CHANDIGARH-HYDERABAD,23321,All
2025,1,CHANDIGARH,HYDERABAD,9714,11031,CHANDIGARH-HYDERABAD,20745,All
2025,2,CHANDIGARH,HYDERABAD,9389,10844,CHANDIGARH-HYDERABAD,20233,All
2025,3,CHANDIGARH,HYDERABAD,10572,11955,CHANDIGARH-HYDERABAD,22527,All
2021,3,CHANDIGARH,INDORE,114,274,CHANDIGARH-INDORE,388,All
2021,4,CHANDIGARH,INDORE,637,808,CHANDIGARH-INDORE,1445,All
2021,8,CHANDIGARH,INDORE,249,377,CHANDIGARH-INDORE,626,All
2022,11,CHANDIGARH,INDORE,1550,1547,CHANDIGARH-INDORE,3097,All
2022,12,CHANDIGARH,INDORE,1434,1346,CHANDIGARH-INDORE,2780,All
2023,1,CHANDIGARH,INDORE,1256,1608,CHANDIGARH-INDORE,2864,All
2023,2,CHANDIGARH,INDORE,1252,1551,CHANDIGARH-INDORE,2803,All
2023,3,CHANDIGARH,INDORE,1800,1885,CHANDIGARH-INDORE,3685,All
2023,4,CHANDIGARH,INDORE,1757,1797,CHANDIGARH-INDORE,3554,All
2023,5,CHANDIGARH,INDORE,2577,2817,CHANDIGARH-INDORE,5394,All
2023,6,CHANDIGARH,INDORE,2591,2391,CHANDIGARH-INDORE,4982,All
2023,7,CHANDIGARH,INDORE,2005,2238,CHANDIGARH-INDORE,4243,All
2023,8,CHANDIGARH,INDORE,2553,2737,CHANDIGARH-INDORE,5290,All
2023,9,CHANDIGARH,INDORE,2680,2624,CHANDIGARH-INDORE,5304,All
2023,10,CHANDIGARH,INDORE,2462,2321,CHANDIGARH-INDORE,4783,All
2023,11,CHANDIGARH,INDORE,2050,1999,CHANDIGARH-INDORE,4049,All
2023,12,CHANDIGARH,INDORE,1915,1860,CHANDIGARH-INDORE,3775,All
2024,1,CHANDIGARH,INDORE,1932,2079,CHANDIGARH-INDORE,4011,All
2024,2,CHANDIGARH,INDORE,2055,1974,CHANDIGARH-INDORE,4029,All
2024,3,CHANDIGARH,INDORE,2513,2388,CHANDIGARH-INDORE,4901,All
2024,4,CHANDIGARH,INDORE,1971,1953,CHANDIGARH-INDORE,3924,All
2024,6,CHANDIGARH,INDORE,2061,1909,CHANDIGARH-INDORE,3970,All
2024,7,CHANDIGARH,INDORE,2090,2009,CHANDIGARH-INDORE,4099,All
2024,8,CHANDIGARH,INDORE,2126,2170,CHANDIGARH-INDORE,4296,All
2024,9,CHANDIGARH,INDORE,1859,1872,CHANDIGARH-INDORE,3731,All
2024,10,CHANDIGARH,INDORE,1951,1710,CHANDIGARH-INDORE,3661,All
2024,11,CHANDIGARH,INDORE,2160,2614,CHANDIGARH-INDORE,4774,All
2024,12,CHANDIGARH,INDORE,1694,1955,CHANDIGARH-INDORE,3649,All
2025,1,CHANDIGARH,INDORE,2338,2663,CHANDIGARH-INDORE,5001,All
2025,2,CHANDIGARH,INDORE,2364,2576,CHANDIGARH-INDORE,4940,All
2025,3,CHANDIGARH,INDORE,2696,2727,CHANDIGARH-INDORE,5423,All
2017,3,CHANDIGARH,JAIPUR,885,737,CHANDIGARH-JAIPUR,1622,All
2017,4,CHANDIGARH,JAIPUR,4524,4274,CHANDIGARH-JAIPUR,8798,All
2017,5,CHANDIGARH,JAIPUR,3205,3750,CHANDIGARH-JAIPUR,6955,All
2017,6,CHANDIGARH,JAIPUR,3287,3863,CHANDIGARH-JAIPUR,7150,All
2017,7,CHANDIGARH,JAIPUR,3029,3736,CHANDIGARH-JAIPUR,6765,All
2017,8,CHANDIGARH,JAIPUR,3262,3723,CHANDIGARH-JAIPUR,6985,All
2017,9,CHANDIGARH,JAIPUR,3191,3617,CHANDIGARH-JAIPUR,6808,All
2017,10,CHANDIGARH,JAIPUR,1660,3186,CHANDIGARH-JAIPUR,4846,All
2017,11,CHANDIGARH,JAIPUR,1611,1588,CHANDIGARH-JAIPUR,3199,All
2017,12,CHANDIGARH,JAIPUR,1546,1569,CHANDIGARH-JAIPUR,3115,All
2018,1,CHANDIGARH,JAIPUR,1392,1680,CHANDIGARH-JAIPUR,3072,All
2018,2,CHANDIGARH,JAIPUR,554,582,CHANDIGARH-JAIPUR,1136,All
2018,3,CHANDIGARH,JAIPUR,284,336,CHANDIGARH-JAIPUR,620,All
2018,4,CHANDIGARH,JAIPUR,1454,1489,CHANDIGARH-JAIPUR,2943,All
2018,5,CHANDIGARH,JAIPUR,464,472,CHANDIGARH-JAIPUR,936,All
2018,6,CHANDIGARH,JAIPUR,1498,1598,CHANDIGARH-JAIPUR,3096,All
2018,7,CHANDIGARH,JAIPUR,1323,1323,CHANDIGARH-JAIPUR,2646,All
2018,8,CHANDIGARH,JAIPUR,1410,1384,CHANDIGARH-JAIPUR,2794,All
2018,9,CHANDIGARH,JAIPUR,1729,1828,CHANDIGARH-JAIPUR,3557,All
2018,10,CHANDIGARH,JAIPUR,1711,1700,CHANDIGARH-JAIPUR,3411,All
2018,11,CHANDIGARH,JAIPUR,1594,1638,CHANDIGARH-JAIPUR,3232,All
2018,12,CHANDIGARH,JAIPUR,1650,1708,CHANDIGARH-JAIPUR,3358,All
2019,1,CHANDIGARH,JAIPUR,1647,1592,CHANDIGARH-JAIPUR,3239,All
2019,2,CHANDIGARH,JAIPUR,428,449,CHANDIGARH-JAIPUR,877,All
2019,4,CHANDIGARH,JAIPUR,238,240,CHANDIGARH-JAIPUR,478,All
2020,8,CHANDIGARH,JAIPUR,97,74,CHANDIGARH-JAIPUR,171,All
2020,12,CHANDIGARH,JAIPUR,822,3615,CHANDIGARH-JAIPUR,4437,All
2021,1,CHANDIGARH,JAIPUR,2630,3667,CHANDIGARH-JAIPUR,6297,All
2021,2,CHANDIGARH,JAIPUR,3431,3922,CHANDIGARH-JAIPUR,7353,All
2021,3,CHANDIGARH,JAIPUR,3329,3857,CHANDIGARH-JAIPUR,7186,All
2021,4,CHANDIGARH,JAIPUR,403,812,CHANDIGARH-JAIPUR,1215,All
2021,7,CHANDIGARH,JAIPUR,1348,411,CHANDIGARH-JAIPUR,1759,All
2021,8,CHANDIGARH,JAIPUR,1652,1808,CHANDIGARH-JAIPUR,3460,All
2021,9,CHANDIGARH,JAIPUR,1920,1921,CHANDIGARH-JAIPUR,3841,All
2021,10,CHANDIGARH,JAIPUR,1810,1913,CHANDIGARH-JAIPUR,3723,All
2021,11,CHANDIGARH,JAIPUR,2809,2630,CHANDIGARH-JAIPUR,5439,All
2021,12,CHANDIGARH,JAIPUR,2856,2651,CHANDIGARH-JAIPUR,5507,All
2022,1,CHANDIGARH,JAIPUR,997,771,CHANDIGARH-JAIPUR,1768,All
2022,2,CHANDIGARH,JAIPUR,455,367,CHANDIGARH-JAIPUR,822,All
2022,3,CHANDIGARH,JAIPUR,3941,3584,CHANDIGARH-JAIPUR,7525,All
2022,4,CHANDIGARH,JAIPUR,4016,3324,CHANDIGARH-JAIPUR,7340,All
2022,5,CHANDIGARH,JAIPUR,3678,3035,CHANDIGARH-JAIPUR,6713,All
2022,6,CHANDIGARH,JAIPUR,3721,2743,CHANDIGARH-JAIPUR,6464,All
2022,7,CHANDIGARH,JAIPUR,3567,2733,CHANDIGARH-JAIPUR,6300,All
2022,8,CHANDIGARH,JAIPUR,3720,2975,CHANDIGARH-JAIPUR,6695,All
2022,9,CHANDIGARH,JAIPUR,3974,3204,CHANDIGARH-JAIPUR,7178,All
2022,10,CHANDIGARH,JAIPUR,3874,3567,CHANDIGARH-JAIPUR,7441,All
2022,11,CHANDIGARH,JAIPUR,4335,4506,CHANDIGARH-JAIPUR,8841,All
2022,12,CHANDIGARH,JAIPUR,4462,4443,CHANDIGARH-JAIPUR,8905,All
2023,1,CHANDIGARH,JAIPUR,4335,4280,CHANDIGARH-JAIPUR,8615,All
2023,2,CHANDIGARH,JAIPUR,4038,3974,CHANDIGARH-JAIPUR,8012,All
2023,3,CHANDIGARH,JAIPUR,4512,4734,CHANDIGARH-JAIPUR,9246,All
2023,4,CHANDIGARH,JAIPUR,5524,5760,CHANDIGARH-JAIPUR,11284,All
2023,5,CHANDIGARH,JAIPUR,6142,6304,CHANDIGARH-JAIPUR,12446,All
2023,6,CHANDIGARH,JAIPUR,6058,5727,CHANDIGARH-JAIPUR,11785,All
2023,7,CHANDIGARH,JAIPUR,5709,5178,CHANDIGARH-JAIPUR,10887,All
2023,8,CHANDIGARH,JAIPUR,5882,5403,CHANDIGARH-JAIPUR,11285,All
2023,9,CHANDIGARH,JAIPUR,5719,5403,CHANDIGARH-JAIPUR,11122,All
2023,10,CHANDIGARH,JAIPUR,5397,5516,CHANDIGARH-JAIPUR,10913,All
2023,11,CHANDIGARH,JAIPUR,5411,5528,CHANDIGARH-JAIPUR,10939,All
2023,12,CHANDIGARH,JAIPUR,6020,6190,CHANDIGARH-JAIPUR,12210,All
2024,1,CHANDIGARH,JAIPUR,4861,5018,CHANDIGARH-JAIPUR,9879,All
2024,2,CHANDIGARH,JAIPUR,5544,5822,CHANDIGARH-JAIPUR,11366,All
2024,3,CHANDIGARH,JAIPUR,5981,5815,CHANDIGARH-JAIPUR,11796,All
2024,4,CHANDIGARH,JAIPUR,5569,5645,CHANDIGARH-JAIPUR,11214,All
2024,6,CHANDIGARH,JAIPUR,6052,5371,CHANDIGARH-JAIPUR,11423,All
2024,7,CHANDIGARH,JAIPUR,5593,5421,CHANDIGARH-JAIPUR,11014,All
2024,8,CHANDIGARH,JAIPUR,5014,5275,CHANDIGARH-JAIPUR,10289,All
2024,9,CHANDIGARH,JAIPUR,5117,5194,CHANDIGARH-JAIPUR,10311,All
2024,10,CHANDIGARH,JAIPUR,5060,5469,CHANDIGARH-JAIPUR,10529,All
2024,11,CHANDIGARH,JAIPUR,5297,5312,CHANDIGARH-JAIPUR,10609,All
2024,12,CHANDIGARH,JAIPUR,5425,5570,CHANDIGARH-JAIPUR,10995,All
2025,1,CHANDIGARH,JAIPUR,4443,5033,CHANDIGARH-JAIPUR,9476,All
2025,2,CHANDIGARH,JAIPUR,5107,5634,CHANDIGARH-JAIPUR,10741,All
2025,3,CHANDIGARH,JAIPUR,6390,6736,CHANDIGARH-JAIPUR,13126,All
2017,3,CHANDIGARH,JAMMU,139,156,CHANDIGARH-JAMMU,295,All
2017,4,CHANDIGARH,JAMMU,1350,1311,CHANDIGARH-JAMMU,2661,All
2017,5,CHANDIGARH,JAMMU,1812,1286,CHANDIGARH-JAMMU,3098,All
2017,6,CHANDIGARH,JAMMU,2257,1598,CHANDIGARH-JAMMU,3855,All
2017,7,CHANDIGARH,JAMMU,2237,1955,CHANDIGARH-JAMMU,4192,All
2017,8,CHANDIGARH,JAMMU,2031,1897,CHANDIGARH-JAMMU,3928,All
2017,9,CHANDIGARH,JAMMU,1995,1857,CHANDIGARH-JAMMU,3852,All
2017,10,CHANDIGARH,JAMMU,1670,55,CHANDIGARH-JAMMU,1725,All
2021,8,CHANDIGARH,JAMMU,28,34,CHANDIGARH-JAMMU,62,All
2021,10,CHANDIGARH,JAMMU,0,73,CHANDIGARH-JAMMU,73,All
2021,11,CHANDIGARH,JAMMU,1,474,CHANDIGARH-JAMMU,475,All
2022,4,CHANDIGARH,JAMMU,1,0,CHANDIGARH-JAMMU,1,All
2022,6,CHANDIGARH,JAMMU,1,0,CHANDIGARH-JAMMU,1,All
2022,9,CHANDIGARH,JAMMU,1,0,CHANDIGARH-JAMMU,1,All
2024,4,CHANDIGARH,JAMMU,2515,1626,CHANDIGARH-JAMMU,4141,All
2024,6,CHANDIGARH,JAMMU,2668,2036,CHANDIGARH-JAMMU,4704,All
2024,7,CHANDIGARH,JAMMU,1764,1258,CHANDIGARH-JAMMU,3022,All
2024,8,CHANDIGARH,JAMMU,1773,1018,CHANDIGARH-JAMMU,2791,All
2024,9,CHANDIGARH,JAMMU,1873,1093,CHANDIGARH-JAMMU,2966,All
2024,10,CHANDIGARH,JAMMU,2082,1156,CHANDIGARH-JAMMU,3238,All
2024,11,CHANDIGARH,JAMMU,423,313,CHANDIGARH-JAMMU,736,All
2024,12,CHANDIGARH,JAMMU,1302,1263,CHANDIGARH-JAMMU,2565,All
2025,1,CHANDIGARH,JAMMU,1370,1421,CHANDIGARH-JAMMU,2791,All
2025,2,CHANDIGARH,JAMMU,979,896,CHANDIGARH-JAMMU,1875,All
2019,10,CHANDIGARH,KOCHI,0,7,CHANDIGARH-KOCHI,7,All
2019,11,CHANDIGARH,KOCHI,0,173,CHANDIGARH-KOCHI,173,All
2019,12,CHANDIGARH,KOCHI,0,253,CHANDIGARH-KOCHI,253,All
2020,1,CHANDIGARH,KOCHI,0,283,CHANDIGARH-KOCHI,283,All
2020,2,CHANDIGARH,KOCHI,0,255,CHANDIGARH-KOCHI,255,All
2020,3,CHANDIGARH,KOCHI,55,270,CHANDIGARH-KOCHI,325,All
2021,1,CHANDIGARH,KOCHI,104,89,CHANDIGARH-KOCHI,193,All
2021,2,CHANDIGARH,KOCHI,420,235,CHANDIGARH-KOCHI,655,All
2021,3,CHANDIGARH,KOCHI,517,222,CHANDIGARH-KOCHI,739,All
2021,4,CHANDIGARH,KOCHI,231,0,CHANDIGARH-KOCHI,231,All
2021,6,CHANDIGARH,KOCHI,152,0,CHANDIGARH-KOCHI,152,All
2021,7,CHANDIGARH,KOCHI,186,0,CHANDIGARH-KOCHI,186,All
2021,8,CHANDIGARH,KOCHI,144,40,CHANDIGARH-KOCHI,184,All
2022,11,CHANDIGARH,KOCHI,134,149,CHANDIGARH-KOCHI,283,All
2022,12,CHANDIGARH,KOCHI,208,259,CHANDIGARH-KOCHI,467,All
2023,1,CHANDIGARH,KOCHI,325,370,CHANDIGARH-KOCHI,695,All
2023,2,CHANDIGARH,KOCHI,221,288,CHANDIGARH-KOCHI,509,All
2023,3,CHANDIGARH,KOCHI,136,219,CHANDIGARH-KOCHI,355,All
2023,4,CHANDIGARH,KOCHI,294,275,CHANDIGARH-KOCHI,569,All
2023,5,CHANDIGARH,KOCHI,243,80,CHANDIGARH-KOCHI,323,All
2023,6,CHANDIGARH,KOCHI,229,135,CHANDIGARH-KOCHI,364,All
2023,7,CHANDIGARH,KOCHI,113,92,CHANDIGARH-KOCHI,205,All
2023,8,CHANDIGARH,KOCHI,117,145,CHANDIGARH-KOCHI,262,All
2023,9,CHANDIGARH,KOCHI,103,144,CHANDIGARH-KOCHI,247,All
2023,10,CHANDIGARH,KOCHI,212,282,CHANDIGARH-KOCHI,494,All
2023,11,CHANDIGARH,KOCHI,220,201,CHANDIGARH-KOCHI,421,All
2023,12,CHANDIGARH,KOCHI,495,339,CHANDIGARH-KOCHI,834,All
2024,1,CHANDIGARH,KOCHI,92,92,CHANDIGARH-KOCHI,184,All
2024,2,CHANDIGARH,KOCHI,199,352,CHANDIGARH-KOCHI,551,All
2024,3,CHANDIGARH,KOCHI,219,331,CHANDIGARH-KOCHI,550,All
2024,4,CHANDIGARH,KOCHI,241,272,CHANDIGARH-KOCHI,513,All
2024,6,CHANDIGARH,KOCHI,225,334,CHANDIGARH-KOCHI,559,All
2024,7,CHANDIGARH,KOCHI,143,453,CHANDIGARH-KOCHI,596,All
2024,8,CHANDIGARH,KOCHI,251,411,CHANDIGARH-KOCHI,662,All
2024,9,CHANDIGARH,KOCHI,466,590,CHANDIGARH-KOCHI,1056,All
2024,10,CHANDIGARH,KOCHI,488,390,CHANDIGARH-KOCHI,878,All
2024,11,CHANDIGARH,KOCHI,238,409,CHANDIGARH-KOCHI,647,All
2024,12,CHANDIGARH,KOCHI,739,631,CHANDIGARH-KOCHI,1370,All
2025,3,CHANDIGARH,KOCHI,316,552,CHANDIGARH-KOCHI,868,All
2019,5,CHANDIGARH,KOLKATA,3978,3017,CHANDIGARH-KOLKATA,6995,All
2019,6,CHANDIGARH,KOLKATA,3976,2491,CHANDIGARH-KOLKATA,6467,All
2019,7,CHANDIGARH,KOLKATA,3055,2271,CHANDIGARH-KOLKATA,5326,All
2019,8,CHANDIGARH,KOLKATA,860,0,CHANDIGARH-KOLKATA,860,All
2019,9,CHANDIGARH,KOLKATA,2309,1754,CHANDIGARH-KOLKATA,4063,All
2019,10,CHANDIGARH,KOLKATA,3835,2880,CHANDIGARH-KOLKATA,6715,All
2019,11,CHANDIGARH,KOLKATA,3502,2664,CHANDIGARH-KOLKATA,6166,All
2019,12,CHANDIGARH,KOLKATA,0,1213,CHANDIGARH-KOLKATA,1213,All
2020,1,CHANDIGARH,KOLKATA,0,897,CHANDIGARH-KOLKATA,897,All
2020,2,CHANDIGARH,KOLKATA,1862,2750,CHANDIGARH-KOLKATA,4612,All
2020,3,CHANDIGARH,KOLKATA,3587,2991,CHANDIGARH-KOLKATA,6578,All
2020,6,CHANDIGARH,KOLKATA,1346,734,CHANDIGARH-KOLKATA,2080,All
2020,7,CHANDIGARH,KOLKATA,2427,1630,CHANDIGARH-KOLKATA,4057,All
2020,8,CHANDIGARH,KOLKATA,2558,3614,CHANDIGARH-KOLKATA,6172,All
2020,9,CHANDIGARH,KOLKATA,2277,3716,CHANDIGARH-KOLKATA,5993,All
2020,10,CHANDIGARH,KOLKATA,3436,3819,CHANDIGARH-KOLKATA,7255,All
2020,11,CHANDIGARH,KOLKATA,4565,4415,CHANDIGARH-KOLKATA,8980,All
2020,12,CHANDIGARH,KOLKATA,5079,4861,CHANDIGARH-KOLKATA,9940,All
2021,1,CHANDIGARH,KOLKATA,4185,4299,CHANDIGARH-KOLKATA,8484,All
2021,2,CHANDIGARH,KOLKATA,4081,4475,CHANDIGARH-KOLKATA,8556,All
2021,3,CHANDIGARH,KOLKATA,4508,4853,CHANDIGARH-KOLKATA,9361,All
2021,4,CHANDIGARH,KOLKATA,6034,5029,CHANDIGARH-KOLKATA,11063,All
2021,6,CHANDIGARH,KOLKATA,361,519,CHANDIGARH-KOLKATA,880,All
2021,7,CHANDIGARH,KOLKATA,2192,2549,CHANDIGARH-KOLKATA,4741,All
2021,8,CHANDIGARH,KOLKATA,3027,3155,CHANDIGARH-KOLKATA,6182,All
2021,9,CHANDIGARH,KOLKATA,2798,2756,CHANDIGARH-KOLKATA,5554,All
2021,10,CHANDIGARH,KOLKATA,3775,4004,CHANDIGARH-KOLKATA,7779,All
2021,11,CHANDIGARH,KOLKATA,4352,4667,CHANDIGARH-KOLKATA,9019,All
2021,12,CHANDIGARH,KOLKATA,4617,4853,CHANDIGARH-KOLKATA,9470,All
2022,1,CHANDIGARH,KOLKATA,2717,2945,CHANDIGARH-KOLKATA,5662,All
2022,2,CHANDIGARH,KOLKATA,2216,2755,CHANDIGARH-KOLKATA,4971,All
2022,3,CHANDIGARH,KOLKATA,3452,3782,CHANDIGARH-KOLKATA,7234,All
2022,4,CHANDIGARH,KOLKATA,2744,3274,CHANDIGARH-KOLKATA,6018,All
2022,5,CHANDIGARH,KOLKATA,2658,3199,CHANDIGARH-KOLKATA,5857,All
2022,6,CHANDIGARH,KOLKATA,2906,3032,CHANDIGARH-KOLKATA,5938,All
2022,7,CHANDIGARH,KOLKATA,1997,3135,CHANDIGARH-KOLKATA,5132,All
2022,8,CHANDIGARH,KOLKATA,2021,3386,CHANDIGARH-KOLKATA,5407,All
2022,9,CHANDIGARH,KOLKATA,2349,3178,CHANDIGARH-KOLKATA,5527,All
2022,10,CHANDIGARH,KOLKATA,3621,4063,CHANDIGARH-KOLKATA,7684,All
2022,11,CHANDIGARH,KOLKATA,3362,4134,CHANDIGARH-KOLKATA,7496,All
2022,12,CHANDIGARH,KOLKATA,3544,4035,CHANDIGARH-KOLKATA,7579,All
2023,1,CHANDIGARH,KOLKATA,3511,4303,CHANDIGARH-KOLKATA,7814,All
2023,2,CHANDIGARH,KOLKATA,3049,3478,CHANDIGARH-KOLKATA,6527,All
2023,3,CHANDIGARH,KOLKATA,2761,2586,CHANDIGARH-KOLKATA,5347,All
2023,4,CHANDIGARH,KOLKATA,3257,3150,CHANDIGARH-KOLKATA,6407,All
2023,5,CHANDIGARH,KOLKATA,2973,3203,CHANDIGARH-KOLKATA,6176,All
2023,6,CHANDIGARH,KOLKATA,3536,2910,CHANDIGARH-KOLKATA,6446,All
2023,7,CHANDIGARH,KOLKATA,2684,2653,CHANDIGARH-KOLKATA,5337,All
2023,8,CHANDIGARH,KOLKATA,3114,3221,CHANDIGARH-KOLKATA,6335,All
2023,9,CHANDIGARH,KOLKATA,2890,2897,CHANDIGARH-KOLKATA,5787,All
2023,10,CHANDIGARH,KOLKATA,3442,3189,CHANDIGARH-KOLKATA,6631,All
2023,11,CHANDIGARH,KOLKATA,4129,4275,CHANDIGARH-KOLKATA,8404,All
2023,12,CHANDIGARH,KOLKATA,4662,4671,CHANDIGARH-KOLKATA,9333,All
2024,1,CHANDIGARH,KOLKATA,4649,5630,CHANDIGARH-KOLKATA,10279,All
2024,2,CHANDIGARH,KOLKATA,4604,4925,CHANDIGARH-KOLKATA,9529,All
2024,3,CHANDIGARH,KOLKATA,4690,4374,CHANDIGARH-KOLKATA,9064,All
2024,4,CHANDIGARH,KOLKATA,2863,2765,CHANDIGARH-KOLKATA,5628,All
2024,6,CHANDIGARH,KOLKATA,4651,3367,CHANDIGARH-KOLKATA,8018,All
2024,7,CHANDIGARH,KOLKATA,4248,4304,CHANDIGARH-KOLKATA,8552,All
2024,8,CHANDIGARH,KOLKATA,3769,4690,CHANDIGARH-KOLKATA,8459,All
2024,9,CHANDIGARH,KOLKATA,4058,4315,CHANDIGARH-KOLKATA,8373,All
2024,10,CHANDIGARH,KOLKATA,4995,5051,CHANDIGARH-KOLKATA,10046,All
2024,11,CHANDIGARH,KOLKATA,5090,4941,CHANDIGARH-KOLKATA,10031,All
2024,12,CHANDIGARH,KOLKATA,5849,5264,CHANDIGARH-KOLKATA,11113,All
2025,1,CHANDIGARH,KOLKATA,5039,5381,CHANDIGARH-KOLKATA,10420,All
2025,2,CHANDIGARH,KOLKATA,5484,5515,CHANDIGARH-KOLKATA,10999,All
2025,3,CHANDIGARH,KOLKATA,4945,4876,CHANDIGARH-KOLKATA,9821,All
2017,10,CHANDIGARH,KULLU,174,375,CHANDIGARH-KULLU,549,All
2017,11,CHANDIGARH,KULLU,431,438,CHANDIGARH-KULLU,869,All
2017,12,CHANDIGARH,KULLU,25,31,CHANDIGARH-KULLU,56,All
2018,2,CHANDIGARH,KULLU,30,31,CHANDIGARH-KULLU,61,All
2018,3,CHANDIGARH,KULLU,812,627,CHANDIGARH-KULLU,1439,All
2018,4,CHANDIGARH,KULLU,627,460,CHANDIGARH-KULLU,1087,All
2018,5,CHANDIGARH,KULLU,206,218,CHANDIGARH-KULLU,424,All
2018,6,CHANDIGARH,KULLU,680,568,CHANDIGARH-KULLU,1248,All
2018,7,CHANDIGARH,KULLU,276,274,CHANDIGARH-KULLU,550,All
2018,8,CHANDIGARH,KULLU,401,301,CHANDIGARH-KULLU,702,All
2018,9,CHANDIGARH,KULLU,505,380,CHANDIGARH-KULLU,885,All
2018,10,CHANDIGARH,KULLU,379,425,CHANDIGARH-KULLU,804,All
2018,11,CHANDIGARH,KULLU,430,395,CHANDIGARH-KULLU,825,All
2018,12,CHANDIGARH,KULLU,87,220,CHANDIGARH-KULLU,307,All
2019,1,CHANDIGARH,KULLU,73,131,CHANDIGARH-KULLU,204,All
2019,2,CHANDIGARH,KULLU,168,68,CHANDIGARH-KULLU,236,All
2019,3,CHANDIGARH,KULLU,441,252,CHANDIGARH-KULLU,693,All
2019,4,CHANDIGARH,KULLU,590,261,CHANDIGARH-KULLU,851,All
2019,5,CHANDIGARH,KULLU,896,442,CHANDIGARH-KULLU,1338,All
2019,6,CHANDIGARH,KULLU,714,409,CHANDIGARH-KULLU,1123,All
2019,7,CHANDIGARH,KULLU,525,310,CHANDIGARH-KULLU,835,All
2019,8,CHANDIGARH,KULLU,486,185,CHANDIGARH-KULLU,671,All
2019,9,CHANDIGARH,KULLU,409,205,CHANDIGARH-KULLU,614,All
2019,10,CHANDIGARH,KULLU,623,398,CHANDIGARH-KULLU,1021,All
2019,11,CHANDIGARH,KULLU,547,189,CHANDIGARH-KULLU,736,All
2019,12,CHANDIGARH,KULLU,444,306,CHANDIGARH-KULLU,750,All
2020,1,CHANDIGARH,KULLU,100,64,CHANDIGARH-KULLU,164,All
2020,2,CHANDIGARH,KULLU,307,0,CHANDIGARH-KULLU,307,All
2020,3,CHANDIGARH,KULLU,270,37,CHANDIGARH-KULLU,307,All
2020,9,CHANDIGARH,KULLU,67,7,CHANDIGARH-KULLU,74,All
2020,10,CHANDIGARH,KULLU,225,36,CHANDIGARH-KULLU,261,All
2020,11,CHANDIGARH,KULLU,175,32,CHANDIGARH-KULLU,207,All
2020,12,CHANDIGARH,KULLU,248,52,CHANDIGARH-KULLU,300,All
2021,1,CHANDIGARH,KULLU,345,121,CHANDIGARH-KULLU,466,All
2021,2,CHANDIGARH,KULLU,363,129,CHANDIGARH-KULLU,492,All
2021,3,CHANDIGARH,KULLU,437,114,CHANDIGARH-KULLU,551,All
2021,4,CHANDIGARH,KULLU,419,117,CHANDIGARH-KULLU,536,All
2021,6,CHANDIGARH,KULLU,72,75,CHANDIGARH-KULLU,147,All
2021,7,CHANDIGARH,KULLU,402,102,CHANDIGARH-KULLU,504,All
2021,8,CHANDIGARH,KULLU,269,89,CHANDIGARH-KULLU,358,All
2021,9,CHANDIGARH,KULLU,352,70,CHANDIGARH-KULLU,422,All
2021,10,CHANDIGARH,KULLU,444,107,CHANDIGARH-KULLU,551,All
2021,11,CHANDIGARH,KULLU,501,98,CHANDIGARH-KULLU,599,All
2021,12,CHANDIGARH,KULLU,379,82,CHANDIGARH-KULLU,461,All
2022,1,CHANDIGARH,KULLU,253,63,CHANDIGARH-KULLU,316,All
2022,2,CHANDIGARH,KULLU,227,47,CHANDIGARH-KULLU,274,All
2022,3,CHANDIGARH,KULLU,550,158,CHANDIGARH-KULLU,708,All
2022,4,CHANDIGARH,KULLU,501,98,CHANDIGARH-KULLU,599,All
2022,5,CHANDIGARH,KULLU,379,82,CHANDIGARH-KULLU,461,All
2022,6,CHANDIGARH,KULLU,501,98,CHANDIGARH-KULLU,599,All
2022,7,CHANDIGARH,KULLU,227,47,CHANDIGARH-KULLU,274,All
2022,8,CHANDIGARH,KULLU,379,82,CHANDIGARH-KULLU,461,All
2022,9,CHANDIGARH,KULLU,501,98,CHANDIGARH-KULLU,599,All
2022,10,CHANDIGARH,KULLU,249,171,CHANDIGARH-KULLU,420,All
2022,11,CHANDIGARH,KULLU,217,173,CHANDIGARH-KULLU,390,All
2022,12,CHANDIGARH,KULLU,257,181,CHANDIGARH-KULLU,438,All
2023,1,CHANDIGARH,KULLU,363,288,CHANDIGARH-KULLU,651,All
2023,2,CHANDIGARH,KULLU,202,158,CHANDIGARH-KULLU,360,All
2023,3,CHANDIGARH,KULLU,281,198,CHANDIGARH-KULLU,479,All
2023,4,CHANDIGARH,KULLU,509,383,CHANDIGARH-KULLU,892,All
2023,5,CHANDIGARH,KULLU,774,584,CHANDIGARH-KULLU,1358,All
2023,6,CHANDIGARH,KULLU,646,316,CHANDIGARH-KULLU,962,All
2023,7,CHANDIGARH,KULLU,404,282,CHANDIGARH-KULLU,686,All
2023,8,CHANDIGARH,KULLU,443,322,CHANDIGARH-KULLU,765,All
2023,9,CHANDIGARH,KULLU,662,343,CHANDIGARH-KULLU,1005,All
2023,10,CHANDIGARH,KULLU,407,215,CHANDIGARH-KULLU,622,All
2023,11,CHANDIGARH,KULLU,139,88,CHANDIGARH-KULLU,227,All
2024,4,CHANDIGARH,KULLU,40,0,CHANDIGARH-KULLU,40,All
2024,7,CHANDIGARH,KULLU,77,0,CHANDIGARH-KULLU,77,All
2016,12,CHANDIGARH,LEH,54,98,CHANDIGARH-LEH,152,All
2017,1,CHANDIGARH,LEH,410,1156,CHANDIGARH-LEH,1566,All
2017,2,CHANDIGARH,LEH,1438,1199,CHANDIGARH-LEH,2637,All
2017,3,CHANDIGARH,LEH,1470,648,CHANDIGARH-LEH,2118,All
2017,4,CHANDIGARH,LEH,1531,1193,CHANDIGARH-LEH,2724,All
2017,5,CHANDIGARH,LEH,1440,1432,CHANDIGARH-LEH,2872,All
2017,6,CHANDIGARH,LEH,1315,1500,CHANDIGARH-LEH,2815,All
2017,7,CHANDIGARH,LEH,1206,1525,CHANDIGARH-LEH,2731,All
2017,8,CHANDIGARH,LEH,1148,1565,CHANDIGARH-LEH,2713,All
2017,9,CHANDIGARH,LEH,678,892,CHANDIGARH-LEH,1570,All
2017,10,CHANDIGARH,LEH,480,905,CHANDIGARH-LEH,1385,All
2017,11,CHANDIGARH,LEH,405,901,CHANDIGARH-LEH,1306,All
2017,12,CHANDIGARH,LEH,480,883,CHANDIGARH-LEH,1363,All
2018,1,CHANDIGARH,LEH,532,855,CHANDIGARH-LEH,1387,All
2018,2,CHANDIGARH,LEH,439,382,CHANDIGARH-LEH,821,All
2018,3,CHANDIGARH,LEH,882,346,CHANDIGARH-LEH,1228,All
2018,4,CHANDIGARH,LEH,835,600,CHANDIGARH-LEH,1435,All
2018,5,CHANDIGARH,LEH,232,200,CHANDIGARH-LEH,432,All
2018,6,CHANDIGARH,LEH,1033,1076,CHANDIGARH-LEH,2109,All
2018,7,CHANDIGARH,LEH,980,1065,CHANDIGARH-LEH,2045,All
2018,8,CHANDIGARH,LEH,702,935,CHANDIGARH-LEH,1637,All
2018,9,CHANDIGARH,LEH,887,1047,CHANDIGARH-LEH,1934,All
2018,10,CHANDIGARH,LEH,667,1083,CHANDIGARH-LEH,1750,All
2018,11,CHANDIGARH,LEH,460,963,CHANDIGARH-LEH,1423,All
2018,12,CHANDIGARH,LEH,535,1036,CHANDIGARH-LEH,1571,All
2019,1,CHANDIGARH,LEH,632,902,CHANDIGARH-LEH,1534,All
2019,2,CHANDIGARH,LEH,907,657,CHANDIGARH-LEH,1564,All
2019,3,CHANDIGARH,LEH,1083,550,CHANDIGARH-LEH,1633,All
2019,4,CHANDIGARH,LEH,998,749,CHANDIGARH-LEH,1747,All
2019,5,CHANDIGARH,LEH,832,815,CHANDIGARH-LEH,1647,All
2019,6,CHANDIGARH,LEH,934,1117,CHANDIGARH-LEH,2051,All
2019,7,CHANDIGARH,LEH,1003,1093,CHANDIGARH-LEH,2096,All
2019,8,CHANDIGARH,LEH,871,1161,CHANDIGARH-LEH,2032,All
2019,9,CHANDIGARH,LEH,749,862,CHANDIGARH-LEH,1611,All
2019,10,CHANDIGARH,LEH,501,1039,CHANDIGARH-LEH,1540,All
2019,11,CHANDIGARH,LEH,456,964,CHANDIGARH-LEH,1420,All
2019,12,CHANDIGARH,LEH,620,1097,CHANDIGARH-LEH,1717,All
2020,1,CHANDIGARH,LEH,444,888,CHANDIGARH-LEH,1332,All
2020,2,CHANDIGARH,LEH,1034,867,CHANDIGARH-LEH,1901,All
2020,3,CHANDIGARH,LEH,758,491,CHANDIGARH-LEH,1249,All
2020,6,CHANDIGARH,LEH,0,22,CHANDIGARH-LEH,22,All
2020,7,CHANDIGARH,LEH,0,190,CHANDIGARH-LEH,190,All
2020,8,CHANDIGARH,LEH,0,1063,CHANDIGARH-LEH,1063,All
2020,9,CHANDIGARH,LEH,0,1413,CHANDIGARH-LEH,1413,All
2020,10,CHANDIGARH,LEH,0,1475,CHANDIGARH-LEH,1475,All
2020,11,CHANDIGARH,LEH,0,1322,CHANDIGARH-LEH,1322,All
2020,12,CHANDIGARH,LEH,0,1947,CHANDIGARH-LEH,1947,All
2021,1,CHANDIGARH,LEH,0,1209,CHANDIGARH-LEH,1209,All
2021,2,CHANDIGARH,LEH,0,1261,CHANDIGARH-LEH,1261,All
2021,3,CHANDIGARH,LEH,101,1247,CHANDIGARH-LEH,1348,All
2021,4,CHANDIGARH,LEH,869,956,CHANDIGARH-LEH,1825,All
2021,6,CHANDIGARH,LEH,611,1220,CHANDIGARH-LEH,1831,All
2021,7,CHANDIGARH,LEH,867,1386,CHANDIGARH-LEH,2253,All
2021,8,CHANDIGARH,LEH,1545,3747,CHANDIGARH-LEH,5292,All
2021,9,CHANDIGARH,LEH,1415,3962,CHANDIGARH-LEH,5377,All
2021,10,CHANDIGARH,LEH,965,4661,CHANDIGARH-LEH,5626,All
2021,11,CHANDIGARH,LEH,647,4082,CHANDIGARH-LEH,4729,All
2021,12,CHANDIGARH,LEH,461,3017,CHANDIGARH-LEH,3478,All
2022,1,CHANDIGARH,LEH,892,2024,CHANDIGARH-LEH,2916,All
2022,2,CHANDIGARH,LEH,1771,1512,CHANDIGARH-LEH,3283,All
2022,3,CHANDIGARH,LEH,3404,1587,CHANDIGARH-LEH,4991,All
2022,4,CHANDIGARH,LEH,879,1318,CHANDIGARH-LEH,2197,All
2022,5,CHANDIGARH,LEH,909,1346,CHANDIGARH-LEH,2255,All
2022,6,CHANDIGARH,LEH,809,1097,CHANDIGARH-LEH,1906,All
2022,7,CHANDIGARH,LEH,721,1319,CHANDIGARH-LEH,2040,All
2022,8,CHANDIGARH,LEH,539,1357,CHANDIGARH-LEH,1896,All
2022,9,CHANDIGARH,LEH,283,1239,CHANDIGARH-LEH,1522,All
2022,10,CHANDIGARH,LEH,619,1109,CHANDIGARH-LEH,1728,All
2022,11,CHANDIGARH,LEH,1195,3215,CHANDIGARH-LEH,4410,All
2022,12,CHANDIGARH,LEH,1219,3297,CHANDIGARH-LEH,4516,All
2023,1,CHANDIGARH,LEH,1458,2776,CHANDIGARH-LEH,4234,All
2023,2,CHANDIGARH,LEH,3228,1891,CHANDIGARH-LEH,5119,All
2023,3,CHANDIGARH,LEH,3051,1439,CHANDIGARH-LEH,4490,All
2023,4,CHANDIGARH,LEH,1278,1221,CHANDIGARH-LEH,2499,All
2023,5,CHANDIGARH,LEH,1362,1326,CHANDIGARH-LEH,2688,All
2023,6,CHANDIGARH,LEH,1175,1225,CHANDIGARH-LEH,2400,All
2023,7,CHANDIGARH,LEH,1170,1310,CHANDIGARH-LEH,2480,All
2023,8,CHANDIGARH,LEH,1161,1228,CHANDIGARH-LEH,2389,All
2023,9,CHANDIGARH,LEH,1292,1271,CHANDIGARH-LEH,2563,All
2023,10,CHANDIGARH,LEH,1206,1543,CHANDIGARH-LEH,2749,All
2023,11,CHANDIGARH,LEH,2541,3379,CHANDIGARH-LEH,5920,All
2023,12,CHANDIGARH,LEH,2786,3561,CHANDIGARH-LEH,6347,All
2024,1,CHANDIGARH,LEH,2424,2857,CHANDIGARH-LEH,5281,All
2024,2,CHANDIGARH,LEH,3288,2022,CHANDIGARH-LEH,5310,All
2024,3,CHANDIGARH,LEH,2941,2158,CHANDIGARH-LEH,5099,All
2024,4,CHANDIGARH,LEH,1056,1271,CHANDIGARH-LEH,2327,All
2024,6,CHANDIGARH,LEH,1101,1135,CHANDIGARH-LEH,2236,All
2024,7,CHANDIGARH,LEH,1033,1232,CHANDIGARH-LEH,2265,All
2024,8,CHANDIGARH,LEH,1166,1298,CHANDIGARH-LEH,2464,All
2024,9,CHANDIGARH,LEH,757,1185,CHANDIGARH-LEH,1942,All
2024,10,CHANDIGARH,LEH,936,1694,CHANDIGARH-LEH,2630,All
2024,11,CHANDIGARH,LEH,2795,3409,CHANDIGARH-LEH,6204,All
2024,12,CHANDIGARH,LEH,2506,3530,CHANDIGARH-LEH,6036,All
2025,1,CHANDIGARH,LEH,2159,3210,CHANDIGARH-LEH,5369,All
2025,2,CHANDIGARH,LEH,3087,2586,CHANDIGARH-LEH,5673,All
2025,3,CHANDIGARH,LEH,3052,2078,CHANDIGARH-LEH,5130,All
2017,7,CHANDIGARH,LUCKNOW,194,55,CHANDIGARH-LUCKNOW,249,All
2017,8,CHANDIGARH,LUCKNOW,327,275,CHANDIGARH-LUCKNOW,602,All
2017,9,CHANDIGARH,LUCKNOW,297,266,CHANDIGARH-LUCKNOW,563,All
2017,10,CHANDIGARH,LUCKNOW,268,16,CHANDIGARH-LUCKNOW,284,All
2017,11,CHANDIGARH,LUCKNOW,208,0,CHANDIGARH-LUCKNOW,208,All
2017,12,CHANDIGARH,LUCKNOW,173,322,CHANDIGARH-LUCKNOW,495,All
2018,1,CHANDIGARH,LUCKNOW,0,609,CHANDIGARH-LUCKNOW,609,All
2018,2,CHANDIGARH,LUCKNOW,15,269,CHANDIGARH-LUCKNOW,284,All
2018,3,CHANDIGARH,LUCKNOW,252,594,CHANDIGARH-LUCKNOW,846,All
2018,4,CHANDIGARH,LUCKNOW,242,505,CHANDIGARH-LUCKNOW,747,All
2018,5,CHANDIGARH,LUCKNOW,158,352,CHANDIGARH-LUCKNOW,510,All
2018,6,CHANDIGARH,LUCKNOW,349,668,CHANDIGARH-LUCKNOW,1017,All
2018,7,CHANDIGARH,LUCKNOW,91,589,CHANDIGARH-LUCKNOW,680,All
2018,8,CHANDIGARH,LUCKNOW,179,237,CHANDIGARH-LUCKNOW,416,All
2018,9,CHANDIGARH,LUCKNOW,1619,2035,CHANDIGARH-LUCKNOW,3654,All
2018,10,CHANDIGARH,LUCKNOW,1629,2089,CHANDIGARH-LUCKNOW,3718,All
2018,11,CHANDIGARH,LUCKNOW,1537,1728,CHANDIGARH-LUCKNOW,3265,All
2018,12,CHANDIGARH,LUCKNOW,2046,2102,CHANDIGARH-LUCKNOW,4148,All
2019,1,CHANDIGARH,LUCKNOW,1851,1903,CHANDIGARH-LUCKNOW,3754,All
2019,2,CHANDIGARH,LUCKNOW,1786,1797,CHANDIGARH-LUCKNOW,3583,All
2019,3,CHANDIGARH,LUCKNOW,1999,1944,CHANDIGARH-LUCKNOW,3943,All
2019,4,CHANDIGARH,LUCKNOW,586,1219,CHANDIGARH-LUCKNOW,1805,All
2019,5,CHANDIGARH,LUCKNOW,0,525,CHANDIGARH-LUCKNOW,525,All
2019,6,CHANDIGARH,LUCKNOW,0,559,CHANDIGARH-LUCKNOW,559,All
2019,7,CHANDIGARH,LUCKNOW,0,648,CHANDIGARH-LUCKNOW,648,All
2019,8,CHANDIGARH,LUCKNOW,0,389,CHANDIGARH-LUCKNOW,389,All
2019,9,CHANDIGARH,LUCKNOW,0,472,CHANDIGARH-LUCKNOW,472,All
2019,10,CHANDIGARH,LUCKNOW,0,506,CHANDIGARH-LUCKNOW,506,All
2020,3,CHANDIGARH,LUCKNOW,2186,2064,CHANDIGARH-LUCKNOW,4250,All
2020,8,CHANDIGARH,LUCKNOW,213,379,CHANDIGARH-LUCKNOW,592,All
2020,9,CHANDIGARH,LUCKNOW,1099,1261,CHANDIGARH-LUCKNOW,2360,All
2020,10,CHANDIGARH,LUCKNOW,1712,2168,CHANDIGARH-LUCKNOW,3880,All
2020,11,CHANDIGARH,LUCKNOW,2865,3044,CHANDIGARH-LUCKNOW,5909,All
2020,12,CHANDIGARH,LUCKNOW,3030,3079,CHANDIGARH-LUCKNOW,6109,All
2021,1,CHANDIGARH,LUCKNOW,2559,2981,CHANDIGARH-LUCKNOW,5540,All
2021,2,CHANDIGARH,LUCKNOW,2710,3329,CHANDIGARH-LUCKNOW,6039,All
2021,3,CHANDIGARH,LUCKNOW,2814,2886,CHANDIGARH-LUCKNOW,5700,All
2021,4,CHANDIGARH,LUCKNOW,2004,1570,CHANDIGARH-LUCKNOW,3574,All
2021,6,CHANDIGARH,LUCKNOW,118,152,CHANDIGARH-LUCKNOW,270,All
2021,7,CHANDIGARH,LUCKNOW,1114,1476,CHANDIGARH-LUCKNOW,2590,All
2021,8,CHANDIGARH,LUCKNOW,953,1142,CHANDIGARH-LUCKNOW,2095,All
2021,9,CHANDIGARH,LUCKNOW,1345,1598,CHANDIGARH-LUCKNOW,2943,All
2021,10,CHANDIGARH,LUCKNOW,2572,2817,CHANDIGARH-LUCKNOW,5389,All
2021,11,CHANDIGARH,LUCKNOW,3938,4013,CHANDIGARH-LUCKNOW,7951,All
2021,12,CHANDIGARH,LUCKNOW,3581,4065,CHANDIGARH-LUCKNOW,7646,All
2022,1,CHANDIGARH,LUCKNOW,1771,1690,CHANDIGARH-LUCKNOW,3461,All
2022,2,CHANDIGARH,LUCKNOW,1471,2023,CHANDIGARH-LUCKNOW,3494,All
2022,3,CHANDIGARH,LUCKNOW,3069,3387,CHANDIGARH-LUCKNOW,6456,All
2022,4,CHANDIGARH,LUCKNOW,3797,4001,CHANDIGARH-LUCKNOW,7798,All
2022,5,CHANDIGARH,LUCKNOW,3958,4384,CHANDIGARH-LUCKNOW,8342,All
2022,6,CHANDIGARH,LUCKNOW,3853,4324,CHANDIGARH-LUCKNOW,8177,All
2022,7,CHANDIGARH,LUCKNOW,2767,3180,CHANDIGARH-LUCKNOW,5947,All
2022,8,CHANDIGARH,LUCKNOW,2731,2940,CHANDIGARH-LUCKNOW,5671,All
2022,9,CHANDIGARH,LUCKNOW,3103,3046,CHANDIGARH-LUCKNOW,6149,All
2022,10,CHANDIGARH,LUCKNOW,3525,3850,CHANDIGARH-LUCKNOW,7375,All
2022,11,CHANDIGARH,LUCKNOW,3564,4134,CHANDIGARH-LUCKNOW,7698,All
2022,12,CHANDIGARH,LUCKNOW,2988,3654,CHANDIGARH-LUCKNOW,6642,All
2023,1,CHANDIGARH,LUCKNOW,3217,3567,CHANDIGARH-LUCKNOW,6784,All
2023,2,CHANDIGARH,LUCKNOW,3375,3276,CHANDIGARH-LUCKNOW,6651,All
2023,3,CHANDIGARH,LUCKNOW,3328,3704,CHANDIGARH-LUCKNOW,7032,All
2023,4,CHANDIGARH,LUCKNOW,4686,4221,CHANDIGARH-LUCKNOW,8907,All
2023,5,CHANDIGARH,LUCKNOW,4479,4476,CHANDIGARH-LUCKNOW,8955,All
2023,6,CHANDIGARH,LUCKNOW,2793,2839,CHANDIGARH-LUCKNOW,5632,All
2023,7,CHANDIGARH,LUCKNOW,2683,2577,CHANDIGARH-LUCKNOW,5260,All
2023,8,CHANDIGARH,LUCKNOW,2613,2703,CHANDIGARH-LUCKNOW,5316,All
2023,9,CHANDIGARH,LUCKNOW,2747,2880,CHANDIGARH-LUCKNOW,5627,All
2023,10,CHANDIGARH,LUCKNOW,4210,4175,CHANDIGARH-LUCKNOW,8385,All
2023,11,CHANDIGARH,LUCKNOW,3301,3223,CHANDIGARH-LUCKNOW,6524,All
2023,12,CHANDIGARH,LUCKNOW,3596,4220,CHANDIGARH-LUCKNOW,7816,All
2024,1,CHANDIGARH,LUCKNOW,2216,2138,CHANDIGARH-LUCKNOW,4354,All
2024,2,CHANDIGARH,LUCKNOW,2110,2084,CHANDIGARH-LUCKNOW,4194,All
2024,3,CHANDIGARH,LUCKNOW,3884,3942,CHANDIGARH-LUCKNOW,7826,All
2024,4,CHANDIGARH,LUCKNOW,3906,4116,CHANDIGARH-LUCKNOW,8022,All
2024,6,CHANDIGARH,LUCKNOW,4052,4197,CHANDIGARH-LUCKNOW,8249,All
2024,7,CHANDIGARH,LUCKNOW,2949,3240,CHANDIGARH-LUCKNOW,6189,All
2024,8,CHANDIGARH,LUCKNOW,2755,3428,CHANDIGARH-LUCKNOW,6183,All
2024,9,CHANDIGARH,LUCKNOW,2655,3199,CHANDIGARH-LUCKNOW,5854,All
2024,10,CHANDIGARH,LUCKNOW,3851,4054,CHANDIGARH-LUCKNOW,7905,All
2024,11,CHANDIGARH,LUCKNOW,4458,4394,CHANDIGARH-LUCKNOW,8852,All
2024,12,CHANDIGARH,LUCKNOW,4369,4380,CHANDIGARH-LUCKNOW,8749,All
2025,1,CHANDIGARH,LUCKNOW,3913,4421,CHANDIGARH-LUCKNOW,8334,All
2025,2,CHANDIGARH,LUCKNOW,4447,4710,CHANDIGARH-LUCKNOW,9157,All
2025,3,CHANDIGARH,LUCKNOW,4355,5712,CHANDIGARH-LUCKNOW,10067,All
2019,5,CHANDIGARH,MUMBAI,21466,21978,CHANDIGARH-MUMBAI,43444,All
2019,6,CHANDIGARH,MUMBAI,22550,20822,CHANDIGARH-MUMBAI,43372,All
2019,7,CHANDIGARH,MUMBAI,22615,23976,CHANDIGARH-MUMBAI,46591,All
2019,8,CHANDIGARH,MUMBAI,23122,24860,CHANDIGARH-MUMBAI,47982,All
2019,9,CHANDIGARH,MUMBAI,21580,23698,CHANDIGARH-MUMBAI,45278,All
2019,10,CHANDIGARH,MUMBAI,21839,25289,CHANDIGARH-MUMBAI,47128,All
2019,11,CHANDIGARH,MUMBAI,26705,25962,CHANDIGARH-MUMBAI,52667,All
2019,12,CHANDIGARH,MUMBAI,27655,27095,CHANDIGARH-MUMBAI,54750,All
2020,1,CHANDIGARH,MUMBAI,28446,28077,CHANDIGARH-MUMBAI,56523,All
2020,2,CHANDIGARH,MUMBAI,26086,26400,CHANDIGARH-MUMBAI,52486,All
2020,3,CHANDIGARH,MUMBAI,17281,18510,CHANDIGARH-MUMBAI,35791,All
2020,5,CHANDIGARH,MUMBAI,118,513,CHANDIGARH-MUMBAI,631,All
2020,6,CHANDIGARH,MUMBAI,1242,2634,CHANDIGARH-MUMBAI,3876,All
2020,7,CHANDIGARH,MUMBAI,1835,3037,CHANDIGARH-MUMBAI,4872,All
2020,8,CHANDIGARH,MUMBAI,4024,3271,CHANDIGARH-MUMBAI,7295,All
2020,9,CHANDIGARH,MUMBAI,3758,3371,CHANDIGARH-MUMBAI,7129,All
2020,10,CHANDIGARH,MUMBAI,6738,8111,CHANDIGARH-MUMBAI,14849,All
2020,11,CHANDIGARH,MUMBAI,16476,18013,CHANDIGARH-MUMBAI,34489,All
2020,12,CHANDIGARH,MUMBAI,20973,25183,CHANDIGARH-MUMBAI,46156,All
2021,1,CHANDIGARH,MUMBAI,25894,25590,CHANDIGARH-MUMBAI,51484,All
2021,2,CHANDIGARH,MUMBAI,28184,32234,CHANDIGARH-MUMBAI,60418,All
2021,3,CHANDIGARH,MUMBAI,27331,30730,CHANDIGARH-MUMBAI,58061,All
2021,4,CHANDIGARH,MUMBAI,13973,16627,CHANDIGARH-MUMBAI,30600,All
2021,6,CHANDIGARH,MUMBAI,10875,11464,CHANDIGARH-MUMBAI,22339,All
2021,7,CHANDIGARH,MUMBAI,16950,17568,CHANDIGARH-MUMBAI,34518,All
2021,8,CHANDIGARH,MUMBAI,22032,20876,CHANDIGARH-MUMBAI,42908,All
2021,9,CHANDIGARH,MUMBAI,22636,22976,CHANDIGARH-MUMBAI,45612,All
2021,10,CHANDIGARH,MUMBAI,30609,35518,CHANDIGARH-MUMBAI,66127,All
2021,11,CHANDIGARH,MUMBAI,38044,39658,CHANDIGARH-MUMBAI,77702,All
2021,12,CHANDIGARH,MUMBAI,39248,40610,CHANDIGARH-MUMBAI,79858,All
2022,1,CHANDIGARH,MUMBAI,25652,25869,CHANDIGARH-MUMBAI,51521,All
2022,2,CHANDIGARH,MUMBAI,31832,35591,CHANDIGARH-MUMBAI,67423,All
2022,3,CHANDIGARH,MUMBAI,41993,44240,CHANDIGARH-MUMBAI,86233,All
2022,4,CHANDIGARH,MUMBAI,39943,45672,CHANDIGARH-MUMBAI,85615,All
2022,5,CHANDIGARH,MUMBAI,45321,47834,CHANDIGARH-MUMBAI,93155,All
2022,6,CHANDIGARH,MUMBAI,41259,37073,CHANDIGARH-MUMBAI,78332,All
2022,7,CHANDIGARH,MUMBAI,27617,26584,CHANDIGARH-MUMBAI,54201,All
2022,8,CHANDIGARH,MUMBAI,29130,27966,CHANDIGARH-MUMBAI,57096,All
2022,9,CHANDIGARH,MUMBAI,27387,28846,CHANDIGARH-MUMBAI,56233,All
2022,10,CHANDIGARH,MUMBAI,28367,35482,CHANDIGARH-MUMBAI,63849,All
2022,11,CHANDIGARH,MUMBAI,33352,31573,CHANDIGARH-MUMBAI,64925,All
2022,12,CHANDIGARH,MUMBAI,36156,35630,CHANDIGARH-MUMBAI,71786,All
2023,11,CHANDIGARH,MUMBAI,26985,28236,CHANDIGARH-MUMBAI,55221,All
2023,12,CHANDIGARH,MUMBAI,28938,28438,CHANDIGARH-MUMBAI,57376,All
2024,1,CHANDIGARH,MUMBAI,26949,27453,CHANDIGARH-MUMBAI,54402,All
2024,2,CHANDIGARH,MUMBAI,27673,28612,CHANDIGARH-MUMBAI,56285,All
2024,3,CHANDIGARH,MUMBAI,28656,29397,CHANDIGARH-MUMBAI,58053,All
2024,4,CHANDIGARH,MUMBAI,25918,26641,CHANDIGARH-MUMBAI,52559,All
2024,6,CHANDIGARH,MUMBAI,27629,26840,CHANDIGARH-MUMBAI,54469,All
2024,7,CHANDIGARH,MUMBAI,23670,25163,CHANDIGARH-MUMBAI,48833,All
2024,8,CHANDIGARH,MUMBAI,23983,25803,CHANDIGARH-MUMBAI,49786,All
2024,9,CHANDIGARH,MUMBAI,25433,27016,CHANDIGARH-MUMBAI,52449,All
2024,10,CHANDIGARH,MUMBAI,25706,33144,CHANDIGARH-MUMBAI,58850,All
2024,11,CHANDIGARH,MUMBAI,31396,31288,CHANDIGARH-MUMBAI,62684,All
2024,12,CHANDIGARH,MUMBAI,33100,32667,CHANDIGARH-MUMBAI,65767,All
2025,1,CHANDIGARH,MUMBAI,28661,29668,CHANDIGARH-MUMBAI,58329,All
2025,2,CHANDIGARH,MUMBAI,27514,29428,CHANDIGARH-MUMBAI,56942,All
2025,3,CHANDIGARH,MUMBAI,30444,30326,CHANDIGARH-MUMBAI,60770,All
2020,1,CHANDIGARH,NAGPUR,0,174,CHANDIGARH-NAGPUR,174,All
2021,3,CHANDIGARH,NAGPUR,11,27,CHANDIGARH-NAGPUR,38,All
2021,4,CHANDIGARH,NAGPUR,67,122,CHANDIGARH-NAGPUR,189,All
2021,8,CHANDIGARH,NAGPUR,38,74,CHANDIGARH-NAGPUR,112,All
2019,1,CHANDIGARH,NANDED,1161,1094,CHANDIGARH-NANDED,2255,All
2019,2,CHANDIGARH,NANDED,1103,1123,CHANDIGARH-NANDED,2226,All
2019,3,CHANDIGARH,NANDED,1059,998,CHANDIGARH-NANDED,2057,All
2019,4,CHANDIGARH,NANDED,926,987,CHANDIGARH-NANDED,1913,All
2019,5,CHANDIGARH,NANDED,833,882,CHANDIGARH-NANDED,1715,All
2019,6,CHANDIGARH,NANDED,950,831,CHANDIGARH-NANDED,1781,All
2019,7,CHANDIGARH,NANDED,709,773,CHANDIGARH-NANDED,1482,All
2019,8,CHANDIGARH,NANDED,891,1005,CHANDIGARH-NANDED,1896,All
2019,9,CHANDIGARH,NANDED,731,770,CHANDIGARH-NANDED,1501,All
2019,10,CHANDIGARH,NANDED,974,984,CHANDIGARH-NANDED,1958,All
2019,11,CHANDIGARH,NANDED,876,835,CHANDIGARH-NANDED,1711,All
2019,12,CHANDIGARH,NANDED,1111,1124,CHANDIGARH-NANDED,2235,All
2020,1,CHANDIGARH,NANDED,1145,1306,CHANDIGARH-NANDED,2451,All
2020,2,CHANDIGARH,NANDED,1123,1211,CHANDIGARH-NANDED,2334,All
2020,3,CHANDIGARH,NANDED,690,1026,CHANDIGARH-NANDED,1716,All
2020,3,CHANDIGARH,PATNA,2177,1911,CHANDIGARH-PATNA,4088,All
2020,10,CHANDIGARH,PATNA,238,430,CHANDIGARH-PATNA,668,All
2020,11,CHANDIGARH,PATNA,1996,1833,CHANDIGARH-PATNA,3829,All
2020,12,CHANDIGARH,PATNA,1359,2256,CHANDIGARH-PATNA,3615,All
2021,1,CHANDIGARH,PATNA,1802,2630,CHANDIGARH-PATNA,4432,All
2021,2,CHANDIGARH,PATNA,2682,3380,CHANDIGARH-PATNA,6062,All
2021,3,CHANDIGARH,PATNA,2856,2500,CHANDIGARH-PATNA,5356,All
2021,4,CHANDIGARH,PATNA,91,57,CHANDIGARH-PATNA,148,All
2021,6,CHANDIGARH,PATNA,43,0,CHANDIGARH-PATNA,43,All
2021,8,CHANDIGARH,PATNA,41,79,CHANDIGARH-PATNA,120,All
2021,9,CHANDIGARH,PATNA,316,478,CHANDIGARH-PATNA,794,All
2021,10,CHANDIGARH,PATNA,892,816,CHANDIGARH-PATNA,1708,All
2021,11,CHANDIGARH,PATNA,2932,3337,CHANDIGARH-PATNA,6269,All
2022,3,CHANDIGARH,PATNA,3142,3860,CHANDIGARH-PATNA,7002,All
2022,4,CHANDIGARH,PATNA,3850,3553,CHANDIGARH-PATNA,7403,All
2022,5,CHANDIGARH,PATNA,3208,3194,CHANDIGARH-PATNA,6402,All
2022,6,CHANDIGARH,PATNA,2735,3187,CHANDIGARH-PATNA,5922,All
2022,7,CHANDIGARH,PATNA,2604,2909,CHANDIGARH-PATNA,5513,All
2022,8,CHANDIGARH,PATNA,2445,2899,CHANDIGARH-PATNA,5344,All
2022,9,CHANDIGARH,PATNA,2841,2696,CHANDIGARH-PATNA,5537,All
2022,10,CHANDIGARH,PATNA,3856,3516,CHANDIGARH-PATNA,7372,All
2022,11,CHANDIGARH,PATNA,4184,4500,CHANDIGARH-PATNA,8684,All
2022,12,CHANDIGARH,PATNA,4305,4739,CHANDIGARH-PATNA,9044,All
2023,1,CHANDIGARH,PATNA,3756,3734,CHANDIGARH-PATNA,7490,All
2023,2,CHANDIGARH,PATNA,3821,4128,CHANDIGARH-PATNA,7949,All
2023,3,CHANDIGARH,PATNA,4060,4248,CHANDIGARH-PATNA,8308,All
2023,4,CHANDIGARH,PATNA,4175,3517,CHANDIGARH-PATNA,7692,All
2023,5,CHANDIGARH,PATNA,3840,3433,CHANDIGARH-PATNA,7273,All
2023,6,CHANDIGARH,PATNA,2004,1902,CHANDIGARH-PATNA,3906,All
2023,7,CHANDIGARH,PATNA,1741,1809,CHANDIGARH-PATNA,3550,All
2023,8,CHANDIGARH,PATNA,2036,2015,CHANDIGARH-PATNA,4051,All
2023,9,CHANDIGARH,PATNA,2093,2051,CHANDIGARH-PATNA,4144,All
2023,10,CHANDIGARH,PATNA,4628,4122,CHANDIGARH-PATNA,8750,All
2023,11,CHANDIGARH,PATNA,4237,3584,CHANDIGARH-PATNA,7821,All
2023,12,CHANDIGARH,PATNA,4590,5115,CHANDIGARH-PATNA,9705,All
2024,1,CHANDIGARH,PATNA,2031,2071,CHANDIGARH-PATNA,4102,All
2024,2,CHANDIGARH,PATNA,2196,2143,CHANDIGARH-PATNA,4339,All
2024,3,CHANDIGARH,PATNA,4334,4328,CHANDIGARH-PATNA,8662,All
2024,4,CHANDIGARH,PATNA,4853,4473,CHANDIGARH-PATNA,9326,All
2024,6,CHANDIGARH,PATNA,4620,4112,CHANDIGARH-PATNA,8732,All
2024,7,CHANDIGARH,PATNA,4497,4486,CHANDIGARH-PATNA,8983,All
2024,8,CHANDIGARH,PATNA,4175,3956,CHANDIGARH-PATNA,8131,All
2024,9,CHANDIGARH,PATNA,4363,3697,CHANDIGARH-PATNA,8060,All
2024,10,CHANDIGARH,PATNA,5263,4553,CHANDIGARH-PATNA,9816,All
2024,11,CHANDIGARH,PATNA,4714,4734,CHANDIGARH-PATNA,9448,All
2024,12,CHANDIGARH,PATNA,4603,4576,CHANDIGARH-PATNA,9179,All
2025,1,CHANDIGARH,PATNA,4504,4637,CHANDIGARH-PATNA,9141,All
2025,2,CHANDIGARH,PATNA,4313,4467,CHANDIGARH-PATNA,8780,All
2025,3,CHANDIGARH,PATNA,4899,4725,CHANDIGARH-PATNA,9624,All
2017,1,CHANDIGARH,PUNE,972,877,CHANDIGARH-PUNE,1849,All
2017,2,CHANDIGARH,PUNE,2307,2437,CHANDIGARH-PUNE,4744,All
2017,3,CHANDIGARH,PUNE,2824,3045,CHANDIGARH-PUNE,5869,All
2017,4,CHANDIGARH,PUNE,2766,3203,CHANDIGARH-PUNE,5969,All
2017,5,CHANDIGARH,PUNE,3700,3648,CHANDIGARH-PUNE,7348,All
2017,6,CHANDIGARH,PUNE,3171,2941,CHANDIGARH-PUNE,6112,All
2017,7,CHANDIGARH,PUNE,1901,2500,CHANDIGARH-PUNE,4401,All
2017,8,CHANDIGARH,PUNE,1661,2004,CHANDIGARH-PUNE,3665,All
2017,9,CHANDIGARH,PUNE,1315,1846,CHANDIGARH-PUNE,3161,All
2017,10,CHANDIGARH,PUNE,2058,2529,CHANDIGARH-PUNE,4587,All
2017,11,CHANDIGARH,PUNE,2560,2635,CHANDIGARH-PUNE,5195,All
2017,12,CHANDIGARH,PUNE,2165,1343,CHANDIGARH-PUNE,3508,All
2018,2,CHANDIGARH,PUNE,984,1161,CHANDIGARH-PUNE,2145,All
2018,3,CHANDIGARH,PUNE,3040,3251,CHANDIGARH-PUNE,6291,All
2018,4,CHANDIGARH,PUNE,4589,5671,CHANDIGARH-PUNE,10260,All
2018,5,CHANDIGARH,PUNE,1979,2112,CHANDIGARH-PUNE,4091,All
2018,6,CHANDIGARH,PUNE,4990,3904,CHANDIGARH-PUNE,8894,All
2018,7,CHANDIGARH,PUNE,4103,4082,CHANDIGARH-PUNE,8185,All
2018,8,CHANDIGARH,PUNE,3973,4260,CHANDIGARH-PUNE,8233,All
2018,9,CHANDIGARH,PUNE,3679,3899,CHANDIGARH-PUNE,7578,All
2018,10,CHANDIGARH,PUNE,3444,4447,CHANDIGARH-PUNE,7891,All
2018,11,CHANDIGARH,PUNE,4311,4450,CHANDIGARH-PUNE,8761,All
2018,12,CHANDIGARH,PUNE,4880,4925,CHANDIGARH-PUNE,9805,All
2019,1,CHANDIGARH,PUNE,3671,3838,CHANDIGARH-PUNE,7509,All
2019,2,CHANDIGARH,PUNE,3505,3556,CHANDIGARH-PUNE,7061,All
2019,3,CHANDIGARH,PUNE,1984,1981,CHANDIGARH-PUNE,3965,All
2019,4,CHANDIGARH,PUNE,1878,1928,CHANDIGARH-PUNE,3806,All
2019,5,CHANDIGARH,PUNE,2028,2055,CHANDIGARH-PUNE,4083,All
2019,6,CHANDIGARH,PUNE,1707,1491,CHANDIGARH-PUNE,3198,All
2019,7,CHANDIGARH,PUNE,1740,1722,CHANDIGARH-PUNE,3462,All
2019,8,CHANDIGARH,PUNE,1481,1585,CHANDIGARH-PUNE,3066,All
2019,9,CHANDIGARH,PUNE,1043,1383,CHANDIGARH-PUNE,2426,All
2019,10,CHANDIGARH,PUNE,1138,1536,CHANDIGARH-PUNE,2674,All
2019,11,CHANDIGARH,PUNE,1506,1433,CHANDIGARH-PUNE,2939,All
2019,12,CHANDIGARH,PUNE,1787,1792,CHANDIGARH-PUNE,3579,All
2020,1,CHANDIGARH,PUNE,1630,1748,CHANDIGARH-PUNE,3378,All
2020,2,CHANDIGARH,PUNE,1419,1854,CHANDIGARH-PUNE,3273,All
2020,3,CHANDIGARH,PUNE,1609,2816,CHANDIGARH-PUNE,4425,All
2020,8,CHANDIGARH,PUNE,821,831,CHANDIGARH-PUNE,1652,All
2020,9,CHANDIGARH,PUNE,1126,1130,CHANDIGARH-PUNE,2256,All
2020,10,CHANDIGARH,PUNE,1047,1346,CHANDIGARH-PUNE,2393,All
2020,11,CHANDIGARH,PUNE,1022,1296,CHANDIGARH-PUNE,2318,All
2020,12,CHANDIGARH,PUNE,2398,2315,CHANDIGARH-PUNE,4713,All
2021,1,CHANDIGARH,PUNE,2595,2417,CHANDIGARH-PUNE,5012,All
2021,2,CHANDIGARH,PUNE,2300,2483,CHANDIGARH-PUNE,4783,All
2021,3,CHANDIGARH,PUNE,1920,2704,CHANDIGARH-PUNE,4624,All
2021,4,CHANDIGARH,PUNE,1420,2600,CHANDIGARH-PUNE,4020,All
2021,6,CHANDIGARH,PUNE,977,1000,CHANDIGARH-PUNE,1977,All
2021,7,CHANDIGARH,PUNE,2690,3208,CHANDIGARH-PUNE,5898,All
2021,8,CHANDIGARH,PUNE,3375,3927,CHANDIGARH-PUNE,7302,All
2021,9,CHANDIGARH,PUNE,3013,3750,CHANDIGARH-PUNE,6763,All
2021,10,CHANDIGARH,PUNE,1798,2166,CHANDIGARH-PUNE,3964,All
2021,11,CHANDIGARH,PUNE,4561,4449,CHANDIGARH-PUNE,9010,All
2021,12,CHANDIGARH,PUNE,5069,4925,CHANDIGARH-PUNE,9994,All
2022,1,CHANDIGARH,PUNE,3707,3800,CHANDIGARH-PUNE,7507,All
2022,2,CHANDIGARH,PUNE,3367,3482,CHANDIGARH-PUNE,6849,All
2022,3,CHANDIGARH,PUNE,4763,4433,CHANDIGARH-PUNE,9196,All
2022,4,CHANDIGARH,PUNE,5208,4854,CHANDIGARH-PUNE,10062,All
2022,5,CHANDIGARH,PUNE,5493,5286,CHANDIGARH-PUNE,10779,All
2022,6,CHANDIGARH,PUNE,6385,5432,CHANDIGARH-PUNE,11817,All
2022,7,CHANDIGARH,PUNE,4894,4468,CHANDIGARH-PUNE,9362,All
2022,8,CHANDIGARH,PUNE,4681,4173,CHANDIGARH-PUNE,8854,All
2022,9,CHANDIGARH,PUNE,4590,4100,CHANDIGARH-PUNE,8690,All
2022,10,CHANDIGARH,PUNE,5775,5811,CHANDIGARH-PUNE,11586,All
2022,11,CHANDIGARH,PUNE,4099,3819,CHANDIGARH-PUNE,7918,All
2022,12,CHANDIGARH,PUNE,4244,3793,CHANDIGARH-PUNE,8037,All
2023,1,CHANDIGARH,PUNE,3689,3347,CHANDIGARH-PUNE,7036,All
2023,2,CHANDIGARH,PUNE,4152,4065,CHANDIGARH-PUNE,8217,All
2023,3,CHANDIGARH,PUNE,4646,4415,CHANDIGARH-PUNE,9061,All
2023,4,CHANDIGARH,PUNE,4425,4519,CHANDIGARH-PUNE,8944,All
2023,5,CHANDIGARH,PUNE,5181,5234,CHANDIGARH-PUNE,10415,All
2023,6,CHANDIGARH,PUNE,5085,4594,CHANDIGARH-PUNE,9679,All
2023,7,CHANDIGARH,PUNE,5154,4814,CHANDIGARH-PUNE,9968,All
2023,8,CHANDIGARH,PUNE,5336,5116,CHANDIGARH-PUNE,10452,All
2023,9,CHANDIGARH,PUNE,4809,4840,CHANDIGARH-PUNE,9649,All
2023,10,CHANDIGARH,PUNE,5027,5004,CHANDIGARH-PUNE,10031,All
2023,11,CHANDIGARH,PUNE,4949,4942,CHANDIGARH-PUNE,9891,All
2023,12,CHANDIGARH,PUNE,4347,4400,CHANDIGARH-PUNE,8747,All
2024,1,CHANDIGARH,PUNE,1845,1506,CHANDIGARH-PUNE,3351,All
2024,2,CHANDIGARH,PUNE,4594,4246,CHANDIGARH-PUNE,8840,All
2024,3,CHANDIGARH,PUNE,5063,4967,CHANDIGARH-PUNE,10030,All
2024,4,CHANDIGARH,PUNE,4797,4867,CHANDIGARH-PUNE,9664,All
2024,6,CHANDIGARH,PUNE,4909,4707,CHANDIGARH-PUNE,9616,All
2024,7,CHANDIGARH,PUNE,5166,4825,CHANDIGARH-PUNE,9991,All
2024,8,CHANDIGARH,PUNE,4886,4679,CHANDIGARH-PUNE,9565,All
2024,9,CHANDIGARH,PUNE,4612,4419,CHANDIGARH-PUNE,9031,All
2024,10,CHANDIGARH,PUNE,4515,5116,CHANDIGARH-PUNE,9631,All
2024,11,CHANDIGARH,PUNE,5627,5230,CHANDIGARH-PUNE,10857,All
2024,12,CHANDIGARH,PUNE,6123,6092,CHANDIGARH-PUNE,12215,All
2025,1,CHANDIGARH,PUNE,4738,4481,CHANDIGARH-PUNE,9219,All
2025,2,CHANDIGARH,PUNE,5693,5419,CHANDIGARH-PUNE,11112,All
2025,3,CHANDIGARH,PUNE,6574,6152,CHANDIGARH-PUNE,12726,All
2020,8,CHANDIGARH,RAIPUR,16,0,CHANDIGARH-RAIPUR,16,All
2020,9,CHANDIGARH,RAIPUR,59,0,CHANDIGARH-RAIPUR,59,All
2020,10,CHANDIGARH,RAIPUR,41,0,CHANDIGARH-RAIPUR,41,All
2022,9,CHANDIGARH,RAIPUR,0,17,CHANDIGARH-RAIPUR,17,All
2024,7,CHANDIGARH,RAIPUR,0,1,CHANDIGARH-RAIPUR,1,All
2021,9,CHANDIGARH,RANCHI,94,196,CHANDIGARH-RANCHI,290,All
2021,10,CHANDIGARH,RANCHI,258,477,CHANDIGARH-RANCHI,735,All
2023,12,CHANDIGARH,RANCHI,0,138,CHANDIGARH-RANCHI,138,All
2019,5,CHANDIGARH,SIMLA,112,80,CHANDIGARH-SIMLA,192,All
2019,6,CHANDIGARH,SIMLA,111,77,CHANDIGARH-SIMLA,188,All
2019,7,CHANDIGARH,SIMLA,49,33,CHANDIGARH-SIMLA,82,All
2019,8,CHANDIGARH,SIMLA,80,51,CHANDIGARH-SIMLA,131,All
2019,9,CHANDIGARH,SIMLA,68,79,CHANDIGARH-SIMLA,147,All
2019,10,CHANDIGARH,SIMLA,115,114,CHANDIGARH-SIMLA,229,All
2019,11,CHANDIGARH,SIMLA,113,117,CHANDIGARH-SIMLA,230,All
2019,12,CHANDIGARH,SIMLA,107,113,CHANDIGARH-SIMLA,220,All
2020,1,CHANDIGARH,SIMLA,113,104,CHANDIGARH-SIMLA,217,All
2020,2,CHANDIGARH,SIMLA,106,124,CHANDIGARH-SIMLA,230,All
2020,3,CHANDIGARH,SIMLA,63,71,CHANDIGARH-SIMLA,134,All
2020,6,CHANDIGARH,SIMLA,3,0,CHANDIGARH-SIMLA,3,All
2020,7,CHANDIGARH,SIMLA,7,3,CHANDIGARH-SIMLA,10,All
2020,8,CHANDIGARH,SIMLA,4,0,CHANDIGARH-SIMLA,4,All
2020,9,CHANDIGARH,SIMLA,11,13,CHANDIGARH-SIMLA,24,All
2020,10,CHANDIGARH,SIMLA,48,45,CHANDIGARH-SIMLA,93,All
2020,11,CHANDIGARH,SIMLA,45,55,CHANDIGARH-SIMLA,100,All
2020,12,CHANDIGARH,SIMLA,71,53,CHANDIGARH-SIMLA,124,All
2021,1,CHANDIGARH,SIMLA,51,59,CHANDIGARH-SIMLA,110,All
2021,2,CHANDIGARH,SIMLA,62,77,CHANDIGARH-SIMLA,139,All
2021,3,CHANDIGARH,SIMLA,67,75,CHANDIGARH-SIMLA,142,All
2021,4,CHANDIGARH,SIMLA,18,45,CHANDIGARH-SIMLA,63,All
2021,6,CHANDIGARH,SIMLA,35,27,CHANDIGARH-SIMLA,62,All
2021,7,CHANDIGARH,SIMLA,51,54,CHANDIGARH-SIMLA,105,All
2021,8,CHANDIGARH,SIMLA,33,33,CHANDIGARH-SIMLA,66,All
2021,9,CHANDIGARH,SIMLA,52,55,CHANDIGARH-SIMLA,107,All
2021,10,CHANDIGARH,SIMLA,81,91,CHANDIGARH-SIMLA,172,All
2021,11,CHANDIGARH,SIMLA,151,124,CHANDIGARH-SIMLA,275,All
2021,12,CHANDIGARH,SIMLA,18,21,CHANDIGARH-SIMLA,39,All
2024,12,CHANDIGARH,SIMLA,45,0,CHANDIGARH-SIMLA,45,All
2015,4,CHANDIGARH,SRINAGAR,3481,4259,CHANDIGARH-SRINAGAR,7740,All
2015,5,CHANDIGARH,SRINAGAR,6801,7053,CHANDIGARH-SRINAGAR,13854,All
2015,6,CHANDIGARH,SRINAGAR,8364,7506,CHANDIGARH-SRINAGAR,15870,All
2015,7,CHANDIGARH,SRINAGAR,6769,7995,CHANDIGARH-SRINAGAR,14764,All
2015,8,CHANDIGARH,SRINAGAR,6145,7392,CHANDIGARH-SRINAGAR,13537,All
2015,9,CHANDIGARH,SRINAGAR,6193,6269,CHANDIGARH-SRINAGAR,12462,All
2015,10,CHANDIGARH,SRINAGAR,5521,5415,CHANDIGARH-SRINAGAR,10936,All
2015,11,CHANDIGARH,SRINAGAR,5091,5400,CHANDIGARH-SRINAGAR,10491,All
2015,12,CHANDIGARH,SRINAGAR,6294,6182,CHANDIGARH-SRINAGAR,12476,All
2016,1,CHANDIGARH,SRINAGAR,6170,6032,CHANDIGARH-SRINAGAR,12202,All
2016,2,CHANDIGARH,SRINAGAR,5935,5738,CHANDIGARH-SRINAGAR,11673,All
2016,3,CHANDIGARH,SRINAGAR,6101,6324,CHANDIGARH-SRINAGAR,12425,All
2016,4,CHANDIGARH,SRINAGAR,4982,5361,CHANDIGARH-SRINAGAR,10343,All
2016,5,CHANDIGARH,SRINAGAR,5993,6034,CHANDIGARH-SRINAGAR,12027,All
2016,6,CHANDIGARH,SRINAGAR,7554,7264,CHANDIGARH-SRINAGAR,14818,All
2016,7,CHANDIGARH,SRINAGAR,4757,7548,CHANDIGARH-SRINAGAR,12305,All
2016,8,CHANDIGARH,SRINAGAR,3663,5778,CHANDIGARH-SRINAGAR,9441,All
2016,9,CHANDIGARH,SRINAGAR,3380,3911,CHANDIGARH-SRINAGAR,7291,All
2016,10,CHANDIGARH,SRINAGAR,4493,4817,CHANDIGARH-SRINAGAR,9310,All
2016,11,CHANDIGARH,SRINAGAR,4173,4709,CHANDIGARH-SRINAGAR,8882,All
2016,12,CHANDIGARH,SRINAGAR,6394,5645,CHANDIGARH-SRINAGAR,12039,All
2017,1,CHANDIGARH,SRINAGAR,4657,4706,CHANDIGARH-SRINAGAR,9363,All
2017,2,CHANDIGARH,SRINAGAR,5353,6685,CHANDIGARH-SRINAGAR,12038,All
2017,3,CHANDIGARH,SRINAGAR,6659,6717,CHANDIGARH-SRINAGAR,13376,All
2017,4,CHANDIGARH,SRINAGAR,6423,6259,CHANDIGARH-SRINAGAR,12682,All
2017,5,CHANDIGARH,SRINAGAR,6416,6119,CHANDIGARH-SRINAGAR,12535,All
2017,6,CHANDIGARH,SRINAGAR,7606,7202,CHANDIGARH-SRINAGAR,14808,All
2017,7,CHANDIGARH,SRINAGAR,6305,8445,CHANDIGARH-SRINAGAR,14750,All
2017,8,CHANDIGARH,SRINAGAR,6167,7703,CHANDIGARH-SRINAGAR,13870,All
2017,9,CHANDIGARH,SRINAGAR,5945,7502,CHANDIGARH-SRINAGAR,13447,All
2017,10,CHANDIGARH,SRINAGAR,3429,3641,CHANDIGARH-SRINAGAR,7070,All
2017,11,CHANDIGARH,SRINAGAR,2858,2659,CHANDIGARH-SRINAGAR,5517,All
2017,12,CHANDIGARH,SRINAGAR,3159,2805,CHANDIGARH-SRINAGAR,5964,All
2018,1,CHANDIGARH,SRINAGAR,3202,3728,CHANDIGARH-SRINAGAR,6930,All
2018,2,CHANDIGARH,SRINAGAR,1084,1786,CHANDIGARH-SRINAGAR,2870,All
2018,3,CHANDIGARH,SRINAGAR,2782,4074,CHANDIGARH-SRINAGAR,6856,All
2018,4,CHANDIGARH,SRINAGAR,4640,4644,CHANDIGARH-SRINAGAR,9284,All
2018,5,CHANDIGARH,SRINAGAR,1853,1827,CHANDIGARH-SRINAGAR,3680,All
2018,6,CHANDIGARH,SRINAGAR,8352,7684,CHANDIGARH-SRINAGAR,16036,All
2018,7,CHANDIGARH,SRINAGAR,10230,11082,CHANDIGARH-SRINAGAR,21312,All
2018,8,CHANDIGARH,SRINAGAR,8954,11105,CHANDIGARH-SRINAGAR,20059,All
2018,9,CHANDIGARH,SRINAGAR,9033,9795,CHANDIGARH-SRINAGAR,18828,All
2018,10,CHANDIGARH,SRINAGAR,7471,7930,CHANDIGARH-SRINAGAR,15401,All
2018,11,CHANDIGARH,SRINAGAR,6805,7409,CHANDIGARH-SRINAGAR,14214,All
2018,12,CHANDIGARH,SRINAGAR,6851,7672,CHANDIGARH-SRINAGAR,14523,All
2019,1,CHANDIGARH,SRINAGAR,6241,7363,CHANDIGARH-SRINAGAR,13604,All
2019,2,CHANDIGARH,SRINAGAR,6416,6037,CHANDIGARH-SRINAGAR,12453,All
2019,3,CHANDIGARH,SRINAGAR,7537,7771,CHANDIGARH-SRINAGAR,15308,All
2019,4,CHANDIGARH,SRINAGAR,7177,7879,CHANDIGARH-SRINAGAR,15056,All
2019,5,CHANDIGARH,SRINAGAR,7999,8013,CHANDIGARH-SRINAGAR,16012,All
2019,6,CHANDIGARH,SRINAGAR,7150,7629,CHANDIGARH-SRINAGAR,14779,All
2019,7,CHANDIGARH,SRINAGAR,7538,7666,CHANDIGARH-SRINAGAR,15204,All
2019,8,CHANDIGARH,SRINAGAR,3383,4045,CHANDIGARH-SRINAGAR,7428,All
2019,9,CHANDIGARH,SRINAGAR,5591,7837,CHANDIGARH-SRINAGAR,13428,All
2019,10,CHANDIGARH,SRINAGAR,6782,8832,CHANDIGARH-SRINAGAR,15614,All
2019,11,CHANDIGARH,SRINAGAR,7356,7630,CHANDIGARH-SRINAGAR,14986,All
2019,12,CHANDIGARH,SRINAGAR,2842,2978,CHANDIGARH-SRINAGAR,5820,All
2020,1,CHANDIGARH,SRINAGAR,4083,4190,CHANDIGARH-SRINAGAR,8273,All
2020,2,CHANDIGARH,SRINAGAR,5655,5411,CHANDIGARH-SRINAGAR,11066,All
2020,3,CHANDIGARH,SRINAGAR,5400,4649,CHANDIGARH-SRINAGAR,10049,All
2020,6,CHANDIGARH,SRINAGAR,2472,2821,CHANDIGARH-SRINAGAR,5293,All
2020,7,CHANDIGARH,SRINAGAR,3448,3441,CHANDIGARH-SRINAGAR,6889,All
2020,8,CHANDIGARH,SRINAGAR,3485,4032,CHANDIGARH-SRINAGAR,7517,All
2020,9,CHANDIGARH,SRINAGAR,4928,6188,CHANDIGARH-SRINAGAR,11116,All
2020,10,CHANDIGARH,SRINAGAR,5463,9624,CHANDIGARH-SRINAGAR,15087,All
2020,11,CHANDIGARH,SRINAGAR,5266,10110,CHANDIGARH-SRINAGAR,15376,All
2020,12,CHANDIGARH,SRINAGAR,7136,4779,CHANDIGARH-SRINAGAR,11915,All
2021,1,CHANDIGARH,SRINAGAR,5731,8208,CHANDIGARH-SRINAGAR,13939,All
2021,2,CHANDIGARH,SRINAGAR,7133,7749,CHANDIGARH-SRINAGAR,14882,All
2021,3,CHANDIGARH,SRINAGAR,7863,8095,CHANDIGARH-SRINAGAR,15958,All
2021,4,CHANDIGARH,SRINAGAR,9854,8022,CHANDIGARH-SRINAGAR,17876,All
2021,6,CHANDIGARH,SRINAGAR,6185,5662,CHANDIGARH-SRINAGAR,11847,All
2021,7,CHANDIGARH,SRINAGAR,9840,10826,CHANDIGARH-SRINAGAR,20666,All
2021,8,CHANDIGARH,SRINAGAR,9464,11584,CHANDIGARH-SRINAGAR,21048,All
2021,9,CHANDIGARH,SRINAGAR,10360,11335,CHANDIGARH-SRINAGAR,21695,All
2021,10,CHANDIGARH,SRINAGAR,9109,12336,CHANDIGARH-SRINAGAR,21445,All
2021,11,CHANDIGARH,SRINAGAR,8126,10947,CHANDIGARH-SRINAGAR,19073,All
2021,12,CHANDIGARH,SRINAGAR,9475,11004,CHANDIGARH-SRINAGAR,20479,All
2022,1,CHANDIGARH,SRINAGAR,6846,6906,CHANDIGARH-SRINAGAR,13752,All
2022,2,CHANDIGARH,SRINAGAR,6824,6856,CHANDIGARH-SRINAGAR,13680,All
2022,3,CHANDIGARH,SRINAGAR,10432,9396,CHANDIGARH-SRINAGAR,19828,All
2022,4,CHANDIGARH,SRINAGAR,11586,10009,CHANDIGARH-SRINAGAR,21595,All
2022,5,CHANDIGARH,SRINAGAR,11303,10354,CHANDIGARH-SRINAGAR,21657,All
2022,6,CHANDIGARH,SRINAGAR,12769,12933,CHANDIGARH-SRINAGAR,25702,All
2022,7,CHANDIGARH,SRINAGAR,11395,11812,CHANDIGARH-SRINAGAR,23207,All
2022,8,CHANDIGARH,SRINAGAR,9339,10528,CHANDIGARH-SRINAGAR,19867,All
2022,9,CHANDIGARH,SRINAGAR,10442,11803,CHANDIGARH-SRINAGAR,22245,All
2022,10,CHANDIGARH,SRINAGAR,11197,11432,CHANDIGARH-SRINAGAR,22629,All
2022,11,CHANDIGARH,SRINAGAR,10362,12322,CHANDIGARH-SRINAGAR,22684,All
2022,12,CHANDIGARH,SRINAGAR,11954,12821,CHANDIGARH-SRINAGAR,24775,All
2023,1,CHANDIGARH,SRINAGAR,9595,10922,CHANDIGARH-SRINAGAR,20517,All
2023,2,CHANDIGARH,SRINAGAR,12117,11441,CHANDIGARH-SRINAGAR,23558,All
2023,3,CHANDIGARH,SRINAGAR,10426,11052,CHANDIGARH-SRINAGAR,21478,All
2023,4,CHANDIGARH,SRINAGAR,8125,7896,CHANDIGARH-SRINAGAR,16021,All
2023,5,CHANDIGARH,SRINAGAR,9404,8320,CHANDIGARH-SRINAGAR,17724,All
2023,6,CHANDIGARH,SRINAGAR,8816,8206,CHANDIGARH-SRINAGAR,17022,All
2023,7,CHANDIGARH,SRINAGAR,8362,7979,CHANDIGARH-SRINAGAR,16341,All
2023,8,CHANDIGARH,SRINAGAR,8072,8139,CHANDIGARH-SRINAGAR,16211,All
2023,9,CHANDIGARH,SRINAGAR,8366,7902,CHANDIGARH-SRINAGAR,16268,All
2023,10,CHANDIGARH,SRINAGAR,6777,7343,CHANDIGARH-SRINAGAR,14120,All
2023,11,CHANDIGARH,SRINAGAR,4626,4468,CHANDIGARH-SRINAGAR,9094,All
2023,12,CHANDIGARH,SRINAGAR,4763,4041,CHANDIGARH-SRINAGAR,8804,All
2024,1,CHANDIGARH,SRINAGAR,4443,4118,CHANDIGARH-SRINAGAR,8561,All
2024,2,CHANDIGARH,SRINAGAR,4946,4238,CHANDIGARH-SRINAGAR,9184,All
2024,3,CHANDIGARH,SRINAGAR,4494,4038,CHANDIGARH-SRINAGAR,8532,All
2024,4,CHANDIGARH,SRINAGAR,9030,9269,CHANDIGARH-SRINAGAR,18299,All
2024,6,CHANDIGARH,SRINAGAR,10145,11203,CHANDIGARH-SRINAGAR,21348,All
2024,7,CHANDIGARH,SRINAGAR,10621,11479,CHANDIGARH-SRINAGAR,22100,All
2024,8,CHANDIGARH,SRINAGAR,7500,7528,CHANDIGARH-SRINAGAR,15028,All
2024,9,CHANDIGARH,SRINAGAR,7633,7253,CHANDIGARH-SRINAGAR,14886,All
2024,10,CHANDIGARH,SRINAGAR,8325,10072,CHANDIGARH-SRINAGAR,18397,All
2024,11,CHANDIGARH,SRINAGAR,7595,7596,CHANDIGARH-SRINAGAR,15191,All
2024,12,CHANDIGARH,SRINAGAR,8539,9046,CHANDIGARH-SRINAGAR,17585,All
2025,1,CHANDIGARH,SRINAGAR,10040,9785,CHANDIGARH-SRINAGAR,19825,All
2025,2,CHANDIGARH,SRINAGAR,9994,8940,CHANDIGARH-SRINAGAR,18934,All
2025,3,CHANDIGARH,SRINAGAR,10130,8737,CHANDIGARH-SRINAGAR,18867,All
2018,8,CHANDIGARH,SURAT,38,0,CHANDIGARH-SURAT,38,All
2018,9,CHANDIGARH,SURAT,50,0,CHANDIGARH-SURAT,50,All
2018,10,CHANDIGARH,SURAT,61,0,CHANDIGARH-SURAT,61,All
2018,11,CHANDIGARH,SURAT,149,0,CHANDIGARH-SURAT,149,All
2018,12,CHANDIGARH,SURAT,102,0,CHANDIGARH-SURAT,102,All
2019,1,CHANDIGARH,SURAT,32,0,CHANDIGARH-SURAT,32,All
2017,6,CHANDIGARH,TRIVANDRUM,8,0,CHANDIGARH-TRIVANDRUM,8,All
2017,7,CHANDIGARH,TRIVANDRUM,23,0,CHANDIGARH-TRIVANDRUM,23,All
2017,8,CHANDIGARH,TRIVANDRUM,38,0,CHANDIGARH-TRIVANDRUM,38,All
2017,9,CHANDIGARH,TRIVANDRUM,45,0,CHANDIGARH-TRIVANDRUM,45,All
2017,10,CHANDIGARH,TRIVANDRUM,4,0,CHANDIGARH-TRIVANDRUM,4,All
2017,11,CHANDIGARH,TRIVANDRUM,21,0,CHANDIGARH-TRIVANDRUM,21,All
2017,12,CHANDIGARH,TRIVANDRUM,18,0,CHANDIGARH-TRIVANDRUM,18,All
2018,1,CHANDIGARH,TRIVANDRUM,64,0,CHANDIGARH-TRIVANDRUM,64,All
2018,2,CHANDIGARH,TRIVANDRUM,33,0,CHANDIGARH-TRIVANDRUM,33,All
2018,3,CHANDIGARH,TRIVANDRUM,33,0,CHANDIGARH-TRIVANDRUM,33,All
2018,4,CHANDIGARH,TRIVANDRUM,40,0,CHANDIGARH-TRIVANDRUM,40,All
2018,5,CHANDIGARH,TRIVANDRUM,11,0,CHANDIGARH-TRIVANDRUM,11,All
2018,6,CHANDIGARH,TRIVANDRUM,12,0,CHANDIGARH-TRIVANDRUM,12,All
2018,7,CHANDIGARH,TRIVANDRUM,33,0,CHANDIGARH-TRIVANDRUM,33,All
2018,8,CHANDIGARH,TRIVANDRUM,44,0,CHANDIGARH-TRIVANDRUM,44,All
2018,9,CHANDIGARH,TRIVANDRUM,14,0,CHANDIGARH-TRIVANDRUM,14,All
2018,10,CHANDIGARH,TRIVANDRUM,34,0,CHANDIGARH-TRIVANDRUM,34,All
2018,12,CHANDIGARH,TRIVANDRUM,61,0,CHANDIGARH-TRIVANDRUM,61,All
2019,1,CHANDIGARH,TRIVANDRUM,67,0,CHANDIGARH-TRIVANDRUM,67,All
2019,2,CHANDIGARH,TRIVANDRUM,3,0,CHANDIGARH-TRIVANDRUM,3,All
2019,3,CHANDIGARH,TRIVANDRUM,3,0,CHANDIGARH-TRIVANDRUM,3,All
2019,7,CHANDIGARH,TRIVANDRUM,2,0,CHANDIGARH-TRIVANDRUM,2,All
2020,2,CHANDIGARH,TRIVANDRUM,37,65,CHANDIGARH-TRIVANDRUM,102,All
2020,3,CHANDIGARH,TRIVANDRUM,122,151,CHANDIGARH-TRIVANDRUM,273,All
2024,10,CHANDIGARH,UDAIPUR,44,51,CHANDIGARH-UDAIPUR,95,All
2024,11,CHANDIGARH,UDAIPUR,259,217,CHANDIGARH-UDAIPUR,476,All
2024,12,CHANDIGARH,UDAIPUR,236,138,CHANDIGARH-UDAIPUR,374,All
2025,3,CHANDIGARH,UDAIPUR,370,383,CHANDIGARH-UDAIPUR,753,All
2022,3,CHANDIGARH,VADODARA,245,406,CHANDIGARH-VADODARA,651,All
2022,4,CHANDIGARH,VADODARA,127,287,CHANDIGARH-VADODARA,414,All
2022,5,CHANDIGARH,VADODARA,0,173,CHANDIGARH-VADODARA,173,All
2022,6,CHANDIGARH,VADODARA,0,119,CHANDIGARH-VADODARA,119,All
2022,7,CHANDIGARH,VADODARA,0,88,CHANDIGARH-VADODARA,88,All
2022,8,CHANDIGARH,VADODARA,0,83,CHANDIGARH-VADODARA,83,All
2022,9,CHANDIGARH,VADODARA,0,54,CHANDIGARH-VADODARA,54,All
2022,10,CHANDIGARH,VADODARA,0,80,CHANDIGARH-VADODARA,80,All
2024,2,CHENNAI,Ayodhya International Airport ,3901,3462,Ayodhya International Airport -CHENNAI,7363,All
2024,3,CHENNAI,Ayodhya International Airport ,3564,3415,Ayodhya International Airport -CHENNAI,6979,All
2024,4,CHENNAI,Ayodhya International Airport ,4634,3623,Ayodhya International Airport -CHENNAI,8257,All
2024,6,CHENNAI,Ayodhya International Airport ,2416,2174,Ayodhya International Airport -CHENNAI,4590,All
2024,7,CHENNAI,Ayodhya International Airport ,1538,1546,Ayodhya International Airport -CHENNAI,3084,All
2019,5,CHENNAI,COIMBATORE,36445,35755,CHENNAI-COIMBATORE,72200,All
2019,6,CHENNAI,COIMBATORE,34281,35587,CHENNAI-COIMBATORE,69868,All
2019,7,CHENNAI,COIMBATORE,41118,40132,CHENNAI-COIMBATORE,81250,All
2019,8,CHENNAI,COIMBATORE,40007,38971,CHENNAI-COIMBATORE,78978,All
2019,9,CHENNAI,COIMBATORE,37786,37004,CHENNAI-COIMBATORE,74790,All
2019,10,CHENNAI,COIMBATORE,34093,33547,CHENNAI-COIMBATORE,67640,All
2019,11,CHENNAI,COIMBATORE,41173,39596,CHENNAI-COIMBATORE,80769,All
2019,12,CHENNAI,COIMBATORE,46121,41956,CHENNAI-COIMBATORE,88077,All
2020,1,CHENNAI,COIMBATORE,42923,43472,CHENNAI-COIMBATORE,86395,All
2020,2,CHENNAI,COIMBATORE,40857,39820,CHENNAI-COIMBATORE,80677,All
2020,3,CHENNAI,COIMBATORE,23791,22323,CHENNAI-COIMBATORE,46114,All
2020,5,CHENNAI,COIMBATORE,1319,583,CHENNAI-COIMBATORE,1902,All
2020,6,CHENNAI,COIMBATORE,3742,2211,CHENNAI-COIMBATORE,5953,All
2020,7,CHENNAI,COIMBATORE,2632,2336,CHENNAI-COIMBATORE,4968,All
2020,8,CHENNAI,COIMBATORE,4983,4856,CHENNAI-COIMBATORE,9839,All
2020,9,CHENNAI,COIMBATORE,9558,8992,CHENNAI-COIMBATORE,18550,All
2020,10,CHENNAI,COIMBATORE,12088,12018,CHENNAI-COIMBATORE,24106,All
2020,11,CHENNAI,COIMBATORE,13242,13299,CHENNAI-COIMBATORE,26541,All
2020,12,CHENNAI,COIMBATORE,19198,17666,CHENNAI-COIMBATORE,36864,All
2021,1,CHENNAI,COIMBATORE,24722,23530,CHENNAI-COIMBATORE,48252,All
2021,2,CHENNAI,COIMBATORE,24368,23809,CHENNAI-COIMBATORE,48177,All
2021,3,CHENNAI,COIMBATORE,24033,23617,CHENNAI-COIMBATORE,47650,All
2021,4,CHENNAI,COIMBATORE,15859,14897,CHENNAI-COIMBATORE,30756,All
2021,6,CHENNAI,COIMBATORE,5185,5829,CHENNAI-COIMBATORE,11014,All
2021,7,CHENNAI,COIMBATORE,13502,12905,CHENNAI-COIMBATORE,26407,All
2021,8,CHENNAI,COIMBATORE,19796,18718,CHENNAI-COIMBATORE,38514,All
2021,9,CHENNAI,COIMBATORE,22597,22101,CHENNAI-COIMBATORE,44698,All
2021,10,CHENNAI,COIMBATORE,24451,22838,CHENNAI-COIMBATORE,47289,All
2021,11,CHENNAI,COIMBATORE,26142,24993,CHENNAI-COIMBATORE,51135,All
2021,12,CHENNAI,COIMBATORE,32647,30066,CHENNAI-COIMBATORE,62713,All
2022,1,CHENNAI,COIMBATORE,17934,18403,CHENNAI-COIMBATORE,36337,All
2022,2,CHENNAI,COIMBATORE,20344,20404,CHENNAI-COIMBATORE,40748,All
2022,3,CHENNAI,COIMBATORE,31537,31178,CHENNAI-COIMBATORE,62715,All
2022,4,CHENNAI,COIMBATORE,30623,30052,CHENNAI-COIMBATORE,60675,All
2022,5,CHENNAI,COIMBATORE,32581,30305,CHENNAI-COIMBATORE,62886,All
2022,6,CHENNAI,COIMBATORE,31258,31531,CHENNAI-COIMBATORE,62789,All
2022,7,CHENNAI,COIMBATORE,31069,30462,CHENNAI-COIMBATORE,61531,All
2022,8,CHENNAI,COIMBATORE,34480,32712,CHENNAI-COIMBATORE,67192,All
2022,9,CHENNAI,COIMBATORE,34860,34192,CHENNAI-COIMBATORE,69052,All
2022,10,CHENNAI,COIMBATORE,33047,32684,CHENNAI-COIMBATORE,65731,All
2022,11,CHENNAI,COIMBATORE,30386,29033,CHENNAI-COIMBATORE,59419,All
2022,12,CHENNAI,COIMBATORE,35879,34405,CHENNAI-COIMBATORE,70284,All
2023,1,CHENNAI,COIMBATORE,36354,37155,CHENNAI-COIMBATORE,73509,All
2023,2,CHENNAI,COIMBATORE,33727,33512,CHENNAI-COIMBATORE,67239,All
2023,3,CHENNAI,COIMBATORE,36761,35366,CHENNAI-COIMBATORE,72127,All
2023,4,CHENNAI,COIMBATORE,36467,36078,CHENNAI-COIMBATORE,72545,All
2023,5,CHENNAI,COIMBATORE,39870,40330,CHENNAI-COIMBATORE,80200,All
2023,6,CHENNAI,COIMBATORE,37180,37167,CHENNAI-COIMBATORE,74347,All
2023,7,CHENNAI,COIMBATORE,38189,38858,CHENNAI-COIMBATORE,77047,All
2023,8,CHENNAI,COIMBATORE,39990,40883,CHENNAI-COIMBATORE,80873,All
2023,9,CHENNAI,COIMBATORE,40222,40407,CHENNAI-COIMBATORE,80629,All
2023,10,CHENNAI,COIMBATORE,37075,37257,CHENNAI-COIMBATORE,74332,All
2023,11,CHENNAI,COIMBATORE,31107,31374,CHENNAI-COIMBATORE,62481,All
2023,12,CHENNAI,COIMBATORE,32256,32849,CHENNAI-COIMBATORE,65105,All
2024,1,CHENNAI,COIMBATORE,29284,31492,CHENNAI-COIMBATORE,60776,All
2024,2,CHENNAI,COIMBATORE,28601,29542,CHENNAI-COIMBATORE,58143,All
2024,3,CHENNAI,COIMBATORE,28760,29546,CHENNAI-COIMBATORE,58306,All
2024,4,CHENNAI,COIMBATORE,35769,36250,CHENNAI-COIMBATORE,72019,All
2024,6,CHENNAI,COIMBATORE,37520,39213,CHENNAI-COIMBATORE,76733,All
2024,7,CHENNAI,COIMBATORE,38848,39664,CHENNAI-COIMBATORE,78512,All
2024,8,CHENNAI,COIMBATORE,38620,38672,CHENNAI-COIMBATORE,77292,All
2024,9,CHENNAI,COIMBATORE,38301,39176,CHENNAI-COIMBATORE,77477,All
2024,10,CHENNAI,COIMBATORE,36096,34397,CHENNAI-COIMBATORE,70493,All
2024,11,CHENNAI,COIMBATORE,34552,35105,CHENNAI-COIMBATORE,69657,All
2024,12,CHENNAI,COIMBATORE,41336,40836,CHENNAI-COIMBATORE,82172,All
2025,1,CHENNAI,COIMBATORE,39688,39834,CHENNAI-COIMBATORE,79522,All
2025,2,CHENNAI,COIMBATORE,38299,34465,CHENNAI-COIMBATORE,72764,All
2025,3,CHENNAI,COIMBATORE,39939,40777,CHENNAI-COIMBATORE,80716,All
2023,1,CHENNAI,Cuddapah,363,513,CHENNAI-Cuddapah,876,All
2023,6,CHENNAI,Cuddapah,441,554,CHENNAI-Cuddapah,995,All
2023,7,CHENNAI,Cuddapah,326,611,CHENNAI-Cuddapah,937,All
2023,8,CHENNAI,Cuddapah,401,527,CHENNAI-Cuddapah,928,All
2023,9,CHENNAI,Cuddapah,319,634,CHENNAI-Cuddapah,953,All
2023,10,CHENNAI,Cuddapah,395,657,CHENNAI-Cuddapah,1052,All
2023,11,CHENNAI,Cuddapah,800,842,CHENNAI-Cuddapah,1642,All
2023,12,CHENNAI,Cuddapah,649,696,CHENNAI-Cuddapah,1345,All
2024,1,CHENNAI,Cuddapah,543,693,CHENNAI-Cuddapah,1236,All
2024,2,CHENNAI,Cuddapah,616,759,CHENNAI-Cuddapah,1375,All
2024,3,CHENNAI,Cuddapah,497,615,CHENNAI-Cuddapah,1112,All
2024,4,CHENNAI,Cuddapah,379,644,CHENNAI-Cuddapah,1023,All
2024,6,CHENNAI,Cuddapah,435,711,CHENNAI-Cuddapah,1146,All
2024,7,CHENNAI,Cuddapah,447,744,CHENNAI-Cuddapah,1191,All
2024,8,CHENNAI,Cuddapah,452,652,CHENNAI-Cuddapah,1104,All
2024,9,CHENNAI,Cuddapah,446,691,CHENNAI-Cuddapah,1137,All
2024,10,CHENNAI,Cuddapah,351,674,CHENNAI-Cuddapah,1025,All
2024,11,CHENNAI,Cuddapah,364,515,CHENNAI-Cuddapah,879,All
2024,12,CHENNAI,Cuddapah,437,374,CHENNAI-Cuddapah,811,All
2025,1,CHENNAI,Cuddapah,375,648,CHENNAI-Cuddapah,1023,All
2025,2,CHENNAI,Cuddapah,408,642,CHENNAI-Cuddapah,1050,All
2025,3,CHENNAI,Cuddapah,468,695,CHENNAI-Cuddapah,1163,All
2019,5,CHENNAI,DABOLIM,16288,16147,CHENNAI-DABOLIM,32435,All
2019,6,CHENNAI,DABOLIM,11840,12279,CHENNAI-DABOLIM,24119,All
2019,7,CHENNAI,DABOLIM,11147,11764,CHENNAI-DABOLIM,22911,All
2019,8,CHENNAI,DABOLIM,13038,12696,CHENNAI-DABOLIM,25734,All
2019,9,CHENNAI,DABOLIM,13063,11382,CHENNAI-DABOLIM,24445,All
2019,10,CHENNAI,DABOLIM,11770,12477,CHENNAI-DABOLIM,24247,All
2019,11,CHENNAI,DABOLIM,14456,13497,CHENNAI-DABOLIM,27953,All
2019,12,CHENNAI,DABOLIM,14684,14785,CHENNAI-DABOLIM,29469,All
2020,1,CHENNAI,DABOLIM,14648,15456,CHENNAI-DABOLIM,30104,All
2020,2,CHENNAI,DABOLIM,13633,14475,CHENNAI-DABOLIM,28108,All
2020,3,CHENNAI,DABOLIM,6959,8453,CHENNAI-DABOLIM,15412,All
2020,10,CHENNAI,DABOLIM,1255,879,CHENNAI-DABOLIM,2134,All
2020,11,CHENNAI,DABOLIM,4811,3183,CHENNAI-DABOLIM,7994,All
2020,12,CHENNAI,DABOLIM,6866,4982,CHENNAI-DABOLIM,11848,All
2021,1,CHENNAI,DABOLIM,6985,6827,CHENNAI-DABOLIM,13812,All
2021,2,CHENNAI,DABOLIM,6497,6313,CHENNAI-DABOLIM,12810,All
2021,3,CHENNAI,DABOLIM,6624,6670,CHENNAI-DABOLIM,13294,All
2021,4,CHENNAI,DABOLIM,4295,4870,CHENNAI-DABOLIM,9165,All
2021,6,CHENNAI,DABOLIM,89,85,CHENNAI-DABOLIM,174,All
2021,7,CHENNAI,DABOLIM,563,445,CHENNAI-DABOLIM,1008,All
2021,8,CHENNAI,DABOLIM,1590,1988,CHENNAI-DABOLIM,3578,All
2021,9,CHENNAI,DABOLIM,2670,2831,CHENNAI-DABOLIM,5501,All
2021,10,CHENNAI,DABOLIM,6228,6783,CHENNAI-DABOLIM,13011,All
2021,11,CHENNAI,DABOLIM,7460,6683,CHENNAI-DABOLIM,14143,All
2021,12,CHENNAI,DABOLIM,7876,7328,CHENNAI-DABOLIM,15204,All
2022,1,CHENNAI,DABOLIM,4537,5126,CHENNAI-DABOLIM,9663,All
2022,2,CHENNAI,DABOLIM,5510,4815,CHENNAI-DABOLIM,10325,All
2022,3,CHENNAI,DABOLIM,7540,7147,CHENNAI-DABOLIM,14687,All
2022,4,CHENNAI,DABOLIM,5127,5237,CHENNAI-DABOLIM,10364,All
2022,5,CHENNAI,DABOLIM,5168,5341,CHENNAI-DABOLIM,10509,All
2022,6,CHENNAI,DABOLIM,4723,4864,CHENNAI-DABOLIM,9587,All
2022,7,CHENNAI,DABOLIM,4688,4931,CHENNAI-DABOLIM,9619,All
2022,8,CHENNAI,DABOLIM,4686,4837,CHENNAI-DABOLIM,9523,All
2022,9,CHENNAI,DABOLIM,4898,4609,CHENNAI-DABOLIM,9507,All
2022,10,CHENNAI,DABOLIM,5071,5230,CHENNAI-DABOLIM,10301,All
2022,11,CHENNAI,DABOLIM,9154,8610,CHENNAI-DABOLIM,17764,All
2022,12,CHENNAI,DABOLIM,10259,9997,CHENNAI-DABOLIM,20256,All
2023,1,CHENNAI,DABOLIM,8966,9522,CHENNAI-DABOLIM,18488,All
2023,2,CHENNAI,DABOLIM,7952,8022,CHENNAI-DABOLIM,15974,All
2023,3,CHENNAI,DABOLIM,7414,7759,CHENNAI-DABOLIM,15173,All
2023,4,CHENNAI,DABOLIM,7954,7732,CHENNAI-DABOLIM,15686,All
2023,5,CHENNAI,DABOLIM,5255,5419,CHENNAI-DABOLIM,10674,All
2023,6,CHENNAI,DABOLIM,4938,5083,CHENNAI-DABOLIM,10021,All
2023,7,CHENNAI,DABOLIM,4166,5225,CHENNAI-DABOLIM,9391,All
2023,8,CHENNAI,DABOLIM,4734,4826,CHENNAI-DABOLIM,9560,All
2023,9,CHENNAI,DABOLIM,4769,4640,CHENNAI-DABOLIM,9409,All
2023,10,CHENNAI,DABOLIM,4974,5109,CHENNAI-DABOLIM,10083,All
2023,11,CHENNAI,DABOLIM,5224,5002,CHENNAI-DABOLIM,10226,All
2023,12,CHENNAI,DABOLIM,4997,4816,CHENNAI-DABOLIM,9813,All
2024,1,CHENNAI,DABOLIM,4855,5202,CHENNAI-DABOLIM,10057,All
2024,2,CHENNAI,DABOLIM,4573,4436,CHENNAI-DABOLIM,9009,All
2024,3,CHENNAI,DABOLIM,4568,4258,CHENNAI-DABOLIM,8826,All
2024,4,CHENNAI,DABOLIM,4384,4795,CHENNAI-DABOLIM,9179,All
2024,6,CHENNAI,DABOLIM,4065,4645,CHENNAI-DABOLIM,8710,All
2024,7,CHENNAI,DABOLIM,3727,4104,CHENNAI-DABOLIM,7831,All
2024,8,CHENNAI,DABOLIM,4061,4602,CHENNAI-DABOLIM,8663,All
2024,9,CHENNAI,DABOLIM,4140,4481,CHENNAI-DABOLIM,8621,All
2024,10,CHENNAI,DABOLIM,5058,5608,CHENNAI-DABOLIM,10666,All
2024,11,CHENNAI,DABOLIM,12718,12131,CHENNAI-DABOLIM,24849,All
2024,12,CHENNAI,DABOLIM,19277,19067,CHENNAI-DABOLIM,38344,All
2025,1,CHENNAI,DABOLIM,16155,18013,CHENNAI-DABOLIM,34168,All
2025,2,CHENNAI,DABOLIM,14332,14689,CHENNAI-DABOLIM,29021,All
2025,3,CHENNAI,DABOLIM,12669,13330,CHENNAI-DABOLIM,25999,All
2021,8,CHENNAI,DARBHANGA,19,0,CHENNAI-DARBHANGA,19,All
2021,9,CHENNAI,DARBHANGA,26,0,CHENNAI-DARBHANGA,26,All
2021,10,CHENNAI,DARBHANGA,26,0,CHENNAI-DARBHANGA,26,All
2021,11,CHENNAI,DARBHANGA,465,81,CHENNAI-DARBHANGA,546,All
2021,12,CHENNAI,DARBHANGA,356,214,CHENNAI-DARBHANGA,570,All
2022,1,CHENNAI,DARBHANGA,82,16,CHENNAI-DARBHANGA,98,All
2022,2,CHENNAI,DARBHANGA,234,99,CHENNAI-DARBHANGA,333,All
2022,3,CHENNAI,DARBHANGA,240,117,CHENNAI-DARBHANGA,357,All
2022,4,CHENNAI,DARBHANGA,388,158,CHENNAI-DARBHANGA,546,All
2022,5,CHENNAI,DARBHANGA,417,380,CHENNAI-DARBHANGA,797,All
2022,6,CHENNAI,DARBHANGA,582,577,CHENNAI-DARBHANGA,1159,All
2022,7,CHENNAI,DARBHANGA,512,259,CHENNAI-DARBHANGA,771,All
2022,8,CHENNAI,DARBHANGA,469,243,CHENNAI-DARBHANGA,712,All
2022,9,CHENNAI,DARBHANGA,253,76,CHENNAI-DARBHANGA,329,All
2022,10,CHENNAI,DARBHANGA,724,127,CHENNAI-DARBHANGA,851,All
2022,11,CHENNAI,DARBHANGA,333,284,CHENNAI-DARBHANGA,617,All
2022,12,CHENNAI,DARBHANGA,228,168,CHENNAI-DARBHANGA,396,All
2023,1,CHENNAI,DARBHANGA,209,76,CHENNAI-DARBHANGA,285,All
2023,2,CHENNAI,DARBHANGA,458,106,CHENNAI-DARBHANGA,564,All
2023,3,CHENNAI,DARBHANGA,386,314,CHENNAI-DARBHANGA,700,All
2023,4,CHENNAI,DARBHANGA,481,135,CHENNAI-DARBHANGA,616,All
2023,5,CHENNAI,DARBHANGA,470,395,CHENNAI-DARBHANGA,865,All
2023,6,CHENNAI,DARBHANGA,294,314,CHENNAI-DARBHANGA,608,All
2023,7,CHENNAI,DARBHANGA,133,119,CHENNAI-DARBHANGA,252,All
2023,8,CHENNAI,DARBHANGA,79,39,CHENNAI-DARBHANGA,118,All
2023,9,CHENNAI,DARBHANGA,61,57,CHENNAI-DARBHANGA,118,All
2023,10,CHENNAI,DARBHANGA,126,89,CHENNAI-DARBHANGA,215,All
2019,5,CHENNAI,DEHRA DUN,257,0,CHENNAI-DEHRA DUN,257,All
2019,6,CHENNAI,DEHRA DUN,657,0,CHENNAI-DEHRA DUN,657,All
2019,7,CHENNAI,DEHRA DUN,866,0,CHENNAI-DEHRA DUN,866,All
2019,8,CHENNAI,DEHRA DUN,850,0,CHENNAI-DEHRA DUN,850,All
2019,9,CHENNAI,DEHRA DUN,984,0,CHENNAI-DEHRA DUN,984,All
2019,10,CHENNAI,DEHRA DUN,649,0,CHENNAI-DEHRA DUN,649,All
2021,3,CHENNAI,DEHRA DUN,0,5,CHENNAI-DEHRA DUN,5,All
2021,4,CHENNAI,DEHRA DUN,0,36,CHENNAI-DEHRA DUN,36,All
2021,7,CHENNAI,DEHRA DUN,147,152,CHENNAI-DEHRA DUN,299,All
2021,8,CHENNAI,DEHRA DUN,233,218,CHENNAI-DEHRA DUN,451,All
2021,9,CHENNAI,DEHRA DUN,371,294,CHENNAI-DEHRA DUN,665,All
2021,10,CHENNAI,DEHRA DUN,926,786,CHENNAI-DEHRA DUN,1712,All
2021,11,CHENNAI,DEHRA DUN,541,480,CHENNAI-DEHRA DUN,1021,All
2021,12,CHENNAI,DEHRA DUN,660,498,CHENNAI-DEHRA DUN,1158,All
2022,1,CHENNAI,DEHRA DUN,341,331,CHENNAI-DEHRA DUN,672,All
2022,2,CHENNAI,DEHRA DUN,291,212,CHENNAI-DEHRA DUN,503,All
2022,3,CHENNAI,DEHRA DUN,639,505,CHENNAI-DEHRA DUN,1144,All
2022,4,CHENNAI,DEHRA DUN,681,754,CHENNAI-DEHRA DUN,1435,All
2022,5,CHENNAI,DEHRA DUN,941,1001,CHENNAI-DEHRA DUN,1942,All
2022,6,CHENNAI,DEHRA DUN,838,940,CHENNAI-DEHRA DUN,1778,All
2022,7,CHENNAI,DEHRA DUN,748,799,CHENNAI-DEHRA DUN,1547,All
2022,8,CHENNAI,DEHRA DUN,729,795,CHENNAI-DEHRA DUN,1524,All
2022,9,CHENNAI,DEHRA DUN,1361,1059,CHENNAI-DEHRA DUN,2420,All
2022,10,CHENNAI,DEHRA DUN,764,1213,CHENNAI-DEHRA DUN,1977,All
2022,11,CHENNAI,DEHRA DUN,918,804,CHENNAI-DEHRA DUN,1722,All
2022,12,CHENNAI,DEHRA DUN,1148,926,CHENNAI-DEHRA DUN,2074,All
2023,2,CHENNAI,DEHRA DUN,736,479,CHENNAI-DEHRA DUN,1215,All
2023,3,CHENNAI,DEHRA DUN,666,639,CHENNAI-DEHRA DUN,1305,All
2023,4,CHENNAI,DEHRA DUN,1264,949,CHENNAI-DEHRA DUN,2213,All
2023,5,CHENNAI,DEHRA DUN,1538,1413,CHENNAI-DEHRA DUN,2951,All
2019,5,CHENNAI,DELHI,98827,104475,CHENNAI-DELHI,203302,All
2019,6,CHENNAI,DELHI,94622,102740,CHENNAI-DELHI,197362,All
2019,7,CHENNAI,DELHI,95846,99436,CHENNAI-DELHI,195282,All
2019,8,CHENNAI,DELHI,96839,93060,CHENNAI-DELHI,189899,All
2019,9,CHENNAI,DELHI,101071,92293,CHENNAI-DELHI,193364,All
2019,10,CHENNAI,DELHI,103460,102025,CHENNAI-DELHI,205485,All
2019,11,CHENNAI,DELHI,107911,108904,CHENNAI-DELHI,216815,All
2019,12,CHENNAI,DELHI,104761,118032,CHENNAI-DELHI,222793,All
2020,1,CHENNAI,DELHI,107250,105682,CHENNAI-DELHI,212932,All
2020,2,CHENNAI,DELHI,107076,99165,CHENNAI-DELHI,206241,All
2020,3,CHENNAI,DELHI,67319,62051,CHENNAI-DELHI,129370,All
2020,5,CHENNAI,DELHI,3923,1837,CHENNAI-DELHI,5760,All
2020,6,CHENNAI,DELHI,18996,15856,CHENNAI-DELHI,34852,All
2020,7,CHENNAI,DELHI,20864,22205,CHENNAI-DELHI,43069,All
2020,8,CHENNAI,DELHI,20760,32831,CHENNAI-DELHI,53591,All
2020,9,CHENNAI,DELHI,23656,33848,CHENNAI-DELHI,57504,All
2020,10,CHENNAI,DELHI,31892,37689,CHENNAI-DELHI,69581,All
2020,11,CHENNAI,DELHI,37286,35096,CHENNAI-DELHI,72382,All
2020,12,CHENNAI,DELHI,38238,47859,CHENNAI-DELHI,86097,All
2021,1,CHENNAI,DELHI,47898,55001,CHENNAI-DELHI,102899,All
2021,2,CHENNAI,DELHI,54585,49633,CHENNAI-DELHI,104218,All
2021,3,CHENNAI,DELHI,57642,51625,CHENNAI-DELHI,109267,All
2021,4,CHENNAI,DELHI,49798,42248,CHENNAI-DELHI,92046,All
2021,6,CHENNAI,DELHI,26022,23631,CHENNAI-DELHI,49653,All
2021,7,CHENNAI,DELHI,35999,35616,CHENNAI-DELHI,71615,All
2021,8,CHENNAI,DELHI,52283,51931,CHENNAI-DELHI,104214,All
2021,9,CHENNAI,DELHI,60288,57731,CHENNAI-DELHI,118019,All
2021,10,CHENNAI,DELHI,70064,65976,CHENNAI-DELHI,136040,All
2021,11,CHENNAI,DELHI,76506,70308,CHENNAI-DELHI,146814,All
2021,12,CHENNAI,DELHI,84055,88091,CHENNAI-DELHI,172146,All
2022,1,CHENNAI,DELHI,57220,52281,CHENNAI-DELHI,109501,All
2022,2,CHENNAI,DELHI,74273,67466,CHENNAI-DELHI,141739,All
2022,3,CHENNAI,DELHI,89110,90422,CHENNAI-DELHI,179532,All
2022,4,CHENNAI,DELHI,84299,82856,CHENNAI-DELHI,167155,All
2022,5,CHENNAI,DELHI,78095,88243,CHENNAI-DELHI,166338,All
2022,6,CHENNAI,DELHI,75439,83492,CHENNAI-DELHI,158931,All
2022,7,CHENNAI,DELHI,80898,82890,CHENNAI-DELHI,163788,All
2022,8,CHENNAI,DELHI,85556,82260,CHENNAI-DELHI,167816,All
2022,9,CHENNAI,DELHI,86942,76623,CHENNAI-DELHI,163565,All
2022,10,CHENNAI,DELHI,76149,73118,CHENNAI-DELHI,149267,All
2022,11,CHENNAI,DELHI,78577,82331,CHENNAI-DELHI,160908,All
2022,12,CHENNAI,DELHI,86108,97114,CHENNAI-DELHI,183222,All
2023,1,CHENNAI,DELHI,89785,91960,CHENNAI-DELHI,181745,All
2023,2,CHENNAI,DELHI,95616,89872,CHENNAI-DELHI,185488,All
2023,3,CHENNAI,DELHI,98258,99891,CHENNAI-DELHI,198149,All
2023,4,CHENNAI,DELHI,100764,94167,CHENNAI-DELHI,194931,All
2023,5,CHENNAI,DELHI,98398,104107,CHENNAI-DELHI,202505,All
2023,6,CHENNAI,DELHI,89218,93152,CHENNAI-DELHI,182370,All
2023,7,CHENNAI,DELHI,86509,89819,CHENNAI-DELHI,176328,All
2023,8,CHENNAI,DELHI,91018,87846,CHENNAI-DELHI,178864,All
2023,9,CHENNAI,DELHI,90299,87718,CHENNAI-DELHI,178017,All
2023,10,CHENNAI,DELHI,96613,91760,CHENNAI-DELHI,188373,All
2023,11,CHENNAI,DELHI,104840,98447,CHENNAI-DELHI,203287,All
2023,12,CHENNAI,DELHI,99967,106286,CHENNAI-DELHI,206253,All
2024,1,CHENNAI,DELHI,102766,104314,CHENNAI-DELHI,207080,All
2024,2,CHENNAI,DELHI,101243,97890,CHENNAI-DELHI,199133,All
2024,3,CHENNAI,DELHI,100786,99331,CHENNAI-DELHI,200117,All
2024,4,CHENNAI,DELHI,103449,93254,CHENNAI-DELHI,196703,All
2024,6,CHENNAI,DELHI,91150,104418,CHENNAI-DELHI,195568,All
2024,7,CHENNAI,DELHI,97954,104919,CHENNAI-DELHI,202873,All
2024,8,CHENNAI,DELHI,105534,101786,CHENNAI-DELHI,207320,All
2024,9,CHENNAI,DELHI,103544,95176,CHENNAI-DELHI,198720,All
2024,10,CHENNAI,DELHI,97862,86506,CHENNAI-DELHI,184368,All
2024,11,CHENNAI,DELHI,96677,103848,CHENNAI-DELHI,200525,All
2024,12,CHENNAI,DELHI,105787,119201,CHENNAI-DELHI,224988,All
2025,1,CHENNAI,DELHI,110168,107038,CHENNAI-DELHI,217206,All
2025,2,CHENNAI,DELHI,108491,103197,CHENNAI-DELHI,211688,All
2025,3,CHENNAI,DELHI,101807,103629,CHENNAI-DELHI,205436,All
2023,10,CHENNAI,DHARAMSALA,15,15,CHENNAI-DHARAMSALA,30,All
2021,3,CHENNAI,DIBRUGARH,25,114,CHENNAI-DIBRUGARH,139,All
2021,4,CHENNAI,DIBRUGARH,769,382,CHENNAI-DIBRUGARH,1151,All
2021,6,CHENNAI,DIBRUGARH,156,91,CHENNAI-DIBRUGARH,247,All
2021,7,CHENNAI,DIBRUGARH,349,483,CHENNAI-DIBRUGARH,832,All
2021,8,CHENNAI,DIBRUGARH,460,401,CHENNAI-DIBRUGARH,861,All
2021,9,CHENNAI,DIBRUGARH,480,489,CHENNAI-DIBRUGARH,969,All
2021,10,CHENNAI,DIBRUGARH,532,439,CHENNAI-DIBRUGARH,971,All
2021,11,CHENNAI,DIBRUGARH,839,726,CHENNAI-DIBRUGARH,1565,All
2021,12,CHENNAI,DIBRUGARH,753,461,CHENNAI-DIBRUGARH,1214,All
2022,1,CHENNAI,DIBRUGARH,210,320,CHENNAI-DIBRUGARH,530,All
2022,2,CHENNAI,DIBRUGARH,0,321,CHENNAI-DIBRUGARH,321,All
2022,3,CHENNAI,DIBRUGARH,590,706,CHENNAI-DIBRUGARH,1296,All
2022,4,CHENNAI,DIBRUGARH,779,686,CHENNAI-DIBRUGARH,1465,All
2022,5,CHENNAI,DIBRUGARH,435,660,CHENNAI-DIBRUGARH,1095,All
2022,6,CHENNAI,DIBRUGARH,660,878,CHENNAI-DIBRUGARH,1538,All
2022,7,CHENNAI,DIBRUGARH,857,908,CHENNAI-DIBRUGARH,1765,All
2022,8,CHENNAI,DIBRUGARH,262,331,CHENNAI-DIBRUGARH,593,All
2022,9,CHENNAI,DIBRUGARH,530,287,CHENNAI-DIBRUGARH,817,All
2022,10,CHENNAI,DIBRUGARH,99,98,CHENNAI-DIBRUGARH,197,All
2022,11,CHENNAI,DIBRUGARH,984,829,CHENNAI-DIBRUGARH,1813,All
2022,12,CHENNAI,DIBRUGARH,1113,990,CHENNAI-DIBRUGARH,2103,All
2023,1,CHENNAI,DIBRUGARH,1130,992,CHENNAI-DIBRUGARH,2122,All
2023,2,CHENNAI,DIBRUGARH,885,775,CHENNAI-DIBRUGARH,1660,All
2023,3,CHENNAI,DIBRUGARH,1015,944,CHENNAI-DIBRUGARH,1959,All
2023,4,CHENNAI,DIBRUGARH,1137,1070,CHENNAI-DIBRUGARH,2207,All
2023,5,CHENNAI,DIBRUGARH,826,906,CHENNAI-DIBRUGARH,1732,All
2023,6,CHENNAI,DIBRUGARH,1063,960,CHENNAI-DIBRUGARH,2023,All
2023,7,CHENNAI,DIBRUGARH,1029,1249,CHENNAI-DIBRUGARH,2278,All
2023,8,CHENNAI,DIBRUGARH,877,866,CHENNAI-DIBRUGARH,1743,All
2023,9,CHENNAI,DIBRUGARH,609,701,CHENNAI-DIBRUGARH,1310,All
2023,10,CHENNAI,DIBRUGARH,463,373,CHENNAI-DIBRUGARH,836,All
2023,11,CHENNAI,DIBRUGARH,508,796,CHENNAI-DIBRUGARH,1304,All
2023,12,CHENNAI,DIBRUGARH,448,719,CHENNAI-DIBRUGARH,1167,All
2024,1,CHENNAI,DIBRUGARH,676,632,CHENNAI-DIBRUGARH,1308,All
2024,2,CHENNAI,DIBRUGARH,862,773,CHENNAI-DIBRUGARH,1635,All
2024,3,CHENNAI,DIBRUGARH,808,749,CHENNAI-DIBRUGARH,1557,All
2024,4,CHENNAI,DIBRUGARH,400,458,CHENNAI-DIBRUGARH,858,All
2019,10,CHENNAI,DURGAPUR,885,691,CHENNAI-DURGAPUR,1576,All
2019,11,CHENNAI,DURGAPUR,4801,4488,CHENNAI-DURGAPUR,9289,All
2019,12,CHENNAI,DURGAPUR,5655,5364,CHENNAI-DURGAPUR,11019,All
2020,1,CHENNAI,DURGAPUR,5624,5335,CHENNAI-DURGAPUR,10959,All
2020,2,CHENNAI,DURGAPUR,5186,4643,CHENNAI-DURGAPUR,9829,All
2020,3,CHENNAI,DURGAPUR,4476,3674,CHENNAI-DURGAPUR,8150,All
2020,9,CHENNAI,DURGAPUR,1004,1801,CHENNAI-DURGAPUR,2805,All
2020,10,CHENNAI,DURGAPUR,2152,2359,CHENNAI-DURGAPUR,4511,All
2020,11,CHENNAI,DURGAPUR,2337,2236,CHENNAI-DURGAPUR,4573,All
2020,12,CHENNAI,DURGAPUR,2412,2429,CHENNAI-DURGAPUR,4841,All
2021,1,CHENNAI,DURGAPUR,2344,2427,CHENNAI-DURGAPUR,4771,All
2021,2,CHENNAI,DURGAPUR,2238,2224,CHENNAI-DURGAPUR,4462,All
2021,3,CHENNAI,DURGAPUR,2620,2556,CHENNAI-DURGAPUR,5176,All
2021,4,CHENNAI,DURGAPUR,2424,1851,CHENNAI-DURGAPUR,4275,All
2021,6,CHENNAI,DURGAPUR,418,841,CHENNAI-DURGAPUR,1259,All
2021,7,CHENNAI,DURGAPUR,1762,2422,CHENNAI-DURGAPUR,4184,All
2021,8,CHENNAI,DURGAPUR,2037,2418,CHENNAI-DURGAPUR,4455,All
2021,9,CHENNAI,DURGAPUR,2268,2404,CHENNAI-DURGAPUR,4672,All
2021,10,CHENNAI,DURGAPUR,1930,1973,CHENNAI-DURGAPUR,3903,All
2021,11,CHENNAI,DURGAPUR,2410,2331,CHENNAI-DURGAPUR,4741,All
2021,12,CHENNAI,DURGAPUR,4215,4149,CHENNAI-DURGAPUR,8364,All
2022,1,CHENNAI,DURGAPUR,1671,1603,CHENNAI-DURGAPUR,3274,All
2022,2,CHENNAI,DURGAPUR,1670,1728,CHENNAI-DURGAPUR,3398,All
2022,3,CHENNAI,DURGAPUR,3999,3994,CHENNAI-DURGAPUR,7993,All
2022,4,CHENNAI,DURGAPUR,5223,4277,CHENNAI-DURGAPUR,9500,All
2022,5,CHENNAI,DURGAPUR,5231,5526,CHENNAI-DURGAPUR,10757,All
2022,6,CHENNAI,DURGAPUR,5660,5603,CHENNAI-DURGAPUR,11263,All
2022,7,CHENNAI,DURGAPUR,4117,4345,CHENNAI-DURGAPUR,8462,All
2022,8,CHENNAI,DURGAPUR,3166,3954,CHENNAI-DURGAPUR,7120,All
2022,9,CHENNAI,DURGAPUR,4070,3933,CHENNAI-DURGAPUR,8003,All
2022,10,CHENNAI,DURGAPUR,4744,4660,CHENNAI-DURGAPUR,9404,All
2022,11,CHENNAI,DURGAPUR,3757,3904,CHENNAI-DURGAPUR,7661,All
2022,12,CHENNAI,DURGAPUR,4680,4604,CHENNAI-DURGAPUR,9284,All
2023,1,CHENNAI,DURGAPUR,4964,4691,CHENNAI-DURGAPUR,9655,All
2023,2,CHENNAI,DURGAPUR,4286,3549,CHENNAI-DURGAPUR,7835,All
2023,3,CHENNAI,DURGAPUR,3777,3291,CHENNAI-DURGAPUR,7068,All
2023,4,CHENNAI,DURGAPUR,5136,4659,CHENNAI-DURGAPUR,9795,All
2023,5,CHENNAI,DURGAPUR,5086,5088,CHENNAI-DURGAPUR,10174,All
2023,6,CHENNAI,DURGAPUR,2694,2376,CHENNAI-DURGAPUR,5070,All
2023,7,CHENNAI,DURGAPUR,4299,4747,CHENNAI-DURGAPUR,9046,All
2023,8,CHENNAI,DURGAPUR,4819,5268,CHENNAI-DURGAPUR,10087,All
2023,9,CHENNAI,DURGAPUR,3650,3471,CHENNAI-DURGAPUR,7121,All
2023,10,CHENNAI,DURGAPUR,3063,2468,CHENNAI-DURGAPUR,5531,All
2023,11,CHENNAI,DURGAPUR,714,517,CHENNAI-DURGAPUR,1231,All
2023,12,CHENNAI,DURGAPUR,1040,720,CHENNAI-DURGAPUR,1760,All
2024,1,CHENNAI,DURGAPUR,787,957,CHENNAI-DURGAPUR,1744,All
2024,2,CHENNAI,DURGAPUR,644,859,CHENNAI-DURGAPUR,1503,All
2024,3,CHENNAI,DURGAPUR,611,801,CHENNAI-DURGAPUR,1412,All
2024,6,CHENNAI,DURGAPUR,2136,2047,CHENNAI-DURGAPUR,4183,All
2024,7,CHENNAI,DURGAPUR,2031,2228,CHENNAI-DURGAPUR,4259,All
2024,8,CHENNAI,DURGAPUR,1813,1963,CHENNAI-DURGAPUR,3776,All
2024,9,CHENNAI,DURGAPUR,1593,1542,CHENNAI-DURGAPUR,3135,All
2024,10,CHENNAI,DURGAPUR,2669,1540,CHENNAI-DURGAPUR,4209,All
2024,11,CHENNAI,DURGAPUR,2969,2629,CHENNAI-DURGAPUR,5598,All
2024,12,CHENNAI,DURGAPUR,5310,5017,CHENNAI-DURGAPUR,10327,All
2025,1,CHENNAI,DURGAPUR,4129,4158,CHENNAI-DURGAPUR,8287,All
2025,2,CHENNAI,DURGAPUR,4509,3693,CHENNAI-DURGAPUR,8202,All
2025,3,CHENNAI,DURGAPUR,4864,3896,CHENNAI-DURGAPUR,8760,All
2023,1,CHENNAI,DehraDun,838,723,CHENNAI-DehraDun,1561,All
2023,6,CHENNAI,DehraDun,929,825,CHENNAI-DehraDun,1754,All
2023,7,CHENNAI,DehraDun,694,533,CHENNAI-DehraDun,1227,All
2023,8,CHENNAI,DehraDun,568,341,CHENNAI-DehraDun,909,All
2023,9,CHENNAI,DehraDun,908,523,CHENNAI-DehraDun,1431,All
2023,10,CHENNAI,DehraDun,698,825,CHENNAI-DehraDun,1523,All
2023,11,CHENNAI,DehraDun,419,585,CHENNAI-DehraDun,1004,All
2023,12,CHENNAI,DehraDun,683,678,CHENNAI-DehraDun,1361,All
2024,3,CHENNAI,DehraDun,9,22,CHENNAI-DehraDun,31,All
2024,4,CHENNAI,DehraDun,412,533,CHENNAI-DehraDun,945,All
2024,6,CHENNAI,DehraDun,619,828,CHENNAI-DehraDun,1447,All
2024,7,CHENNAI,DehraDun,312,527,CHENNAI-DehraDun,839,All
2024,8,CHENNAI,DehraDun,227,319,CHENNAI-DehraDun,546,All
2024,9,CHENNAI,DehraDun,609,705,CHENNAI-DehraDun,1314,All
2024,10,CHENNAI,DehraDun,659,1022,CHENNAI-DehraDun,1681,All
2024,11,CHENNAI,DehraDun,502,562,CHENNAI-DehraDun,1064,All
2024,12,CHENNAI,DehraDun,655,842,CHENNAI-DehraDun,1497,All
2025,3,CHENNAI,DehraDun,21,79,CHENNAI-DehraDun,100,All
2019,9,CHENNAI,GORAKHPUR,0,4,CHENNAI-GORAKHPUR,4,All
2021,7,CHENNAI,GORAKHPUR,62,0,CHENNAI-GORAKHPUR,62,All
2021,8,CHENNAI,GORAKHPUR,25,0,CHENNAI-GORAKHPUR,25,All
2021,9,CHENNAI,GORAKHPUR,44,0,CHENNAI-GORAKHPUR,44,All
2021,10,CHENNAI,GORAKHPUR,44,0,CHENNAI-GORAKHPUR,44,All
2021,11,CHENNAI,GORAKHPUR,157,0,CHENNAI-GORAKHPUR,157,All
2021,12,CHENNAI,GORAKHPUR,141,0,CHENNAI-GORAKHPUR,141,All
2022,1,CHENNAI,GORAKHPUR,85,0,CHENNAI-GORAKHPUR,85,All
2022,2,CHENNAI,GORAKHPUR,106,0,CHENNAI-GORAKHPUR,106,All
2022,3,CHENNAI,GORAKHPUR,9,0,CHENNAI-GORAKHPUR,9,All
2022,4,CHENNAI,GORAKHPUR,124,0,CHENNAI-GORAKHPUR,124,All
2022,5,CHENNAI,GORAKHPUR,249,0,CHENNAI-GORAKHPUR,249,All
2022,6,CHENNAI,GORAKHPUR,202,0,CHENNAI-GORAKHPUR,202,All
2022,7,CHENNAI,GORAKHPUR,6,0,CHENNAI-GORAKHPUR,6,All
2022,8,CHENNAI,GORAKHPUR,36,0,CHENNAI-GORAKHPUR,36,All
2023,3,CHENNAI,GORAKHPUR,5,0,CHENNAI-GORAKHPUR,5,All
2023,4,CHENNAI,GORAKHPUR,81,0,CHENNAI-GORAKHPUR,81,All
2024,6,CHENNAI,GORAKHPUR,0,157,CHENNAI-GORAKHPUR,157,All
2019,5,CHENNAI,GUWAHATI,15152,16810,CHENNAI-GUWAHATI,31962,All
2019,6,CHENNAI,GUWAHATI,13894,15782,CHENNAI-GUWAHATI,29676,All
2019,7,CHENNAI,GUWAHATI,12908,12359,CHENNAI-GUWAHATI,25267,All
2019,8,CHENNAI,GUWAHATI,10016,8808,CHENNAI-GUWAHATI,18824,All
2019,9,CHENNAI,GUWAHATI,10861,9213,CHENNAI-GUWAHATI,20074,All
2019,10,CHENNAI,GUWAHATI,11924,11106,CHENNAI-GUWAHATI,23030,All
2019,11,CHENNAI,GUWAHATI,15076,14164,CHENNAI-GUWAHATI,29240,All
2019,12,CHENNAI,GUWAHATI,15238,12403,CHENNAI-GUWAHATI,27641,All
2020,1,CHENNAI,GUWAHATI,15895,14137,CHENNAI-GUWAHATI,30032,All
2020,2,CHENNAI,GUWAHATI,13814,10984,CHENNAI-GUWAHATI,24798,All
2020,3,CHENNAI,GUWAHATI,10431,6821,CHENNAI-GUWAHATI,17252,All
2020,5,CHENNAI,GUWAHATI,1143,270,CHENNAI-GUWAHATI,1413,All
2020,6,CHENNAI,GUWAHATI,7311,1682,CHENNAI-GUWAHATI,8993,All
2020,7,CHENNAI,GUWAHATI,5078,1465,CHENNAI-GUWAHATI,6543,All
2020,8,CHENNAI,GUWAHATI,4237,6489,CHENNAI-GUWAHATI,10726,All
2020,9,CHENNAI,GUWAHATI,4960,8339,CHENNAI-GUWAHATI,13299,All
2020,10,CHENNAI,GUWAHATI,5664,9665,CHENNAI-GUWAHATI,15329,All
2020,11,CHENNAI,GUWAHATI,7423,9813,CHENNAI-GUWAHATI,17236,All
2020,12,CHENNAI,GUWAHATI,10314,10445,CHENNAI-GUWAHATI,20759,All
2021,1,CHENNAI,GUWAHATI,11598,14540,CHENNAI-GUWAHATI,26138,All
2021,2,CHENNAI,GUWAHATI,10486,11100,CHENNAI-GUWAHATI,21586,All
2021,3,CHENNAI,GUWAHATI,13632,8694,CHENNAI-GUWAHATI,22326,All
2021,4,CHENNAI,GUWAHATI,13072,12237,CHENNAI-GUWAHATI,25309,All
2021,6,CHENNAI,GUWAHATI,2319,4527,CHENNAI-GUWAHATI,6846,All
2021,7,CHENNAI,GUWAHATI,4526,9204,CHENNAI-GUWAHATI,13730,All
2021,8,CHENNAI,GUWAHATI,6924,13293,CHENNAI-GUWAHATI,20217,All
2021,9,CHENNAI,GUWAHATI,9485,11464,CHENNAI-GUWAHATI,20949,All
2021,10,CHENNAI,GUWAHATI,14206,13269,CHENNAI-GUWAHATI,27475,All
2021,11,CHENNAI,GUWAHATI,11796,11737,CHENNAI-GUWAHATI,23533,All
2021,12,CHENNAI,GUWAHATI,12817,12016,CHENNAI-GUWAHATI,24833,All
2022,1,CHENNAI,GUWAHATI,10325,9813,CHENNAI-GUWAHATI,20138,All
2022,2,CHENNAI,GUWAHATI,8235,9058,CHENNAI-GUWAHATI,17293,All
2022,3,CHENNAI,GUWAHATI,12784,15237,CHENNAI-GUWAHATI,28021,All
2022,4,CHENNAI,GUWAHATI,17361,14587,CHENNAI-GUWAHATI,31948,All
2022,5,CHENNAI,GUWAHATI,14406,16768,CHENNAI-GUWAHATI,31174,All
2022,6,CHENNAI,GUWAHATI,12559,13226,CHENNAI-GUWAHATI,25785,All
2022,7,CHENNAI,GUWAHATI,13945,14412,CHENNAI-GUWAHATI,28357,All
2022,8,CHENNAI,GUWAHATI,10231,12648,CHENNAI-GUWAHATI,22879,All
2022,9,CHENNAI,GUWAHATI,11338,12196,CHENNAI-GUWAHATI,23534,All
2022,10,CHENNAI,GUWAHATI,10595,10234,CHENNAI-GUWAHATI,20829,All
2022,11,CHENNAI,GUWAHATI,13207,12973,CHENNAI-GUWAHATI,26180,All
2022,12,CHENNAI,GUWAHATI,13025,12503,CHENNAI-GUWAHATI,25528,All
2023,1,CHENNAI,GUWAHATI,12311,11847,CHENNAI-GUWAHATI,24158,All
2023,2,CHENNAI,GUWAHATI,10498,9472,CHENNAI-GUWAHATI,19970,All
2023,3,CHENNAI,GUWAHATI,14484,12065,CHENNAI-GUWAHATI,26549,All
2023,4,CHENNAI,GUWAHATI,14151,12526,CHENNAI-GUWAHATI,26677,All
2023,5,CHENNAI,GUWAHATI,13509,14649,CHENNAI-GUWAHATI,28158,All
2023,6,CHENNAI,GUWAHATI,13267,13952,CHENNAI-GUWAHATI,27219,All
2023,7,CHENNAI,GUWAHATI,13533,14071,CHENNAI-GUWAHATI,27604,All
2023,8,CHENNAI,GUWAHATI,13498,14076,CHENNAI-GUWAHATI,27574,All
2023,9,CHENNAI,GUWAHATI,12971,11920,CHENNAI-GUWAHATI,24891,All
2023,10,CHENNAI,GUWAHATI,15115,12796,CHENNAI-GUWAHATI,27911,All
2023,11,CHENNAI,GUWAHATI,13805,12346,CHENNAI-GUWAHATI,26151,All
2023,12,CHENNAI,GUWAHATI,14033,12976,CHENNAI-GUWAHATI,27009,All
2024,1,CHENNAI,GUWAHATI,14148,14827,CHENNAI-GUWAHATI,28975,All
2024,2,CHENNAI,GUWAHATI,13672,13111,CHENNAI-GUWAHATI,26783,All
2024,3,CHENNAI,GUWAHATI,15155,13464,CHENNAI-GUWAHATI,28619,All
2024,4,CHENNAI,GUWAHATI,15049,13175,CHENNAI-GUWAHATI,28224,All
2024,6,CHENNAI,GUWAHATI,12683,13289,CHENNAI-GUWAHATI,25972,All
2024,7,CHENNAI,GUWAHATI,14238,14923,CHENNAI-GUWAHATI,29161,All
2024,8,CHENNAI,GUWAHATI,13248,13270,CHENNAI-GUWAHATI,26518,All
2024,9,CHENNAI,GUWAHATI,12812,12004,CHENNAI-GUWAHATI,24816,All
2024,10,CHENNAI,GUWAHATI,15123,12854,CHENNAI-GUWAHATI,27977,All
2024,11,CHENNAI,GUWAHATI,12989,13728,CHENNAI-GUWAHATI,26717,All
2024,12,CHENNAI,GUWAHATI,16215,15467,CHENNAI-GUWAHATI,31682,All
2025,1,CHENNAI,GUWAHATI,15039,15797,CHENNAI-GUWAHATI,30836,All
2025,2,CHENNAI,GUWAHATI,14800,13930,CHENNAI-GUWAHATI,28730,All
2025,3,CHENNAI,GUWAHATI,15946,15118,CHENNAI-GUWAHATI,31064,All
2023,11,CHENNAI,Goa,7733,7371,CHENNAI-Goa,15104,All
2023,12,CHENNAI,Goa,7464,7625,CHENNAI-Goa,15089,All
2024,1,CHENNAI,Goa,6774,8331,CHENNAI-Goa,15105,All
2024,2,CHENNAI,Goa,6198,7551,CHENNAI-Goa,13749,All
2024,3,CHENNAI,Goa,5834,6914,CHENNAI-Goa,12748,All
2024,4,CHENNAI,Goa,3791,4033,CHENNAI-Goa,7824,All
2024,6,CHENNAI,Goa,6018,6263,CHENNAI-Goa,12281,All
2024,7,CHENNAI,Goa,4581,5219,CHENNAI-Goa,9800,All
2024,8,CHENNAI,Goa,6347,6218,CHENNAI-Goa,12565,All
2024,9,CHENNAI,Goa,6829,6766,CHENNAI-Goa,13595,All
2024,10,CHENNAI,Goa,6980,7453,CHENNAI-Goa,14433,All
2024,11,CHENNAI,Goa,4023,3780,CHENNAI-Goa,7803,All
2024,12,CHENNAI,Goa,684,642,CHENNAI-Goa,1326,All
2025,1,CHENNAI,Goa,645,573,CHENNAI-Goa,1218,All
2025,2,CHENNAI,Goa,704,525,CHENNAI-Goa,1229,All
2025,3,CHENNAI,Goa,986,802,CHENNAI-Goa,1788,All
2025,3,CHENNAI,HINDON AIRPORT,1541,1498,CHENNAI-HINDON AIRPORT,3039,All
2019,5,CHENNAI,HUBLI,4196,4386,CHENNAI-HUBLI,8582,All
2019,6,CHENNAI,HUBLI,3293,3824,CHENNAI-HUBLI,7117,All
2019,7,CHENNAI,HUBLI,3098,3607,CHENNAI-HUBLI,6705,All
2019,9,CHENNAI,HUBLI,2705,2994,CHENNAI-HUBLI,5699,All
2019,10,CHENNAI,HUBLI,2873,3333,CHENNAI-HUBLI,6206,All
2019,11,CHENNAI,HUBLI,2028,2024,CHENNAI-HUBLI,4052,All
2019,12,CHENNAI,HUBLI,2020,2040,CHENNAI-HUBLI,4060,All
2020,1,CHENNAI,HUBLI,1952,2009,CHENNAI-HUBLI,3961,All
2020,2,CHENNAI,HUBLI,1718,1799,CHENNAI-HUBLI,3517,All
2020,3,CHENNAI,HUBLI,1257,1102,CHENNAI-HUBLI,2359,All
2020,9,CHENNAI,HUBLI,521,517,CHENNAI-HUBLI,1038,All
2020,10,CHENNAI,HUBLI,756,871,CHENNAI-HUBLI,1627,All
2020,11,CHENNAI,HUBLI,993,1186,CHENNAI-HUBLI,2179,All
2020,12,CHENNAI,HUBLI,1358,1397,CHENNAI-HUBLI,2755,All
2021,1,CHENNAI,HUBLI,1237,1533,CHENNAI-HUBLI,2770,All
2021,2,CHENNAI,HUBLI,1297,1462,CHENNAI-HUBLI,2759,All
2021,3,CHENNAI,HUBLI,964,1142,CHENNAI-HUBLI,2106,All
2021,4,CHENNAI,HUBLI,716,725,CHENNAI-HUBLI,1441,All
2021,7,CHENNAI,HUBLI,636,728,CHENNAI-HUBLI,1364,All
2021,8,CHENNAI,HUBLI,1067,1205,CHENNAI-HUBLI,2272,All
2021,9,CHENNAI,HUBLI,1037,1200,CHENNAI-HUBLI,2237,All
2021,10,CHENNAI,HUBLI,1159,1394,CHENNAI-HUBLI,2553,All
2021,11,CHENNAI,HUBLI,1311,1346,CHENNAI-HUBLI,2657,All
2021,12,CHENNAI,HUBLI,1648,1665,CHENNAI-HUBLI,3313,All
2022,1,CHENNAI,HUBLI,948,1062,CHENNAI-HUBLI,2010,All
2022,2,CHENNAI,HUBLI,860,870,CHENNAI-HUBLI,1730,All
2022,3,CHENNAI,HUBLI,1362,1606,CHENNAI-HUBLI,2968,All
2022,4,CHENNAI,HUBLI,1688,1755,CHENNAI-HUBLI,3443,All
2022,5,CHENNAI,HUBLI,1594,1645,CHENNAI-HUBLI,3239,All
2022,6,CHENNAI,HUBLI,1632,1799,CHENNAI-HUBLI,3431,All
2022,7,CHENNAI,HUBLI,1664,1640,CHENNAI-HUBLI,3304,All
2022,8,CHENNAI,HUBLI,1665,1674,CHENNAI-HUBLI,3339,All
2022,9,CHENNAI,HUBLI,1646,1739,CHENNAI-HUBLI,3385,All
2022,10,CHENNAI,HUBLI,1771,2006,CHENNAI-HUBLI,3777,All
2022,11,CHENNAI,HUBLI,1802,1859,CHENNAI-HUBLI,3661,All
2022,12,CHENNAI,HUBLI,1749,1806,CHENNAI-HUBLI,3555,All
2023,1,CHENNAI,HUBLI,1623,1863,CHENNAI-HUBLI,3486,All
2023,2,CHENNAI,HUBLI,1590,1638,CHENNAI-HUBLI,3228,All
2023,3,CHENNAI,HUBLI,1634,1692,CHENNAI-HUBLI,3326,All
2023,4,CHENNAI,HUBLI,1741,1679,CHENNAI-HUBLI,3420,All
2023,5,CHENNAI,HUBLI,1942,1940,CHENNAI-HUBLI,3882,All
2023,6,CHENNAI,HUBLI,1741,1804,CHENNAI-HUBLI,3545,All
2023,7,CHENNAI,HUBLI,1750,1769,CHENNAI-HUBLI,3519,All
2023,8,CHENNAI,HUBLI,1839,1936,CHENNAI-HUBLI,3775,All
2023,9,CHENNAI,HUBLI,1810,1768,CHENNAI-HUBLI,3578,All
2023,10,CHENNAI,HUBLI,1758,1769,CHENNAI-HUBLI,3527,All
2023,11,CHENNAI,HUBLI,827,722,CHENNAI-HUBLI,1549,All
2023,12,CHENNAI,HUBLI,730,645,CHENNAI-HUBLI,1375,All
2024,1,CHENNAI,HUBLI,715,715,CHENNAI-HUBLI,1430,All
2024,2,CHENNAI,HUBLI,772,710,CHENNAI-HUBLI,1482,All
2024,3,CHENNAI,HUBLI,662,597,CHENNAI-HUBLI,1259,All
2024,4,CHENNAI,HUBLI,664,699,CHENNAI-HUBLI,1363,All
2024,6,CHENNAI,HUBLI,645,699,CHENNAI-HUBLI,1344,All
2024,7,CHENNAI,HUBLI,631,665,CHENNAI-HUBLI,1296,All
2024,8,CHENNAI,HUBLI,707,753,CHENNAI-HUBLI,1460,All
2024,9,CHENNAI,HUBLI,669,674,CHENNAI-HUBLI,1343,All
2024,10,CHENNAI,HUBLI,651,671,CHENNAI-HUBLI,1322,All
2019,5,CHENNAI,HYDERABAD,56495,58402,CHENNAI-HYDERABAD,114897,All
2019,6,CHENNAI,HYDERABAD,57943,57586,CHENNAI-HYDERABAD,115529,All
2019,7,CHENNAI,HYDERABAD,63866,64248,CHENNAI-HYDERABAD,128114,All
2019,8,CHENNAI,HYDERABAD,67828,66920,CHENNAI-HYDERABAD,134748,All
2019,9,CHENNAI,HYDERABAD,67480,64439,CHENNAI-HYDERABAD,131919,All
2019,10,CHENNAI,HYDERABAD,69413,68569,CHENNAI-HYDERABAD,137982,All
2019,11,CHENNAI,HYDERABAD,70516,67011,CHENNAI-HYDERABAD,137527,All
2019,12,CHENNAI,HYDERABAD,72042,68926,CHENNAI-HYDERABAD,140968,All
2020,1,CHENNAI,HYDERABAD,67041,65298,CHENNAI-HYDERABAD,132339,All
2020,2,CHENNAI,HYDERABAD,59935,60223,CHENNAI-HYDERABAD,120158,All
2020,3,CHENNAI,HYDERABAD,40185,35196,CHENNAI-HYDERABAD,75381,All
2020,4,CHENNAI,HYDERABAD,0,0,CHENNAI-HYDERABAD,0,All
2020,5,CHENNAI,HYDERABAD,1078,748,CHENNAI-HYDERABAD,1826,All
2020,6,CHENNAI,HYDERABAD,8463,4854,CHENNAI-HYDERABAD,13317,All
2020,7,CHENNAI,HYDERABAD,11447,10923,CHENNAI-HYDERABAD,22370,All
2020,8,CHENNAI,HYDERABAD,12971,19584,CHENNAI-HYDERABAD,32555,All
2020,9,CHENNAI,HYDERABAD,17265,25152,CHENNAI-HYDERABAD,42417,All
2020,10,CHENNAI,HYDERABAD,24852,31313,CHENNAI-HYDERABAD,56165,All
2020,11,CHENNAI,HYDERABAD,27564,28282,CHENNAI-HYDERABAD,55846,All
2020,12,CHENNAI,HYDERABAD,30606,33477,CHENNAI-HYDERABAD,64083,All
2021,1,CHENNAI,HYDERABAD,34580,35393,CHENNAI-HYDERABAD,69973,All
2021,2,CHENNAI,HYDERABAD,34807,31624,CHENNAI-HYDERABAD,66431,All
2021,3,CHENNAI,HYDERABAD,36952,30940,CHENNAI-HYDERABAD,67892,All
2021,4,CHENNAI,HYDERABAD,30738,25049,CHENNAI-HYDERABAD,55787,All
2021,6,CHENNAI,HYDERABAD,11926,13412,CHENNAI-HYDERABAD,25338,All
2021,7,CHENNAI,HYDERABAD,26332,27606,CHENNAI-HYDERABAD,53938,All
2021,8,CHENNAI,HYDERABAD,36928,40050,CHENNAI-HYDERABAD,76978,All
2021,9,CHENNAI,HYDERABAD,33871,34236,CHENNAI-HYDERABAD,68107,All
2021,10,CHENNAI,HYDERABAD,40271,39559,CHENNAI-HYDERABAD,79830,All
2021,11,CHENNAI,HYDERABAD,43860,40681,CHENNAI-HYDERABAD,84541,All
2021,12,CHENNAI,HYDERABAD,47324,46868,CHENNAI-HYDERABAD,94192,All
2022,1,CHENNAI,HYDERABAD,30542,28190,CHENNAI-HYDERABAD,58732,All
2022,2,CHENNAI,HYDERABAD,35665,35185,CHENNAI-HYDERABAD,70850,All
2022,3,CHENNAI,HYDERABAD,50964,50892,CHENNAI-HYDERABAD,101856,All
2022,4,CHENNAI,HYDERABAD,45891,44398,CHENNAI-HYDERABAD,90289,All
2022,5,CHENNAI,HYDERABAD,41854,44288,CHENNAI-HYDERABAD,86142,All
2022,6,CHENNAI,HYDERABAD,44241,41001,CHENNAI-HYDERABAD,85242,All
2022,7,CHENNAI,HYDERABAD,43476,42472,CHENNAI-HYDERABAD,85948,All
2022,8,CHENNAI,HYDERABAD,40300,41366,CHENNAI-HYDERABAD,81666,All
2022,9,CHENNAI,HYDERABAD,39852,39769,CHENNAI-HYDERABAD,79621,All
2022,10,CHENNAI,HYDERABAD,44875,45559,CHENNAI-HYDERABAD,90434,All
2022,11,CHENNAI,HYDERABAD,50339,50403,CHENNAI-HYDERABAD,100742,All
2022,12,CHENNAI,HYDERABAD,54430,53726,CHENNAI-HYDERABAD,108156,All
2023,1,CHENNAI,HYDERABAD,52059,53104,CHENNAI-HYDERABAD,105163,All
2023,2,CHENNAI,HYDERABAD,49189,48587,CHENNAI-HYDERABAD,97776,All
2023,3,CHENNAI,HYDERABAD,51273,49397,CHENNAI-HYDERABAD,100670,All
2023,4,CHENNAI,HYDERABAD,58809,54567,CHENNAI-HYDERABAD,113376,All
2023,5,CHENNAI,HYDERABAD,61191,60125,CHENNAI-HYDERABAD,121316,All
2023,6,CHENNAI,HYDERABAD,57681,56646,CHENNAI-HYDERABAD,114327,All
2023,7,CHENNAI,HYDERABAD,53977,51844,CHENNAI-HYDERABAD,105821,All
2023,8,CHENNAI,HYDERABAD,55452,51907,CHENNAI-HYDERABAD,107359,All
2023,9,CHENNAI,HYDERABAD,56888,52862,CHENNAI-HYDERABAD,109750,All
2023,10,CHENNAI,HYDERABAD,57961,54599,CHENNAI-HYDERABAD,112560,All
2023,11,CHENNAI,HYDERABAD,55663,52778,CHENNAI-HYDERABAD,108441,All
2023,12,CHENNAI,HYDERABAD,54862,52467,CHENNAI-HYDERABAD,107329,All
2024,1,CHENNAI,HYDERABAD,59733,61696,CHENNAI-HYDERABAD,121429,All
2024,2,CHENNAI,HYDERABAD,57715,53181,CHENNAI-HYDERABAD,110896,All
2024,3,CHENNAI,HYDERABAD,66021,63248,CHENNAI-HYDERABAD,129269,All
2024,4,CHENNAI,HYDERABAD,67331,65439,CHENNAI-HYDERABAD,132770,All
2024,6,CHENNAI,HYDERABAD,63165,60912,CHENNAI-HYDERABAD,124077,All
2024,7,CHENNAI,HYDERABAD,63246,62618,CHENNAI-HYDERABAD,125864,All
2024,8,CHENNAI,HYDERABAD,69357,67498,CHENNAI-HYDERABAD,136855,All
2024,9,CHENNAI,HYDERABAD,68919,63671,CHENNAI-HYDERABAD,132590,All
2024,10,CHENNAI,HYDERABAD,68756,65614,CHENNAI-HYDERABAD,134370,All
2024,11,CHENNAI,HYDERABAD,60607,59959,CHENNAI-HYDERABAD,120566,All
2024,12,CHENNAI,HYDERABAD,67843,67415,CHENNAI-HYDERABAD,135258,All
2025,1,CHENNAI,HYDERABAD,66939,67835,CHENNAI-HYDERABAD,134774,All
2025,2,CHENNAI,HYDERABAD,60140,58828,CHENNAI-HYDERABAD,118968,All
2025,3,CHENNAI,HYDERABAD,67266,65060,CHENNAI-HYDERABAD,132326,All
2020,5,CHENNAI,IMPHAL,0,63,CHENNAI-IMPHAL,63,All
2019,5,CHENNAI,INDORE,4504,4952,CHENNAI-INDORE,9456,All
2019,6,CHENNAI,INDORE,4758,4271,CHENNAI-INDORE,9029,All
2019,7,CHENNAI,INDORE,3933,3963,CHENNAI-INDORE,7896,All
2019,8,CHENNAI,INDORE,4238,3992,CHENNAI-INDORE,8230,All
2019,9,CHENNAI,INDORE,4411,3676,CHENNAI-INDORE,8087,All
2019,10,CHENNAI,INDORE,4234,3666,CHENNAI-INDORE,7900,All
2019,11,CHENNAI,INDORE,4753,4310,CHENNAI-INDORE,9063,All
2019,12,CHENNAI,INDORE,5000,5049,CHENNAI-INDORE,10049,All
2020,1,CHENNAI,INDORE,4907,4780,CHENNAI-INDORE,9687,All
2020,2,CHENNAI,INDORE,4027,4205,CHENNAI-INDORE,8232,All
2020,3,CHENNAI,INDORE,3379,2754,CHENNAI-INDORE,6133,All
2020,11,CHENNAI,INDORE,812,636,CHENNAI-INDORE,1448,All
2020,12,CHENNAI,INDORE,2237,2423,CHENNAI-INDORE,4660,All
2021,1,CHENNAI,INDORE,3215,3661,CHENNAI-INDORE,6876,All
2021,2,CHENNAI,INDORE,3642,3225,CHENNAI-INDORE,6867,All
2021,3,CHENNAI,INDORE,3235,2782,CHENNAI-INDORE,6017,All
2021,4,CHENNAI,INDORE,868,703,CHENNAI-INDORE,1571,All
2021,7,CHENNAI,INDORE,262,177,CHENNAI-INDORE,439,All
2021,8,CHENNAI,INDORE,621,478,CHENNAI-INDORE,1099,All
2021,9,CHENNAI,INDORE,1916,1829,CHENNAI-INDORE,3745,All
2021,10,CHENNAI,INDORE,2075,2202,CHENNAI-INDORE,4277,All
2021,11,CHENNAI,INDORE,3087,3261,CHENNAI-INDORE,6348,All
2021,12,CHENNAI,INDORE,2353,3011,CHENNAI-INDORE,5364,All
2022,1,CHENNAI,INDORE,2215,1917,CHENNAI-INDORE,4132,All
2022,2,CHENNAI,INDORE,955,1028,CHENNAI-INDORE,1983,All
2022,3,CHENNAI,INDORE,1389,1760,CHENNAI-INDORE,3149,All
2022,4,CHENNAI,INDORE,3086,3803,CHENNAI-INDORE,6889,All
2022,5,CHENNAI,INDORE,2875,3703,CHENNAI-INDORE,6578,All
2022,6,CHENNAI,INDORE,1458,1266,CHENNAI-INDORE,2724,All
2022,7,CHENNAI,INDORE,1338,1388,CHENNAI-INDORE,2726,All
2022,8,CHENNAI,INDORE,1406,1474,CHENNAI-INDORE,2880,All
2022,9,CHENNAI,INDORE,1460,1408,CHENNAI-INDORE,2868,All
2022,10,CHENNAI,INDORE,1775,1747,CHENNAI-INDORE,3522,All
2022,11,CHENNAI,INDORE,2600,2381,CHENNAI-INDORE,4981,All
2022,12,CHENNAI,INDORE,3526,3800,CHENNAI-INDORE,7326,All
2023,1,CHENNAI,INDORE,4020,4098,CHENNAI-INDORE,8118,All
2023,2,CHENNAI,INDORE,4184,3982,CHENNAI-INDORE,8166,All
2023,3,CHENNAI,INDORE,4622,4230,CHENNAI-INDORE,8852,All
2023,4,CHENNAI,INDORE,4660,4241,CHENNAI-INDORE,8901,All
2023,5,CHENNAI,INDORE,4694,5001,CHENNAI-INDORE,9695,All
2023,6,CHENNAI,INDORE,4613,4739,CHENNAI-INDORE,9352,All
2023,7,CHENNAI,INDORE,4237,4552,CHENNAI-INDORE,8789,All
2023,8,CHENNAI,INDORE,4689,4575,CHENNAI-INDORE,9264,All
2023,9,CHENNAI,INDORE,4800,4938,CHENNAI-INDORE,9738,All
2023,10,CHENNAI,INDORE,4909,4810,CHENNAI-INDORE,9719,All
2023,11,CHENNAI,INDORE,4601,4525,CHENNAI-INDORE,9126,All
2023,12,CHENNAI,INDORE,4911,5194,CHENNAI-INDORE,10105,All
2024,1,CHENNAI,INDORE,5049,5073,CHENNAI-INDORE,10122,All
2024,2,CHENNAI,INDORE,4884,4814,CHENNAI-INDORE,9698,All
2024,3,CHENNAI,INDORE,5119,5049,CHENNAI-INDORE,10168,All
2024,4,CHENNAI,INDORE,6067,5433,CHENNAI-INDORE,11500,All
2024,6,CHENNAI,INDORE,4794,5072,CHENNAI-INDORE,9866,All
2024,7,CHENNAI,INDORE,5134,5215,CHENNAI-INDORE,10349,All
2024,8,CHENNAI,INDORE,4776,4772,CHENNAI-INDORE,9548,All
2024,9,CHENNAI,INDORE,4837,4906,CHENNAI-INDORE,9743,All
2024,10,CHENNAI,INDORE,4609,3974,CHENNAI-INDORE,8583,All
2024,11,CHENNAI,INDORE,5893,6519,CHENNAI-INDORE,12412,All
2024,12,CHENNAI,INDORE,7262,7750,CHENNAI-INDORE,15012,All
2025,1,CHENNAI,INDORE,7647,8243,CHENNAI-INDORE,15890,All
2025,2,CHENNAI,INDORE,7433,7106,CHENNAI-INDORE,14539,All
2025,3,CHENNAI,INDORE,6514,6416,CHENNAI-INDORE,12930,All
2022,5,CHENNAI,JABALPUR,64,180,CHENNAI-JABALPUR,244,All
2022,6,CHENNAI,JABALPUR,485,805,CHENNAI-JABALPUR,1290,All
2022,7,CHENNAI,JABALPUR,305,359,CHENNAI-JABALPUR,664,All
2019,5,CHENNAI,JAIPUR,6123,5665,CHENNAI-JAIPUR,11788,All
2019,6,CHENNAI,JAIPUR,5739,5888,CHENNAI-JAIPUR,11627,All
2019,7,CHENNAI,JAIPUR,5160,5420,CHENNAI-JAIPUR,10580,All
2019,8,CHENNAI,JAIPUR,5460,5666,CHENNAI-JAIPUR,11126,All
2019,9,CHENNAI,JAIPUR,5044,4908,CHENNAI-JAIPUR,9952,All
2019,10,CHENNAI,JAIPUR,5070,5051,CHENNAI-JAIPUR,10121,All
2019,11,CHENNAI,JAIPUR,10586,10155,CHENNAI-JAIPUR,20741,All
2019,12,CHENNAI,JAIPUR,10175,10659,CHENNAI-JAIPUR,20834,All
2020,1,CHENNAI,JAIPUR,10414,9868,CHENNAI-JAIPUR,20282,All
2020,2,CHENNAI,JAIPUR,5627,5618,CHENNAI-JAIPUR,11245,All
2020,3,CHENNAI,JAIPUR,4409,3594,CHENNAI-JAIPUR,8003,All
2020,8,CHENNAI,JAIPUR,1358,2131,CHENNAI-JAIPUR,3489,All
2020,9,CHENNAI,JAIPUR,2051,2839,CHENNAI-JAIPUR,4890,All
2020,10,CHENNAI,JAIPUR,1808,2285,CHENNAI-JAIPUR,4093,All
2020,11,CHENNAI,JAIPUR,6409,3442,CHENNAI-JAIPUR,9851,All
2020,12,CHENNAI,JAIPUR,5281,7468,CHENNAI-JAIPUR,12749,All
2021,1,CHENNAI,JAIPUR,3830,3996,CHENNAI-JAIPUR,7826,All
2021,2,CHENNAI,JAIPUR,4038,3566,CHENNAI-JAIPUR,7604,All
2021,3,CHENNAI,JAIPUR,3311,2976,CHENNAI-JAIPUR,6287,All
2021,4,CHENNAI,JAIPUR,3423,1986,CHENNAI-JAIPUR,5409,All
2021,6,CHENNAI,JAIPUR,293,370,CHENNAI-JAIPUR,663,All
2021,7,CHENNAI,JAIPUR,942,1083,CHENNAI-JAIPUR,2025,All
2021,8,CHENNAI,JAIPUR,1705,1789,CHENNAI-JAIPUR,3494,All
2021,9,CHENNAI,JAIPUR,2202,2062,CHENNAI-JAIPUR,4264,All
2021,10,CHENNAI,JAIPUR,4468,3993,CHENNAI-JAIPUR,8461,All
2021,11,CHENNAI,JAIPUR,10452,8708,CHENNAI-JAIPUR,19160,All
2021,12,CHENNAI,JAIPUR,9229,10901,CHENNAI-JAIPUR,20130,All
2022,1,CHENNAI,JAIPUR,2334,2362,CHENNAI-JAIPUR,4696,All
2022,2,CHENNAI,JAIPUR,3107,2887,CHENNAI-JAIPUR,5994,All
2022,3,CHENNAI,JAIPUR,7669,6651,CHENNAI-JAIPUR,14320,All
2022,4,CHENNAI,JAIPUR,6671,5917,CHENNAI-JAIPUR,12588,All
2022,5,CHENNAI,JAIPUR,5193,5711,CHENNAI-JAIPUR,10904,All
2022,6,CHENNAI,JAIPUR,4520,4312,CHENNAI-JAIPUR,8832,All
2022,7,CHENNAI,JAIPUR,4733,4247,CHENNAI-JAIPUR,8980,All
2022,8,CHENNAI,JAIPUR,4857,4494,CHENNAI-JAIPUR,9351,All
2022,9,CHENNAI,JAIPUR,4871,4273,CHENNAI-JAIPUR,9144,All
2022,10,CHENNAI,JAIPUR,4588,4644,CHENNAI-JAIPUR,9232,All
2022,11,CHENNAI,JAIPUR,4300,4723,CHENNAI-JAIPUR,9023,All
2022,12,CHENNAI,JAIPUR,4173,4796,CHENNAI-JAIPUR,8969,All
2023,1,CHENNAI,JAIPUR,4487,4604,CHENNAI-JAIPUR,9091,All
2023,2,CHENNAI,JAIPUR,4405,4360,CHENNAI-JAIPUR,8765,All
2023,3,CHENNAI,JAIPUR,4154,4389,CHENNAI-JAIPUR,8543,All
2023,4,CHENNAI,JAIPUR,4699,4389,CHENNAI-JAIPUR,9088,All
2023,5,CHENNAI,JAIPUR,4577,5122,CHENNAI-JAIPUR,9699,All
2023,6,CHENNAI,JAIPUR,4339,4802,CHENNAI-JAIPUR,9141,All
2023,7,CHENNAI,JAIPUR,4355,4769,CHENNAI-JAIPUR,9124,All
2023,8,CHENNAI,JAIPUR,4706,4614,CHENNAI-JAIPUR,9320,All
2023,9,CHENNAI,JAIPUR,4856,4907,CHENNAI-JAIPUR,9763,All
2023,10,CHENNAI,JAIPUR,5146,5084,CHENNAI-JAIPUR,10230,All
2023,11,CHENNAI,JAIPUR,6459,5863,CHENNAI-JAIPUR,12322,All
2023,12,CHENNAI,JAIPUR,6408,6454,CHENNAI-JAIPUR,12862,All
2024,1,CHENNAI,JAIPUR,7416,6941,CHENNAI-JAIPUR,14357,All
2024,2,CHENNAI,JAIPUR,10265,9793,CHENNAI-JAIPUR,20058,All
2024,3,CHENNAI,JAIPUR,9088,9237,CHENNAI-JAIPUR,18325,All
2024,4,CHENNAI,JAIPUR,6367,5747,CHENNAI-JAIPUR,12114,All
2024,6,CHENNAI,JAIPUR,6401,6718,CHENNAI-JAIPUR,13119,All
2024,7,CHENNAI,JAIPUR,5241,6582,CHENNAI-JAIPUR,11823,All
2024,8,CHENNAI,JAIPUR,5671,6306,CHENNAI-JAIPUR,11977,All
2024,9,CHENNAI,JAIPUR,6937,7135,CHENNAI-JAIPUR,14072,All
2024,10,CHENNAI,JAIPUR,11552,10211,CHENNAI-JAIPUR,21763,All
2024,11,CHENNAI,JAIPUR,14986,15176,CHENNAI-JAIPUR,30162,All
2024,12,CHENNAI,JAIPUR,14962,16695,CHENNAI-JAIPUR,31657,All
2025,1,CHENNAI,JAIPUR,13306,13282,CHENNAI-JAIPUR,26588,All
2025,2,CHENNAI,JAIPUR,15405,15369,CHENNAI-JAIPUR,30774,All
2025,3,CHENNAI,JAIPUR,13593,13796,CHENNAI-JAIPUR,27389,All
2019,10,CHENNAI,JAISALMER,0,9,CHENNAI-JAISALMER,9,All
2019,11,CHENNAI,JAISALMER,0,71,CHENNAI-JAISALMER,71,All
2019,12,CHENNAI,JAISALMER,0,139,CHENNAI-JAISALMER,139,All
2020,1,CHENNAI,JAISALMER,5,107,CHENNAI-JAISALMER,112,All
2020,2,CHENNAI,JAISALMER,0,96,CHENNAI-JAISALMER,96,All
2020,3,CHENNAI,JAISALMER,0,57,CHENNAI-JAISALMER,57,All
2024,10,CHENNAI,JAMMU,17,7,CHENNAI-JAMMU,24,All
2024,11,CHENNAI,JAMMU,144,156,CHENNAI-JAMMU,300,All
2024,12,CHENNAI,JAMMU,140,86,CHENNAI-JAMMU,226,All
2025,3,CHENNAI,JAMMU,175,83,CHENNAI-JAMMU,258,All
2021,4,CHENNAI,JHARSUGUDA,206,224,CHENNAI-JHARSUGUDA,430,All
2020,8,CHENNAI,JODHPUR,1080,1084,CHENNAI-JODHPUR,2164,All
2020,9,CHENNAI,JODHPUR,4510,4685,CHENNAI-JODHPUR,9195,All
2020,10,CHENNAI,JODHPUR,5470,5472,CHENNAI-JODHPUR,10942,All
2020,11,CHENNAI,JODHPUR,5360,4834,CHENNAI-JODHPUR,10194,All
2020,12,CHENNAI,JODHPUR,5270,5342,CHENNAI-JODHPUR,10612,All
2021,1,CHENNAI,JODHPUR,5048,4965,CHENNAI-JODHPUR,10013,All
2021,2,CHENNAI,JODHPUR,5009,4724,CHENNAI-JODHPUR,9733,All
2021,3,CHENNAI,JODHPUR,5180,4780,CHENNAI-JODHPUR,9960,All
2021,4,CHENNAI,JODHPUR,4764,4067,CHENNAI-JODHPUR,8831,All
2021,6,CHENNAI,JODHPUR,4423,5559,CHENNAI-JODHPUR,9982,All
2021,7,CHENNAI,JODHPUR,7060,6720,CHENNAI-JODHPUR,13780,All
2021,8,CHENNAI,JODHPUR,5345,5167,CHENNAI-JODHPUR,10512,All
2021,9,CHENNAI,JODHPUR,4568,4394,CHENNAI-JODHPUR,8962,All
2021,10,CHENNAI,JODHPUR,6212,6053,CHENNAI-JODHPUR,12265,All
2021,11,CHENNAI,JODHPUR,4803,4116,CHENNAI-JODHPUR,8919,All
2021,12,CHENNAI,JODHPUR,5105,5276,CHENNAI-JODHPUR,10381,All
2022,1,CHENNAI,JODHPUR,4836,4630,CHENNAI-JODHPUR,9466,All
2022,2,CHENNAI,JODHPUR,4942,4804,CHENNAI-JODHPUR,9746,All
2022,3,CHENNAI,JODHPUR,6078,5944,CHENNAI-JODHPUR,12022,All
2022,4,CHENNAI,JODHPUR,5344,4896,CHENNAI-JODHPUR,10240,All
2022,5,CHENNAI,JODHPUR,5144,5372,CHENNAI-JODHPUR,10516,All
2022,6,CHENNAI,JODHPUR,4952,4963,CHENNAI-JODHPUR,9915,All
2022,7,CHENNAI,JODHPUR,4945,5072,CHENNAI-JODHPUR,10017,All
2022,8,CHENNAI,JODHPUR,4863,5121,CHENNAI-JODHPUR,9984,All
2022,9,CHENNAI,JODHPUR,4857,4869,CHENNAI-JODHPUR,9726,All
2022,10,CHENNAI,JODHPUR,5254,5173,CHENNAI-JODHPUR,10427,All
2022,11,CHENNAI,JODHPUR,4651,4907,CHENNAI-JODHPUR,9558,All
2022,12,CHENNAI,JODHPUR,4765,5199,CHENNAI-JODHPUR,9964,All
2023,1,CHENNAI,JODHPUR,4517,4684,CHENNAI-JODHPUR,9201,All
2023,2,CHENNAI,JODHPUR,4658,4649,CHENNAI-JODHPUR,9307,All
2023,3,CHENNAI,JODHPUR,4620,4775,CHENNAI-JODHPUR,9395,All
2023,4,CHENNAI,JODHPUR,4874,3764,CHENNAI-JODHPUR,8638,All
2023,5,CHENNAI,JODHPUR,4931,5250,CHENNAI-JODHPUR,10181,All
2023,6,CHENNAI,JODHPUR,4652,4227,CHENNAI-JODHPUR,8879,All
2023,7,CHENNAI,JODHPUR,4144,4223,CHENNAI-JODHPUR,8367,All
2023,8,CHENNAI,JODHPUR,5083,4738,CHENNAI-JODHPUR,9821,All
2023,9,CHENNAI,JODHPUR,5305,4829,CHENNAI-JODHPUR,10134,All
2023,10,CHENNAI,JODHPUR,5095,5024,CHENNAI-JODHPUR,10119,All
2023,11,CHENNAI,JODHPUR,5533,5154,CHENNAI-JODHPUR,10687,All
2023,12,CHENNAI,JODHPUR,4732,4979,CHENNAI-JODHPUR,9711,All
2024,11,CHENNAI,JODHPUR,0,172,CHENNAI-JODHPUR,172,All
2019,5,CHENNAI,KADAPA,1409,1834,CHENNAI-KADAPA,3243,All
2019,6,CHENNAI,KADAPA,1349,1636,CHENNAI-KADAPA,2985,All
2019,7,CHENNAI,KADAPA,1304,1652,CHENNAI-KADAPA,2956,All
2019,8,CHENNAI,KADAPA,1465,1720,CHENNAI-KADAPA,3185,All
2019,9,CHENNAI,KADAPA,1239,1303,CHENNAI-KADAPA,2542,All
2019,10,CHENNAI,KADAPA,1512,1666,CHENNAI-KADAPA,3178,All
2019,11,CHENNAI,KADAPA,1483,1708,CHENNAI-KADAPA,3191,All
2019,12,CHENNAI,KADAPA,1787,2091,CHENNAI-KADAPA,3878,All
2020,1,CHENNAI,KADAPA,1395,1671,CHENNAI-KADAPA,3066,All
2020,2,CHENNAI,KADAPA,1441,1940,CHENNAI-KADAPA,3381,All
2020,3,CHENNAI,KADAPA,1218,1250,CHENNAI-KADAPA,2468,All
2020,5,CHENNAI,KADAPA,83,0,CHENNAI-KADAPA,83,All
2020,6,CHENNAI,KADAPA,549,331,CHENNAI-KADAPA,880,All
2020,7,CHENNAI,KADAPA,285,261,CHENNAI-KADAPA,546,All
2020,8,CHENNAI,KADAPA,245,497,CHENNAI-KADAPA,742,All
2020,9,CHENNAI,KADAPA,207,341,CHENNAI-KADAPA,548,All
2020,10,CHENNAI,KADAPA,782,908,CHENNAI-KADAPA,1690,All
2020,11,CHENNAI,KADAPA,518,669,CHENNAI-KADAPA,1187,All
2020,12,CHENNAI,KADAPA,1040,968,CHENNAI-KADAPA,2008,All
2021,1,CHENNAI,KADAPA,915,963,CHENNAI-KADAPA,1878,All
2021,2,CHENNAI,KADAPA,822,1034,CHENNAI-KADAPA,1856,All
2021,3,CHENNAI,KADAPA,981,1038,CHENNAI-KADAPA,2019,All
2021,4,CHENNAI,KADAPA,308,395,CHENNAI-KADAPA,703,All
2022,3,CHENNAI,KADAPA,33,93,CHENNAI-KADAPA,126,All
2022,4,CHENNAI,KADAPA,221,356,CHENNAI-KADAPA,577,All
2022,5,CHENNAI,KADAPA,195,368,CHENNAI-KADAPA,563,All
2022,6,CHENNAI,KADAPA,218,318,CHENNAI-KADAPA,536,All
2022,7,CHENNAI,KADAPA,330,376,CHENNAI-KADAPA,706,All
2022,8,CHENNAI,KADAPA,334,328,CHENNAI-KADAPA,662,All
2022,9,CHENNAI,KADAPA,340,392,CHENNAI-KADAPA,732,All
2022,10,CHENNAI,KADAPA,242,444,CHENNAI-KADAPA,686,All
2022,11,CHENNAI,KADAPA,328,464,CHENNAI-KADAPA,792,All
2022,12,CHENNAI,KADAPA,350,363,CHENNAI-KADAPA,713,All
2023,2,CHENNAI,KADAPA,502,697,CHENNAI-KADAPA,1199,All
2023,3,CHENNAI,KADAPA,692,714,CHENNAI-KADAPA,1406,All
2023,4,CHENNAI,KADAPA,427,592,CHENNAI-KADAPA,1019,All
2023,5,CHENNAI,KADAPA,464,795,CHENNAI-KADAPA,1259,All
2019,5,CHENNAI,KANNUR,4235,3745,CHENNAI-KANNUR,7980,All
2019,6,CHENNAI,KANNUR,3344,3289,CHENNAI-KANNUR,6633,All
2019,7,CHENNAI,KANNUR,3441,2815,CHENNAI-KANNUR,6256,All
2019,8,CHENNAI,KANNUR,4188,3531,CHENNAI-KANNUR,7719,All
2019,9,CHENNAI,KANNUR,3664,3251,CHENNAI-KANNUR,6915,All
2019,10,CHENNAI,KANNUR,3491,3269,CHENNAI-KANNUR,6760,All
2019,11,CHENNAI,KANNUR,3400,2798,CHENNAI-KANNUR,6198,All
2019,12,CHENNAI,KANNUR,2134,2073,CHENNAI-KANNUR,4207,All
2020,1,CHENNAI,KANNUR,2103,2249,CHENNAI-KANNUR,4352,All
2020,2,CHENNAI,KANNUR,1971,1958,CHENNAI-KANNUR,3929,All
2020,3,CHENNAI,KANNUR,1380,1146,CHENNAI-KANNUR,2526,All
2020,9,CHENNAI,KANNUR,656,719,CHENNAI-KANNUR,1375,All
2020,10,CHENNAI,KANNUR,604,593,CHENNAI-KANNUR,1197,All
2020,11,CHENNAI,KANNUR,837,757,CHENNAI-KANNUR,1594,All
2020,12,CHENNAI,KANNUR,1073,857,CHENNAI-KANNUR,1930,All
2021,1,CHENNAI,KANNUR,966,1132,CHENNAI-KANNUR,2098,All
2021,2,CHENNAI,KANNUR,880,1043,CHENNAI-KANNUR,1923,All
2021,3,CHENNAI,KANNUR,978,1123,CHENNAI-KANNUR,2101,All
2021,4,CHENNAI,KANNUR,2070,1417,CHENNAI-KANNUR,3487,All
2021,6,CHENNAI,KANNUR,966,1049,CHENNAI-KANNUR,2015,All
2021,7,CHENNAI,KANNUR,1356,1653,CHENNAI-KANNUR,3009,All
2021,8,CHENNAI,KANNUR,1830,1472,CHENNAI-KANNUR,3302,All
2021,9,CHENNAI,KANNUR,1666,1388,CHENNAI-KANNUR,3054,All
2021,10,CHENNAI,KANNUR,2142,1646,CHENNAI-KANNUR,3788,All
2021,11,CHENNAI,KANNUR,2058,1451,CHENNAI-KANNUR,3509,All
2021,12,CHENNAI,KANNUR,2217,1935,CHENNAI-KANNUR,4152,All
2022,1,CHENNAI,KANNUR,1396,1357,CHENNAI-KANNUR,2753,All
2022,2,CHENNAI,KANNUR,1030,1077,CHENNAI-KANNUR,2107,All
2022,3,CHENNAI,KANNUR,2051,1864,CHENNAI-KANNUR,3915,All
2022,4,CHENNAI,KANNUR,2163,1993,CHENNAI-KANNUR,4156,All
2022,5,CHENNAI,KANNUR,2297,2196,CHENNAI-KANNUR,4493,All
2022,6,CHENNAI,KANNUR,2086,1897,CHENNAI-KANNUR,3983,All
2022,7,CHENNAI,KANNUR,2104,1946,CHENNAI-KANNUR,4050,All
2022,8,CHENNAI,KANNUR,2096,1766,CHENNAI-KANNUR,3862,All
2022,9,CHENNAI,KANNUR,1633,1515,CHENNAI-KANNUR,3148,All
2022,10,CHENNAI,KANNUR,1608,1732,CHENNAI-KANNUR,3340,All
2022,11,CHENNAI,KANNUR,1626,1499,CHENNAI-KANNUR,3125,All
2022,12,CHENNAI,KANNUR,1998,1436,CHENNAI-KANNUR,3434,All
2023,1,CHENNAI,KANNUR,1725,1774,CHENNAI-KANNUR,3499,All
2023,2,CHENNAI,KANNUR,1836,1382,CHENNAI-KANNUR,3218,All
2023,3,CHENNAI,KANNUR,2012,1912,CHENNAI-KANNUR,3924,All
2023,4,CHENNAI,KANNUR,2058,2113,CHENNAI-KANNUR,4171,All
2023,5,CHENNAI,KANNUR,2243,2225,CHENNAI-KANNUR,4468,All
2023,6,CHENNAI,KANNUR,2089,1817,CHENNAI-KANNUR,3906,All
2023,7,CHENNAI,KANNUR,2170,1821,CHENNAI-KANNUR,3991,All
2023,8,CHENNAI,KANNUR,2211,1983,CHENNAI-KANNUR,4194,All
2023,9,CHENNAI,KANNUR,1830,1758,CHENNAI-KANNUR,3588,All
2023,10,CHENNAI,KANNUR,1746,1655,CHENNAI-KANNUR,3401,All
2023,11,CHENNAI,KANNUR,1755,1928,CHENNAI-KANNUR,3683,All
2023,12,CHENNAI,KANNUR,1936,1574,CHENNAI-KANNUR,3510,All
2024,1,CHENNAI,KANNUR,1843,2042,CHENNAI-KANNUR,3885,All
2024,2,CHENNAI,KANNUR,1593,1587,CHENNAI-KANNUR,3180,All
2024,3,CHENNAI,KANNUR,1572,1584,CHENNAI-KANNUR,3156,All
2024,4,CHENNAI,KANNUR,1935,1815,CHENNAI-KANNUR,3750,All
2024,6,CHENNAI,KANNUR,3307,3307,CHENNAI-KANNUR,6614,All
2024,7,CHENNAI,KANNUR,3807,3035,CHENNAI-KANNUR,6842,All
2024,8,CHENNAI,KANNUR,3770,3603,CHENNAI-KANNUR,7373,All
2024,9,CHENNAI,KANNUR,3371,3490,CHENNAI-KANNUR,6861,All
2024,10,CHENNAI,KANNUR,2887,3140,CHENNAI-KANNUR,6027,All
2024,11,CHENNAI,KANNUR,3715,2862,CHENNAI-KANNUR,6577,All
2024,12,CHENNAI,KANNUR,4434,3460,CHENNAI-KANNUR,7894,All
2025,1,CHENNAI,KANNUR,3029,3756,CHENNAI-KANNUR,6785,All
2025,2,CHENNAI,KANNUR,3133,3122,CHENNAI-KANNUR,6255,All
2025,3,CHENNAI,KANNUR,2273,1882,CHENNAI-KANNUR,4155,All
2021,11,CHENNAI,KANPUR,190,288,CHENNAI-KANPUR,478,All
2022,10,CHENNAI,KANPUR,0,1,CHENNAI-KANPUR,1,All
2022,11,CHENNAI,KANPUR,43,70,CHENNAI-KANPUR,113,All
2022,12,CHENNAI,KANPUR,105,164,CHENNAI-KANPUR,269,All
2023,1,CHENNAI,KANPUR,87,63,CHENNAI-KANPUR,150,All
2023,2,CHENNAI,KANPUR,187,29,CHENNAI-KANPUR,216,All
2023,3,CHENNAI,KANPUR,163,87,CHENNAI-KANPUR,250,All
2023,4,CHENNAI,KANPUR,144,59,CHENNAI-KANPUR,203,All
2023,5,CHENNAI,KANPUR,189,90,CHENNAI-KANPUR,279,All
2023,6,CHENNAI,KANPUR,190,87,CHENNAI-KANPUR,277,All
2023,7,CHENNAI,KANPUR,193,92,CHENNAI-KANPUR,285,All
2023,8,CHENNAI,KANPUR,291,95,CHENNAI-KANPUR,386,All
2023,9,CHENNAI,KANPUR,260,78,CHENNAI-KANPUR,338,All
2023,10,CHENNAI,KANPUR,217,205,CHENNAI-KANPUR,422,All
2023,11,CHENNAI,KANPUR,217,179,CHENNAI-KANPUR,396,All
2023,12,CHENNAI,KANPUR,209,251,CHENNAI-KANPUR,460,All
2024,1,CHENNAI,KANPUR,4,8,CHENNAI-KANPUR,12,All
2024,10,CHENNAI,KANPUR,2,14,CHENNAI-KANPUR,16,All
2024,11,CHENNAI,KANPUR,66,21,CHENNAI-KANPUR,87,All
2024,12,CHENNAI,KANPUR,79,63,CHENNAI-KANPUR,142,All
2019,5,CHENNAI,KOCHI,33686,29416,CHENNAI-KOCHI,63102,All
2019,6,CHENNAI,KOCHI,31638,30342,CHENNAI-KOCHI,61980,All
2019,7,CHENNAI,KOCHI,34060,32291,CHENNAI-KOCHI,66351,All
2019,8,CHENNAI,KOCHI,29161,26474,CHENNAI-KOCHI,55635,All
2019,9,CHENNAI,KOCHI,31364,29782,CHENNAI-KOCHI,61146,All
2019,10,CHENNAI,KOCHI,29035,28621,CHENNAI-KOCHI,57656,All
2019,11,CHENNAI,KOCHI,29551,28542,CHENNAI-KOCHI,58093,All
2019,12,CHENNAI,KOCHI,28098,28486,CHENNAI-KOCHI,56584,All
2020,1,CHENNAI,KOCHI,27907,30565,CHENNAI-KOCHI,58472,All
2020,2,CHENNAI,KOCHI,23768,25924,CHENNAI-KOCHI,49692,All
2020,3,CHENNAI,KOCHI,12556,12787,CHENNAI-KOCHI,25343,All
2020,5,CHENNAI,KOCHI,459,174,CHENNAI-KOCHI,633,All
2020,6,CHENNAI,KOCHI,3064,2155,CHENNAI-KOCHI,5219,All
2020,7,CHENNAI,KOCHI,1407,2224,CHENNAI-KOCHI,3631,All
2020,8,CHENNAI,KOCHI,1580,2665,CHENNAI-KOCHI,4245,All
2020,9,CHENNAI,KOCHI,3704,3891,CHENNAI-KOCHI,7595,All
2020,10,CHENNAI,KOCHI,5563,3994,CHENNAI-KOCHI,9557,All
2020,11,CHENNAI,KOCHI,7795,5559,CHENNAI-KOCHI,13354,All
2020,12,CHENNAI,KOCHI,10325,7333,CHENNAI-KOCHI,17658,All
2021,1,CHENNAI,KOCHI,11031,8371,CHENNAI-KOCHI,19402,All
2021,2,CHENNAI,KOCHI,9143,9860,CHENNAI-KOCHI,19003,All
2021,3,CHENNAI,KOCHI,6678,8344,CHENNAI-KOCHI,15022,All
2021,4,CHENNAI,KOCHI,9996,8405,CHENNAI-KOCHI,18401,All
2021,6,CHENNAI,KOCHI,2569,2751,CHENNAI-KOCHI,5320,All
2021,7,CHENNAI,KOCHI,4454,4800,CHENNAI-KOCHI,9254,All
2021,8,CHENNAI,KOCHI,6498,5240,CHENNAI-KOCHI,11738,All
2021,9,CHENNAI,KOCHI,6015,6752,CHENNAI-KOCHI,12767,All
2021,10,CHENNAI,KOCHI,7060,8510,CHENNAI-KOCHI,15570,All
2021,11,CHENNAI,KOCHI,11475,10967,CHENNAI-KOCHI,22442,All
2021,12,CHENNAI,KOCHI,18108,17136,CHENNAI-KOCHI,35244,All
2022,1,CHENNAI,KOCHI,8706,10043,CHENNAI-KOCHI,18749,All
2022,2,CHENNAI,KOCHI,8649,9128,CHENNAI-KOCHI,17777,All
2022,3,CHENNAI,KOCHI,14905,15078,CHENNAI-KOCHI,29983,All
2022,4,CHENNAI,KOCHI,18435,18381,CHENNAI-KOCHI,36816,All
2022,5,CHENNAI,KOCHI,21462,20870,CHENNAI-KOCHI,42332,All
2022,6,CHENNAI,KOCHI,18983,19362,CHENNAI-KOCHI,38345,All
2022,7,CHENNAI,KOCHI,17849,17476,CHENNAI-KOCHI,35325,All
2022,8,CHENNAI,KOCHI,18763,17274,CHENNAI-KOCHI,36037,All
2022,9,CHENNAI,KOCHI,19690,19345,CHENNAI-KOCHI,39035,All
2022,10,CHENNAI,KOCHI,20467,21498,CHENNAI-KOCHI,41965,All
2022,11,CHENNAI,KOCHI,25657,26700,CHENNAI-KOCHI,52357,All
2022,12,CHENNAI,KOCHI,28287,25264,CHENNAI-KOCHI,53551,All
2023,1,CHENNAI,KOCHI,24822,25131,CHENNAI-KOCHI,49953,All
2023,2,CHENNAI,KOCHI,24532,24215,CHENNAI-KOCHI,48747,All
2023,3,CHENNAI,KOCHI,24738,24840,CHENNAI-KOCHI,49578,All
2023,4,CHENNAI,KOCHI,21255,21242,CHENNAI-KOCHI,42497,All
2023,5,CHENNAI,KOCHI,25743,24771,CHENNAI-KOCHI,50514,All
2023,6,CHENNAI,KOCHI,22183,23242,CHENNAI-KOCHI,45425,All
2023,7,CHENNAI,KOCHI,25087,23839,CHENNAI-KOCHI,48926,All
2023,8,CHENNAI,KOCHI,26125,25245,CHENNAI-KOCHI,51370,All
2023,9,CHENNAI,KOCHI,22559,22757,CHENNAI-KOCHI,45316,All
2023,10,CHENNAI,KOCHI,20575,21756,CHENNAI-KOCHI,42331,All
2023,11,CHENNAI,KOCHI,22862,22914,CHENNAI-KOCHI,45776,All
2023,12,CHENNAI,KOCHI,24398,22543,CHENNAI-KOCHI,46941,All
2024,1,CHENNAI,KOCHI,23572,25639,CHENNAI-KOCHI,49211,All
2024,2,CHENNAI,KOCHI,21303,22883,CHENNAI-KOCHI,44186,All
2024,3,CHENNAI,KOCHI,21705,22906,CHENNAI-KOCHI,44611,All
2024,4,CHENNAI,KOCHI,22784,23334,CHENNAI-KOCHI,46118,All
2024,6,CHENNAI,KOCHI,21350,24994,CHENNAI-KOCHI,46344,All
2024,7,CHENNAI,KOCHI,24198,23492,CHENNAI-KOCHI,47690,All
2024,8,CHENNAI,KOCHI,25488,26118,CHENNAI-KOCHI,51606,All
2024,9,CHENNAI,KOCHI,26097,28272,CHENNAI-KOCHI,54369,All
2024,10,CHENNAI,KOCHI,28747,29926,CHENNAI-KOCHI,58673,All
2024,11,CHENNAI,KOCHI,32946,31440,CHENNAI-KOCHI,64386,All
2024,12,CHENNAI,KOCHI,35369,33057,CHENNAI-KOCHI,68426,All
2025,1,CHENNAI,KOCHI,32157,36445,CHENNAI-KOCHI,68602,All
2025,2,CHENNAI,KOCHI,27933,28378,CHENNAI-KOCHI,56311,All
2025,3,CHENNAI,KOCHI,27977,28577,CHENNAI-KOCHI,56554,All
2022,5,CHENNAI,KOLHAPUR,0,4,CHENNAI-KOLHAPUR,4,All
2019,5,CHENNAI,KOLKATA,46799,45928,CHENNAI-KOLKATA,92727,All
2019,6,CHENNAI,KOLKATA,54347,55773,CHENNAI-KOLKATA,110120,All
2019,7,CHENNAI,KOLKATA,56730,57303,CHENNAI-KOLKATA,114033,All
2019,8,CHENNAI,KOLKATA,57959,56623,CHENNAI-KOLKATA,114582,All
2019,9,CHENNAI,KOLKATA,61906,58732,CHENNAI-KOLKATA,120638,All
2019,10,CHENNAI,KOLKATA,67643,62004,CHENNAI-KOLKATA,129647,All
2019,11,CHENNAI,KOLKATA,61753,59383,CHENNAI-KOLKATA,121136,All
2019,12,CHENNAI,KOLKATA,66032,61624,CHENNAI-KOLKATA,127656,All
2020,1,CHENNAI,KOLKATA,63778,60992,CHENNAI-KOLKATA,124770,All
2020,2,CHENNAI,KOLKATA,62423,56559,CHENNAI-KOLKATA,118982,All
2020,3,CHENNAI,KOLKATA,49270,33803,CHENNAI-KOLKATA,83073,All
2020,5,CHENNAI,KOLKATA,624,336,CHENNAI-KOLKATA,960,All
2020,6,CHENNAI,KOLKATA,19333,5780,CHENNAI-KOLKATA,25113,All
2020,7,CHENNAI,KOLKATA,4175,1585,CHENNAI-KOLKATA,5760,All
2020,8,CHENNAI,KOLKATA,0,2116,CHENNAI-KOLKATA,2116,All
2020,9,CHENNAI,KOLKATA,11267,19499,CHENNAI-KOLKATA,30766,All
2020,10,CHENNAI,KOLKATA,16583,23611,CHENNAI-KOLKATA,40194,All
2020,11,CHENNAI,KOLKATA,17589,22982,CHENNAI-KOLKATA,40571,All
2020,12,CHENNAI,KOLKATA,19687,24706,CHENNAI-KOLKATA,44393,All
2021,1,CHENNAI,KOLKATA,21040,27057,CHENNAI-KOLKATA,48097,All
2021,2,CHENNAI,KOLKATA,22499,28323,CHENNAI-KOLKATA,50822,All
2021,3,CHENNAI,KOLKATA,27514,28424,CHENNAI-KOLKATA,55938,All
2021,4,CHENNAI,KOLKATA,14845,13488,CHENNAI-KOLKATA,28333,All
2021,6,CHENNAI,KOLKATA,6058,10722,CHENNAI-KOLKATA,16780,All
2021,7,CHENNAI,KOLKATA,12779,16876,CHENNAI-KOLKATA,29655,All
2021,8,CHENNAI,KOLKATA,17215,28700,CHENNAI-KOLKATA,45915,All
2021,9,CHENNAI,KOLKATA,21236,26665,CHENNAI-KOLKATA,47901,All
2021,10,CHENNAI,KOLKATA,29477,29465,CHENNAI-KOLKATA,58942,All
2021,11,CHENNAI,KOLKATA,34723,33042,CHENNAI-KOLKATA,67765,All
2021,12,CHENNAI,KOLKATA,45272,44424,CHENNAI-KOLKATA,89696,All
2022,1,CHENNAI,KOLKATA,31171,25953,CHENNAI-KOLKATA,57124,All
2022,2,CHENNAI,KOLKATA,29696,27883,CHENNAI-KOLKATA,57579,All
2022,3,CHENNAI,KOLKATA,38687,38581,CHENNAI-KOLKATA,77268,All
2022,4,CHENNAI,KOLKATA,47473,39681,CHENNAI-KOLKATA,87154,All
2022,5,CHENNAI,KOLKATA,45043,47135,CHENNAI-KOLKATA,92178,All
2022,6,CHENNAI,KOLKATA,41061,38948,CHENNAI-KOLKATA,80009,All
2022,7,CHENNAI,KOLKATA,37647,35476,CHENNAI-KOLKATA,73123,All
2022,8,CHENNAI,KOLKATA,34390,37249,CHENNAI-KOLKATA,71639,All
2022,9,CHENNAI,KOLKATA,32680,31216,CHENNAI-KOLKATA,63896,All
2022,10,CHENNAI,KOLKATA,35398,32361,CHENNAI-KOLKATA,67759,All
2022,11,CHENNAI,KOLKATA,28968,29595,CHENNAI-KOLKATA,58563,All
2022,12,CHENNAI,KOLKATA,32425,32224,CHENNAI-KOLKATA,64649,All
2023,1,CHENNAI,KOLKATA,33725,34897,CHENNAI-KOLKATA,68622,All
2023,2,CHENNAI,KOLKATA,30667,30396,CHENNAI-KOLKATA,61063,All
2023,3,CHENNAI,KOLKATA,40325,38586,CHENNAI-KOLKATA,78911,All
2023,4,CHENNAI,KOLKATA,37308,31405,CHENNAI-KOLKATA,68713,All
2023,5,CHENNAI,KOLKATA,35790,37343,CHENNAI-KOLKATA,73133,All
2023,6,CHENNAI,KOLKATA,34888,34029,CHENNAI-KOLKATA,68917,All
2023,7,CHENNAI,KOLKATA,34106,37115,CHENNAI-KOLKATA,71221,All
2023,8,CHENNAI,KOLKATA,38176,36820,CHENNAI-KOLKATA,74996,All
2023,9,CHENNAI,KOLKATA,33501,32775,CHENNAI-KOLKATA,66276,All
2023,10,CHENNAI,KOLKATA,35842,32524,CHENNAI-KOLKATA,68366,All
2023,11,CHENNAI,KOLKATA,34782,32196,CHENNAI-KOLKATA,66978,All
2023,12,CHENNAI,KOLKATA,35038,36064,CHENNAI-KOLKATA,71102,All
2024,1,CHENNAI,KOLKATA,32088,32124,CHENNAI-KOLKATA,64212,All
2024,2,CHENNAI,KOLKATA,32266,30847,CHENNAI-KOLKATA,63113,All
2024,3,CHENNAI,KOLKATA,44472,37725,CHENNAI-KOLKATA,82197,All
2024,4,CHENNAI,KOLKATA,46559,36085,CHENNAI-KOLKATA,82644,All
2024,6,CHENNAI,KOLKATA,46624,46039,CHENNAI-KOLKATA,92663,All
2024,7,CHENNAI,KOLKATA,41965,46331,CHENNAI-KOLKATA,88296,All
2024,8,CHENNAI,KOLKATA,43546,43554,CHENNAI-KOLKATA,87100,All
2024,9,CHENNAI,KOLKATA,49351,42430,CHENNAI-KOLKATA,91781,All
2024,10,CHENNAI,KOLKATA,52942,46421,CHENNAI-KOLKATA,99363,All
2024,11,CHENNAI,KOLKATA,40000,38960,CHENNAI-KOLKATA,78960,All
2024,12,CHENNAI,KOLKATA,45382,43726,CHENNAI-KOLKATA,89108,All
2025,1,CHENNAI,KOLKATA,44780,43590,CHENNAI-KOLKATA,88370,All
2025,2,CHENNAI,KOLKATA,39340,38059,CHENNAI-KOLKATA,77399,All
2025,3,CHENNAI,KOLKATA,42789,40161,CHENNAI-KOLKATA,82950,All
2019,5,CHENNAI,KOZHIKODE,5962,5692,CHENNAI-KOZHIKODE,11654,All
2019,6,CHENNAI,KOZHIKODE,5404,5400,CHENNAI-KOZHIKODE,10804,All
2019,7,CHENNAI,KOZHIKODE,4896,4300,CHENNAI-KOZHIKODE,9196,All
2019,8,CHENNAI,KOZHIKODE,4226,3973,CHENNAI-KOZHIKODE,8199,All
2019,9,CHENNAI,KOZHIKODE,3559,3377,CHENNAI-KOZHIKODE,6936,All
2019,10,CHENNAI,KOZHIKODE,3230,3499,CHENNAI-KOZHIKODE,6729,All
2019,11,CHENNAI,KOZHIKODE,3938,3792,CHENNAI-KOZHIKODE,7730,All
2019,12,CHENNAI,KOZHIKODE,4328,4078,CHENNAI-KOZHIKODE,8406,All
2020,1,CHENNAI,KOZHIKODE,4416,4339,CHENNAI-KOZHIKODE,8755,All
2020,2,CHENNAI,KOZHIKODE,3976,3626,CHENNAI-KOZHIKODE,7602,All
2020,3,CHENNAI,KOZHIKODE,2544,2455,CHENNAI-KOZHIKODE,4999,All
2020,5,CHENNAI,KOZHIKODE,0,0,CHENNAI-KOZHIKODE,0,All
2020,6,CHENNAI,KOZHIKODE,0,0,CHENNAI-KOZHIKODE,0,All
2020,8,CHENNAI,KOZHIKODE,159,212,CHENNAI-KOZHIKODE,371,All
2020,9,CHENNAI,KOZHIKODE,882,539,CHENNAI-KOZHIKODE,1421,All
2020,10,CHENNAI,KOZHIKODE,1066,706,CHENNAI-KOZHIKODE,1772,All
2020,11,CHENNAI,KOZHIKODE,776,1379,CHENNAI-KOZHIKODE,2155,All
2020,12,CHENNAI,KOZHIKODE,1299,1595,CHENNAI-KOZHIKODE,2894,All
2021,1,CHENNAI,KOZHIKODE,1181,1803,CHENNAI-KOZHIKODE,2984,All
2021,2,CHENNAI,KOZHIKODE,1064,1680,CHENNAI-KOZHIKODE,2744,All
2021,3,CHENNAI,KOZHIKODE,1339,1664,CHENNAI-KOZHIKODE,3003,All
2021,4,CHENNAI,KOZHIKODE,1919,1888,CHENNAI-KOZHIKODE,3807,All
2021,6,CHENNAI,KOZHIKODE,149,517,CHENNAI-KOZHIKODE,666,All
2021,7,CHENNAI,KOZHIKODE,708,1102,CHENNAI-KOZHIKODE,1810,All
2021,8,CHENNAI,KOZHIKODE,326,399,CHENNAI-KOZHIKODE,725,All
2021,9,CHENNAI,KOZHIKODE,299,207,CHENNAI-KOZHIKODE,506,All
2021,10,CHENNAI,KOZHIKODE,854,771,CHENNAI-KOZHIKODE,1625,All
2021,11,CHENNAI,KOZHIKODE,1467,1716,CHENNAI-KOZHIKODE,3183,All
2021,12,CHENNAI,KOZHIKODE,1940,1873,CHENNAI-KOZHIKODE,3813,All
2022,1,CHENNAI,KOZHIKODE,1031,1316,CHENNAI-KOZHIKODE,2347,All
2022,2,CHENNAI,KOZHIKODE,755,832,CHENNAI-KOZHIKODE,1587,All
2022,3,CHENNAI,KOZHIKODE,1897,1946,CHENNAI-KOZHIKODE,3843,All
2022,4,CHENNAI,KOZHIKODE,1935,2165,CHENNAI-KOZHIKODE,4100,All
2022,5,CHENNAI,KOZHIKODE,2137,2218,CHENNAI-KOZHIKODE,4355,All
2022,6,CHENNAI,KOZHIKODE,1690,1882,CHENNAI-KOZHIKODE,3572,All
2022,7,CHENNAI,KOZHIKODE,1963,2019,CHENNAI-KOZHIKODE,3982,All
2022,8,CHENNAI,KOZHIKODE,2067,1962,CHENNAI-KOZHIKODE,4029,All
2022,9,CHENNAI,KOZHIKODE,1941,1846,CHENNAI-KOZHIKODE,3787,All
2022,10,CHENNAI,KOZHIKODE,2159,2193,CHENNAI-KOZHIKODE,4352,All
2022,11,CHENNAI,KOZHIKODE,2830,3066,CHENNAI-KOZHIKODE,5896,All
2022,12,CHENNAI,KOZHIKODE,3881,3001,CHENNAI-KOZHIKODE,6882,All
2023,1,CHENNAI,KOZHIKODE,3285,3652,CHENNAI-KOZHIKODE,6937,All
2023,2,CHENNAI,KOZHIKODE,3282,3345,CHENNAI-KOZHIKODE,6627,All
2023,3,CHENNAI,KOZHIKODE,3890,3887,CHENNAI-KOZHIKODE,7777,All
2023,4,CHENNAI,KOZHIKODE,3914,4039,CHENNAI-KOZHIKODE,7953,All
2023,5,CHENNAI,KOZHIKODE,4436,4275,CHENNAI-KOZHIKODE,8711,All
2023,6,CHENNAI,KOZHIKODE,4088,3912,CHENNAI-KOZHIKODE,8000,All
2023,7,CHENNAI,KOZHIKODE,2659,2523,CHENNAI-KOZHIKODE,5182,All
2023,8,CHENNAI,KOZHIKODE,3292,3224,CHENNAI-KOZHIKODE,6516,All
2023,9,CHENNAI,KOZHIKODE,3639,3672,CHENNAI-KOZHIKODE,7311,All
2023,10,CHENNAI,KOZHIKODE,3360,3519,CHENNAI-KOZHIKODE,6879,All
2023,11,CHENNAI,KOZHIKODE,3297,3235,CHENNAI-KOZHIKODE,6532,All
2023,12,CHENNAI,KOZHIKODE,3577,3247,CHENNAI-KOZHIKODE,6824,All
2024,1,CHENNAI,KOZHIKODE,3802,4143,CHENNAI-KOZHIKODE,7945,All
2024,2,CHENNAI,KOZHIKODE,3592,3570,CHENNAI-KOZHIKODE,7162,All
2024,3,CHENNAI,KOZHIKODE,3249,3634,CHENNAI-KOZHIKODE,6883,All
2024,4,CHENNAI,KOZHIKODE,4058,3997,CHENNAI-KOZHIKODE,8055,All
2024,6,CHENNAI,KOZHIKODE,3855,3861,CHENNAI-KOZHIKODE,7716,All
2024,7,CHENNAI,KOZHIKODE,4382,3608,CHENNAI-KOZHIKODE,7990,All
2024,8,CHENNAI,KOZHIKODE,3987,3640,CHENNAI-KOZHIKODE,7627,All
2024,9,CHENNAI,KOZHIKODE,3847,3781,CHENNAI-KOZHIKODE,7628,All
2024,10,CHENNAI,KOZHIKODE,3560,3483,CHENNAI-KOZHIKODE,7043,All
2024,11,CHENNAI,KOZHIKODE,3560,3477,CHENNAI-KOZHIKODE,7037,All
2024,12,CHENNAI,KOZHIKODE,4021,3670,CHENNAI-KOZHIKODE,7691,All
2025,1,CHENNAI,KOZHIKODE,3940,4138,CHENNAI-KOZHIKODE,8078,All
2025,2,CHENNAI,KOZHIKODE,3733,3655,CHENNAI-KOZHIKODE,7388,All
2025,3,CHENNAI,KOZHIKODE,3626,3144,CHENNAI-KOZHIKODE,6770,All
2021,3,CHENNAI,KURNOOL,32,46,CHENNAI-KURNOOL,78,All
2021,4,CHENNAI,KURNOOL,228,175,CHENNAI-KURNOOL,403,All
2021,6,CHENNAI,KURNOOL,199,171,CHENNAI-KURNOOL,370,All
2021,7,CHENNAI,KURNOOL,320,277,CHENNAI-KURNOOL,597,All
2021,8,CHENNAI,KURNOOL,383,289,CHENNAI-KURNOOL,672,All
2021,9,CHENNAI,KURNOOL,311,306,CHENNAI-KURNOOL,617,All
2021,10,CHENNAI,KURNOOL,379,374,CHENNAI-KURNOOL,753,All
2021,11,CHENNAI,KURNOOL,369,347,CHENNAI-KURNOOL,716,All
2021,12,CHENNAI,KURNOOL,380,390,CHENNAI-KURNOOL,770,All
2022,1,CHENNAI,KURNOOL,223,252,CHENNAI-KURNOOL,475,All
2022,2,CHENNAI,KURNOOL,286,323,CHENNAI-KURNOOL,609,All
2022,3,CHENNAI,KURNOOL,450,551,CHENNAI-KURNOOL,1001,All
2022,4,CHENNAI,KURNOOL,581,606,CHENNAI-KURNOOL,1187,All
2022,5,CHENNAI,KURNOOL,689,713,CHENNAI-KURNOOL,1402,All
2022,6,CHENNAI,KURNOOL,639,721,CHENNAI-KURNOOL,1360,All
2022,7,CHENNAI,KURNOOL,369,386,CHENNAI-KURNOOL,755,All
2022,8,CHENNAI,KURNOOL,425,461,CHENNAI-KURNOOL,886,All
2022,9,CHENNAI,KURNOOL,376,348,CHENNAI-KURNOOL,724,All
2022,10,CHENNAI,KURNOOL,446,418,CHENNAI-KURNOOL,864,All
2022,11,CHENNAI,KURNOOL,288,276,CHENNAI-KURNOOL,564,All
2022,12,CHENNAI,KURNOOL,395,344,CHENNAI-KURNOOL,739,All
2023,1,CHENNAI,KURNOOL,336,412,CHENNAI-KURNOOL,748,All
2023,2,CHENNAI,KURNOOL,458,394,CHENNAI-KURNOOL,852,All
2023,3,CHENNAI,KURNOOL,457,449,CHENNAI-KURNOOL,906,All
2023,4,CHENNAI,KURNOOL,537,580,CHENNAI-KURNOOL,1117,All
2023,5,CHENNAI,KURNOOL,608,894,CHENNAI-KURNOOL,1502,All
2023,6,CHENNAI,KURNOOL,619,560,CHENNAI-KURNOOL,1179,All
2023,7,CHENNAI,KURNOOL,550,568,CHENNAI-KURNOOL,1118,All
2023,8,CHENNAI,KURNOOL,635,629,CHENNAI-KURNOOL,1264,All
2023,9,CHENNAI,KURNOOL,576,526,CHENNAI-KURNOOL,1102,All
2023,10,CHENNAI,KURNOOL,507,440,CHENNAI-KURNOOL,947,All
2023,11,CHENNAI,KURNOOL,370,281,CHENNAI-KURNOOL,651,All
2023,12,CHENNAI,KURNOOL,522,348,CHENNAI-KURNOOL,870,All
2024,1,CHENNAI,KURNOOL,409,412,CHENNAI-KURNOOL,821,All
2024,2,CHENNAI,KURNOOL,340,327,CHENNAI-KURNOOL,667,All
2024,3,CHENNAI,KURNOOL,297,308,CHENNAI-KURNOOL,605,All
2024,4,CHENNAI,KURNOOL,228,259,CHENNAI-KURNOOL,487,All
2024,6,CHENNAI,KURNOOL,276,211,CHENNAI-KURNOOL,487,All
2024,7,CHENNAI,KURNOOL,295,301,CHENNAI-KURNOOL,596,All
2024,8,CHENNAI,KURNOOL,351,319,CHENNAI-KURNOOL,670,All
2024,9,CHENNAI,KURNOOL,304,237,CHENNAI-KURNOOL,541,All
2024,10,CHENNAI,KURNOOL,331,320,CHENNAI-KURNOOL,651,All
2024,11,CHENNAI,KURNOOL,352,299,CHENNAI-KURNOOL,651,All
2024,12,CHENNAI,KURNOOL,449,286,CHENNAI-KURNOOL,735,All
2025,1,CHENNAI,KURNOOL,481,448,CHENNAI-KURNOOL,929,All
2025,2,CHENNAI,KURNOOL,422,335,CHENNAI-KURNOOL,757,All
2025,3,CHENNAI,KURNOOL,355,261,CHENNAI-KURNOOL,616,All
2021,8,CHENNAI,LEH,0,7,CHENNAI-LEH,7,All
2021,9,CHENNAI,LEH,0,56,CHENNAI-LEH,56,All
2019,5,CHENNAI,LUCKNOW,5319,5606,CHENNAI-LUCKNOW,10925,All
2019,6,CHENNAI,LUCKNOW,4989,5818,CHENNAI-LUCKNOW,10807,All
2019,7,CHENNAI,LUCKNOW,2920,3918,CHENNAI-LUCKNOW,6838,All
2019,8,CHENNAI,LUCKNOW,5064,4461,CHENNAI-LUCKNOW,9525,All
2019,9,CHENNAI,LUCKNOW,4878,3771,CHENNAI-LUCKNOW,8649,All
2019,10,CHENNAI,LUCKNOW,5338,4335,CHENNAI-LUCKNOW,9673,All
2019,11,CHENNAI,LUCKNOW,5175,4851,CHENNAI-LUCKNOW,10026,All
2019,12,CHENNAI,LUCKNOW,2739,2360,CHENNAI-LUCKNOW,5099,All
2020,1,CHENNAI,LUCKNOW,2148,1986,CHENNAI-LUCKNOW,4134,All
2020,2,CHENNAI,LUCKNOW,5443,4580,CHENNAI-LUCKNOW,10023,All
2020,3,CHENNAI,LUCKNOW,4369,3245,CHENNAI-LUCKNOW,7614,All
2020,7,CHENNAI,LUCKNOW,267,410,CHENNAI-LUCKNOW,677,All
2020,8,CHENNAI,LUCKNOW,911,1676,CHENNAI-LUCKNOW,2587,All
2020,9,CHENNAI,LUCKNOW,1768,3458,CHENNAI-LUCKNOW,5226,All
2020,10,CHENNAI,LUCKNOW,2353,3154,CHENNAI-LUCKNOW,5507,All
2020,11,CHENNAI,LUCKNOW,4246,2937,CHENNAI-LUCKNOW,7183,All
2020,12,CHENNAI,LUCKNOW,3413,4753,CHENNAI-LUCKNOW,8166,All
2021,1,CHENNAI,LUCKNOW,3252,3586,CHENNAI-LUCKNOW,6838,All
2021,2,CHENNAI,LUCKNOW,3282,3121,CHENNAI-LUCKNOW,6403,All
2021,3,CHENNAI,LUCKNOW,3388,2358,CHENNAI-LUCKNOW,5746,All
2021,4,CHENNAI,LUCKNOW,3465,2705,CHENNAI-LUCKNOW,6170,All
2021,7,CHENNAI,LUCKNOW,1023,1419,CHENNAI-LUCKNOW,2442,All
2021,8,CHENNAI,LUCKNOW,1435,1657,CHENNAI-LUCKNOW,3092,All
2021,9,CHENNAI,LUCKNOW,1773,1991,CHENNAI-LUCKNOW,3764,All
2021,10,CHENNAI,LUCKNOW,3521,2900,CHENNAI-LUCKNOW,6421,All
2021,11,CHENNAI,LUCKNOW,3853,3481,CHENNAI-LUCKNOW,7334,All
2021,12,CHENNAI,LUCKNOW,3414,4287,CHENNAI-LUCKNOW,7701,All
2022,1,CHENNAI,LUCKNOW,2757,2339,CHENNAI-LUCKNOW,5096,All
2022,2,CHENNAI,LUCKNOW,1844,1783,CHENNAI-LUCKNOW,3627,All
2022,3,CHENNAI,LUCKNOW,3805,4024,CHENNAI-LUCKNOW,7829,All
2022,4,CHENNAI,LUCKNOW,4165,3870,CHENNAI-LUCKNOW,8035,All
2022,5,CHENNAI,LUCKNOW,3975,4108,CHENNAI-LUCKNOW,8083,All
2022,6,CHENNAI,LUCKNOW,4044,4226,CHENNAI-LUCKNOW,8270,All
2022,7,CHENNAI,LUCKNOW,4262,4416,CHENNAI-LUCKNOW,8678,All
2022,8,CHENNAI,LUCKNOW,4390,4224,CHENNAI-LUCKNOW,8614,All
2022,9,CHENNAI,LUCKNOW,3510,3101,CHENNAI-LUCKNOW,6611,All
2022,10,CHENNAI,LUCKNOW,6375,4514,CHENNAI-LUCKNOW,10889,All
2022,11,CHENNAI,LUCKNOW,3428,3910,CHENNAI-LUCKNOW,7338,All
2022,12,CHENNAI,LUCKNOW,2829,3675,CHENNAI-LUCKNOW,6504,All
2023,1,CHENNAI,LUCKNOW,2779,3096,CHENNAI-LUCKNOW,5875,All
2023,2,CHENNAI,LUCKNOW,3517,3092,CHENNAI-LUCKNOW,6609,All
2023,3,CHENNAI,LUCKNOW,3828,3877,CHENNAI-LUCKNOW,7705,All
2023,4,CHENNAI,LUCKNOW,3712,3164,CHENNAI-LUCKNOW,6876,All
2023,5,CHENNAI,LUCKNOW,3500,3950,CHENNAI-LUCKNOW,7450,All
2023,6,CHENNAI,LUCKNOW,3634,4304,CHENNAI-LUCKNOW,7938,All
2023,7,CHENNAI,LUCKNOW,3741,4233,CHENNAI-LUCKNOW,7974,All
2023,8,CHENNAI,LUCKNOW,4272,4064,CHENNAI-LUCKNOW,8336,All
2023,9,CHENNAI,LUCKNOW,3988,4173,CHENNAI-LUCKNOW,8161,All
2023,10,CHENNAI,LUCKNOW,4605,4271,CHENNAI-LUCKNOW,8876,All
2023,11,CHENNAI,LUCKNOW,4832,4358,CHENNAI-LUCKNOW,9190,All
2023,12,CHENNAI,LUCKNOW,4471,4623,CHENNAI-LUCKNOW,9094,All
2024,1,CHENNAI,LUCKNOW,5923,5906,CHENNAI-LUCKNOW,11829,All
2024,2,CHENNAI,LUCKNOW,5522,5317,CHENNAI-LUCKNOW,10839,All
2024,3,CHENNAI,LUCKNOW,5661,5553,CHENNAI-LUCKNOW,11214,All
2024,4,CHENNAI,LUCKNOW,4653,4304,CHENNAI-LUCKNOW,8957,All
2024,6,CHENNAI,LUCKNOW,4299,4120,CHENNAI-LUCKNOW,8419,All
2024,7,CHENNAI,LUCKNOW,4469,4464,CHENNAI-LUCKNOW,8933,All
2024,8,CHENNAI,LUCKNOW,4731,4432,CHENNAI-LUCKNOW,9163,All
2024,9,CHENNAI,LUCKNOW,4430,4004,CHENNAI-LUCKNOW,8434,All
2024,10,CHENNAI,LUCKNOW,4681,3446,CHENNAI-LUCKNOW,8127,All
2024,11,CHENNAI,LUCKNOW,4406,4189,CHENNAI-LUCKNOW,8595,All
2024,12,CHENNAI,LUCKNOW,4513,4542,CHENNAI-LUCKNOW,9055,All
2025,1,CHENNAI,LUCKNOW,4599,4364,CHENNAI-LUCKNOW,8963,All
2025,2,CHENNAI,LUCKNOW,4558,4287,CHENNAI-LUCKNOW,8845,All
2025,3,CHENNAI,LUCKNOW,4673,4557,CHENNAI-LUCKNOW,9230,All
2019,5,CHENNAI,MADURAI,28741,26372,CHENNAI-MADURAI,55113,All
2019,6,CHENNAI,MADURAI,28384,28644,CHENNAI-MADURAI,57028,All
2019,7,CHENNAI,MADURAI,29478,29832,CHENNAI-MADURAI,59310,All
2019,8,CHENNAI,MADURAI,28615,28127,CHENNAI-MADURAI,56742,All
2019,9,CHENNAI,MADURAI,27546,27369,CHENNAI-MADURAI,54915,All
2019,10,CHENNAI,MADURAI,26245,24121,CHENNAI-MADURAI,50366,All
2019,11,CHENNAI,MADURAI,25835,25459,CHENNAI-MADURAI,51294,All
2019,12,CHENNAI,MADURAI,25050,23913,CHENNAI-MADURAI,48963,All
2020,1,CHENNAI,MADURAI,26345,26621,CHENNAI-MADURAI,52966,All
2020,2,CHENNAI,MADURAI,25952,25001,CHENNAI-MADURAI,50953,All
2020,3,CHENNAI,MADURAI,15638,15387,CHENNAI-MADURAI,31025,All
2020,5,CHENNAI,MADURAI,873,598,CHENNAI-MADURAI,1471,All
2020,6,CHENNAI,MADURAI,5229,4328,CHENNAI-MADURAI,9557,All
2020,7,CHENNAI,MADURAI,5264,5641,CHENNAI-MADURAI,10905,All
2020,8,CHENNAI,MADURAI,7842,8042,CHENNAI-MADURAI,15884,All
2020,9,CHENNAI,MADURAI,10535,11230,CHENNAI-MADURAI,21765,All
2020,10,CHENNAI,MADURAI,12042,11562,CHENNAI-MADURAI,23604,All
2020,11,CHENNAI,MADURAI,11587,11052,CHENNAI-MADURAI,22639,All
2020,12,CHENNAI,MADURAI,12304,11948,CHENNAI-MADURAI,24252,All
2021,1,CHENNAI,MADURAI,16142,15663,CHENNAI-MADURAI,31805,All
2021,2,CHENNAI,MADURAI,15238,16033,CHENNAI-MADURAI,31271,All
2021,3,CHENNAI,MADURAI,16428,16313,CHENNAI-MADURAI,32741,All
2021,4,CHENNAI,MADURAI,14292,12238,CHENNAI-MADURAI,26530,All
2021,6,CHENNAI,MADURAI,8792,8519,CHENNAI-MADURAI,17311,All
2021,7,CHENNAI,MADURAI,12679,11770,CHENNAI-MADURAI,24449,All
2021,8,CHENNAI,MADURAI,14661,14205,CHENNAI-MADURAI,28866,All
2021,9,CHENNAI,MADURAI,16145,16298,CHENNAI-MADURAI,32443,All
2021,10,CHENNAI,MADURAI,16678,15804,CHENNAI-MADURAI,32482,All
2021,11,CHENNAI,MADURAI,12389,12677,CHENNAI-MADURAI,25066,All
2021,12,CHENNAI,MADURAI,13772,14002,CHENNAI-MADURAI,27774,All
2022,1,CHENNAI,MADURAI,11983,12048,CHENNAI-MADURAI,24031,All
2022,2,CHENNAI,MADURAI,12304,12671,CHENNAI-MADURAI,24975,All
2022,3,CHENNAI,MADURAI,13903,13798,CHENNAI-MADURAI,27701,All
2022,4,CHENNAI,MADURAI,13111,12818,CHENNAI-MADURAI,25929,All
2022,5,CHENNAI,MADURAI,14354,13816,CHENNAI-MADURAI,28170,All
2022,6,CHENNAI,MADURAI,13626,13764,CHENNAI-MADURAI,27390,All
2022,7,CHENNAI,MADURAI,13851,13576,CHENNAI-MADURAI,27427,All
2022,8,CHENNAI,MADURAI,14376,14546,CHENNAI-MADURAI,28922,All
2022,9,CHENNAI,MADURAI,14244,14095,CHENNAI-MADURAI,28339,All
2022,10,CHENNAI,MADURAI,14089,13674,CHENNAI-MADURAI,27763,All
2022,11,CHENNAI,MADURAI,15098,14919,CHENNAI-MADURAI,30017,All
2022,12,CHENNAI,MADURAI,16356,16299,CHENNAI-MADURAI,32655,All
2023,1,CHENNAI,MADURAI,16090,16272,CHENNAI-MADURAI,32362,All
2023,2,CHENNAI,MADURAI,14944,15065,CHENNAI-MADURAI,30009,All
2023,3,CHENNAI,MADURAI,15733,15453,CHENNAI-MADURAI,31186,All
2023,4,CHENNAI,MADURAI,14517,14185,CHENNAI-MADURAI,28702,All
2023,5,CHENNAI,MADURAI,15967,15470,CHENNAI-MADURAI,31437,All
2023,6,CHENNAI,MADURAI,14284,14271,CHENNAI-MADURAI,28555,All
2023,7,CHENNAI,MADURAI,16493,15991,CHENNAI-MADURAI,32484,All
2023,8,CHENNAI,MADURAI,18240,17868,CHENNAI-MADURAI,36108,All
2023,9,CHENNAI,MADURAI,20441,18823,CHENNAI-MADURAI,39264,All
2023,10,CHENNAI,MADURAI,18974,18122,CHENNAI-MADURAI,37096,All
2023,11,CHENNAI,MADURAI,18924,17847,CHENNAI-MADURAI,36771,All
2023,12,CHENNAI,MADURAI,18838,17247,CHENNAI-MADURAI,36085,All
2024,1,CHENNAI,MADURAI,16286,17078,CHENNAI-MADURAI,33364,All
2024,2,CHENNAI,MADURAI,14626,14705,CHENNAI-MADURAI,29331,All
2024,3,CHENNAI,MADURAI,16214,15811,CHENNAI-MADURAI,32025,All
2024,4,CHENNAI,MADURAI,15317,15072,CHENNAI-MADURAI,30389,All
2024,6,CHENNAI,MADURAI,15541,15875,CHENNAI-MADURAI,31416,All
2024,7,CHENNAI,MADURAI,16451,16409,CHENNAI-MADURAI,32860,All
2024,8,CHENNAI,MADURAI,16683,16358,CHENNAI-MADURAI,33041,All
2024,9,CHENNAI,MADURAI,15560,15496,CHENNAI-MADURAI,31056,All
2024,10,CHENNAI,MADURAI,16108,14084,CHENNAI-MADURAI,30192,All
2024,11,CHENNAI,MADURAI,18724,18077,CHENNAI-MADURAI,36801,All
2024,12,CHENNAI,MADURAI,20723,18567,CHENNAI-MADURAI,39290,All
2025,1,CHENNAI,MADURAI,22623,22354,CHENNAI-MADURAI,44977,All
2025,2,CHENNAI,MADURAI,20756,19837,CHENNAI-MADURAI,40593,All
2025,3,CHENNAI,MADURAI,21758,20465,CHENNAI-MADURAI,42223,All
2019,5,CHENNAI,MANGALORE,3957,3813,CHENNAI-MANGALORE,7770,All
2019,6,CHENNAI,MANGALORE,3299,3415,CHENNAI-MANGALORE,6714,All
2019,7,CHENNAI,MANGALORE,4052,3485,CHENNAI-MANGALORE,7537,All
2019,8,CHENNAI,MANGALORE,2140,2078,CHENNAI-MANGALORE,4218,All
2019,9,CHENNAI,MANGALORE,3242,3118,CHENNAI-MANGALORE,6360,All
2019,10,CHENNAI,MANGALORE,3824,3848,CHENNAI-MANGALORE,7672,All
2019,11,CHENNAI,MANGALORE,3881,3683,CHENNAI-MANGALORE,7564,All
2019,12,CHENNAI,MANGALORE,4200,4017,CHENNAI-MANGALORE,8217,All
2020,1,CHENNAI,MANGALORE,3264,3404,CHENNAI-MANGALORE,6668,All
2020,2,CHENNAI,MANGALORE,3869,4031,CHENNAI-MANGALORE,7900,All
2020,3,CHENNAI,MANGALORE,2352,2541,CHENNAI-MANGALORE,4893,All
2020,5,CHENNAI,MANGALORE,67,25,CHENNAI-MANGALORE,92,All
2020,9,CHENNAI,MANGALORE,662,388,CHENNAI-MANGALORE,1050,All
2020,10,CHENNAI,MANGALORE,866,709,CHENNAI-MANGALORE,1575,All
2020,11,CHENNAI,MANGALORE,1585,1006,CHENNAI-MANGALORE,2591,All
2020,12,CHENNAI,MANGALORE,2015,1496,CHENNAI-MANGALORE,3511,All
2021,1,CHENNAI,MANGALORE,1755,1634,CHENNAI-MANGALORE,3389,All
2021,2,CHENNAI,MANGALORE,1894,1502,CHENNAI-MANGALORE,3396,All
2021,3,CHENNAI,MANGALORE,1585,1582,CHENNAI-MANGALORE,3167,All
2021,4,CHENNAI,MANGALORE,1440,1308,CHENNAI-MANGALORE,2748,All
2021,6,CHENNAI,MANGALORE,475,327,CHENNAI-MANGALORE,802,All
2021,7,CHENNAI,MANGALORE,885,680,CHENNAI-MANGALORE,1565,All
2021,8,CHENNAI,MANGALORE,1580,1216,CHENNAI-MANGALORE,2796,All
2021,9,CHENNAI,MANGALORE,1577,1476,CHENNAI-MANGALORE,3053,All
2021,10,CHENNAI,MANGALORE,1682,1713,CHENNAI-MANGALORE,3395,All
2021,11,CHENNAI,MANGALORE,1796,1467,CHENNAI-MANGALORE,3263,All
2021,12,CHENNAI,MANGALORE,1938,1838,CHENNAI-MANGALORE,3776,All
2022,1,CHENNAI,MANGALORE,1011,1123,CHENNAI-MANGALORE,2134,All
2022,2,CHENNAI,MANGALORE,1843,1522,CHENNAI-MANGALORE,3365,All
2022,3,CHENNAI,MANGALORE,2093,1991,CHENNAI-MANGALORE,4084,All
2022,4,CHENNAI,MANGALORE,2226,2018,CHENNAI-MANGALORE,4244,All
2022,5,CHENNAI,MANGALORE,2219,2269,CHENNAI-MANGALORE,4488,All
2022,6,CHENNAI,MANGALORE,1980,1989,CHENNAI-MANGALORE,3969,All
2022,7,CHENNAI,MANGALORE,2057,1965,CHENNAI-MANGALORE,4022,All
2022,8,CHENNAI,MANGALORE,2192,2069,CHENNAI-MANGALORE,4261,All
2022,9,CHENNAI,MANGALORE,1902,1840,CHENNAI-MANGALORE,3742,All
2022,10,CHENNAI,MANGALORE,2060,2219,CHENNAI-MANGALORE,4279,All
2022,11,CHENNAI,MANGALORE,2214,1927,CHENNAI-MANGALORE,4141,All
2022,12,CHENNAI,MANGALORE,1978,1823,CHENNAI-MANGALORE,3801,All
2023,1,CHENNAI,MANGALORE,1912,2030,CHENNAI-MANGALORE,3942,All
2023,2,CHENNAI,MANGALORE,1939,1802,CHENNAI-MANGALORE,3741,All
2023,3,CHENNAI,MANGALORE,2033,1842,CHENNAI-MANGALORE,3875,All
2023,4,CHENNAI,MANGALORE,2038,2127,CHENNAI-MANGALORE,4165,All
2023,5,CHENNAI,MANGALORE,2239,2211,CHENNAI-MANGALORE,4450,All
2023,6,CHENNAI,MANGALORE,2070,2083,CHENNAI-MANGALORE,4153,All
2023,7,CHENNAI,MANGALORE,2129,2101,CHENNAI-MANGALORE,4230,All
2023,8,CHENNAI,MANGALORE,1977,1998,CHENNAI-MANGALORE,3975,All
2023,9,CHENNAI,MANGALORE,2069,2028,CHENNAI-MANGALORE,4097,All
2023,10,CHENNAI,MANGALORE,2066,2094,CHENNAI-MANGALORE,4160,All
2023,11,CHENNAI,MANGALORE,2694,2746,CHENNAI-MANGALORE,5440,All
2023,12,CHENNAI,MANGALORE,2622,2552,CHENNAI-MANGALORE,5174,All
2024,1,CHENNAI,MANGALORE,2808,2961,CHENNAI-MANGALORE,5769,All
2024,2,CHENNAI,MANGALORE,2660,2647,CHENNAI-MANGALORE,5307,All
2024,3,CHENNAI,MANGALORE,2818,2863,CHENNAI-MANGALORE,5681,All
2024,4,CHENNAI,MANGALORE,3510,3508,CHENNAI-MANGALORE,7018,All
2024,6,CHENNAI,MANGALORE,3147,3528,CHENNAI-MANGALORE,6675,All
2024,7,CHENNAI,MANGALORE,3724,3450,CHENNAI-MANGALORE,7174,All
2024,8,CHENNAI,MANGALORE,3637,3747,CHENNAI-MANGALORE,7384,All
2024,9,CHENNAI,MANGALORE,2932,3034,CHENNAI-MANGALORE,5966,All
2024,10,CHENNAI,MANGALORE,2859,3139,CHENNAI-MANGALORE,5998,All
2024,11,CHENNAI,MANGALORE,3618,3081,CHENNAI-MANGALORE,6699,All
2024,12,CHENNAI,MANGALORE,3782,3752,CHENNAI-MANGALORE,7534,All
2025,1,CHENNAI,MANGALORE,3503,3682,CHENNAI-MANGALORE,7185,All
2025,2,CHENNAI,MANGALORE,3389,3391,CHENNAI-MANGALORE,6780,All
2025,3,CHENNAI,MANGALORE,3143,3138,CHENNAI-MANGALORE,6281,All
2019,5,CHENNAI,MUMBAI,80768,87342,CHENNAI-MUMBAI,168110,All
2019,6,CHENNAI,MUMBAI,86473,87845,CHENNAI-MUMBAI,174318,All
2019,7,CHENNAI,MUMBAI,94831,99654,CHENNAI-MUMBAI,194485,All
2019,8,CHENNAI,MUMBAI,106441,105637,CHENNAI-MUMBAI,212078,All
2019,9,CHENNAI,MUMBAI,101667,89728,CHENNAI-MUMBAI,191395,All
2019,10,CHENNAI,MUMBAI,81604,91542,CHENNAI-MUMBAI,173146,All
2019,11,CHENNAI,MUMBAI,100477,91066,CHENNAI-MUMBAI,191543,All
2019,12,CHENNAI,MUMBAI,96682,100046,CHENNAI-MUMBAI,196728,All
2020,1,CHENNAI,MUMBAI,99905,99717,CHENNAI-MUMBAI,199622,All
2020,2,CHENNAI,MUMBAI,97869,96616,CHENNAI-MUMBAI,194485,All
2020,3,CHENNAI,MUMBAI,54548,51814,CHENNAI-MUMBAI,106362,All
2020,5,CHENNAI,MUMBAI,0,470,CHENNAI-MUMBAI,470,All
2020,6,CHENNAI,MUMBAI,0,657,CHENNAI-MUMBAI,657,All
2020,7,CHENNAI,MUMBAI,2618,3541,CHENNAI-MUMBAI,6159,All
2020,8,CHENNAI,MUMBAI,6862,2037,CHENNAI-MUMBAI,8899,All
2020,9,CHENNAI,MUMBAI,13988,11021,CHENNAI-MUMBAI,25009,All
2020,10,CHENNAI,MUMBAI,19158,19048,CHENNAI-MUMBAI,38206,All
2020,11,CHENNAI,MUMBAI,27884,26366,CHENNAI-MUMBAI,54250,All
2020,12,CHENNAI,MUMBAI,28261,42646,CHENNAI-MUMBAI,70907,All
2021,1,CHENNAI,MUMBAI,36805,37108,CHENNAI-MUMBAI,73913,All
2021,2,CHENNAI,MUMBAI,38841,37742,CHENNAI-MUMBAI,76583,All
2021,3,CHENNAI,MUMBAI,32879,28467,CHENNAI-MUMBAI,61346,All
2021,4,CHENNAI,MUMBAI,22856,20485,CHENNAI-MUMBAI,43341,All
2021,6,CHENNAI,MUMBAI,14354,13849,CHENNAI-MUMBAI,28203,All
2021,7,CHENNAI,MUMBAI,23441,24231,CHENNAI-MUMBAI,47672,All
2021,8,CHENNAI,MUMBAI,37443,35190,CHENNAI-MUMBAI,72633,All
2021,9,CHENNAI,MUMBAI,44726,40683,CHENNAI-MUMBAI,85409,All
2021,10,CHENNAI,MUMBAI,52902,54492,CHENNAI-MUMBAI,107394,All
2021,11,CHENNAI,MUMBAI,64089,55634,CHENNAI-MUMBAI,119723,All
2021,12,CHENNAI,MUMBAI,67870,65782,CHENNAI-MUMBAI,133652,All
2022,1,CHENNAI,MUMBAI,41545,37477,CHENNAI-MUMBAI,79022,All
2022,2,CHENNAI,MUMBAI,54092,52913,CHENNAI-MUMBAI,107005,All
2022,3,CHENNAI,MUMBAI,67926,66630,CHENNAI-MUMBAI,134556,All
2022,4,CHENNAI,MUMBAI,64848,64840,CHENNAI-MUMBAI,129688,All
2022,5,CHENNAI,MUMBAI,67031,72220,CHENNAI-MUMBAI,139251,All
2022,6,CHENNAI,MUMBAI,66582,68230,CHENNAI-MUMBAI,134812,All
2022,7,CHENNAI,MUMBAI,63919,66704,CHENNAI-MUMBAI,130623,All
2022,8,CHENNAI,MUMBAI,80680,77189,CHENNAI-MUMBAI,157869,All
2022,9,CHENNAI,MUMBAI,103205,87078,CHENNAI-MUMBAI,190283,All
2022,10,CHENNAI,MUMBAI,91036,98118,CHENNAI-MUMBAI,189154,All
2022,11,CHENNAI,MUMBAI,101670,95834,CHENNAI-MUMBAI,197504,All
2022,12,CHENNAI,MUMBAI,103137,105354,CHENNAI-MUMBAI,208491,All
2023,11,CHENNAI,MUMBAI,104423,108233,CHENNAI-MUMBAI,212656,All
2023,12,CHENNAI,MUMBAI,110747,112090,CHENNAI-MUMBAI,222837,All
2024,1,CHENNAI,MUMBAI,114843,120294,CHENNAI-MUMBAI,235137,All
2024,2,CHENNAI,MUMBAI,108650,111152,CHENNAI-MUMBAI,219802,All
2024,3,CHENNAI,MUMBAI,94590,94377,CHENNAI-MUMBAI,188967,All
2024,4,CHENNAI,MUMBAI,87665,86760,CHENNAI-MUMBAI,174425,All
2024,6,CHENNAI,MUMBAI,81225,90413,CHENNAI-MUMBAI,171638,All
2024,7,CHENNAI,MUMBAI,83743,95267,CHENNAI-MUMBAI,179010,All
2024,8,CHENNAI,MUMBAI,97209,89941,CHENNAI-MUMBAI,187150,All
2024,9,CHENNAI,MUMBAI,95339,83455,CHENNAI-MUMBAI,178794,All
2024,10,CHENNAI,MUMBAI,80449,86932,CHENNAI-MUMBAI,167381,All
2024,11,CHENNAI,MUMBAI,89708,83994,CHENNAI-MUMBAI,173702,All
2024,12,CHENNAI,MUMBAI,91337,94742,CHENNAI-MUMBAI,186079,All
2025,1,CHENNAI,MUMBAI,87813,90471,CHENNAI-MUMBAI,178284,All
2025,2,CHENNAI,MUMBAI,81532,82031,CHENNAI-MUMBAI,163563,All
2025,3,CHENNAI,MUMBAI,81523,80009,CHENNAI-MUMBAI,161532,All
2017,9,CHENNAI,MYSORE,597,591,CHENNAI-MYSORE,1188,All
2017,10,CHENNAI,MYSORE,1290,1382,CHENNAI-MYSORE,2672,All
2017,11,CHENNAI,MYSORE,984,993,CHENNAI-MYSORE,1977,All
2017,12,CHENNAI,MYSORE,1641,1556,CHENNAI-MYSORE,3197,All
2018,1,CHENNAI,MYSORE,1650,1687,CHENNAI-MYSORE,3337,All
2018,2,CHENNAI,MYSORE,1411,1373,CHENNAI-MYSORE,2784,All
2018,3,CHENNAI,MYSORE,1387,1278,CHENNAI-MYSORE,2665,All
2018,4,CHENNAI,MYSORE,1755,1713,CHENNAI-MYSORE,3468,All
2018,5,CHENNAI,MYSORE,1936,2056,CHENNAI-MYSORE,3992,All
2018,6,CHENNAI,MYSORE,1560,1760,CHENNAI-MYSORE,3320,All
2018,7,CHENNAI,MYSORE,1711,1836,CHENNAI-MYSORE,3547,All
2018,8,CHENNAI,MYSORE,1732,1871,CHENNAI-MYSORE,3603,All
2018,9,CHENNAI,MYSORE,1630,1720,CHENNAI-MYSORE,3350,All
2018,10,CHENNAI,MYSORE,1693,1919,CHENNAI-MYSORE,3612,All
2018,11,CHENNAI,MYSORE,1620,1683,CHENNAI-MYSORE,3303,All
2018,12,CHENNAI,MYSORE,1758,1895,CHENNAI-MYSORE,3653,All
2019,1,CHENNAI,MYSORE,1739,1839,CHENNAI-MYSORE,3578,All
2019,2,CHENNAI,MYSORE,1534,1654,CHENNAI-MYSORE,3188,All
2019,3,CHENNAI,MYSORE,1646,1690,CHENNAI-MYSORE,3336,All
2019,4,CHENNAI,MYSORE,1653,1585,CHENNAI-MYSORE,3238,All
2019,5,CHENNAI,MYSORE,1913,1781,CHENNAI-MYSORE,3694,All
2019,6,CHENNAI,MYSORE,1662,1784,CHENNAI-MYSORE,3446,All
2019,7,CHENNAI,MYSORE,1682,1828,CHENNAI-MYSORE,3510,All
2019,8,CHENNAI,MYSORE,1565,1611,CHENNAI-MYSORE,3176,All
2019,9,CHENNAI,MYSORE,1424,1511,CHENNAI-MYSORE,2935,All
2019,10,CHENNAI,MYSORE,1573,1698,CHENNAI-MYSORE,3271,All
2019,11,CHENNAI,MYSORE,2039,2073,CHENNAI-MYSORE,4112,All
2019,12,CHENNAI,MYSORE,2824,2782,CHENNAI-MYSORE,5606,All
2020,1,CHENNAI,MYSORE,2286,2384,CHENNAI-MYSORE,4670,All
2020,2,CHENNAI,MYSORE,1732,1819,CHENNAI-MYSORE,3551,All
2020,3,CHENNAI,MYSORE,1164,1260,CHENNAI-MYSORE,2424,All
2020,6,CHENNAI,MYSORE,174,44,CHENNAI-MYSORE,218,All
2020,7,CHENNAI,MYSORE,72,29,CHENNAI-MYSORE,101,All
2020,10,CHENNAI,MYSORE,775,773,CHENNAI-MYSORE,1548,All
2020,11,CHENNAI,MYSORE,696,655,CHENNAI-MYSORE,1351,All
2020,12,CHENNAI,MYSORE,1441,1433,CHENNAI-MYSORE,2874,All
2021,1,CHENNAI,MYSORE,1599,1631,CHENNAI-MYSORE,3230,All
2021,2,CHENNAI,MYSORE,1614,1627,CHENNAI-MYSORE,3241,All
2021,3,CHENNAI,MYSORE,1419,1414,CHENNAI-MYSORE,2833,All
2021,4,CHENNAI,MYSORE,799,780,CHENNAI-MYSORE,1579,All
2021,6,CHENNAI,MYSORE,12,18,CHENNAI-MYSORE,30,All
2021,8,CHENNAI,MYSORE,354,338,CHENNAI-MYSORE,692,All
2021,9,CHENNAI,MYSORE,644,663,CHENNAI-MYSORE,1307,All
2021,10,CHENNAI,MYSORE,698,710,CHENNAI-MYSORE,1408,All
2021,11,CHENNAI,MYSORE,876,1009,CHENNAI-MYSORE,1885,All
2021,12,CHENNAI,MYSORE,1201,1441,CHENNAI-MYSORE,2642,All
2022,1,CHENNAI,MYSORE,443,681,CHENNAI-MYSORE,1124,All
2022,2,CHENNAI,MYSORE,546,616,CHENNAI-MYSORE,1162,All
2022,3,CHENNAI,MYSORE,1320,1526,CHENNAI-MYSORE,2846,All
2022,4,CHENNAI,MYSORE,1833,1853,CHENNAI-MYSORE,3686,All
2022,5,CHENNAI,MYSORE,1935,2032,CHENNAI-MYSORE,3967,All
2022,6,CHENNAI,MYSORE,1985,1957,CHENNAI-MYSORE,3942,All
2022,7,CHENNAI,MYSORE,2211,1994,CHENNAI-MYSORE,4205,All
2022,8,CHENNAI,MYSORE,2138,1846,CHENNAI-MYSORE,3984,All
2022,9,CHENNAI,MYSORE,2100,1706,CHENNAI-MYSORE,3806,All
2022,10,CHENNAI,MYSORE,2116,2168,CHENNAI-MYSORE,4284,All
2022,11,CHENNAI,MYSORE,1959,2021,CHENNAI-MYSORE,3980,All
2022,12,CHENNAI,MYSORE,2036,2174,CHENNAI-MYSORE,4210,All
2023,1,CHENNAI,MYSORE,1876,2455,CHENNAI-MYSORE,4331,All
2023,2,CHENNAI,MYSORE,1811,2121,CHENNAI-MYSORE,3932,All
2023,3,CHENNAI,MYSORE,2032,2191,CHENNAI-MYSORE,4223,All
2023,4,CHENNAI,MYSORE,2444,2394,CHENNAI-MYSORE,4838,All
2023,5,CHENNAI,MYSORE,2754,2589,CHENNAI-MYSORE,5343,All
2023,6,CHENNAI,MYSORE,2510,2302,CHENNAI-MYSORE,4812,All
2023,7,CHENNAI,MYSORE,2325,2079,CHENNAI-MYSORE,4404,All
2023,8,CHENNAI,MYSORE,1955,1761,CHENNAI-MYSORE,3716,All
2023,9,CHENNAI,MYSORE,1906,1635,CHENNAI-MYSORE,3541,All
2023,10,CHENNAI,MYSORE,1760,1738,CHENNAI-MYSORE,3498,All
2023,11,CHENNAI,MYSORE,1886,1634,CHENNAI-MYSORE,3520,All
2023,12,CHENNAI,MYSORE,1873,1561,CHENNAI-MYSORE,3434,All
2024,1,CHENNAI,MYSORE,1791,1767,CHENNAI-MYSORE,3558,All
2024,2,CHENNAI,MYSORE,1768,1585,CHENNAI-MYSORE,3353,All
2024,3,CHENNAI,MYSORE,1807,1658,CHENNAI-MYSORE,3465,All
2024,4,CHENNAI,MYSORE,1469,1336,CHENNAI-MYSORE,2805,All
2024,6,CHENNAI,MYSORE,1866,1540,CHENNAI-MYSORE,3406,All
2024,7,CHENNAI,MYSORE,1622,1537,CHENNAI-MYSORE,3159,All
2024,8,CHENNAI,MYSORE,1607,1486,CHENNAI-MYSORE,3093,All
2024,9,CHENNAI,MYSORE,1529,1494,CHENNAI-MYSORE,3023,All
2024,10,CHENNAI,MYSORE,1782,1659,CHENNAI-MYSORE,3441,All
2024,11,CHENNAI,MYSORE,1970,1642,CHENNAI-MYSORE,3612,All
2024,12,CHENNAI,MYSORE,2062,1819,CHENNAI-MYSORE,3881,All
2025,1,CHENNAI,MYSORE,2078,2001,CHENNAI-MYSORE,4079,All
2025,2,CHENNAI,MYSORE,2026,1705,CHENNAI-MYSORE,3731,All
2025,3,CHENNAI,MYSORE,2019,1752,CHENNAI-MYSORE,3771,All
2018,2,CHENNAI,NAGPUR,26,0,CHENNAI-NAGPUR,26,All
2018,3,CHENNAI,NAGPUR,14,0,CHENNAI-NAGPUR,14,All
2018,11,CHENNAI,NAGPUR,2766,2878,CHENNAI-NAGPUR,5644,All
2018,12,CHENNAI,NAGPUR,3576,3829,CHENNAI-NAGPUR,7405,All
2019,1,CHENNAI,NAGPUR,3758,4282,CHENNAI-NAGPUR,8040,All
2019,2,CHENNAI,NAGPUR,3781,4052,CHENNAI-NAGPUR,7833,All
2019,3,CHENNAI,NAGPUR,3813,3982,CHENNAI-NAGPUR,7795,All
2019,4,CHENNAI,NAGPUR,4099,4033,CHENNAI-NAGPUR,8132,All
2019,5,CHENNAI,NAGPUR,3971,4561,CHENNAI-NAGPUR,8532,All
2019,6,CHENNAI,NAGPUR,3553,3931,CHENNAI-NAGPUR,7484,All
2019,7,CHENNAI,NAGPUR,2767,3208,CHENNAI-NAGPUR,5975,All
2019,8,CHENNAI,NAGPUR,3267,3387,CHENNAI-NAGPUR,6654,All
2019,9,CHENNAI,NAGPUR,3239,2812,CHENNAI-NAGPUR,6051,All
2019,10,CHENNAI,NAGPUR,3553,3362,CHENNAI-NAGPUR,6915,All
2019,11,CHENNAI,NAGPUR,4814,4961,CHENNAI-NAGPUR,9775,All
2019,12,CHENNAI,NAGPUR,4756,4956,CHENNAI-NAGPUR,9712,All
2020,1,CHENNAI,NAGPUR,4961,5199,CHENNAI-NAGPUR,10160,All
2020,2,CHENNAI,NAGPUR,4826,4766,CHENNAI-NAGPUR,9592,All
2020,3,CHENNAI,NAGPUR,3468,2916,CHENNAI-NAGPUR,6384,All
2020,8,CHENNAI,NAGPUR,412,382,CHENNAI-NAGPUR,794,All
2020,9,CHENNAI,NAGPUR,567,640,CHENNAI-NAGPUR,1207,All
2020,10,CHENNAI,NAGPUR,563,604,CHENNAI-NAGPUR,1167,All
2020,11,CHENNAI,NAGPUR,672,655,CHENNAI-NAGPUR,1327,All
2020,12,CHENNAI,NAGPUR,2144,2111,CHENNAI-NAGPUR,4255,All
2021,1,CHENNAI,NAGPUR,2422,3166,CHENNAI-NAGPUR,5588,All
2021,2,CHENNAI,NAGPUR,3016,3428,CHENNAI-NAGPUR,6444,All
2021,3,CHENNAI,NAGPUR,1724,2027,CHENNAI-NAGPUR,3751,All
2021,4,CHENNAI,NAGPUR,909,502,CHENNAI-NAGPUR,1411,All
2021,7,CHENNAI,NAGPUR,327,230,CHENNAI-NAGPUR,557,All
2021,10,CHENNAI,NAGPUR,520,598,CHENNAI-NAGPUR,1118,All
2021,11,CHENNAI,NAGPUR,3932,4360,CHENNAI-NAGPUR,8292,All
2021,12,CHENNAI,NAGPUR,3021,3341,CHENNAI-NAGPUR,6362,All
2022,1,CHENNAI,NAGPUR,957,861,CHENNAI-NAGPUR,1818,All
2022,2,CHENNAI,NAGPUR,1,0,CHENNAI-NAGPUR,1,All
2022,3,CHENNAI,NAGPUR,2138,2530,CHENNAI-NAGPUR,4668,All
2022,4,CHENNAI,NAGPUR,3287,2437,CHENNAI-NAGPUR,5724,All
2022,5,CHENNAI,NAGPUR,3047,2377,CHENNAI-NAGPUR,5424,All
2022,6,CHENNAI,NAGPUR,1705,1212,CHENNAI-NAGPUR,2917,All
2022,7,CHENNAI,NAGPUR,145,90,CHENNAI-NAGPUR,235,All
2022,10,CHENNAI,NAGPUR,311,354,CHENNAI-NAGPUR,665,All
2022,11,CHENNAI,NAGPUR,3158,2384,CHENNAI-NAGPUR,5542,All
2022,12,CHENNAI,NAGPUR,3790,3518,CHENNAI-NAGPUR,7308,All
2023,1,CHENNAI,NAGPUR,3423,3674,CHENNAI-NAGPUR,7097,All
2023,2,CHENNAI,NAGPUR,3565,3494,CHENNAI-NAGPUR,7059,All
2023,3,CHENNAI,NAGPUR,4193,3546,CHENNAI-NAGPUR,7739,All
2023,4,CHENNAI,NAGPUR,4968,3640,CHENNAI-NAGPUR,8608,All
2023,5,CHENNAI,NAGPUR,3132,3523,CHENNAI-NAGPUR,6655,All
2023,6,CHENNAI,NAGPUR,3292,3277,CHENNAI-NAGPUR,6569,All
2023,7,CHENNAI,NAGPUR,900,906,CHENNAI-NAGPUR,1806,All
2023,8,CHENNAI,NAGPUR,2409,2236,CHENNAI-NAGPUR,4645,All
2023,9,CHENNAI,NAGPUR,4506,3866,CHENNAI-NAGPUR,8372,All
2023,10,CHENNAI,NAGPUR,3495,3155,CHENNAI-NAGPUR,6650,All
2024,2,CHENNAI,NAGPUR,97,0,CHENNAI-NAGPUR,97,All
2024,3,CHENNAI,NAGPUR,41,0,CHENNAI-NAGPUR,41,All
2024,4,CHENNAI,NAGPUR,76,36,CHENNAI-NAGPUR,112,All
2021,10,CHENNAI,NASIK,306,215,CHENNAI-NASIK,521,All
2022,1,CHENNAI,NASIK,84,163,CHENNAI-NASIK,247,All
2022,5,CHENNAI,NASIK,186,176,CHENNAI-NASIK,362,All
2022,6,CHENNAI,NASIK,307,360,CHENNAI-NASIK,667,All
2022,10,CHENNAI,NASIK,176,181,CHENNAI-NASIK,357,All
2022,11,CHENNAI,NASIK,147,110,CHENNAI-NASIK,257,All
2022,12,CHENNAI,NASIK,233,354,CHENNAI-NASIK,587,All
2023,1,CHENNAI,NASIK,156,163,CHENNAI-NASIK,319,All
2023,5,CHENNAI,NASIK,556,531,CHENNAI-NASIK,1087,All
2023,6,CHENNAI,NASIK,493,184,CHENNAI-NASIK,677,All
2023,7,CHENNAI,NASIK,0,162,CHENNAI-NASIK,162,All
2016,11,CHENNAI,PATNA,1,6,CHENNAI-PATNA,7,All
2016,12,CHENNAI,PATNA,7,0,CHENNAI-PATNA,7,All
2017,2,CHENNAI,PATNA,7,0,CHENNAI-PATNA,7,All
2017,7,CHENNAI,PATNA,931,980,CHENNAI-PATNA,1911,All
2017,8,CHENNAI,PATNA,1328,1098,CHENNAI-PATNA,2426,All
2017,9,CHENNAI,PATNA,1244,1026,CHENNAI-PATNA,2270,All
2017,10,CHENNAI,PATNA,2283,1854,CHENNAI-PATNA,4137,All
2017,11,CHENNAI,PATNA,1386,1472,CHENNAI-PATNA,2858,All
2017,12,CHENNAI,PATNA,1128,1176,CHENNAI-PATNA,2304,All
2018,1,CHENNAI,PATNA,1396,2065,CHENNAI-PATNA,3461,All
2018,2,CHENNAI,PATNA,4032,2454,CHENNAI-PATNA,6486,All
2018,3,CHENNAI,PATNA,4364,3111,CHENNAI-PATNA,7475,All
2018,4,CHENNAI,PATNA,5655,2648,CHENNAI-PATNA,8303,All
2018,5,CHENNAI,PATNA,5235,3550,CHENNAI-PATNA,8785,All
2018,6,CHENNAI,PATNA,5563,2541,CHENNAI-PATNA,8104,All
2018,7,CHENNAI,PATNA,4129,3332,CHENNAI-PATNA,7461,All
2018,8,CHENNAI,PATNA,4504,2798,CHENNAI-PATNA,7302,All
2018,9,CHENNAI,PATNA,4695,2792,CHENNAI-PATNA,7487,All
2018,10,CHENNAI,PATNA,6760,3300,CHENNAI-PATNA,10060,All
2018,11,CHENNAI,PATNA,6677,3656,CHENNAI-PATNA,10333,All
2018,12,CHENNAI,PATNA,2915,3313,CHENNAI-PATNA,6228,All
2019,1,CHENNAI,PATNA,2371,2805,CHENNAI-PATNA,5176,All
2019,2,CHENNAI,PATNA,2077,1936,CHENNAI-PATNA,4013,All
2019,3,CHENNAI,PATNA,2034,2360,CHENNAI-PATNA,4394,All
2019,4,CHENNAI,PATNA,3105,2396,CHENNAI-PATNA,5501,All
2019,5,CHENNAI,PATNA,2198,2030,CHENNAI-PATNA,4228,All
2019,6,CHENNAI,PATNA,2227,2442,CHENNAI-PATNA,4669,All
2019,7,CHENNAI,PATNA,1136,1435,CHENNAI-PATNA,2571,All
2019,8,CHENNAI,PATNA,1468,1647,CHENNAI-PATNA,3115,All
2019,9,CHENNAI,PATNA,1245,1659,CHENNAI-PATNA,2904,All
2019,10,CHENNAI,PATNA,2464,1955,CHENNAI-PATNA,4419,All
2019,11,CHENNAI,PATNA,4874,6044,CHENNAI-PATNA,10918,All
2019,12,CHENNAI,PATNA,6526,7454,CHENNAI-PATNA,13980,All
2020,1,CHENNAI,PATNA,5476,5699,CHENNAI-PATNA,11175,All
2020,2,CHENNAI,PATNA,0,306,CHENNAI-PATNA,306,All
2020,3,CHENNAI,PATNA,0,410,CHENNAI-PATNA,410,All
2020,7,CHENNAI,PATNA,3857,2703,CHENNAI-PATNA,6560,All
2020,8,CHENNAI,PATNA,3445,5516,CHENNAI-PATNA,8961,All
2020,9,CHENNAI,PATNA,4191,7370,CHENNAI-PATNA,11561,All
2020,10,CHENNAI,PATNA,6608,11970,CHENNAI-PATNA,18578,All
2020,11,CHENNAI,PATNA,11674,8338,CHENNAI-PATNA,20012,All
2020,12,CHENNAI,PATNA,4688,9295,CHENNAI-PATNA,13983,All
2021,1,CHENNAI,PATNA,6784,14359,CHENNAI-PATNA,21143,All
2021,2,CHENNAI,PATNA,6585,7914,CHENNAI-PATNA,14499,All
2021,3,CHENNAI,PATNA,10176,6306,CHENNAI-PATNA,16482,All
2021,4,CHENNAI,PATNA,10188,5419,CHENNAI-PATNA,15607,All
2021,6,CHENNAI,PATNA,1976,4054,CHENNAI-PATNA,6030,All
2021,7,CHENNAI,PATNA,3146,5795,CHENNAI-PATNA,8941,All
2021,8,CHENNAI,PATNA,2729,3599,CHENNAI-PATNA,6328,All
2021,9,CHENNAI,PATNA,1958,2424,CHENNAI-PATNA,4382,All
2021,10,CHENNAI,PATNA,3501,2438,CHENNAI-PATNA,5939,All
2021,11,CHENNAI,PATNA,5312,5476,CHENNAI-PATNA,10788,All
2021,12,CHENNAI,PATNA,4356,6350,CHENNAI-PATNA,10706,All
2022,1,CHENNAI,PATNA,2781,2695,CHENNAI-PATNA,5476,All
2022,2,CHENNAI,PATNA,2063,3008,CHENNAI-PATNA,5071,All
2022,3,CHENNAI,PATNA,4319,5392,CHENNAI-PATNA,9711,All
2022,4,CHENNAI,PATNA,5053,4116,CHENNAI-PATNA,9169,All
2022,5,CHENNAI,PATNA,5575,6160,CHENNAI-PATNA,11735,All
2022,6,CHENNAI,PATNA,2380,2812,CHENNAI-PATNA,5192,All
2022,7,CHENNAI,PATNA,1582,1528,CHENNAI-PATNA,3110,All
2022,8,CHENNAI,PATNA,1792,2111,CHENNAI-PATNA,3903,All
2022,9,CHENNAI,PATNA,2196,1930,CHENNAI-PATNA,4126,All
2022,10,CHENNAI,PATNA,3514,3331,CHENNAI-PATNA,6845,All
2022,11,CHENNAI,PATNA,5570,6274,CHENNAI-PATNA,11844,All
2022,12,CHENNAI,PATNA,3861,4299,CHENNAI-PATNA,8160,All
2023,1,CHENNAI,PATNA,3894,4225,CHENNAI-PATNA,8119,All
2023,2,CHENNAI,PATNA,4330,3911,CHENNAI-PATNA,8241,All
2023,3,CHENNAI,PATNA,4213,4297,CHENNAI-PATNA,8510,All
2023,4,CHENNAI,PATNA,4696,4037,CHENNAI-PATNA,8733,All
2023,5,CHENNAI,PATNA,4794,4679,CHENNAI-PATNA,9473,All
2023,6,CHENNAI,PATNA,4531,4593,CHENNAI-PATNA,9124,All
2023,7,CHENNAI,PATNA,4118,4566,CHENNAI-PATNA,8684,All
2023,8,CHENNAI,PATNA,4419,4363,CHENNAI-PATNA,8782,All
2023,9,CHENNAI,PATNA,4556,4439,CHENNAI-PATNA,8995,All
2023,10,CHENNAI,PATNA,5460,4447,CHENNAI-PATNA,9907,All
2023,11,CHENNAI,PATNA,5741,4390,CHENNAI-PATNA,10131,All
2023,12,CHENNAI,PATNA,4902,5198,CHENNAI-PATNA,10100,All
2024,1,CHENNAI,PATNA,2371,2838,CHENNAI-PATNA,5209,All
2024,2,CHENNAI,PATNA,2113,1983,CHENNAI-PATNA,4096,All
2024,3,CHENNAI,PATNA,2336,2121,CHENNAI-PATNA,4457,All
2024,4,CHENNAI,PATNA,5298,4782,CHENNAI-PATNA,10080,All
2024,6,CHENNAI,PATNA,5131,5186,CHENNAI-PATNA,10317,All
2024,7,CHENNAI,PATNA,5159,5363,CHENNAI-PATNA,10522,All
2024,8,CHENNAI,PATNA,5048,5247,CHENNAI-PATNA,10295,All
2024,9,CHENNAI,PATNA,5009,4812,CHENNAI-PATNA,9821,All
2024,10,CHENNAI,PATNA,5720,4669,CHENNAI-PATNA,10389,All
2024,11,CHENNAI,PATNA,5323,5119,CHENNAI-PATNA,10442,All
2024,12,CHENNAI,PATNA,5077,5141,CHENNAI-PATNA,10218,All
2025,1,CHENNAI,PATNA,4962,5006,CHENNAI-PATNA,9968,All
2025,2,CHENNAI,PATNA,6036,5569,CHENNAI-PATNA,11605,All
2025,3,CHENNAI,PATNA,5316,4996,CHENNAI-PATNA,10312,All
2019,5,CHENNAI,PORT BLAIR,31769,35181,CHENNAI-PORT BLAIR,66950,All
2019,6,CHENNAI,PORT BLAIR,29134,28188,CHENNAI-PORT BLAIR,57322,All
2019,7,CHENNAI,PORT BLAIR,25411,23542,CHENNAI-PORT BLAIR,48953,All
2019,8,CHENNAI,PORT BLAIR,25963,26860,CHENNAI-PORT BLAIR,52823,All
2019,9,CHENNAI,PORT BLAIR,27236,25502,CHENNAI-PORT BLAIR,52738,All
2019,10,CHENNAI,PORT BLAIR,26869,27754,CHENNAI-PORT BLAIR,54623,All
2019,11,CHENNAI,PORT BLAIR,25455,24988,CHENNAI-PORT BLAIR,50443,All
2019,12,CHENNAI,PORT BLAIR,28820,27393,CHENNAI-PORT BLAIR,56213,All
2020,1,CHENNAI,PORT BLAIR,28231,28968,CHENNAI-PORT BLAIR,57199,All
2020,2,CHENNAI,PORT BLAIR,27523,28426,CHENNAI-PORT BLAIR,55949,All
2020,3,CHENNAI,PORT BLAIR,19273,20808,CHENNAI-PORT BLAIR,40081,All
2020,5,CHENNAI,PORT BLAIR,878,900,CHENNAI-PORT BLAIR,1778,All
2020,6,CHENNAI,PORT BLAIR,3392,3224,CHENNAI-PORT BLAIR,6616,All
2020,7,CHENNAI,PORT BLAIR,3020,2846,CHENNAI-PORT BLAIR,5866,All
2020,8,CHENNAI,PORT BLAIR,1124,2259,CHENNAI-PORT BLAIR,3383,All
2020,9,CHENNAI,PORT BLAIR,1593,3644,CHENNAI-PORT BLAIR,5237,All
2020,10,CHENNAI,PORT BLAIR,4821,4924,CHENNAI-PORT BLAIR,9745,All
2020,11,CHENNAI,PORT BLAIR,8698,8444,CHENNAI-PORT BLAIR,17142,All
2020,12,CHENNAI,PORT BLAIR,12195,8329,CHENNAI-PORT BLAIR,20524,All
2021,1,CHENNAI,PORT BLAIR,13640,13987,CHENNAI-PORT BLAIR,27627,All
2021,2,CHENNAI,PORT BLAIR,15064,14114,CHENNAI-PORT BLAIR,29178,All
2021,3,CHENNAI,PORT BLAIR,17578,16713,CHENNAI-PORT BLAIR,34291,All
2021,4,CHENNAI,PORT BLAIR,12803,14154,CHENNAI-PORT BLAIR,26957,All
2021,6,CHENNAI,PORT BLAIR,4694,3948,CHENNAI-PORT BLAIR,8642,All
2021,7,CHENNAI,PORT BLAIR,3905,3881,CHENNAI-PORT BLAIR,7786,All
2021,8,CHENNAI,PORT BLAIR,8739,7679,CHENNAI-PORT BLAIR,16418,All
2021,9,CHENNAI,PORT BLAIR,13329,10204,CHENNAI-PORT BLAIR,23533,All
2021,10,CHENNAI,PORT BLAIR,14559,13985,CHENNAI-PORT BLAIR,28544,All
2021,11,CHENNAI,PORT BLAIR,16544,16610,CHENNAI-PORT BLAIR,33154,All
2021,12,CHENNAI,PORT BLAIR,20334,19512,CHENNAI-PORT BLAIR,39846,All
2022,1,CHENNAI,PORT BLAIR,11603,13951,CHENNAI-PORT BLAIR,25554,All
2022,2,CHENNAI,PORT BLAIR,13822,13215,CHENNAI-PORT BLAIR,27037,All
2022,3,CHENNAI,PORT BLAIR,13126,13749,CHENNAI-PORT BLAIR,26875,All
2022,4,CHENNAI,PORT BLAIR,14721,15531,CHENNAI-PORT BLAIR,30252,All
2022,5,CHENNAI,PORT BLAIR,15730,17002,CHENNAI-PORT BLAIR,32732,All
2022,6,CHENNAI,PORT BLAIR,20765,20112,CHENNAI-PORT BLAIR,40877,All
2022,7,CHENNAI,PORT BLAIR,15633,14290,CHENNAI-PORT BLAIR,29923,All
2022,8,CHENNAI,PORT BLAIR,15001,16517,CHENNAI-PORT BLAIR,31518,All
2022,9,CHENNAI,PORT BLAIR,23881,21525,CHENNAI-PORT BLAIR,45406,All
2022,10,CHENNAI,PORT BLAIR,23303,23619,CHENNAI-PORT BLAIR,46922,All
2022,11,CHENNAI,PORT BLAIR,15376,16178,CHENNAI-PORT BLAIR,31554,All
2022,12,CHENNAI,PORT BLAIR,20358,19272,CHENNAI-PORT BLAIR,39630,All
2023,1,CHENNAI,PORT BLAIR,18711,20825,CHENNAI-PORT BLAIR,39536,All
2023,2,CHENNAI,PORT BLAIR,16353,16418,CHENNAI-PORT BLAIR,32771,All
2023,3,CHENNAI,PORT BLAIR,17932,19731,CHENNAI-PORT BLAIR,37663,All
2023,4,CHENNAI,PORT BLAIR,19671,23014,CHENNAI-PORT BLAIR,42685,All
2023,5,CHENNAI,PORT BLAIR,19113,21091,CHENNAI-PORT BLAIR,40204,All
2023,6,CHENNAI,PORT BLAIR,23839,22567,CHENNAI-PORT BLAIR,46406,All
2023,7,CHENNAI,PORT BLAIR,15291,14924,CHENNAI-PORT BLAIR,30215,All
2023,8,CHENNAI,PORT BLAIR,18872,19739,CHENNAI-PORT BLAIR,38611,All
2023,9,CHENNAI,PORT BLAIR,19499,18484,CHENNAI-PORT BLAIR,37983,All
2023,10,CHENNAI,PORT BLAIR,20020,19563,CHENNAI-PORT BLAIR,39583,All
2023,11,CHENNAI,PORT BLAIR,18502,18849,CHENNAI-PORT BLAIR,37351,All
2023,12,CHENNAI,PORT BLAIR,24481,22566,CHENNAI-PORT BLAIR,47047,All
2024,1,CHENNAI,PORT BLAIR,26085,28517,CHENNAI-PORT BLAIR,54602,All
2024,2,CHENNAI,PORT BLAIR,23419,21762,CHENNAI-PORT BLAIR,45181,All
2024,3,CHENNAI,PORT BLAIR,23510,22919,CHENNAI-PORT BLAIR,46429,All
2024,4,CHENNAI,PORT BLAIR,21664,23485,CHENNAI-PORT BLAIR,45149,All
2024,6,CHENNAI,PORT BLAIR,19618,17146,CHENNAI-PORT BLAIR,36764,All
2024,7,CHENNAI,PORT BLAIR,15013,16193,CHENNAI-PORT BLAIR,31206,All
2024,8,CHENNAI,PORT BLAIR,16472,16633,CHENNAI-PORT BLAIR,33105,All
2024,9,CHENNAI,PORT BLAIR,17608,17195,CHENNAI-PORT BLAIR,34803,All
2024,10,CHENNAI,PORT BLAIR,20465,18604,CHENNAI-PORT BLAIR,39069,All
2024,11,CHENNAI,PORT BLAIR,23871,24081,CHENNAI-PORT BLAIR,47952,All
2024,12,CHENNAI,PORT BLAIR,28431,26605,CHENNAI-PORT BLAIR,55036,All
2025,1,CHENNAI,PORT BLAIR,26410,28717,CHENNAI-PORT BLAIR,55127,All
2025,2,CHENNAI,PORT BLAIR,25272,24280,CHENNAI-PORT BLAIR,49552,All
2025,3,CHENNAI,PORT BLAIR,26337,26583,CHENNAI-PORT BLAIR,52920,All
2015,4,CHENNAI,PUNE,28257,28703,CHENNAI-PUNE,56960,All
2015,5,CHENNAI,PUNE,29606,32123,CHENNAI-PUNE,61729,All
2015,6,CHENNAI,PUNE,27042,27614,CHENNAI-PUNE,54656,All
2015,7,CHENNAI,PUNE,30981,31510,CHENNAI-PUNE,62491,All
2015,8,CHENNAI,PUNE,29465,29796,CHENNAI-PUNE,59261,All
2015,9,CHENNAI,PUNE,28823,28683,CHENNAI-PUNE,57506,All
2015,10,CHENNAI,PUNE,28495,29396,CHENNAI-PUNE,57891,All
2015,11,CHENNAI,PUNE,27889,27714,CHENNAI-PUNE,55603,All
2015,12,CHENNAI,PUNE,23235,24737,CHENNAI-PUNE,47972,All
2016,1,CHENNAI,PUNE,31056,32326,CHENNAI-PUNE,63382,All
2016,2,CHENNAI,PUNE,30011,30287,CHENNAI-PUNE,60298,All
2016,3,CHENNAI,PUNE,31424,32077,CHENNAI-PUNE,63501,All
2016,4,CHENNAI,PUNE,30544,31595,CHENNAI-PUNE,62139,All
2016,5,CHENNAI,PUNE,32560,34109,CHENNAI-PUNE,66669,All
2016,6,CHENNAI,PUNE,33530,33295,CHENNAI-PUNE,66825,All
2016,7,CHENNAI,PUNE,37233,38951,CHENNAI-PUNE,76184,All
2016,8,CHENNAI,PUNE,37309,38857,CHENNAI-PUNE,76166,All
2016,9,CHENNAI,PUNE,36700,37422,CHENNAI-PUNE,74122,All
2016,10,CHENNAI,PUNE,31513,37510,CHENNAI-PUNE,69023,All
2016,11,CHENNAI,PUNE,37615,37229,CHENNAI-PUNE,74844,All
2016,12,CHENNAI,PUNE,36788,37457,CHENNAI-PUNE,74245,All
2017,1,CHENNAI,PUNE,39168,39945,CHENNAI-PUNE,79113,All
2017,2,CHENNAI,PUNE,34580,35703,CHENNAI-PUNE,70283,All
2017,3,CHENNAI,PUNE,35631,38573,CHENNAI-PUNE,74204,All
2017,4,CHENNAI,PUNE,36839,40550,CHENNAI-PUNE,77389,All
2017,5,CHENNAI,PUNE,39695,43483,CHENNAI-PUNE,83178,All
2017,6,CHENNAI,PUNE,38193,39343,CHENNAI-PUNE,77536,All
2017,7,CHENNAI,PUNE,39393,41607,CHENNAI-PUNE,81000,All
2017,8,CHENNAI,PUNE,39344,40520,CHENNAI-PUNE,79864,All
2017,9,CHENNAI,PUNE,38840,37447,CHENNAI-PUNE,76287,All
2017,10,CHENNAI,PUNE,37104,41210,CHENNAI-PUNE,78314,All
2017,11,CHENNAI,PUNE,39872,40408,CHENNAI-PUNE,80280,All
2017,12,CHENNAI,PUNE,42466,42740,CHENNAI-PUNE,85206,All
2018,1,CHENNAI,PUNE,41904,42062,CHENNAI-PUNE,83966,All
2018,2,CHENNAI,PUNE,38280,38088,CHENNAI-PUNE,76368,All
2018,3,CHENNAI,PUNE,42180,42036,CHENNAI-PUNE,84216,All
2018,4,CHENNAI,PUNE,45258,44980,CHENNAI-PUNE,90238,All
2018,5,CHENNAI,PUNE,47345,48833,CHENNAI-PUNE,96178,All
2018,6,CHENNAI,PUNE,42232,41917,CHENNAI-PUNE,84149,All
2018,7,CHENNAI,PUNE,44483,44646,CHENNAI-PUNE,89129,All
2018,8,CHENNAI,PUNE,43931,44289,CHENNAI-PUNE,88220,All
2018,9,CHENNAI,PUNE,45229,42696,CHENNAI-PUNE,87925,All
2018,10,CHENNAI,PUNE,42731,43881,CHENNAI-PUNE,86612,All
2018,11,CHENNAI,PUNE,39706,40117,CHENNAI-PUNE,79823,All
2018,12,CHENNAI,PUNE,42938,43363,CHENNAI-PUNE,86301,All
2019,1,CHENNAI,PUNE,40350,41695,CHENNAI-PUNE,82045,All
2019,2,CHENNAI,PUNE,37216,37634,CHENNAI-PUNE,74850,All
2019,3,CHENNAI,PUNE,30991,30783,CHENNAI-PUNE,61774,All
2019,4,CHENNAI,PUNE,33395,33752,CHENNAI-PUNE,67147,All
2019,5,CHENNAI,PUNE,34691,35503,CHENNAI-PUNE,70194,All
2019,6,CHENNAI,PUNE,32678,32917,CHENNAI-PUNE,65595,All
2019,7,CHENNAI,PUNE,31289,32328,CHENNAI-PUNE,63617,All
2019,8,CHENNAI,PUNE,28548,29715,CHENNAI-PUNE,58263,All
2019,9,CHENNAI,PUNE,28546,28578,CHENNAI-PUNE,57124,All
2019,10,CHENNAI,PUNE,26503,29293,CHENNAI-PUNE,55796,All
2019,11,CHENNAI,PUNE,31390,30536,CHENNAI-PUNE,61926,All
2019,12,CHENNAI,PUNE,32666,33173,CHENNAI-PUNE,65839,All
2020,1,CHENNAI,PUNE,32405,32563,CHENNAI-PUNE,64968,All
2020,2,CHENNAI,PUNE,29327,30238,CHENNAI-PUNE,59565,All
2020,3,CHENNAI,PUNE,15050,16586,CHENNAI-PUNE,31636,All
2020,9,CHENNAI,PUNE,503,662,CHENNAI-PUNE,1165,All
2020,10,CHENNAI,PUNE,4645,4584,CHENNAI-PUNE,9229,All
2020,11,CHENNAI,PUNE,8151,10759,CHENNAI-PUNE,18910,All
2020,12,CHENNAI,PUNE,7195,7061,CHENNAI-PUNE,14256,All
2021,1,CHENNAI,PUNE,12022,11848,CHENNAI-PUNE,23870,All
2021,2,CHENNAI,PUNE,12696,12016,CHENNAI-PUNE,24712,All
2021,3,CHENNAI,PUNE,8470,7595,CHENNAI-PUNE,16065,All
2021,4,CHENNAI,PUNE,4585,5368,CHENNAI-PUNE,9953,All
2021,6,CHENNAI,PUNE,3220,2604,CHENNAI-PUNE,5824,All
2021,7,CHENNAI,PUNE,5904,6015,CHENNAI-PUNE,11919,All
2021,8,CHENNAI,PUNE,10006,10824,CHENNAI-PUNE,20830,All
2021,9,CHENNAI,PUNE,11206,11494,CHENNAI-PUNE,22700,All
2021,10,CHENNAI,PUNE,6974,6941,CHENNAI-PUNE,13915,All
2021,11,CHENNAI,PUNE,14068,14102,CHENNAI-PUNE,28170,All
2021,12,CHENNAI,PUNE,16564,17307,CHENNAI-PUNE,33871,All
2022,1,CHENNAI,PUNE,9311,10431,CHENNAI-PUNE,19742,All
2022,2,CHENNAI,PUNE,11607,12326,CHENNAI-PUNE,23933,All
2022,3,CHENNAI,PUNE,18553,19089,CHENNAI-PUNE,37642,All
2022,4,CHENNAI,PUNE,21294,22225,CHENNAI-PUNE,43519,All
2022,5,CHENNAI,PUNE,23638,24319,CHENNAI-PUNE,47957,All
2022,6,CHENNAI,PUNE,23780,22698,CHENNAI-PUNE,46478,All
2022,7,CHENNAI,PUNE,21225,21904,CHENNAI-PUNE,43129,All
2022,8,CHENNAI,PUNE,21105,22394,CHENNAI-PUNE,43499,All
2022,9,CHENNAI,PUNE,18851,19724,CHENNAI-PUNE,38575,All
2022,10,CHENNAI,PUNE,17914,20035,CHENNAI-PUNE,37949,All
2022,11,CHENNAI,PUNE,23165,21219,CHENNAI-PUNE,44384,All
2022,12,CHENNAI,PUNE,24191,23516,CHENNAI-PUNE,47707,All
2023,1,CHENNAI,PUNE,23113,23210,CHENNAI-PUNE,46323,All
2023,2,CHENNAI,PUNE,21731,21593,CHENNAI-PUNE,43324,All
2023,3,CHENNAI,PUNE,22478,22843,CHENNAI-PUNE,45321,All
2023,4,CHENNAI,PUNE,22824,22783,CHENNAI-PUNE,45607,All
2023,5,CHENNAI,PUNE,24077,24627,CHENNAI-PUNE,48704,All
2023,6,CHENNAI,PUNE,24100,23576,CHENNAI-PUNE,47676,All
2023,7,CHENNAI,PUNE,22129,23664,CHENNAI-PUNE,45793,All
2023,8,CHENNAI,PUNE,22541,22718,CHENNAI-PUNE,45259,All
2023,9,CHENNAI,PUNE,23034,22863,CHENNAI-PUNE,45897,All
2023,10,CHENNAI,PUNE,21131,22251,CHENNAI-PUNE,43382,All
2023,11,CHENNAI,PUNE,26404,25996,CHENNAI-PUNE,52400,All
2023,12,CHENNAI,PUNE,28569,29003,CHENNAI-PUNE,57572,All
2024,1,CHENNAI,PUNE,29458,32037,CHENNAI-PUNE,61495,All
2024,2,CHENNAI,PUNE,23704,25348,CHENNAI-PUNE,49052,All
2024,3,CHENNAI,PUNE,23200,24938,CHENNAI-PUNE,48138,All
2024,4,CHENNAI,PUNE,22391,23278,CHENNAI-PUNE,45669,All
2024,6,CHENNAI,PUNE,24207,24577,CHENNAI-PUNE,48784,All
2024,7,CHENNAI,PUNE,26066,27071,CHENNAI-PUNE,53137,All
2024,8,CHENNAI,PUNE,26642,26379,CHENNAI-PUNE,53021,All
2024,9,CHENNAI,PUNE,26501,26202,CHENNAI-PUNE,52703,All
2024,10,CHENNAI,PUNE,23590,26344,CHENNAI-PUNE,49934,All
2024,11,CHENNAI,PUNE,35383,32628,CHENNAI-PUNE,68011,All
2024,12,CHENNAI,PUNE,34250,35603,CHENNAI-PUNE,69853,All
2025,1,CHENNAI,PUNE,36614,37817,CHENNAI-PUNE,74431,All
2025,2,CHENNAI,PUNE,34079,33694,CHENNAI-PUNE,67773,All
2025,3,CHENNAI,PUNE,34434,34229,CHENNAI-PUNE,68663,All
2015,4,CHENNAI,RAIPUR,1403,1363,CHENNAI-RAIPUR,2766,All
2015,5,CHENNAI,RAIPUR,2047,2387,CHENNAI-RAIPUR,4434,All
2015,6,CHENNAI,RAIPUR,1333,1650,CHENNAI-RAIPUR,2983,All
2015,7,CHENNAI,RAIPUR,1032,1143,CHENNAI-RAIPUR,2175,All
2015,8,CHENNAI,RAIPUR,1481,1506,CHENNAI-RAIPUR,2987,All
2015,9,CHENNAI,RAIPUR,1267,1510,CHENNAI-RAIPUR,2777,All
2015,10,CHENNAI,RAIPUR,1701,1830,CHENNAI-RAIPUR,3531,All
2015,11,CHENNAI,RAIPUR,1675,1875,CHENNAI-RAIPUR,3550,All
2015,12,CHENNAI,RAIPUR,1378,1775,CHENNAI-RAIPUR,3153,All
2016,1,CHENNAI,RAIPUR,1962,2416,CHENNAI-RAIPUR,4378,All
2016,2,CHENNAI,RAIPUR,1385,1592,CHENNAI-RAIPUR,2977,All
2016,3,CHENNAI,RAIPUR,1291,1374,CHENNAI-RAIPUR,2665,All
2016,4,CHENNAI,RAIPUR,1267,1291,CHENNAI-RAIPUR,2558,All
2016,5,CHENNAI,RAIPUR,1306,1455,CHENNAI-RAIPUR,2761,All
2016,6,CHENNAI,RAIPUR,1210,1185,CHENNAI-RAIPUR,2395,All
2016,7,CHENNAI,RAIPUR,1268,1348,CHENNAI-RAIPUR,2616,All
2016,8,CHENNAI,RAIPUR,1225,1280,CHENNAI-RAIPUR,2505,All
2016,9,CHENNAI,RAIPUR,1221,1214,CHENNAI-RAIPUR,2435,All
2016,10,CHENNAI,RAIPUR,1278,1188,CHENNAI-RAIPUR,2466,All
2016,11,CHENNAI,RAIPUR,1370,1079,CHENNAI-RAIPUR,2449,All
2016,12,CHENNAI,RAIPUR,1619,311,CHENNAI-RAIPUR,1930,All
2017,1,CHENNAI,RAIPUR,1640,0,CHENNAI-RAIPUR,1640,All
2017,2,CHENNAI,RAIPUR,1254,0,CHENNAI-RAIPUR,1254,All
2017,3,CHENNAI,RAIPUR,920,0,CHENNAI-RAIPUR,920,All
2017,4,CHENNAI,RAIPUR,1057,0,CHENNAI-RAIPUR,1057,All
2017,5,CHENNAI,RAIPUR,1190,0,CHENNAI-RAIPUR,1190,All
2017,6,CHENNAI,RAIPUR,903,0,CHENNAI-RAIPUR,903,All
2017,7,CHENNAI,RAIPUR,880,0,CHENNAI-RAIPUR,880,All
2017,8,CHENNAI,RAIPUR,943,0,CHENNAI-RAIPUR,943,All
2017,9,CHENNAI,RAIPUR,1153,0,CHENNAI-RAIPUR,1153,All
2017,10,CHENNAI,RAIPUR,1048,0,CHENNAI-RAIPUR,1048,All
2017,11,CHENNAI,RAIPUR,1468,0,CHENNAI-RAIPUR,1468,All
2017,12,CHENNAI,RAIPUR,1890,0,CHENNAI-RAIPUR,1890,All
2018,1,CHENNAI,RAIPUR,1366,0,CHENNAI-RAIPUR,1366,All
2018,2,CHENNAI,RAIPUR,1471,0,CHENNAI-RAIPUR,1471,All
2018,3,CHENNAI,RAIPUR,1496,0,CHENNAI-RAIPUR,1496,All
2018,4,CHENNAI,RAIPUR,1566,0,CHENNAI-RAIPUR,1566,All
2018,5,CHENNAI,RAIPUR,1941,0,CHENNAI-RAIPUR,1941,All
2018,6,CHENNAI,RAIPUR,1937,0,CHENNAI-RAIPUR,1937,All
2018,7,CHENNAI,RAIPUR,1090,0,CHENNAI-RAIPUR,1090,All
2018,8,CHENNAI,RAIPUR,1129,0,CHENNAI-RAIPUR,1129,All
2018,9,CHENNAI,RAIPUR,1245,0,CHENNAI-RAIPUR,1245,All
2018,10,CHENNAI,RAIPUR,1111,42,CHENNAI-RAIPUR,1153,All
2018,11,CHENNAI,RAIPUR,873,188,CHENNAI-RAIPUR,1061,All
2018,12,CHENNAI,RAIPUR,1011,413,CHENNAI-RAIPUR,1424,All
2019,1,CHENNAI,RAIPUR,0,390,CHENNAI-RAIPUR,390,All
2019,2,CHENNAI,RAIPUR,0,326,CHENNAI-RAIPUR,326,All
2019,4,CHENNAI,RAIPUR,3333,3238,CHENNAI-RAIPUR,6571,All
2019,5,CHENNAI,RAIPUR,5072,5427,CHENNAI-RAIPUR,10499,All
2019,6,CHENNAI,RAIPUR,4740,4917,CHENNAI-RAIPUR,9657,All
2019,7,CHENNAI,RAIPUR,3903,4288,CHENNAI-RAIPUR,8191,All
2019,8,CHENNAI,RAIPUR,4072,4133,CHENNAI-RAIPUR,8205,All
2019,10,CHENNAI,RAIPUR,4117,3692,CHENNAI-RAIPUR,7809,All
2019,11,CHENNAI,RAIPUR,3988,3460,CHENNAI-RAIPUR,7448,All
2019,12,CHENNAI,RAIPUR,3983,3841,CHENNAI-RAIPUR,7824,All
2020,1,CHENNAI,RAIPUR,3625,3205,CHENNAI-RAIPUR,6830,All
2020,2,CHENNAI,RAIPUR,4180,3651,CHENNAI-RAIPUR,7831,All
2020,3,CHENNAI,RAIPUR,3407,2328,CHENNAI-RAIPUR,5735,All
2020,12,CHENNAI,RAIPUR,859,1140,CHENNAI-RAIPUR,1999,All
2021,1,CHENNAI,RAIPUR,2123,3209,CHENNAI-RAIPUR,5332,All
2021,2,CHENNAI,RAIPUR,2389,3011,CHENNAI-RAIPUR,5400,All
2021,3,CHENNAI,RAIPUR,1812,2159,CHENNAI-RAIPUR,3971,All
2021,4,CHENNAI,RAIPUR,684,594,CHENNAI-RAIPUR,1278,All
2021,10,CHENNAI,RAIPUR,388,191,CHENNAI-RAIPUR,579,All
2021,11,CHENNAI,RAIPUR,2269,1827,CHENNAI-RAIPUR,4096,All
2021,12,CHENNAI,RAIPUR,2431,1758,CHENNAI-RAIPUR,4189,All
2022,1,CHENNAI,RAIPUR,1641,1265,CHENNAI-RAIPUR,2906,All
2022,2,CHENNAI,RAIPUR,1866,2061,CHENNAI-RAIPUR,3927,All
2022,3,CHENNAI,RAIPUR,2803,2749,CHENNAI-RAIPUR,5552,All
2022,4,CHENNAI,RAIPUR,2585,2677,CHENNAI-RAIPUR,5262,All
2022,5,CHENNAI,RAIPUR,2783,3006,CHENNAI-RAIPUR,5789,All
2022,6,CHENNAI,RAIPUR,2922,3116,CHENNAI-RAIPUR,6038,All
2022,7,CHENNAI,RAIPUR,2557,2759,CHENNAI-RAIPUR,5316,All
2022,8,CHENNAI,RAIPUR,2753,2817,CHENNAI-RAIPUR,5570,All
2022,9,CHENNAI,RAIPUR,2635,2588,CHENNAI-RAIPUR,5223,All
2022,10,CHENNAI,RAIPUR,3159,2965,CHENNAI-RAIPUR,6124,All
2022,11,CHENNAI,RAIPUR,2535,2368,CHENNAI-RAIPUR,4903,All
2022,12,CHENNAI,RAIPUR,2426,2394,CHENNAI-RAIPUR,4820,All
2023,1,CHENNAI,RAIPUR,2188,2197,CHENNAI-RAIPUR,4385,All
2023,2,CHENNAI,RAIPUR,1846,1735,CHENNAI-RAIPUR,3581,All
2023,3,CHENNAI,RAIPUR,1905,1838,CHENNAI-RAIPUR,3743,All
2023,4,CHENNAI,RAIPUR,2009,1981,CHENNAI-RAIPUR,3990,All
2023,5,CHENNAI,RAIPUR,1965,2100,CHENNAI-RAIPUR,4065,All
2023,6,CHENNAI,RAIPUR,2048,2083,CHENNAI-RAIPUR,4131,All
2023,7,CHENNAI,RAIPUR,1921,2201,CHENNAI-RAIPUR,4122,All
2023,8,CHENNAI,RAIPUR,2157,2126,CHENNAI-RAIPUR,4283,All
2023,9,CHENNAI,RAIPUR,2100,2064,CHENNAI-RAIPUR,4164,All
2023,10,CHENNAI,RAIPUR,2098,1919,CHENNAI-RAIPUR,4017,All
2023,11,CHENNAI,RAIPUR,1906,1761,CHENNAI-RAIPUR,3667,All
2023,12,CHENNAI,RAIPUR,2560,2539,CHENNAI-RAIPUR,5099,All
2024,1,CHENNAI,RAIPUR,2507,2572,CHENNAI-RAIPUR,5079,All
2024,2,CHENNAI,RAIPUR,2348,2303,CHENNAI-RAIPUR,4651,All
2024,3,CHENNAI,RAIPUR,2329,2147,CHENNAI-RAIPUR,4476,All
2024,4,CHENNAI,RAIPUR,2451,2501,CHENNAI-RAIPUR,4952,All
2024,6,CHENNAI,RAIPUR,2740,2697,CHENNAI-RAIPUR,5437,All
2024,7,CHENNAI,RAIPUR,2936,3182,CHENNAI-RAIPUR,6118,All
2024,8,CHENNAI,RAIPUR,2796,3005,CHENNAI-RAIPUR,5801,All
2024,9,CHENNAI,RAIPUR,2640,2624,CHENNAI-RAIPUR,5264,All
2024,10,CHENNAI,RAIPUR,3238,2539,CHENNAI-RAIPUR,5777,All
2024,11,CHENNAI,RAIPUR,4466,4725,CHENNAI-RAIPUR,9191,All
2024,12,CHENNAI,RAIPUR,5066,4782,CHENNAI-RAIPUR,9848,All
2025,1,CHENNAI,RAIPUR,4582,4397,CHENNAI-RAIPUR,8979,All
2025,2,CHENNAI,RAIPUR,4622,4356,CHENNAI-RAIPUR,8978,All
2025,3,CHENNAI,RAIPUR,4688,4125,CHENNAI-RAIPUR,8813,All
2015,7,CHENNAI,RAJAHMUNDRY,653,671,CHENNAI-RAJAHMUNDRY,1324,All
2016,3,CHENNAI,RAJAHMUNDRY,258,296,CHENNAI-RAJAHMUNDRY,554,All
2016,4,CHENNAI,RAJAHMUNDRY,1673,1821,CHENNAI-RAJAHMUNDRY,3494,All
2016,5,CHENNAI,RAJAHMUNDRY,1501,1821,CHENNAI-RAJAHMUNDRY,3322,All
2016,6,CHENNAI,RAJAHMUNDRY,1389,1444,CHENNAI-RAJAHMUNDRY,2833,All
2016,7,CHENNAI,RAJAHMUNDRY,1216,1367,CHENNAI-RAJAHMUNDRY,2583,All
2016,8,CHENNAI,RAJAHMUNDRY,1262,1536,CHENNAI-RAJAHMUNDRY,2798,All
2016,9,CHENNAI,RAJAHMUNDRY,1045,1291,CHENNAI-RAJAHMUNDRY,2336,All
2016,10,CHENNAI,RAJAHMUNDRY,1356,1615,CHENNAI-RAJAHMUNDRY,2971,All
2016,11,CHENNAI,RAJAHMUNDRY,1080,1476,CHENNAI-RAJAHMUNDRY,2556,All
2016,12,CHENNAI,RAJAHMUNDRY,1635,1616,CHENNAI-RAJAHMUNDRY,3251,All
2017,1,CHENNAI,RAJAHMUNDRY,1973,2231,CHENNAI-RAJAHMUNDRY,4204,All
2017,2,CHENNAI,RAJAHMUNDRY,1291,1327,CHENNAI-RAJAHMUNDRY,2618,All
2017,3,CHENNAI,RAJAHMUNDRY,882,914,CHENNAI-RAJAHMUNDRY,1796,All
2017,4,CHENNAI,RAJAHMUNDRY,1108,1139,CHENNAI-RAJAHMUNDRY,2247,All
2017,6,CHENNAI,RAJAHMUNDRY,0,114,CHENNAI-RAJAHMUNDRY,114,All
2017,10,CHENNAI,RAJAHMUNDRY,0,12,CHENNAI-RAJAHMUNDRY,12,All
2017,11,CHENNAI,RAJAHMUNDRY,0,54,CHENNAI-RAJAHMUNDRY,54,All
2018,1,CHENNAI,RAJAHMUNDRY,953,1243,CHENNAI-RAJAHMUNDRY,2196,All
2018,2,CHENNAI,RAJAHMUNDRY,1204,1399,CHENNAI-RAJAHMUNDRY,2603,All
2018,3,CHENNAI,RAJAHMUNDRY,1408,1595,CHENNAI-RAJAHMUNDRY,3003,All
2018,4,CHENNAI,RAJAHMUNDRY,1666,1752,CHENNAI-RAJAHMUNDRY,3418,All
2018,5,CHENNAI,RAJAHMUNDRY,2322,2144,CHENNAI-RAJAHMUNDRY,4466,All
2018,6,CHENNAI,RAJAHMUNDRY,1794,1836,CHENNAI-RAJAHMUNDRY,3630,All
2018,7,CHENNAI,RAJAHMUNDRY,2598,3385,CHENNAI-RAJAHMUNDRY,5983,All
2018,8,CHENNAI,RAJAHMUNDRY,2682,2868,CHENNAI-RAJAHMUNDRY,5550,All
2018,9,CHENNAI,RAJAHMUNDRY,2615,3028,CHENNAI-RAJAHMUNDRY,5643,All
2018,10,CHENNAI,RAJAHMUNDRY,2576,2781,CHENNAI-RAJAHMUNDRY,5357,All
2018,11,CHENNAI,RAJAHMUNDRY,1377,1691,CHENNAI-RAJAHMUNDRY,3068,All
2018,12,CHENNAI,RAJAHMUNDRY,1803,1867,CHENNAI-RAJAHMUNDRY,3670,All
2019,1,CHENNAI,RAJAHMUNDRY,1621,1747,CHENNAI-RAJAHMUNDRY,3368,All
2019,2,CHENNAI,RAJAHMUNDRY,1740,1760,CHENNAI-RAJAHMUNDRY,3500,All
2019,3,CHENNAI,RAJAHMUNDRY,1751,1864,CHENNAI-RAJAHMUNDRY,3615,All
2019,4,CHENNAI,RAJAHMUNDRY,1742,1799,CHENNAI-RAJAHMUNDRY,3541,All
2019,5,CHENNAI,RAJAHMUNDRY,1895,2029,CHENNAI-RAJAHMUNDRY,3924,All
2019,6,CHENNAI,RAJAHMUNDRY,1878,1877,CHENNAI-RAJAHMUNDRY,3755,All
2019,7,CHENNAI,RAJAHMUNDRY,1831,1807,CHENNAI-RAJAHMUNDRY,3638,All
2019,8,CHENNAI,RAJAHMUNDRY,1881,1914,CHENNAI-RAJAHMUNDRY,3795,All
2019,9,CHENNAI,RAJAHMUNDRY,1587,1716,CHENNAI-RAJAHMUNDRY,3303,All
2019,10,CHENNAI,RAJAHMUNDRY,1990,2045,CHENNAI-RAJAHMUNDRY,4035,All
2019,11,CHENNAI,RAJAHMUNDRY,1870,2009,CHENNAI-RAJAHMUNDRY,3879,All
2019,12,CHENNAI,RAJAHMUNDRY,1729,1901,CHENNAI-RAJAHMUNDRY,3630,All
2020,1,CHENNAI,RAJAHMUNDRY,1831,2063,CHENNAI-RAJAHMUNDRY,3894,All
2020,2,CHENNAI,RAJAHMUNDRY,1711,1957,CHENNAI-RAJAHMUNDRY,3668,All
2020,3,CHENNAI,RAJAHMUNDRY,1222,1101,CHENNAI-RAJAHMUNDRY,2323,All
2020,5,CHENNAI,RAJAHMUNDRY,208,136,CHENNAI-RAJAHMUNDRY,344,All
2020,6,CHENNAI,RAJAHMUNDRY,402,172,CHENNAI-RAJAHMUNDRY,574,All
2020,12,CHENNAI,RAJAHMUNDRY,1017,854,CHENNAI-RAJAHMUNDRY,1871,All
2021,1,CHENNAI,RAJAHMUNDRY,1596,1688,CHENNAI-RAJAHMUNDRY,3284,All
2021,2,CHENNAI,RAJAHMUNDRY,1370,1498,CHENNAI-RAJAHMUNDRY,2868,All
2021,3,CHENNAI,RAJAHMUNDRY,1195,1126,CHENNAI-RAJAHMUNDRY,2321,All
2021,4,CHENNAI,RAJAHMUNDRY,903,1106,CHENNAI-RAJAHMUNDRY,2009,All
2021,8,CHENNAI,RAJAHMUNDRY,774,979,CHENNAI-RAJAHMUNDRY,1753,All
2021,9,CHENNAI,RAJAHMUNDRY,694,1108,CHENNAI-RAJAHMUNDRY,1802,All
2021,10,CHENNAI,RAJAHMUNDRY,1289,1607,CHENNAI-RAJAHMUNDRY,2896,All
2021,11,CHENNAI,RAJAHMUNDRY,1894,2182,CHENNAI-RAJAHMUNDRY,4076,All
2021,12,CHENNAI,RAJAHMUNDRY,2352,2334,CHENNAI-RAJAHMUNDRY,4686,All
2022,1,CHENNAI,RAJAHMUNDRY,1129,1568,CHENNAI-RAJAHMUNDRY,2697,All
2022,2,CHENNAI,RAJAHMUNDRY,1120,1898,CHENNAI-RAJAHMUNDRY,3018,All
2022,3,CHENNAI,RAJAHMUNDRY,1687,1925,CHENNAI-RAJAHMUNDRY,3612,All
2022,4,CHENNAI,RAJAHMUNDRY,1355,1560,CHENNAI-RAJAHMUNDRY,2915,All
2022,5,CHENNAI,RAJAHMUNDRY,1435,1649,CHENNAI-RAJAHMUNDRY,3084,All
2022,6,CHENNAI,RAJAHMUNDRY,2436,2558,CHENNAI-RAJAHMUNDRY,4994,All
2022,7,CHENNAI,RAJAHMUNDRY,1800,2030,CHENNAI-RAJAHMUNDRY,3830,All
2022,8,CHENNAI,RAJAHMUNDRY,2575,2926,CHENNAI-RAJAHMUNDRY,5501,All
2022,9,CHENNAI,RAJAHMUNDRY,2373,2501,CHENNAI-RAJAHMUNDRY,4874,All
2022,10,CHENNAI,RAJAHMUNDRY,2384,2634,CHENNAI-RAJAHMUNDRY,5018,All
2022,11,CHENNAI,RAJAHMUNDRY,1607,2007,CHENNAI-RAJAHMUNDRY,3614,All
2022,12,CHENNAI,RAJAHMUNDRY,1787,1979,CHENNAI-RAJAHMUNDRY,3766,All
2023,1,CHENNAI,RAJAHMUNDRY,1592,2031,CHENNAI-RAJAHMUNDRY,3623,All
2023,2,CHENNAI,RAJAHMUNDRY,1604,1752,CHENNAI-RAJAHMUNDRY,3356,All
2023,3,CHENNAI,RAJAHMUNDRY,1771,1770,CHENNAI-RAJAHMUNDRY,3541,All
2023,4,CHENNAI,RAJAHMUNDRY,1702,1896,CHENNAI-RAJAHMUNDRY,3598,All
2023,5,CHENNAI,RAJAHMUNDRY,1971,2125,CHENNAI-RAJAHMUNDRY,4096,All
2023,6,CHENNAI,RAJAHMUNDRY,1887,2032,CHENNAI-RAJAHMUNDRY,3919,All
2023,7,CHENNAI,RAJAHMUNDRY,1757,2081,CHENNAI-RAJAHMUNDRY,3838,All
2023,8,CHENNAI,RAJAHMUNDRY,1977,2104,CHENNAI-RAJAHMUNDRY,4081,All
2023,9,CHENNAI,RAJAHMUNDRY,1810,2027,CHENNAI-RAJAHMUNDRY,3837,All
2023,10,CHENNAI,RAJAHMUNDRY,1940,2000,CHENNAI-RAJAHMUNDRY,3940,All
2023,11,CHENNAI,RAJAHMUNDRY,1850,1876,CHENNAI-RAJAHMUNDRY,3726,All
2023,12,CHENNAI,RAJAHMUNDRY,1971,1993,CHENNAI-RAJAHMUNDRY,3964,All
2024,1,CHENNAI,RAJAHMUNDRY,1973,2222,CHENNAI-RAJAHMUNDRY,4195,All
2024,2,CHENNAI,RAJAHMUNDRY,1824,1981,CHENNAI-RAJAHMUNDRY,3805,All
2024,3,CHENNAI,RAJAHMUNDRY,1892,1973,CHENNAI-RAJAHMUNDRY,3865,All
2024,4,CHENNAI,RAJAHMUNDRY,2088,1921,CHENNAI-RAJAHMUNDRY,4009,All
2024,6,CHENNAI,RAJAHMUNDRY,2085,2017,CHENNAI-RAJAHMUNDRY,4102,All
2024,7,CHENNAI,RAJAHMUNDRY,1779,1793,CHENNAI-RAJAHMUNDRY,3572,All
2024,8,CHENNAI,RAJAHMUNDRY,1826,1878,CHENNAI-RAJAHMUNDRY,3704,All
2024,9,CHENNAI,RAJAHMUNDRY,1785,1632,CHENNAI-RAJAHMUNDRY,3417,All
2024,10,CHENNAI,RAJAHMUNDRY,1967,1748,CHENNAI-RAJAHMUNDRY,3715,All
2024,11,CHENNAI,RAJAHMUNDRY,1825,1936,CHENNAI-RAJAHMUNDRY,3761,All
2024,12,CHENNAI,RAJAHMUNDRY,2182,2117,CHENNAI-RAJAHMUNDRY,4299,All
2025,1,CHENNAI,RAJAHMUNDRY,2117,2263,CHENNAI-RAJAHMUNDRY,4380,All
2025,2,CHENNAI,RAJAHMUNDRY,1890,1896,CHENNAI-RAJAHMUNDRY,3786,All
2025,3,CHENNAI,RAJAHMUNDRY,1974,1918,CHENNAI-RAJAHMUNDRY,3892,All
2017,10,CHENNAI,RAJKOT,4,5,CHENNAI-RAJKOT,9,All
2017,11,CHENNAI,RAJKOT,66,95,CHENNAI-RAJKOT,161,All
2017,12,CHENNAI,RAJKOT,143,41,CHENNAI-RAJKOT,184,All
2018,1,CHENNAI,RAJKOT,78,0,CHENNAI-RAJKOT,78,All
2018,2,CHENNAI,RAJKOT,105,41,CHENNAI-RAJKOT,146,All
2018,3,CHENNAI,RAJKOT,94,96,CHENNAI-RAJKOT,190,All
2022,6,CHENNAI,RAJKOT,0,29,CHENNAI-RAJKOT,29,All
2020,11,CHENNAI,RANCHI,1150,1469,CHENNAI-RANCHI,2619,All
2020,12,CHENNAI,RANCHI,4233,5349,CHENNAI-RANCHI,9582,All
2021,1,CHENNAI,RANCHI,4274,5505,CHENNAI-RANCHI,9779,All
2021,2,CHENNAI,RANCHI,4347,5107,CHENNAI-RANCHI,9454,All
2021,3,CHENNAI,RANCHI,5490,4930,CHENNAI-RANCHI,10420,All
2021,4,CHENNAI,RANCHI,4381,2664,CHENNAI-RANCHI,7045,All
2021,6,CHENNAI,RANCHI,564,732,CHENNAI-RANCHI,1296,All
2021,7,CHENNAI,RANCHI,2229,2337,CHENNAI-RANCHI,4566,All
2021,8,CHENNAI,RANCHI,2764,2892,CHENNAI-RANCHI,5656,All
2021,9,CHENNAI,RANCHI,3883,3839,CHENNAI-RANCHI,7722,All
2021,10,CHENNAI,RANCHI,5024,4349,CHENNAI-RANCHI,9373,All
2021,11,CHENNAI,RANCHI,7342,6751,CHENNAI-RANCHI,14093,All
2021,12,CHENNAI,RANCHI,6796,7995,CHENNAI-RANCHI,14791,All
2022,1,CHENNAI,RANCHI,4140,4236,CHENNAI-RANCHI,8376,All
2022,2,CHENNAI,RANCHI,3626,4463,CHENNAI-RANCHI,8089,All
2022,3,CHENNAI,RANCHI,3796,4187,CHENNAI-RANCHI,7983,All
2022,4,CHENNAI,RANCHI,3392,3653,CHENNAI-RANCHI,7045,All
2022,5,CHENNAI,RANCHI,3229,3845,CHENNAI-RANCHI,7074,All
2022,6,CHENNAI,RANCHI,3239,3903,CHENNAI-RANCHI,7142,All
2022,7,CHENNAI,RANCHI,3053,4124,CHENNAI-RANCHI,7177,All
2022,8,CHENNAI,RANCHI,2675,3792,CHENNAI-RANCHI,6467,All
2022,9,CHENNAI,RANCHI,3512,4009,CHENNAI-RANCHI,7521,All
2022,10,CHENNAI,RANCHI,4782,4867,CHENNAI-RANCHI,9649,All
2022,11,CHENNAI,RANCHI,4043,4613,CHENNAI-RANCHI,8656,All
2022,12,CHENNAI,RANCHI,3890,4153,CHENNAI-RANCHI,8043,All
2023,1,CHENNAI,RANCHI,4051,4519,CHENNAI-RANCHI,8570,All
2023,2,CHENNAI,RANCHI,3833,3657,CHENNAI-RANCHI,7490,All
2023,3,CHENNAI,RANCHI,4180,4166,CHENNAI-RANCHI,8346,All
2023,4,CHENNAI,RANCHI,4865,4442,CHENNAI-RANCHI,9307,All
2023,5,CHENNAI,RANCHI,4769,5166,CHENNAI-RANCHI,9935,All
2023,6,CHENNAI,RANCHI,5067,5030,CHENNAI-RANCHI,10097,All
2023,7,CHENNAI,RANCHI,4535,4835,CHENNAI-RANCHI,9370,All
2023,8,CHENNAI,RANCHI,4776,4836,CHENNAI-RANCHI,9612,All
2023,9,CHENNAI,RANCHI,4938,4951,CHENNAI-RANCHI,9889,All
2023,10,CHENNAI,RANCHI,5657,5058,CHENNAI-RANCHI,10715,All
2023,11,CHENNAI,RANCHI,6450,5589,CHENNAI-RANCHI,12039,All
2023,12,CHENNAI,RANCHI,6127,6480,CHENNAI-RANCHI,12607,All
2024,1,CHENNAI,RANCHI,7687,7351,CHENNAI-RANCHI,15038,All
2024,2,CHENNAI,RANCHI,6073,5894,CHENNAI-RANCHI,11967,All
2024,3,CHENNAI,RANCHI,6535,5819,CHENNAI-RANCHI,12354,All
2024,4,CHENNAI,RANCHI,5087,4805,CHENNAI-RANCHI,9892,All
2024,6,CHENNAI,RANCHI,5007,5035,CHENNAI-RANCHI,10042,All
2024,7,CHENNAI,RANCHI,4562,5273,CHENNAI-RANCHI,9835,All
2024,8,CHENNAI,RANCHI,4808,4956,CHENNAI-RANCHI,9764,All
2024,9,CHENNAI,RANCHI,4725,4283,CHENNAI-RANCHI,9008,All
2024,10,CHENNAI,RANCHI,5571,4637,CHENNAI-RANCHI,10208,All
2024,11,CHENNAI,RANCHI,4845,4908,CHENNAI-RANCHI,9753,All
2024,12,CHENNAI,RANCHI,5281,5289,CHENNAI-RANCHI,10570,All
2025,1,CHENNAI,RANCHI,5261,5192,CHENNAI-RANCHI,10453,All
2025,2,CHENNAI,RANCHI,5201,4788,CHENNAI-RANCHI,9989,All
2025,3,CHENNAI,RANCHI,5608,4670,CHENNAI-RANCHI,10278,All
2018,3,CHENNAI,SALEM,401,443,CHENNAI-SALEM,844,All
2018,4,CHENNAI,SALEM,1955,1992,CHENNAI-SALEM,3947,All
2018,5,CHENNAI,SALEM,1918,1884,CHENNAI-SALEM,3802,All
2018,6,CHENNAI,SALEM,1647,1695,CHENNAI-SALEM,3342,All
2018,7,CHENNAI,SALEM,1583,1615,CHENNAI-SALEM,3198,All
2018,8,CHENNAI,SALEM,1644,1674,CHENNAI-SALEM,3318,All
2018,9,CHENNAI,SALEM,1539,1649,CHENNAI-SALEM,3188,All
2018,10,CHENNAI,SALEM,1715,1699,CHENNAI-SALEM,3414,All
2018,11,CHENNAI,SALEM,1580,1554,CHENNAI-SALEM,3134,All
2018,12,CHENNAI,SALEM,1800,1764,CHENNAI-SALEM,3564,All
2019,1,CHENNAI,SALEM,1744,1795,CHENNAI-SALEM,3539,All
2019,2,CHENNAI,SALEM,1522,1503,CHENNAI-SALEM,3025,All
2019,3,CHENNAI,SALEM,1673,1660,CHENNAI-SALEM,3333,All
2019,4,CHENNAI,SALEM,1629,1638,CHENNAI-SALEM,3267,All
2019,5,CHENNAI,SALEM,1815,1771,CHENNAI-SALEM,3586,All
2019,6,CHENNAI,SALEM,1692,1760,CHENNAI-SALEM,3452,All
2019,7,CHENNAI,SALEM,1551,1630,CHENNAI-SALEM,3181,All
2019,8,CHENNAI,SALEM,1610,1534,CHENNAI-SALEM,3144,All
2019,9,CHENNAI,SALEM,1471,1543,CHENNAI-SALEM,3014,All
2019,10,CHENNAI,SALEM,1680,1593,CHENNAI-SALEM,3273,All
2019,11,CHENNAI,SALEM,1575,1706,CHENNAI-SALEM,3281,All
2019,12,CHENNAI,SALEM,1759,1759,CHENNAI-SALEM,3518,All
2020,1,CHENNAI,SALEM,1445,1496,CHENNAI-SALEM,2941,All
2020,2,CHENNAI,SALEM,1557,1682,CHENNAI-SALEM,3239,All
2020,3,CHENNAI,SALEM,1167,1131,CHENNAI-SALEM,2298,All
2020,5,CHENNAI,SALEM,185,152,CHENNAI-SALEM,337,All
2020,6,CHENNAI,SALEM,915,447,CHENNAI-SALEM,1362,All
2020,7,CHENNAI,SALEM,375,472,CHENNAI-SALEM,847,All
2020,8,CHENNAI,SALEM,494,580,CHENNAI-SALEM,1074,All
2020,9,CHENNAI,SALEM,227,323,CHENNAI-SALEM,550,All
2020,10,CHENNAI,SALEM,691,725,CHENNAI-SALEM,1416,All
2020,11,CHENNAI,SALEM,624,689,CHENNAI-SALEM,1313,All
2020,12,CHENNAI,SALEM,1200,1367,CHENNAI-SALEM,2567,All
2021,1,CHENNAI,SALEM,1394,1687,CHENNAI-SALEM,3081,All
2021,2,CHENNAI,SALEM,1522,1734,CHENNAI-SALEM,3256,All
2021,3,CHENNAI,SALEM,1544,1837,CHENNAI-SALEM,3381,All
2021,4,CHENNAI,SALEM,1065,1187,CHENNAI-SALEM,2252,All
2021,6,CHENNAI,SALEM,22,22,CHENNAI-SALEM,44,All
2023,10,CHENNAI,SALEM,132,179,CHENNAI-SALEM,311,All
2023,11,CHENNAI,SALEM,1882,1916,CHENNAI-SALEM,3798,All
2023,12,CHENNAI,SALEM,1831,1830,CHENNAI-SALEM,3661,All
2024,1,CHENNAI,SALEM,1864,2016,CHENNAI-SALEM,3880,All
2024,2,CHENNAI,SALEM,1650,1800,CHENNAI-SALEM,3450,All
2024,3,CHENNAI,SALEM,1661,1840,CHENNAI-SALEM,3501,All
2024,4,CHENNAI,SALEM,1537,1789,CHENNAI-SALEM,3326,All
2024,6,CHENNAI,SALEM,1761,2066,CHENNAI-SALEM,3827,All
2024,7,CHENNAI,SALEM,1825,2057,CHENNAI-SALEM,3882,All
2024,8,CHENNAI,SALEM,1903,2179,CHENNAI-SALEM,4082,All
2024,9,CHENNAI,SALEM,1618,1968,CHENNAI-SALEM,3586,All
2024,10,CHENNAI,SALEM,1615,1532,CHENNAI-SALEM,3147,All
2024,11,CHENNAI,SALEM,1600,1812,CHENNAI-SALEM,3412,All
2024,12,CHENNAI,SALEM,1803,1833,CHENNAI-SALEM,3636,All
2025,1,CHENNAI,SALEM,1643,1942,CHENNAI-SALEM,3585,All
2025,2,CHENNAI,SALEM,1616,1839,CHENNAI-SALEM,3455,All
2025,3,CHENNAI,SALEM,1682,1961,CHENNAI-SALEM,3643,All
2019,1,CHENNAI,SHIRDI,3944,3951,CHENNAI-SHIRDI,7895,All
2019,2,CHENNAI,SHIRDI,5229,5233,CHENNAI-SHIRDI,10462,All
2019,3,CHENNAI,SHIRDI,5797,5739,CHENNAI-SHIRDI,11536,All
2019,4,CHENNAI,SHIRDI,5011,4883,CHENNAI-SHIRDI,9894,All
2019,5,CHENNAI,SHIRDI,5027,5080,CHENNAI-SHIRDI,10107,All
2019,6,CHENNAI,SHIRDI,4821,4888,CHENNAI-SHIRDI,9709,All
2019,7,CHENNAI,SHIRDI,5188,5190,CHENNAI-SHIRDI,10378,All
2019,8,CHENNAI,SHIRDI,5208,5208,CHENNAI-SHIRDI,10416,All
2019,9,CHENNAI,SHIRDI,5808,5649,CHENNAI-SHIRDI,11457,All
2019,10,CHENNAI,SHIRDI,7541,7764,CHENNAI-SHIRDI,15305,All
2019,11,CHENNAI,SHIRDI,3313,2892,CHENNAI-SHIRDI,6205,All
2019,12,CHENNAI,SHIRDI,5357,4868,CHENNAI-SHIRDI,10225,All
2020,1,CHENNAI,SHIRDI,9516,9483,CHENNAI-SHIRDI,18999,All
2020,2,CHENNAI,SHIRDI,6883,6516,CHENNAI-SHIRDI,13399,All
2020,3,CHENNAI,SHIRDI,4966,5211,CHENNAI-SHIRDI,10177,All
2020,12,CHENNAI,SHIRDI,1165,1049,CHENNAI-SHIRDI,2214,All
2021,1,CHENNAI,SHIRDI,3526,3412,CHENNAI-SHIRDI,6938,All
2021,2,CHENNAI,SHIRDI,3650,2990,CHENNAI-SHIRDI,6640,All
2021,3,CHENNAI,SHIRDI,2475,2380,CHENNAI-SHIRDI,4855,All
2021,4,CHENNAI,SHIRDI,447,714,CHENNAI-SHIRDI,1161,All
2021,10,CHENNAI,SHIRDI,2302,2436,CHENNAI-SHIRDI,4738,All
2021,11,CHENNAI,SHIRDI,3215,3367,CHENNAI-SHIRDI,6582,All
2021,12,CHENNAI,SHIRDI,4653,4419,CHENNAI-SHIRDI,9072,All
2022,1,CHENNAI,SHIRDI,1887,1994,CHENNAI-SHIRDI,3881,All
2022,2,CHENNAI,SHIRDI,2615,2667,CHENNAI-SHIRDI,5282,All
2022,3,CHENNAI,SHIRDI,5544,5250,CHENNAI-SHIRDI,10794,All
2022,4,CHENNAI,SHIRDI,6403,6023,CHENNAI-SHIRDI,12426,All
2022,5,CHENNAI,SHIRDI,6732,6469,CHENNAI-SHIRDI,13201,All
2022,6,CHENNAI,SHIRDI,5656,5322,CHENNAI-SHIRDI,10978,All
2022,7,CHENNAI,SHIRDI,6265,6253,CHENNAI-SHIRDI,12518,All
2022,8,CHENNAI,SHIRDI,7036,6720,CHENNAI-SHIRDI,13756,All
2022,9,CHENNAI,SHIRDI,6527,6041,CHENNAI-SHIRDI,12568,All
2022,10,CHENNAI,SHIRDI,5802,5740,CHENNAI-SHIRDI,11542,All
2022,11,CHENNAI,SHIRDI,7053,6644,CHENNAI-SHIRDI,13697,All
2022,12,CHENNAI,SHIRDI,7090,7245,CHENNAI-SHIRDI,14335,All
2023,1,CHENNAI,SHIRDI,7856,8009,CHENNAI-SHIRDI,15865,All
2023,2,CHENNAI,SHIRDI,7711,7576,CHENNAI-SHIRDI,15287,All
2023,3,CHENNAI,SHIRDI,8033,7717,CHENNAI-SHIRDI,15750,All
2023,4,CHENNAI,SHIRDI,6755,6610,CHENNAI-SHIRDI,13365,All
2023,5,CHENNAI,SHIRDI,6069,6106,CHENNAI-SHIRDI,12175,All
2023,6,CHENNAI,SHIRDI,1479,1698,CHENNAI-SHIRDI,3177,All
2023,7,CHENNAI,SHIRDI,1792,1544,CHENNAI-SHIRDI,3336,All
2023,8,CHENNAI,SHIRDI,3728,3589,CHENNAI-SHIRDI,7317,All
2023,9,CHENNAI,SHIRDI,3844,3549,CHENNAI-SHIRDI,7393,All
2023,10,CHENNAI,SHIRDI,3804,3669,CHENNAI-SHIRDI,7473,All
2023,11,CHENNAI,SHIRDI,5452,5254,CHENNAI-SHIRDI,10706,All
2023,12,CHENNAI,SHIRDI,6146,5964,CHENNAI-SHIRDI,12110,All
2024,1,CHENNAI,SHIRDI,5737,5750,CHENNAI-SHIRDI,11487,All
2024,2,CHENNAI,SHIRDI,5369,5316,CHENNAI-SHIRDI,10685,All
2024,3,CHENNAI,SHIRDI,5392,5057,CHENNAI-SHIRDI,10449,All
2024,4,CHENNAI,SHIRDI,3514,3273,CHENNAI-SHIRDI,6787,All
2024,6,CHENNAI,SHIRDI,2796,2424,CHENNAI-SHIRDI,5220,All
2024,7,CHENNAI,SHIRDI,3919,3607,CHENNAI-SHIRDI,7526,All
2024,8,CHENNAI,SHIRDI,3917,3478,CHENNAI-SHIRDI,7395,All
2024,9,CHENNAI,SHIRDI,3552,3347,CHENNAI-SHIRDI,6899,All
2024,10,CHENNAI,SHIRDI,6120,6503,CHENNAI-SHIRDI,12623,All
2024,11,CHENNAI,SHIRDI,6634,6585,CHENNAI-SHIRDI,13219,All
2024,12,CHENNAI,SHIRDI,5559,5259,CHENNAI-SHIRDI,10818,All
2025,1,CHENNAI,SHIRDI,4800,4550,CHENNAI-SHIRDI,9350,All
2025,2,CHENNAI,SHIRDI,5485,5207,CHENNAI-SHIRDI,10692,All
2025,3,CHENNAI,SHIRDI,5291,5201,CHENNAI-SHIRDI,10492,All
2021,7,CHENNAI,SILCHAR,381,893,CHENNAI-SILCHAR,1274,All
2021,8,CHENNAI,SILCHAR,437,1140,CHENNAI-SILCHAR,1577,All
2021,9,CHENNAI,SILCHAR,204,280,CHENNAI-SILCHAR,484,All
2021,10,CHENNAI,SILCHAR,260,234,CHENNAI-SILCHAR,494,All
2015,5,CHENNAI,SRINAGAR,755,610,CHENNAI-SRINAGAR,1365,All
2015,6,CHENNAI,SRINAGAR,185,336,CHENNAI-SRINAGAR,521,All
2015,7,CHENNAI,SRINAGAR,300,327,CHENNAI-SRINAGAR,627,All
2015,8,CHENNAI,SRINAGAR,473,446,CHENNAI-SRINAGAR,919,All
2015,9,CHENNAI,SRINAGAR,413,421,CHENNAI-SRINAGAR,834,All
2015,10,CHENNAI,SRINAGAR,366,476,CHENNAI-SRINAGAR,842,All
2015,11,CHENNAI,SRINAGAR,352,407,CHENNAI-SRINAGAR,759,All
2015,12,CHENNAI,SRINAGAR,567,623,CHENNAI-SRINAGAR,1190,All
2016,1,CHENNAI,SRINAGAR,634,522,CHENNAI-SRINAGAR,1156,All
2016,2,CHENNAI,SRINAGAR,545,277,CHENNAI-SRINAGAR,822,All
2016,3,CHENNAI,SRINAGAR,388,290,CHENNAI-SRINAGAR,678,All
2016,4,CHENNAI,SRINAGAR,488,332,CHENNAI-SRINAGAR,820,All
2016,5,CHENNAI,SRINAGAR,684,866,CHENNAI-SRINAGAR,1550,All
2016,6,CHENNAI,SRINAGAR,111,192,CHENNAI-SRINAGAR,303,All
2016,7,CHENNAI,SRINAGAR,92,165,CHENNAI-SRINAGAR,257,All
2016,8,CHENNAI,SRINAGAR,33,58,CHENNAI-SRINAGAR,91,All
2017,12,CHENNAI,SRINAGAR,21,0,CHENNAI-SRINAGAR,21,All
2018,1,CHENNAI,SRINAGAR,37,0,CHENNAI-SRINAGAR,37,All
2018,3,CHENNAI,SRINAGAR,0,19,CHENNAI-SRINAGAR,19,All
2018,4,CHENNAI,SRINAGAR,32,67,CHENNAI-SRINAGAR,99,All
2018,5,CHENNAI,SRINAGAR,117,284,CHENNAI-SRINAGAR,401,All
2018,6,CHENNAI,SRINAGAR,142,112,CHENNAI-SRINAGAR,254,All
2018,7,CHENNAI,SRINAGAR,164,102,CHENNAI-SRINAGAR,266,All
2018,8,CHENNAI,SRINAGAR,318,246,CHENNAI-SRINAGAR,564,All
2018,9,CHENNAI,SRINAGAR,365,433,CHENNAI-SRINAGAR,798,All
2018,10,CHENNAI,SRINAGAR,598,924,CHENNAI-SRINAGAR,1522,All
2018,11,CHENNAI,SRINAGAR,557,410,CHENNAI-SRINAGAR,967,All
2018,12,CHENNAI,SRINAGAR,1000,779,CHENNAI-SRINAGAR,1779,All
2019,1,CHENNAI,SRINAGAR,865,0,CHENNAI-SRINAGAR,865,All
2019,2,CHENNAI,SRINAGAR,600,0,CHENNAI-SRINAGAR,600,All
2019,3,CHENNAI,SRINAGAR,387,0,CHENNAI-SRINAGAR,387,All
2019,4,CHENNAI,SRINAGAR,876,0,CHENNAI-SRINAGAR,876,All
2019,5,CHENNAI,SRINAGAR,839,0,CHENNAI-SRINAGAR,839,All
2019,6,CHENNAI,SRINAGAR,604,0,CHENNAI-SRINAGAR,604,All
2019,7,CHENNAI,SRINAGAR,939,0,CHENNAI-SRINAGAR,939,All
2019,8,CHENNAI,SRINAGAR,539,0,CHENNAI-SRINAGAR,539,All
2019,9,CHENNAI,SRINAGAR,397,0,CHENNAI-SRINAGAR,397,All
2019,10,CHENNAI,SRINAGAR,468,5,CHENNAI-SRINAGAR,473,All
2019,11,CHENNAI,SRINAGAR,625,69,CHENNAI-SRINAGAR,694,All
2019,12,CHENNAI,SRINAGAR,586,114,CHENNAI-SRINAGAR,700,All
2020,1,CHENNAI,SRINAGAR,446,122,CHENNAI-SRINAGAR,568,All
2020,2,CHENNAI,SRINAGAR,328,147,CHENNAI-SRINAGAR,475,All
2020,3,CHENNAI,SRINAGAR,77,118,CHENNAI-SRINAGAR,195,All
2021,3,CHENNAI,SRINAGAR,97,8,CHENNAI-SRINAGAR,105,All
2021,4,CHENNAI,SRINAGAR,436,33,CHENNAI-SRINAGAR,469,All
2022,3,CHENNAI,SRINAGAR,298,66,CHENNAI-SRINAGAR,364,All
2022,4,CHENNAI,SRINAGAR,1038,810,CHENNAI-SRINAGAR,1848,All
2022,5,CHENNAI,SRINAGAR,1057,1105,CHENNAI-SRINAGAR,2162,All
2022,6,CHENNAI,SRINAGAR,936,985,CHENNAI-SRINAGAR,1921,All
2022,7,CHENNAI,SRINAGAR,688,612,CHENNAI-SRINAGAR,1300,All
2022,8,CHENNAI,SRINAGAR,595,575,CHENNAI-SRINAGAR,1170,All
2022,9,CHENNAI,SRINAGAR,336,446,CHENNAI-SRINAGAR,782,All
2022,10,CHENNAI,SRINAGAR,382,468,CHENNAI-SRINAGAR,850,All
2022,11,CHENNAI,SRINAGAR,76,80,CHENNAI-SRINAGAR,156,All
2022,12,CHENNAI,SRINAGAR,191,6,CHENNAI-SRINAGAR,197,All
2023,1,CHENNAI,SRINAGAR,293,50,CHENNAI-SRINAGAR,343,All
2023,2,CHENNAI,SRINAGAR,80,46,CHENNAI-SRINAGAR,126,All
2023,3,CHENNAI,SRINAGAR,269,219,CHENNAI-SRINAGAR,488,All
2023,4,CHENNAI,SRINAGAR,446,610,CHENNAI-SRINAGAR,1056,All
2023,5,CHENNAI,SRINAGAR,1098,1221,CHENNAI-SRINAGAR,2319,All
2023,6,CHENNAI,SRINAGAR,1177,1093,CHENNAI-SRINAGAR,2270,All
2023,7,CHENNAI,SRINAGAR,785,628,CHENNAI-SRINAGAR,1413,All
2023,8,CHENNAI,SRINAGAR,592,598,CHENNAI-SRINAGAR,1190,All
2023,9,CHENNAI,SRINAGAR,505,440,CHENNAI-SRINAGAR,945,All
2023,10,CHENNAI,SRINAGAR,456,564,CHENNAI-SRINAGAR,1020,All
2023,11,CHENNAI,SRINAGAR,0,38,CHENNAI-SRINAGAR,38,All
2023,12,CHENNAI,SRINAGAR,0,39,CHENNAI-SRINAGAR,39,All
2024,1,CHENNAI,SRINAGAR,0,142,CHENNAI-SRINAGAR,142,All
2024,2,CHENNAI,SRINAGAR,0,14,CHENNAI-SRINAGAR,14,All
2024,3,CHENNAI,SRINAGAR,0,60,CHENNAI-SRINAGAR,60,All
2024,4,CHENNAI,SRINAGAR,121,121,CHENNAI-SRINAGAR,242,All
2024,6,CHENNAI,SRINAGAR,32,74,CHENNAI-SRINAGAR,106,All
2024,7,CHENNAI,SRINAGAR,50,80,CHENNAI-SRINAGAR,130,All
2024,8,CHENNAI,SRINAGAR,29,24,CHENNAI-SRINAGAR,53,All
2024,9,CHENNAI,SRINAGAR,2,18,CHENNAI-SRINAGAR,20,All
2024,10,CHENNAI,SRINAGAR,4,4,CHENNAI-SRINAGAR,8,All
2024,11,CHENNAI,SRINAGAR,14,0,CHENNAI-SRINAGAR,14,All
2017,12,CHENNAI,SURAT,267,276,CHENNAI-SURAT,543,All
2018,1,CHENNAI,SURAT,175,335,CHENNAI-SURAT,510,All
2018,2,CHENNAI,SURAT,209,383,CHENNAI-SURAT,592,All
2018,3,CHENNAI,SURAT,307,377,CHENNAI-SURAT,684,All
2018,10,CHENNAI,SURAT,1241,1411,CHENNAI-SURAT,2652,All
2018,11,CHENNAI,SURAT,4014,3692,CHENNAI-SURAT,7706,All
2018,12,CHENNAI,SURAT,4142,3934,CHENNAI-SURAT,8076,All
2019,1,CHENNAI,SURAT,4390,4224,CHENNAI-SURAT,8614,All
2019,2,CHENNAI,SURAT,3692,2893,CHENNAI-SURAT,6585,All
2019,3,CHENNAI,SURAT,3740,2831,CHENNAI-SURAT,6571,All
2019,4,CHENNAI,SURAT,4722,3635,CHENNAI-SURAT,8357,All
2019,5,CHENNAI,SURAT,4833,5090,CHENNAI-SURAT,9923,All
2019,6,CHENNAI,SURAT,4555,3920,CHENNAI-SURAT,8475,All
2019,7,CHENNAI,SURAT,4276,4459,CHENNAI-SURAT,8735,All
2019,8,CHENNAI,SURAT,4895,4873,CHENNAI-SURAT,9768,All
2019,9,CHENNAI,SURAT,4935,4737,CHENNAI-SURAT,9672,All
2019,10,CHENNAI,SURAT,3488,4556,CHENNAI-SURAT,8044,All
2019,11,CHENNAI,SURAT,5177,4331,CHENNAI-SURAT,9508,All
2019,12,CHENNAI,SURAT,5524,5530,CHENNAI-SURAT,11054,All
2020,1,CHENNAI,SURAT,5267,5352,CHENNAI-SURAT,10619,All
2020,2,CHENNAI,SURAT,4977,5008,CHENNAI-SURAT,9985,All
2020,3,CHENNAI,SURAT,3573,3484,CHENNAI-SURAT,7057,All
2020,5,CHENNAI,SURAT,0,0,CHENNAI-SURAT,0,All
2020,6,CHENNAI,SURAT,0,0,CHENNAI-SURAT,0,All
2021,1,CHENNAI,SURAT,893,1003,CHENNAI-SURAT,1896,All
2021,2,CHENNAI,SURAT,1115,1317,CHENNAI-SURAT,2432,All
2021,3,CHENNAI,SURAT,1638,1724,CHENNAI-SURAT,3362,All
2021,4,CHENNAI,SURAT,926,914,CHENNAI-SURAT,1840,All
2021,7,CHENNAI,SURAT,439,399,CHENNAI-SURAT,838,All
2021,8,CHENNAI,SURAT,551,500,CHENNAI-SURAT,1051,All
2021,9,CHENNAI,SURAT,1368,1478,CHENNAI-SURAT,2846,All
2021,10,CHENNAI,SURAT,1514,1601,CHENNAI-SURAT,3115,All
2021,11,CHENNAI,SURAT,2582,2262,CHENNAI-SURAT,4844,All
2021,12,CHENNAI,SURAT,2428,2301,CHENNAI-SURAT,4729,All
2022,1,CHENNAI,SURAT,1589,1763,CHENNAI-SURAT,3352,All
2022,3,CHENNAI,SURAT,520,465,CHENNAI-SURAT,985,All
2022,4,CHENNAI,SURAT,3111,2806,CHENNAI-SURAT,5917,All
2022,5,CHENNAI,SURAT,3329,3989,CHENNAI-SURAT,7318,All
2022,6,CHENNAI,SURAT,3345,3322,CHENNAI-SURAT,6667,All
2022,7,CHENNAI,SURAT,2192,2269,CHENNAI-SURAT,4461,All
2022,8,CHENNAI,SURAT,3901,3525,CHENNAI-SURAT,7426,All
2022,9,CHENNAI,SURAT,4570,4125,CHENNAI-SURAT,8695,All
2022,10,CHENNAI,SURAT,3869,4506,CHENNAI-SURAT,8375,All
2022,11,CHENNAI,SURAT,2325,2296,CHENNAI-SURAT,4621,All
2022,12,CHENNAI,SURAT,2185,2260,CHENNAI-SURAT,4445,All
2023,1,CHENNAI,SURAT,2371,2303,CHENNAI-SURAT,4674,All
2023,2,CHENNAI,SURAT,1732,1724,CHENNAI-SURAT,3456,All
2023,3,CHENNAI,SURAT,1457,1663,CHENNAI-SURAT,3120,All
2023,4,CHENNAI,SURAT,2047,2132,CHENNAI-SURAT,4179,All
2023,5,CHENNAI,SURAT,2316,2734,CHENNAI-SURAT,5050,All
2023,6,CHENNAI,SURAT,2208,2381,CHENNAI-SURAT,4589,All
2023,7,CHENNAI,SURAT,2361,2552,CHENNAI-SURAT,4913,All
2023,8,CHENNAI,SURAT,2376,2409,CHENNAI-SURAT,4785,All
2023,9,CHENNAI,SURAT,2465,2463,CHENNAI-SURAT,4928,All
2023,10,CHENNAI,SURAT,2673,2596,CHENNAI-SURAT,5269,All
2023,11,CHENNAI,SURAT,2401,2372,CHENNAI-SURAT,4773,All
2023,12,CHENNAI,SURAT,2923,2848,CHENNAI-SURAT,5771,All
2024,1,CHENNAI,SURAT,3218,3253,CHENNAI-SURAT,6471,All
2024,2,CHENNAI,SURAT,3121,3037,CHENNAI-SURAT,6158,All
2024,3,CHENNAI,SURAT,3085,2765,CHENNAI-SURAT,5850,All
2024,4,CHENNAI,SURAT,1841,1983,CHENNAI-SURAT,3824,All
2024,6,CHENNAI,SURAT,1996,2064,CHENNAI-SURAT,4060,All
2024,7,CHENNAI,SURAT,2060,2121,CHENNAI-SURAT,4181,All
2024,8,CHENNAI,SURAT,2118,2043,CHENNAI-SURAT,4161,All
2024,9,CHENNAI,SURAT,2184,2128,CHENNAI-SURAT,4312,All
2024,10,CHENNAI,SURAT,2052,2006,CHENNAI-SURAT,4058,All
2024,11,CHENNAI,SURAT,2879,2588,CHENNAI-SURAT,5467,All
2024,12,CHENNAI,SURAT,3489,3556,CHENNAI-SURAT,7045,All
2025,1,CHENNAI,SURAT,4304,4742,CHENNAI-SURAT,9046,All
2025,2,CHENNAI,SURAT,4221,4175,CHENNAI-SURAT,8396,All
2025,3,CHENNAI,SURAT,3754,3608,CHENNAI-SURAT,7362,All
2024,10,CHENNAI,Shivamogga Airport,424,453,CHENNAI-Shivamogga Airport,877,All
2024,11,CHENNAI,Shivamogga Airport,578,667,CHENNAI-Shivamogga Airport,1245,All
2024,12,CHENNAI,Shivamogga Airport,855,817,CHENNAI-Shivamogga Airport,1672,All
2025,1,CHENNAI,Shivamogga Airport,597,691,CHENNAI-Shivamogga Airport,1288,All
2025,2,CHENNAI,Shivamogga Airport,707,777,CHENNAI-Shivamogga Airport,1484,All
2025,3,CHENNAI,Shivamogga Airport,658,699,CHENNAI-Shivamogga Airport,1357,All
2015,4,CHENNAI,TIRUCHIRAPALLY,6494,6623,CHENNAI-TIRUCHIRAPALLY,13117,All
2015,5,CHENNAI,TIRUCHIRAPALLY,7583,7733,CHENNAI-TIRUCHIRAPALLY,15316,All
2015,6,CHENNAI,TIRUCHIRAPALLY,6524,6931,CHENNAI-TIRUCHIRAPALLY,13455,All
2015,7,CHENNAI,TIRUCHIRAPALLY,6712,6390,CHENNAI-TIRUCHIRAPALLY,13102,All
2015,8,CHENNAI,TIRUCHIRAPALLY,7552,7728,CHENNAI-TIRUCHIRAPALLY,15280,All
2015,9,CHENNAI,TIRUCHIRAPALLY,6681,6996,CHENNAI-TIRUCHIRAPALLY,13677,All
2015,10,CHENNAI,TIRUCHIRAPALLY,6277,5997,CHENNAI-TIRUCHIRAPALLY,12274,All
2015,11,CHENNAI,TIRUCHIRAPALLY,6389,5702,CHENNAI-TIRUCHIRAPALLY,12091,All
2015,12,CHENNAI,TIRUCHIRAPALLY,5175,4570,CHENNAI-TIRUCHIRAPALLY,9745,All
2016,1,CHENNAI,TIRUCHIRAPALLY,6675,6429,CHENNAI-TIRUCHIRAPALLY,13104,All
2016,2,CHENNAI,TIRUCHIRAPALLY,6352,6470,CHENNAI-TIRUCHIRAPALLY,12822,All
2016,3,CHENNAI,TIRUCHIRAPALLY,5952,5963,CHENNAI-TIRUCHIRAPALLY,11915,All
2016,4,CHENNAI,TIRUCHIRAPALLY,6141,6303,CHENNAI-TIRUCHIRAPALLY,12444,All
2016,5,CHENNAI,TIRUCHIRAPALLY,7687,7830,CHENNAI-TIRUCHIRAPALLY,15517,All
2016,6,CHENNAI,TIRUCHIRAPALLY,7936,8055,CHENNAI-TIRUCHIRAPALLY,15991,All
2016,7,CHENNAI,TIRUCHIRAPALLY,8109,8270,CHENNAI-TIRUCHIRAPALLY,16379,All
2016,8,CHENNAI,TIRUCHIRAPALLY,7640,8351,CHENNAI-TIRUCHIRAPALLY,15991,All
2016,9,CHENNAI,TIRUCHIRAPALLY,7313,8618,CHENNAI-TIRUCHIRAPALLY,15931,All
2016,10,CHENNAI,TIRUCHIRAPALLY,6970,7634,CHENNAI-TIRUCHIRAPALLY,14604,All
2016,11,CHENNAI,TIRUCHIRAPALLY,6220,7647,CHENNAI-TIRUCHIRAPALLY,13867,All
2016,12,CHENNAI,TIRUCHIRAPALLY,6398,7417,CHENNAI-TIRUCHIRAPALLY,13815,All
2017,1,CHENNAI,TIRUCHIRAPALLY,6689,7252,CHENNAI-TIRUCHIRAPALLY,13941,All
2017,2,CHENNAI,TIRUCHIRAPALLY,5487,6436,CHENNAI-TIRUCHIRAPALLY,11923,All
2017,3,CHENNAI,TIRUCHIRAPALLY,5850,6029,CHENNAI-TIRUCHIRAPALLY,11879,All
2017,4,CHENNAI,TIRUCHIRAPALLY,4652,4699,CHENNAI-TIRUCHIRAPALLY,9351,All
2017,5,CHENNAI,TIRUCHIRAPALLY,5158,4388,CHENNAI-TIRUCHIRAPALLY,9546,All
2017,6,CHENNAI,TIRUCHIRAPALLY,5249,4611,CHENNAI-TIRUCHIRAPALLY,9860,All
2017,7,CHENNAI,TIRUCHIRAPALLY,4950,4605,CHENNAI-TIRUCHIRAPALLY,9555,All
2017,8,CHENNAI,TIRUCHIRAPALLY,4907,4637,CHENNAI-TIRUCHIRAPALLY,9544,All
2017,9,CHENNAI,TIRUCHIRAPALLY,5826,5777,CHENNAI-TIRUCHIRAPALLY,11603,All
2017,10,CHENNAI,TIRUCHIRAPALLY,6032,5723,CHENNAI-TIRUCHIRAPALLY,11755,All
2017,11,CHENNAI,TIRUCHIRAPALLY,5755,5224,CHENNAI-TIRUCHIRAPALLY,10979,All
2017,12,CHENNAI,TIRUCHIRAPALLY,6788,5997,CHENNAI-TIRUCHIRAPALLY,12785,All
2018,1,CHENNAI,TIRUCHIRAPALLY,7160,6893,CHENNAI-TIRUCHIRAPALLY,14053,All
2018,2,CHENNAI,TIRUCHIRAPALLY,6298,6101,CHENNAI-TIRUCHIRAPALLY,12399,All
2018,3,CHENNAI,TIRUCHIRAPALLY,6741,6199,CHENNAI-TIRUCHIRAPALLY,12940,All
2018,4,CHENNAI,TIRUCHIRAPALLY,6209,5694,CHENNAI-TIRUCHIRAPALLY,11903,All
2018,5,CHENNAI,TIRUCHIRAPALLY,6654,6007,CHENNAI-TIRUCHIRAPALLY,12661,All
2018,6,CHENNAI,TIRUCHIRAPALLY,10093,9492,CHENNAI-TIRUCHIRAPALLY,19585,All
2018,7,CHENNAI,TIRUCHIRAPALLY,11410,11118,CHENNAI-TIRUCHIRAPALLY,22528,All
2018,8,CHENNAI,TIRUCHIRAPALLY,11312,11006,CHENNAI-TIRUCHIRAPALLY,22318,All
2018,9,CHENNAI,TIRUCHIRAPALLY,10792,10763,CHENNAI-TIRUCHIRAPALLY,21555,All
2018,10,CHENNAI,TIRUCHIRAPALLY,10105,9554,CHENNAI-TIRUCHIRAPALLY,19659,All
2018,11,CHENNAI,TIRUCHIRAPALLY,9882,9104,CHENNAI-TIRUCHIRAPALLY,18986,All
2018,12,CHENNAI,TIRUCHIRAPALLY,10304,9084,CHENNAI-TIRUCHIRAPALLY,19388,All
2019,1,CHENNAI,TIRUCHIRAPALLY,10178,9468,CHENNAI-TIRUCHIRAPALLY,19646,All
2019,2,CHENNAI,TIRUCHIRAPALLY,9489,9093,CHENNAI-TIRUCHIRAPALLY,18582,All
2019,3,CHENNAI,TIRUCHIRAPALLY,9300,8687,CHENNAI-TIRUCHIRAPALLY,17987,All
2019,4,CHENNAI,TIRUCHIRAPALLY,8661,8377,CHENNAI-TIRUCHIRAPALLY,17038,All
2019,5,CHENNAI,TIRUCHIRAPALLY,8549,8238,CHENNAI-TIRUCHIRAPALLY,16787,All
2019,6,CHENNAI,TIRUCHIRAPALLY,8621,8961,CHENNAI-TIRUCHIRAPALLY,17582,All
2019,7,CHENNAI,TIRUCHIRAPALLY,8844,8749,CHENNAI-TIRUCHIRAPALLY,17593,All
2019,8,CHENNAI,TIRUCHIRAPALLY,8975,8840,CHENNAI-TIRUCHIRAPALLY,17815,All
2019,9,CHENNAI,TIRUCHIRAPALLY,8493,8705,CHENNAI-TIRUCHIRAPALLY,17198,All
2019,10,CHENNAI,TIRUCHIRAPALLY,9088,7245,CHENNAI-TIRUCHIRAPALLY,16333,All
2019,11,CHENNAI,TIRUCHIRAPALLY,7965,7986,CHENNAI-TIRUCHIRAPALLY,15951,All
2019,12,CHENNAI,TIRUCHIRAPALLY,8792,8244,CHENNAI-TIRUCHIRAPALLY,17036,All
2020,1,CHENNAI,TIRUCHIRAPALLY,11050,10255,CHENNAI-TIRUCHIRAPALLY,21305,All
2020,2,CHENNAI,TIRUCHIRAPALLY,9313,9510,CHENNAI-TIRUCHIRAPALLY,18823,All
2020,3,CHENNAI,TIRUCHIRAPALLY,4468,4726,CHENNAI-TIRUCHIRAPALLY,9194,All
2020,5,CHENNAI,TIRUCHIRAPALLY,68,98,CHENNAI-TIRUCHIRAPALLY,166,All
2020,6,CHENNAI,TIRUCHIRAPALLY,2475,1776,CHENNAI-TIRUCHIRAPALLY,4251,All
2020,7,CHENNAI,TIRUCHIRAPALLY,3178,3554,CHENNAI-TIRUCHIRAPALLY,6732,All
2020,8,CHENNAI,TIRUCHIRAPALLY,3271,3742,CHENNAI-TIRUCHIRAPALLY,7013,All
2020,9,CHENNAI,TIRUCHIRAPALLY,2459,2764,CHENNAI-TIRUCHIRAPALLY,5223,All
2020,10,CHENNAI,TIRUCHIRAPALLY,2069,2055,CHENNAI-TIRUCHIRAPALLY,4124,All
2020,11,CHENNAI,TIRUCHIRAPALLY,3153,2783,CHENNAI-TIRUCHIRAPALLY,5936,All
2020,12,CHENNAI,TIRUCHIRAPALLY,3200,3264,CHENNAI-TIRUCHIRAPALLY,6464,All
2021,1,CHENNAI,TIRUCHIRAPALLY,3748,3772,CHENNAI-TIRUCHIRAPALLY,7520,All
2021,2,CHENNAI,TIRUCHIRAPALLY,3608,3753,CHENNAI-TIRUCHIRAPALLY,7361,All
2021,3,CHENNAI,TIRUCHIRAPALLY,5349,5306,CHENNAI-TIRUCHIRAPALLY,10655,All
2021,4,CHENNAI,TIRUCHIRAPALLY,4059,3606,CHENNAI-TIRUCHIRAPALLY,7665,All
2021,6,CHENNAI,TIRUCHIRAPALLY,1518,1908,CHENNAI-TIRUCHIRAPALLY,3426,All
2021,7,CHENNAI,TIRUCHIRAPALLY,2121,2277,CHENNAI-TIRUCHIRAPALLY,4398,All
2021,8,CHENNAI,TIRUCHIRAPALLY,2334,2469,CHENNAI-TIRUCHIRAPALLY,4803,All
2021,9,CHENNAI,TIRUCHIRAPALLY,2959,3236,CHENNAI-TIRUCHIRAPALLY,6195,All
2021,10,CHENNAI,TIRUCHIRAPALLY,3351,2900,CHENNAI-TIRUCHIRAPALLY,6251,All
2021,11,CHENNAI,TIRUCHIRAPALLY,4063,4141,CHENNAI-TIRUCHIRAPALLY,8204,All
2021,12,CHENNAI,TIRUCHIRAPALLY,5184,3909,CHENNAI-TIRUCHIRAPALLY,9093,All
2022,1,CHENNAI,TIRUCHIRAPALLY,4274,3524,CHENNAI-TIRUCHIRAPALLY,7798,All
2022,2,CHENNAI,TIRUCHIRAPALLY,4267,3934,CHENNAI-TIRUCHIRAPALLY,8201,All
2022,3,CHENNAI,TIRUCHIRAPALLY,5393,4837,CHENNAI-TIRUCHIRAPALLY,10230,All
2022,4,CHENNAI,TIRUCHIRAPALLY,6422,5506,CHENNAI-TIRUCHIRAPALLY,11928,All
2022,5,CHENNAI,TIRUCHIRAPALLY,7256,5963,CHENNAI-TIRUCHIRAPALLY,13219,All
2022,6,CHENNAI,TIRUCHIRAPALLY,7858,7109,CHENNAI-TIRUCHIRAPALLY,14967,All
2022,7,CHENNAI,TIRUCHIRAPALLY,7594,7022,CHENNAI-TIRUCHIRAPALLY,14616,All
2022,8,CHENNAI,TIRUCHIRAPALLY,8154,7746,CHENNAI-TIRUCHIRAPALLY,15900,All
2022,9,CHENNAI,TIRUCHIRAPALLY,7629,7382,CHENNAI-TIRUCHIRAPALLY,15011,All
2022,10,CHENNAI,TIRUCHIRAPALLY,7673,7029,CHENNAI-TIRUCHIRAPALLY,14702,All
2022,11,CHENNAI,TIRUCHIRAPALLY,7104,6488,CHENNAI-TIRUCHIRAPALLY,13592,All
2022,12,CHENNAI,TIRUCHIRAPALLY,7276,7315,CHENNAI-TIRUCHIRAPALLY,14591,All
2023,1,CHENNAI,TIRUCHIRAPALLY,7724,7521,CHENNAI-TIRUCHIRAPALLY,15245,All
2023,2,CHENNAI,TIRUCHIRAPALLY,6966,7225,CHENNAI-TIRUCHIRAPALLY,14191,All
2023,3,CHENNAI,TIRUCHIRAPALLY,7858,7623,CHENNAI-TIRUCHIRAPALLY,15481,All
2023,4,CHENNAI,TIRUCHIRAPALLY,7835,7546,CHENNAI-TIRUCHIRAPALLY,15381,All
2023,5,CHENNAI,TIRUCHIRAPALLY,8090,8304,CHENNAI-TIRUCHIRAPALLY,16394,All
2023,6,CHENNAI,TIRUCHIRAPALLY,7963,7793,CHENNAI-TIRUCHIRAPALLY,15756,All
2023,7,CHENNAI,TIRUCHIRAPALLY,7481,7035,CHENNAI-TIRUCHIRAPALLY,14516,All
2023,8,CHENNAI,TIRUCHIRAPALLY,7746,7177,CHENNAI-TIRUCHIRAPALLY,14923,All
2023,9,CHENNAI,TIRUCHIRAPALLY,7803,7338,CHENNAI-TIRUCHIRAPALLY,15141,All
2023,10,CHENNAI,TIRUCHIRAPALLY,7805,6886,CHENNAI-TIRUCHIRAPALLY,14691,All
2023,11,CHENNAI,TIRUCHIRAPALLY,8450,7436,CHENNAI-TIRUCHIRAPALLY,15886,All
2023,12,CHENNAI,TIRUCHIRAPALLY,8079,6963,CHENNAI-TIRUCHIRAPALLY,15042,All
2024,1,CHENNAI,TIRUCHIRAPALLY,10580,9473,CHENNAI-TIRUCHIRAPALLY,20053,All
2024,2,CHENNAI,TIRUCHIRAPALLY,9764,9048,CHENNAI-TIRUCHIRAPALLY,18812,All
2024,3,CHENNAI,TIRUCHIRAPALLY,9963,8640,CHENNAI-TIRUCHIRAPALLY,18603,All
2024,4,CHENNAI,TIRUCHIRAPALLY,11176,9112,CHENNAI-TIRUCHIRAPALLY,20288,All
2024,6,CHENNAI,TIRUCHIRAPALLY,11508,10622,CHENNAI-TIRUCHIRAPALLY,22130,All
2024,7,CHENNAI,TIRUCHIRAPALLY,11026,9990,CHENNAI-TIRUCHIRAPALLY,21016,All
2024,8,CHENNAI,TIRUCHIRAPALLY,11653,10707,CHENNAI-TIRUCHIRAPALLY,22360,All
2024,9,CHENNAI,TIRUCHIRAPALLY,10159,10494,CHENNAI-TIRUCHIRAPALLY,20653,All
2024,10,CHENNAI,TIRUCHIRAPALLY,9995,8801,CHENNAI-TIRUCHIRAPALLY,18796,All
2024,11,CHENNAI,TIRUCHIRAPALLY,10150,11051,CHENNAI-TIRUCHIRAPALLY,21201,All
2024,12,CHENNAI,TIRUCHIRAPALLY,12224,11380,CHENNAI-TIRUCHIRAPALLY,23604,All
2025,1,CHENNAI,TIRUCHIRAPALLY,12192,11853,CHENNAI-TIRUCHIRAPALLY,24045,All
2025,2,CHENNAI,TIRUCHIRAPALLY,11656,11900,CHENNAI-TIRUCHIRAPALLY,23556,All
2025,3,CHENNAI,TIRUCHIRAPALLY,14413,14067,CHENNAI-TIRUCHIRAPALLY,28480,All
2020,9,CHENNAI,TIRUPATI,2,1,CHENNAI-TIRUPATI,3,All
2021,7,CHENNAI,TIRUPATI,122,0,CHENNAI-TIRUPATI,122,All
2021,10,CHENNAI,TIRUPATI,0,1,CHENNAI-TIRUPATI,1,All
2022,5,CHENNAI,TIRUPATI,42,0,CHENNAI-TIRUPATI,42,All
2022,9,CHENNAI,TIRUPATI,70,0,CHENNAI-TIRUPATI,70,All
2023,11,CHENNAI,TIRUPATI,76,61,CHENNAI-TIRUPATI,137,All
2024,10,CHENNAI,TIRUPATI,68,0,CHENNAI-TIRUPATI,68,All
2015,4,CHENNAI,TRIVANDRUM,9177,7643,CHENNAI-TRIVANDRUM,16820,All
2015,5,CHENNAI,TRIVANDRUM,10651,10000,CHENNAI-TRIVANDRUM,20651,All
2015,6,CHENNAI,TRIVANDRUM,9123,9305,CHENNAI-TRIVANDRUM,18428,All
2015,7,CHENNAI,TRIVANDRUM,9969,9848,CHENNAI-TRIVANDRUM,19817,All
2015,8,CHENNAI,TRIVANDRUM,9464,8975,CHENNAI-TRIVANDRUM,18439,All
2015,9,CHENNAI,TRIVANDRUM,7532,7556,CHENNAI-TRIVANDRUM,15088,All
2015,10,CHENNAI,TRIVANDRUM,5064,6249,CHENNAI-TRIVANDRUM,11313,All
2015,11,CHENNAI,TRIVANDRUM,8720,9694,CHENNAI-TRIVANDRUM,18414,All
2015,12,CHENNAI,TRIVANDRUM,7874,7446,CHENNAI-TRIVANDRUM,15320,All
2016,1,CHENNAI,TRIVANDRUM,11352,12064,CHENNAI-TRIVANDRUM,23416,All
2016,2,CHENNAI,TRIVANDRUM,10961,12049,CHENNAI-TRIVANDRUM,23010,All
2016,3,CHENNAI,TRIVANDRUM,11455,12630,CHENNAI-TRIVANDRUM,24085,All
2016,4,CHENNAI,TRIVANDRUM,13146,13547,CHENNAI-TRIVANDRUM,26693,All
2016,5,CHENNAI,TRIVANDRUM,15550,15281,CHENNAI-TRIVANDRUM,30831,All
2016,6,CHENNAI,TRIVANDRUM,11371,10723,CHENNAI-TRIVANDRUM,22094,All
2016,7,CHENNAI,TRIVANDRUM,15191,14629,CHENNAI-TRIVANDRUM,29820,All
2016,8,CHENNAI,TRIVANDRUM,15007,16117,CHENNAI-TRIVANDRUM,31124,All
2016,9,CHENNAI,TRIVANDRUM,15014,15860,CHENNAI-TRIVANDRUM,30874,All
2016,10,CHENNAI,TRIVANDRUM,12800,14235,CHENNAI-TRIVANDRUM,27035,All
2016,11,CHENNAI,TRIVANDRUM,12760,13231,CHENNAI-TRIVANDRUM,25991,All
2016,12,CHENNAI,TRIVANDRUM,13709,13020,CHENNAI-TRIVANDRUM,26729,All
2017,1,CHENNAI,TRIVANDRUM,9917,10271,CHENNAI-TRIVANDRUM,20188,All
2017,2,CHENNAI,TRIVANDRUM,8610,8674,CHENNAI-TRIVANDRUM,17284,All
2017,3,CHENNAI,TRIVANDRUM,9244,10044,CHENNAI-TRIVANDRUM,19288,All
2017,4,CHENNAI,TRIVANDRUM,12617,12717,CHENNAI-TRIVANDRUM,25334,All
2017,5,CHENNAI,TRIVANDRUM,14140,13805,CHENNAI-TRIVANDRUM,27945,All
2017,6,CHENNAI,TRIVANDRUM,11368,12222,CHENNAI-TRIVANDRUM,23590,All
2017,7,CHENNAI,TRIVANDRUM,12084,11829,CHENNAI-TRIVANDRUM,23913,All
2017,8,CHENNAI,TRIVANDRUM,13590,12694,CHENNAI-TRIVANDRUM,26284,All
2017,9,CHENNAI,TRIVANDRUM,13901,12935,CHENNAI-TRIVANDRUM,26836,All
2017,10,CHENNAI,TRIVANDRUM,12248,13049,CHENNAI-TRIVANDRUM,25297,All
2017,11,CHENNAI,TRIVANDRUM,15352,13486,CHENNAI-TRIVANDRUM,28838,All
2017,12,CHENNAI,TRIVANDRUM,16740,13534,CHENNAI-TRIVANDRUM,30274,All
2018,1,CHENNAI,TRIVANDRUM,16082,15092,CHENNAI-TRIVANDRUM,31174,All
2018,2,CHENNAI,TRIVANDRUM,14979,14375,CHENNAI-TRIVANDRUM,29354,All
2018,3,CHENNAI,TRIVANDRUM,16631,15784,CHENNAI-TRIVANDRUM,32415,All
2018,4,CHENNAI,TRIVANDRUM,16089,13251,CHENNAI-TRIVANDRUM,29340,All
2018,5,CHENNAI,TRIVANDRUM,19000,16785,CHENNAI-TRIVANDRUM,35785,All
2018,6,CHENNAI,TRIVANDRUM,16735,17396,CHENNAI-TRIVANDRUM,34131,All
2018,7,CHENNAI,TRIVANDRUM,16309,15569,CHENNAI-TRIVANDRUM,31878,All
2018,8,CHENNAI,TRIVANDRUM,19374,18560,CHENNAI-TRIVANDRUM,37934,All
2018,9,CHENNAI,TRIVANDRUM,15613,14712,CHENNAI-TRIVANDRUM,30325,All
2018,10,CHENNAI,TRIVANDRUM,16027,15884,CHENNAI-TRIVANDRUM,31911,All
2018,11,CHENNAI,TRIVANDRUM,17839,15765,CHENNAI-TRIVANDRUM,33604,All
2018,12,CHENNAI,TRIVANDRUM,19470,17390,CHENNAI-TRIVANDRUM,36860,All
2019,1,CHENNAI,TRIVANDRUM,17626,18374,CHENNAI-TRIVANDRUM,36000,All
2019,2,CHENNAI,TRIVANDRUM,13948,14374,CHENNAI-TRIVANDRUM,28322,All
2019,3,CHENNAI,TRIVANDRUM,13094,14377,CHENNAI-TRIVANDRUM,27471,All
2019,4,CHENNAI,TRIVANDRUM,14732,13758,CHENNAI-TRIVANDRUM,28490,All
2019,5,CHENNAI,TRIVANDRUM,16861,15363,CHENNAI-TRIVANDRUM,32224,All
2019,6,CHENNAI,TRIVANDRUM,12749,14972,CHENNAI-TRIVANDRUM,27721,All
2019,7,CHENNAI,TRIVANDRUM,14117,14164,CHENNAI-TRIVANDRUM,28281,All
2019,8,CHENNAI,TRIVANDRUM,14724,15007,CHENNAI-TRIVANDRUM,29731,All
2019,9,CHENNAI,TRIVANDRUM,14351,14864,CHENNAI-TRIVANDRUM,29215,All
2019,10,CHENNAI,TRIVANDRUM,13577,15884,CHENNAI-TRIVANDRUM,29461,All
2019,11,CHENNAI,TRIVANDRUM,19486,18598,CHENNAI-TRIVANDRUM,38084,All
2019,12,CHENNAI,TRIVANDRUM,24370,21418,CHENNAI-TRIVANDRUM,45788,All
2020,1,CHENNAI,TRIVANDRUM,21374,23468,CHENNAI-TRIVANDRUM,44842,All
2020,2,CHENNAI,TRIVANDRUM,17287,17090,CHENNAI-TRIVANDRUM,34377,All
2020,3,CHENNAI,TRIVANDRUM,9069,8644,CHENNAI-TRIVANDRUM,17713,All
2020,5,CHENNAI,TRIVANDRUM,470,179,CHENNAI-TRIVANDRUM,649,All
2020,6,CHENNAI,TRIVANDRUM,2094,836,CHENNAI-TRIVANDRUM,2930,All
2020,7,CHENNAI,TRIVANDRUM,1482,1275,CHENNAI-TRIVANDRUM,2757,All
2020,8,CHENNAI,TRIVANDRUM,1162,1426,CHENNAI-TRIVANDRUM,2588,All
2020,9,CHENNAI,TRIVANDRUM,1476,2177,CHENNAI-TRIVANDRUM,3653,All
2020,10,CHENNAI,TRIVANDRUM,1955,2706,CHENNAI-TRIVANDRUM,4661,All
2020,11,CHENNAI,TRIVANDRUM,3010,3426,CHENNAI-TRIVANDRUM,6436,All
2020,12,CHENNAI,TRIVANDRUM,4649,4540,CHENNAI-TRIVANDRUM,9189,All
2021,1,CHENNAI,TRIVANDRUM,6113,6748,CHENNAI-TRIVANDRUM,12861,All
2021,2,CHENNAI,TRIVANDRUM,6363,6898,CHENNAI-TRIVANDRUM,13261,All
2021,3,CHENNAI,TRIVANDRUM,4991,5055,CHENNAI-TRIVANDRUM,10046,All
2021,4,CHENNAI,TRIVANDRUM,5515,4128,CHENNAI-TRIVANDRUM,9643,All
2021,6,CHENNAI,TRIVANDRUM,1639,2138,CHENNAI-TRIVANDRUM,3777,All
2021,7,CHENNAI,TRIVANDRUM,2926,3157,CHENNAI-TRIVANDRUM,6083,All
2021,8,CHENNAI,TRIVANDRUM,3970,3742,CHENNAI-TRIVANDRUM,7712,All
2021,9,CHENNAI,TRIVANDRUM,3439,3878,CHENNAI-TRIVANDRUM,7317,All
2021,10,CHENNAI,TRIVANDRUM,4732,4499,CHENNAI-TRIVANDRUM,9231,All
2021,11,CHENNAI,TRIVANDRUM,6879,6346,CHENNAI-TRIVANDRUM,13225,All
2021,12,CHENNAI,TRIVANDRUM,9909,9353,CHENNAI-TRIVANDRUM,19262,All
2022,1,CHENNAI,TRIVANDRUM,4871,6104,CHENNAI-TRIVANDRUM,10975,All
2022,2,CHENNAI,TRIVANDRUM,4264,4218,CHENNAI-TRIVANDRUM,8482,All
2022,3,CHENNAI,TRIVANDRUM,6991,7041,CHENNAI-TRIVANDRUM,14032,All
2022,4,CHENNAI,TRIVANDRUM,12731,12089,CHENNAI-TRIVANDRUM,24820,All
2022,5,CHENNAI,TRIVANDRUM,15465,14887,CHENNAI-TRIVANDRUM,30352,All
2022,6,CHENNAI,TRIVANDRUM,14211,14850,CHENNAI-TRIVANDRUM,29061,All
2022,7,CHENNAI,TRIVANDRUM,14234,14566,CHENNAI-TRIVANDRUM,28800,All
2022,8,CHENNAI,TRIVANDRUM,14858,15540,CHENNAI-TRIVANDRUM,30398,All
2022,9,CHENNAI,TRIVANDRUM,14581,15372,CHENNAI-TRIVANDRUM,29953,All
2022,10,CHENNAI,TRIVANDRUM,12236,14401,CHENNAI-TRIVANDRUM,26637,All
2022,11,CHENNAI,TRIVANDRUM,11618,13006,CHENNAI-TRIVANDRUM,24624,All
2022,12,CHENNAI,TRIVANDRUM,13042,12451,CHENNAI-TRIVANDRUM,25493,All
2023,1,CHENNAI,TRIVANDRUM,11799,14434,CHENNAI-TRIVANDRUM,26233,All
2023,2,CHENNAI,TRIVANDRUM,10061,10354,CHENNAI-TRIVANDRUM,20415,All
2023,3,CHENNAI,TRIVANDRUM,12466,12326,CHENNAI-TRIVANDRUM,24792,All
2023,4,CHENNAI,TRIVANDRUM,13654,14241,CHENNAI-TRIVANDRUM,27895,All
2023,5,CHENNAI,TRIVANDRUM,14815,14897,CHENNAI-TRIVANDRUM,29712,All
2023,6,CHENNAI,TRIVANDRUM,12746,13401,CHENNAI-TRIVANDRUM,26147,All
2023,7,CHENNAI,TRIVANDRUM,13915,13869,CHENNAI-TRIVANDRUM,27784,All
2023,8,CHENNAI,TRIVANDRUM,14102,14392,CHENNAI-TRIVANDRUM,28494,All
2023,9,CHENNAI,TRIVANDRUM,13742,14568,CHENNAI-TRIVANDRUM,28310,All
2023,10,CHENNAI,TRIVANDRUM,12664,14465,CHENNAI-TRIVANDRUM,27129,All
2023,11,CHENNAI,TRIVANDRUM,15466,15807,CHENNAI-TRIVANDRUM,31273,All
2023,12,CHENNAI,TRIVANDRUM,17692,16858,CHENNAI-TRIVANDRUM,34550,All
2024,1,CHENNAI,TRIVANDRUM,15941,18968,CHENNAI-TRIVANDRUM,34909,All
2024,2,CHENNAI,TRIVANDRUM,14498,16084,CHENNAI-TRIVANDRUM,30582,All
2024,3,CHENNAI,TRIVANDRUM,14921,15752,CHENNAI-TRIVANDRUM,30673,All
2024,4,CHENNAI,TRIVANDRUM,13490,13673,CHENNAI-TRIVANDRUM,27163,All
2024,6,CHENNAI,TRIVANDRUM,14146,15487,CHENNAI-TRIVANDRUM,29633,All
2024,7,CHENNAI,TRIVANDRUM,14116,14651,CHENNAI-TRIVANDRUM,28767,All
2024,8,CHENNAI,TRIVANDRUM,16208,16873,CHENNAI-TRIVANDRUM,33081,All
2024,9,CHENNAI,TRIVANDRUM,16710,17743,CHENNAI-TRIVANDRUM,34453,All
2024,10,CHENNAI,TRIVANDRUM,14132,15406,CHENNAI-TRIVANDRUM,29538,All
2024,11,CHENNAI,TRIVANDRUM,16160,17439,CHENNAI-TRIVANDRUM,33599,All
2024,12,CHENNAI,TRIVANDRUM,17444,16801,CHENNAI-TRIVANDRUM,34245,All
2025,1,CHENNAI,TRIVANDRUM,14823,17503,CHENNAI-TRIVANDRUM,32326,All
2025,2,CHENNAI,TRIVANDRUM,12696,14528,CHENNAI-TRIVANDRUM,27224,All
2025,3,CHENNAI,TRIVANDRUM,12876,14268,CHENNAI-TRIVANDRUM,27144,All
2015,4,CHENNAI,TUTICORIN,2874,2471,CHENNAI-TUTICORIN,5345,All
2015,5,CHENNAI,TUTICORIN,4936,4271,CHENNAI-TUTICORIN,9207,All
2015,6,CHENNAI,TUTICORIN,4120,3811,CHENNAI-TUTICORIN,7931,All
2015,7,CHENNAI,TUTICORIN,4656,4708,CHENNAI-TUTICORIN,9364,All
2015,8,CHENNAI,TUTICORIN,4579,4483,CHENNAI-TUTICORIN,9062,All
2015,9,CHENNAI,TUTICORIN,4271,4174,CHENNAI-TUTICORIN,8445,All
2015,10,CHENNAI,TUTICORIN,4119,4025,CHENNAI-TUTICORIN,8144,All
2015,11,CHENNAI,TUTICORIN,3908,3744,CHENNAI-TUTICORIN,7652,All
2015,12,CHENNAI,TUTICORIN,3428,3165,CHENNAI-TUTICORIN,6593,All
2016,1,CHENNAI,TUTICORIN,4175,4097,CHENNAI-TUTICORIN,8272,All
2016,2,CHENNAI,TUTICORIN,3996,3769,CHENNAI-TUTICORIN,7765,All
2016,3,CHENNAI,TUTICORIN,4294,3970,CHENNAI-TUTICORIN,8264,All
2016,4,CHENNAI,TUTICORIN,4393,4172,CHENNAI-TUTICORIN,8565,All
2016,5,CHENNAI,TUTICORIN,4420,4249,CHENNAI-TUTICORIN,8669,All
2016,6,CHENNAI,TUTICORIN,4330,4052,CHENNAI-TUTICORIN,8382,All
2016,7,CHENNAI,TUTICORIN,4312,4062,CHENNAI-TUTICORIN,8374,All
2016,8,CHENNAI,TUTICORIN,4485,4358,CHENNAI-TUTICORIN,8843,All
2016,9,CHENNAI,TUTICORIN,4445,4347,CHENNAI-TUTICORIN,8792,All
2016,10,CHENNAI,TUTICORIN,4440,4376,CHENNAI-TUTICORIN,8816,All
2016,11,CHENNAI,TUTICORIN,4297,4263,CHENNAI-TUTICORIN,8560,All
2016,12,CHENNAI,TUTICORIN,4248,4070,CHENNAI-TUTICORIN,8318,All
2017,1,CHENNAI,TUTICORIN,4589,4520,CHENNAI-TUTICORIN,9109,All
2017,2,CHENNAI,TUTICORIN,4403,4329,CHENNAI-TUTICORIN,8732,All
2017,3,CHENNAI,TUTICORIN,5727,5433,CHENNAI-TUTICORIN,11160,All
2017,4,CHENNAI,TUTICORIN,4471,4004,CHENNAI-TUTICORIN,8475,All
2017,5,CHENNAI,TUTICORIN,4420,3977,CHENNAI-TUTICORIN,8397,All
2017,6,CHENNAI,TUTICORIN,4391,4057,CHENNAI-TUTICORIN,8448,All
2017,7,CHENNAI,TUTICORIN,4772,4603,CHENNAI-TUTICORIN,9375,All
2017,8,CHENNAI,TUTICORIN,4327,3948,CHENNAI-TUTICORIN,8275,All
2017,9,CHENNAI,TUTICORIN,4354,4008,CHENNAI-TUTICORIN,8362,All
2017,10,CHENNAI,TUTICORIN,4372,4038,CHENNAI-TUTICORIN,8410,All
2017,11,CHENNAI,TUTICORIN,3972,3784,CHENNAI-TUTICORIN,7756,All
2017,12,CHENNAI,TUTICORIN,4459,4029,CHENNAI-TUTICORIN,8488,All
2018,1,CHENNAI,TUTICORIN,4201,4228,CHENNAI-TUTICORIN,8429,All
2018,2,CHENNAI,TUTICORIN,4302,4209,CHENNAI-TUTICORIN,8511,All
2018,3,CHENNAI,TUTICORIN,4639,4460,CHENNAI-TUTICORIN,9099,All
2018,4,CHENNAI,TUTICORIN,4537,4475,CHENNAI-TUTICORIN,9012,All
2018,5,CHENNAI,TUTICORIN,4712,4561,CHENNAI-TUTICORIN,9273,All
2018,6,CHENNAI,TUTICORIN,4637,4560,CHENNAI-TUTICORIN,9197,All
2018,7,CHENNAI,TUTICORIN,5659,5512,CHENNAI-TUTICORIN,11171,All
2018,8,CHENNAI,TUTICORIN,8540,8344,CHENNAI-TUTICORIN,16884,All
2018,9,CHENNAI,TUTICORIN,8653,8559,CHENNAI-TUTICORIN,17212,All
2018,10,CHENNAI,TUTICORIN,8837,8435,CHENNAI-TUTICORIN,17272,All
2018,11,CHENNAI,TUTICORIN,7595,7158,CHENNAI-TUTICORIN,14753,All
2018,12,CHENNAI,TUTICORIN,9302,8198,CHENNAI-TUTICORIN,17500,All
2019,1,CHENNAI,TUTICORIN,8886,9106,CHENNAI-TUTICORIN,17992,All
2019,2,CHENNAI,TUTICORIN,8180,8341,CHENNAI-TUTICORIN,16521,All
2019,3,CHENNAI,TUTICORIN,8731,8535,CHENNAI-TUTICORIN,17266,All
2019,4,CHENNAI,TUTICORIN,9834,9568,CHENNAI-TUTICORIN,19402,All
2019,5,CHENNAI,TUTICORIN,10374,10036,CHENNAI-TUTICORIN,20410,All
2019,6,CHENNAI,TUTICORIN,9032,9437,CHENNAI-TUTICORIN,18469,All
2019,7,CHENNAI,TUTICORIN,9762,9610,CHENNAI-TUTICORIN,19372,All
2019,8,CHENNAI,TUTICORIN,10227,10217,CHENNAI-TUTICORIN,20444,All
2019,9,CHENNAI,TUTICORIN,9587,9693,CHENNAI-TUTICORIN,19280,All
2019,10,CHENNAI,TUTICORIN,9527,9243,CHENNAI-TUTICORIN,18770,All
2019,11,CHENNAI,TUTICORIN,9503,9471,CHENNAI-TUTICORIN,18974,All
2019,12,CHENNAI,TUTICORIN,10550,9866,CHENNAI-TUTICORIN,20416,All
2020,1,CHENNAI,TUTICORIN,9796,9964,CHENNAI-TUTICORIN,19760,All
2020,2,CHENNAI,TUTICORIN,8629,8649,CHENNAI-TUTICORIN,17278,All
2020,3,CHENNAI,TUTICORIN,5026,4921,CHENNAI-TUTICORIN,9947,All
2020,5,CHENNAI,TUTICORIN,178,174,CHENNAI-TUTICORIN,352,All
2020,6,CHENNAI,TUTICORIN,2535,1305,CHENNAI-TUTICORIN,3840,All
2020,7,CHENNAI,TUTICORIN,3690,3707,CHENNAI-TUTICORIN,7397,All
2020,8,CHENNAI,TUTICORIN,4619,4900,CHENNAI-TUTICORIN,9519,All
2020,9,CHENNAI,TUTICORIN,4406,5320,CHENNAI-TUTICORIN,9726,All
2020,10,CHENNAI,TUTICORIN,4810,4700,CHENNAI-TUTICORIN,9510,All
2020,11,CHENNAI,TUTICORIN,5129,4979,CHENNAI-TUTICORIN,10108,All
2020,12,CHENNAI,TUTICORIN,5786,5098,CHENNAI-TUTICORIN,10884,All
2021,1,CHENNAI,TUTICORIN,5906,5665,CHENNAI-TUTICORIN,11571,All
2021,2,CHENNAI,TUTICORIN,5402,5424,CHENNAI-TUTICORIN,10826,All
2021,3,CHENNAI,TUTICORIN,5584,5493,CHENNAI-TUTICORIN,11077,All
2021,4,CHENNAI,TUTICORIN,3900,3789,CHENNAI-TUTICORIN,7689,All
2021,6,CHENNAI,TUTICORIN,2611,2630,CHENNAI-TUTICORIN,5241,All
2021,7,CHENNAI,TUTICORIN,4614,4421,CHENNAI-TUTICORIN,9035,All
2021,8,CHENNAI,TUTICORIN,5872,5768,CHENNAI-TUTICORIN,11640,All
2021,9,CHENNAI,TUTICORIN,5929,5849,CHENNAI-TUTICORIN,11778,All
2021,10,CHENNAI,TUTICORIN,5855,5776,CHENNAI-TUTICORIN,11631,All
2021,11,CHENNAI,TUTICORIN,5666,5546,CHENNAI-TUTICORIN,11212,All
2021,12,CHENNAI,TUTICORIN,8012,7219,CHENNAI-TUTICORIN,15231,All
2022,1,CHENNAI,TUTICORIN,5143,5447,CHENNAI-TUTICORIN,10590,All
2022,2,CHENNAI,TUTICORIN,4791,4795,CHENNAI-TUTICORIN,9586,All
2022,3,CHENNAI,TUTICORIN,6555,6335,CHENNAI-TUTICORIN,12890,All
2022,4,CHENNAI,TUTICORIN,7142,6878,CHENNAI-TUTICORIN,14020,All
2022,5,CHENNAI,TUTICORIN,7603,7138,CHENNAI-TUTICORIN,14741,All
2022,6,CHENNAI,TUTICORIN,7051,6863,CHENNAI-TUTICORIN,13914,All
2022,7,CHENNAI,TUTICORIN,6924,6725,CHENNAI-TUTICORIN,13649,All
2022,8,CHENNAI,TUTICORIN,7288,7114,CHENNAI-TUTICORIN,14402,All
2022,9,CHENNAI,TUTICORIN,5859,5686,CHENNAI-TUTICORIN,11545,All
2022,10,CHENNAI,TUTICORIN,6548,6081,CHENNAI-TUTICORIN,12629,All
2022,11,CHENNAI,TUTICORIN,6086,5803,CHENNAI-TUTICORIN,11889,All
2022,12,CHENNAI,TUTICORIN,6605,5887,CHENNAI-TUTICORIN,12492,All
2023,1,CHENNAI,TUTICORIN,6498,6471,CHENNAI-TUTICORIN,12969,All
2023,2,CHENNAI,TUTICORIN,6498,6057,CHENNAI-TUTICORIN,12555,All
2023,3,CHENNAI,TUTICORIN,6902,6478,CHENNAI-TUTICORIN,13380,All
2023,4,CHENNAI,TUTICORIN,7208,6650,CHENNAI-TUTICORIN,13858,All
2023,5,CHENNAI,TUTICORIN,7536,6975,CHENNAI-TUTICORIN,14511,All
2023,6,CHENNAI,TUTICORIN,7074,6568,CHENNAI-TUTICORIN,13642,All
2023,7,CHENNAI,TUTICORIN,5641,5207,CHENNAI-TUTICORIN,10848,All
2023,8,CHENNAI,TUTICORIN,6243,5865,CHENNAI-TUTICORIN,12108,All
2023,9,CHENNAI,TUTICORIN,6909,6486,CHENNAI-TUTICORIN,13395,All
2023,10,CHENNAI,TUTICORIN,6515,6153,CHENNAI-TUTICORIN,12668,All
2023,11,CHENNAI,TUTICORIN,6315,5686,CHENNAI-TUTICORIN,12001,All
2023,12,CHENNAI,TUTICORIN,5491,4847,CHENNAI-TUTICORIN,10338,All
2024,1,CHENNAI,TUTICORIN,6584,6488,CHENNAI-TUTICORIN,13072,All
2024,2,CHENNAI,TUTICORIN,6362,5954,CHENNAI-TUTICORIN,12316,All
2024,3,CHENNAI,TUTICORIN,6514,5945,CHENNAI-TUTICORIN,12459,All
2024,4,CHENNAI,TUTICORIN,8050,7266,CHENNAI-TUTICORIN,15316,All
2024,6,CHENNAI,TUTICORIN,7721,7491,CHENNAI-TUTICORIN,15212,All
2024,7,CHENNAI,TUTICORIN,7965,7320,CHENNAI-TUTICORIN,15285,All
2024,8,CHENNAI,TUTICORIN,7349,6808,CHENNAI-TUTICORIN,14157,All
2024,9,CHENNAI,TUTICORIN,6162,5911,CHENNAI-TUTICORIN,12073,All
2024,10,CHENNAI,TUTICORIN,6240,5570,CHENNAI-TUTICORIN,11810,All
2024,11,CHENNAI,TUTICORIN,7137,6502,CHENNAI-TUTICORIN,13639,All
2024,12,CHENNAI,TUTICORIN,8045,6879,CHENNAI-TUTICORIN,14924,All
2025,1,CHENNAI,TUTICORIN,8041,7931,CHENNAI-TUTICORIN,15972,All
2025,2,CHENNAI,TUTICORIN,7609,7090,CHENNAI-TUTICORIN,14699,All
2025,3,CHENNAI,TUTICORIN,8628,7614,CHENNAI-TUTICORIN,16242,All
2018,2,CHENNAI,UDAIPUR,2327,1191,CHENNAI-UDAIPUR,3518,All
2018,3,CHENNAI,UDAIPUR,2337,1119,CHENNAI-UDAIPUR,3456,All
2018,4,CHENNAI,UDAIPUR,3546,1196,CHENNAI-UDAIPUR,4742,All
2018,5,CHENNAI,UDAIPUR,4024,3705,CHENNAI-UDAIPUR,7729,All
2018,6,CHENNAI,UDAIPUR,2945,2805,CHENNAI-UDAIPUR,5750,All
2018,7,CHENNAI,UDAIPUR,1519,2125,CHENNAI-UDAIPUR,3644,All
2018,8,CHENNAI,UDAIPUR,677,1700,CHENNAI-UDAIPUR,2377,All
2018,9,CHENNAI,UDAIPUR,2704,2566,CHENNAI-UDAIPUR,5270,All
2018,10,CHENNAI,UDAIPUR,3002,3621,CHENNAI-UDAIPUR,6623,All
2018,11,CHENNAI,UDAIPUR,4216,3969,CHENNAI-UDAIPUR,8185,All
2018,12,CHENNAI,UDAIPUR,4254,4653,CHENNAI-UDAIPUR,8907,All
2019,1,CHENNAI,UDAIPUR,4504,5311,CHENNAI-UDAIPUR,9815,All
2019,2,CHENNAI,UDAIPUR,4213,5095,CHENNAI-UDAIPUR,9308,All
2019,3,CHENNAI,UDAIPUR,3792,4656,CHENNAI-UDAIPUR,8448,All
2019,4,CHENNAI,UDAIPUR,4891,3843,CHENNAI-UDAIPUR,8734,All
2019,5,CHENNAI,UDAIPUR,4551,5543,CHENNAI-UDAIPUR,10094,All
2019,6,CHENNAI,UDAIPUR,3686,4397,CHENNAI-UDAIPUR,8083,All
2019,7,CHENNAI,UDAIPUR,2357,2950,CHENNAI-UDAIPUR,5307,All
2019,8,CHENNAI,UDAIPUR,4132,4102,CHENNAI-UDAIPUR,8234,All
2019,9,CHENNAI,UDAIPUR,0,1501,CHENNAI-UDAIPUR,1501,All
2019,10,CHENNAI,UDAIPUR,0,705,CHENNAI-UDAIPUR,705,All
2019,11,CHENNAI,UDAIPUR,0,364,CHENNAI-UDAIPUR,364,All
2019,12,CHENNAI,UDAIPUR,0,587,CHENNAI-UDAIPUR,587,All
2020,1,CHENNAI,UDAIPUR,0,458,CHENNAI-UDAIPUR,458,All
2020,2,CHENNAI,UDAIPUR,0,405,CHENNAI-UDAIPUR,405,All
2020,3,CHENNAI,UDAIPUR,0,153,CHENNAI-UDAIPUR,153,All
2020,8,CHENNAI,UDAIPUR,183,183,CHENNAI-UDAIPUR,366,All
2020,9,CHENNAI,UDAIPUR,177,146,CHENNAI-UDAIPUR,323,All
2020,10,CHENNAI,UDAIPUR,416,453,CHENNAI-UDAIPUR,869,All
2020,11,CHENNAI,UDAIPUR,277,88,CHENNAI-UDAIPUR,365,All
2020,12,CHENNAI,UDAIPUR,502,363,CHENNAI-UDAIPUR,865,All
2021,1,CHENNAI,UDAIPUR,524,439,CHENNAI-UDAIPUR,963,All
2021,2,CHENNAI,UDAIPUR,945,699,CHENNAI-UDAIPUR,1644,All
2021,3,CHENNAI,UDAIPUR,837,822,CHENNAI-UDAIPUR,1659,All
2021,4,CHENNAI,UDAIPUR,289,0,CHENNAI-UDAIPUR,289,All
2021,6,CHENNAI,UDAIPUR,225,0,CHENNAI-UDAIPUR,225,All
2021,7,CHENNAI,UDAIPUR,332,72,CHENNAI-UDAIPUR,404,All
2021,8,CHENNAI,UDAIPUR,550,292,CHENNAI-UDAIPUR,842,All
2021,9,CHENNAI,UDAIPUR,320,0,CHENNAI-UDAIPUR,320,All
2021,10,CHENNAI,UDAIPUR,159,0,CHENNAI-UDAIPUR,159,All
2022,4,CHENNAI,UDAIPUR,110,66,CHENNAI-UDAIPUR,176,All
2022,9,CHENNAI,UDAIPUR,43,62,CHENNAI-UDAIPUR,105,All
2019,5,CHENNAI,VADODARA,165,0,CHENNAI-VADODARA,165,All
2019,6,CHENNAI,VADODARA,72,0,CHENNAI-VADODARA,72,All
2019,7,CHENNAI,VADODARA,80,0,CHENNAI-VADODARA,80,All
2019,8,CHENNAI,VADODARA,75,0,CHENNAI-VADODARA,75,All
2019,9,CHENNAI,VADODARA,45,0,CHENNAI-VADODARA,45,All
2019,10,CHENNAI,VADODARA,36,0,CHENNAI-VADODARA,36,All
2019,11,CHENNAI,VADODARA,140,0,CHENNAI-VADODARA,140,All
2019,12,CHENNAI,VADODARA,314,0,CHENNAI-VADODARA,314,All
2020,1,CHENNAI,VADODARA,218,0,CHENNAI-VADODARA,218,All
2020,2,CHENNAI,VADODARA,180,0,CHENNAI-VADODARA,180,All
2020,3,CHENNAI,VADODARA,369,0,CHENNAI-VADODARA,369,All
2021,9,CHENNAI,VADODARA,647,536,CHENNAI-VADODARA,1183,All
2021,10,CHENNAI,VADODARA,649,566,CHENNAI-VADODARA,1215,All
2022,3,CHENNAI,VADODARA,162,203,CHENNAI-VADODARA,365,All
2022,4,CHENNAI,VADODARA,2756,2557,CHENNAI-VADODARA,5313,All
2022,5,CHENNAI,VADODARA,1360,1499,CHENNAI-VADODARA,2859,All
2022,6,CHENNAI,VADODARA,628,670,CHENNAI-VADODARA,1298,All
2022,7,CHENNAI,VADODARA,583,588,CHENNAI-VADODARA,1171,All
2022,8,CHENNAI,VADODARA,702,767,CHENNAI-VADODARA,1469,All
2022,9,CHENNAI,VADODARA,184,141,CHENNAI-VADODARA,325,All
2022,11,CHENNAI,VADODARA,748,566,CHENNAI-VADODARA,1314,All
2022,12,CHENNAI,VADODARA,574,539,CHENNAI-VADODARA,1113,All
2023,1,CHENNAI,VADODARA,535,542,CHENNAI-VADODARA,1077,All
2023,2,CHENNAI,VADODARA,581,633,CHENNAI-VADODARA,1214,All
2023,3,CHENNAI,VADODARA,607,630,CHENNAI-VADODARA,1237,All
2023,4,CHENNAI,VADODARA,646,633,CHENNAI-VADODARA,1279,All
2023,5,CHENNAI,VADODARA,868,951,CHENNAI-VADODARA,1819,All
2023,6,CHENNAI,VADODARA,604,727,CHENNAI-VADODARA,1331,All
2023,7,CHENNAI,VADODARA,580,632,CHENNAI-VADODARA,1212,All
2023,8,CHENNAI,VADODARA,849,840,CHENNAI-VADODARA,1689,All
2023,9,CHENNAI,VADODARA,724,660,CHENNAI-VADODARA,1384,All
2023,10,CHENNAI,VADODARA,680,674,CHENNAI-VADODARA,1354,All
2023,11,CHENNAI,VADODARA,780,791,CHENNAI-VADODARA,1571,All
2023,12,CHENNAI,VADODARA,689,642,CHENNAI-VADODARA,1331,All
2024,10,CHENNAI,VADODARA,104,164,CHENNAI-VADODARA,268,All
2024,11,CHENNAI,VADODARA,677,581,CHENNAI-VADODARA,1258,All
2024,12,CHENNAI,VADODARA,629,673,CHENNAI-VADODARA,1302,All
2025,1,CHENNAI,VADODARA,675,762,CHENNAI-VADODARA,1437,All
2025,2,CHENNAI,VADODARA,690,615,CHENNAI-VADODARA,1305,All
2025,3,CHENNAI,VADODARA,521,559,CHENNAI-VADODARA,1080,All
2017,6,CHENNAI,VARANASI,152,0,CHENNAI-VARANASI,152,All
2017,7,CHENNAI,VARANASI,484,0,CHENNAI-VARANASI,484,All
2017,8,CHENNAI,VARANASI,530,0,CHENNAI-VARANASI,530,All
2017,9,CHENNAI,VARANASI,593,0,CHENNAI-VARANASI,593,All
2017,10,CHENNAI,VARANASI,554,0,CHENNAI-VARANASI,554,All
2017,11,CHENNAI,VARANASI,340,0,CHENNAI-VARANASI,340,All
2017,12,CHENNAI,VARANASI,931,0,CHENNAI-VARANASI,931,All
2018,1,CHENNAI,VARANASI,922,0,CHENNAI-VARANASI,922,All
2018,2,CHENNAI,VARANASI,2715,3357,CHENNAI-VARANASI,6072,All
2018,3,CHENNAI,VARANASI,3248,4267,CHENNAI-VARANASI,7515,All
2018,4,CHENNAI,VARANASI,3102,3659,CHENNAI-VARANASI,6761,All
2018,5,CHENNAI,VARANASI,3159,5072,CHENNAI-VARANASI,8231,All
2018,6,CHENNAI,VARANASI,2422,3985,CHENNAI-VARANASI,6407,All
2018,7,CHENNAI,VARANASI,1799,3368,CHENNAI-VARANASI,5167,All
2018,8,CHENNAI,VARANASI,1727,2998,CHENNAI-VARANASI,4725,All
2018,9,CHENNAI,VARANASI,2031,3494,CHENNAI-VARANASI,5525,All
2018,10,CHENNAI,VARANASI,2099,2963,CHENNAI-VARANASI,5062,All
2018,11,CHENNAI,VARANASI,2216,3413,CHENNAI-VARANASI,5629,All
2018,12,CHENNAI,VARANASI,1379,0,CHENNAI-VARANASI,1379,All
2019,1,CHENNAI,VARANASI,4540,3612,CHENNAI-VARANASI,8152,All
2019,2,CHENNAI,VARANASI,5900,5255,CHENNAI-VARANASI,11155,All
2019,3,CHENNAI,VARANASI,6183,5675,CHENNAI-VARANASI,11858,All
2019,4,CHENNAI,VARANASI,4768,3761,CHENNAI-VARANASI,8529,All
2019,5,CHENNAI,VARANASI,5077,4488,CHENNAI-VARANASI,9565,All
2019,6,CHENNAI,VARANASI,6741,7711,CHENNAI-VARANASI,14452,All
2019,7,CHENNAI,VARANASI,7815,7951,CHENNAI-VARANASI,15766,All
2019,8,CHENNAI,VARANASI,7570,7378,CHENNAI-VARANASI,14948,All
2019,9,CHENNAI,VARANASI,7861,7701,CHENNAI-VARANASI,15562,All
2019,10,CHENNAI,VARANASI,9303,7557,CHENNAI-VARANASI,16860,All
2019,11,CHENNAI,VARANASI,9117,10974,CHENNAI-VARANASI,20091,All
2019,12,CHENNAI,VARANASI,8059,10022,CHENNAI-VARANASI,18081,All
2020,1,CHENNAI,VARANASI,7912,8597,CHENNAI-VARANASI,16509,All
2020,2,CHENNAI,VARANASI,9719,8956,CHENNAI-VARANASI,18675,All
2020,3,CHENNAI,VARANASI,7722,6733,CHENNAI-VARANASI,14455,All
2020,5,CHENNAI,VARANASI,174,45,CHENNAI-VARANASI,219,All
2020,6,CHENNAI,VARANASI,2866,847,CHENNAI-VARANASI,3713,All
2020,7,CHENNAI,VARANASI,2815,1352,CHENNAI-VARANASI,4167,All
2020,8,CHENNAI,VARANASI,1284,2026,CHENNAI-VARANASI,3310,All
2020,9,CHENNAI,VARANASI,1643,3919,CHENNAI-VARANASI,5562,All
2020,10,CHENNAI,VARANASI,2416,2539,CHENNAI-VARANASI,4955,All
2020,11,CHENNAI,VARANASI,5257,2503,CHENNAI-VARANASI,7760,All
2020,12,CHENNAI,VARANASI,3112,4831,CHENNAI-VARANASI,7943,All
2021,1,CHENNAI,VARANASI,2874,3326,CHENNAI-VARANASI,6200,All
2021,2,CHENNAI,VARANASI,3821,3242,CHENNAI-VARANASI,7063,All
2021,3,CHENNAI,VARANASI,4929,3952,CHENNAI-VARANASI,8881,All
2021,4,CHENNAI,VARANASI,4523,2630,CHENNAI-VARANASI,7153,All
2021,6,CHENNAI,VARANASI,426,642,CHENNAI-VARANASI,1068,All
2021,7,CHENNAI,VARANASI,452,327,CHENNAI-VARANASI,779,All
2021,8,CHENNAI,VARANASI,1794,1904,CHENNAI-VARANASI,3698,All
2021,9,CHENNAI,VARANASI,2005,1909,CHENNAI-VARANASI,3914,All
2021,10,CHENNAI,VARANASI,2692,2239,CHENNAI-VARANASI,4931,All
2021,11,CHENNAI,VARANASI,2360,2205,CHENNAI-VARANASI,4565,All
2021,12,CHENNAI,VARANASI,2004,1976,CHENNAI-VARANASI,3980,All
2022,1,CHENNAI,VARANASI,2563,2596,CHENNAI-VARANASI,5159,All
2022,2,CHENNAI,VARANASI,4054,3505,CHENNAI-VARANASI,7559,All
2022,3,CHENNAI,VARANASI,6442,5813,CHENNAI-VARANASI,12255,All
2022,4,CHENNAI,VARANASI,2726,2491,CHENNAI-VARANASI,5217,All
2022,5,CHENNAI,VARANASI,2725,2720,CHENNAI-VARANASI,5445,All
2022,6,CHENNAI,VARANASI,2531,2563,CHENNAI-VARANASI,5094,All
2022,7,CHENNAI,VARANASI,2878,2734,CHENNAI-VARANASI,5612,All
2022,8,CHENNAI,VARANASI,2735,2345,CHENNAI-VARANASI,5080,All
2022,9,CHENNAI,VARANASI,2820,2439,CHENNAI-VARANASI,5259,All
2022,10,CHENNAI,VARANASI,3099,3077,CHENNAI-VARANASI,6176,All
2022,11,CHENNAI,VARANASI,4581,4749,CHENNAI-VARANASI,9330,All
2022,12,CHENNAI,VARANASI,3813,4853,CHENNAI-VARANASI,8666,All
2023,1,CHENNAI,VARANASI,3625,4502,CHENNAI-VARANASI,8127,All
2023,2,CHENNAI,VARANASI,4571,4584,CHENNAI-VARANASI,9155,All
2023,3,CHENNAI,VARANASI,4207,4581,CHENNAI-VARANASI,8788,All
2023,4,CHENNAI,VARANASI,5038,4922,CHENNAI-VARANASI,9960,All
2023,5,CHENNAI,VARANASI,5224,5345,CHENNAI-VARANASI,10569,All
2023,6,CHENNAI,VARANASI,4916,5282,CHENNAI-VARANASI,10198,All
2023,7,CHENNAI,VARANASI,4895,5157,CHENNAI-VARANASI,10052,All
2023,8,CHENNAI,VARANASI,4922,4866,CHENNAI-VARANASI,9788,All
2023,9,CHENNAI,VARANASI,5009,4917,CHENNAI-VARANASI,9926,All
2023,10,CHENNAI,VARANASI,5540,5031,CHENNAI-VARANASI,10571,All
2023,11,CHENNAI,VARANASI,6773,5246,CHENNAI-VARANASI,12019,All
2023,12,CHENNAI,VARANASI,5656,5545,CHENNAI-VARANASI,11201,All
2024,1,CHENNAI,VARANASI,4263,4876,CHENNAI-VARANASI,9139,All
2024,2,CHENNAI,VARANASI,4379,3985,CHENNAI-VARANASI,8364,All
2024,3,CHENNAI,VARANASI,4332,4166,CHENNAI-VARANASI,8498,All
2024,4,CHENNAI,VARANASI,5686,4489,CHENNAI-VARANASI,10175,All
2024,6,CHENNAI,VARANASI,4703,4995,CHENNAI-VARANASI,9698,All
2024,7,CHENNAI,VARANASI,5907,6370,CHENNAI-VARANASI,12277,All
2024,8,CHENNAI,VARANASI,4837,5021,CHENNAI-VARANASI,9858,All
2024,9,CHENNAI,VARANASI,4550,4346,CHENNAI-VARANASI,8896,All
2024,10,CHENNAI,VARANASI,5862,4416,CHENNAI-VARANASI,10278,All
2024,11,CHENNAI,VARANASI,4764,4980,CHENNAI-VARANASI,9744,All
2024,12,CHENNAI,VARANASI,4575,5271,CHENNAI-VARANASI,9846,All
2025,1,CHENNAI,VARANASI,5236,5202,CHENNAI-VARANASI,10438,All
2025,2,CHENNAI,VARANASI,5159,5212,CHENNAI-VARANASI,10371,All
2025,3,CHENNAI,VARANASI,5534,5228,CHENNAI-VARANASI,10762,All
2018,2,CHENNAI,VIDYANAGAR,65,51,CHENNAI-VIDYANAGAR,116,All
2015,4,CHENNAI,VIJAYAWADA,1412,1476,CHENNAI-VIJAYAWADA,2888,All
2015,5,CHENNAI,VIJAYAWADA,1962,2282,CHENNAI-VIJAYAWADA,4244,All
2015,6,CHENNAI,VIJAYAWADA,2762,2839,CHENNAI-VIJAYAWADA,5601,All
2015,7,CHENNAI,VIJAYAWADA,3609,3540,CHENNAI-VIJAYAWADA,7149,All
2015,8,CHENNAI,VIJAYAWADA,2979,3067,CHENNAI-VIJAYAWADA,6046,All
2015,9,CHENNAI,VIJAYAWADA,2637,2572,CHENNAI-VIJAYAWADA,5209,All
2015,10,CHENNAI,VIJAYAWADA,2066,2069,CHENNAI-VIJAYAWADA,4135,All
2015,11,CHENNAI,VIJAYAWADA,1885,1897,CHENNAI-VIJAYAWADA,3782,All
2015,12,CHENNAI,VIJAYAWADA,1678,1623,CHENNAI-VIJAYAWADA,3301,All
2016,1,CHENNAI,VIJAYAWADA,2174,2330,CHENNAI-VIJAYAWADA,4504,All
2016,2,CHENNAI,VIJAYAWADA,2066,2203,CHENNAI-VIJAYAWADA,4269,All
2016,3,CHENNAI,VIJAYAWADA,2195,2479,CHENNAI-VIJAYAWADA,4674,All
2016,4,CHENNAI,VIJAYAWADA,2316,2270,CHENNAI-VIJAYAWADA,4586,All
2016,5,CHENNAI,VIJAYAWADA,2417,2315,CHENNAI-VIJAYAWADA,4732,All
2016,6,CHENNAI,VIJAYAWADA,2491,2369,CHENNAI-VIJAYAWADA,4860,All
2016,7,CHENNAI,VIJAYAWADA,2475,2496,CHENNAI-VIJAYAWADA,4971,All
2016,8,CHENNAI,VIJAYAWADA,3012,3077,CHENNAI-VIJAYAWADA,6089,All
2016,9,CHENNAI,VIJAYAWADA,2412,2588,CHENNAI-VIJAYAWADA,5000,All
2016,10,CHENNAI,VIJAYAWADA,4311,4181,CHENNAI-VIJAYAWADA,8492,All
2016,11,CHENNAI,VIJAYAWADA,4609,4724,CHENNAI-VIJAYAWADA,9333,All
2016,12,CHENNAI,VIJAYAWADA,2931,4076,CHENNAI-VIJAYAWADA,7007,All
2017,1,CHENNAI,VIJAYAWADA,3624,3841,CHENNAI-VIJAYAWADA,7465,All
2017,2,CHENNAI,VIJAYAWADA,3435,3763,CHENNAI-VIJAYAWADA,7198,All
2017,3,CHENNAI,VIJAYAWADA,3681,3973,CHENNAI-VIJAYAWADA,7654,All
2017,4,CHENNAI,VIJAYAWADA,4488,3727,CHENNAI-VIJAYAWADA,8215,All
2017,5,CHENNAI,VIJAYAWADA,4085,4332,CHENNAI-VIJAYAWADA,8417,All
2017,6,CHENNAI,VIJAYAWADA,3590,3846,CHENNAI-VIJAYAWADA,7436,All
2017,7,CHENNAI,VIJAYAWADA,3983,4250,CHENNAI-VIJAYAWADA,8233,All
2017,8,CHENNAI,VIJAYAWADA,3891,4331,CHENNAI-VIJAYAWADA,8222,All
2017,9,CHENNAI,VIJAYAWADA,5495,5595,CHENNAI-VIJAYAWADA,11090,All
2017,10,CHENNAI,VIJAYAWADA,5129,5544,CHENNAI-VIJAYAWADA,10673,All
2017,11,CHENNAI,VIJAYAWADA,4510,4829,CHENNAI-VIJAYAWADA,9339,All
2017,12,CHENNAI,VIJAYAWADA,4529,4491,CHENNAI-VIJAYAWADA,9020,All
2018,1,CHENNAI,VIJAYAWADA,4357,4431,CHENNAI-VIJAYAWADA,8788,All
2018,2,CHENNAI,VIJAYAWADA,3929,3954,CHENNAI-VIJAYAWADA,7883,All
2018,3,CHENNAI,VIJAYAWADA,7802,8035,CHENNAI-VIJAYAWADA,15837,All
2018,4,CHENNAI,VIJAYAWADA,7598,7436,CHENNAI-VIJAYAWADA,15034,All
2018,5,CHENNAI,VIJAYAWADA,8601,9519,CHENNAI-VIJAYAWADA,18120,All
2018,6,CHENNAI,VIJAYAWADA,8017,7566,CHENNAI-VIJAYAWADA,15583,All
2018,7,CHENNAI,VIJAYAWADA,7726,7923,CHENNAI-VIJAYAWADA,15649,All
2018,8,CHENNAI,VIJAYAWADA,5400,5627,CHENNAI-VIJAYAWADA,11027,All
2018,9,CHENNAI,VIJAYAWADA,5169,5781,CHENNAI-VIJAYAWADA,10950,All
2018,10,CHENNAI,VIJAYAWADA,5513,5623,CHENNAI-VIJAYAWADA,11136,All
2018,11,CHENNAI,VIJAYAWADA,4887,5091,CHENNAI-VIJAYAWADA,9978,All
2018,12,CHENNAI,VIJAYAWADA,5928,5972,CHENNAI-VIJAYAWADA,11900,All
2019,1,CHENNAI,VIJAYAWADA,5166,6178,CHENNAI-VIJAYAWADA,11344,All
2019,2,CHENNAI,VIJAYAWADA,5883,6115,CHENNAI-VIJAYAWADA,11998,All
2019,3,CHENNAI,VIJAYAWADA,5659,6196,CHENNAI-VIJAYAWADA,11855,All
2019,4,CHENNAI,VIJAYAWADA,5806,5916,CHENNAI-VIJAYAWADA,11722,All
2019,5,CHENNAI,VIJAYAWADA,5590,6173,CHENNAI-VIJAYAWADA,11763,All
2019,6,CHENNAI,VIJAYAWADA,5659,6291,CHENNAI-VIJAYAWADA,11950,All
2019,7,CHENNAI,VIJAYAWADA,5210,6125,CHENNAI-VIJAYAWADA,11335,All
2019,8,CHENNAI,VIJAYAWADA,5151,5820,CHENNAI-VIJAYAWADA,10971,All
2019,9,CHENNAI,VIJAYAWADA,4438,5148,CHENNAI-VIJAYAWADA,9586,All
2019,10,CHENNAI,VIJAYAWADA,5068,5593,CHENNAI-VIJAYAWADA,10661,All
2019,11,CHENNAI,VIJAYAWADA,4056,3905,CHENNAI-VIJAYAWADA,7961,All
2019,12,CHENNAI,VIJAYAWADA,4048,4203,CHENNAI-VIJAYAWADA,8251,All
2020,1,CHENNAI,VIJAYAWADA,3510,4192,CHENNAI-VIJAYAWADA,7702,All
2020,2,CHENNAI,VIJAYAWADA,3412,3564,CHENNAI-VIJAYAWADA,6976,All
2020,3,CHENNAI,VIJAYAWADA,2443,2276,CHENNAI-VIJAYAWADA,4719,All
2020,5,CHENNAI,VIJAYAWADA,123,66,CHENNAI-VIJAYAWADA,189,All
2020,6,CHENNAI,VIJAYAWADA,0,0,CHENNAI-VIJAYAWADA,0,All
2020,9,CHENNAI,VIJAYAWADA,824,909,CHENNAI-VIJAYAWADA,1733,All
2020,10,CHENNAI,VIJAYAWADA,1239,1330,CHENNAI-VIJAYAWADA,2569,All
2020,11,CHENNAI,VIJAYAWADA,1638,1512,CHENNAI-VIJAYAWADA,3150,All
2020,12,CHENNAI,VIJAYAWADA,1848,1622,CHENNAI-VIJAYAWADA,3470,All
2021,1,CHENNAI,VIJAYAWADA,2087,2145,CHENNAI-VIJAYAWADA,4232,All
2021,2,CHENNAI,VIJAYAWADA,1730,1789,CHENNAI-VIJAYAWADA,3519,All
2021,3,CHENNAI,VIJAYAWADA,1706,1950,CHENNAI-VIJAYAWADA,3656,All
2021,4,CHENNAI,VIJAYAWADA,1113,1477,CHENNAI-VIJAYAWADA,2590,All
2021,7,CHENNAI,VIJAYAWADA,244,308,CHENNAI-VIJAYAWADA,552,All
2021,8,CHENNAI,VIJAYAWADA,816,1074,CHENNAI-VIJAYAWADA,1890,All
2021,9,CHENNAI,VIJAYAWADA,1423,1822,CHENNAI-VIJAYAWADA,3245,All
2021,10,CHENNAI,VIJAYAWADA,1736,1984,CHENNAI-VIJAYAWADA,3720,All
2021,11,CHENNAI,VIJAYAWADA,2955,2865,CHENNAI-VIJAYAWADA,5820,All
2021,12,CHENNAI,VIJAYAWADA,3767,3487,CHENNAI-VIJAYAWADA,7254,All
2022,1,CHENNAI,VIJAYAWADA,1813,1750,CHENNAI-VIJAYAWADA,3563,All
2022,2,CHENNAI,VIJAYAWADA,2017,1755,CHENNAI-VIJAYAWADA,3772,All
2022,3,CHENNAI,VIJAYAWADA,3398,3492,CHENNAI-VIJAYAWADA,6890,All
2022,4,CHENNAI,VIJAYAWADA,2875,3301,CHENNAI-VIJAYAWADA,6176,All
2022,5,CHENNAI,VIJAYAWADA,3033,3359,CHENNAI-VIJAYAWADA,6392,All
2022,6,CHENNAI,VIJAYAWADA,4740,5179,CHENNAI-VIJAYAWADA,9919,All
2022,7,CHENNAI,VIJAYAWADA,4312,5052,CHENNAI-VIJAYAWADA,9364,All
2022,8,CHENNAI,VIJAYAWADA,4486,5386,CHENNAI-VIJAYAWADA,9872,All
2022,9,CHENNAI,VIJAYAWADA,3565,4442,CHENNAI-VIJAYAWADA,8007,All
2022,10,CHENNAI,VIJAYAWADA,3575,4186,CHENNAI-VIJAYAWADA,7761,All
2022,11,CHENNAI,VIJAYAWADA,4396,3914,CHENNAI-VIJAYAWADA,8310,All
2022,12,CHENNAI,VIJAYAWADA,4330,4018,CHENNAI-VIJAYAWADA,8348,All
2023,1,CHENNAI,VIJAYAWADA,4016,4548,CHENNAI-VIJAYAWADA,8564,All
2023,2,CHENNAI,VIJAYAWADA,3752,3893,CHENNAI-VIJAYAWADA,7645,All
2023,3,CHENNAI,VIJAYAWADA,4191,4234,CHENNAI-VIJAYAWADA,8425,All
2023,4,CHENNAI,VIJAYAWADA,4084,4341,CHENNAI-VIJAYAWADA,8425,All
2023,5,CHENNAI,VIJAYAWADA,4667,4620,CHENNAI-VIJAYAWADA,9287,All
2023,6,CHENNAI,VIJAYAWADA,4862,4692,CHENNAI-VIJAYAWADA,9554,All
2023,7,CHENNAI,VIJAYAWADA,3496,3393,CHENNAI-VIJAYAWADA,6889,All
2023,8,CHENNAI,VIJAYAWADA,3923,3684,CHENNAI-VIJAYAWADA,7607,All
2023,9,CHENNAI,VIJAYAWADA,4183,4011,CHENNAI-VIJAYAWADA,8194,All
2023,10,CHENNAI,VIJAYAWADA,4569,4225,CHENNAI-VIJAYAWADA,8794,All
2023,11,CHENNAI,VIJAYAWADA,3901,3770,CHENNAI-VIJAYAWADA,7671,All
2023,12,CHENNAI,VIJAYAWADA,4150,3921,CHENNAI-VIJAYAWADA,8071,All
2024,1,CHENNAI,VIJAYAWADA,3697,4370,CHENNAI-VIJAYAWADA,8067,All
2024,2,CHENNAI,VIJAYAWADA,3465,3627,CHENNAI-VIJAYAWADA,7092,All
2024,3,CHENNAI,VIJAYAWADA,3541,3779,CHENNAI-VIJAYAWADA,7320,All
2024,4,CHENNAI,VIJAYAWADA,3786,3597,CHENNAI-VIJAYAWADA,7383,All
2024,6,CHENNAI,VIJAYAWADA,4221,3731,CHENNAI-VIJAYAWADA,7952,All
2024,7,CHENNAI,VIJAYAWADA,3873,3805,CHENNAI-VIJAYAWADA,7678,All
2024,8,CHENNAI,VIJAYAWADA,4036,4164,CHENNAI-VIJAYAWADA,8200,All
2024,9,CHENNAI,VIJAYAWADA,3464,3466,CHENNAI-VIJAYAWADA,6930,All
2024,10,CHENNAI,VIJAYAWADA,3957,3672,CHENNAI-VIJAYAWADA,7629,All
2024,11,CHENNAI,VIJAYAWADA,3730,3631,CHENNAI-VIJAYAWADA,7361,All
2024,12,CHENNAI,VIJAYAWADA,4192,4028,CHENNAI-VIJAYAWADA,8220,All
2025,1,CHENNAI,VIJAYAWADA,4004,4185,CHENNAI-VIJAYAWADA,8189,All
2025,2,CHENNAI,VIJAYAWADA,4114,4066,CHENNAI-VIJAYAWADA,8180,All
2025,3,CHENNAI,VIJAYAWADA,3933,3735,CHENNAI-VIJAYAWADA,7668,All
2015,4,CHENNAI,VISAKHAPATNAM,5334,5185,CHENNAI-VISAKHAPATNAM,10519,All
2015,5,CHENNAI,VISAKHAPATNAM,5603,5612,CHENNAI-VISAKHAPATNAM,11215,All
2015,6,CHENNAI,VISAKHAPATNAM,5457,5393,CHENNAI-VISAKHAPATNAM,10850,All
2015,7,CHENNAI,VISAKHAPATNAM,5791,5699,CHENNAI-VISAKHAPATNAM,11490,All
2015,8,CHENNAI,VISAKHAPATNAM,5538,5611,CHENNAI-VISAKHAPATNAM,11149,All
2015,9,CHENNAI,VISAKHAPATNAM,5183,5008,CHENNAI-VISAKHAPATNAM,10191,All
2015,10,CHENNAI,VISAKHAPATNAM,5268,5118,CHENNAI-VISAKHAPATNAM,10386,All
2015,11,CHENNAI,VISAKHAPATNAM,5265,5257,CHENNAI-VISAKHAPATNAM,10522,All
2015,12,CHENNAI,VISAKHAPATNAM,3974,3990,CHENNAI-VISAKHAPATNAM,7964,All
2016,1,CHENNAI,VISAKHAPATNAM,5093,5097,CHENNAI-VISAKHAPATNAM,10190,All
2016,2,CHENNAI,VISAKHAPATNAM,5047,4941,CHENNAI-VISAKHAPATNAM,9988,All
2016,3,CHENNAI,VISAKHAPATNAM,5584,5481,CHENNAI-VISAKHAPATNAM,11065,All
2016,4,CHENNAI,VISAKHAPATNAM,5483,5468,CHENNAI-VISAKHAPATNAM,10951,All
2016,5,CHENNAI,VISAKHAPATNAM,5688,5601,CHENNAI-VISAKHAPATNAM,11289,All
2016,6,CHENNAI,VISAKHAPATNAM,9424,8727,CHENNAI-VISAKHAPATNAM,18151,All
2016,7,CHENNAI,VISAKHAPATNAM,10631,10431,CHENNAI-VISAKHAPATNAM,21062,All
2016,8,CHENNAI,VISAKHAPATNAM,13907,13577,CHENNAI-VISAKHAPATNAM,27484,All
2016,9,CHENNAI,VISAKHAPATNAM,12566,11800,CHENNAI-VISAKHAPATNAM,24366,All
2016,10,CHENNAI,VISAKHAPATNAM,14604,13131,CHENNAI-VISAKHAPATNAM,27735,All
2016,11,CHENNAI,VISAKHAPATNAM,12673,12375,CHENNAI-VISAKHAPATNAM,25048,All
2016,12,CHENNAI,VISAKHAPATNAM,13487,12337,CHENNAI-VISAKHAPATNAM,25824,All
2017,1,CHENNAI,VISAKHAPATNAM,13200,12694,CHENNAI-VISAKHAPATNAM,25894,All
2017,2,CHENNAI,VISAKHAPATNAM,11871,11468,CHENNAI-VISAKHAPATNAM,23339,All
2017,3,CHENNAI,VISAKHAPATNAM,12134,11574,CHENNAI-VISAKHAPATNAM,23708,All
2017,4,CHENNAI,VISAKHAPATNAM,10162,10002,CHENNAI-VISAKHAPATNAM,20164,All
2017,5,CHENNAI,VISAKHAPATNAM,11050,11622,CHENNAI-VISAKHAPATNAM,22672,All
2017,6,CHENNAI,VISAKHAPATNAM,10248,10076,CHENNAI-VISAKHAPATNAM,20324,All
2017,7,CHENNAI,VISAKHAPATNAM,9967,9833,CHENNAI-VISAKHAPATNAM,19800,All
2017,8,CHENNAI,VISAKHAPATNAM,9973,9440,CHENNAI-VISAKHAPATNAM,19413,All
2017,9,CHENNAI,VISAKHAPATNAM,9396,8515,CHENNAI-VISAKHAPATNAM,17911,All
2017,10,CHENNAI,VISAKHAPATNAM,9399,8354,CHENNAI-VISAKHAPATNAM,17753,All
2017,11,CHENNAI,VISAKHAPATNAM,10563,10645,CHENNAI-VISAKHAPATNAM,21208,All
2017,12,CHENNAI,VISAKHAPATNAM,10744,10947,CHENNAI-VISAKHAPATNAM,21691,All
2018,1,CHENNAI,VISAKHAPATNAM,10469,10886,CHENNAI-VISAKHAPATNAM,21355,All
2018,2,CHENNAI,VISAKHAPATNAM,11706,10532,CHENNAI-VISAKHAPATNAM,22238,All
2018,3,CHENNAI,VISAKHAPATNAM,12538,13163,CHENNAI-VISAKHAPATNAM,25701,All
2018,4,CHENNAI,VISAKHAPATNAM,12076,11966,CHENNAI-VISAKHAPATNAM,24042,All
2018,5,CHENNAI,VISAKHAPATNAM,11759,13062,CHENNAI-VISAKHAPATNAM,24821,All
2018,6,CHENNAI,VISAKHAPATNAM,11078,10396,CHENNAI-VISAKHAPATNAM,21474,All
2018,7,CHENNAI,VISAKHAPATNAM,10900,10630,CHENNAI-VISAKHAPATNAM,21530,All
2018,8,CHENNAI,VISAKHAPATNAM,9912,8603,CHENNAI-VISAKHAPATNAM,18515,All
2018,9,CHENNAI,VISAKHAPATNAM,9461,8243,CHENNAI-VISAKHAPATNAM,17704,All
2018,10,CHENNAI,VISAKHAPATNAM,8904,8494,CHENNAI-VISAKHAPATNAM,17398,All
2018,11,CHENNAI,VISAKHAPATNAM,11371,11933,CHENNAI-VISAKHAPATNAM,23304,All
2018,12,CHENNAI,VISAKHAPATNAM,12594,13456,CHENNAI-VISAKHAPATNAM,26050,All
2019,1,CHENNAI,VISAKHAPATNAM,9973,11099,CHENNAI-VISAKHAPATNAM,21072,All
2019,2,CHENNAI,VISAKHAPATNAM,11073,11295,CHENNAI-VISAKHAPATNAM,22368,All
2019,3,CHENNAI,VISAKHAPATNAM,8402,8298,CHENNAI-VISAKHAPATNAM,16700,All
2019,4,CHENNAI,VISAKHAPATNAM,8475,7627,CHENNAI-VISAKHAPATNAM,16102,All
2019,5,CHENNAI,VISAKHAPATNAM,8827,8558,CHENNAI-VISAKHAPATNAM,17385,All
2019,6,CHENNAI,VISAKHAPATNAM,8968,8922,CHENNAI-VISAKHAPATNAM,17890,All
2019,7,CHENNAI,VISAKHAPATNAM,10106,10115,CHENNAI-VISAKHAPATNAM,20221,All
2019,8,CHENNAI,VISAKHAPATNAM,8668,8438,CHENNAI-VISAKHAPATNAM,17106,All
2019,9,CHENNAI,VISAKHAPATNAM,12824,12281,CHENNAI-VISAKHAPATNAM,25105,All
2019,10,CHENNAI,VISAKHAPATNAM,10709,10822,CHENNAI-VISAKHAPATNAM,21531,All
2019,11,CHENNAI,VISAKHAPATNAM,15474,15319,CHENNAI-VISAKHAPATNAM,30793,All
2019,12,CHENNAI,VISAKHAPATNAM,15703,15679,CHENNAI-VISAKHAPATNAM,31382,All
2020,1,CHENNAI,VISAKHAPATNAM,15540,15775,CHENNAI-VISAKHAPATNAM,31315,All
2020,2,CHENNAI,VISAKHAPATNAM,13646,12920,CHENNAI-VISAKHAPATNAM,26566,All
2020,3,CHENNAI,VISAKHAPATNAM,9408,7586,CHENNAI-VISAKHAPATNAM,16994,All
2020,5,CHENNAI,VISAKHAPATNAM,322,211,CHENNAI-VISAKHAPATNAM,533,All
2020,6,CHENNAI,VISAKHAPATNAM,1881,1031,CHENNAI-VISAKHAPATNAM,2912,All
2020,7,CHENNAI,VISAKHAPATNAM,1940,931,CHENNAI-VISAKHAPATNAM,2871,All
2020,8,CHENNAI,VISAKHAPATNAM,1696,2661,CHENNAI-VISAKHAPATNAM,4357,All
2020,9,CHENNAI,VISAKHAPATNAM,3371,4043,CHENNAI-VISAKHAPATNAM,7414,All
2020,10,CHENNAI,VISAKHAPATNAM,6524,7437,CHENNAI-VISAKHAPATNAM,13961,All
2020,11,CHENNAI,VISAKHAPATNAM,8395,10486,CHENNAI-VISAKHAPATNAM,18881,All
2020,12,CHENNAI,VISAKHAPATNAM,9300,9679,CHENNAI-VISAKHAPATNAM,18979,All
2021,1,CHENNAI,VISAKHAPATNAM,10325,11146,CHENNAI-VISAKHAPATNAM,21471,All
2021,2,CHENNAI,VISAKHAPATNAM,7602,8293,CHENNAI-VISAKHAPATNAM,15895,All
2021,3,CHENNAI,VISAKHAPATNAM,6540,6711,CHENNAI-VISAKHAPATNAM,13251,All
2021,4,CHENNAI,VISAKHAPATNAM,8192,6232,CHENNAI-VISAKHAPATNAM,14424,All
2021,6,CHENNAI,VISAKHAPATNAM,1789,2440,CHENNAI-VISAKHAPATNAM,4229,All
2021,7,CHENNAI,VISAKHAPATNAM,4233,5374,CHENNAI-VISAKHAPATNAM,9607,All
2021,8,CHENNAI,VISAKHAPATNAM,5940,7480,CHENNAI-VISAKHAPATNAM,13420,All
2021,9,CHENNAI,VISAKHAPATNAM,5421,7556,CHENNAI-VISAKHAPATNAM,12977,All
2021,10,CHENNAI,VISAKHAPATNAM,7227,8940,CHENNAI-VISAKHAPATNAM,16167,All
2021,11,CHENNAI,VISAKHAPATNAM,7968,8375,CHENNAI-VISAKHAPATNAM,16343,All
2021,12,CHENNAI,VISAKHAPATNAM,9927,10339,CHENNAI-VISAKHAPATNAM,20266,All
2022,1,CHENNAI,VISAKHAPATNAM,5709,6219,CHENNAI-VISAKHAPATNAM,11928,All
2022,2,CHENNAI,VISAKHAPATNAM,5355,6812,CHENNAI-VISAKHAPATNAM,12167,All
2022,3,CHENNAI,VISAKHAPATNAM,7766,8711,CHENNAI-VISAKHAPATNAM,16477,All
2022,4,CHENNAI,VISAKHAPATNAM,10538,11046,CHENNAI-VISAKHAPATNAM,21584,All
2022,5,CHENNAI,VISAKHAPATNAM,9358,11323,CHENNAI-VISAKHAPATNAM,20681,All
2022,6,CHENNAI,VISAKHAPATNAM,11138,11810,CHENNAI-VISAKHAPATNAM,22948,All
2022,7,CHENNAI,VISAKHAPATNAM,9236,9836,CHENNAI-VISAKHAPATNAM,19072,All
2022,8,CHENNAI,VISAKHAPATNAM,9746,12097,CHENNAI-VISAKHAPATNAM,21843,All
2022,9,CHENNAI,VISAKHAPATNAM,10485,11373,CHENNAI-VISAKHAPATNAM,21858,All
2022,10,CHENNAI,VISAKHAPATNAM,9439,10172,CHENNAI-VISAKHAPATNAM,19611,All
2022,11,CHENNAI,VISAKHAPATNAM,11573,12467,CHENNAI-VISAKHAPATNAM,24040,All
2022,12,CHENNAI,VISAKHAPATNAM,11454,11567,CHENNAI-VISAKHAPATNAM,23021,All
2023,1,CHENNAI,VISAKHAPATNAM,11230,12688,CHENNAI-VISAKHAPATNAM,23918,All
2023,2,CHENNAI,VISAKHAPATNAM,11433,11340,CHENNAI-VISAKHAPATNAM,22773,All
2023,3,CHENNAI,VISAKHAPATNAM,11120,10183,CHENNAI-VISAKHAPATNAM,21303,All
2023,4,CHENNAI,VISAKHAPATNAM,11507,12273,CHENNAI-VISAKHAPATNAM,23780,All
2023,5,CHENNAI,VISAKHAPATNAM,9246,9588,CHENNAI-VISAKHAPATNAM,18834,All
2023,6,CHENNAI,VISAKHAPATNAM,8977,8073,CHENNAI-VISAKHAPATNAM,17050,All
2023,7,CHENNAI,VISAKHAPATNAM,10424,12501,CHENNAI-VISAKHAPATNAM,22925,All
2023,8,CHENNAI,VISAKHAPATNAM,10968,11415,CHENNAI-VISAKHAPATNAM,22383,All
2023,9,CHENNAI,VISAKHAPATNAM,11707,11930,CHENNAI-VISAKHAPATNAM,23637,All
2023,10,CHENNAI,VISAKHAPATNAM,13072,12230,CHENNAI-VISAKHAPATNAM,25302,All
2023,11,CHENNAI,VISAKHAPATNAM,12764,12312,CHENNAI-VISAKHAPATNAM,25076,All
2023,12,CHENNAI,VISAKHAPATNAM,13705,12935,CHENNAI-VISAKHAPATNAM,26640,All
2024,1,CHENNAI,VISAKHAPATNAM,9018,9779,CHENNAI-VISAKHAPATNAM,18797,All
2024,2,CHENNAI,VISAKHAPATNAM,8686,8232,CHENNAI-VISAKHAPATNAM,16918,All
2024,3,CHENNAI,VISAKHAPATNAM,9298,7998,CHENNAI-VISAKHAPATNAM,17296,All
2024,4,CHENNAI,VISAKHAPATNAM,9421,10298,CHENNAI-VISAKHAPATNAM,19719,All
2024,6,CHENNAI,VISAKHAPATNAM,11028,10300,CHENNAI-VISAKHAPATNAM,21328,All
2024,7,CHENNAI,VISAKHAPATNAM,9143,11819,CHENNAI-VISAKHAPATNAM,20962,All
2024,8,CHENNAI,VISAKHAPATNAM,11300,12858,CHENNAI-VISAKHAPATNAM,24158,All
2024,9,CHENNAI,VISAKHAPATNAM,10783,10660,CHENNAI-VISAKHAPATNAM,21443,All
2024,10,CHENNAI,VISAKHAPATNAM,13258,10849,CHENNAI-VISAKHAPATNAM,24107,All
2024,11,CHENNAI,VISAKHAPATNAM,11224,12442,CHENNAI-VISAKHAPATNAM,23666,All
2024,12,CHENNAI,VISAKHAPATNAM,14579,13791,CHENNAI-VISAKHAPATNAM,28370,All
2025,1,CHENNAI,VISAKHAPATNAM,12216,13754,CHENNAI-VISAKHAPATNAM,25970,All
2025,2,CHENNAI,VISAKHAPATNAM,12761,12233,CHENNAI-VISAKHAPATNAM,24994,All
2025,3,CHENNAI,VISAKHAPATNAM,13222,12130,CHENNAI-VISAKHAPATNAM,25352,All
2015,9,COCHIN,HYDERABAD,0,286,COCHIN-HYDERABAD,286,All
2015,10,COCHIN,HYDERABAD,0,352,COCHIN-HYDERABAD,352,All
2015,11,COCHIN,HYDERABAD,0,66,COCHIN-HYDERABAD,66,All
2015,11,COCHIN,TRIVANDRUM,45,0,COCHIN-TRIVANDRUM,45,All
2016,3,COIMBATORE,AGARTALA,6,1,AGARTALA-COIMBATORE,7,All
2016,4,COIMBATORE,AGARTALA,47,27,AGARTALA-COIMBATORE,74,All
2016,5,COIMBATORE,AGARTALA,46,58,AGARTALA-COIMBATORE,104,All
2016,6,COIMBATORE,AGARTALA,88,55,AGARTALA-COIMBATORE,143,All
2016,7,COIMBATORE,AGARTALA,49,62,AGARTALA-COIMBATORE,111,All
2016,8,COIMBATORE,AGARTALA,65,71,AGARTALA-COIMBATORE,136,All
2016,9,COIMBATORE,AGARTALA,55,115,AGARTALA-COIMBATORE,170,All
2016,10,COIMBATORE,AGARTALA,41,37,AGARTALA-COIMBATORE,78,All
2016,11,COIMBATORE,AGARTALA,85,82,AGARTALA-COIMBATORE,167,All
2016,12,COIMBATORE,AGARTALA,77,76,AGARTALA-COIMBATORE,153,All
2017,1,COIMBATORE,AGARTALA,77,13,AGARTALA-COIMBATORE,90,All
2017,2,COIMBATORE,AGARTALA,71,46,AGARTALA-COIMBATORE,117,All
2017,3,COIMBATORE,AGARTALA,66,63,AGARTALA-COIMBATORE,129,All
2017,4,COIMBATORE,AGARTALA,57,66,AGARTALA-COIMBATORE,123,All
2017,5,COIMBATORE,AGARTALA,53,53,AGARTALA-COIMBATORE,106,All
2017,6,COIMBATORE,AGARTALA,79,85,AGARTALA-COIMBATORE,164,All
2017,7,COIMBATORE,AGARTALA,84,81,AGARTALA-COIMBATORE,165,All
2017,8,COIMBATORE,AGARTALA,45,79,AGARTALA-COIMBATORE,124,All
2017,9,COIMBATORE,AGARTALA,123,66,AGARTALA-COIMBATORE,189,All
2017,10,COIMBATORE,AGARTALA,63,151,AGARTALA-COIMBATORE,214,All
2017,11,COIMBATORE,AGARTALA,145,59,AGARTALA-COIMBATORE,204,All
2017,12,COIMBATORE,AGARTALA,67,96,AGARTALA-COIMBATORE,163,All
2018,1,COIMBATORE,AGARTALA,59,59,AGARTALA-COIMBATORE,118,All
2018,2,COIMBATORE,AGARTALA,57,46,AGARTALA-COIMBATORE,103,All
2018,3,COIMBATORE,AGARTALA,54,28,AGARTALA-COIMBATORE,82,All
2018,4,COIMBATORE,AGARTALA,64,21,AGARTALA-COIMBATORE,85,All
2018,5,COIMBATORE,AGARTALA,27,15,AGARTALA-COIMBATORE,42,All
2018,6,COIMBATORE,AGARTALA,30,6,AGARTALA-COIMBATORE,36,All
2018,7,COIMBATORE,AGARTALA,22,18,AGARTALA-COIMBATORE,40,All
2018,8,COIMBATORE,AGARTALA,31,20,AGARTALA-COIMBATORE,51,All
2018,9,COIMBATORE,AGARTALA,28,9,AGARTALA-COIMBATORE,37,All
2018,10,COIMBATORE,AGARTALA,23,8,AGARTALA-COIMBATORE,31,All
2018,11,COIMBATORE,AGARTALA,35,7,AGARTALA-COIMBATORE,42,All
2018,12,COIMBATORE,AGARTALA,13,9,AGARTALA-COIMBATORE,22,All
2019,1,COIMBATORE,AGARTALA,32,13,AGARTALA-COIMBATORE,45,All
2019,2,COIMBATORE,AGARTALA,12,15,AGARTALA-COIMBATORE,27,All
2019,3,COIMBATORE,AGARTALA,6,3,AGARTALA-COIMBATORE,9,All
2019,4,COIMBATORE,AGARTALA,12,0,AGARTALA-COIMBATORE,12,All
2017,10,COIMBATORE,BELGAUM,27,0,BELGAUM-COIMBATORE,27,All
2015,4,COIMBATORE,CHENNAI,27681,27606,CHENNAI-COIMBATORE,55287,All
2015,5,COIMBATORE,CHENNAI,28165,29375,CHENNAI-COIMBATORE,57540,All
2015,6,COIMBATORE,CHENNAI,25957,25716,CHENNAI-COIMBATORE,51673,All
2015,7,COIMBATORE,CHENNAI,25213,26055,CHENNAI-COIMBATORE,51268,All
2015,8,COIMBATORE,CHENNAI,25867,25973,CHENNAI-COIMBATORE,51840,All
2015,9,COIMBATORE,CHENNAI,25069,24800,CHENNAI-COIMBATORE,49869,All
2015,10,COIMBATORE,CHENNAI,24262,24682,CHENNAI-COIMBATORE,48944,All
2015,11,COIMBATORE,CHENNAI,24741,24957,CHENNAI-COIMBATORE,49698,All
2015,12,COIMBATORE,CHENNAI,18991,18980,CHENNAI-COIMBATORE,37971,All
2016,1,COIMBATORE,CHENNAI,26561,25378,CHENNAI-COIMBATORE,51939,All
2016,2,COIMBATORE,CHENNAI,24520,24043,CHENNAI-COIMBATORE,48563,All
2016,3,COIMBATORE,CHENNAI,26378,26213,CHENNAI-COIMBATORE,52591,All
2016,4,COIMBATORE,CHENNAI,24835,23706,CHENNAI-COIMBATORE,48541,All
2016,5,COIMBATORE,CHENNAI,26108,25601,CHENNAI-COIMBATORE,51709,All
2016,6,COIMBATORE,CHENNAI,25370,24887,CHENNAI-COIMBATORE,50257,All
2016,7,COIMBATORE,CHENNAI,28231,27701,CHENNAI-COIMBATORE,55932,All
2016,8,COIMBATORE,CHENNAI,32059,30754,CHENNAI-COIMBATORE,62813,All
2016,9,COIMBATORE,CHENNAI,32066,31629,CHENNAI-COIMBATORE,63695,All
2016,10,COIMBATORE,CHENNAI,31687,31561,CHENNAI-COIMBATORE,63248,All
2016,11,COIMBATORE,CHENNAI,33781,32062,CHENNAI-COIMBATORE,65843,All
2016,12,COIMBATORE,CHENNAI,34205,33848,CHENNAI-COIMBATORE,68053,All
2017,1,COIMBATORE,CHENNAI,36729,33912,CHENNAI-COIMBATORE,70641,All
2017,2,COIMBATORE,CHENNAI,33829,32556,CHENNAI-COIMBATORE,66385,All
2017,3,COIMBATORE,CHENNAI,34079,33135,CHENNAI-COIMBATORE,67214,All
2017,4,COIMBATORE,CHENNAI,33240,32581,CHENNAI-COIMBATORE,65821,All
2017,5,COIMBATORE,CHENNAI,35465,35824,CHENNAI-COIMBATORE,71289,All
2017,6,COIMBATORE,CHENNAI,32896,32599,CHENNAI-COIMBATORE,65495,All
2017,7,COIMBATORE,CHENNAI,34084,34152,CHENNAI-COIMBATORE,68236,All
2017,8,COIMBATORE,CHENNAI,34882,34921,CHENNAI-COIMBATORE,69803,All
2017,9,COIMBATORE,CHENNAI,35291,35299,CHENNAI-COIMBATORE,70590,All
2017,10,COIMBATORE,CHENNAI,35261,34530,CHENNAI-COIMBATORE,69791,All
2017,11,COIMBATORE,CHENNAI,35775,36612,CHENNAI-COIMBATORE,72387,All
2017,12,COIMBATORE,CHENNAI,39911,40135,CHENNAI-COIMBATORE,80046,All
2018,1,COIMBATORE,CHENNAI,41004,39768,CHENNAI-COIMBATORE,80772,All
2018,2,COIMBATORE,CHENNAI,37078,36213,CHENNAI-COIMBATORE,73291,All
2018,3,COIMBATORE,CHENNAI,39932,38944,CHENNAI-COIMBATORE,78876,All
2018,4,COIMBATORE,CHENNAI,42571,42625,CHENNAI-COIMBATORE,85196,All
2018,5,COIMBATORE,CHENNAI,42275,42270,CHENNAI-COIMBATORE,84545,All
2018,6,COIMBATORE,CHENNAI,42082,42325,CHENNAI-COIMBATORE,84407,All
2018,7,COIMBATORE,CHENNAI,40569,41498,CHENNAI-COIMBATORE,82067,All
2018,8,COIMBATORE,CHENNAI,39952,40433,CHENNAI-COIMBATORE,80385,All
2018,9,COIMBATORE,CHENNAI,40519,40557,CHENNAI-COIMBATORE,81076,All
2018,10,COIMBATORE,CHENNAI,39198,39951,CHENNAI-COIMBATORE,79149,All
2018,11,COIMBATORE,CHENNAI,40351,44634,CHENNAI-COIMBATORE,84985,All
2018,12,COIMBATORE,CHENNAI,40202,44839,CHENNAI-COIMBATORE,85041,All
2019,1,COIMBATORE,CHENNAI,39664,38462,CHENNAI-COIMBATORE,78126,All
2019,2,COIMBATORE,CHENNAI,38990,41654,CHENNAI-COIMBATORE,80644,All
2019,3,COIMBATORE,CHENNAI,36483,36939,CHENNAI-COIMBATORE,73422,All
2019,4,COIMBATORE,CHENNAI,33270,35084,CHENNAI-COIMBATORE,68354,All
2019,1,COIMBATORE,DABOLIM,0,459,COIMBATORE-DABOLIM,459,All
2019,2,COIMBATORE,DABOLIM,0,279,COIMBATORE-DABOLIM,279,All
2019,3,COIMBATORE,DABOLIM,0,232,COIMBATORE-DABOLIM,232,All
2019,4,COIMBATORE,DABOLIM,0,224,COIMBATORE-DABOLIM,224,All
2019,5,COIMBATORE,DABOLIM,0,123,COIMBATORE-DABOLIM,123,All
2019,6,COIMBATORE,DABOLIM,0,119,COIMBATORE-DABOLIM,119,All
2019,7,COIMBATORE,DABOLIM,0,186,COIMBATORE-DABOLIM,186,All
2019,8,COIMBATORE,DABOLIM,0,218,COIMBATORE-DABOLIM,218,All
2019,9,COIMBATORE,DABOLIM,0,266,COIMBATORE-DABOLIM,266,All
2019,10,COIMBATORE,DABOLIM,0,131,COIMBATORE-DABOLIM,131,All
2021,3,COIMBATORE,DABOLIM,15,0,COIMBATORE-DABOLIM,15,All
2021,4,COIMBATORE,DABOLIM,100,0,COIMBATORE-DABOLIM,100,All
2021,8,COIMBATORE,DABOLIM,54,0,COIMBATORE-DABOLIM,54,All
2021,12,COIMBATORE,DABOLIM,3269,3462,COIMBATORE-DABOLIM,6731,All
2022,1,COIMBATORE,DABOLIM,1355,2106,COIMBATORE-DABOLIM,3461,All
2022,3,COIMBATORE,DABOLIM,66,0,COIMBATORE-DABOLIM,66,All
2022,4,COIMBATORE,DABOLIM,586,0,COIMBATORE-DABOLIM,586,All
2022,5,COIMBATORE,DABOLIM,519,0,COIMBATORE-DABOLIM,519,All
2024,10,COIMBATORE,DABOLIM,377,359,COIMBATORE-DABOLIM,736,All
2024,11,COIMBATORE,DABOLIM,2115,2102,COIMBATORE-DABOLIM,4217,All
2024,12,COIMBATORE,DABOLIM,2175,2226,COIMBATORE-DABOLIM,4401,All
2025,1,COIMBATORE,DABOLIM,2174,2224,COIMBATORE-DABOLIM,4398,All
2025,2,COIMBATORE,DABOLIM,1970,1938,COIMBATORE-DABOLIM,3908,All
2025,3,COIMBATORE,DABOLIM,2117,2215,COIMBATORE-DABOLIM,4332,All
2021,11,COIMBATORE,DARBHANGA,16,0,COIMBATORE-DARBHANGA,16,All
2015,4,COIMBATORE,DELHI,10302,8917,COIMBATORE-DELHI,19219,All
2015,5,COIMBATORE,DELHI,10290,12576,COIMBATORE-DELHI,22866,All
2015,6,COIMBATORE,DELHI,11909,12074,COIMBATORE-DELHI,23983,All
2015,7,COIMBATORE,DELHI,10946,10249,COIMBATORE-DELHI,21195,All
2015,8,COIMBATORE,DELHI,10176,9629,COIMBATORE-DELHI,19805,All
2015,9,COIMBATORE,DELHI,10544,9466,COIMBATORE-DELHI,20010,All
2015,10,COIMBATORE,DELHI,12749,15430,COIMBATORE-DELHI,28179,All
2015,11,COIMBATORE,DELHI,9521,9788,COIMBATORE-DELHI,19309,All
2015,12,COIMBATORE,DELHI,10521,11897,COIMBATORE-DELHI,22418,All
2016,1,COIMBATORE,DELHI,9312,8569,COIMBATORE-DELHI,17881,All
2016,2,COIMBATORE,DELHI,8560,7866,COIMBATORE-DELHI,16426,All
2016,3,COIMBATORE,DELHI,9038,8319,COIMBATORE-DELHI,17357,All
2016,4,COIMBATORE,DELHI,8970,8169,COIMBATORE-DELHI,17139,All
2016,5,COIMBATORE,DELHI,8590,10597,COIMBATORE-DELHI,19187,All
2016,6,COIMBATORE,DELHI,9757,9354,COIMBATORE-DELHI,19111,All
2016,7,COIMBATORE,DELHI,8757,8512,COIMBATORE-DELHI,17269,All
2016,8,COIMBATORE,DELHI,8494,7477,COIMBATORE-DELHI,15971,All
2016,9,COIMBATORE,DELHI,9098,8441,COIMBATORE-DELHI,17539,All
2016,10,COIMBATORE,DELHI,9863,9414,COIMBATORE-DELHI,19277,All
2016,11,COIMBATORE,DELHI,10187,10251,COIMBATORE-DELHI,20438,All
2016,12,COIMBATORE,DELHI,10557,12599,COIMBATORE-DELHI,23156,All
2017,1,COIMBATORE,DELHI,11406,11172,COIMBATORE-DELHI,22578,All
2017,2,COIMBATORE,DELHI,10211,9860,COIMBATORE-DELHI,20071,All
2017,3,COIMBATORE,DELHI,9854,9549,COIMBATORE-DELHI,19403,All
2017,4,COIMBATORE,DELHI,11553,10151,COIMBATORE-DELHI,21704,All
2017,5,COIMBATORE,DELHI,11496,13272,COIMBATORE-DELHI,24768,All
2017,6,COIMBATORE,DELHI,11700,12305,COIMBATORE-DELHI,24005,All
2017,7,COIMBATORE,DELHI,11273,10539,COIMBATORE-DELHI,21812,All
2017,8,COIMBATORE,DELHI,11003,10238,COIMBATORE-DELHI,21241,All
2017,9,COIMBATORE,DELHI,12826,10629,COIMBATORE-DELHI,23455,All
2017,10,COIMBATORE,DELHI,10820,10940,COIMBATORE-DELHI,21760,All
2017,11,COIMBATORE,DELHI,11487,11887,COIMBATORE-DELHI,23374,All
2017,12,COIMBATORE,DELHI,13468,15608,COIMBATORE-DELHI,29076,All
2018,1,COIMBATORE,DELHI,14257,13609,COIMBATORE-DELHI,27866,All
2018,2,COIMBATORE,DELHI,14482,13948,COIMBATORE-DELHI,28430,All
2018,3,COIMBATORE,DELHI,14448,14798,COIMBATORE-DELHI,29246,All
2018,4,COIMBATORE,DELHI,15912,14479,COIMBATORE-DELHI,30391,All
2018,5,COIMBATORE,DELHI,14378,16642,COIMBATORE-DELHI,31020,All
2018,6,COIMBATORE,DELHI,15724,15650,COIMBATORE-DELHI,31374,All
2018,7,COIMBATORE,DELHI,14635,14134,COIMBATORE-DELHI,28769,All
2018,8,COIMBATORE,DELHI,16193,14958,COIMBATORE-DELHI,31151,All
2018,9,COIMBATORE,DELHI,14544,12580,COIMBATORE-DELHI,27124,All
2018,10,COIMBATORE,DELHI,15724,14863,COIMBATORE-DELHI,30587,All
2018,11,COIMBATORE,DELHI,20166,21143,COIMBATORE-DELHI,41309,All
2018,12,COIMBATORE,DELHI,25926,26642,COIMBATORE-DELHI,52568,All
2019,1,COIMBATORE,DELHI,25937,23717,COIMBATORE-DELHI,49654,All
2019,2,COIMBATORE,DELHI,22288,21076,COIMBATORE-DELHI,43364,All
2019,3,COIMBATORE,DELHI,22770,21752,COIMBATORE-DELHI,44522,All
2019,4,COIMBATORE,DELHI,20179,18554,COIMBATORE-DELHI,38733,All
2019,5,COIMBATORE,DELHI,19625,21737,COIMBATORE-DELHI,41362,All
2019,6,COIMBATORE,DELHI,21871,22337,COIMBATORE-DELHI,44208,All
2019,7,COIMBATORE,DELHI,19956,19923,COIMBATORE-DELHI,39879,All
2019,8,COIMBATORE,DELHI,20453,20093,COIMBATORE-DELHI,40546,All
2019,9,COIMBATORE,DELHI,21661,19007,COIMBATORE-DELHI,40668,All
2019,10,COIMBATORE,DELHI,19686,18154,COIMBATORE-DELHI,37840,All
2019,11,COIMBATORE,DELHI,19345,18966,COIMBATORE-DELHI,38311,All
2019,12,COIMBATORE,DELHI,18843,20974,COIMBATORE-DELHI,39817,All
2020,1,COIMBATORE,DELHI,19656,18569,COIMBATORE-DELHI,38225,All
2020,2,COIMBATORE,DELHI,18892,18212,COIMBATORE-DELHI,37104,All
2020,3,COIMBATORE,DELHI,10887,10816,COIMBATORE-DELHI,21703,All
2020,5,COIMBATORE,DELHI,716,459,COIMBATORE-DELHI,1175,All
2020,6,COIMBATORE,DELHI,4424,3760,COIMBATORE-DELHI,8184,All
2020,7,COIMBATORE,DELHI,5160,5135,COIMBATORE-DELHI,10295,All
2020,8,COIMBATORE,DELHI,5268,8570,COIMBATORE-DELHI,13838,All
2020,9,COIMBATORE,DELHI,5071,10060,COIMBATORE-DELHI,15131,All
2020,10,COIMBATORE,DELHI,4925,8170,COIMBATORE-DELHI,13095,All
2020,11,COIMBATORE,DELHI,7700,7421,COIMBATORE-DELHI,15121,All
2020,12,COIMBATORE,DELHI,6492,9454,COIMBATORE-DELHI,15946,All
2021,1,COIMBATORE,DELHI,7912,9138,COIMBATORE-DELHI,17050,All
2021,2,COIMBATORE,DELHI,8949,8139,COIMBATORE-DELHI,17088,All
2021,3,COIMBATORE,DELHI,9446,7916,COIMBATORE-DELHI,17362,All
2021,4,COIMBATORE,DELHI,7333,5221,COIMBATORE-DELHI,12554,All
2021,6,COIMBATORE,DELHI,1989,2269,COIMBATORE-DELHI,4258,All
2021,7,COIMBATORE,DELHI,3363,3884,COIMBATORE-DELHI,7247,All
2021,8,COIMBATORE,DELHI,3591,4379,COIMBATORE-DELHI,7970,All
2021,9,COIMBATORE,DELHI,4507,5179,COIMBATORE-DELHI,9686,All
2021,10,COIMBATORE,DELHI,5459,5958,COIMBATORE-DELHI,11417,All
2021,11,COIMBATORE,DELHI,9386,8977,COIMBATORE-DELHI,18363,All
2021,12,COIMBATORE,DELHI,9929,11366,COIMBATORE-DELHI,21295,All
2022,1,COIMBATORE,DELHI,7124,6089,COIMBATORE-DELHI,13213,All
2022,2,COIMBATORE,DELHI,6170,5658,COIMBATORE-DELHI,11828,All
2022,3,COIMBATORE,DELHI,11366,11099,COIMBATORE-DELHI,22465,All
2022,4,COIMBATORE,DELHI,11109,10829,COIMBATORE-DELHI,21938,All
2022,5,COIMBATORE,DELHI,12266,14279,COIMBATORE-DELHI,26545,All
2022,6,COIMBATORE,DELHI,15611,16502,COIMBATORE-DELHI,32113,All
2022,7,COIMBATORE,DELHI,14994,13952,COIMBATORE-DELHI,28946,All
2022,8,COIMBATORE,DELHI,15258,15250,COIMBATORE-DELHI,30508,All
2022,9,COIMBATORE,DELHI,17453,15078,COIMBATORE-DELHI,32531,All
2022,10,COIMBATORE,DELHI,13719,12701,COIMBATORE-DELHI,26420,All
2022,11,COIMBATORE,DELHI,12843,12520,COIMBATORE-DELHI,25363,All
2022,12,COIMBATORE,DELHI,14470,16189,COIMBATORE-DELHI,30659,All
2023,1,COIMBATORE,DELHI,14128,12513,COIMBATORE-DELHI,26641,All
2023,2,COIMBATORE,DELHI,15763,14309,COIMBATORE-DELHI,30072,All
2023,3,COIMBATORE,DELHI,16698,16441,COIMBATORE-DELHI,33139,All
2023,4,COIMBATORE,DELHI,18435,16291,COIMBATORE-DELHI,34726,All
2023,5,COIMBATORE,DELHI,17588,20243,COIMBATORE-DELHI,37831,All
2023,6,COIMBATORE,DELHI,17534,19214,COIMBATORE-DELHI,36748,All
2023,7,COIMBATORE,DELHI,17225,17824,COIMBATORE-DELHI,35049,All
2023,8,COIMBATORE,DELHI,18438,17466,COIMBATORE-DELHI,35904,All
2023,9,COIMBATORE,DELHI,17288,16328,COIMBATORE-DELHI,33616,All
2023,10,COIMBATORE,DELHI,16855,15187,COIMBATORE-DELHI,32042,All
2023,11,COIMBATORE,DELHI,15483,15322,COIMBATORE-DELHI,30805,All
2023,12,COIMBATORE,DELHI,16483,19704,COIMBATORE-DELHI,36187,All
2024,1,COIMBATORE,DELHI,14721,14527,COIMBATORE-DELHI,29248,All
2024,2,COIMBATORE,DELHI,16560,15402,COIMBATORE-DELHI,31962,All
2024,3,COIMBATORE,DELHI,16656,16738,COIMBATORE-DELHI,33394,All
2024,4,COIMBATORE,DELHI,14326,13093,COIMBATORE-DELHI,27419,All
2024,6,COIMBATORE,DELHI,16919,17916,COIMBATORE-DELHI,34835,All
2024,7,COIMBATORE,DELHI,17424,18634,COIMBATORE-DELHI,36058,All
2024,8,COIMBATORE,DELHI,17816,17614,COIMBATORE-DELHI,35430,All
2024,9,COIMBATORE,DELHI,18892,17371,COIMBATORE-DELHI,36263,All
2024,10,COIMBATORE,DELHI,18381,16476,COIMBATORE-DELHI,34857,All
2024,11,COIMBATORE,DELHI,18573,20308,COIMBATORE-DELHI,38881,All
2024,12,COIMBATORE,DELHI,19495,21042,COIMBATORE-DELHI,40537,All
2025,1,COIMBATORE,DELHI,18440,17668,COIMBATORE-DELHI,36108,All
2025,2,COIMBATORE,DELHI,19346,18706,COIMBATORE-DELHI,38052,All
2025,3,COIMBATORE,DELHI,17333,17070,COIMBATORE-DELHI,34403,All
2021,9,COIMBATORE,DIBRUGARH,0,7,COIMBATORE-DIBRUGARH,7,All
2021,10,COIMBATORE,DIBRUGARH,0,4,COIMBATORE-DIBRUGARH,4,All
2021,3,COIMBATORE,DIMAPUR,4,2,COIMBATORE-DIMAPUR,6,All
2021,4,COIMBATORE,DIMAPUR,6,10,COIMBATORE-DIMAPUR,16,All
2022,11,COIMBATORE,DURGAPUR,69,40,COIMBATORE-DURGAPUR,109,All
2022,12,COIMBATORE,DURGAPUR,104,71,COIMBATORE-DURGAPUR,175,All
2023,1,COIMBATORE,DURGAPUR,29,35,COIMBATORE-DURGAPUR,64,All
2023,3,COIMBATORE,DURGAPUR,2,0,COIMBATORE-DURGAPUR,2,All
2023,4,COIMBATORE,DURGAPUR,65,0,COIMBATORE-DURGAPUR,65,All
2023,5,COIMBATORE,DURGAPUR,77,0,COIMBATORE-DURGAPUR,77,All
2023,6,COIMBATORE,DURGAPUR,66,0,COIMBATORE-DURGAPUR,66,All
2023,7,COIMBATORE,DURGAPUR,23,3,COIMBATORE-DURGAPUR,26,All
2023,8,COIMBATORE,DURGAPUR,23,21,COIMBATORE-DURGAPUR,44,All
2023,9,COIMBATORE,DURGAPUR,42,41,COIMBATORE-DURGAPUR,83,All
2023,10,COIMBATORE,DURGAPUR,127,114,COIMBATORE-DURGAPUR,241,All
2023,11,COIMBATORE,DURGAPUR,98,55,COIMBATORE-DURGAPUR,153,All
2023,12,COIMBATORE,DURGAPUR,178,61,COIMBATORE-DURGAPUR,239,All
2024,1,COIMBATORE,DURGAPUR,73,64,COIMBATORE-DURGAPUR,137,All
2024,10,COIMBATORE,DURGAPUR,26,3,COIMBATORE-DURGAPUR,29,All
2024,11,COIMBATORE,DURGAPUR,134,108,COIMBATORE-DURGAPUR,242,All
2024,12,COIMBATORE,DURGAPUR,163,0,COIMBATORE-DURGAPUR,163,All
2025,3,COIMBATORE,DURGAPUR,0,59,COIMBATORE-DURGAPUR,59,All
2017,10,COIMBATORE,GOA,0,2,COIMBATORE-GOA,2,All
2017,11,COIMBATORE,GOA,0,44,COIMBATORE-GOA,44,All
2017,12,COIMBATORE,GOA,0,59,COIMBATORE-GOA,59,All
2018,1,COIMBATORE,GOA,0,133,COIMBATORE-GOA,133,All
2018,2,COIMBATORE,GOA,0,105,COIMBATORE-GOA,105,All
2018,3,COIMBATORE,GOA,0,58,COIMBATORE-GOA,58,All
2018,4,COIMBATORE,GOA,0,47,COIMBATORE-GOA,47,All
2018,5,COIMBATORE,GOA,125,188,COIMBATORE-GOA,313,All
2018,6,COIMBATORE,GOA,23,131,COIMBATORE-GOA,154,All
2018,7,COIMBATORE,GOA,11,147,COIMBATORE-GOA,158,All
2018,8,COIMBATORE,GOA,14,205,COIMBATORE-GOA,219,All
2018,9,COIMBATORE,GOA,28,203,COIMBATORE-GOA,231,All
2018,10,COIMBATORE,GOA,0,215,COIMBATORE-GOA,215,All
2018,11,COIMBATORE,GOA,0,444,COIMBATORE-GOA,444,All
2018,12,COIMBATORE,GOA,0,334,COIMBATORE-GOA,334,All
2021,3,COIMBATORE,GUWAHATI,29,13,COIMBATORE-GUWAHATI,42,All
2021,4,COIMBATORE,GUWAHATI,144,90,COIMBATORE-GUWAHATI,234,All
2021,7,COIMBATORE,GUWAHATI,29,58,COIMBATORE-GUWAHATI,87,All
2021,8,COIMBATORE,GUWAHATI,164,152,COIMBATORE-GUWAHATI,316,All
2021,9,COIMBATORE,GUWAHATI,110,84,COIMBATORE-GUWAHATI,194,All
2021,10,COIMBATORE,GUWAHATI,144,96,COIMBATORE-GUWAHATI,240,All
2021,11,COIMBATORE,GUWAHATI,155,163,COIMBATORE-GUWAHATI,318,All
2021,12,COIMBATORE,GUWAHATI,319,145,COIMBATORE-GUWAHATI,464,All
2022,1,COIMBATORE,GUWAHATI,134,55,COIMBATORE-GUWAHATI,189,All
2022,2,COIMBATORE,GUWAHATI,113,0,COIMBATORE-GUWAHATI,113,All
2022,3,COIMBATORE,GUWAHATI,243,189,COIMBATORE-GUWAHATI,432,All
2022,4,COIMBATORE,GUWAHATI,341,188,COIMBATORE-GUWAHATI,529,All
2022,5,COIMBATORE,GUWAHATI,499,245,COIMBATORE-GUWAHATI,744,All
2022,6,COIMBATORE,GUWAHATI,522,265,COIMBATORE-GUWAHATI,787,All
2022,7,COIMBATORE,GUWAHATI,520,222,COIMBATORE-GUWAHATI,742,All
2022,8,COIMBATORE,GUWAHATI,436,202,COIMBATORE-GUWAHATI,638,All
2022,9,COIMBATORE,GUWAHATI,556,165,COIMBATORE-GUWAHATI,721,All
2022,10,COIMBATORE,GUWAHATI,500,243,COIMBATORE-GUWAHATI,743,All
2022,11,COIMBATORE,GUWAHATI,540,363,COIMBATORE-GUWAHATI,903,All
2022,12,COIMBATORE,GUWAHATI,536,412,COIMBATORE-GUWAHATI,948,All
2023,1,COIMBATORE,GUWAHATI,515,502,COIMBATORE-GUWAHATI,1017,All
2023,2,COIMBATORE,GUWAHATI,390,221,COIMBATORE-GUWAHATI,611,All
2023,3,COIMBATORE,GUWAHATI,532,319,COIMBATORE-GUWAHATI,851,All
2023,4,COIMBATORE,GUWAHATI,599,407,COIMBATORE-GUWAHATI,1006,All
2023,5,COIMBATORE,GUWAHATI,472,511,COIMBATORE-GUWAHATI,983,All
2023,6,COIMBATORE,GUWAHATI,498,398,COIMBATORE-GUWAHATI,896,All
2023,7,COIMBATORE,GUWAHATI,403,459,COIMBATORE-GUWAHATI,862,All
2023,8,COIMBATORE,GUWAHATI,132,198,COIMBATORE-GUWAHATI,330,All
2023,9,COIMBATORE,GUWAHATI,180,136,COIMBATORE-GUWAHATI,316,All
2023,10,COIMBATORE,GUWAHATI,196,204,COIMBATORE-GUWAHATI,400,All
2023,11,COIMBATORE,GUWAHATI,201,362,COIMBATORE-GUWAHATI,563,All
2023,12,COIMBATORE,GUWAHATI,171,463,COIMBATORE-GUWAHATI,634,All
2024,3,COIMBATORE,GUWAHATI,8,12,COIMBATORE-GUWAHATI,20,All
2024,4,COIMBATORE,GUWAHATI,265,224,COIMBATORE-GUWAHATI,489,All
2024,6,COIMBATORE,GUWAHATI,350,325,COIMBATORE-GUWAHATI,675,All
2024,7,COIMBATORE,GUWAHATI,175,210,COIMBATORE-GUWAHATI,385,All
2024,8,COIMBATORE,GUWAHATI,315,220,COIMBATORE-GUWAHATI,535,All
2024,9,COIMBATORE,GUWAHATI,203,121,COIMBATORE-GUWAHATI,324,All
2024,10,COIMBATORE,GUWAHATI,377,248,COIMBATORE-GUWAHATI,625,All
2024,11,COIMBATORE,GUWAHATI,311,290,COIMBATORE-GUWAHATI,601,All
2024,12,COIMBATORE,GUWAHATI,282,337,COIMBATORE-GUWAHATI,619,All
2025,3,COIMBATORE,GUWAHATI,212,108,COIMBATORE-GUWAHATI,320,All
2023,11,COIMBATORE,Goa,2407,2576,COIMBATORE-Goa,4983,All
2023,12,COIMBATORE,Goa,2301,2781,COIMBATORE-Goa,5082,All
2024,1,COIMBATORE,Goa,1397,1686,COIMBATORE-Goa,3083,All
2024,2,COIMBATORE,Goa,1814,1961,COIMBATORE-Goa,3775,All
2024,3,COIMBATORE,Goa,1725,1800,COIMBATORE-Goa,3525,All
2024,4,COIMBATORE,Goa,1512,1159,COIMBATORE-Goa,2671,All
2024,6,COIMBATORE,Goa,1429,1108,COIMBATORE-Goa,2537,All
2024,7,COIMBATORE,Goa,1814,1533,COIMBATORE-Goa,3347,All
2024,8,COIMBATORE,Goa,1912,1300,COIMBATORE-Goa,3212,All
2024,9,COIMBATORE,Goa,2064,1560,COIMBATORE-Goa,3624,All
2024,10,COIMBATORE,Goa,1706,1355,COIMBATORE-Goa,3061,All
2015,4,COIMBATORE,HYDERABAD,5522,5798,COIMBATORE-HYDERABAD,11320,All
2015,5,COIMBATORE,HYDERABAD,6179,5730,COIMBATORE-HYDERABAD,11909,All
2015,6,COIMBATORE,HYDERABAD,5613,5167,COIMBATORE-HYDERABAD,10780,All
2015,7,COIMBATORE,HYDERABAD,5953,5966,COIMBATORE-HYDERABAD,11919,All
2015,8,COIMBATORE,HYDERABAD,6174,6016,COIMBATORE-HYDERABAD,12190,All
2015,9,COIMBATORE,HYDERABAD,5874,5724,COIMBATORE-HYDERABAD,11598,All
2015,10,COIMBATORE,HYDERABAD,5326,5632,COIMBATORE-HYDERABAD,10958,All
2015,11,COIMBATORE,HYDERABAD,5250,5236,COIMBATORE-HYDERABAD,10486,All
2015,12,COIMBATORE,HYDERABAD,6038,6042,COIMBATORE-HYDERABAD,12080,All
2016,1,COIMBATORE,HYDERABAD,6103,6103,COIMBATORE-HYDERABAD,12206,All
2016,2,COIMBATORE,HYDERABAD,6830,6798,COIMBATORE-HYDERABAD,13628,All
2016,3,COIMBATORE,HYDERABAD,7086,7131,COIMBATORE-HYDERABAD,14217,All
2016,4,COIMBATORE,HYDERABAD,8645,8536,COIMBATORE-HYDERABAD,17181,All
2016,5,COIMBATORE,HYDERABAD,8937,9444,COIMBATORE-HYDERABAD,18381,All
2016,6,COIMBATORE,HYDERABAD,9099,8373,COIMBATORE-HYDERABAD,17472,All
2016,7,COIMBATORE,HYDERABAD,12794,12349,COIMBATORE-HYDERABAD,25143,All
2016,8,COIMBATORE,HYDERABAD,12918,12842,COIMBATORE-HYDERABAD,25760,All
2016,9,COIMBATORE,HYDERABAD,11041,10893,COIMBATORE-HYDERABAD,21934,All
2016,10,COIMBATORE,HYDERABAD,11504,11436,COIMBATORE-HYDERABAD,22940,All
2016,11,COIMBATORE,HYDERABAD,11382,10690,COIMBATORE-HYDERABAD,22072,All
2016,12,COIMBATORE,HYDERABAD,11205,11221,COIMBATORE-HYDERABAD,22426,All
2017,1,COIMBATORE,HYDERABAD,18614,18374,COIMBATORE-HYDERABAD,36988,All
2017,2,COIMBATORE,HYDERABAD,13652,13078,COIMBATORE-HYDERABAD,26730,All
2017,3,COIMBATORE,HYDERABAD,14442,13284,COIMBATORE-HYDERABAD,27726,All
2017,4,COIMBATORE,HYDERABAD,17223,16208,COIMBATORE-HYDERABAD,33431,All
2017,5,COIMBATORE,HYDERABAD,16937,16652,COIMBATORE-HYDERABAD,33589,All
2017,6,COIMBATORE,HYDERABAD,14369,12269,COIMBATORE-HYDERABAD,26638,All
2017,7,COIMBATORE,HYDERABAD,9164,9297,COIMBATORE-HYDERABAD,18461,All
2017,8,COIMBATORE,HYDERABAD,5285,5251,COIMBATORE-HYDERABAD,10536,All
2017,9,COIMBATORE,HYDERABAD,5138,5060,COIMBATORE-HYDERABAD,10198,All
2017,10,COIMBATORE,HYDERABAD,8981,8906,COIMBATORE-HYDERABAD,17887,All
2017,11,COIMBATORE,HYDERABAD,11285,11117,COIMBATORE-HYDERABAD,22402,All
2017,12,COIMBATORE,HYDERABAD,11705,11611,COIMBATORE-HYDERABAD,23316,All
2018,1,COIMBATORE,HYDERABAD,11491,11069,COIMBATORE-HYDERABAD,22560,All
2018,2,COIMBATORE,HYDERABAD,9987,9748,COIMBATORE-HYDERABAD,19735,All
2018,3,COIMBATORE,HYDERABAD,12182,11970,COIMBATORE-HYDERABAD,24152,All
2018,4,COIMBATORE,HYDERABAD,8315,8013,COIMBATORE-HYDERABAD,16328,All
2018,5,COIMBATORE,HYDERABAD,11751,11860,COIMBATORE-HYDERABAD,23611,All
2018,6,COIMBATORE,HYDERABAD,10386,9427,COIMBATORE-HYDERABAD,19813,All
2018,7,COIMBATORE,HYDERABAD,10774,10656,COIMBATORE-HYDERABAD,21430,All
2018,8,COIMBATORE,HYDERABAD,10609,10981,COIMBATORE-HYDERABAD,21590,All
2018,9,COIMBATORE,HYDERABAD,13483,13142,COIMBATORE-HYDERABAD,26625,All
2018,10,COIMBATORE,HYDERABAD,15328,15203,COIMBATORE-HYDERABAD,30531,All
2018,11,COIMBATORE,HYDERABAD,13934,16227,COIMBATORE-HYDERABAD,30161,All
2018,12,COIMBATORE,HYDERABAD,16363,18542,COIMBATORE-HYDERABAD,34905,All
2019,1,COIMBATORE,HYDERABAD,20710,20146,COIMBATORE-HYDERABAD,40856,All
2019,2,COIMBATORE,HYDERABAD,16340,16695,COIMBATORE-HYDERABAD,33035,All
2019,3,COIMBATORE,HYDERABAD,17260,16443,COIMBATORE-HYDERABAD,33703,All
2019,4,COIMBATORE,HYDERABAD,10803,11129,COIMBATORE-HYDERABAD,21932,All
2019,5,COIMBATORE,HYDERABAD,10282,11529,COIMBATORE-HYDERABAD,21811,All
2019,6,COIMBATORE,HYDERABAD,5230,6318,COIMBATORE-HYDERABAD,11548,All
2019,7,COIMBATORE,HYDERABAD,13214,13454,COIMBATORE-HYDERABAD,26668,All
2019,8,COIMBATORE,HYDERABAD,9459,9456,COIMBATORE-HYDERABAD,18915,All
2019,9,COIMBATORE,HYDERABAD,14888,13735,COIMBATORE-HYDERABAD,28623,All
2019,10,COIMBATORE,HYDERABAD,13892,13485,COIMBATORE-HYDERABAD,27377,All
2019,11,COIMBATORE,HYDERABAD,13919,13698,COIMBATORE-HYDERABAD,27617,All
2019,12,COIMBATORE,HYDERABAD,19368,20111,COIMBATORE-HYDERABAD,39479,All
2020,1,COIMBATORE,HYDERABAD,19589,19651,COIMBATORE-HYDERABAD,39240,All
2020,2,COIMBATORE,HYDERABAD,17315,17623,COIMBATORE-HYDERABAD,34938,All
2020,3,COIMBATORE,HYDERABAD,11359,10977,COIMBATORE-HYDERABAD,22336,All
2020,5,COIMBATORE,HYDERABAD,209,101,COIMBATORE-HYDERABAD,310,All
2020,6,COIMBATORE,HYDERABAD,4084,3908,COIMBATORE-HYDERABAD,7992,All
2020,7,COIMBATORE,HYDERABAD,3704,3198,COIMBATORE-HYDERABAD,6902,All
2020,8,COIMBATORE,HYDERABAD,4573,5439,COIMBATORE-HYDERABAD,10012,All
2020,9,COIMBATORE,HYDERABAD,3992,5469,COIMBATORE-HYDERABAD,9461,All
2020,10,COIMBATORE,HYDERABAD,3551,5906,COIMBATORE-HYDERABAD,9457,All
2020,11,COIMBATORE,HYDERABAD,6208,7491,COIMBATORE-HYDERABAD,13699,All
2020,12,COIMBATORE,HYDERABAD,6566,9004,COIMBATORE-HYDERABAD,15570,All
2021,1,COIMBATORE,HYDERABAD,6261,8239,COIMBATORE-HYDERABAD,14500,All
2021,2,COIMBATORE,HYDERABAD,6045,7473,COIMBATORE-HYDERABAD,13518,All
2021,3,COIMBATORE,HYDERABAD,6919,7739,COIMBATORE-HYDERABAD,14658,All
2021,4,COIMBATORE,HYDERABAD,6401,5034,COIMBATORE-HYDERABAD,11435,All
2021,6,COIMBATORE,HYDERABAD,1256,2001,COIMBATORE-HYDERABAD,3257,All
2021,7,COIMBATORE,HYDERABAD,2307,3297,COIMBATORE-HYDERABAD,5604,All
2021,8,COIMBATORE,HYDERABAD,5969,6350,COIMBATORE-HYDERABAD,12319,All
2021,9,COIMBATORE,HYDERABAD,7050,6463,COIMBATORE-HYDERABAD,13513,All
2021,10,COIMBATORE,HYDERABAD,7886,7960,COIMBATORE-HYDERABAD,15846,All
2021,11,COIMBATORE,HYDERABAD,10469,10106,COIMBATORE-HYDERABAD,20575,All
2021,12,COIMBATORE,HYDERABAD,11726,12663,COIMBATORE-HYDERABAD,24389,All
2022,1,COIMBATORE,HYDERABAD,7495,6887,COIMBATORE-HYDERABAD,14382,All
2022,2,COIMBATORE,HYDERABAD,7385,7859,COIMBATORE-HYDERABAD,15244,All
2022,3,COIMBATORE,HYDERABAD,13967,13328,COIMBATORE-HYDERABAD,27295,All
2022,4,COIMBATORE,HYDERABAD,17941,18339,COIMBATORE-HYDERABAD,36280,All
2022,5,COIMBATORE,HYDERABAD,19965,21182,COIMBATORE-HYDERABAD,41147,All
2022,6,COIMBATORE,HYDERABAD,19095,17241,COIMBATORE-HYDERABAD,36336,All
2022,7,COIMBATORE,HYDERABAD,16221,15977,COIMBATORE-HYDERABAD,32198,All
2022,8,COIMBATORE,HYDERABAD,17608,17293,COIMBATORE-HYDERABAD,34901,All
2022,9,COIMBATORE,HYDERABAD,18614,18339,COIMBATORE-HYDERABAD,36953,All
2022,10,COIMBATORE,HYDERABAD,19490,18267,COIMBATORE-HYDERABAD,37757,All
2022,11,COIMBATORE,HYDERABAD,15723,14630,COIMBATORE-HYDERABAD,30353,All
2022,12,COIMBATORE,HYDERABAD,16639,16982,COIMBATORE-HYDERABAD,33621,All
2023,1,COIMBATORE,HYDERABAD,16260,16129,COIMBATORE-HYDERABAD,32389,All
2023,2,COIMBATORE,HYDERABAD,16457,17209,COIMBATORE-HYDERABAD,33666,All
2023,3,COIMBATORE,HYDERABAD,17094,17738,COIMBATORE-HYDERABAD,34832,All
2023,4,COIMBATORE,HYDERABAD,18632,19580,COIMBATORE-HYDERABAD,38212,All
2023,5,COIMBATORE,HYDERABAD,20678,21870,COIMBATORE-HYDERABAD,42548,All
2023,6,COIMBATORE,HYDERABAD,16452,16659,COIMBATORE-HYDERABAD,33111,All
2023,7,COIMBATORE,HYDERABAD,14636,15304,COIMBATORE-HYDERABAD,29940,All
2023,8,COIMBATORE,HYDERABAD,17889,17707,COIMBATORE-HYDERABAD,35596,All
2023,9,COIMBATORE,HYDERABAD,17463,17028,COIMBATORE-HYDERABAD,34491,All
2023,10,COIMBATORE,HYDERABAD,16944,16940,COIMBATORE-HYDERABAD,33884,All
2023,11,COIMBATORE,HYDERABAD,14003,13760,COIMBATORE-HYDERABAD,27763,All
2023,12,COIMBATORE,HYDERABAD,14096,14717,COIMBATORE-HYDERABAD,28813,All
2024,1,COIMBATORE,HYDERABAD,10032,10339,COIMBATORE-HYDERABAD,20371,All
2024,2,COIMBATORE,HYDERABAD,10007,9859,COIMBATORE-HYDERABAD,19866,All
2024,3,COIMBATORE,HYDERABAD,12181,12045,COIMBATORE-HYDERABAD,24226,All
2024,4,COIMBATORE,HYDERABAD,13289,13281,COIMBATORE-HYDERABAD,26570,All
2024,6,COIMBATORE,HYDERABAD,13464,12627,COIMBATORE-HYDERABAD,26091,All
2024,7,COIMBATORE,HYDERABAD,13334,13260,COIMBATORE-HYDERABAD,26594,All
2024,8,COIMBATORE,HYDERABAD,14788,14530,COIMBATORE-HYDERABAD,29318,All
2024,9,COIMBATORE,HYDERABAD,14511,13566,COIMBATORE-HYDERABAD,28077,All
2024,10,COIMBATORE,HYDERABAD,17260,17238,COIMBATORE-HYDERABAD,34498,All
2024,11,COIMBATORE,HYDERABAD,17673,17440,COIMBATORE-HYDERABAD,35113,All
2024,12,COIMBATORE,HYDERABAD,19068,19368,COIMBATORE-HYDERABAD,38436,All
2025,1,COIMBATORE,HYDERABAD,21396,20720,COIMBATORE-HYDERABAD,42116,All
2025,2,COIMBATORE,HYDERABAD,18681,18788,COIMBATORE-HYDERABAD,37469,All
2025,3,COIMBATORE,HYDERABAD,19360,18372,COIMBATORE-HYDERABAD,37732,All
2021,1,COIMBATORE,IMPHAL,2,4,COIMBATORE-IMPHAL,6,All
2021,2,COIMBATORE,IMPHAL,66,53,COIMBATORE-IMPHAL,119,All
2021,3,COIMBATORE,IMPHAL,68,51,COIMBATORE-IMPHAL,119,All
2021,8,COIMBATORE,IMPHAL,0,14,COIMBATORE-IMPHAL,14,All
2021,9,COIMBATORE,IMPHAL,0,6,COIMBATORE-IMPHAL,6,All
2021,10,COIMBATORE,IMPHAL,0,4,COIMBATORE-IMPHAL,4,All
2021,8,COIMBATORE,INDORE,36,0,COIMBATORE-INDORE,36,All
2021,9,COIMBATORE,INDORE,66,0,COIMBATORE-INDORE,66,All
2021,10,COIMBATORE,INDORE,67,0,COIMBATORE-INDORE,67,All
2023,4,COIMBATORE,INDORE,0,1,COIMBATORE-INDORE,1,All
2017,9,COIMBATORE,JAIPUR,0,14,COIMBATORE-JAIPUR,14,All
2017,10,COIMBATORE,JAIPUR,0,9,COIMBATORE-JAIPUR,9,All
2018,1,COIMBATORE,JAIPUR,3,6,COIMBATORE-JAIPUR,9,All
2018,2,COIMBATORE,JAIPUR,8,5,COIMBATORE-JAIPUR,13,All
2018,3,COIMBATORE,JAIPUR,14,2,COIMBATORE-JAIPUR,16,All
2018,4,COIMBATORE,JAIPUR,15,13,COIMBATORE-JAIPUR,28,All
2018,5,COIMBATORE,JAIPUR,9,3,COIMBATORE-JAIPUR,12,All
2018,6,COIMBATORE,JAIPUR,11,8,COIMBATORE-JAIPUR,19,All
2018,7,COIMBATORE,JAIPUR,0,4,COIMBATORE-JAIPUR,4,All
2018,8,COIMBATORE,JAIPUR,7,15,COIMBATORE-JAIPUR,22,All
2018,9,COIMBATORE,JAIPUR,0,4,COIMBATORE-JAIPUR,4,All
2020,10,COIMBATORE,JAIPUR,71,66,COIMBATORE-JAIPUR,137,All
2020,11,COIMBATORE,JAIPUR,568,353,COIMBATORE-JAIPUR,921,All
2020,12,COIMBATORE,JAIPUR,436,519,COIMBATORE-JAIPUR,955,All
2021,1,COIMBATORE,JAIPUR,332,308,COIMBATORE-JAIPUR,640,All
2021,2,COIMBATORE,JAIPUR,351,269,COIMBATORE-JAIPUR,620,All
2021,3,COIMBATORE,JAIPUR,353,177,COIMBATORE-JAIPUR,530,All
2021,4,COIMBATORE,JAIPUR,245,200,COIMBATORE-JAIPUR,445,All
2021,10,COIMBATORE,JAIPUR,12,1,COIMBATORE-JAIPUR,13,All
2021,11,COIMBATORE,JAIPUR,414,220,COIMBATORE-JAIPUR,634,All
2021,12,COIMBATORE,JAIPUR,369,387,COIMBATORE-JAIPUR,756,All
2022,1,COIMBATORE,JAIPUR,196,124,COIMBATORE-JAIPUR,320,All
2022,2,COIMBATORE,JAIPUR,404,179,COIMBATORE-JAIPUR,583,All
2022,3,COIMBATORE,JAIPUR,443,309,COIMBATORE-JAIPUR,752,All
2022,4,COIMBATORE,JAIPUR,590,396,COIMBATORE-JAIPUR,986,All
2022,5,COIMBATORE,JAIPUR,533,539,COIMBATORE-JAIPUR,1072,All
2022,6,COIMBATORE,JAIPUR,517,487,COIMBATORE-JAIPUR,1004,All
2022,7,COIMBATORE,JAIPUR,440,370,COIMBATORE-JAIPUR,810,All
2022,8,COIMBATORE,JAIPUR,525,394,COIMBATORE-JAIPUR,919,All
2022,9,COIMBATORE,JAIPUR,608,322,COIMBATORE-JAIPUR,930,All
2022,10,COIMBATORE,JAIPUR,631,403,COIMBATORE-JAIPUR,1034,All
2022,11,COIMBATORE,JAIPUR,532,332,COIMBATORE-JAIPUR,864,All
2022,12,COIMBATORE,JAIPUR,588,597,COIMBATORE-JAIPUR,1185,All
2023,1,COIMBATORE,JAIPUR,600,378,COIMBATORE-JAIPUR,978,All
2023,2,COIMBATORE,JAIPUR,583,328,COIMBATORE-JAIPUR,911,All
2023,3,COIMBATORE,JAIPUR,395,148,COIMBATORE-JAIPUR,543,All
2023,4,COIMBATORE,JAIPUR,368,154,COIMBATORE-JAIPUR,522,All
2023,5,COIMBATORE,JAIPUR,303,202,COIMBATORE-JAIPUR,505,All
2023,6,COIMBATORE,JAIPUR,334,230,COIMBATORE-JAIPUR,564,All
2023,7,COIMBATORE,JAIPUR,385,192,COIMBATORE-JAIPUR,577,All
2023,8,COIMBATORE,JAIPUR,243,129,COIMBATORE-JAIPUR,372,All
2023,9,COIMBATORE,JAIPUR,251,182,COIMBATORE-JAIPUR,433,All
2023,10,COIMBATORE,JAIPUR,501,346,COIMBATORE-JAIPUR,847,All
2023,11,COIMBATORE,JAIPUR,845,748,COIMBATORE-JAIPUR,1593,All
2023,12,COIMBATORE,JAIPUR,1029,1143,COIMBATORE-JAIPUR,2172,All
2024,1,COIMBATORE,JAIPUR,724,565,COIMBATORE-JAIPUR,1289,All
2024,2,COIMBATORE,JAIPUR,660,648,COIMBATORE-JAIPUR,1308,All
2024,3,COIMBATORE,JAIPUR,716,780,COIMBATORE-JAIPUR,1496,All
2024,4,COIMBATORE,JAIPUR,845,652,COIMBATORE-JAIPUR,1497,All
2024,6,COIMBATORE,JAIPUR,576,667,COIMBATORE-JAIPUR,1243,All
2024,7,COIMBATORE,JAIPUR,427,307,COIMBATORE-JAIPUR,734,All
2024,8,COIMBATORE,JAIPUR,497,488,COIMBATORE-JAIPUR,985,All
2024,9,COIMBATORE,JAIPUR,818,620,COIMBATORE-JAIPUR,1438,All
2024,10,COIMBATORE,JAIPUR,454,538,COIMBATORE-JAIPUR,992,All
2024,11,COIMBATORE,JAIPUR,257,166,COIMBATORE-JAIPUR,423,All
2024,12,COIMBATORE,JAIPUR,284,262,COIMBATORE-JAIPUR,546,All
2025,3,COIMBATORE,JAIPUR,97,152,COIMBATORE-JAIPUR,249,All
2021,8,COIMBATORE,KANNUR,0,194,COIMBATORE-KANNUR,194,All
2021,9,COIMBATORE,KANNUR,109,0,COIMBATORE-KANNUR,109,All
2018,4,COIMBATORE,KOCHI,648,474,COIMBATORE-KOCHI,1122,All
2018,5,COIMBATORE,KOCHI,670,631,COIMBATORE-KOCHI,1301,All
2018,6,COIMBATORE,KOCHI,761,781,COIMBATORE-KOCHI,1542,All
2018,7,COIMBATORE,KOCHI,764,600,COIMBATORE-KOCHI,1364,All
2018,8,COIMBATORE,KOCHI,576,415,COIMBATORE-KOCHI,991,All
2018,9,COIMBATORE,KOCHI,738,670,COIMBATORE-KOCHI,1408,All
2018,10,COIMBATORE,KOCHI,17,0,COIMBATORE-KOCHI,17,All
2018,11,COIMBATORE,KOCHI,3,1465,COIMBATORE-KOCHI,1468,All
2018,12,COIMBATORE,KOCHI,45,931,COIMBATORE-KOCHI,976,All
2019,1,COIMBATORE,KOCHI,62,0,COIMBATORE-KOCHI,62,All
2019,2,COIMBATORE,KOCHI,16,554,COIMBATORE-KOCHI,570,All
2019,3,COIMBATORE,KOCHI,21,0,COIMBATORE-KOCHI,21,All
2019,4,COIMBATORE,KOCHI,45,0,COIMBATORE-KOCHI,45,All
2019,5,COIMBATORE,KOCHI,36,0,COIMBATORE-KOCHI,36,All
2019,6,COIMBATORE,KOCHI,26,0,COIMBATORE-KOCHI,26,All
2019,7,COIMBATORE,KOCHI,31,0,COIMBATORE-KOCHI,31,All
2019,8,COIMBATORE,KOCHI,23,0,COIMBATORE-KOCHI,23,All
2019,9,COIMBATORE,KOCHI,25,0,COIMBATORE-KOCHI,25,All
2019,10,COIMBATORE,KOCHI,10,0,COIMBATORE-KOCHI,10,All
2020,6,COIMBATORE,KOCHI,0,0,COIMBATORE-KOCHI,0,All
2020,7,COIMBATORE,KOCHI,9,0,COIMBATORE-KOCHI,9,All
2020,8,COIMBATORE,KOCHI,11,0,COIMBATORE-KOCHI,11,All
2020,9,COIMBATORE,KOCHI,5,0,COIMBATORE-KOCHI,5,All
2021,3,COIMBATORE,KOCHI,77,218,COIMBATORE-KOCHI,295,All
2021,4,COIMBATORE,KOCHI,0,198,COIMBATORE-KOCHI,198,All
2022,1,COIMBATORE,KOCHI,40,0,COIMBATORE-KOCHI,40,All
2022,2,COIMBATORE,KOCHI,227,0,COIMBATORE-KOCHI,227,All
2022,7,COIMBATORE,KOCHI,42,0,COIMBATORE-KOCHI,42,All
2022,8,COIMBATORE,KOCHI,187,0,COIMBATORE-KOCHI,187,All
2023,11,COIMBATORE,KOCHI,21,0,COIMBATORE-KOCHI,21,All
2023,1,COIMBATORE,KOLHAPUR,97,67,COIMBATORE-KOLHAPUR,164,All
2023,2,COIMBATORE,KOLHAPUR,88,81,COIMBATORE-KOLHAPUR,169,All
2023,3,COIMBATORE,KOLHAPUR,76,59,COIMBATORE-KOLHAPUR,135,All
2019,5,COIMBATORE,KOLKATA,1400,993,COIMBATORE-KOLKATA,2393,All
2019,6,COIMBATORE,KOLKATA,1414,958,COIMBATORE-KOLKATA,2372,All
2019,7,COIMBATORE,KOLKATA,856,696,COIMBATORE-KOLKATA,1552,All
2019,8,COIMBATORE,KOLKATA,937,488,COIMBATORE-KOLKATA,1425,All
2019,9,COIMBATORE,KOLKATA,911,407,COIMBATORE-KOLKATA,1318,All
2019,10,COIMBATORE,KOLKATA,1174,559,COIMBATORE-KOLKATA,1733,All
2019,11,COIMBATORE,KOLKATA,1090,728,COIMBATORE-KOLKATA,1818,All
2019,12,COIMBATORE,KOLKATA,1303,638,COIMBATORE-KOLKATA,1941,All
2020,1,COIMBATORE,KOLKATA,1288,566,COIMBATORE-KOLKATA,1854,All
2020,2,COIMBATORE,KOLKATA,845,539,COIMBATORE-KOLKATA,1384,All
2020,3,COIMBATORE,KOLKATA,653,378,COIMBATORE-KOLKATA,1031,All
2020,6,COIMBATORE,KOLKATA,408,0,COIMBATORE-KOLKATA,408,All
2020,10,COIMBATORE,KOLKATA,189,202,COIMBATORE-KOLKATA,391,All
2020,11,COIMBATORE,KOLKATA,1214,651,COIMBATORE-KOLKATA,1865,All
2020,12,COIMBATORE,KOLKATA,804,634,COIMBATORE-KOLKATA,1438,All
2021,1,COIMBATORE,KOLKATA,2343,2612,COIMBATORE-KOLKATA,4955,All
2021,2,COIMBATORE,KOLKATA,3512,4060,COIMBATORE-KOLKATA,7572,All
2021,3,COIMBATORE,KOLKATA,3349,3290,COIMBATORE-KOLKATA,6639,All
2021,4,COIMBATORE,KOLKATA,931,88,COIMBATORE-KOLKATA,1019,All
2021,7,COIMBATORE,KOLKATA,267,547,COIMBATORE-KOLKATA,814,All
2021,8,COIMBATORE,KOLKATA,85,1112,COIMBATORE-KOLKATA,1197,All
2021,9,COIMBATORE,KOLKATA,571,950,COIMBATORE-KOLKATA,1521,All
2021,10,COIMBATORE,KOLKATA,1102,932,COIMBATORE-KOLKATA,2034,All
2021,11,COIMBATORE,KOLKATA,1802,1318,COIMBATORE-KOLKATA,3120,All
2022,10,COIMBATORE,KOLKATA,17,31,COIMBATORE-KOLKATA,48,All
2022,11,COIMBATORE,KOLKATA,444,487,COIMBATORE-KOLKATA,931,All
2022,12,COIMBATORE,KOLKATA,365,559,COIMBATORE-KOLKATA,924,All
2023,1,COIMBATORE,KOLKATA,379,384,COIMBATORE-KOLKATA,763,All
2023,2,COIMBATORE,KOLKATA,294,208,COIMBATORE-KOLKATA,502,All
2023,3,COIMBATORE,KOLKATA,195,112,COIMBATORE-KOLKATA,307,All
2023,4,COIMBATORE,KOLKATA,343,103,COIMBATORE-KOLKATA,446,All
2023,5,COIMBATORE,KOLKATA,384,280,COIMBATORE-KOLKATA,664,All
2023,10,COIMBATORE,KOLKATA,32,57,COIMBATORE-KOLKATA,89,All
2023,11,COIMBATORE,KOLKATA,366,260,COIMBATORE-KOLKATA,626,All
2023,12,COIMBATORE,KOLKATA,559,561,COIMBATORE-KOLKATA,1120,All
2024,1,COIMBATORE,KOLKATA,470,415,COIMBATORE-KOLKATA,885,All
2024,2,COIMBATORE,KOLKATA,426,307,COIMBATORE-KOLKATA,733,All
2024,3,COIMBATORE,KOLKATA,537,266,COIMBATORE-KOLKATA,803,All
2024,4,COIMBATORE,KOLKATA,259,147,COIMBATORE-KOLKATA,406,All
2024,6,COIMBATORE,KOLKATA,400,158,COIMBATORE-KOLKATA,558,All
2024,7,COIMBATORE,KOLKATA,237,332,COIMBATORE-KOLKATA,569,All
2024,8,COIMBATORE,KOLKATA,354,210,COIMBATORE-KOLKATA,564,All
2024,9,COIMBATORE,KOLKATA,261,148,COIMBATORE-KOLKATA,409,All
2024,10,COIMBATORE,KOLKATA,398,173,COIMBATORE-KOLKATA,571,All
2024,11,COIMBATORE,KOLKATA,0,124,COIMBATORE-KOLKATA,124,All
2024,12,COIMBATORE,KOLKATA,0,223,COIMBATORE-KOLKATA,223,All
2025,3,COIMBATORE,KOLKATA,0,196,COIMBATORE-KOLKATA,196,All
2020,9,COIMBATORE,KOZHIKODE,59,0,COIMBATORE-KOZHIKODE,59,All
2022,5,COIMBATORE,KOZHIKODE,172,0,COIMBATORE-KOZHIKODE,172,All
2019,12,COIMBATORE,LUCKNOW,8,0,COIMBATORE-LUCKNOW,8,All
2021,9,COIMBATORE,LUCKNOW,114,119,COIMBATORE-LUCKNOW,233,All
2021,10,COIMBATORE,LUCKNOW,205,168,COIMBATORE-LUCKNOW,373,All
2023,12,COIMBATORE,LUCKNOW,16,0,COIMBATORE-LUCKNOW,16,All
2024,10,COIMBATORE,LUCKNOW,1,0,COIMBATORE-LUCKNOW,1,All
2024,11,COIMBATORE,LUCKNOW,25,0,COIMBATORE-LUCKNOW,25,All
2024,12,COIMBATORE,LUCKNOW,22,0,COIMBATORE-LUCKNOW,22,All
2019,8,COIMBATORE,MADURAI,0,15,COIMBATORE-MADURAI,15,All
2019,9,COIMBATORE,MADURAI,0,15,COIMBATORE-MADURAI,15,All
2019,10,COIMBATORE,MADURAI,0,36,COIMBATORE-MADURAI,36,All
2020,1,COIMBATORE,MADURAI,0,2,COIMBATORE-MADURAI,2,All
2020,5,COIMBATORE,MADURAI,0,0,COIMBATORE-MADURAI,0,All
2020,10,COIMBATORE,MADURAI,0,44,COIMBATORE-MADURAI,44,All
2017,3,COIMBATORE,MANGALORE,0,18,COIMBATORE-MANGALORE,18,All
2017,9,COIMBATORE,MANGALORE,0,1,COIMBATORE-MANGALORE,1,All
2018,2,COIMBATORE,MANGALORE,0,98,COIMBATORE-MANGALORE,98,All
2018,3,COIMBATORE,MANGALORE,0,62,COIMBATORE-MANGALORE,62,All
2019,9,COIMBATORE,MANGALORE,0,8,COIMBATORE-MANGALORE,8,All
2019,10,COIMBATORE,MANGALORE,0,151,COIMBATORE-MANGALORE,151,All
2019,11,COIMBATORE,MANGALORE,0,297,COIMBATORE-MANGALORE,297,All
2019,12,COIMBATORE,MANGALORE,0,389,COIMBATORE-MANGALORE,389,All
2020,1,COIMBATORE,MANGALORE,0,442,COIMBATORE-MANGALORE,442,All
2020,2,COIMBATORE,MANGALORE,0,482,COIMBATORE-MANGALORE,482,All
2020,3,COIMBATORE,MANGALORE,0,508,COIMBATORE-MANGALORE,508,All
2020,10,COIMBATORE,MANGALORE,21,1,COIMBATORE-MANGALORE,22,All
2021,3,COIMBATORE,MANGALORE,35,668,COIMBATORE-MANGALORE,703,All
2021,4,COIMBATORE,MANGALORE,44,205,COIMBATORE-MANGALORE,249,All
2021,6,COIMBATORE,MANGALORE,0,116,COIMBATORE-MANGALORE,116,All
2021,7,COIMBATORE,MANGALORE,112,117,COIMBATORE-MANGALORE,229,All
2021,8,COIMBATORE,MANGALORE,692,427,COIMBATORE-MANGALORE,1119,All
2021,9,COIMBATORE,MANGALORE,1581,547,COIMBATORE-MANGALORE,2128,All
2021,10,COIMBATORE,MANGALORE,0,473,COIMBATORE-MANGALORE,473,All
2021,11,COIMBATORE,MANGALORE,0,305,COIMBATORE-MANGALORE,305,All
2021,12,COIMBATORE,MANGALORE,0,362,COIMBATORE-MANGALORE,362,All
2022,1,COIMBATORE,MANGALORE,1187,509,COIMBATORE-MANGALORE,1696,All
2022,2,COIMBATORE,MANGALORE,110,370,COIMBATORE-MANGALORE,480,All
2022,3,COIMBATORE,MANGALORE,0,299,COIMBATORE-MANGALORE,299,All
2022,5,COIMBATORE,MANGALORE,0,72,COIMBATORE-MANGALORE,72,All
2022,6,COIMBATORE,MANGALORE,281,203,COIMBATORE-MANGALORE,484,All
2022,7,COIMBATORE,MANGALORE,213,1364,COIMBATORE-MANGALORE,1577,All
2022,9,COIMBATORE,MANGALORE,0,337,COIMBATORE-MANGALORE,337,All
2019,5,COIMBATORE,MUMBAI,25214,27256,COIMBATORE-MUMBAI,52470,All
2019,6,COIMBATORE,MUMBAI,25194,24448,COIMBATORE-MUMBAI,49642,All
2019,7,COIMBATORE,MUMBAI,22983,24966,COIMBATORE-MUMBAI,47949,All
2019,8,COIMBATORE,MUMBAI,26722,26136,COIMBATORE-MUMBAI,52858,All
2019,9,COIMBATORE,MUMBAI,22543,20968,COIMBATORE-MUMBAI,43511,All
2019,10,COIMBATORE,MUMBAI,22635,25962,COIMBATORE-MUMBAI,48597,All
2019,11,COIMBATORE,MUMBAI,24924,23431,COIMBATORE-MUMBAI,48355,All
2019,12,COIMBATORE,MUMBAI,24947,25802,COIMBATORE-MUMBAI,50749,All
2020,1,COIMBATORE,MUMBAI,25260,24051,COIMBATORE-MUMBAI,49311,All
2020,2,COIMBATORE,MUMBAI,20988,22314,COIMBATORE-MUMBAI,43302,All
2020,3,COIMBATORE,MUMBAI,11535,11249,COIMBATORE-MUMBAI,22784,All
2020,6,COIMBATORE,MUMBAI,386,433,COIMBATORE-MUMBAI,819,All
2020,7,COIMBATORE,MUMBAI,809,938,COIMBATORE-MUMBAI,1747,All
2020,8,COIMBATORE,MUMBAI,1021,1463,COIMBATORE-MUMBAI,2484,All
2020,9,COIMBATORE,MUMBAI,2865,3712,COIMBATORE-MUMBAI,6577,All
2020,10,COIMBATORE,MUMBAI,4519,5618,COIMBATORE-MUMBAI,10137,All
2020,11,COIMBATORE,MUMBAI,6269,6997,COIMBATORE-MUMBAI,13266,All
2020,12,COIMBATORE,MUMBAI,10257,8562,COIMBATORE-MUMBAI,18819,All
2021,1,COIMBATORE,MUMBAI,11483,13193,COIMBATORE-MUMBAI,24676,All
2021,2,COIMBATORE,MUMBAI,11711,12431,COIMBATORE-MUMBAI,24142,All
2021,3,COIMBATORE,MUMBAI,10155,9151,COIMBATORE-MUMBAI,19306,All
2021,4,COIMBATORE,MUMBAI,6484,6431,COIMBATORE-MUMBAI,12915,All
2021,6,COIMBATORE,MUMBAI,2849,2403,COIMBATORE-MUMBAI,5252,All
2021,7,COIMBATORE,MUMBAI,5395,6045,COIMBATORE-MUMBAI,11440,All
2021,8,COIMBATORE,MUMBAI,10650,10801,COIMBATORE-MUMBAI,21451,All
2021,9,COIMBATORE,MUMBAI,10987,12138,COIMBATORE-MUMBAI,23125,All
2021,10,COIMBATORE,MUMBAI,13802,13774,COIMBATORE-MUMBAI,27576,All
2021,11,COIMBATORE,MUMBAI,17367,15467,COIMBATORE-MUMBAI,32834,All
2021,12,COIMBATORE,MUMBAI,17160,16651,COIMBATORE-MUMBAI,33811,All
2022,1,COIMBATORE,MUMBAI,10522,10565,COIMBATORE-MUMBAI,21087,All
2022,2,COIMBATORE,MUMBAI,13346,13761,COIMBATORE-MUMBAI,27107,All
2022,3,COIMBATORE,MUMBAI,17957,16788,COIMBATORE-MUMBAI,34745,All
2022,4,COIMBATORE,MUMBAI,15309,15572,COIMBATORE-MUMBAI,30881,All
2022,5,COIMBATORE,MUMBAI,16684,17127,COIMBATORE-MUMBAI,33811,All
2022,6,COIMBATORE,MUMBAI,17666,16710,COIMBATORE-MUMBAI,34376,All
2022,7,COIMBATORE,MUMBAI,16819,15066,COIMBATORE-MUMBAI,31885,All
2022,8,COIMBATORE,MUMBAI,18954,17907,COIMBATORE-MUMBAI,36861,All
2022,9,COIMBATORE,MUMBAI,19322,17475,COIMBATORE-MUMBAI,36797,All
2022,10,COIMBATORE,MUMBAI,13643,15118,COIMBATORE-MUMBAI,28761,All
2022,11,COIMBATORE,MUMBAI,14236,14320,COIMBATORE-MUMBAI,28556,All
2022,12,COIMBATORE,MUMBAI,14197,14809,COIMBATORE-MUMBAI,29006,All
2023,11,COIMBATORE,MUMBAI,21946,22147,COIMBATORE-MUMBAI,44093,All
2023,12,COIMBATORE,MUMBAI,26186,27864,COIMBATORE-MUMBAI,54050,All
2024,1,COIMBATORE,MUMBAI,29708,28862,COIMBATORE-MUMBAI,58570,All
2024,2,COIMBATORE,MUMBAI,28016,26674,COIMBATORE-MUMBAI,54690,All
2024,3,COIMBATORE,MUMBAI,28584,27638,COIMBATORE-MUMBAI,56222,All
2024,4,COIMBATORE,MUMBAI,32121,30210,COIMBATORE-MUMBAI,62331,All
2024,6,COIMBATORE,MUMBAI,31779,30851,COIMBATORE-MUMBAI,62630,All
2024,7,COIMBATORE,MUMBAI,27375,31225,COIMBATORE-MUMBAI,58600,All
2024,8,COIMBATORE,MUMBAI,31464,28517,COIMBATORE-MUMBAI,59981,All
2024,9,COIMBATORE,MUMBAI,31868,29325,COIMBATORE-MUMBAI,61193,All
2024,10,COIMBATORE,MUMBAI,25749,29223,COIMBATORE-MUMBAI,54972,All
2024,11,COIMBATORE,MUMBAI,28471,28203,COIMBATORE-MUMBAI,56674,All
2024,12,COIMBATORE,MUMBAI,31333,33244,COIMBATORE-MUMBAI,64577,All
2025,1,COIMBATORE,MUMBAI,32990,33663,COIMBATORE-MUMBAI,66653,All
2025,2,COIMBATORE,MUMBAI,28326,29194,COIMBATORE-MUMBAI,57520,All
2025,3,COIMBATORE,MUMBAI,29686,30116,COIMBATORE-MUMBAI,59802,All
2022,5,COIMBATORE,MYSORE,58,0,COIMBATORE-MYSORE,58,All
2019,3,COIMBATORE,NAGPUR,0,1,COIMBATORE-NAGPUR,1,All
2019,4,COIMBATORE,NAGPUR,0,127,COIMBATORE-NAGPUR,127,All
2019,5,COIMBATORE,NAGPUR,0,358,COIMBATORE-NAGPUR,358,All
2019,6,COIMBATORE,NAGPUR,0,368,COIMBATORE-NAGPUR,368,All
2019,7,COIMBATORE,NAGPUR,0,220,COIMBATORE-NAGPUR,220,All
2019,8,COIMBATORE,NAGPUR,0,1,COIMBATORE-NAGPUR,1,All
2019,9,COIMBATORE,NAGPUR,0,128,COIMBATORE-NAGPUR,128,All
2019,10,COIMBATORE,NAGPUR,0,165,COIMBATORE-NAGPUR,165,All
2019,11,COIMBATORE,NAGPUR,0,97,COIMBATORE-NAGPUR,97,All
2019,12,COIMBATORE,NAGPUR,0,384,COIMBATORE-NAGPUR,384,All
2020,1,COIMBATORE,NAGPUR,0,238,COIMBATORE-NAGPUR,238,All
2020,2,COIMBATORE,NAGPUR,0,184,COIMBATORE-NAGPUR,184,All
2020,3,COIMBATORE,NAGPUR,0,63,COIMBATORE-NAGPUR,63,All
2025,3,COIMBATORE,NASIK,8,1,COIMBATORE-NASIK,9,All
2020,2,COIMBATORE,PORT BLAIR,26,0,COIMBATORE-PORT BLAIR,26,All
2020,3,COIMBATORE,PORT BLAIR,76,0,COIMBATORE-PORT BLAIR,76,All
2017,9,COIMBATORE,PUNE,2431,2559,COIMBATORE-PUNE,4990,All
2017,10,COIMBATORE,PUNE,2491,3078,COIMBATORE-PUNE,5569,All
2017,11,COIMBATORE,PUNE,2087,2447,COIMBATORE-PUNE,4534,All
2017,12,COIMBATORE,PUNE,2806,3194,COIMBATORE-PUNE,6000,All
2018,1,COIMBATORE,PUNE,2389,2436,COIMBATORE-PUNE,4825,All
2018,2,COIMBATORE,PUNE,1586,2186,COIMBATORE-PUNE,3772,All
2018,3,COIMBATORE,PUNE,2829,3338,COIMBATORE-PUNE,6167,All
2018,4,COIMBATORE,PUNE,3005,3521,COIMBATORE-PUNE,6526,All
2018,5,COIMBATORE,PUNE,2980,3644,COIMBATORE-PUNE,6624,All
2018,6,COIMBATORE,PUNE,1779,2283,COIMBATORE-PUNE,4062,All
2018,7,COIMBATORE,PUNE,1956,2471,COIMBATORE-PUNE,4427,All
2018,8,COIMBATORE,PUNE,2338,2974,COIMBATORE-PUNE,5312,All
2018,9,COIMBATORE,PUNE,2278,2797,COIMBATORE-PUNE,5075,All
2018,10,COIMBATORE,PUNE,1473,1842,COIMBATORE-PUNE,3315,All
2018,11,COIMBATORE,PUNE,2096,1819,COIMBATORE-PUNE,3915,All
2018,12,COIMBATORE,PUNE,1967,1968,COIMBATORE-PUNE,3935,All
2019,1,COIMBATORE,PUNE,2305,2238,COIMBATORE-PUNE,4543,All
2019,2,COIMBATORE,PUNE,1851,1705,COIMBATORE-PUNE,3556,All
2019,10,COIMBATORE,PUNE,368,655,COIMBATORE-PUNE,1023,All
2019,11,COIMBATORE,PUNE,3494,3215,COIMBATORE-PUNE,6709,All
2019,12,COIMBATORE,PUNE,4527,5101,COIMBATORE-PUNE,9628,All
2020,1,COIMBATORE,PUNE,4710,4719,COIMBATORE-PUNE,9429,All
2020,2,COIMBATORE,PUNE,3755,4318,COIMBATORE-PUNE,8073,All
2020,3,COIMBATORE,PUNE,1858,2761,COIMBATORE-PUNE,4619,All
2021,1,COIMBATORE,PUNE,201,168,COIMBATORE-PUNE,369,All
2021,3,COIMBATORE,PUNE,147,115,COIMBATORE-PUNE,262,All
2021,4,COIMBATORE,PUNE,233,211,COIMBATORE-PUNE,444,All
2021,7,COIMBATORE,PUNE,183,183,COIMBATORE-PUNE,366,All
2021,8,COIMBATORE,PUNE,244,259,COIMBATORE-PUNE,503,All
2021,12,COIMBATORE,PUNE,2974,1465,COIMBATORE-PUNE,4439,All
2022,1,COIMBATORE,PUNE,979,509,COIMBATORE-PUNE,1488,All
2022,3,COIMBATORE,PUNE,1894,1142,COIMBATORE-PUNE,3036,All
2022,4,COIMBATORE,PUNE,4659,3895,COIMBATORE-PUNE,8554,All
2022,5,COIMBATORE,PUNE,4664,3733,COIMBATORE-PUNE,8397,All
2022,6,COIMBATORE,PUNE,4549,3422,COIMBATORE-PUNE,7971,All
2022,7,COIMBATORE,PUNE,4634,4155,COIMBATORE-PUNE,8789,All
2022,8,COIMBATORE,PUNE,0,165,COIMBATORE-PUNE,165,All
2022,9,COIMBATORE,PUNE,3073,2108,COIMBATORE-PUNE,5181,All
2022,10,COIMBATORE,PUNE,4434,4884,COIMBATORE-PUNE,9318,All
2022,11,COIMBATORE,PUNE,4256,3799,COIMBATORE-PUNE,8055,All
2022,12,COIMBATORE,PUNE,3647,3454,COIMBATORE-PUNE,7101,All
2023,1,COIMBATORE,PUNE,3690,3455,COIMBATORE-PUNE,7145,All
2023,2,COIMBATORE,PUNE,4297,4005,COIMBATORE-PUNE,8302,All
2023,3,COIMBATORE,PUNE,3843,3750,COIMBATORE-PUNE,7593,All
2023,4,COIMBATORE,PUNE,4534,4307,COIMBATORE-PUNE,8841,All
2023,5,COIMBATORE,PUNE,4722,5103,COIMBATORE-PUNE,9825,All
2023,6,COIMBATORE,PUNE,4556,4488,COIMBATORE-PUNE,9044,All
2023,7,COIMBATORE,PUNE,4374,4449,COIMBATORE-PUNE,8823,All
2023,8,COIMBATORE,PUNE,4551,4558,COIMBATORE-PUNE,9109,All
2023,9,COIMBATORE,PUNE,4630,4311,COIMBATORE-PUNE,8941,All
2023,10,COIMBATORE,PUNE,4628,4529,COIMBATORE-PUNE,9157,All
2023,11,COIMBATORE,PUNE,4472,4497,COIMBATORE-PUNE,8969,All
2023,12,COIMBATORE,PUNE,4767,4671,COIMBATORE-PUNE,9438,All
2024,1,COIMBATORE,PUNE,4720,4671,COIMBATORE-PUNE,9391,All
2024,2,COIMBATORE,PUNE,4627,4512,COIMBATORE-PUNE,9139,All
2024,3,COIMBATORE,PUNE,4738,4615,COIMBATORE-PUNE,9353,All
2024,4,COIMBATORE,PUNE,4613,4338,COIMBATORE-PUNE,8951,All
2024,6,COIMBATORE,PUNE,4637,4506,COIMBATORE-PUNE,9143,All
2024,7,COIMBATORE,PUNE,5101,4911,COIMBATORE-PUNE,10012,All
2024,8,COIMBATORE,PUNE,4942,4759,COIMBATORE-PUNE,9701,All
2024,9,COIMBATORE,PUNE,4999,4914,COIMBATORE-PUNE,9913,All
2024,10,COIMBATORE,PUNE,4336,4687,COIMBATORE-PUNE,9023,All
2024,11,COIMBATORE,PUNE,5168,4650,COIMBATORE-PUNE,9818,All
2024,12,COIMBATORE,PUNE,5263,5200,COIMBATORE-PUNE,10463,All
2025,1,COIMBATORE,PUNE,5344,4894,COIMBATORE-PUNE,10238,All
2025,2,COIMBATORE,PUNE,4740,4596,COIMBATORE-PUNE,9336,All
2025,3,COIMBATORE,PUNE,5057,4688,COIMBATORE-PUNE,9745,All
2019,11,COIMBATORE,RAIPUR,9,0,COIMBATORE-RAIPUR,9,All
2019,12,COIMBATORE,RAIPUR,374,0,COIMBATORE-RAIPUR,374,All
2020,1,COIMBATORE,RAIPUR,263,0,COIMBATORE-RAIPUR,263,All
2020,2,COIMBATORE,RAIPUR,115,0,COIMBATORE-RAIPUR,115,All
2020,3,COIMBATORE,RAIPUR,115,0,COIMBATORE-RAIPUR,115,All
2022,11,COIMBATORE,RAIPUR,63,60,COIMBATORE-RAIPUR,123,All
2022,12,COIMBATORE,RAIPUR,193,200,COIMBATORE-RAIPUR,393,All
2023,1,COIMBATORE,RAIPUR,186,178,COIMBATORE-RAIPUR,364,All
2023,2,COIMBATORE,RAIPUR,63,78,COIMBATORE-RAIPUR,141,All
2023,3,COIMBATORE,RAIPUR,52,58,COIMBATORE-RAIPUR,110,All
2023,4,COIMBATORE,RAIPUR,123,93,COIMBATORE-RAIPUR,216,All
2023,5,COIMBATORE,RAIPUR,127,98,COIMBATORE-RAIPUR,225,All
2023,6,COIMBATORE,RAIPUR,147,88,COIMBATORE-RAIPUR,235,All
2023,7,COIMBATORE,RAIPUR,155,41,COIMBATORE-RAIPUR,196,All
2023,8,COIMBATORE,RAIPUR,97,61,COIMBATORE-RAIPUR,158,All
2023,9,COIMBATORE,RAIPUR,60,41,COIMBATORE-RAIPUR,101,All
2023,10,COIMBATORE,RAIPUR,101,32,COIMBATORE-RAIPUR,133,All
2023,11,COIMBATORE,RAIPUR,168,110,COIMBATORE-RAIPUR,278,All
2023,12,COIMBATORE,RAIPUR,171,126,COIMBATORE-RAIPUR,297,All
2024,1,COIMBATORE,RAIPUR,129,139,COIMBATORE-RAIPUR,268,All
2024,2,COIMBATORE,RAIPUR,188,168,COIMBATORE-RAIPUR,356,All
2024,3,COIMBATORE,RAIPUR,239,144,COIMBATORE-RAIPUR,383,All
2023,4,COIMBATORE,RAJKOT,0,8,COIMBATORE-RAJKOT,8,All
2024,10,COIMBATORE,SHIRDI,12,0,COIMBATORE-SHIRDI,12,All
2024,11,COIMBATORE,SHIRDI,344,0,COIMBATORE-SHIRDI,344,All
2024,12,COIMBATORE,SHIRDI,236,470,COIMBATORE-SHIRDI,706,All
2025,3,COIMBATORE,SHIRDI,0,245,COIMBATORE-SHIRDI,245,All
2018,8,COIMBATORE,SURAT,116,0,COIMBATORE-SURAT,116,All
2018,9,COIMBATORE,SURAT,134,0,COIMBATORE-SURAT,134,All
2018,10,COIMBATORE,SURAT,17,0,COIMBATORE-SURAT,17,All
2018,11,COIMBATORE,SURAT,811,0,COIMBATORE-SURAT,811,All
2018,12,COIMBATORE,SURAT,610,0,COIMBATORE-SURAT,610,All
2019,1,COIMBATORE,SURAT,569,0,COIMBATORE-SURAT,569,All
2019,2,COIMBATORE,SURAT,509,0,COIMBATORE-SURAT,509,All
2019,3,COIMBATORE,SURAT,360,0,COIMBATORE-SURAT,360,All
2019,4,COIMBATORE,SURAT,380,0,COIMBATORE-SURAT,380,All
2019,5,COIMBATORE,SURAT,587,0,COIMBATORE-SURAT,587,All
2019,6,COIMBATORE,SURAT,78,0,COIMBATORE-SURAT,78,All
2019,10,COIMBATORE,SURAT,0,31,COIMBATORE-SURAT,31,All
2019,11,COIMBATORE,SURAT,0,162,COIMBATORE-SURAT,162,All
2019,12,COIMBATORE,SURAT,0,381,COIMBATORE-SURAT,381,All
2020,1,COIMBATORE,SURAT,0,323,COIMBATORE-SURAT,323,All
2020,2,COIMBATORE,SURAT,0,355,COIMBATORE-SURAT,355,All
2020,3,COIMBATORE,SURAT,0,171,COIMBATORE-SURAT,171,All
2021,3,COIMBATORE,SURAT,39,0,COIMBATORE-SURAT,39,All
2021,4,COIMBATORE,SURAT,63,4,COIMBATORE-SURAT,67,All
2021,8,COIMBATORE,SURAT,27,0,COIMBATORE-SURAT,27,All
2021,9,COIMBATORE,SURAT,135,0,COIMBATORE-SURAT,135,All
2021,10,COIMBATORE,SURAT,109,40,COIMBATORE-SURAT,149,All
2021,11,COIMBATORE,SURAT,299,179,COIMBATORE-SURAT,478,All
2021,12,COIMBATORE,SURAT,147,227,COIMBATORE-SURAT,374,All
2022,1,COIMBATORE,SURAT,96,158,COIMBATORE-SURAT,254,All
2022,3,COIMBATORE,SURAT,77,51,COIMBATORE-SURAT,128,All
2022,4,COIMBATORE,SURAT,378,358,COIMBATORE-SURAT,736,All
2022,5,COIMBATORE,SURAT,1081,944,COIMBATORE-SURAT,2025,All
2022,6,COIMBATORE,SURAT,742,599,COIMBATORE-SURAT,1341,All
2022,7,COIMBATORE,SURAT,454,450,COIMBATORE-SURAT,904,All
2022,8,COIMBATORE,SURAT,712,707,COIMBATORE-SURAT,1419,All
2022,9,COIMBATORE,SURAT,745,713,COIMBATORE-SURAT,1458,All
2022,10,COIMBATORE,SURAT,543,511,COIMBATORE-SURAT,1054,All
2022,11,COIMBATORE,SURAT,304,204,COIMBATORE-SURAT,508,All
2022,12,COIMBATORE,SURAT,415,311,COIMBATORE-SURAT,726,All
2023,1,COIMBATORE,SURAT,305,229,COIMBATORE-SURAT,534,All
2023,2,COIMBATORE,SURAT,160,141,COIMBATORE-SURAT,301,All
2023,3,COIMBATORE,SURAT,189,130,COIMBATORE-SURAT,319,All
2023,4,COIMBATORE,SURAT,329,247,COIMBATORE-SURAT,576,All
2023,5,COIMBATORE,SURAT,420,240,COIMBATORE-SURAT,660,All
2023,6,COIMBATORE,SURAT,334,193,COIMBATORE-SURAT,527,All
2023,7,COIMBATORE,SURAT,225,100,COIMBATORE-SURAT,325,All
2023,8,COIMBATORE,SURAT,273,82,COIMBATORE-SURAT,355,All
2023,9,COIMBATORE,SURAT,256,173,COIMBATORE-SURAT,429,All
2023,10,COIMBATORE,SURAT,273,147,COIMBATORE-SURAT,420,All
2023,11,COIMBATORE,SURAT,263,186,COIMBATORE-SURAT,449,All
2023,12,COIMBATORE,SURAT,301,255,COIMBATORE-SURAT,556,All
2024,1,COIMBATORE,SURAT,237,191,COIMBATORE-SURAT,428,All
2024,2,COIMBATORE,SURAT,297,238,COIMBATORE-SURAT,535,All
2024,3,COIMBATORE,SURAT,298,238,COIMBATORE-SURAT,536,All
2019,10,COIMBATORE,TIRUCHIRAPALLY,0,4,COIMBATORE-TIRUCHIRAPALLY,4,All
2016,6,COIMBATORE,TIRUPATI,1,0,COIMBATORE-TIRUPATI,1,All
2016,7,COIMBATORE,TIRUPATI,3,0,COIMBATORE-TIRUPATI,3,All
2016,8,COIMBATORE,TIRUPATI,27,0,COIMBATORE-TIRUPATI,27,All
2016,10,COIMBATORE,TIRUPATI,4,0,COIMBATORE-TIRUPATI,4,All
2016,11,COIMBATORE,TIRUPATI,182,181,COIMBATORE-TIRUPATI,363,All
2016,12,COIMBATORE,TIRUPATI,377,325,COIMBATORE-TIRUPATI,702,All
2017,1,COIMBATORE,TIRUPATI,542,556,COIMBATORE-TIRUPATI,1098,All
2017,2,COIMBATORE,TIRUPATI,567,511,COIMBATORE-TIRUPATI,1078,All
2021,12,COIMBATORE,TIRUPATI,386,565,COIMBATORE-TIRUPATI,951,All
2022,1,COIMBATORE,TIRUPATI,286,354,COIMBATORE-TIRUPATI,640,All
2022,3,COIMBATORE,TIRUPATI,79,103,COIMBATORE-TIRUPATI,182,All
2022,4,COIMBATORE,TIRUPATI,210,294,COIMBATORE-TIRUPATI,504,All
2022,5,COIMBATORE,TIRUPATI,406,446,COIMBATORE-TIRUPATI,852,All
2022,6,COIMBATORE,TIRUPATI,444,596,COIMBATORE-TIRUPATI,1040,All
2022,7,COIMBATORE,TIRUPATI,450,744,COIMBATORE-TIRUPATI,1194,All
2022,8,COIMBATORE,TIRUPATI,379,602,COIMBATORE-TIRUPATI,981,All
2022,9,COIMBATORE,TIRUPATI,336,524,COIMBATORE-TIRUPATI,860,All
2022,10,COIMBATORE,TIRUPATI,648,712,COIMBATORE-TIRUPATI,1360,All
2018,10,COIMBATORE,TRIVANDRUM,0,7,COIMBATORE-TRIVANDRUM,7,All
2020,3,COIMBATORE,TRIVANDRUM,82,78,COIMBATORE-TRIVANDRUM,160,All
2020,7,COIMBATORE,TRIVANDRUM,9,0,COIMBATORE-TRIVANDRUM,9,All
2020,8,COIMBATORE,TRIVANDRUM,14,0,COIMBATORE-TRIVANDRUM,14,All
2020,9,COIMBATORE,TRIVANDRUM,8,0,COIMBATORE-TRIVANDRUM,8,All
2022,7,COIMBATORE,TRIVANDRUM,0,9,COIMBATORE-TRIVANDRUM,9,All
2021,9,COIMBATORE,UDAIPUR,158,120,COIMBATORE-UDAIPUR,278,All
2021,10,COIMBATORE,UDAIPUR,134,94,COIMBATORE-UDAIPUR,228,All
2021,3,COIMBATORE,VADODARA,8,0,COIMBATORE-VADODARA,8,All
2021,4,COIMBATORE,VADODARA,85,0,COIMBATORE-VADODARA,85,All
2023,3,COIMBATORE,VARANASI,5,0,COIMBATORE-VARANASI,5,All
2023,4,COIMBATORE,VARANASI,150,153,COIMBATORE-VARANASI,303,All
2023,5,COIMBATORE,VARANASI,63,126,COIMBATORE-VARANASI,189,All
2023,6,COIMBATORE,VARANASI,136,202,COIMBATORE-VARANASI,338,All
2023,7,COIMBATORE,VARANASI,144,129,COIMBATORE-VARANASI,273,All
2023,8,COIMBATORE,VARANASI,146,78,COIMBATORE-VARANASI,224,All
2023,9,COIMBATORE,VARANASI,227,91,COIMBATORE-VARANASI,318,All
2023,10,COIMBATORE,VARANASI,256,195,COIMBATORE-VARANASI,451,All
2023,11,COIMBATORE,VARANASI,18,0,COIMBATORE-VARANASI,18,All
2023,12,COIMBATORE,VARANASI,24,0,COIMBATORE-VARANASI,24,All
2024,4,COIMBATORE,VARANASI,125,0,COIMBATORE-VARANASI,125,All
2024,6,COIMBATORE,VARANASI,7,0,COIMBATORE-VARANASI,7,All
2024,7,COIMBATORE,VARANASI,16,0,COIMBATORE-VARANASI,16,All
2024,8,COIMBATORE,VARANASI,9,0,COIMBATORE-VARANASI,9,All
2024,9,COIMBATORE,VARANASI,26,0,COIMBATORE-VARANASI,26,All
2024,10,COIMBATORE,VARANASI,35,0,COIMBATORE-VARANASI,35,All
2016,1,COIMBATORE,VIJAYAWADA,0,103,COIMBATORE-VIJAYAWADA,103,All
2016,2,COIMBATORE,VIJAYAWADA,147,167,COIMBATORE-VIJAYAWADA,314,All
2016,3,COIMBATORE,VIJAYAWADA,155,210,COIMBATORE-VIJAYAWADA,365,All
2016,4,COIMBATORE,VIJAYAWADA,200,177,COIMBATORE-VIJAYAWADA,377,All
2016,5,COIMBATORE,VIJAYAWADA,153,0,COIMBATORE-VIJAYAWADA,153,All
2016,6,COIMBATORE,VIJAYAWADA,5,0,COIMBATORE-VIJAYAWADA,5,All
2016,6,COIMBATORE,VISAKHAPATNAM,146,0,COIMBATORE-VISAKHAPATNAM,146,All
2016,7,COIMBATORE,VISAKHAPATNAM,202,102,COIMBATORE-VISAKHAPATNAM,304,All
2016,8,COIMBATORE,VISAKHAPATNAM,356,224,COIMBATORE-VISAKHAPATNAM,580,All
2016,9,COIMBATORE,VISAKHAPATNAM,310,266,COIMBATORE-VISAKHAPATNAM,576,All
2016,10,COIMBATORE,VISAKHAPATNAM,318,268,COIMBATORE-VISAKHAPATNAM,586,All
2016,11,COIMBATORE,VISAKHAPATNAM,359,288,COIMBATORE-VISAKHAPATNAM,647,All
2016,12,COIMBATORE,VISAKHAPATNAM,469,321,COIMBATORE-VISAKHAPATNAM,790,All
2017,1,COIMBATORE,VISAKHAPATNAM,357,332,COIMBATORE-VISAKHAPATNAM,689,All
2017,2,COIMBATORE,VISAKHAPATNAM,398,230,COIMBATORE-VISAKHAPATNAM,628,All
2017,3,COIMBATORE,VISAKHAPATNAM,292,223,COIMBATORE-VISAKHAPATNAM,515,All
2017,4,COIMBATORE,VISAKHAPATNAM,232,264,COIMBATORE-VISAKHAPATNAM,496,All
2017,5,COIMBATORE,VISAKHAPATNAM,353,358,COIMBATORE-VISAKHAPATNAM,711,All
2017,6,COIMBATORE,VISAKHAPATNAM,291,361,COIMBATORE-VISAKHAPATNAM,652,All
2017,7,COIMBATORE,VISAKHAPATNAM,269,325,COIMBATORE-VISAKHAPATNAM,594,All
2017,8,COIMBATORE,VISAKHAPATNAM,319,374,COIMBATORE-VISAKHAPATNAM,693,All
2017,9,COIMBATORE,VISAKHAPATNAM,325,385,COIMBATORE-VISAKHAPATNAM,710,All
2017,10,COIMBATORE,VISAKHAPATNAM,381,476,COIMBATORE-VISAKHAPATNAM,857,All
2017,11,COIMBATORE,VISAKHAPATNAM,501,485,COIMBATORE-VISAKHAPATNAM,986,All
2017,12,COIMBATORE,VISAKHAPATNAM,577,680,COIMBATORE-VISAKHAPATNAM,1257,All
2018,1,COIMBATORE,VISAKHAPATNAM,500,806,COIMBATORE-VISAKHAPATNAM,1306,All
2018,2,COIMBATORE,VISAKHAPATNAM,498,566,COIMBATORE-VISAKHAPATNAM,1064,All
2018,3,COIMBATORE,VISAKHAPATNAM,214,341,COIMBATORE-VISAKHAPATNAM,555,All
2018,4,COIMBATORE,VISAKHAPATNAM,337,476,COIMBATORE-VISAKHAPATNAM,813,All
2018,5,COIMBATORE,VISAKHAPATNAM,525,723,COIMBATORE-VISAKHAPATNAM,1248,All
2018,6,COIMBATORE,VISAKHAPATNAM,433,536,COIMBATORE-VISAKHAPATNAM,969,All
2018,7,COIMBATORE,VISAKHAPATNAM,354,488,COIMBATORE-VISAKHAPATNAM,842,All
2018,8,COIMBATORE,VISAKHAPATNAM,552,603,COIMBATORE-VISAKHAPATNAM,1155,All
2018,9,COIMBATORE,VISAKHAPATNAM,296,286,COIMBATORE-VISAKHAPATNAM,582,All
2018,10,COIMBATORE,VISAKHAPATNAM,387,529,COIMBATORE-VISAKHAPATNAM,916,All
2018,11,COIMBATORE,VISAKHAPATNAM,634,540,COIMBATORE-VISAKHAPATNAM,1174,All
2018,12,COIMBATORE,VISAKHAPATNAM,541,637,COIMBATORE-VISAKHAPATNAM,1178,All
2019,1,COIMBATORE,VISAKHAPATNAM,1006,672,COIMBATORE-VISAKHAPATNAM,1678,All
2019,2,COIMBATORE,VISAKHAPATNAM,444,514,COIMBATORE-VISAKHAPATNAM,958,All
2019,3,COIMBATORE,VISAKHAPATNAM,479,588,COIMBATORE-VISAKHAPATNAM,1067,All
2019,4,COIMBATORE,VISAKHAPATNAM,495,666,COIMBATORE-VISAKHAPATNAM,1161,All
2019,5,COIMBATORE,VISAKHAPATNAM,581,1037,COIMBATORE-VISAKHAPATNAM,1618,All
2019,6,COIMBATORE,VISAKHAPATNAM,536,651,COIMBATORE-VISAKHAPATNAM,1187,All
2019,7,COIMBATORE,VISAKHAPATNAM,519,766,COIMBATORE-VISAKHAPATNAM,1285,All
2019,8,COIMBATORE,VISAKHAPATNAM,370,596,COIMBATORE-VISAKHAPATNAM,966,All
2019,9,COIMBATORE,VISAKHAPATNAM,566,499,COIMBATORE-VISAKHAPATNAM,1065,All
2019,10,COIMBATORE,VISAKHAPATNAM,84,514,COIMBATORE-VISAKHAPATNAM,598,All
2019,11,COIMBATORE,VISAKHAPATNAM,575,476,COIMBATORE-VISAKHAPATNAM,1051,All
2019,12,COIMBATORE,VISAKHAPATNAM,805,705,COIMBATORE-VISAKHAPATNAM,1510,All
2020,1,COIMBATORE,VISAKHAPATNAM,597,741,COIMBATORE-VISAKHAPATNAM,1338,All
2020,2,COIMBATORE,VISAKHAPATNAM,564,535,COIMBATORE-VISAKHAPATNAM,1099,All
2020,3,COIMBATORE,VISAKHAPATNAM,419,182,COIMBATORE-VISAKHAPATNAM,601,All
2021,3,COIMBATORE,VISAKHAPATNAM,42,16,COIMBATORE-VISAKHAPATNAM,58,All
2021,4,COIMBATORE,VISAKHAPATNAM,202,102,COIMBATORE-VISAKHAPATNAM,304,All
2021,10,COIMBATORE,VISAKHAPATNAM,0,6,COIMBATORE-VISAKHAPATNAM,6,All
2021,11,COIMBATORE,VISAKHAPATNAM,0,144,COIMBATORE-VISAKHAPATNAM,144,All
2021,12,COIMBATORE,VISAKHAPATNAM,0,70,COIMBATORE-VISAKHAPATNAM,70,All
2022,3,COIMBATORE,VISAKHAPATNAM,0,22,COIMBATORE-VISAKHAPATNAM,22,All
2022,4,COIMBATORE,VISAKHAPATNAM,0,247,COIMBATORE-VISAKHAPATNAM,247,All
2022,5,COIMBATORE,VISAKHAPATNAM,0,275,COIMBATORE-VISAKHAPATNAM,275,All
2022,6,COIMBATORE,VISAKHAPATNAM,0,598,COIMBATORE-VISAKHAPATNAM,598,All
2022,7,COIMBATORE,VISAKHAPATNAM,0,408,COIMBATORE-VISAKHAPATNAM,408,All
2022,8,COIMBATORE,VISAKHAPATNAM,0,332,COIMBATORE-VISAKHAPATNAM,332,All
2022,9,COIMBATORE,VISAKHAPATNAM,0,282,COIMBATORE-VISAKHAPATNAM,282,All
2022,10,COIMBATORE,VISAKHAPATNAM,4,392,COIMBATORE-VISAKHAPATNAM,396,All
2022,11,COIMBATORE,VISAKHAPATNAM,234,335,COIMBATORE-VISAKHAPATNAM,569,All
2022,12,COIMBATORE,VISAKHAPATNAM,420,395,COIMBATORE-VISAKHAPATNAM,815,All
2023,1,COIMBATORE,VISAKHAPATNAM,271,315,COIMBATORE-VISAKHAPATNAM,586,All
2023,2,COIMBATORE,VISAKHAPATNAM,193,368,COIMBATORE-VISAKHAPATNAM,561,All
2023,3,COIMBATORE,VISAKHAPATNAM,140,187,COIMBATORE-VISAKHAPATNAM,327,All
2023,4,COIMBATORE,VISAKHAPATNAM,225,180,COIMBATORE-VISAKHAPATNAM,405,All
2023,5,COIMBATORE,VISAKHAPATNAM,58,0,COIMBATORE-VISAKHAPATNAM,58,All
2023,6,COIMBATORE,VISAKHAPATNAM,244,0,COIMBATORE-VISAKHAPATNAM,244,All
2023,7,COIMBATORE,VISAKHAPATNAM,174,170,COIMBATORE-VISAKHAPATNAM,344,All
2023,8,COIMBATORE,VISAKHAPATNAM,203,124,COIMBATORE-VISAKHAPATNAM,327,All
2023,9,COIMBATORE,VISAKHAPATNAM,189,170,COIMBATORE-VISAKHAPATNAM,359,All
2023,10,COIMBATORE,VISAKHAPATNAM,418,294,COIMBATORE-VISAKHAPATNAM,712,All
2023,11,COIMBATORE,VISAKHAPATNAM,0,545,COIMBATORE-VISAKHAPATNAM,545,All
2023,12,COIMBATORE,VISAKHAPATNAM,0,670,COIMBATORE-VISAKHAPATNAM,670,All
2024,1,COIMBATORE,VISAKHAPATNAM,0,526,COIMBATORE-VISAKHAPATNAM,526,All
2024,2,COIMBATORE,VISAKHAPATNAM,0,645,COIMBATORE-VISAKHAPATNAM,645,All
2024,3,COIMBATORE,VISAKHAPATNAM,0,644,COIMBATORE-VISAKHAPATNAM,644,All
2024,4,COIMBATORE,VISAKHAPATNAM,0,463,COIMBATORE-VISAKHAPATNAM,463,All
2024,6,COIMBATORE,VISAKHAPATNAM,0,639,COIMBATORE-VISAKHAPATNAM,639,All
2024,7,COIMBATORE,VISAKHAPATNAM,0,590,COIMBATORE-VISAKHAPATNAM,590,All
2024,8,COIMBATORE,VISAKHAPATNAM,0,444,COIMBATORE-VISAKHAPATNAM,444,All
2024,9,COIMBATORE,VISAKHAPATNAM,0,215,COIMBATORE-VISAKHAPATNAM,215,All
2024,10,COIMBATORE,VISAKHAPATNAM,0,310,COIMBATORE-VISAKHAPATNAM,310,All
2025,3,COIMBATORE,VISAKHAPATNAM,7,5,COIMBATORE-VISAKHAPATNAM,12,All
2023,2,COOCH BEHAR,KOLKATA,41,38,COOCH BEHAR-KOLKATA,79,All
2023,3,COOCH BEHAR,KOLKATA,170,170,COOCH BEHAR-KOLKATA,340,All
2023,4,COOCH BEHAR,KOLKATA,104,113,COOCH BEHAR-KOLKATA,217,All
2023,5,COOCH BEHAR,KOLKATA,43,44,COOCH BEHAR-KOLKATA,87,All
2023,6,COOCH BEHAR,KOLKATA,16,17,COOCH BEHAR-KOLKATA,33,All
2023,7,COOCH BEHAR,KOLKATA,7,7,COOCH BEHAR-KOLKATA,14,All
2023,8,COOCH BEHAR,KOLKATA,8,3,COOCH BEHAR-KOLKATA,11,All
2023,9,COOCH BEHAR,KOLKATA,49,56,COOCH BEHAR-KOLKATA,105,All
2023,10,COOCH BEHAR,KOLKATA,134,116,COOCH BEHAR-KOLKATA,250,All
2023,11,COOCH BEHAR,KOLKATA,238,234,COOCH BEHAR-KOLKATA,472,All
2023,12,COOCH BEHAR,KOLKATA,237,234,COOCH BEHAR-KOLKATA,471,All
2024,1,COOCH BEHAR,KOLKATA,204,205,COOCH BEHAR-KOLKATA,409,All
2024,2,COOCH BEHAR,KOLKATA,205,218,COOCH BEHAR-KOLKATA,423,All
2024,3,COOCH BEHAR,KOLKATA,258,262,COOCH BEHAR-KOLKATA,520,All
2024,4,COOCH BEHAR,KOLKATA,170,177,COOCH BEHAR-KOLKATA,347,All
2024,6,COOCH BEHAR,KOLKATA,209,213,COOCH BEHAR-KOLKATA,422,All
2024,7,COOCH BEHAR,KOLKATA,169,169,COOCH BEHAR-KOLKATA,338,All
2024,8,COOCH BEHAR,KOLKATA,201,168,COOCH BEHAR-KOLKATA,369,All
2024,9,COOCH BEHAR,KOLKATA,212,200,COOCH BEHAR-KOLKATA,412,All
2024,10,COOCH BEHAR,KOLKATA,184,184,COOCH BEHAR-KOLKATA,368,All
2024,11,COOCH BEHAR,KOLKATA,253,243,COOCH BEHAR-KOLKATA,496,All
2024,12,COOCH BEHAR,KOLKATA,263,263,COOCH BEHAR-KOLKATA,526,All
2025,1,COOCH BEHAR,KOLKATA,260,261,COOCH BEHAR-KOLKATA,521,All
2025,2,COOCH BEHAR,KOLKATA,229,232,COOCH BEHAR-KOLKATA,461,All
2025,3,COOCH BEHAR,KOLKATA,261,267,COOCH BEHAR-KOLKATA,528,All
2016,6,CUDDAPAH,CHENNAI,174,164,CHENNAI-CUDDAPAH,338,All
2016,7,CUDDAPAH,CHENNAI,139,93,CHENNAI-CUDDAPAH,232,All
2017,11,CUDDAPAH,CHENNAI,658,620,CHENNAI-CUDDAPAH,1278,All
2017,12,CUDDAPAH,CHENNAI,1266,1317,CHENNAI-CUDDAPAH,2583,All
2018,1,CUDDAPAH,CHENNAI,1557,1108,CHENNAI-CUDDAPAH,2665,All
2018,2,CUDDAPAH,CHENNAI,1394,1318,CHENNAI-CUDDAPAH,2712,All
2018,3,CUDDAPAH,CHENNAI,1443,1446,CHENNAI-CUDDAPAH,2889,All
2018,4,CUDDAPAH,CHENNAI,1597,1500,CHENNAI-CUDDAPAH,3097,All
2018,5,CUDDAPAH,CHENNAI,1644,1342,CHENNAI-CUDDAPAH,2986,All
2018,6,CUDDAPAH,CHENNAI,1505,1308,CHENNAI-CUDDAPAH,2813,All
2018,7,CUDDAPAH,CHENNAI,1312,1135,CHENNAI-CUDDAPAH,2447,All
2018,8,CUDDAPAH,CHENNAI,1438,1206,CHENNAI-CUDDAPAH,2644,All
2018,9,CUDDAPAH,CHENNAI,1311,1148,CHENNAI-CUDDAPAH,2459,All
2018,10,CUDDAPAH,CHENNAI,1779,1481,CHENNAI-CUDDAPAH,3260,All
2018,11,CUDDAPAH,CHENNAI,1476,1259,CHENNAI-CUDDAPAH,2735,All
2018,12,CUDDAPAH,CHENNAI,1531,1509,CHENNAI-CUDDAPAH,3040,All
2016,4,CUDDAPAH,HYDERABAD,0,873,CUDDAPAH-HYDERABAD,873,All
2016,5,CUDDAPAH,HYDERABAD,23,679,CUDDAPAH-HYDERABAD,702,All
2016,6,CUDDAPAH,HYDERABAD,0,352,CUDDAPAH-HYDERABAD,352,All
2016,7,CUDDAPAH,HYDERABAD,0,304,CUDDAPAH-HYDERABAD,304,All
2016,8,CUDDAPAH,HYDERABAD,0,54,CUDDAPAH-HYDERABAD,54,All
2016,9,CUDDAPAH,HYDERABAD,0,107,CUDDAPAH-HYDERABAD,107,All
2017,4,CUDDAPAH,HYDERABAD,220,158,CUDDAPAH-HYDERABAD,378,All
2017,5,CUDDAPAH,HYDERABAD,1408,1446,CUDDAPAH-HYDERABAD,2854,All
2017,6,CUDDAPAH,HYDERABAD,1204,1276,CUDDAPAH-HYDERABAD,2480,All
2017,7,CUDDAPAH,HYDERABAD,1410,1401,CUDDAPAH-HYDERABAD,2811,All
2017,8,CUDDAPAH,HYDERABAD,1617,1600,CUDDAPAH-HYDERABAD,3217,All
2017,9,CUDDAPAH,HYDERABAD,1255,1320,CUDDAPAH-HYDERABAD,2575,All
2017,10,CUDDAPAH,HYDERABAD,1194,1162,CUDDAPAH-HYDERABAD,2356,All
2017,11,CUDDAPAH,HYDERABAD,1220,1170,CUDDAPAH-HYDERABAD,2390,All
2017,12,CUDDAPAH,HYDERABAD,1586,1495,CUDDAPAH-HYDERABAD,3081,All
2018,1,CUDDAPAH,HYDERABAD,1734,1723,CUDDAPAH-HYDERABAD,3457,All
2018,2,CUDDAPAH,HYDERABAD,1594,1580,CUDDAPAH-HYDERABAD,3174,All
2018,3,CUDDAPAH,HYDERABAD,1750,1712,CUDDAPAH-HYDERABAD,3462,All
2018,4,CUDDAPAH,HYDERABAD,1914,1886,CUDDAPAH-HYDERABAD,3800,All
2018,5,CUDDAPAH,HYDERABAD,1866,1979,CUDDAPAH-HYDERABAD,3845,All
2018,6,CUDDAPAH,HYDERABAD,1746,1806,CUDDAPAH-HYDERABAD,3552,All
2018,7,CUDDAPAH,HYDERABAD,1725,1705,CUDDAPAH-HYDERABAD,3430,All
2018,8,CUDDAPAH,HYDERABAD,1812,1778,CUDDAPAH-HYDERABAD,3590,All
2018,9,CUDDAPAH,HYDERABAD,1692,1711,CUDDAPAH-HYDERABAD,3403,All
2018,10,CUDDAPAH,HYDERABAD,1848,1833,CUDDAPAH-HYDERABAD,3681,All
2018,11,CUDDAPAH,HYDERABAD,1579,1654,CUDDAPAH-HYDERABAD,3233,All
2018,12,CUDDAPAH,HYDERABAD,1748,1898,CUDDAPAH-HYDERABAD,3646,All
2016,4,CUDDAPAH,TIRUPATI,802,0,CUDDAPAH-TIRUPATI,802,All
2016,5,CUDDAPAH,TIRUPATI,679,0,CUDDAPAH-TIRUPATI,679,All
2016,6,CUDDAPAH,TIRUPATI,348,0,CUDDAPAH-TIRUPATI,348,All
2016,7,CUDDAPAH,TIRUPATI,312,0,CUDDAPAH-TIRUPATI,312,All
2016,8,CUDDAPAH,TIRUPATI,54,0,CUDDAPAH-TIRUPATI,54,All
2016,9,CUDDAPAH,TIRUPATI,96,0,CUDDAPAH-TIRUPATI,96,All
2016,5,CUDDAPAH,VIJAYAWADA,375,397,CUDDAPAH-VIJAYAWADA,772,All
2016,6,CUDDAPAH,VIJAYAWADA,252,211,CUDDAPAH-VIJAYAWADA,463,All
2016,7,CUDDAPAH,VIJAYAWADA,142,165,CUDDAPAH-VIJAYAWADA,307,All
2016,8,CUDDAPAH,VIJAYAWADA,166,173,CUDDAPAH-VIJAYAWADA,339,All
2016,9,CUDDAPAH,VIJAYAWADA,75,66,CUDDAPAH-VIJAYAWADA,141,All
2016,10,CUDDAPAH,VIJAYAWADA,141,100,CUDDAPAH-VIJAYAWADA,241,All
2016,11,CUDDAPAH,VIJAYAWADA,143,132,CUDDAPAH-VIJAYAWADA,275,All
2016,12,CUDDAPAH,VIJAYAWADA,52,23,CUDDAPAH-VIJAYAWADA,75,All
2018,3,CUDDAPAH,VIJAYAWADA,1501,1463,CUDDAPAH-VIJAYAWADA,2964,All
2018,4,CUDDAPAH,VIJAYAWADA,1697,1563,CUDDAPAH-VIJAYAWADA,3260,All
2018,5,CUDDAPAH,VIJAYAWADA,1711,1580,CUDDAPAH-VIJAYAWADA,3291,All
2018,6,CUDDAPAH,VIJAYAWADA,1744,1627,CUDDAPAH-VIJAYAWADA,3371,All
2018,7,CUDDAPAH,VIJAYAWADA,1714,1506,CUDDAPAH-VIJAYAWADA,3220,All
2018,8,CUDDAPAH,VIJAYAWADA,1615,1579,CUDDAPAH-VIJAYAWADA,3194,All
2018,9,CUDDAPAH,VIJAYAWADA,1595,1501,CUDDAPAH-VIJAYAWADA,3096,All
2018,10,CUDDAPAH,VIJAYAWADA,1724,1696,CUDDAPAH-VIJAYAWADA,3420,All
2018,11,CUDDAPAH,VIJAYAWADA,1635,1612,CUDDAPAH-VIJAYAWADA,3247,All
2018,12,CUDDAPAH,VIJAYAWADA,1658,1698,CUDDAPAH-VIJAYAWADA,3356,All
2023,1,Cuddapah,VIJAYAWADA,276,304,Cuddapah-VIJAYAWADA,580,All
2023,6,Cuddapah,VIJAYAWADA,295,276,Cuddapah-VIJAYAWADA,571,All
2023,7,Cuddapah,VIJAYAWADA,275,318,Cuddapah-VIJAYAWADA,593,All
2023,8,Cuddapah,VIJAYAWADA,385,268,Cuddapah-VIJAYAWADA,653,All
2023,9,Cuddapah,VIJAYAWADA,287,315,Cuddapah-VIJAYAWADA,602,All
2023,10,Cuddapah,VIJAYAWADA,342,332,Cuddapah-VIJAYAWADA,674,All
2023,11,Cuddapah,VIJAYAWADA,310,282,Cuddapah-VIJAYAWADA,592,All
2023,12,Cuddapah,VIJAYAWADA,372,277,Cuddapah-VIJAYAWADA,649,All
2024,1,Cuddapah,VIJAYAWADA,463,319,Cuddapah-VIJAYAWADA,782,All
2024,2,Cuddapah,VIJAYAWADA,332,245,Cuddapah-VIJAYAWADA,577,All
2024,3,Cuddapah,VIJAYAWADA,267,256,Cuddapah-VIJAYAWADA,523,All
2024,4,Cuddapah,VIJAYAWADA,282,232,Cuddapah-VIJAYAWADA,514,All
2024,6,Cuddapah,VIJAYAWADA,459,304,Cuddapah-VIJAYAWADA,763,All
2024,7,Cuddapah,VIJAYAWADA,388,239,Cuddapah-VIJAYAWADA,627,All
2024,8,Cuddapah,VIJAYAWADA,398,204,Cuddapah-VIJAYAWADA,602,All
2024,9,Cuddapah,VIJAYAWADA,310,235,Cuddapah-VIJAYAWADA,545,All
2024,10,Cuddapah,VIJAYAWADA,522,431,Cuddapah-VIJAYAWADA,953,All
2024,11,Cuddapah,VIJAYAWADA,518,312,Cuddapah-VIJAYAWADA,830,All
2024,12,Cuddapah,VIJAYAWADA,424,238,Cuddapah-VIJAYAWADA,662,All
2025,1,Cuddapah,VIJAYAWADA,399,247,Cuddapah-VIJAYAWADA,646,All
2025,2,Cuddapah,VIJAYAWADA,502,218,Cuddapah-VIJAYAWADA,720,All
2025,3,Cuddapah,VIJAYAWADA,341,220,Cuddapah-VIJAYAWADA,561,All
2023,1,Cuddapah,VISAKHAPATNAM,434,515,Cuddapah-VISAKHAPATNAM,949,All
2023,6,Cuddapah,VISAKHAPATNAM,304,353,Cuddapah-VISAKHAPATNAM,657,All
2023,7,Cuddapah,VISAKHAPATNAM,311,305,Cuddapah-VISAKHAPATNAM,616,All
2023,8,Cuddapah,VISAKHAPATNAM,340,349,Cuddapah-VISAKHAPATNAM,689,All
2023,9,Cuddapah,VISAKHAPATNAM,228,288,Cuddapah-VISAKHAPATNAM,516,All
2023,10,Cuddapah,VISAKHAPATNAM,359,320,Cuddapah-VISAKHAPATNAM,679,All
2023,11,Cuddapah,VISAKHAPATNAM,323,328,Cuddapah-VISAKHAPATNAM,651,All
2023,12,Cuddapah,VISAKHAPATNAM,374,319,Cuddapah-VISAKHAPATNAM,693,All
2024,1,Cuddapah,VISAKHAPATNAM,439,426,Cuddapah-VISAKHAPATNAM,865,All
2024,2,Cuddapah,VISAKHAPATNAM,411,280,Cuddapah-VISAKHAPATNAM,691,All
2024,3,Cuddapah,VISAKHAPATNAM,324,334,Cuddapah-VISAKHAPATNAM,658,All
2024,4,Cuddapah,VISAKHAPATNAM,413,358,Cuddapah-VISAKHAPATNAM,771,All
2024,6,Cuddapah,VISAKHAPATNAM,425,299,Cuddapah-VISAKHAPATNAM,724,All
2024,7,Cuddapah,VISAKHAPATNAM,364,357,Cuddapah-VISAKHAPATNAM,721,All
2024,8,Cuddapah,VISAKHAPATNAM,455,361,Cuddapah-VISAKHAPATNAM,816,All
2024,9,Cuddapah,VISAKHAPATNAM,272,259,Cuddapah-VISAKHAPATNAM,531,All
2024,10,Cuddapah,VISAKHAPATNAM,298,338,Cuddapah-VISAKHAPATNAM,636,All
2019,1,DABOLIM,CHENNAI,14648,14310,CHENNAI-DABOLIM,28958,All
2019,2,DABOLIM,CHENNAI,11976,12431,CHENNAI-DABOLIM,24407,All
2019,3,DABOLIM,CHENNAI,13423,13570,CHENNAI-DABOLIM,26993,All
2019,4,DABOLIM,CHENNAI,12804,13413,CHENNAI-DABOLIM,26217,All
2022,11,DABOLIM,DARBHANGA,0,6,DABOLIM-DARBHANGA,6,All
2022,12,DABOLIM,DARBHANGA,0,9,DABOLIM-DARBHANGA,9,All
2023,1,DABOLIM,DARBHANGA,0,6,DABOLIM-DARBHANGA,6,All
2023,3,DABOLIM,DARBHANGA,0,11,DABOLIM-DARBHANGA,11,All
2019,5,DABOLIM,DELHI,76557,80269,DABOLIM-DELHI,156826,All
2019,6,DABOLIM,DELHI,79320,82699,DABOLIM-DELHI,162019,All
2019,7,DABOLIM,DELHI,72815,70342,DABOLIM-DELHI,143157,All
2019,8,DABOLIM,DELHI,71763,71898,DABOLIM-DELHI,143661,All
2019,9,DABOLIM,DELHI,73883,73528,DABOLIM-DELHI,147411,All
2019,10,DABOLIM,DELHI,77408,72495,DABOLIM-DELHI,149903,All
2019,11,DABOLIM,DELHI,82182,86752,DABOLIM-DELHI,168934,All
2019,12,DABOLIM,DELHI,86428,93156,DABOLIM-DELHI,179584,All
2020,1,DABOLIM,DELHI,92409,88412,DABOLIM-DELHI,180821,All
2020,2,DABOLIM,DELHI,86090,83999,DABOLIM-DELHI,170089,All
2020,3,DABOLIM,DELHI,58636,44399,DABOLIM-DELHI,103035,All
2020,5,DABOLIM,DELHI,979,415,DABOLIM-DELHI,1394,All
2020,6,DABOLIM,DELHI,4368,2861,DABOLIM-DELHI,7229,All
2020,7,DABOLIM,DELHI,4031,3769,DABOLIM-DELHI,7800,All
2020,8,DABOLIM,DELHI,4814,6109,DABOLIM-DELHI,10923,All
2020,9,DABOLIM,DELHI,8903,15125,DABOLIM-DELHI,24028,All
2020,10,DABOLIM,DELHI,18835,25590,DABOLIM-DELHI,44425,All
2020,11,DABOLIM,DELHI,32342,36685,DABOLIM-DELHI,69027,All
2020,12,DABOLIM,DELHI,53507,67400,DABOLIM-DELHI,120907,All
2021,1,DABOLIM,DELHI,79652,78966,DABOLIM-DELHI,158618,All
2021,2,DABOLIM,DELHI,76304,77641,DABOLIM-DELHI,153945,All
2021,3,DABOLIM,DELHI,85469,81633,DABOLIM-DELHI,167102,All
2021,4,DABOLIM,DELHI,48031,34347,DABOLIM-DELHI,82378,All
2021,6,DABOLIM,DELHI,6468,6810,DABOLIM-DELHI,13278,All
2021,7,DABOLIM,DELHI,15076,16313,DABOLIM-DELHI,31389,All
2021,8,DABOLIM,DELHI,33401,35143,DABOLIM-DELHI,68544,All
2021,9,DABOLIM,DELHI,49953,53978,DABOLIM-DELHI,103931,All
2021,10,DABOLIM,DELHI,72113,66298,DABOLIM-DELHI,138411,All
2021,11,DABOLIM,DELHI,84527,89084,DABOLIM-DELHI,173611,All
2021,12,DABOLIM,DELHI,100057,111583,DABOLIM-DELHI,211640,All
2022,1,DABOLIM,DELHI,64893,47999,DABOLIM-DELHI,112892,All
2022,2,DABOLIM,DELHI,71229,74837,DABOLIM-DELHI,146066,All
2022,3,DABOLIM,DELHI,116965,112701,DABOLIM-DELHI,229666,All
2022,4,DABOLIM,DELHI,81624,76285,DABOLIM-DELHI,157909,All
2022,5,DABOLIM,DELHI,66739,65253,DABOLIM-DELHI,131992,All
2022,6,DABOLIM,DELHI,78738,82704,DABOLIM-DELHI,161442,All
2022,7,DABOLIM,DELHI,63182,59650,DABOLIM-DELHI,122832,All
2022,8,DABOLIM,DELHI,72680,71818,DABOLIM-DELHI,144498,All
2022,9,DABOLIM,DELHI,77488,78227,DABOLIM-DELHI,155715,All
2022,10,DABOLIM,DELHI,82436,77754,DABOLIM-DELHI,160190,All
2022,11,DABOLIM,DELHI,89931,92812,DABOLIM-DELHI,182743,All
2022,12,DABOLIM,DELHI,101729,109000,DABOLIM-DELHI,210729,All
2023,1,DABOLIM,DELHI,99157,93972,DABOLIM-DELHI,193129,All
2023,2,DABOLIM,DELHI,85365,81947,DABOLIM-DELHI,167312,All
2023,3,DABOLIM,DELHI,85016,85357,DABOLIM-DELHI,170373,All
2023,4,DABOLIM,DELHI,81678,71704,DABOLIM-DELHI,153382,All
2023,5,DABOLIM,DELHI,72916,78455,DABOLIM-DELHI,151371,All
2023,6,DABOLIM,DELHI,73555,80244,DABOLIM-DELHI,153799,All
2023,7,DABOLIM,DELHI,63740,63557,DABOLIM-DELHI,127297,All
2023,8,DABOLIM,DELHI,68701,67048,DABOLIM-DELHI,135749,All
2023,9,DABOLIM,DELHI,69378,74445,DABOLIM-DELHI,143823,All
2023,10,DABOLIM,DELHI,77965,74100,DABOLIM-DELHI,152065,All
2023,11,DABOLIM,DELHI,71980,70685,DABOLIM-DELHI,142665,All
2023,12,DABOLIM,DELHI,70046,80312,DABOLIM-DELHI,150358,All
2024,1,DABOLIM,DELHI,78194,71861,DABOLIM-DELHI,150055,All
2024,2,DABOLIM,DELHI,71502,68760,DABOLIM-DELHI,140262,All
2024,3,DABOLIM,DELHI,75205,73985,DABOLIM-DELHI,149190,All
2024,4,DABOLIM,DELHI,72136,62419,DABOLIM-DELHI,134555,All
2024,6,DABOLIM,DELHI,69536,72377,DABOLIM-DELHI,141913,All
2024,7,DABOLIM,DELHI,58338,54894,DABOLIM-DELHI,113232,All
2024,8,DABOLIM,DELHI,62921,63125,DABOLIM-DELHI,126046,All
2024,9,DABOLIM,DELHI,68130,67121,DABOLIM-DELHI,135251,All
2024,10,DABOLIM,DELHI,67371,58418,DABOLIM-DELHI,125789,All
2024,11,DABOLIM,DELHI,60922,66993,DABOLIM-DELHI,127915,All
2024,12,DABOLIM,DELHI,65319,73085,DABOLIM-DELHI,138404,All
2025,1,DABOLIM,DELHI,73232,68809,DABOLIM-DELHI,142041,All
2025,2,DABOLIM,DELHI,64391,62218,DABOLIM-DELHI,126609,All
2025,3,DABOLIM,DELHI,63052,61658,DABOLIM-DELHI,124710,All
2021,10,DABOLIM,GORAKHPUR,131,77,DABOLIM-GORAKHPUR,208,All
2019,5,DABOLIM,GUWAHATI,477,913,DABOLIM-GUWAHATI,1390,All
2019,6,DABOLIM,GUWAHATI,484,373,DABOLIM-GUWAHATI,857,All
2019,7,DABOLIM,GUWAHATI,694,494,DABOLIM-GUWAHATI,1188,All
2019,8,DABOLIM,GUWAHATI,707,378,DABOLIM-GUWAHATI,1085,All
2019,9,DABOLIM,GUWAHATI,691,343,DABOLIM-GUWAHATI,1034,All
2019,10,DABOLIM,GUWAHATI,1001,863,DABOLIM-GUWAHATI,1864,All
2019,11,DABOLIM,GUWAHATI,694,593,DABOLIM-GUWAHATI,1287,All
2019,12,DABOLIM,GUWAHATI,1114,1024,DABOLIM-GUWAHATI,2138,All
2020,1,DABOLIM,GUWAHATI,1643,1033,DABOLIM-GUWAHATI,2676,All
2020,2,DABOLIM,GUWAHATI,1030,830,DABOLIM-GUWAHATI,1860,All
2020,3,DABOLIM,GUWAHATI,658,348,DABOLIM-GUWAHATI,1006,All
2021,3,DABOLIM,GUWAHATI,27,0,DABOLIM-GUWAHATI,27,All
2021,4,DABOLIM,GUWAHATI,185,0,DABOLIM-GUWAHATI,185,All
2021,8,DABOLIM,GUWAHATI,55,50,DABOLIM-GUWAHATI,105,All
2021,9,DABOLIM,GUWAHATI,493,412,DABOLIM-GUWAHATI,905,All
2021,10,DABOLIM,GUWAHATI,299,352,DABOLIM-GUWAHATI,651,All
2021,11,DABOLIM,GUWAHATI,36,119,DABOLIM-GUWAHATI,155,All
2022,3,DABOLIM,GUWAHATI,27,0,DABOLIM-GUWAHATI,27,All
2022,4,DABOLIM,GUWAHATI,850,1,DABOLIM-GUWAHATI,851,All
2022,5,DABOLIM,GUWAHATI,827,3,DABOLIM-GUWAHATI,830,All
2022,6,DABOLIM,GUWAHATI,589,0,DABOLIM-GUWAHATI,589,All
2022,7,DABOLIM,GUWAHATI,1174,0,DABOLIM-GUWAHATI,1174,All
2022,8,DABOLIM,GUWAHATI,487,0,DABOLIM-GUWAHATI,487,All
2022,9,DABOLIM,GUWAHATI,273,0,DABOLIM-GUWAHATI,273,All
2022,10,DABOLIM,GUWAHATI,511,0,DABOLIM-GUWAHATI,511,All
2024,2,DABOLIM,Goa,123,0,DABOLIM-Goa,123,All
2025,3,DABOLIM,HINDON AIRPORT,3671,4118,DABOLIM-HINDON AIRPORT,7789,All
2019,1,DABOLIM,HUBLI,1518,1659,DABOLIM-HUBLI,3177,All
2019,2,DABOLIM,HUBLI,1550,1659,DABOLIM-HUBLI,3209,All
2019,3,DABOLIM,HUBLI,1707,1766,DABOLIM-HUBLI,3473,All
2019,4,DABOLIM,HUBLI,1746,1832,DABOLIM-HUBLI,3578,All
2019,5,DABOLIM,HUBLI,2068,2169,DABOLIM-HUBLI,4237,All
2019,6,DABOLIM,HUBLI,1806,1611,DABOLIM-HUBLI,3417,All
2019,7,DABOLIM,HUBLI,2045,1899,DABOLIM-HUBLI,3944,All
2019,8,DABOLIM,HUBLI,1891,1837,DABOLIM-HUBLI,3728,All
2019,9,DABOLIM,HUBLI,1610,1577,DABOLIM-HUBLI,3187,All
2019,10,DABOLIM,HUBLI,1725,1709,DABOLIM-HUBLI,3434,All
2019,11,DABOLIM,HUBLI,1535,1672,DABOLIM-HUBLI,3207,All
2019,12,DABOLIM,HUBLI,1483,1727,DABOLIM-HUBLI,3210,All
2020,1,DABOLIM,HUBLI,1599,1672,DABOLIM-HUBLI,3271,All
2020,2,DABOLIM,HUBLI,1297,1773,DABOLIM-HUBLI,3070,All
2020,3,DABOLIM,HUBLI,834,1156,DABOLIM-HUBLI,1990,All
2020,6,DABOLIM,HUBLI,16,2,DABOLIM-HUBLI,18,All
2020,10,DABOLIM,HUBLI,78,0,DABOLIM-HUBLI,78,All
2021,1,DABOLIM,HUBLI,371,564,DABOLIM-HUBLI,935,All
2021,2,DABOLIM,HUBLI,903,1410,DABOLIM-HUBLI,2313,All
2021,3,DABOLIM,HUBLI,917,1221,DABOLIM-HUBLI,2138,All
2021,4,DABOLIM,HUBLI,623,729,DABOLIM-HUBLI,1352,All
2021,6,DABOLIM,HUBLI,53,248,DABOLIM-HUBLI,301,All
2021,7,DABOLIM,HUBLI,410,679,DABOLIM-HUBLI,1089,All
2021,8,DABOLIM,HUBLI,706,704,DABOLIM-HUBLI,1410,All
2021,9,DABOLIM,HUBLI,482,573,DABOLIM-HUBLI,1055,All
2019,1,DABOLIM,HYDERABAD,36935,37323,DABOLIM-HYDERABAD,74258,All
2019,2,DABOLIM,HYDERABAD,34971,36324,DABOLIM-HYDERABAD,71295,All
2019,3,DABOLIM,HYDERABAD,36423,37273,DABOLIM-HYDERABAD,73696,All
2019,4,DABOLIM,HYDERABAD,33688,34070,DABOLIM-HYDERABAD,67758,All
2019,5,DABOLIM,HYDERABAD,37590,37961,DABOLIM-HYDERABAD,75551,All
2019,6,DABOLIM,HYDERABAD,35152,35186,DABOLIM-HYDERABAD,70338,All
2019,7,DABOLIM,HYDERABAD,38155,38715,DABOLIM-HYDERABAD,76870,All
2019,8,DABOLIM,HYDERABAD,35523,36465,DABOLIM-HYDERABAD,71988,All
2019,9,DABOLIM,HYDERABAD,31124,33346,DABOLIM-HYDERABAD,64470,All
2019,10,DABOLIM,HYDERABAD,34542,34176,DABOLIM-HYDERABAD,68718,All
2019,11,DABOLIM,HYDERABAD,36961,38690,DABOLIM-HYDERABAD,75651,All
2019,12,DABOLIM,HYDERABAD,38361,38987,DABOLIM-HYDERABAD,77348,All
2020,1,DABOLIM,HYDERABAD,41065,39204,DABOLIM-HYDERABAD,80269,All
2020,2,DABOLIM,HYDERABAD,37368,36975,DABOLIM-HYDERABAD,74343,All
2020,3,DABOLIM,HYDERABAD,22452,18562,DABOLIM-HYDERABAD,41014,All
2020,6,DABOLIM,HYDERABAD,1975,989,DABOLIM-HYDERABAD,2964,All
2020,7,DABOLIM,HYDERABAD,1849,977,DABOLIM-HYDERABAD,2826,All
2020,8,DABOLIM,HYDERABAD,2072,1588,DABOLIM-HYDERABAD,3660,All
2020,9,DABOLIM,HYDERABAD,4742,5341,DABOLIM-HYDERABAD,10083,All
2020,10,DABOLIM,HYDERABAD,11841,11960,DABOLIM-HYDERABAD,23801,All
2020,11,DABOLIM,HYDERABAD,19289,20684,DABOLIM-HYDERABAD,39973,All
2020,12,DABOLIM,HYDERABAD,33015,38676,DABOLIM-HYDERABAD,71691,All
2021,1,DABOLIM,HYDERABAD,38906,37536,DABOLIM-HYDERABAD,76442,All
2021,2,DABOLIM,HYDERABAD,36649,36656,DABOLIM-HYDERABAD,73305,All
2021,3,DABOLIM,HYDERABAD,37263,36019,DABOLIM-HYDERABAD,73282,All
2021,4,DABOLIM,HYDERABAD,26514,20261,DABOLIM-HYDERABAD,46775,All
2021,6,DABOLIM,HYDERABAD,2357,2238,DABOLIM-HYDERABAD,4595,All
2021,7,DABOLIM,HYDERABAD,7910,8058,DABOLIM-HYDERABAD,15968,All
2021,8,DABOLIM,HYDERABAD,19127,17921,DABOLIM-HYDERABAD,37048,All
2021,9,DABOLIM,HYDERABAD,25501,26398,DABOLIM-HYDERABAD,51899,All
2021,10,DABOLIM,HYDERABAD,44938,42950,DABOLIM-HYDERABAD,87888,All
2021,11,DABOLIM,HYDERABAD,41545,41077,DABOLIM-HYDERABAD,82622,All
2021,12,DABOLIM,HYDERABAD,44691,46336,DABOLIM-HYDERABAD,91027,All
2022,1,DABOLIM,HYDERABAD,30634,21976,DABOLIM-HYDERABAD,52610,All
2022,2,DABOLIM,HYDERABAD,29608,30966,DABOLIM-HYDERABAD,60574,All
2022,3,DABOLIM,HYDERABAD,48561,45168,DABOLIM-HYDERABAD,93729,All
2022,4,DABOLIM,HYDERABAD,43533,41557,DABOLIM-HYDERABAD,85090,All
2022,5,DABOLIM,HYDERABAD,47290,42553,DABOLIM-HYDERABAD,89843,All
2022,6,DABOLIM,HYDERABAD,38073,35196,DABOLIM-HYDERABAD,73269,All
2022,7,DABOLIM,HYDERABAD,32631,30417,DABOLIM-HYDERABAD,63048,All
2022,8,DABOLIM,HYDERABAD,30776,30371,DABOLIM-HYDERABAD,61147,All
2022,9,DABOLIM,HYDERABAD,34133,36580,DABOLIM-HYDERABAD,70713,All
2022,10,DABOLIM,HYDERABAD,40620,39206,DABOLIM-HYDERABAD,79826,All
2022,11,DABOLIM,HYDERABAD,35307,35638,DABOLIM-HYDERABAD,70945,All
2022,12,DABOLIM,HYDERABAD,43647,44615,DABOLIM-HYDERABAD,88262,All
2023,1,DABOLIM,HYDERABAD,41781,40120,DABOLIM-HYDERABAD,81901,All
2023,2,DABOLIM,HYDERABAD,33004,31591,DABOLIM-HYDERABAD,64595,All
2023,3,DABOLIM,HYDERABAD,35139,33790,DABOLIM-HYDERABAD,68929,All
2023,4,DABOLIM,HYDERABAD,36233,36252,DABOLIM-HYDERABAD,72485,All
2023,5,DABOLIM,HYDERABAD,38308,36836,DABOLIM-HYDERABAD,75144,All
2023,6,DABOLIM,HYDERABAD,34835,33914,DABOLIM-HYDERABAD,68749,All
2023,7,DABOLIM,HYDERABAD,32856,31663,DABOLIM-HYDERABAD,64519,All
2023,8,DABOLIM,HYDERABAD,37293,37615,DABOLIM-HYDERABAD,74908,All
2023,9,DABOLIM,HYDERABAD,29571,30588,DABOLIM-HYDERABAD,60159,All
2023,10,DABOLIM,HYDERABAD,39675,37256,DABOLIM-HYDERABAD,76931,All
2023,11,DABOLIM,HYDERABAD,31944,30885,DABOLIM-HYDERABAD,62829,All
2023,12,DABOLIM,HYDERABAD,37660,38093,DABOLIM-HYDERABAD,75753,All
2024,1,DABOLIM,HYDERABAD,38830,37993,DABOLIM-HYDERABAD,76823,All
2024,2,DABOLIM,HYDERABAD,37314,35303,DABOLIM-HYDERABAD,72617,All
2024,3,DABOLIM,HYDERABAD,39447,38133,DABOLIM-HYDERABAD,77580,All
2024,4,DABOLIM,HYDERABAD,32929,31903,DABOLIM-HYDERABAD,64832,All
2024,6,DABOLIM,HYDERABAD,38840,37890,DABOLIM-HYDERABAD,76730,All
2024,7,DABOLIM,HYDERABAD,38673,36894,DABOLIM-HYDERABAD,75567,All
2024,8,DABOLIM,HYDERABAD,36275,37211,DABOLIM-HYDERABAD,73486,All
2024,9,DABOLIM,HYDERABAD,38163,38136,DABOLIM-HYDERABAD,76299,All
2024,10,DABOLIM,HYDERABAD,42882,40732,DABOLIM-HYDERABAD,83614,All
2024,11,DABOLIM,HYDERABAD,38553,40060,DABOLIM-HYDERABAD,78613,All
2024,12,DABOLIM,HYDERABAD,42325,42442,DABOLIM-HYDERABAD,84767,All
2025,1,DABOLIM,HYDERABAD,36631,33596,DABOLIM-HYDERABAD,70227,All
2025,2,DABOLIM,HYDERABAD,34877,32699,DABOLIM-HYDERABAD,67576,All
2025,3,DABOLIM,HYDERABAD,35651,33062,DABOLIM-HYDERABAD,68713,All
2019,1,DABOLIM,IMPHAL,0,4,DABOLIM-IMPHAL,4,All
2019,2,DABOLIM,IMPHAL,0,3,DABOLIM-IMPHAL,3,All
2019,1,DABOLIM,INDORE,9069,8684,DABOLIM-INDORE,17753,All
2019,2,DABOLIM,INDORE,6506,6625,DABOLIM-INDORE,13131,All
2019,3,DABOLIM,INDORE,8772,8419,DABOLIM-INDORE,17191,All
2019,4,DABOLIM,INDORE,7161,6857,DABOLIM-INDORE,14018,All
2019,5,DABOLIM,INDORE,7764,8156,DABOLIM-INDORE,15920,All
2019,6,DABOLIM,INDORE,8148,8336,DABOLIM-INDORE,16484,All
2019,7,DABOLIM,INDORE,6985,7011,DABOLIM-INDORE,13996,All
2019,8,DABOLIM,INDORE,7212,7227,DABOLIM-INDORE,14439,All
2019,9,DABOLIM,INDORE,7153,6958,DABOLIM-INDORE,14111,All
2019,10,DABOLIM,INDORE,7431,6693,DABOLIM-INDORE,14124,All
2019,11,DABOLIM,INDORE,7735,8504,DABOLIM-INDORE,16239,All
2019,12,DABOLIM,INDORE,7301,8145,DABOLIM-INDORE,15446,All
2020,1,DABOLIM,INDORE,8716,8778,DABOLIM-INDORE,17494,All
2020,2,DABOLIM,INDORE,8153,8116,DABOLIM-INDORE,16269,All
2020,3,DABOLIM,INDORE,5518,4257,DABOLIM-INDORE,9775,All
2020,11,DABOLIM,INDORE,1832,2036,DABOLIM-INDORE,3868,All
2020,12,DABOLIM,INDORE,3758,3691,DABOLIM-INDORE,7449,All
2021,1,DABOLIM,INDORE,4502,4626,DABOLIM-INDORE,9128,All
2021,2,DABOLIM,INDORE,4226,4113,DABOLIM-INDORE,8339,All
2021,3,DABOLIM,INDORE,4353,3876,DABOLIM-INDORE,8229,All
2021,4,DABOLIM,INDORE,1883,1501,DABOLIM-INDORE,3384,All
2021,8,DABOLIM,INDORE,2566,2430,DABOLIM-INDORE,4996,All
2021,9,DABOLIM,INDORE,3026,2962,DABOLIM-INDORE,5988,All
2021,10,DABOLIM,INDORE,2993,2600,DABOLIM-INDORE,5593,All
2021,11,DABOLIM,INDORE,3414,3625,DABOLIM-INDORE,7039,All
2021,12,DABOLIM,INDORE,3570,3750,DABOLIM-INDORE,7320,All
2022,1,DABOLIM,INDORE,2927,2590,DABOLIM-INDORE,5517,All
2022,2,DABOLIM,INDORE,3240,3607,DABOLIM-INDORE,6847,All
2022,3,DABOLIM,INDORE,3527,3597,DABOLIM-INDORE,7124,All
2022,4,DABOLIM,INDORE,3727,3729,DABOLIM-INDORE,7456,All
2022,5,DABOLIM,INDORE,3804,3894,DABOLIM-INDORE,7698,All
2022,6,DABOLIM,INDORE,3876,3707,DABOLIM-INDORE,7583,All
2022,7,DABOLIM,INDORE,3482,3348,DABOLIM-INDORE,6830,All
2022,8,DABOLIM,INDORE,3341,3259,DABOLIM-INDORE,6600,All
2022,9,DABOLIM,INDORE,3405,3373,DABOLIM-INDORE,6778,All
2022,10,DABOLIM,INDORE,3418,3259,DABOLIM-INDORE,6677,All
2022,11,DABOLIM,INDORE,3086,3340,DABOLIM-INDORE,6426,All
2022,12,DABOLIM,INDORE,2939,3183,DABOLIM-INDORE,6122,All
2023,1,DABOLIM,INDORE,3728,3756,DABOLIM-INDORE,7484,All
2023,2,DABOLIM,INDORE,3694,3854,DABOLIM-INDORE,7548,All
2023,3,DABOLIM,INDORE,4021,3717,DABOLIM-INDORE,7738,All
2023,4,DABOLIM,INDORE,4463,4416,DABOLIM-INDORE,8879,All
2023,5,DABOLIM,INDORE,4126,4302,DABOLIM-INDORE,8428,All
2023,6,DABOLIM,INDORE,3845,3961,DABOLIM-INDORE,7806,All
2023,7,DABOLIM,INDORE,4019,3860,DABOLIM-INDORE,7879,All
2023,8,DABOLIM,INDORE,4225,4165,DABOLIM-INDORE,8390,All
2023,9,DABOLIM,INDORE,3492,3765,DABOLIM-INDORE,7257,All
2023,10,DABOLIM,INDORE,4049,3926,DABOLIM-INDORE,7975,All
2023,11,DABOLIM,INDORE,4282,4076,DABOLIM-INDORE,8358,All
2023,12,DABOLIM,INDORE,4027,4226,DABOLIM-INDORE,8253,All
2024,1,DABOLIM,INDORE,3766,4066,DABOLIM-INDORE,7832,All
2024,2,DABOLIM,INDORE,3866,3914,DABOLIM-INDORE,7780,All
2024,3,DABOLIM,INDORE,4205,4481,DABOLIM-INDORE,8686,All
2024,4,DABOLIM,INDORE,4410,4500,DABOLIM-INDORE,8910,All
2024,6,DABOLIM,INDORE,4857,4707,DABOLIM-INDORE,9564,All
2024,7,DABOLIM,INDORE,4519,4298,DABOLIM-INDORE,8817,All
2024,8,DABOLIM,INDORE,4456,4349,DABOLIM-INDORE,8805,All
2024,9,DABOLIM,INDORE,4217,4344,DABOLIM-INDORE,8561,All
2024,10,DABOLIM,INDORE,3427,3128,DABOLIM-INDORE,6555,All
2024,11,DABOLIM,INDORE,2977,3640,DABOLIM-INDORE,6617,All
2024,12,DABOLIM,INDORE,2629,3583,DABOLIM-INDORE,6212,All
2025,1,DABOLIM,INDORE,3307,4211,DABOLIM-INDORE,7518,All
2025,2,DABOLIM,INDORE,3967,4193,DABOLIM-INDORE,8160,All
2025,3,DABOLIM,INDORE,4332,4626,DABOLIM-INDORE,8958,All
2019,1,DABOLIM,JAIPUR,1280,1094,DABOLIM-JAIPUR,2374,All
2019,2,DABOLIM,JAIPUR,1060,1043,DABOLIM-JAIPUR,2103,All
2019,3,DABOLIM,JAIPUR,1490,705,DABOLIM-JAIPUR,2195,All
2019,4,DABOLIM,JAIPUR,946,336,DABOLIM-JAIPUR,1282,All
2019,5,DABOLIM,JAIPUR,488,160,DABOLIM-JAIPUR,648,All
2019,6,DABOLIM,JAIPUR,661,333,DABOLIM-JAIPUR,994,All
2019,7,DABOLIM,JAIPUR,580,162,DABOLIM-JAIPUR,742,All
2019,8,DABOLIM,JAIPUR,711,307,DABOLIM-JAIPUR,1018,All
2019,9,DABOLIM,JAIPUR,581,229,DABOLIM-JAIPUR,810,All
2019,10,DABOLIM,JAIPUR,993,890,DABOLIM-JAIPUR,1883,All
2019,11,DABOLIM,JAIPUR,989,466,DABOLIM-JAIPUR,1455,All
2019,12,DABOLIM,JAIPUR,1224,690,DABOLIM-JAIPUR,1914,All
2020,1,DABOLIM,JAIPUR,736,460,DABOLIM-JAIPUR,1196,All
2020,2,DABOLIM,JAIPUR,801,292,DABOLIM-JAIPUR,1093,All
2020,3,DABOLIM,JAIPUR,484,227,DABOLIM-JAIPUR,711,All
2020,11,DABOLIM,JAIPUR,0,480,DABOLIM-JAIPUR,480,All
2020,12,DABOLIM,JAIPUR,1187,3893,DABOLIM-JAIPUR,5080,All
2021,1,DABOLIM,JAIPUR,2949,3698,DABOLIM-JAIPUR,6647,All
2021,2,DABOLIM,JAIPUR,3313,3629,DABOLIM-JAIPUR,6942,All
2021,3,DABOLIM,JAIPUR,3497,3231,DABOLIM-JAIPUR,6728,All
2021,4,DABOLIM,JAIPUR,1374,1029,DABOLIM-JAIPUR,2403,All
2021,10,DABOLIM,JAIPUR,42,981,DABOLIM-JAIPUR,1023,All
2021,11,DABOLIM,JAIPUR,3960,3787,DABOLIM-JAIPUR,7747,All
2021,12,DABOLIM,JAIPUR,5735,5922,DABOLIM-JAIPUR,11657,All
2022,1,DABOLIM,JAIPUR,3827,2733,DABOLIM-JAIPUR,6560,All
2022,2,DABOLIM,JAIPUR,1279,1405,DABOLIM-JAIPUR,2684,All
2022,3,DABOLIM,JAIPUR,6504,6064,DABOLIM-JAIPUR,12568,All
2022,4,DABOLIM,JAIPUR,4911,4491,DABOLIM-JAIPUR,9402,All
2022,5,DABOLIM,JAIPUR,3354,3251,DABOLIM-JAIPUR,6605,All
2022,6,DABOLIM,JAIPUR,4087,4089,DABOLIM-JAIPUR,8176,All
2022,7,DABOLIM,JAIPUR,1516,1564,DABOLIM-JAIPUR,3080,All
2022,8,DABOLIM,JAIPUR,1883,2077,DABOLIM-JAIPUR,3960,All
2022,9,DABOLIM,JAIPUR,1421,1838,DABOLIM-JAIPUR,3259,All
2022,10,DABOLIM,JAIPUR,5394,4981,DABOLIM-JAIPUR,10375,All
2022,11,DABOLIM,JAIPUR,5210,5387,DABOLIM-JAIPUR,10597,All
2022,12,DABOLIM,JAIPUR,5425,5686,DABOLIM-JAIPUR,11111,All
2023,1,DABOLIM,JAIPUR,4608,3903,DABOLIM-JAIPUR,8511,All
2023,2,DABOLIM,JAIPUR,2050,2063,DABOLIM-JAIPUR,4113,All
2023,12,DABOLIM,JAIPUR,218,0,DABOLIM-JAIPUR,218,All
2024,8,DABOLIM,JAIPUR,5,0,DABOLIM-JAIPUR,5,All
2024,11,DABOLIM,JAIPUR,1969,2518,DABOLIM-JAIPUR,4487,All
2024,12,DABOLIM,JAIPUR,4337,4690,DABOLIM-JAIPUR,9027,All
2025,1,DABOLIM,JAIPUR,5400,4728,DABOLIM-JAIPUR,10128,All
2025,2,DABOLIM,JAIPUR,4896,4455,DABOLIM-JAIPUR,9351,All
2025,3,DABOLIM,JAIPUR,4287,3864,DABOLIM-JAIPUR,8151,All
2019,5,DABOLIM,KANNUR,2129,2004,DABOLIM-KANNUR,4133,All
2019,6,DABOLIM,KANNUR,1054,1095,DABOLIM-KANNUR,2149,All
2019,7,DABOLIM,KANNUR,1402,1325,DABOLIM-KANNUR,2727,All
2019,8,DABOLIM,KANNUR,1606,1803,DABOLIM-KANNUR,3409,All
2019,9,DABOLIM,KANNUR,1563,1714,DABOLIM-KANNUR,3277,All
2019,10,DABOLIM,KANNUR,1274,1353,DABOLIM-KANNUR,2627,All
2019,11,DABOLIM,KANNUR,1173,1434,DABOLIM-KANNUR,2607,All
2019,12,DABOLIM,KANNUR,1617,1700,DABOLIM-KANNUR,3317,All
2020,1,DABOLIM,KANNUR,1398,1636,DABOLIM-KANNUR,3034,All
2020,2,DABOLIM,KANNUR,976,1320,DABOLIM-KANNUR,2296,All
2020,3,DABOLIM,KANNUR,846,654,DABOLIM-KANNUR,1500,All
2020,6,DABOLIM,KANNUR,99,26,DABOLIM-KANNUR,125,All
2020,7,DABOLIM,KANNUR,295,40,DABOLIM-KANNUR,335,All
2020,8,DABOLIM,KANNUR,227,52,DABOLIM-KANNUR,279,All
2020,9,DABOLIM,KANNUR,133,222,DABOLIM-KANNUR,355,All
2020,10,DABOLIM,KANNUR,171,193,DABOLIM-KANNUR,364,All
2020,11,DABOLIM,KANNUR,180,219,DABOLIM-KANNUR,399,All
2020,12,DABOLIM,KANNUR,339,507,DABOLIM-KANNUR,846,All
2021,1,DABOLIM,KANNUR,491,465,DABOLIM-KANNUR,956,All
2021,2,DABOLIM,KANNUR,596,599,DABOLIM-KANNUR,1195,All
2021,3,DABOLIM,KANNUR,494,582,DABOLIM-KANNUR,1076,All
2021,4,DABOLIM,KANNUR,569,570,DABOLIM-KANNUR,1139,All
2021,6,DABOLIM,KANNUR,77,341,DABOLIM-KANNUR,418,All
2021,7,DABOLIM,KANNUR,235,502,DABOLIM-KANNUR,737,All
2021,8,DABOLIM,KANNUR,677,739,DABOLIM-KANNUR,1416,All
2021,9,DABOLIM,KANNUR,408,633,DABOLIM-KANNUR,1041,All
2021,10,DABOLIM,KANNUR,883,916,DABOLIM-KANNUR,1799,All
2021,11,DABOLIM,KANNUR,758,1066,DABOLIM-KANNUR,1824,All
2021,12,DABOLIM,KANNUR,1584,2067,DABOLIM-KANNUR,3651,All
2022,1,DABOLIM,KANNUR,755,867,DABOLIM-KANNUR,1622,All
2022,2,DABOLIM,KANNUR,396,522,DABOLIM-KANNUR,918,All
2022,3,DABOLIM,KANNUR,1010,1504,DABOLIM-KANNUR,2514,All
2022,4,DABOLIM,KANNUR,707,809,DABOLIM-KANNUR,1516,All
2019,5,DABOLIM,KOCHI,5482,4303,DABOLIM-KOCHI,9785,All
2019,6,DABOLIM,KOCHI,3065,3580,DABOLIM-KOCHI,6645,All
2019,7,DABOLIM,KOCHI,1006,388,DABOLIM-KOCHI,1394,All
2019,8,DABOLIM,KOCHI,3491,3164,DABOLIM-KOCHI,6655,All
2019,9,DABOLIM,KOCHI,2779,2126,DABOLIM-KOCHI,4905,All
2019,10,DABOLIM,KOCHI,3454,2572,DABOLIM-KOCHI,6026,All
2019,11,DABOLIM,KOCHI,4227,4791,DABOLIM-KOCHI,9018,All
2019,12,DABOLIM,KOCHI,5313,4939,DABOLIM-KOCHI,10252,All
2020,1,DABOLIM,KOCHI,5133,4989,DABOLIM-KOCHI,10122,All
2020,2,DABOLIM,KOCHI,3032,2764,DABOLIM-KOCHI,5796,All
2020,3,DABOLIM,KOCHI,232,0,DABOLIM-KOCHI,232,All
2020,6,DABOLIM,KOCHI,0,11,DABOLIM-KOCHI,11,All
2020,8,DABOLIM,KOCHI,0,84,DABOLIM-KOCHI,84,All
2020,10,DABOLIM,KOCHI,31,0,DABOLIM-KOCHI,31,All
2021,3,DABOLIM,KOCHI,34,0,DABOLIM-KOCHI,34,All
2021,4,DABOLIM,KOCHI,358,0,DABOLIM-KOCHI,358,All
2021,6,DABOLIM,KOCHI,4,15,DABOLIM-KOCHI,19,All
2021,11,DABOLIM,KOCHI,1322,1345,DABOLIM-KOCHI,2667,All
2021,12,DABOLIM,KOCHI,4272,4848,DABOLIM-KOCHI,9120,All
2022,1,DABOLIM,KOCHI,1637,1896,DABOLIM-KOCHI,3533,All
2022,2,DABOLIM,KOCHI,0,89,DABOLIM-KOCHI,89,All
2022,3,DABOLIM,KOCHI,2678,2731,DABOLIM-KOCHI,5409,All
2023,11,DABOLIM,KOCHI,4313,3818,DABOLIM-KOCHI,8131,All
2023,12,DABOLIM,KOCHI,4767,3998,DABOLIM-KOCHI,8765,All
2024,1,DABOLIM,KOCHI,4918,4531,DABOLIM-KOCHI,9449,All
2024,2,DABOLIM,KOCHI,4300,3968,DABOLIM-KOCHI,8268,All
2024,3,DABOLIM,KOCHI,3906,3547,DABOLIM-KOCHI,7453,All
2024,4,DABOLIM,KOCHI,4275,3889,DABOLIM-KOCHI,8164,All
2024,6,DABOLIM,KOCHI,3713,2917,DABOLIM-KOCHI,6630,All
2024,7,DABOLIM,KOCHI,4162,3418,DABOLIM-KOCHI,7580,All
2024,8,DABOLIM,KOCHI,3905,3962,DABOLIM-KOCHI,7867,All
2024,9,DABOLIM,KOCHI,4165,4180,DABOLIM-KOCHI,8345,All
2024,10,DABOLIM,KOCHI,4196,3952,DABOLIM-KOCHI,8148,All
2024,11,DABOLIM,KOCHI,4775,5015,DABOLIM-KOCHI,9790,All
2024,12,DABOLIM,KOCHI,4996,4926,DABOLIM-KOCHI,9922,All
2025,1,DABOLIM,KOCHI,4998,4936,DABOLIM-KOCHI,9934,All
2025,2,DABOLIM,KOCHI,4458,4426,DABOLIM-KOCHI,8884,All
2025,3,DABOLIM,KOCHI,4085,3952,DABOLIM-KOCHI,8037,All
2019,5,DABOLIM,KOLKATA,4973,4767,DABOLIM-KOLKATA,9740,All
2019,6,DABOLIM,KOLKATA,5109,4050,DABOLIM-KOLKATA,9159,All
2019,7,DABOLIM,KOLKATA,5013,4547,DABOLIM-KOLKATA,9560,All
2019,8,DABOLIM,KOLKATA,5129,4503,DABOLIM-KOLKATA,9632,All
2019,9,DABOLIM,KOLKATA,5450,4354,DABOLIM-KOLKATA,9804,All
2019,10,DABOLIM,KOLKATA,5587,4253,DABOLIM-KOLKATA,9840,All
2019,11,DABOLIM,KOLKATA,5151,5323,DABOLIM-KOLKATA,10474,All
2019,12,DABOLIM,KOLKATA,5719,5208,DABOLIM-KOLKATA,10927,All
2020,1,DABOLIM,KOLKATA,6074,5022,DABOLIM-KOLKATA,11096,All
2020,2,DABOLIM,KOLKATA,5702,5015,DABOLIM-KOLKATA,10717,All
2020,3,DABOLIM,KOLKATA,4235,2608,DABOLIM-KOLKATA,6843,All
2020,11,DABOLIM,KOLKATA,1819,3158,DABOLIM-KOLKATA,4977,All
2020,12,DABOLIM,KOLKATA,5587,7638,DABOLIM-KOLKATA,13225,All
2021,1,DABOLIM,KOLKATA,8966,8439,DABOLIM-KOLKATA,17405,All
2021,2,DABOLIM,KOLKATA,8568,8792,DABOLIM-KOLKATA,17360,All
2021,3,DABOLIM,KOLKATA,9249,7469,DABOLIM-KOLKATA,16718,All
2021,4,DABOLIM,KOLKATA,8494,3689,DABOLIM-KOLKATA,12183,All
2021,6,DABOLIM,KOLKATA,151,228,DABOLIM-KOLKATA,379,All
2021,7,DABOLIM,KOLKATA,1546,1474,DABOLIM-KOLKATA,3020,All
2021,8,DABOLIM,KOLKATA,2335,2086,DABOLIM-KOLKATA,4421,All
2021,9,DABOLIM,KOLKATA,4582,4648,DABOLIM-KOLKATA,9230,All
2021,10,DABOLIM,KOLKATA,8248,7056,DABOLIM-KOLKATA,15304,All
2021,11,DABOLIM,KOLKATA,8411,8329,DABOLIM-KOLKATA,16740,All
2021,12,DABOLIM,KOLKATA,10096,9873,DABOLIM-KOLKATA,19969,All
2022,1,DABOLIM,KOLKATA,5591,3294,DABOLIM-KOLKATA,8885,All
2022,2,DABOLIM,KOLKATA,5346,5812,DABOLIM-KOLKATA,11158,All
2022,3,DABOLIM,KOLKATA,10769,10299,DABOLIM-KOLKATA,21068,All
2022,4,DABOLIM,KOLKATA,8807,7352,DABOLIM-KOLKATA,16159,All
2022,5,DABOLIM,KOLKATA,8161,7428,DABOLIM-KOLKATA,15589,All
2022,6,DABOLIM,KOLKATA,5057,4957,DABOLIM-KOLKATA,10014,All
2022,7,DABOLIM,KOLKATA,5770,6282,DABOLIM-KOLKATA,12052,All
2022,8,DABOLIM,KOLKATA,5549,6281,DABOLIM-KOLKATA,11830,All
2022,9,DABOLIM,KOLKATA,5978,6111,DABOLIM-KOLKATA,12089,All
2022,10,DABOLIM,KOLKATA,9893,7568,DABOLIM-KOLKATA,17461,All
2022,11,DABOLIM,KOLKATA,4495,4607,DABOLIM-KOLKATA,9102,All
2022,12,DABOLIM,KOLKATA,8116,8826,DABOLIM-KOLKATA,16942,All
2023,1,DABOLIM,KOLKATA,9464,8529,DABOLIM-KOLKATA,17993,All
2023,2,DABOLIM,KOLKATA,7187,6496,DABOLIM-KOLKATA,13683,All
2023,3,DABOLIM,KOLKATA,5409,5282,DABOLIM-KOLKATA,10691,All
2023,4,DABOLIM,KOLKATA,4980,4603,DABOLIM-KOLKATA,9583,All
2023,5,DABOLIM,KOLKATA,4848,4977,DABOLIM-KOLKATA,9825,All
2023,6,DABOLIM,KOLKATA,4177,4057,DABOLIM-KOLKATA,8234,All
2023,7,DABOLIM,KOLKATA,4518,4758,DABOLIM-KOLKATA,9276,All
2023,8,DABOLIM,KOLKATA,4858,4763,DABOLIM-KOLKATA,9621,All
2023,9,DABOLIM,KOLKATA,4633,4537,DABOLIM-KOLKATA,9170,All
2023,10,DABOLIM,KOLKATA,5047,4383,DABOLIM-KOLKATA,9430,All
2023,11,DABOLIM,KOLKATA,5542,5235,DABOLIM-KOLKATA,10777,All
2023,12,DABOLIM,KOLKATA,5941,6522,DABOLIM-KOLKATA,12463,All
2024,1,DABOLIM,KOLKATA,6261,5802,DABOLIM-KOLKATA,12063,All
2024,2,DABOLIM,KOLKATA,5819,5437,DABOLIM-KOLKATA,11256,All
2024,3,DABOLIM,KOLKATA,6151,5826,DABOLIM-KOLKATA,11977,All
2024,4,DABOLIM,KOLKATA,4876,4509,DABOLIM-KOLKATA,9385,All
2024,6,DABOLIM,KOLKATA,4785,4730,DABOLIM-KOLKATA,9515,All
2024,7,DABOLIM,KOLKATA,4065,5090,DABOLIM-KOLKATA,9155,All
2024,8,DABOLIM,KOLKATA,4330,4725,DABOLIM-KOLKATA,9055,All
2024,9,DABOLIM,KOLKATA,5465,5540,DABOLIM-KOLKATA,11005,All
2024,10,DABOLIM,KOLKATA,6256,5134,DABOLIM-KOLKATA,11390,All
2024,11,DABOLIM,KOLKATA,4099,4954,DABOLIM-KOLKATA,9053,All
2024,12,DABOLIM,KOLKATA,5174,5026,DABOLIM-KOLKATA,10200,All
2025,1,DABOLIM,KOLKATA,6040,5537,DABOLIM-KOLKATA,11577,All
2025,2,DABOLIM,KOLKATA,4665,4452,DABOLIM-KOLKATA,9117,All
2025,3,DABOLIM,KOLKATA,5479,4609,DABOLIM-KOLKATA,10088,All
2019,1,DABOLIM,LUCKNOW,5412,4691,DABOLIM-LUCKNOW,10103,All
2019,2,DABOLIM,LUCKNOW,4942,4515,DABOLIM-LUCKNOW,9457,All
2019,3,DABOLIM,LUCKNOW,5254,4695,DABOLIM-LUCKNOW,9949,All
2019,4,DABOLIM,LUCKNOW,4822,3246,DABOLIM-LUCKNOW,8068,All
2019,5,DABOLIM,LUCKNOW,4662,3951,DABOLIM-LUCKNOW,8613,All
2019,6,DABOLIM,LUCKNOW,4762,4767,DABOLIM-LUCKNOW,9529,All
2019,7,DABOLIM,LUCKNOW,4315,4309,DABOLIM-LUCKNOW,8624,All
2019,8,DABOLIM,LUCKNOW,4792,4690,DABOLIM-LUCKNOW,9482,All
2019,9,DABOLIM,LUCKNOW,4993,4917,DABOLIM-LUCKNOW,9910,All
2019,10,DABOLIM,LUCKNOW,4991,4060,DABOLIM-LUCKNOW,9051,All
2019,11,DABOLIM,LUCKNOW,4604,5146,DABOLIM-LUCKNOW,9750,All
2019,12,DABOLIM,LUCKNOW,5183,5415,DABOLIM-LUCKNOW,10598,All
2020,1,DABOLIM,LUCKNOW,5498,5293,DABOLIM-LUCKNOW,10791,All
2020,2,DABOLIM,LUCKNOW,4811,4757,DABOLIM-LUCKNOW,9568,All
2020,3,DABOLIM,LUCKNOW,3708,2717,DABOLIM-LUCKNOW,6425,All
2020,10,DABOLIM,LUCKNOW,302,488,DABOLIM-LUCKNOW,790,All
2020,11,DABOLIM,LUCKNOW,2440,2272,DABOLIM-LUCKNOW,4712,All
2020,12,DABOLIM,LUCKNOW,3458,4064,DABOLIM-LUCKNOW,7522,All
2021,1,DABOLIM,LUCKNOW,4638,4610,DABOLIM-LUCKNOW,9248,All
2021,2,DABOLIM,LUCKNOW,3423,3844,DABOLIM-LUCKNOW,7267,All
2021,3,DABOLIM,LUCKNOW,4061,4008,DABOLIM-LUCKNOW,8069,All
2021,4,DABOLIM,LUCKNOW,1803,1408,DABOLIM-LUCKNOW,3211,All
2021,6,DABOLIM,LUCKNOW,0,532,DABOLIM-LUCKNOW,532,All
2021,7,DABOLIM,LUCKNOW,71,864,DABOLIM-LUCKNOW,935,All
2021,8,DABOLIM,LUCKNOW,408,507,DABOLIM-LUCKNOW,915,All
2021,9,DABOLIM,LUCKNOW,2029,1969,DABOLIM-LUCKNOW,3998,All
2021,10,DABOLIM,LUCKNOW,3476,2934,DABOLIM-LUCKNOW,6410,All
2021,11,DABOLIM,LUCKNOW,3927,4257,DABOLIM-LUCKNOW,8184,All
2021,12,DABOLIM,LUCKNOW,5030,5453,DABOLIM-LUCKNOW,10483,All
2022,1,DABOLIM,LUCKNOW,2832,1953,DABOLIM-LUCKNOW,4785,All
2022,2,DABOLIM,LUCKNOW,1691,1767,DABOLIM-LUCKNOW,3458,All
2022,3,DABOLIM,LUCKNOW,5532,5295,DABOLIM-LUCKNOW,10827,All
2022,4,DABOLIM,LUCKNOW,4055,4045,DABOLIM-LUCKNOW,8100,All
2022,5,DABOLIM,LUCKNOW,4009,4001,DABOLIM-LUCKNOW,8010,All
2022,6,DABOLIM,LUCKNOW,4381,4442,DABOLIM-LUCKNOW,8823,All
2022,7,DABOLIM,LUCKNOW,3824,4001,DABOLIM-LUCKNOW,7825,All
2022,8,DABOLIM,LUCKNOW,6768,7199,DABOLIM-LUCKNOW,13967,All
2022,9,DABOLIM,LUCKNOW,7145,7392,DABOLIM-LUCKNOW,14537,All
2022,10,DABOLIM,LUCKNOW,7604,6279,DABOLIM-LUCKNOW,13883,All
2022,11,DABOLIM,LUCKNOW,8398,9940,DABOLIM-LUCKNOW,18338,All
2022,12,DABOLIM,LUCKNOW,8691,10191,DABOLIM-LUCKNOW,18882,All
2023,1,DABOLIM,LUCKNOW,10014,9099,DABOLIM-LUCKNOW,19113,All
2023,2,DABOLIM,LUCKNOW,8779,8178,DABOLIM-LUCKNOW,16957,All
2023,3,DABOLIM,LUCKNOW,9154,9239,DABOLIM-LUCKNOW,18393,All
2023,4,DABOLIM,LUCKNOW,9632,8765,DABOLIM-LUCKNOW,18397,All
2023,5,DABOLIM,LUCKNOW,7158,6847,DABOLIM-LUCKNOW,14005,All
2023,6,DABOLIM,LUCKNOW,5171,5283,DABOLIM-LUCKNOW,10454,All
2023,7,DABOLIM,LUCKNOW,4241,4670,DABOLIM-LUCKNOW,8911,All
2023,8,DABOLIM,LUCKNOW,4231,4079,DABOLIM-LUCKNOW,8310,All
2023,9,DABOLIM,LUCKNOW,4542,4692,DABOLIM-LUCKNOW,9234,All
2023,10,DABOLIM,LUCKNOW,4984,4443,DABOLIM-LUCKNOW,9427,All
2023,11,DABOLIM,LUCKNOW,5027,4007,DABOLIM-LUCKNOW,9034,All
2023,12,DABOLIM,LUCKNOW,5010,5427,DABOLIM-LUCKNOW,10437,All
2024,1,DABOLIM,LUCKNOW,5319,5294,DABOLIM-LUCKNOW,10613,All
2024,2,DABOLIM,LUCKNOW,4950,4814,DABOLIM-LUCKNOW,9764,All
2024,3,DABOLIM,LUCKNOW,5092,4882,DABOLIM-LUCKNOW,9974,All
2024,4,DABOLIM,LUCKNOW,5161,4653,DABOLIM-LUCKNOW,9814,All
2024,6,DABOLIM,LUCKNOW,4846,5021,DABOLIM-LUCKNOW,9867,All
2024,7,DABOLIM,LUCKNOW,4603,4763,DABOLIM-LUCKNOW,9366,All
2024,8,DABOLIM,LUCKNOW,4883,5180,DABOLIM-LUCKNOW,10063,All
2024,9,DABOLIM,LUCKNOW,4845,4787,DABOLIM-LUCKNOW,9632,All
2024,10,DABOLIM,LUCKNOW,4741,3106,DABOLIM-LUCKNOW,7847,All
2024,11,DABOLIM,LUCKNOW,4967,5101,DABOLIM-LUCKNOW,10068,All
2024,12,DABOLIM,LUCKNOW,5078,5356,DABOLIM-LUCKNOW,10434,All
2025,1,DABOLIM,LUCKNOW,5265,4737,DABOLIM-LUCKNOW,10002,All
2025,2,DABOLIM,LUCKNOW,4781,4565,DABOLIM-LUCKNOW,9346,All
2025,3,DABOLIM,LUCKNOW,4581,120,DABOLIM-LUCKNOW,4701,All
2020,10,DABOLIM,MANGALORE,1,3,DABOLIM-MANGALORE,4,All
2021,10,DABOLIM,MANGALORE,19,0,DABOLIM-MANGALORE,19,All
2019,5,DABOLIM,MUMBAI,89273,93112,DABOLIM-MUMBAI,182385,All
2019,6,DABOLIM,MUMBAI,92044,88467,DABOLIM-MUMBAI,180511,All
2019,7,DABOLIM,MUMBAI,90253,90329,DABOLIM-MUMBAI,180582,All
2019,8,DABOLIM,MUMBAI,97287,98968,DABOLIM-MUMBAI,196255,All
2019,9,DABOLIM,MUMBAI,96488,95247,DABOLIM-MUMBAI,191735,All
2019,10,DABOLIM,MUMBAI,90748,96619,DABOLIM-MUMBAI,187367,All
2019,11,DABOLIM,MUMBAI,98062,97755,DABOLIM-MUMBAI,195817,All
2019,12,DABOLIM,MUMBAI,97145,101799,DABOLIM-MUMBAI,198944,All
2020,1,DABOLIM,MUMBAI,105508,103483,DABOLIM-MUMBAI,208991,All
2020,2,DABOLIM,MUMBAI,97669,96207,DABOLIM-MUMBAI,193876,All
2020,3,DABOLIM,MUMBAI,62406,49946,DABOLIM-MUMBAI,112352,All
2020,6,DABOLIM,MUMBAI,436,159,DABOLIM-MUMBAI,595,All
2020,7,DABOLIM,MUMBAI,2453,2159,DABOLIM-MUMBAI,4612,All
2020,8,DABOLIM,MUMBAI,4979,4686,DABOLIM-MUMBAI,9665,All
2020,9,DABOLIM,MUMBAI,11727,12176,DABOLIM-MUMBAI,23903,All
2020,10,DABOLIM,MUMBAI,24910,28458,DABOLIM-MUMBAI,53368,All
2020,11,DABOLIM,MUMBAI,44408,45473,DABOLIM-MUMBAI,89881,All
2020,12,DABOLIM,MUMBAI,44067,52729,DABOLIM-MUMBAI,96796,All
2021,1,DABOLIM,MUMBAI,77721,71816,DABOLIM-MUMBAI,149537,All
2021,2,DABOLIM,MUMBAI,77748,78815,DABOLIM-MUMBAI,156563,All
2021,3,DABOLIM,MUMBAI,75335,69853,DABOLIM-MUMBAI,145188,All
2021,4,DABOLIM,MUMBAI,38418,32908,DABOLIM-MUMBAI,71326,All
2021,6,DABOLIM,MUMBAI,14336,11404,DABOLIM-MUMBAI,25740,All
2021,7,DABOLIM,MUMBAI,26607,27358,DABOLIM-MUMBAI,53965,All
2021,8,DABOLIM,MUMBAI,49415,46722,DABOLIM-MUMBAI,96137,All
2021,9,DABOLIM,MUMBAI,64732,64043,DABOLIM-MUMBAI,128775,All
2021,10,DABOLIM,MUMBAI,86614,83870,DABOLIM-MUMBAI,170484,All
2021,11,DABOLIM,MUMBAI,96339,91860,DABOLIM-MUMBAI,188199,All
2021,12,DABOLIM,MUMBAI,102636,110080,DABOLIM-MUMBAI,212716,All
2022,1,DABOLIM,MUMBAI,71625,53460,DABOLIM-MUMBAI,125085,All
2022,2,DABOLIM,MUMBAI,78496,78874,DABOLIM-MUMBAI,157370,All
2022,3,DABOLIM,MUMBAI,106672,97879,DABOLIM-MUMBAI,204551,All
2022,4,DABOLIM,MUMBAI,82407,81244,DABOLIM-MUMBAI,163651,All
2022,5,DABOLIM,MUMBAI,98508,96112,DABOLIM-MUMBAI,194620,All
2022,6,DABOLIM,MUMBAI,79950,70518,DABOLIM-MUMBAI,150468,All
2022,7,DABOLIM,MUMBAI,64602,61777,DABOLIM-MUMBAI,126379,All
2022,8,DABOLIM,MUMBAI,77291,76709,DABOLIM-MUMBAI,154000,All
2022,9,DABOLIM,MUMBAI,85713,82016,DABOLIM-MUMBAI,167729,All
2022,10,DABOLIM,MUMBAI,82665,82640,DABOLIM-MUMBAI,165305,All
2022,11,DABOLIM,MUMBAI,110029,107898,DABOLIM-MUMBAI,217927,All
2022,12,DABOLIM,MUMBAI,114345,123964,DABOLIM-MUMBAI,238309,All
2023,11,DABOLIM,MUMBAI,60601,66057,DABOLIM-MUMBAI,126658,All
2023,12,DABOLIM,MUMBAI,61320,65648,DABOLIM-MUMBAI,126968,All
2024,1,DABOLIM,MUMBAI,66761,64087,DABOLIM-MUMBAI,130848,All
2024,2,DABOLIM,MUMBAI,58620,58275,DABOLIM-MUMBAI,116895,All
2024,3,DABOLIM,MUMBAI,60143,59813,DABOLIM-MUMBAI,119956,All
2024,4,DABOLIM,MUMBAI,56271,57709,DABOLIM-MUMBAI,113980,All
2024,6,DABOLIM,MUMBAI,60327,56762,DABOLIM-MUMBAI,117089,All
2024,7,DABOLIM,MUMBAI,54588,53998,DABOLIM-MUMBAI,108586,All
2024,8,DABOLIM,MUMBAI,57385,58116,DABOLIM-MUMBAI,115501,All
2024,9,DABOLIM,MUMBAI,65403,66020,DABOLIM-MUMBAI,131423,All
2024,10,DABOLIM,MUMBAI,62674,64567,DABOLIM-MUMBAI,127241,All
2024,11,DABOLIM,MUMBAI,64898,65566,DABOLIM-MUMBAI,130464,All
2024,12,DABOLIM,MUMBAI,62554,65228,DABOLIM-MUMBAI,127782,All
2025,1,DABOLIM,MUMBAI,70044,69814,DABOLIM-MUMBAI,139858,All
2025,2,DABOLIM,MUMBAI,65213,65688,DABOLIM-MUMBAI,130901,All
2025,3,DABOLIM,MUMBAI,66163,64000,DABOLIM-MUMBAI,130163,All
2019,7,DABOLIM,MYSORE,505,593,DABOLIM-MYSORE,1098,All
2019,8,DABOLIM,MYSORE,1244,1267,DABOLIM-MYSORE,2511,All
2019,9,DABOLIM,MYSORE,1287,1529,DABOLIM-MYSORE,2816,All
2019,10,DABOLIM,MYSORE,1582,1597,DABOLIM-MYSORE,3179,All
2019,11,DABOLIM,MYSORE,1363,1522,DABOLIM-MYSORE,2885,All
2019,12,DABOLIM,MYSORE,1524,1579,DABOLIM-MYSORE,3103,All
2020,1,DABOLIM,MYSORE,1493,1537,DABOLIM-MYSORE,3030,All
2020,2,DABOLIM,MYSORE,1320,1320,DABOLIM-MYSORE,2640,All
2020,3,DABOLIM,MYSORE,646,681,DABOLIM-MYSORE,1327,All
2020,5,DABOLIM,MYSORE,10,20,DABOLIM-MYSORE,30,All
2020,6,DABOLIM,MYSORE,52,96,DABOLIM-MYSORE,148,All
2020,7,DABOLIM,MYSORE,55,99,DABOLIM-MYSORE,154,All
2020,8,DABOLIM,MYSORE,71,141,DABOLIM-MYSORE,212,All
2020,9,DABOLIM,MYSORE,234,278,DABOLIM-MYSORE,512,All
2020,10,DABOLIM,MYSORE,395,472,DABOLIM-MYSORE,867,All
2020,11,DABOLIM,MYSORE,748,878,DABOLIM-MYSORE,1626,All
2020,12,DABOLIM,MYSORE,1127,1178,DABOLIM-MYSORE,2305,All
2021,1,DABOLIM,MYSORE,1109,1074,DABOLIM-MYSORE,2183,All
2021,2,DABOLIM,MYSORE,781,775,DABOLIM-MYSORE,1556,All
2021,3,DABOLIM,MYSORE,1255,1273,DABOLIM-MYSORE,2528,All
2021,4,DABOLIM,MYSORE,756,695,DABOLIM-MYSORE,1451,All
2021,6,DABOLIM,MYSORE,64,43,DABOLIM-MYSORE,107,All
2021,7,DABOLIM,MYSORE,186,194,DABOLIM-MYSORE,380,All
2021,8,DABOLIM,MYSORE,361,368,DABOLIM-MYSORE,729,All
2021,9,DABOLIM,MYSORE,526,541,DABOLIM-MYSORE,1067,All
2021,10,DABOLIM,MYSORE,722,739,DABOLIM-MYSORE,1461,All
2021,11,DABOLIM,MYSORE,1071,1116,DABOLIM-MYSORE,2187,All
2021,12,DABOLIM,MYSORE,1241,1272,DABOLIM-MYSORE,2513,All
2022,1,DABOLIM,MYSORE,612,605,DABOLIM-MYSORE,1217,All
2022,2,DABOLIM,MYSORE,827,862,DABOLIM-MYSORE,1689,All
2022,3,DABOLIM,MYSORE,1117,1169,DABOLIM-MYSORE,2286,All
2022,4,DABOLIM,MYSORE,1071,1116,DABOLIM-MYSORE,2187,All
2022,5,DABOLIM,MYSORE,1241,1272,DABOLIM-MYSORE,2513,All
2022,6,DABOLIM,MYSORE,1071,1116,DABOLIM-MYSORE,2187,All
2022,7,DABOLIM,MYSORE,827,862,DABOLIM-MYSORE,1689,All
2022,8,DABOLIM,MYSORE,1241,1272,DABOLIM-MYSORE,2513,All
2022,9,DABOLIM,MYSORE,1071,1116,DABOLIM-MYSORE,2187,All
2022,10,DABOLIM,MYSORE,1074,1293,DABOLIM-MYSORE,2367,All
2022,11,DABOLIM,MYSORE,961,1083,DABOLIM-MYSORE,2044,All
2022,12,DABOLIM,MYSORE,1152,1231,DABOLIM-MYSORE,2383,All
2023,1,DABOLIM,MYSORE,1260,1217,DABOLIM-MYSORE,2477,All
2023,2,DABOLIM,MYSORE,842,903,DABOLIM-MYSORE,1745,All
2023,3,DABOLIM,MYSORE,770,830,DABOLIM-MYSORE,1600,All
2023,4,DABOLIM,MYSORE,620,731,DABOLIM-MYSORE,1351,All
2023,5,DABOLIM,MYSORE,1272,1131,DABOLIM-MYSORE,2403,All
2023,6,DABOLIM,MYSORE,1046,880,DABOLIM-MYSORE,1926,All
2023,7,DABOLIM,MYSORE,1328,607,DABOLIM-MYSORE,1935,All
2023,8,DABOLIM,MYSORE,1092,705,DABOLIM-MYSORE,1797,All
2020,2,DABOLIM,NAGPUR,4151,4135,DABOLIM-NAGPUR,8286,All
2020,3,DABOLIM,NAGPUR,2940,2107,DABOLIM-NAGPUR,5047,All
2020,12,DABOLIM,NAGPUR,1129,2004,DABOLIM-NAGPUR,3133,All
2021,1,DABOLIM,NAGPUR,3570,3288,DABOLIM-NAGPUR,6858,All
2021,2,DABOLIM,NAGPUR,4118,3938,DABOLIM-NAGPUR,8056,All
2021,3,DABOLIM,NAGPUR,2970,2664,DABOLIM-NAGPUR,5634,All
2021,4,DABOLIM,NAGPUR,1077,732,DABOLIM-NAGPUR,1809,All
2021,8,DABOLIM,NAGPUR,137,81,DABOLIM-NAGPUR,218,All
2021,9,DABOLIM,NAGPUR,0,68,DABOLIM-NAGPUR,68,All
2021,10,DABOLIM,NAGPUR,1780,1497,DABOLIM-NAGPUR,3277,All
2021,11,DABOLIM,NAGPUR,3912,4394,DABOLIM-NAGPUR,8306,All
2021,12,DABOLIM,NAGPUR,3666,4536,DABOLIM-NAGPUR,8202,All
2022,1,DABOLIM,NAGPUR,2202,1421,DABOLIM-NAGPUR,3623,All
2022,3,DABOLIM,NAGPUR,2787,2493,DABOLIM-NAGPUR,5280,All
2022,4,DABOLIM,NAGPUR,2882,2960,DABOLIM-NAGPUR,5842,All
2022,5,DABOLIM,NAGPUR,2565,2717,DABOLIM-NAGPUR,5282,All
2022,6,DABOLIM,NAGPUR,3188,2968,DABOLIM-NAGPUR,6156,All
2022,7,DABOLIM,NAGPUR,2786,2660,DABOLIM-NAGPUR,5446,All
2022,8,DABOLIM,NAGPUR,169,0,DABOLIM-NAGPUR,169,All
2022,10,DABOLIM,NAGPUR,4532,4245,DABOLIM-NAGPUR,8777,All
2022,11,DABOLIM,NAGPUR,4467,4613,DABOLIM-NAGPUR,9080,All
2022,12,DABOLIM,NAGPUR,3944,4022,DABOLIM-NAGPUR,7966,All
2023,1,DABOLIM,NAGPUR,3594,2853,DABOLIM-NAGPUR,6447,All
2023,2,DABOLIM,NAGPUR,5003,4392,DABOLIM-NAGPUR,9395,All
2023,3,DABOLIM,NAGPUR,4403,3981,DABOLIM-NAGPUR,8384,All
2024,10,DABOLIM,NAGPUR,102,50,DABOLIM-NAGPUR,152,All
2024,11,DABOLIM,NAGPUR,1815,2001,DABOLIM-NAGPUR,3816,All
2024,12,DABOLIM,NAGPUR,5954,6213,DABOLIM-NAGPUR,12167,All
2025,1,DABOLIM,NAGPUR,5406,5292,DABOLIM-NAGPUR,10698,All
2025,2,DABOLIM,NAGPUR,4672,4871,DABOLIM-NAGPUR,9543,All
2025,3,DABOLIM,NAGPUR,5372,5169,DABOLIM-NAGPUR,10541,All
2024,10,DABOLIM,NASIK,144,143,DABOLIM-NASIK,287,All
2024,11,DABOLIM,NASIK,659,770,DABOLIM-NASIK,1429,All
2024,12,DABOLIM,NASIK,854,862,DABOLIM-NASIK,1716,All
2025,1,DABOLIM,NASIK,791,858,DABOLIM-NASIK,1649,All
2025,2,DABOLIM,NASIK,826,870,DABOLIM-NASIK,1696,All
2025,3,DABOLIM,NASIK,913,788,DABOLIM-NASIK,1701,All
2019,1,DABOLIM,PATNA,859,397,DABOLIM-PATNA,1256,All
2019,2,DABOLIM,PATNA,700,444,DABOLIM-PATNA,1144,All
2019,3,DABOLIM,PATNA,473,703,DABOLIM-PATNA,1176,All
2019,4,DABOLIM,PATNA,523,898,DABOLIM-PATNA,1421,All
2019,5,DABOLIM,PATNA,525,484,DABOLIM-PATNA,1009,All
2019,6,DABOLIM,PATNA,0,746,DABOLIM-PATNA,746,All
2019,7,DABOLIM,PATNA,0,307,DABOLIM-PATNA,307,All
2019,8,DABOLIM,PATNA,0,469,DABOLIM-PATNA,469,All
2019,9,DABOLIM,PATNA,0,502,DABOLIM-PATNA,502,All
2019,10,DABOLIM,PATNA,0,485,DABOLIM-PATNA,485,All
2019,11,DABOLIM,PATNA,0,468,DABOLIM-PATNA,468,All
2019,12,DABOLIM,PATNA,0,582,DABOLIM-PATNA,582,All
2020,1,DABOLIM,PATNA,0,468,DABOLIM-PATNA,468,All
2020,2,DABOLIM,PATNA,0,296,DABOLIM-PATNA,296,All
2020,3,DABOLIM,PATNA,0,162,DABOLIM-PATNA,162,All
2021,3,DABOLIM,PATNA,0,1,DABOLIM-PATNA,1,All
2021,4,DABOLIM,PATNA,0,76,DABOLIM-PATNA,76,All
2021,10,DABOLIM,PATNA,29,0,DABOLIM-PATNA,29,All
2019,4,DABOLIM,PORT BLAIR,0,28,DABOLIM-PORT BLAIR,28,All
2019,5,DABOLIM,PORT BLAIR,0,81,DABOLIM-PORT BLAIR,81,All
2019,6,DABOLIM,PORT BLAIR,0,74,DABOLIM-PORT BLAIR,74,All
2019,8,DABOLIM,PORT BLAIR,0,45,DABOLIM-PORT BLAIR,45,All
2019,9,DABOLIM,PORT BLAIR,0,62,DABOLIM-PORT BLAIR,62,All
2019,10,DABOLIM,PORT BLAIR,0,71,DABOLIM-PORT BLAIR,71,All
2019,1,DABOLIM,PUNE,10707,10551,DABOLIM-PUNE,21258,All
2019,2,DABOLIM,PUNE,11252,8476,DABOLIM-PUNE,19728,All
2019,3,DABOLIM,PUNE,10287,9867,DABOLIM-PUNE,20154,All
2019,4,DABOLIM,PUNE,10472,10458,DABOLIM-PUNE,20930,All
2019,5,DABOLIM,PUNE,11484,11495,DABOLIM-PUNE,22979,All
2019,6,DABOLIM,PUNE,10430,9409,DABOLIM-PUNE,19839,All
2019,7,DABOLIM,PUNE,10268,9784,DABOLIM-PUNE,20052,All
2019,8,DABOLIM,PUNE,10464,10516,DABOLIM-PUNE,20980,All
2019,9,DABOLIM,PUNE,10457,9821,DABOLIM-PUNE,20278,All
2019,10,DABOLIM,PUNE,9970,10044,DABOLIM-PUNE,20014,All
2019,11,DABOLIM,PUNE,10510,9749,DABOLIM-PUNE,20259,All
2019,12,DABOLIM,PUNE,10774,10487,DABOLIM-PUNE,21261,All
2020,1,DABOLIM,PUNE,11057,10229,DABOLIM-PUNE,21286,All
2020,2,DABOLIM,PUNE,8930,9402,DABOLIM-PUNE,18332,All
2020,3,DABOLIM,PUNE,5471,5044,DABOLIM-PUNE,10515,All
2020,8,DABOLIM,PUNE,240,239,DABOLIM-PUNE,479,All
2020,9,DABOLIM,PUNE,1023,1078,DABOLIM-PUNE,2101,All
2020,10,DABOLIM,PUNE,1568,1322,DABOLIM-PUNE,2890,All
2021,1,DABOLIM,PUNE,0,76,DABOLIM-PUNE,76,All
2021,2,DABOLIM,PUNE,175,0,DABOLIM-PUNE,175,All
2021,3,DABOLIM,PUNE,597,588,DABOLIM-PUNE,1185,All
2021,4,DABOLIM,PUNE,2220,2177,DABOLIM-PUNE,4397,All
2021,8,DABOLIM,PUNE,273,279,DABOLIM-PUNE,552,All
2021,9,DABOLIM,PUNE,5953,6242,DABOLIM-PUNE,12195,All
2021,10,DABOLIM,PUNE,3754,3738,DABOLIM-PUNE,7492,All
2021,11,DABOLIM,PUNE,10893,10566,DABOLIM-PUNE,21459,All
2021,12,DABOLIM,PUNE,9799,10083,DABOLIM-PUNE,19882,All
2022,1,DABOLIM,PUNE,7690,6376,DABOLIM-PUNE,14066,All
2022,2,DABOLIM,PUNE,6028,6006,DABOLIM-PUNE,12034,All
2022,3,DABOLIM,PUNE,12417,11333,DABOLIM-PUNE,23750,All
2022,4,DABOLIM,PUNE,8616,8309,DABOLIM-PUNE,16925,All
2022,5,DABOLIM,PUNE,9809,8960,DABOLIM-PUNE,18769,All
2022,6,DABOLIM,PUNE,8941,7835,DABOLIM-PUNE,16776,All
2022,7,DABOLIM,PUNE,7863,7573,DABOLIM-PUNE,15436,All
2022,8,DABOLIM,PUNE,8728,8071,DABOLIM-PUNE,16799,All
2022,9,DABOLIM,PUNE,8898,8518,DABOLIM-PUNE,17416,All
2022,10,DABOLIM,PUNE,10996,10984,DABOLIM-PUNE,21980,All
2022,11,DABOLIM,PUNE,9878,9291,DABOLIM-PUNE,19169,All
2022,12,DABOLIM,PUNE,10963,10421,DABOLIM-PUNE,21384,All
2023,1,DABOLIM,PUNE,6097,5506,DABOLIM-PUNE,11603,All
2023,2,DABOLIM,PUNE,4425,4389,DABOLIM-PUNE,8814,All
2023,3,DABOLIM,PUNE,4809,4730,DABOLIM-PUNE,9539,All
2023,4,DABOLIM,PUNE,4955,4912,DABOLIM-PUNE,9867,All
2023,5,DABOLIM,PUNE,5528,5391,DABOLIM-PUNE,10919,All
2023,6,DABOLIM,PUNE,5404,5346,DABOLIM-PUNE,10750,All
2023,7,DABOLIM,PUNE,4882,4763,DABOLIM-PUNE,9645,All
2023,8,DABOLIM,PUNE,5285,5449,DABOLIM-PUNE,10734,All
2023,9,DABOLIM,PUNE,4865,5093,DABOLIM-PUNE,9958,All
2023,10,DABOLIM,PUNE,6810,6521,DABOLIM-PUNE,13331,All
2023,11,DABOLIM,PUNE,57,50,DABOLIM-PUNE,107,All
2024,2,DABOLIM,PUNE,428,451,DABOLIM-PUNE,879,All
2024,3,DABOLIM,PUNE,3349,3463,DABOLIM-PUNE,6812,All
2024,6,DABOLIM,PUNE,4176,3811,DABOLIM-PUNE,7987,All
2024,7,DABOLIM,PUNE,4343,4411,DABOLIM-PUNE,8754,All
2024,8,DABOLIM,PUNE,4343,4459,DABOLIM-PUNE,8802,All
2024,9,DABOLIM,PUNE,4293,4417,DABOLIM-PUNE,8710,All
2024,10,DABOLIM,PUNE,3541,3454,DABOLIM-PUNE,6995,All
2024,11,DABOLIM,PUNE,1312,1323,DABOLIM-PUNE,2635,All
2024,12,DABOLIM,PUNE,10884,11220,DABOLIM-PUNE,22104,All
2025,1,DABOLIM,PUNE,11254,10264,DABOLIM-PUNE,21518,All
2025,2,DABOLIM,PUNE,7967,7912,DABOLIM-PUNE,15879,All
2025,3,DABOLIM,PUNE,5351,5062,DABOLIM-PUNE,10413,All
2019,1,DABOLIM,RAIPUR,1234,793,DABOLIM-RAIPUR,2027,All
2019,2,DABOLIM,RAIPUR,754,642,DABOLIM-RAIPUR,1396,All
2019,3,DABOLIM,RAIPUR,1130,1036,DABOLIM-RAIPUR,2166,All
2019,4,DABOLIM,RAIPUR,1003,1071,DABOLIM-RAIPUR,2074,All
2019,5,DABOLIM,RAIPUR,1352,1065,DABOLIM-RAIPUR,2417,All
2019,6,DABOLIM,RAIPUR,1349,1245,DABOLIM-RAIPUR,2594,All
2019,7,DABOLIM,RAIPUR,1261,1181,DABOLIM-RAIPUR,2442,All
2019,8,DABOLIM,RAIPUR,1498,1486,DABOLIM-RAIPUR,2984,All
2019,9,DABOLIM,RAIPUR,1574,1395,DABOLIM-RAIPUR,2969,All
2019,10,DABOLIM,RAIPUR,1429,1272,DABOLIM-RAIPUR,2701,All
2019,11,DABOLIM,RAIPUR,1241,1034,DABOLIM-RAIPUR,2275,All
2019,12,DABOLIM,RAIPUR,1639,1432,DABOLIM-RAIPUR,3071,All
2020,1,DABOLIM,RAIPUR,1122,866,DABOLIM-RAIPUR,1988,All
2020,2,DABOLIM,RAIPUR,994,677,DABOLIM-RAIPUR,1671,All
2020,3,DABOLIM,RAIPUR,789,513,DABOLIM-RAIPUR,1302,All
2020,12,DABOLIM,RAIPUR,167,0,DABOLIM-RAIPUR,167,All
2021,2,DABOLIM,RAIPUR,281,391,DABOLIM-RAIPUR,672,All
2021,3,DABOLIM,RAIPUR,1567,1841,DABOLIM-RAIPUR,3408,All
2021,4,DABOLIM,RAIPUR,788,526,DABOLIM-RAIPUR,1314,All
2021,8,DABOLIM,RAIPUR,1238,1402,DABOLIM-RAIPUR,2640,All
2021,9,DABOLIM,RAIPUR,1427,1587,DABOLIM-RAIPUR,3014,All
2021,10,DABOLIM,RAIPUR,1359,1661,DABOLIM-RAIPUR,3020,All
2021,11,DABOLIM,RAIPUR,1051,1011,DABOLIM-RAIPUR,2062,All
2021,12,DABOLIM,RAIPUR,1024,1203,DABOLIM-RAIPUR,2227,All
2022,1,DABOLIM,RAIPUR,1150,809,DABOLIM-RAIPUR,1959,All
2022,2,DABOLIM,RAIPUR,1078,881,DABOLIM-RAIPUR,1959,All
2022,3,DABOLIM,RAIPUR,1473,1245,DABOLIM-RAIPUR,2718,All
2022,4,DABOLIM,RAIPUR,834,1130,DABOLIM-RAIPUR,1964,All
2022,5,DABOLIM,RAIPUR,1175,1050,DABOLIM-RAIPUR,2225,All
2022,6,DABOLIM,RAIPUR,1010,958,DABOLIM-RAIPUR,1968,All
2022,7,DABOLIM,RAIPUR,1246,1413,DABOLIM-RAIPUR,2659,All
2022,8,DABOLIM,RAIPUR,1154,1230,DABOLIM-RAIPUR,2384,All
2022,9,DABOLIM,RAIPUR,838,1067,DABOLIM-RAIPUR,1905,All
2022,10,DABOLIM,RAIPUR,924,888,DABOLIM-RAIPUR,1812,All
2022,11,DABOLIM,RAIPUR,1191,1266,DABOLIM-RAIPUR,2457,All
2022,12,DABOLIM,RAIPUR,1594,1709,DABOLIM-RAIPUR,3303,All
2023,1,DABOLIM,RAIPUR,3259,3597,DABOLIM-RAIPUR,6856,All
2023,2,DABOLIM,RAIPUR,4206,4242,DABOLIM-RAIPUR,8448,All
2023,3,DABOLIM,RAIPUR,4305,4595,DABOLIM-RAIPUR,8900,All
2023,4,DABOLIM,RAIPUR,4474,4405,DABOLIM-RAIPUR,8879,All
2023,5,DABOLIM,RAIPUR,4345,5584,DABOLIM-RAIPUR,9929,All
2023,6,DABOLIM,RAIPUR,5107,5521,DABOLIM-RAIPUR,10628,All
2023,7,DABOLIM,RAIPUR,4686,5030,DABOLIM-RAIPUR,9716,All
2023,8,DABOLIM,RAIPUR,5035,5163,DABOLIM-RAIPUR,10198,All
2023,9,DABOLIM,RAIPUR,5503,5692,DABOLIM-RAIPUR,11195,All
2023,10,DABOLIM,RAIPUR,5415,5399,DABOLIM-RAIPUR,10814,All
2023,11,DABOLIM,RAIPUR,4855,4326,DABOLIM-RAIPUR,9181,All
2023,12,DABOLIM,RAIPUR,5688,5780,DABOLIM-RAIPUR,11468,All
2024,1,DABOLIM,RAIPUR,5875,5905,DABOLIM-RAIPUR,11780,All
2024,2,DABOLIM,RAIPUR,5381,5370,DABOLIM-RAIPUR,10751,All
2024,3,DABOLIM,RAIPUR,5681,5489,DABOLIM-RAIPUR,11170,All
2024,4,DABOLIM,RAIPUR,5010,4456,DABOLIM-RAIPUR,9466,All
2024,6,DABOLIM,RAIPUR,4982,5188,DABOLIM-RAIPUR,10170,All
2024,7,DABOLIM,RAIPUR,4353,4040,DABOLIM-RAIPUR,8393,All
2024,8,DABOLIM,RAIPUR,4687,5009,DABOLIM-RAIPUR,9696,All
2024,9,DABOLIM,RAIPUR,5218,5027,DABOLIM-RAIPUR,10245,All
2024,10,DABOLIM,RAIPUR,6115,4601,DABOLIM-RAIPUR,10716,All
2024,11,DABOLIM,RAIPUR,6379,6146,DABOLIM-RAIPUR,12525,All
2024,12,DABOLIM,RAIPUR,7661,6776,DABOLIM-RAIPUR,14437,All
2025,1,DABOLIM,RAIPUR,4824,4577,DABOLIM-RAIPUR,9401,All
2025,2,DABOLIM,RAIPUR,4332,4016,DABOLIM-RAIPUR,8348,All
2025,3,DABOLIM,RAIPUR,6115,5424,DABOLIM-RAIPUR,11539,All
2021,7,DABOLIM,RAJKOT,771,616,DABOLIM-RAJKOT,1387,All
2021,8,DABOLIM,RAJKOT,1642,1487,DABOLIM-RAJKOT,3129,All
2021,9,DABOLIM,RAJKOT,1202,987,DABOLIM-RAJKOT,2189,All
2021,10,DABOLIM,RAJKOT,1287,1040,DABOLIM-RAJKOT,2327,All
2021,11,DABOLIM,RAJKOT,2414,2464,DABOLIM-RAJKOT,4878,All
2021,12,DABOLIM,RAJKOT,2000,2116,DABOLIM-RAJKOT,4116,All
2022,1,DABOLIM,RAJKOT,1458,1154,DABOLIM-RAJKOT,2612,All
2022,2,DABOLIM,RAJKOT,1404,1579,DABOLIM-RAJKOT,2983,All
2022,3,DABOLIM,RAJKOT,2377,2324,DABOLIM-RAJKOT,4701,All
2022,4,DABOLIM,RAJKOT,2196,2077,DABOLIM-RAJKOT,4273,All
2022,5,DABOLIM,RAJKOT,2344,2166,DABOLIM-RAJKOT,4510,All
2022,6,DABOLIM,RAJKOT,2034,1711,DABOLIM-RAJKOT,3745,All
2022,7,DABOLIM,RAJKOT,1106,969,DABOLIM-RAJKOT,2075,All
2022,8,DABOLIM,RAJKOT,1618,1558,DABOLIM-RAJKOT,3176,All
2022,9,DABOLIM,RAJKOT,1395,1189,DABOLIM-RAJKOT,2584,All
2022,10,DABOLIM,RAJKOT,1323,1414,DABOLIM-RAJKOT,2737,All
2022,11,DABOLIM,RAJKOT,793,629,DABOLIM-RAJKOT,1422,All
2022,12,DABOLIM,RAJKOT,775,862,DABOLIM-RAJKOT,1637,All
2023,1,DABOLIM,RAJKOT,1045,907,DABOLIM-RAJKOT,1952,All
2019,10,DABOLIM,RANCHI,16,0,DABOLIM-RANCHI,16,All
2019,1,DABOLIM,SURAT,6606,7215,DABOLIM-SURAT,13821,All
2019,2,DABOLIM,SURAT,6624,7390,DABOLIM-SURAT,14014,All
2019,3,DABOLIM,SURAT,6763,7532,DABOLIM-SURAT,14295,All
2019,4,DABOLIM,SURAT,8013,9079,DABOLIM-SURAT,17092,All
2019,5,DABOLIM,SURAT,8954,10123,DABOLIM-SURAT,19077,All
2019,6,DABOLIM,SURAT,7394,8658,DABOLIM-SURAT,16052,All
2019,7,DABOLIM,SURAT,7190,7324,DABOLIM-SURAT,14514,All
2019,8,DABOLIM,SURAT,6804,7528,DABOLIM-SURAT,14332,All
2019,9,DABOLIM,SURAT,6461,6278,DABOLIM-SURAT,12739,All
2019,10,DABOLIM,SURAT,5173,6318,DABOLIM-SURAT,11491,All
2019,11,DABOLIM,SURAT,7347,7132,DABOLIM-SURAT,14479,All
2019,12,DABOLIM,SURAT,6278,7501,DABOLIM-SURAT,13779,All
2020,1,DABOLIM,SURAT,6315,6225,DABOLIM-SURAT,12540,All
2020,2,DABOLIM,SURAT,5562,5375,DABOLIM-SURAT,10937,All
2020,3,DABOLIM,SURAT,3979,2739,DABOLIM-SURAT,6718,All
2020,9,DABOLIM,SURAT,117,267,DABOLIM-SURAT,384,All
2020,10,DABOLIM,SURAT,327,388,DABOLIM-SURAT,715,All
2020,11,DABOLIM,SURAT,752,738,DABOLIM-SURAT,1490,All
2020,12,DABOLIM,SURAT,4034,3983,DABOLIM-SURAT,8017,All
2021,1,DABOLIM,SURAT,5567,4696,DABOLIM-SURAT,10263,All
2021,2,DABOLIM,SURAT,5677,5215,DABOLIM-SURAT,10892,All
2021,3,DABOLIM,SURAT,6013,4654,DABOLIM-SURAT,10667,All
2021,4,DABOLIM,SURAT,2627,2662,DABOLIM-SURAT,5289,All
2021,6,DABOLIM,SURAT,119,200,DABOLIM-SURAT,319,All
2021,7,DABOLIM,SURAT,647,731,DABOLIM-SURAT,1378,All
2021,8,DABOLIM,SURAT,4906,4707,DABOLIM-SURAT,9613,All
2021,9,DABOLIM,SURAT,5548,5331,DABOLIM-SURAT,10879,All
2021,10,DABOLIM,SURAT,5012,4729,DABOLIM-SURAT,9741,All
2021,11,DABOLIM,SURAT,7184,6820,DABOLIM-SURAT,14004,All
2021,12,DABOLIM,SURAT,7105,6721,DABOLIM-SURAT,13826,All
2022,1,DABOLIM,SURAT,5251,4172,DABOLIM-SURAT,9423,All
2022,2,DABOLIM,SURAT,4750,4706,DABOLIM-SURAT,9456,All
2022,3,DABOLIM,SURAT,6338,4906,DABOLIM-SURAT,11244,All
2022,4,DABOLIM,SURAT,4057,4109,DABOLIM-SURAT,8166,All
2022,5,DABOLIM,SURAT,6506,6031,DABOLIM-SURAT,12537,All
2022,6,DABOLIM,SURAT,5266,4390,DABOLIM-SURAT,9656,All
2022,7,DABOLIM,SURAT,4165,4009,DABOLIM-SURAT,8174,All
2022,8,DABOLIM,SURAT,4852,4801,DABOLIM-SURAT,9653,All
2022,9,DABOLIM,SURAT,5129,5078,DABOLIM-SURAT,10207,All
2022,10,DABOLIM,SURAT,5319,6108,DABOLIM-SURAT,11427,All
2022,11,DABOLIM,SURAT,6105,5213,DABOLIM-SURAT,11318,All
2022,12,DABOLIM,SURAT,5793,6267,DABOLIM-SURAT,12060,All
2023,1,DABOLIM,SURAT,7159,6677,DABOLIM-SURAT,13836,All
2023,2,DABOLIM,SURAT,5568,5918,DABOLIM-SURAT,11486,All
2023,3,DABOLIM,SURAT,5920,5782,DABOLIM-SURAT,11702,All
2023,4,DABOLIM,SURAT,5010,5022,DABOLIM-SURAT,10032,All
2023,5,DABOLIM,SURAT,6502,6732,DABOLIM-SURAT,13234,All
2023,6,DABOLIM,SURAT,5669,4512,DABOLIM-SURAT,10181,All
2023,7,DABOLIM,SURAT,4780,3641,DABOLIM-SURAT,8421,All
2023,8,DABOLIM,SURAT,4809,4028,DABOLIM-SURAT,8837,All
2023,9,DABOLIM,SURAT,4710,4028,DABOLIM-SURAT,8738,All
2023,10,DABOLIM,SURAT,4340,2899,DABOLIM-SURAT,7239,All
2023,11,DABOLIM,SURAT,5488,5246,DABOLIM-SURAT,10734,All
2023,12,DABOLIM,SURAT,6000,5075,DABOLIM-SURAT,11075,All
2024,1,DABOLIM,SURAT,6204,5029,DABOLIM-SURAT,11233,All
2024,2,DABOLIM,SURAT,5577,4734,DABOLIM-SURAT,10311,All
2024,3,DABOLIM,SURAT,5383,4380,DABOLIM-SURAT,9763,All
2024,4,DABOLIM,SURAT,5172,4130,DABOLIM-SURAT,9302,All
2024,6,DABOLIM,SURAT,6192,4961,DABOLIM-SURAT,11153,All
2024,7,DABOLIM,SURAT,6070,5247,DABOLIM-SURAT,11317,All
2024,8,DABOLIM,SURAT,5886,5699,DABOLIM-SURAT,11585,All
2024,9,DABOLIM,SURAT,5929,5861,DABOLIM-SURAT,11790,All
2024,10,DABOLIM,SURAT,4519,3947,DABOLIM-SURAT,8466,All
2024,11,DABOLIM,SURAT,5884,5429,DABOLIM-SURAT,11313,All
2024,12,DABOLIM,SURAT,5517,5472,DABOLIM-SURAT,10989,All
2025,1,DABOLIM,SURAT,6028,5563,DABOLIM-SURAT,11591,All
2025,2,DABOLIM,SURAT,5060,4787,DABOLIM-SURAT,9847,All
2025,3,DABOLIM,SURAT,5517,4469,DABOLIM-SURAT,9986,All
2021,1,DABOLIM,TIRUPATI,0,2,DABOLIM-TIRUPATI,2,All
2019,10,DABOLIM,TRIVANDRUM,0,20,DABOLIM-TRIVANDRUM,20,All
2019,11,DABOLIM,TRIVANDRUM,0,239,DABOLIM-TRIVANDRUM,239,All
2019,12,DABOLIM,TRIVANDRUM,0,259,DABOLIM-TRIVANDRUM,259,All
2020,1,DABOLIM,TRIVANDRUM,0,191,DABOLIM-TRIVANDRUM,191,All
2020,2,DABOLIM,TRIVANDRUM,0,175,DABOLIM-TRIVANDRUM,175,All
2020,3,DABOLIM,TRIVANDRUM,0,54,DABOLIM-TRIVANDRUM,54,All
2022,1,DABOLIM,TRIVANDRUM,0,4,DABOLIM-TRIVANDRUM,4,All
2019,1,DABOLIM,VARANASI,0,795,DABOLIM-VARANASI,795,All
2019,2,DABOLIM,VARANASI,58,536,DABOLIM-VARANASI,594,All
2019,3,DABOLIM,VARANASI,489,652,DABOLIM-VARANASI,1141,All
2019,4,DABOLIM,VARANASI,296,734,DABOLIM-VARANASI,1030,All
2019,5,DABOLIM,VARANASI,230,452,DABOLIM-VARANASI,682,All
2019,6,DABOLIM,VARANASI,414,245,DABOLIM-VARANASI,659,All
2019,7,DABOLIM,VARANASI,214,392,DABOLIM-VARANASI,606,All
2019,8,DABOLIM,VARANASI,134,407,DABOLIM-VARANASI,541,All
2019,9,DABOLIM,VARANASI,169,275,DABOLIM-VARANASI,444,All
2019,10,DABOLIM,VARANASI,265,275,DABOLIM-VARANASI,540,All
2019,11,DABOLIM,VARANASI,207,439,DABOLIM-VARANASI,646,All
2019,12,DABOLIM,VARANASI,440,732,DABOLIM-VARANASI,1172,All
2020,1,DABOLIM,VARANASI,196,443,DABOLIM-VARANASI,639,All
2020,2,DABOLIM,VARANASI,278,561,DABOLIM-VARANASI,839,All
2020,3,DABOLIM,VARANASI,273,504,DABOLIM-VARANASI,777,All
2021,10,DABOLIM,VARANASI,212,0,DABOLIM-VARANASI,212,All
2022,8,DABOLIM,VARANASI,12,0,DABOLIM-VARANASI,12,All
2022,9,DABOLIM,VARANASI,7,0,DABOLIM-VARANASI,7,All
2023,11,DABOLIM,VIDYANAGAR,0,12,DABOLIM-VIDYANAGAR,12,All
2021,3,DABOLIM,VIJAYAWADA,169,171,DABOLIM-VIJAYAWADA,340,All
2022,3,DABOLIM,VIJAYAWADA,0,48,DABOLIM-VIJAYAWADA,48,All
2022,11,DABOLIM,VIJAYAWADA,0,150,DABOLIM-VIJAYAWADA,150,All
2022,12,DABOLIM,VIJAYAWADA,0,137,DABOLIM-VIJAYAWADA,137,All
2023,2,DABOLIM,VIJAYAWADA,0,93,DABOLIM-VIJAYAWADA,93,All
2023,3,DABOLIM,VIJAYAWADA,0,88,DABOLIM-VIJAYAWADA,88,All
2019,10,DABOLIM,VISAKHAPATNAM,0,5,DABOLIM-VISAKHAPATNAM,5,All
2019,11,DABOLIM,VISAKHAPATNAM,0,115,DABOLIM-VISAKHAPATNAM,115,All
2019,12,DABOLIM,VISAKHAPATNAM,0,349,DABOLIM-VISAKHAPATNAM,349,All
2020,1,DABOLIM,VISAKHAPATNAM,0,168,DABOLIM-VISAKHAPATNAM,168,All
2020,2,DABOLIM,VISAKHAPATNAM,0,236,DABOLIM-VISAKHAPATNAM,236,All
2020,3,DABOLIM,VISAKHAPATNAM,0,107,DABOLIM-VISAKHAPATNAM,107,All
2024,2,DARBHANGA,Ayodhya International Airport ,786,566,Ayodhya International Airport -DARBHANGA,1352,All
2021,3,DARBHANGA,DELHI,9079,9644,DARBHANGA-DELHI,18723,All
2021,4,DARBHANGA,DELHI,7347,9352,DARBHANGA-DELHI,16699,All
2021,6,DARBHANGA,DELHI,10524,8520,DARBHANGA-DELHI,19044,All
2021,7,DARBHANGA,DELHI,11916,10495,DARBHANGA-DELHI,22411,All
2021,8,DARBHANGA,DELHI,11181,10137,DARBHANGA-DELHI,21318,All
2021,9,DARBHANGA,DELHI,9847,9838,DARBHANGA-DELHI,19685,All
2021,10,DARBHANGA,DELHI,11167,11558,DARBHANGA-DELHI,22725,All
2021,11,DARBHANGA,DELHI,9788,10215,DARBHANGA-DELHI,20003,All
2021,12,DARBHANGA,DELHI,10795,10340,DARBHANGA-DELHI,21135,All
2022,1,DARBHANGA,DELHI,3915,4519,DARBHANGA-DELHI,8434,All
2022,2,DARBHANGA,DELHI,8570,7738,DARBHANGA-DELHI,16308,All
2022,3,DARBHANGA,DELHI,9828,9347,DARBHANGA-DELHI,19175,All
2022,4,DARBHANGA,DELHI,12012,12208,DARBHANGA-DELHI,24220,All
2022,5,DARBHANGA,DELHI,9779,9548,DARBHANGA-DELHI,19327,All
2022,6,DARBHANGA,DELHI,9965,9573,DARBHANGA-DELHI,19538,All
2022,7,DARBHANGA,DELHI,6575,6399,DARBHANGA-DELHI,12974,All
2022,8,DARBHANGA,DELHI,5685,5373,DARBHANGA-DELHI,11058,All
2022,9,DARBHANGA,DELHI,4494,4983,DARBHANGA-DELHI,9477,All
2022,10,DARBHANGA,DELHI,6811,7727,DARBHANGA-DELHI,14538,All
2022,11,DARBHANGA,DELHI,8100,7891,DARBHANGA-DELHI,15991,All
2022,12,DARBHANGA,DELHI,5920,6289,DARBHANGA-DELHI,12209,All
2023,1,DARBHANGA,DELHI,4372,5101,DARBHANGA-DELHI,9473,All
2023,2,DARBHANGA,DELHI,5421,5503,DARBHANGA-DELHI,10924,All
2023,3,DARBHANGA,DELHI,7523,7869,DARBHANGA-DELHI,15392,All
2023,4,DARBHANGA,DELHI,7848,8418,DARBHANGA-DELHI,16266,All
2023,5,DARBHANGA,DELHI,9849,9849,DARBHANGA-DELHI,19698,All
2023,6,DARBHANGA,DELHI,8710,8719,DARBHANGA-DELHI,17429,All
2023,7,DARBHANGA,DELHI,9923,8929,DARBHANGA-DELHI,18852,All
2023,8,DARBHANGA,DELHI,7471,7369,DARBHANGA-DELHI,14840,All
2023,9,DARBHANGA,DELHI,4509,4505,DARBHANGA-DELHI,9014,All
2023,10,DARBHANGA,DELHI,4882,4912,DARBHANGA-DELHI,9794,All
2023,11,DARBHANGA,DELHI,8687,10250,DARBHANGA-DELHI,18937,All
2023,12,DARBHANGA,DELHI,8286,8277,DARBHANGA-DELHI,16563,All
2024,1,DARBHANGA,DELHI,4241,4427,DARBHANGA-DELHI,8668,All
2024,2,DARBHANGA,DELHI,4899,4896,DARBHANGA-DELHI,9795,All
2024,3,DARBHANGA,DELHI,5995,6012,DARBHANGA-DELHI,12007,All
2024,4,DARBHANGA,DELHI,9631,10216,DARBHANGA-DELHI,19847,All
2024,6,DARBHANGA,DELHI,9466,9596,DARBHANGA-DELHI,19062,All
2024,7,DARBHANGA,DELHI,8556,8084,DARBHANGA-DELHI,16640,All
2024,8,DARBHANGA,DELHI,6939,7123,DARBHANGA-DELHI,14062,All
2024,9,DARBHANGA,DELHI,6204,7009,DARBHANGA-DELHI,13213,All
2024,10,DARBHANGA,DELHI,5890,8811,DARBHANGA-DELHI,14701,All
2024,11,DARBHANGA,DELHI,7882,8707,DARBHANGA-DELHI,16589,All
2024,12,DARBHANGA,DELHI,9965,10146,DARBHANGA-DELHI,20111,All
2025,1,DARBHANGA,DELHI,5509,5792,DARBHANGA-DELHI,11301,All
2025,2,DARBHANGA,DELHI,8197,8437,DARBHANGA-DELHI,16634,All
2025,3,DARBHANGA,DELHI,13684,14713,DARBHANGA-DELHI,28397,All
2021,3,DARBHANGA,HYDERABAD,81,261,DARBHANGA-HYDERABAD,342,All
2021,4,DARBHANGA,HYDERABAD,512,550,DARBHANGA-HYDERABAD,1062,All
2021,7,DARBHANGA,HYDERABAD,4835,2030,DARBHANGA-HYDERABAD,6865,All
2021,8,DARBHANGA,HYDERABAD,3078,2361,DARBHANGA-HYDERABAD,5439,All
2021,9,DARBHANGA,HYDERABAD,2313,2240,DARBHANGA-HYDERABAD,4553,All
2021,10,DARBHANGA,HYDERABAD,3060,4098,DARBHANGA-HYDERABAD,7158,All
2021,11,DARBHANGA,HYDERABAD,4274,4345,DARBHANGA-HYDERABAD,8619,All
2021,12,DARBHANGA,HYDERABAD,5120,3032,DARBHANGA-HYDERABAD,8152,All
2022,1,DARBHANGA,HYDERABAD,2270,2741,DARBHANGA-HYDERABAD,5011,All
2022,2,DARBHANGA,HYDERABAD,2555,2555,DARBHANGA-HYDERABAD,5110,All
2022,3,DARBHANGA,HYDERABAD,2554,2677,DARBHANGA-HYDERABAD,5231,All
2022,4,DARBHANGA,HYDERABAD,2350,2838,DARBHANGA-HYDERABAD,5188,All
2022,5,DARBHANGA,HYDERABAD,2743,2744,DARBHANGA-HYDERABAD,5487,All
2022,6,DARBHANGA,HYDERABAD,5109,4195,DARBHANGA-HYDERABAD,9304,All
2022,7,DARBHANGA,HYDERABAD,4849,4112,DARBHANGA-HYDERABAD,8961,All
2022,8,DARBHANGA,HYDERABAD,4253,3240,DARBHANGA-HYDERABAD,7493,All
2022,9,DARBHANGA,HYDERABAD,3399,3391,DARBHANGA-HYDERABAD,6790,All
2022,10,DARBHANGA,HYDERABAD,3864,4414,DARBHANGA-HYDERABAD,8278,All
2022,11,DARBHANGA,HYDERABAD,4332,3923,DARBHANGA-HYDERABAD,8255,All
2022,12,DARBHANGA,HYDERABAD,3725,2786,DARBHANGA-HYDERABAD,6511,All
2023,1,DARBHANGA,HYDERABAD,3590,3251,DARBHANGA-HYDERABAD,6841,All
2023,2,DARBHANGA,HYDERABAD,3665,3666,DARBHANGA-HYDERABAD,7331,All
2023,3,DARBHANGA,HYDERABAD,4707,3953,DARBHANGA-HYDERABAD,8660,All
2023,4,DARBHANGA,HYDERABAD,3737,4124,DARBHANGA-HYDERABAD,7861,All
2023,5,DARBHANGA,HYDERABAD,2281,2294,DARBHANGA-HYDERABAD,4575,All
2023,6,DARBHANGA,HYDERABAD,2233,2172,DARBHANGA-HYDERABAD,4405,All
2023,7,DARBHANGA,HYDERABAD,3862,3625,DARBHANGA-HYDERABAD,7487,All
2023,8,DARBHANGA,HYDERABAD,4369,4406,DARBHANGA-HYDERABAD,8775,All
2023,9,DARBHANGA,HYDERABAD,3761,4388,DARBHANGA-HYDERABAD,8149,All
2023,10,DARBHANGA,HYDERABAD,2559,3147,DARBHANGA-HYDERABAD,5706,All
2023,11,DARBHANGA,HYDERABAD,3451,4665,DARBHANGA-HYDERABAD,8116,All
2023,12,DARBHANGA,HYDERABAD,4514,4464,DARBHANGA-HYDERABAD,8978,All
2024,1,DARBHANGA,HYDERABAD,2951,3173,DARBHANGA-HYDERABAD,6124,All
2024,2,DARBHANGA,HYDERABAD,3808,4315,DARBHANGA-HYDERABAD,8123,All
2024,3,DARBHANGA,HYDERABAD,4586,5022,DARBHANGA-HYDERABAD,9608,All
2024,4,DARBHANGA,HYDERABAD,4390,4999,DARBHANGA-HYDERABAD,9389,All
2024,6,DARBHANGA,HYDERABAD,4472,4468,DARBHANGA-HYDERABAD,8940,All
2024,7,DARBHANGA,HYDERABAD,4834,4536,DARBHANGA-HYDERABAD,9370,All
2024,8,DARBHANGA,HYDERABAD,4618,4528,DARBHANGA-HYDERABAD,9146,All
2024,9,DARBHANGA,HYDERABAD,4430,4618,DARBHANGA-HYDERABAD,9048,All
2024,10,DARBHANGA,HYDERABAD,3809,4909,DARBHANGA-HYDERABAD,8718,All
2024,11,DARBHANGA,HYDERABAD,4553,4881,DARBHANGA-HYDERABAD,9434,All
2024,12,DARBHANGA,HYDERABAD,4880,4244,DARBHANGA-HYDERABAD,9124,All
2025,1,DARBHANGA,HYDERABAD,2696,2691,DARBHANGA-HYDERABAD,5387,All
2025,2,DARBHANGA,HYDERABAD,4116,4634,DARBHANGA-HYDERABAD,8750,All
2025,3,DARBHANGA,HYDERABAD,4726,6010,DARBHANGA-HYDERABAD,10736,All
2021,3,DARBHANGA,KOLKATA,93,99,DARBHANGA-KOLKATA,192,All
2021,4,DARBHANGA,KOLKATA,975,739,DARBHANGA-KOLKATA,1714,All
2021,6,DARBHANGA,KOLKATA,199,150,DARBHANGA-KOLKATA,349,All
2021,7,DARBHANGA,KOLKATA,3112,1498,DARBHANGA-KOLKATA,4610,All
2021,8,DARBHANGA,KOLKATA,1412,595,DARBHANGA-KOLKATA,2007,All
2021,9,DARBHANGA,KOLKATA,1682,972,DARBHANGA-KOLKATA,2654,All
2021,10,DARBHANGA,KOLKATA,1785,2476,DARBHANGA-KOLKATA,4261,All
2021,11,DARBHANGA,KOLKATA,4120,3409,DARBHANGA-KOLKATA,7529,All
2021,12,DARBHANGA,KOLKATA,3993,2479,DARBHANGA-KOLKATA,6472,All
2022,1,DARBHANGA,KOLKATA,336,644,DARBHANGA-KOLKATA,980,All
2022,2,DARBHANGA,KOLKATA,1874,1772,DARBHANGA-KOLKATA,3646,All
2022,3,DARBHANGA,KOLKATA,1519,1546,DARBHANGA-KOLKATA,3065,All
2022,4,DARBHANGA,KOLKATA,1703,2056,DARBHANGA-KOLKATA,3759,All
2022,5,DARBHANGA,KOLKATA,2556,2473,DARBHANGA-KOLKATA,5029,All
2022,6,DARBHANGA,KOLKATA,4353,2956,DARBHANGA-KOLKATA,7309,All
2022,7,DARBHANGA,KOLKATA,2941,2322,DARBHANGA-KOLKATA,5263,All
2022,8,DARBHANGA,KOLKATA,2109,1561,DARBHANGA-KOLKATA,3670,All
2022,9,DARBHANGA,KOLKATA,2001,1520,DARBHANGA-KOLKATA,3521,All
2022,10,DARBHANGA,KOLKATA,3178,3868,DARBHANGA-KOLKATA,7046,All
2022,11,DARBHANGA,KOLKATA,4452,3113,DARBHANGA-KOLKATA,7565,All
2022,12,DARBHANGA,KOLKATA,3517,2183,DARBHANGA-KOLKATA,5700,All
2023,1,DARBHANGA,KOLKATA,2443,2478,DARBHANGA-KOLKATA,4921,All
2023,2,DARBHANGA,KOLKATA,3328,4023,DARBHANGA-KOLKATA,7351,All
2023,3,DARBHANGA,KOLKATA,3682,3545,DARBHANGA-KOLKATA,7227,All
2023,4,DARBHANGA,KOLKATA,2985,3392,DARBHANGA-KOLKATA,6377,All
2023,5,DARBHANGA,KOLKATA,4430,4716,DARBHANGA-KOLKATA,9146,All
2023,6,DARBHANGA,KOLKATA,4503,4274,DARBHANGA-KOLKATA,8777,All
2023,7,DARBHANGA,KOLKATA,4169,4352,DARBHANGA-KOLKATA,8521,All
2023,8,DARBHANGA,KOLKATA,3721,4411,DARBHANGA-KOLKATA,8132,All
2023,9,DARBHANGA,KOLKATA,3977,4818,DARBHANGA-KOLKATA,8795,All
2023,10,DARBHANGA,KOLKATA,3660,4502,DARBHANGA-KOLKATA,8162,All
2023,11,DARBHANGA,KOLKATA,3273,4889,DARBHANGA-KOLKATA,8162,All
2023,12,DARBHANGA,KOLKATA,5098,3802,DARBHANGA-KOLKATA,8900,All
2024,1,DARBHANGA,KOLKATA,1515,1843,DARBHANGA-KOLKATA,3358,All
2024,2,DARBHANGA,KOLKATA,3294,4302,DARBHANGA-KOLKATA,7596,All
2024,3,DARBHANGA,KOLKATA,4238,5074,DARBHANGA-KOLKATA,9312,All
2024,4,DARBHANGA,KOLKATA,1991,2192,DARBHANGA-KOLKATA,4183,All
2024,6,DARBHANGA,KOLKATA,1919,1936,DARBHANGA-KOLKATA,3855,All
2024,7,DARBHANGA,KOLKATA,1798,1972,DARBHANGA-KOLKATA,3770,All
2024,8,DARBHANGA,KOLKATA,1552,1811,DARBHANGA-KOLKATA,3363,All
2024,9,DARBHANGA,KOLKATA,1576,1863,DARBHANGA-KOLKATA,3439,All
2024,10,DARBHANGA,KOLKATA,1167,1752,DARBHANGA-KOLKATA,2919,All
2024,11,DARBHANGA,KOLKATA,1658,1751,DARBHANGA-KOLKATA,3409,All
2024,12,DARBHANGA,KOLKATA,1897,1629,DARBHANGA-KOLKATA,3526,All
2025,1,DARBHANGA,KOLKATA,779,818,DARBHANGA-KOLKATA,1597,All
2025,2,DARBHANGA,KOLKATA,1653,1849,DARBHANGA-KOLKATA,3502,All
2025,3,DARBHANGA,KOLKATA,2007,2168,DARBHANGA-KOLKATA,4175,All
2023,9,DARBHANGA,LUCKNOW,0,145,DARBHANGA-LUCKNOW,145,All
2021,3,DARBHANGA,MUMBAI,5181,7319,DARBHANGA-MUMBAI,12500,All
2021,4,DARBHANGA,MUMBAI,3147,5057,DARBHANGA-MUMBAI,8204,All
2021,6,DARBHANGA,MUMBAI,10134,5657,DARBHANGA-MUMBAI,15791,All
2021,7,DARBHANGA,MUMBAI,8589,6797,DARBHANGA-MUMBAI,15386,All
2021,8,DARBHANGA,MUMBAI,5997,4759,DARBHANGA-MUMBAI,10756,All
2021,9,DARBHANGA,MUMBAI,4779,4764,DARBHANGA-MUMBAI,9543,All
2021,10,DARBHANGA,MUMBAI,6031,7149,DARBHANGA-MUMBAI,13180,All
2021,11,DARBHANGA,MUMBAI,8763,10529,DARBHANGA-MUMBAI,19292,All
2021,12,DARBHANGA,MUMBAI,10207,7549,DARBHANGA-MUMBAI,17756,All
2022,1,DARBHANGA,MUMBAI,2954,3704,DARBHANGA-MUMBAI,6658,All
2022,2,DARBHANGA,MUMBAI,4643,4714,DARBHANGA-MUMBAI,9357,All
2022,3,DARBHANGA,MUMBAI,5027,5383,DARBHANGA-MUMBAI,10410,All
2022,4,DARBHANGA,MUMBAI,6878,9333,DARBHANGA-MUMBAI,16211,All
2022,5,DARBHANGA,MUMBAI,9905,10470,DARBHANGA-MUMBAI,20375,All
2022,6,DARBHANGA,MUMBAI,10172,7639,DARBHANGA-MUMBAI,17811,All
2022,7,DARBHANGA,MUMBAI,5605,5861,DARBHANGA-MUMBAI,11466,All
2022,8,DARBHANGA,MUMBAI,4741,4064,DARBHANGA-MUMBAI,8805,All
2022,9,DARBHANGA,MUMBAI,3500,4384,DARBHANGA-MUMBAI,7884,All
2022,10,DARBHANGA,MUMBAI,5309,8507,DARBHANGA-MUMBAI,13816,All
2022,11,DARBHANGA,MUMBAI,5565,5127,DARBHANGA-MUMBAI,10692,All
2022,12,DARBHANGA,MUMBAI,5422,4947,DARBHANGA-MUMBAI,10369,All
2023,11,DARBHANGA,MUMBAI,4311,5097,DARBHANGA-MUMBAI,9408,All
2023,12,DARBHANGA,MUMBAI,5277,5182,DARBHANGA-MUMBAI,10459,All
2024,1,DARBHANGA,MUMBAI,1890,1890,DARBHANGA-MUMBAI,3780,All
2024,2,DARBHANGA,MUMBAI,4615,4683,DARBHANGA-MUMBAI,9298,All
2024,3,DARBHANGA,MUMBAI,3827,3942,DARBHANGA-MUMBAI,7769,All
2024,4,DARBHANGA,MUMBAI,4778,5481,DARBHANGA-MUMBAI,10259,All
2024,6,DARBHANGA,MUMBAI,5519,5139,DARBHANGA-MUMBAI,10658,All
2024,7,DARBHANGA,MUMBAI,4146,3575,DARBHANGA-MUMBAI,7721,All
2024,8,DARBHANGA,MUMBAI,4089,3623,DARBHANGA-MUMBAI,7712,All
2024,9,DARBHANGA,MUMBAI,3203,4052,DARBHANGA-MUMBAI,7255,All
2024,10,DARBHANGA,MUMBAI,2869,5310,DARBHANGA-MUMBAI,8179,All
2024,11,DARBHANGA,MUMBAI,4090,4692,DARBHANGA-MUMBAI,8782,All
2024,12,DARBHANGA,MUMBAI,8430,8329,DARBHANGA-MUMBAI,16759,All
2025,1,DARBHANGA,MUMBAI,4457,4598,DARBHANGA-MUMBAI,9055,All
2025,2,DARBHANGA,MUMBAI,5292,5747,DARBHANGA-MUMBAI,11039,All
2025,3,DARBHANGA,MUMBAI,7858,8561,DARBHANGA-MUMBAI,16419,All
2021,3,DARBHANGA,PUNE,50,312,DARBHANGA-PUNE,362,All
2021,4,DARBHANGA,PUNE,265,432,DARBHANGA-PUNE,697,All
2021,10,DARBHANGA,PUNE,0,14,DARBHANGA-PUNE,14,All
2021,11,DARBHANGA,PUNE,0,460,DARBHANGA-PUNE,460,All
2021,10,DARBHANGA,SRINAGAR,0,138,DARBHANGA-SRINAGAR,138,All
2025,3,DARBHANGA,SRINAGAR,11,2,DARBHANGA-SRINAGAR,13,All
2017,6,DEHRA DUN,CHANDIGARH,34,0,CHANDIGARH-DEHRA DUN,34,All
2017,7,DEHRA DUN,CHANDIGARH,11,5,CHANDIGARH-DEHRA DUN,16,All
2017,8,DEHRA DUN,CHANDIGARH,26,34,CHANDIGARH-DEHRA DUN,60,All
2017,9,DEHRA DUN,CHANDIGARH,13,16,CHANDIGARH-DEHRA DUN,29,All
2017,10,DEHRA DUN,CHANDIGARH,0,8,CHANDIGARH-DEHRA DUN,8,All
2017,11,DEHRA DUN,CHANDIGARH,0,19,CHANDIGARH-DEHRA DUN,19,All
2017,12,DEHRA DUN,CHANDIGARH,0,12,CHANDIGARH-DEHRA DUN,12,All
2018,1,DEHRA DUN,CHANDIGARH,0,8,CHANDIGARH-DEHRA DUN,8,All
2018,2,DEHRA DUN,CHANDIGARH,0,7,CHANDIGARH-DEHRA DUN,7,All
2018,3,DEHRA DUN,CHANDIGARH,0,14,CHANDIGARH-DEHRA DUN,14,All
2018,4,DEHRA DUN,CHANDIGARH,0,8,CHANDIGARH-DEHRA DUN,8,All
2018,5,DEHRA DUN,CHANDIGARH,0,11,CHANDIGARH-DEHRA DUN,11,All
2018,6,DEHRA DUN,CHANDIGARH,0,20,CHANDIGARH-DEHRA DUN,20,All
2018,7,DEHRA DUN,CHANDIGARH,0,18,CHANDIGARH-DEHRA DUN,18,All
2018,8,DEHRA DUN,CHANDIGARH,0,14,CHANDIGARH-DEHRA DUN,14,All
2018,9,DEHRA DUN,CHANDIGARH,0,13,CHANDIGARH-DEHRA DUN,13,All
2018,10,DEHRA DUN,CHANDIGARH,0,19,CHANDIGARH-DEHRA DUN,19,All
2018,11,DEHRA DUN,CHANDIGARH,33,34,CHANDIGARH-DEHRA DUN,67,All
2018,12,DEHRA DUN,CHANDIGARH,39,5,CHANDIGARH-DEHRA DUN,44,All
2019,1,DEHRA DUN,CHANDIGARH,15,0,CHANDIGARH-DEHRA DUN,15,All
2019,2,DEHRA DUN,CHANDIGARH,6,0,CHANDIGARH-DEHRA DUN,6,All
2019,4,DEHRA DUN,CHANDIGARH,3,0,CHANDIGARH-DEHRA DUN,3,All
2015,12,DEHRA DUN,CHENNAI,47,0,CHENNAI-DEHRA DUN,47,All
2016,1,DEHRA DUN,CHENNAI,240,0,CHENNAI-DEHRA DUN,240,All
2016,2,DEHRA DUN,CHENNAI,224,0,CHENNAI-DEHRA DUN,224,All
2016,3,DEHRA DUN,CHENNAI,290,0,CHENNAI-DEHRA DUN,290,All
2016,4,DEHRA DUN,CHENNAI,368,0,CHENNAI-DEHRA DUN,368,All
2016,5,DEHRA DUN,CHENNAI,311,0,CHENNAI-DEHRA DUN,311,All
2016,6,DEHRA DUN,CHENNAI,448,0,CHENNAI-DEHRA DUN,448,All
2016,7,DEHRA DUN,CHENNAI,361,0,CHENNAI-DEHRA DUN,361,All
2016,8,DEHRA DUN,CHENNAI,323,0,CHENNAI-DEHRA DUN,323,All
2016,9,DEHRA DUN,CHENNAI,324,0,CHENNAI-DEHRA DUN,324,All
2016,10,DEHRA DUN,CHENNAI,574,0,CHENNAI-DEHRA DUN,574,All
2016,11,DEHRA DUN,CHENNAI,382,0,CHENNAI-DEHRA DUN,382,All
2016,12,DEHRA DUN,CHENNAI,249,0,CHENNAI-DEHRA DUN,249,All
2017,1,DEHRA DUN,CHENNAI,440,0,CHENNAI-DEHRA DUN,440,All
2017,2,DEHRA DUN,CHENNAI,557,0,CHENNAI-DEHRA DUN,557,All
2017,3,DEHRA DUN,CHENNAI,717,0,CHENNAI-DEHRA DUN,717,All
2017,4,DEHRA DUN,CHENNAI,477,0,CHENNAI-DEHRA DUN,477,All
2017,5,DEHRA DUN,CHENNAI,500,0,CHENNAI-DEHRA DUN,500,All
2017,6,DEHRA DUN,CHENNAI,358,0,CHENNAI-DEHRA DUN,358,All
2017,7,DEHRA DUN,CHENNAI,349,0,CHENNAI-DEHRA DUN,349,All
2017,8,DEHRA DUN,CHENNAI,372,0,CHENNAI-DEHRA DUN,372,All
2017,9,DEHRA DUN,CHENNAI,547,0,CHENNAI-DEHRA DUN,547,All
2017,10,DEHRA DUN,CHENNAI,472,0,CHENNAI-DEHRA DUN,472,All
2017,11,DEHRA DUN,CHENNAI,351,0,CHENNAI-DEHRA DUN,351,All
2017,12,DEHRA DUN,CHENNAI,454,0,CHENNAI-DEHRA DUN,454,All
2018,1,DEHRA DUN,CHENNAI,450,0,CHENNAI-DEHRA DUN,450,All
2018,2,DEHRA DUN,CHENNAI,435,0,CHENNAI-DEHRA DUN,435,All
2018,3,DEHRA DUN,CHENNAI,540,37,CHENNAI-DEHRA DUN,577,All
2018,4,DEHRA DUN,CHENNAI,300,0,CHENNAI-DEHRA DUN,300,All
2019,1,DEHRA DUN,DABOLIM,529,0,DABOLIM-DEHRA DUN,529,All
2019,2,DEHRA DUN,DABOLIM,233,0,DABOLIM-DEHRA DUN,233,All
2019,3,DEHRA DUN,DABOLIM,251,0,DABOLIM-DEHRA DUN,251,All
2015,4,DEHRA DUN,DELHI,16384,16948,DEHRA DUN-DELHI,33332,All
2015,5,DEHRA DUN,DELHI,18124,17987,DEHRA DUN-DELHI,36111,All
2015,6,DEHRA DUN,DELHI,17378,17162,DEHRA DUN-DELHI,34540,All
2015,7,DEHRA DUN,DELHI,16021,16938,DEHRA DUN-DELHI,32959,All
2015,8,DEHRA DUN,DELHI,16742,17094,DEHRA DUN-DELHI,33836,All
2015,9,DEHRA DUN,DELHI,16661,17453,DEHRA DUN-DELHI,34114,All
2015,10,DEHRA DUN,DELHI,17912,18655,DEHRA DUN-DELHI,36567,All
2015,11,DEHRA DUN,DELHI,15053,15336,DEHRA DUN-DELHI,30389,All
2015,12,DEHRA DUN,DELHI,15159,14692,DEHRA DUN-DELHI,29851,All
2016,1,DEHRA DUN,DELHI,15405,15173,DEHRA DUN-DELHI,30578,All
2016,2,DEHRA DUN,DELHI,16213,16841,DEHRA DUN-DELHI,33054,All
2016,3,DEHRA DUN,DELHI,27557,27168,DEHRA DUN-DELHI,54725,All
2016,4,DEHRA DUN,DELHI,28603,28569,DEHRA DUN-DELHI,57172,All
2016,5,DEHRA DUN,DELHI,29216,28904,DEHRA DUN-DELHI,58120,All
2016,6,DEHRA DUN,DELHI,27829,26396,DEHRA DUN-DELHI,54225,All
2016,7,DEHRA DUN,DELHI,25554,27049,DEHRA DUN-DELHI,52603,All
2016,8,DEHRA DUN,DELHI,27213,26727,DEHRA DUN-DELHI,53940,All
2016,9,DEHRA DUN,DELHI,27823,29042,DEHRA DUN-DELHI,56865,All
2016,10,DEHRA DUN,DELHI,33434,34091,DEHRA DUN-DELHI,67525,All
2016,11,DEHRA DUN,DELHI,34919,32251,DEHRA DUN-DELHI,67170,All
2016,12,DEHRA DUN,DELHI,30672,27249,DEHRA DUN-DELHI,57921,All
2017,1,DEHRA DUN,DELHI,27365,27276,DEHRA DUN-DELHI,54641,All
2017,2,DEHRA DUN,DELHI,26828,28379,DEHRA DUN-DELHI,55207,All
2017,3,DEHRA DUN,DELHI,36816,36260,DEHRA DUN-DELHI,73076,All
2017,4,DEHRA DUN,DELHI,33365,34252,DEHRA DUN-DELHI,67617,All
2017,5,DEHRA DUN,DELHI,36057,36358,DEHRA DUN-DELHI,72415,All
2017,6,DEHRA DUN,DELHI,35967,34056,DEHRA DUN-DELHI,70023,All
2017,7,DEHRA DUN,DELHI,33765,34724,DEHRA DUN-DELHI,68489,All
2017,8,DEHRA DUN,DELHI,33205,33326,DEHRA DUN-DELHI,66531,All
2017,9,DEHRA DUN,DELHI,31774,33525,DEHRA DUN-DELHI,65299,All
2017,10,DEHRA DUN,DELHI,34345,34664,DEHRA DUN-DELHI,69009,All
2017,11,DEHRA DUN,DELHI,30855,30196,DEHRA DUN-DELHI,61051,All
2017,12,DEHRA DUN,DELHI,31780,29626,DEHRA DUN-DELHI,61406,All
2018,1,DEHRA DUN,DELHI,28169,29505,DEHRA DUN-DELHI,57674,All
2018,2,DEHRA DUN,DELHI,29641,30838,DEHRA DUN-DELHI,60479,All
2018,3,DEHRA DUN,DELHI,33380,35072,DEHRA DUN-DELHI,68452,All
2018,4,DEHRA DUN,DELHI,32157,34172,DEHRA DUN-DELHI,66329,All
2018,5,DEHRA DUN,DELHI,36938,39163,DEHRA DUN-DELHI,76101,All
2018,6,DEHRA DUN,DELHI,31542,32111,DEHRA DUN-DELHI,63653,All
2018,7,DEHRA DUN,DELHI,31214,31739,DEHRA DUN-DELHI,62953,All
2018,8,DEHRA DUN,DELHI,30092,31118,DEHRA DUN-DELHI,61210,All
2018,9,DEHRA DUN,DELHI,31013,31933,DEHRA DUN-DELHI,62946,All
2018,10,DEHRA DUN,DELHI,34426,35632,DEHRA DUN-DELHI,70058,All
2018,11,DEHRA DUN,DELHI,28614,28488,DEHRA DUN-DELHI,57102,All
2018,12,DEHRA DUN,DELHI,31062,29175,DEHRA DUN-DELHI,60237,All
2019,1,DEHRA DUN,DELHI,25765,27551,DEHRA DUN-DELHI,53316,All
2019,2,DEHRA DUN,DELHI,23875,27392,DEHRA DUN-DELHI,51267,All
2019,3,DEHRA DUN,DELHI,27319,27930,DEHRA DUN-DELHI,55249,All
2019,4,DEHRA DUN,DELHI,23459,25864,DEHRA DUN-DELHI,49323,All
2019,5,DEHRA DUN,DELHI,22032,23513,DEHRA DUN-DELHI,45545,All
2019,6,DEHRA DUN,DELHI,23136,23495,DEHRA DUN-DELHI,46631,All
2019,7,DEHRA DUN,DELHI,23836,24558,DEHRA DUN-DELHI,48394,All
2019,8,DEHRA DUN,DELHI,24855,24556,DEHRA DUN-DELHI,49411,All
2019,9,DEHRA DUN,DELHI,24149,24807,DEHRA DUN-DELHI,48956,All
2019,10,DEHRA DUN,DELHI,25393,25879,DEHRA DUN-DELHI,51272,All
2019,11,DEHRA DUN,DELHI,24489,24179,DEHRA DUN-DELHI,48668,All
2019,12,DEHRA DUN,DELHI,26971,26375,DEHRA DUN-DELHI,53346,All
2020,1,DEHRA DUN,DELHI,24982,26062,DEHRA DUN-DELHI,51044,All
2020,2,DEHRA DUN,DELHI,25879,27789,DEHRA DUN-DELHI,53668,All
2020,3,DEHRA DUN,DELHI,18114,16192,DEHRA DUN-DELHI,34306,All
2020,5,DEHRA DUN,DELHI,1487,1175,DEHRA DUN-DELHI,2662,All
2020,6,DEHRA DUN,DELHI,6932,5338,DEHRA DUN-DELHI,12270,All
2020,7,DEHRA DUN,DELHI,5425,6353,DEHRA DUN-DELHI,11778,All
2020,8,DEHRA DUN,DELHI,6296,6933,DEHRA DUN-DELHI,13229,All
2020,9,DEHRA DUN,DELHI,8599,8595,DEHRA DUN-DELHI,17194,All
2020,10,DEHRA DUN,DELHI,15042,15460,DEHRA DUN-DELHI,30502,All
2020,11,DEHRA DUN,DELHI,18142,15263,DEHRA DUN-DELHI,33405,All
2020,12,DEHRA DUN,DELHI,20121,17386,DEHRA DUN-DELHI,37507,All
2021,1,DEHRA DUN,DELHI,23081,19774,DEHRA DUN-DELHI,42855,All
2021,2,DEHRA DUN,DELHI,21291,21084,DEHRA DUN-DELHI,42375,All
2021,3,DEHRA DUN,DELHI,24775,23371,DEHRA DUN-DELHI,48146,All
2021,4,DEHRA DUN,DELHI,21923,17414,DEHRA DUN-DELHI,39337,All
2021,6,DEHRA DUN,DELHI,10260,8709,DEHRA DUN-DELHI,18969,All
2021,7,DEHRA DUN,DELHI,13987,12785,DEHRA DUN-DELHI,26772,All
2021,8,DEHRA DUN,DELHI,15447,14263,DEHRA DUN-DELHI,29710,All
2021,9,DEHRA DUN,DELHI,14778,15853,DEHRA DUN-DELHI,30631,All
2021,10,DEHRA DUN,DELHI,21473,22086,DEHRA DUN-DELHI,43559,All
2021,11,DEHRA DUN,DELHI,30307,27658,DEHRA DUN-DELHI,57965,All
2021,12,DEHRA DUN,DELHI,33555,28868,DEHRA DUN-DELHI,62423,All
2022,1,DEHRA DUN,DELHI,18079,13281,DEHRA DUN-DELHI,31360,All
2022,2,DEHRA DUN,DELHI,20119,20524,DEHRA DUN-DELHI,40643,All
2022,3,DEHRA DUN,DELHI,26688,27331,DEHRA DUN-DELHI,54019,All
2022,4,DEHRA DUN,DELHI,25834,28301,DEHRA DUN-DELHI,54135,All
2022,5,DEHRA DUN,DELHI,31652,34343,DEHRA DUN-DELHI,65995,All
2022,6,DEHRA DUN,DELHI,32344,28462,DEHRA DUN-DELHI,60806,All
2022,7,DEHRA DUN,DELHI,21850,21148,DEHRA DUN-DELHI,42998,All
2022,8,DEHRA DUN,DELHI,23228,22676,DEHRA DUN-DELHI,45904,All
2022,9,DEHRA DUN,DELHI,27068,28878,DEHRA DUN-DELHI,55946,All
2022,10,DEHRA DUN,DELHI,27031,27210,DEHRA DUN-DELHI,54241,All
2022,11,DEHRA DUN,DELHI,23101,22342,DEHRA DUN-DELHI,45443,All
2022,12,DEHRA DUN,DELHI,22960,23391,DEHRA DUN-DELHI,46351,All
2023,2,DEHRA DUN,DELHI,20292,22029,DEHRA DUN-DELHI,42321,All
2023,3,DEHRA DUN,DELHI,25606,25919,DEHRA DUN-DELHI,51525,All
2023,4,DEHRA DUN,DELHI,25200,26245,DEHRA DUN-DELHI,51445,All
2023,5,DEHRA DUN,DELHI,25174,27129,DEHRA DUN-DELHI,52303,All
2018,4,DEHRA DUN,DIBRUGARH,2,0,DEHRA DUN-DIBRUGARH,2,All
2018,7,DEHRA DUN,GOA,3,0,DEHRA DUN-GOA,3,All
2018,8,DEHRA DUN,GOA,48,0,DEHRA DUN-GOA,48,All
2018,9,DEHRA DUN,GOA,108,0,DEHRA DUN-GOA,108,All
2018,10,DEHRA DUN,GOA,156,0,DEHRA DUN-GOA,156,All
2018,11,DEHRA DUN,GOA,224,0,DEHRA DUN-GOA,224,All
2018,12,DEHRA DUN,GOA,390,0,DEHRA DUN-GOA,390,All
2019,2,DEHRA DUN,GORAKHPUR,0,55,DEHRA DUN-GORAKHPUR,55,All
2019,2,DEHRA DUN,GUWAHATI,1455,1204,DEHRA DUN-GUWAHATI,2659,All
2019,3,DEHRA DUN,GUWAHATI,2506,2376,DEHRA DUN-GUWAHATI,4882,All
2019,4,DEHRA DUN,GUWAHATI,1028,883,DEHRA DUN-GUWAHATI,1911,All
2021,8,DEHRA DUN,GUWAHATI,49,103,DEHRA DUN-GUWAHATI,152,All
2021,9,DEHRA DUN,GUWAHATI,259,597,DEHRA DUN-GUWAHATI,856,All
2021,10,DEHRA DUN,GUWAHATI,578,929,DEHRA DUN-GUWAHATI,1507,All
2022,3,DEHRA DUN,GUWAHATI,77,84,DEHRA DUN-GUWAHATI,161,All
2022,4,DEHRA DUN,GUWAHATI,688,621,DEHRA DUN-GUWAHATI,1309,All
2022,5,DEHRA DUN,GUWAHATI,838,744,DEHRA DUN-GUWAHATI,1582,All
2022,6,DEHRA DUN,GUWAHATI,991,762,DEHRA DUN-GUWAHATI,1753,All
2022,7,DEHRA DUN,GUWAHATI,299,206,DEHRA DUN-GUWAHATI,505,All
2022,8,DEHRA DUN,GUWAHATI,564,69,DEHRA DUN-GUWAHATI,633,All
2022,9,DEHRA DUN,GUWAHATI,472,159,DEHRA DUN-GUWAHATI,631,All
2022,10,DEHRA DUN,GUWAHATI,428,310,DEHRA DUN-GUWAHATI,738,All
2023,3,DEHRA DUN,GUWAHATI,92,38,DEHRA DUN-GUWAHATI,130,All
2023,4,DEHRA DUN,GUWAHATI,376,315,DEHRA DUN-GUWAHATI,691,All
2023,5,DEHRA DUN,GUWAHATI,322,256,DEHRA DUN-GUWAHATI,578,All
2021,2,DEHRA DUN,HISSAR,13,10,DEHRA DUN-HISSAR,23,All
2021,3,DEHRA DUN,HISSAR,8,7,DEHRA DUN-HISSAR,15,All
2021,4,DEHRA DUN,HISSAR,7,9,DEHRA DUN-HISSAR,16,All
2021,6,DEHRA DUN,HISSAR,7,12,DEHRA DUN-HISSAR,19,All
2021,7,DEHRA DUN,HISSAR,1,5,DEHRA DUN-HISSAR,6,All
2015,12,DEHRA DUN,HYDERABAD,0,153,DEHRA DUN-HYDERABAD,153,All
2016,1,DEHRA DUN,HYDERABAD,0,345,DEHRA DUN-HYDERABAD,345,All
2016,2,DEHRA DUN,HYDERABAD,0,316,DEHRA DUN-HYDERABAD,316,All
2016,3,DEHRA DUN,HYDERABAD,446,792,DEHRA DUN-HYDERABAD,1238,All
2016,4,DEHRA DUN,HYDERABAD,669,962,DEHRA DUN-HYDERABAD,1631,All
2016,5,DEHRA DUN,HYDERABAD,946,1252,DEHRA DUN-HYDERABAD,2198,All
2016,6,DEHRA DUN,HYDERABAD,957,963,DEHRA DUN-HYDERABAD,1920,All
2016,7,DEHRA DUN,HYDERABAD,590,774,DEHRA DUN-HYDERABAD,1364,All
2016,8,DEHRA DUN,HYDERABAD,547,673,DEHRA DUN-HYDERABAD,1220,All
2016,9,DEHRA DUN,HYDERABAD,451,673,DEHRA DUN-HYDERABAD,1124,All
2016,10,DEHRA DUN,HYDERABAD,317,713,DEHRA DUN-HYDERABAD,1030,All
2016,11,DEHRA DUN,HYDERABAD,477,645,DEHRA DUN-HYDERABAD,1122,All
2016,12,DEHRA DUN,HYDERABAD,663,743,DEHRA DUN-HYDERABAD,1406,All
2017,1,DEHRA DUN,HYDERABAD,483,793,DEHRA DUN-HYDERABAD,1276,All
2017,2,DEHRA DUN,HYDERABAD,497,804,DEHRA DUN-HYDERABAD,1301,All
2017,3,DEHRA DUN,HYDERABAD,476,948,DEHRA DUN-HYDERABAD,1424,All
2017,4,DEHRA DUN,HYDERABAD,598,745,DEHRA DUN-HYDERABAD,1343,All
2017,5,DEHRA DUN,HYDERABAD,603,732,DEHRA DUN-HYDERABAD,1335,All
2017,6,DEHRA DUN,HYDERABAD,430,826,DEHRA DUN-HYDERABAD,1256,All
2017,7,DEHRA DUN,HYDERABAD,353,363,DEHRA DUN-HYDERABAD,716,All
2017,8,DEHRA DUN,HYDERABAD,362,397,DEHRA DUN-HYDERABAD,759,All
2017,9,DEHRA DUN,HYDERABAD,541,394,DEHRA DUN-HYDERABAD,935,All
2017,10,DEHRA DUN,HYDERABAD,349,346,DEHRA DUN-HYDERABAD,695,All
2017,11,DEHRA DUN,HYDERABAD,445,327,DEHRA DUN-HYDERABAD,772,All
2017,12,DEHRA DUN,HYDERABAD,645,523,DEHRA DUN-HYDERABAD,1168,All
2018,1,DEHRA DUN,HYDERABAD,580,679,DEHRA DUN-HYDERABAD,1259,All
2018,2,DEHRA DUN,HYDERABAD,626,539,DEHRA DUN-HYDERABAD,1165,All
2018,3,DEHRA DUN,HYDERABAD,935,770,DEHRA DUN-HYDERABAD,1705,All
2018,4,DEHRA DUN,HYDERABAD,586,563,DEHRA DUN-HYDERABAD,1149,All
2018,5,DEHRA DUN,HYDERABAD,897,777,DEHRA DUN-HYDERABAD,1674,All
2018,6,DEHRA DUN,HYDERABAD,897,0,DEHRA DUN-HYDERABAD,897,All
2018,7,DEHRA DUN,HYDERABAD,498,0,DEHRA DUN-HYDERABAD,498,All
2018,8,DEHRA DUN,HYDERABAD,544,0,DEHRA DUN-HYDERABAD,544,All
2018,9,DEHRA DUN,HYDERABAD,552,0,DEHRA DUN-HYDERABAD,552,All
2018,10,DEHRA DUN,HYDERABAD,1124,0,DEHRA DUN-HYDERABAD,1124,All
2018,11,DEHRA DUN,HYDERABAD,2680,2191,DEHRA DUN-HYDERABAD,4871,All
2018,12,DEHRA DUN,HYDERABAD,4954,3940,DEHRA DUN-HYDERABAD,8894,All
2019,1,DEHRA DUN,HYDERABAD,3782,3963,DEHRA DUN-HYDERABAD,7745,All
2019,2,DEHRA DUN,HYDERABAD,3233,3413,DEHRA DUN-HYDERABAD,6646,All
2019,3,DEHRA DUN,HYDERABAD,4382,4109,DEHRA DUN-HYDERABAD,8491,All
2019,4,DEHRA DUN,HYDERABAD,3392,3922,DEHRA DUN-HYDERABAD,7314,All
2019,5,DEHRA DUN,HYDERABAD,4736,3930,DEHRA DUN-HYDERABAD,8666,All
2019,6,DEHRA DUN,HYDERABAD,4713,3148,DEHRA DUN-HYDERABAD,7861,All
2019,7,DEHRA DUN,HYDERABAD,3654,3696,DEHRA DUN-HYDERABAD,7350,All
2019,9,DEHRA DUN,HYDERABAD,3278,3822,DEHRA DUN-HYDERABAD,7100,All
2019,10,DEHRA DUN,HYDERABAD,3856,3529,DEHRA DUN-HYDERABAD,7385,All
2019,11,DEHRA DUN,HYDERABAD,4689,3217,DEHRA DUN-HYDERABAD,7906,All
2019,12,DEHRA DUN,HYDERABAD,5626,3950,DEHRA DUN-HYDERABAD,9576,All
2020,1,DEHRA DUN,HYDERABAD,4761,3805,DEHRA DUN-HYDERABAD,8566,All
2020,2,DEHRA DUN,HYDERABAD,4318,3498,DEHRA DUN-HYDERABAD,7816,All
2020,3,DEHRA DUN,HYDERABAD,3573,2504,DEHRA DUN-HYDERABAD,6077,All
2020,6,DEHRA DUN,HYDERABAD,7,10,DEHRA DUN-HYDERABAD,17,All
2020,7,DEHRA DUN,HYDERABAD,97,185,DEHRA DUN-HYDERABAD,282,All
2020,8,DEHRA DUN,HYDERABAD,435,423,DEHRA DUN-HYDERABAD,858,All
2020,9,DEHRA DUN,HYDERABAD,731,958,DEHRA DUN-HYDERABAD,1689,All
2020,10,DEHRA DUN,HYDERABAD,855,980,DEHRA DUN-HYDERABAD,1835,All
2020,11,DEHRA DUN,HYDERABAD,1645,1563,DEHRA DUN-HYDERABAD,3208,All
2020,12,DEHRA DUN,HYDERABAD,2097,2220,DEHRA DUN-HYDERABAD,4317,All
2021,1,DEHRA DUN,HYDERABAD,2071,1838,DEHRA DUN-HYDERABAD,3909,All
2021,2,DEHRA DUN,HYDERABAD,2002,1993,DEHRA DUN-HYDERABAD,3995,All
2021,3,DEHRA DUN,HYDERABAD,1952,1918,DEHRA DUN-HYDERABAD,3870,All
2021,4,DEHRA DUN,HYDERABAD,58,165,DEHRA DUN-HYDERABAD,223,All
2022,3,DEHRA DUN,HYDERABAD,542,462,DEHRA DUN-HYDERABAD,1004,All
2022,4,DEHRA DUN,HYDERABAD,4015,4416,DEHRA DUN-HYDERABAD,8431,All
2022,5,DEHRA DUN,HYDERABAD,5160,4945,DEHRA DUN-HYDERABAD,10105,All
2022,6,DEHRA DUN,HYDERABAD,4865,4537,DEHRA DUN-HYDERABAD,9402,All
2022,7,DEHRA DUN,HYDERABAD,4255,3960,DEHRA DUN-HYDERABAD,8215,All
2022,8,DEHRA DUN,HYDERABAD,3648,3600,DEHRA DUN-HYDERABAD,7248,All
2022,9,DEHRA DUN,HYDERABAD,4035,4602,DEHRA DUN-HYDERABAD,8637,All
2022,10,DEHRA DUN,HYDERABAD,4722,4462,DEHRA DUN-HYDERABAD,9184,All
2022,11,DEHRA DUN,HYDERABAD,3606,3449,DEHRA DUN-HYDERABAD,7055,All
2022,12,DEHRA DUN,HYDERABAD,4420,3982,DEHRA DUN-HYDERABAD,8402,All
2023,2,DEHRA DUN,HYDERABAD,3255,4026,DEHRA DUN-HYDERABAD,7281,All
2023,3,DEHRA DUN,HYDERABAD,4725,4573,DEHRA DUN-HYDERABAD,9298,All
2023,4,DEHRA DUN,HYDERABAD,4499,4995,DEHRA DUN-HYDERABAD,9494,All
2023,5,DEHRA DUN,HYDERABAD,5512,5135,DEHRA DUN-HYDERABAD,10647,All
2019,10,DEHRA DUN,INDORE,5,0,DEHRA DUN-INDORE,5,All
2019,11,DEHRA DUN,INDORE,61,0,DEHRA DUN-INDORE,61,All
2019,12,DEHRA DUN,INDORE,175,0,DEHRA DUN-INDORE,175,All
2020,1,DEHRA DUN,INDORE,214,0,DEHRA DUN-INDORE,214,All
2020,2,DEHRA DUN,INDORE,110,0,DEHRA DUN-INDORE,110,All
2020,3,DEHRA DUN,INDORE,210,0,DEHRA DUN-INDORE,210,All
2023,5,DEHRA DUN,INDORE,36,0,DEHRA DUN-INDORE,36,All
2017,3,DEHRA DUN,JAIPUR,0,51,DEHRA DUN-JAIPUR,51,All
2017,4,DEHRA DUN,JAIPUR,0,58,DEHRA DUN-JAIPUR,58,All
2017,7,DEHRA DUN,JAIPUR,90,114,DEHRA DUN-JAIPUR,204,All
2017,8,DEHRA DUN,JAIPUR,247,172,DEHRA DUN-JAIPUR,419,All
2017,9,DEHRA DUN,JAIPUR,235,201,DEHRA DUN-JAIPUR,436,All
2017,10,DEHRA DUN,JAIPUR,198,150,DEHRA DUN-JAIPUR,348,All
2017,11,DEHRA DUN,JAIPUR,336,293,DEHRA DUN-JAIPUR,629,All
2017,12,DEHRA DUN,JAIPUR,259,227,DEHRA DUN-JAIPUR,486,All
2018,1,DEHRA DUN,JAIPUR,246,111,DEHRA DUN-JAIPUR,357,All
2018,2,DEHRA DUN,JAIPUR,418,315,DEHRA DUN-JAIPUR,733,All
2018,5,DEHRA DUN,JAIPUR,0,161,DEHRA DUN-JAIPUR,161,All
2018,6,DEHRA DUN,JAIPUR,0,71,DEHRA DUN-JAIPUR,71,All
2018,7,DEHRA DUN,JAIPUR,0,39,DEHRA DUN-JAIPUR,39,All
2018,8,DEHRA DUN,JAIPUR,0,94,DEHRA DUN-JAIPUR,94,All
2018,9,DEHRA DUN,JAIPUR,0,36,DEHRA DUN-JAIPUR,36,All
2018,10,DEHRA DUN,JAIPUR,0,1920,DEHRA DUN-JAIPUR,1920,All
2019,1,DEHRA DUN,JAIPUR,586,604,DEHRA DUN-JAIPUR,1190,All
2019,2,DEHRA DUN,JAIPUR,1462,1486,DEHRA DUN-JAIPUR,2948,All
2019,3,DEHRA DUN,JAIPUR,1623,1611,DEHRA DUN-JAIPUR,3234,All
2019,4,DEHRA DUN,JAIPUR,1833,1623,DEHRA DUN-JAIPUR,3456,All
2019,5,DEHRA DUN,JAIPUR,1988,1949,DEHRA DUN-JAIPUR,3937,All
2019,6,DEHRA DUN,JAIPUR,1982,1784,DEHRA DUN-JAIPUR,3766,All
2019,7,DEHRA DUN,JAIPUR,1887,1402,DEHRA DUN-JAIPUR,3289,All
2019,8,DEHRA DUN,JAIPUR,2016,1591,DEHRA DUN-JAIPUR,3607,All
2019,9,DEHRA DUN,JAIPUR,1632,1483,DEHRA DUN-JAIPUR,3115,All
2019,10,DEHRA DUN,JAIPUR,2065,1829,DEHRA DUN-JAIPUR,3894,All
2019,11,DEHRA DUN,JAIPUR,1841,1715,DEHRA DUN-JAIPUR,3556,All
2019,12,DEHRA DUN,JAIPUR,2096,1934,DEHRA DUN-JAIPUR,4030,All
2020,1,DEHRA DUN,JAIPUR,1759,1958,DEHRA DUN-JAIPUR,3717,All
2020,2,DEHRA DUN,JAIPUR,1567,1753,DEHRA DUN-JAIPUR,3320,All
2020,3,DEHRA DUN,JAIPUR,1049,1000,DEHRA DUN-JAIPUR,2049,All
2020,10,DEHRA DUN,JAIPUR,107,132,DEHRA DUN-JAIPUR,239,All
2020,11,DEHRA DUN,JAIPUR,408,458,DEHRA DUN-JAIPUR,866,All
2020,12,DEHRA DUN,JAIPUR,515,681,DEHRA DUN-JAIPUR,1196,All
2021,1,DEHRA DUN,JAIPUR,468,607,DEHRA DUN-JAIPUR,1075,All
2021,2,DEHRA DUN,JAIPUR,1041,1064,DEHRA DUN-JAIPUR,2105,All
2021,3,DEHRA DUN,JAIPUR,1286,1246,DEHRA DUN-JAIPUR,2532,All
2021,7,DEHRA DUN,JAIPUR,263,239,DEHRA DUN-JAIPUR,502,All
2021,8,DEHRA DUN,JAIPUR,1040,1156,DEHRA DUN-JAIPUR,2196,All
2021,9,DEHRA DUN,JAIPUR,680,908,DEHRA DUN-JAIPUR,1588,All
2021,10,DEHRA DUN,JAIPUR,1705,2311,DEHRA DUN-JAIPUR,4016,All
2021,11,DEHRA DUN,JAIPUR,1163,1046,DEHRA DUN-JAIPUR,2209,All
2021,12,DEHRA DUN,JAIPUR,1438,1148,DEHRA DUN-JAIPUR,2586,All
2022,1,DEHRA DUN,JAIPUR,693,451,DEHRA DUN-JAIPUR,1144,All
2022,3,DEHRA DUN,JAIPUR,2375,1917,DEHRA DUN-JAIPUR,4292,All
2022,4,DEHRA DUN,JAIPUR,3510,3344,DEHRA DUN-JAIPUR,6854,All
2022,5,DEHRA DUN,JAIPUR,3967,4466,DEHRA DUN-JAIPUR,8433,All
2022,6,DEHRA DUN,JAIPUR,4306,2994,DEHRA DUN-JAIPUR,7300,All
2022,7,DEHRA DUN,JAIPUR,1997,1572,DEHRA DUN-JAIPUR,3569,All
2022,8,DEHRA DUN,JAIPUR,2821,2038,DEHRA DUN-JAIPUR,4859,All
2022,9,DEHRA DUN,JAIPUR,1991,1657,DEHRA DUN-JAIPUR,3648,All
2022,10,DEHRA DUN,JAIPUR,2612,2500,DEHRA DUN-JAIPUR,5112,All
2022,11,DEHRA DUN,JAIPUR,2138,1664,DEHRA DUN-JAIPUR,3802,All
2022,12,DEHRA DUN,JAIPUR,2435,2034,DEHRA DUN-JAIPUR,4469,All
2023,2,DEHRA DUN,JAIPUR,2100,1838,DEHRA DUN-JAIPUR,3938,All
2023,3,DEHRA DUN,JAIPUR,2047,1762,DEHRA DUN-JAIPUR,3809,All
2023,4,DEHRA DUN,JAIPUR,2608,2785,DEHRA DUN-JAIPUR,5393,All
2023,5,DEHRA DUN,JAIPUR,3225,3339,DEHRA DUN-JAIPUR,6564,All
2017,5,DEHRA DUN,JAMMU,1010,936,DEHRA DUN-JAMMU,1946,All
2017,6,DEHRA DUN,JAMMU,1770,1902,DEHRA DUN-JAMMU,3672,All
2017,7,DEHRA DUN,JAMMU,1538,1502,DEHRA DUN-JAMMU,3040,All
2017,8,DEHRA DUN,JAMMU,1454,1523,DEHRA DUN-JAMMU,2977,All
2017,9,DEHRA DUN,JAMMU,1329,1307,DEHRA DUN-JAMMU,2636,All
2017,10,DEHRA DUN,JAMMU,1364,1321,DEHRA DUN-JAMMU,2685,All
2019,1,DEHRA DUN,JAMMU,176,346,DEHRA DUN-JAMMU,522,All
2019,2,DEHRA DUN,JAMMU,794,1117,DEHRA DUN-JAMMU,1911,All
2019,3,DEHRA DUN,JAMMU,817,930,DEHRA DUN-JAMMU,1747,All
2019,4,DEHRA DUN,JAMMU,955,1209,DEHRA DUN-JAMMU,2164,All
2019,5,DEHRA DUN,JAMMU,1050,951,DEHRA DUN-JAMMU,2001,All
2019,6,DEHRA DUN,JAMMU,1639,1962,DEHRA DUN-JAMMU,3601,All
2019,7,DEHRA DUN,JAMMU,1123,1573,DEHRA DUN-JAMMU,2696,All
2019,8,DEHRA DUN,JAMMU,604,822,DEHRA DUN-JAMMU,1426,All
2019,9,DEHRA DUN,JAMMU,50,87,DEHRA DUN-JAMMU,137,All
2023,3,DEHRA DUN,JAMMU,25,43,DEHRA DUN-JAMMU,68,All
2023,4,DEHRA DUN,JAMMU,404,314,DEHRA DUN-JAMMU,718,All
2023,5,DEHRA DUN,JAMMU,418,349,DEHRA DUN-JAMMU,767,All
2019,5,DEHRA DUN,KOCHI,43,0,DEHRA DUN-KOCHI,43,All
2019,6,DEHRA DUN,KOCHI,95,0,DEHRA DUN-KOCHI,95,All
2019,7,DEHRA DUN,KOCHI,55,0,DEHRA DUN-KOCHI,55,All
2019,8,DEHRA DUN,KOCHI,33,0,DEHRA DUN-KOCHI,33,All
2019,9,DEHRA DUN,KOCHI,54,0,DEHRA DUN-KOCHI,54,All
2019,10,DEHRA DUN,KOCHI,46,0,DEHRA DUN-KOCHI,46,All
2019,11,DEHRA DUN,KOCHI,21,0,DEHRA DUN-KOCHI,21,All
2019,12,DEHRA DUN,KOCHI,2,0,DEHRA DUN-KOCHI,2,All
2020,2,DEHRA DUN,KOCHI,4,0,DEHRA DUN-KOCHI,4,All
2020,3,DEHRA DUN,KOCHI,4,0,DEHRA DUN-KOCHI,4,All
2019,5,DEHRA DUN,KOLKATA,38,0,DEHRA DUN-KOLKATA,38,All
2019,10,DEHRA DUN,KOLKATA,123,180,DEHRA DUN-KOLKATA,303,All
2019,11,DEHRA DUN,KOLKATA,877,1103,DEHRA DUN-KOLKATA,1980,All
2019,12,DEHRA DUN,KOLKATA,1195,746,DEHRA DUN-KOLKATA,1941,All
2020,1,DEHRA DUN,KOLKATA,938,666,DEHRA DUN-KOLKATA,1604,All
2020,2,DEHRA DUN,KOLKATA,827,597,DEHRA DUN-KOLKATA,1424,All
2020,3,DEHRA DUN,KOLKATA,1290,462,DEHRA DUN-KOLKATA,1752,All
2020,9,DEHRA DUN,KOLKATA,236,403,DEHRA DUN-KOLKATA,639,All
2020,10,DEHRA DUN,KOLKATA,1607,1950,DEHRA DUN-KOLKATA,3557,All
2020,11,DEHRA DUN,KOLKATA,2142,2681,DEHRA DUN-KOLKATA,4823,All
2020,12,DEHRA DUN,KOLKATA,3042,3200,DEHRA DUN-KOLKATA,6242,All
2021,1,DEHRA DUN,KOLKATA,2598,2778,DEHRA DUN-KOLKATA,5376,All
2021,2,DEHRA DUN,KOLKATA,2160,2581,DEHRA DUN-KOLKATA,4741,All
2021,3,DEHRA DUN,KOLKATA,2083,2097,DEHRA DUN-KOLKATA,4180,All
2021,4,DEHRA DUN,KOLKATA,3322,1691,DEHRA DUN-KOLKATA,5013,All
2022,3,DEHRA DUN,KOLKATA,278,195,DEHRA DUN-KOLKATA,473,All
2022,4,DEHRA DUN,KOLKATA,2400,2211,DEHRA DUN-KOLKATA,4611,All
2022,5,DEHRA DUN,KOLKATA,2678,2678,DEHRA DUN-KOLKATA,5356,All
2022,6,DEHRA DUN,KOLKATA,2447,1741,DEHRA DUN-KOLKATA,4188,All
2022,7,DEHRA DUN,KOLKATA,929,800,DEHRA DUN-KOLKATA,1729,All
2022,8,DEHRA DUN,KOLKATA,1478,1419,DEHRA DUN-KOLKATA,2897,All
2022,9,DEHRA DUN,KOLKATA,1590,1626,DEHRA DUN-KOLKATA,3216,All
2022,10,DEHRA DUN,KOLKATA,2324,2393,DEHRA DUN-KOLKATA,4717,All
2023,3,DEHRA DUN,KOLKATA,452,361,DEHRA DUN-KOLKATA,813,All
2023,4,DEHRA DUN,KOLKATA,2156,2177,DEHRA DUN-KOLKATA,4333,All
2023,5,DEHRA DUN,KOLKATA,2737,2779,DEHRA DUN-KOLKATA,5516,All
2016,11,DEHRA DUN,LEH,0,2,DEHRA DUN-LEH,2,All
2017,2,DEHRA DUN,LUCKNOW,1535,1491,DEHRA DUN-LUCKNOW,3026,All
2017,3,DEHRA DUN,LUCKNOW,2595,2477,DEHRA DUN-LUCKNOW,5072,All
2017,4,DEHRA DUN,LUCKNOW,2802,2874,DEHRA DUN-LUCKNOW,5676,All
2017,7,DEHRA DUN,LUCKNOW,1314,1001,DEHRA DUN-LUCKNOW,2315,All
2017,8,DEHRA DUN,LUCKNOW,1868,1774,DEHRA DUN-LUCKNOW,3642,All
2017,9,DEHRA DUN,LUCKNOW,1307,1571,DEHRA DUN-LUCKNOW,2878,All
2017,10,DEHRA DUN,LUCKNOW,1394,1757,DEHRA DUN-LUCKNOW,3151,All
2017,11,DEHRA DUN,LUCKNOW,1851,1576,DEHRA DUN-LUCKNOW,3427,All
2017,12,DEHRA DUN,LUCKNOW,2383,2324,DEHRA DUN-LUCKNOW,4707,All
2018,1,DEHRA DUN,LUCKNOW,5393,6199,DEHRA DUN-LUCKNOW,11592,All
2018,2,DEHRA DUN,LUCKNOW,5624,5216,DEHRA DUN-LUCKNOW,10840,All
2018,3,DEHRA DUN,LUCKNOW,5559,6002,DEHRA DUN-LUCKNOW,11561,All
2018,4,DEHRA DUN,LUCKNOW,6339,6389,DEHRA DUN-LUCKNOW,12728,All
2018,5,DEHRA DUN,LUCKNOW,5798,6702,DEHRA DUN-LUCKNOW,12500,All
2018,6,DEHRA DUN,LUCKNOW,6518,6815,DEHRA DUN-LUCKNOW,13333,All
2018,7,DEHRA DUN,LUCKNOW,5074,5794,DEHRA DUN-LUCKNOW,10868,All
2018,8,DEHRA DUN,LUCKNOW,4190,4706,DEHRA DUN-LUCKNOW,8896,All
2018,9,DEHRA DUN,LUCKNOW,4784,5314,DEHRA DUN-LUCKNOW,10098,All
2018,10,DEHRA DUN,LUCKNOW,4916,4284,DEHRA DUN-LUCKNOW,9200,All
2018,11,DEHRA DUN,LUCKNOW,4322,4734,DEHRA DUN-LUCKNOW,9056,All
2018,12,DEHRA DUN,LUCKNOW,4680,4847,DEHRA DUN-LUCKNOW,9527,All
2019,1,DEHRA DUN,LUCKNOW,4212,5137,DEHRA DUN-LUCKNOW,9349,All
2019,2,DEHRA DUN,LUCKNOW,3821,4612,DEHRA DUN-LUCKNOW,8433,All
2019,3,DEHRA DUN,LUCKNOW,4364,4891,DEHRA DUN-LUCKNOW,9255,All
2019,4,DEHRA DUN,LUCKNOW,4405,4671,DEHRA DUN-LUCKNOW,9076,All
2019,5,DEHRA DUN,LUCKNOW,4842,5094,DEHRA DUN-LUCKNOW,9936,All
2019,6,DEHRA DUN,LUCKNOW,5151,5065,DEHRA DUN-LUCKNOW,10216,All
2019,7,DEHRA DUN,LUCKNOW,4055,4467,DEHRA DUN-LUCKNOW,8522,All
2019,8,DEHRA DUN,LUCKNOW,3931,3995,DEHRA DUN-LUCKNOW,7926,All
2019,9,DEHRA DUN,LUCKNOW,4022,3896,DEHRA DUN-LUCKNOW,7918,All
2019,10,DEHRA DUN,LUCKNOW,4801,3867,DEHRA DUN-LUCKNOW,8668,All
2019,11,DEHRA DUN,LUCKNOW,4179,4030,DEHRA DUN-LUCKNOW,8209,All
2019,12,DEHRA DUN,LUCKNOW,3478,3434,DEHRA DUN-LUCKNOW,6912,All
2020,1,DEHRA DUN,LUCKNOW,3502,3637,DEHRA DUN-LUCKNOW,7139,All
2020,2,DEHRA DUN,LUCKNOW,3594,3597,DEHRA DUN-LUCKNOW,7191,All
2020,3,DEHRA DUN,LUCKNOW,2920,2114,DEHRA DUN-LUCKNOW,5034,All
2020,6,DEHRA DUN,LUCKNOW,213,134,DEHRA DUN-LUCKNOW,347,All
2020,8,DEHRA DUN,LUCKNOW,190,298,DEHRA DUN-LUCKNOW,488,All
2020,9,DEHRA DUN,LUCKNOW,824,869,DEHRA DUN-LUCKNOW,1693,All
2020,10,DEHRA DUN,LUCKNOW,2100,2566,DEHRA DUN-LUCKNOW,4666,All
2020,11,DEHRA DUN,LUCKNOW,3920,4042,DEHRA DUN-LUCKNOW,7962,All
2020,12,DEHRA DUN,LUCKNOW,3749,4683,DEHRA DUN-LUCKNOW,8432,All
2021,1,DEHRA DUN,LUCKNOW,3657,4338,DEHRA DUN-LUCKNOW,7995,All
2021,2,DEHRA DUN,LUCKNOW,3019,4091,DEHRA DUN-LUCKNOW,7110,All
2021,3,DEHRA DUN,LUCKNOW,2856,3812,DEHRA DUN-LUCKNOW,6668,All
2021,4,DEHRA DUN,LUCKNOW,86,28,DEHRA DUN-LUCKNOW,114,All
2021,6,DEHRA DUN,LUCKNOW,0,12,DEHRA DUN-LUCKNOW,12,All
2021,7,DEHRA DUN,LUCKNOW,1350,1549,DEHRA DUN-LUCKNOW,2899,All
2021,8,DEHRA DUN,LUCKNOW,1314,1550,DEHRA DUN-LUCKNOW,2864,All
2021,9,DEHRA DUN,LUCKNOW,1513,1907,DEHRA DUN-LUCKNOW,3420,All
2021,10,DEHRA DUN,LUCKNOW,3689,3658,DEHRA DUN-LUCKNOW,7347,All
2021,11,DEHRA DUN,LUCKNOW,4344,4298,DEHRA DUN-LUCKNOW,8642,All
2021,12,DEHRA DUN,LUCKNOW,4116,4099,DEHRA DUN-LUCKNOW,8215,All
2022,1,DEHRA DUN,LUCKNOW,1945,1604,DEHRA DUN-LUCKNOW,3549,All
2022,2,DEHRA DUN,LUCKNOW,1889,2141,DEHRA DUN-LUCKNOW,4030,All
2022,3,DEHRA DUN,LUCKNOW,3767,3944,DEHRA DUN-LUCKNOW,7711,All
2022,4,DEHRA DUN,LUCKNOW,3966,4382,DEHRA DUN-LUCKNOW,8348,All
2022,5,DEHRA DUN,LUCKNOW,4374,4425,DEHRA DUN-LUCKNOW,8799,All
2022,6,DEHRA DUN,LUCKNOW,4460,4148,DEHRA DUN-LUCKNOW,8608,All
2022,7,DEHRA DUN,LUCKNOW,3111,3815,DEHRA DUN-LUCKNOW,6926,All
2022,8,DEHRA DUN,LUCKNOW,2968,3404,DEHRA DUN-LUCKNOW,6372,All
2022,9,DEHRA DUN,LUCKNOW,2943,3556,DEHRA DUN-LUCKNOW,6499,All
2022,10,DEHRA DUN,LUCKNOW,4730,5032,DEHRA DUN-LUCKNOW,9762,All
2022,11,DEHRA DUN,LUCKNOW,5124,4631,DEHRA DUN-LUCKNOW,9755,All
2022,12,DEHRA DUN,LUCKNOW,5115,4269,DEHRA DUN-LUCKNOW,9384,All
2023,2,DEHRA DUN,LUCKNOW,4745,4645,DEHRA DUN-LUCKNOW,9390,All
2023,3,DEHRA DUN,LUCKNOW,4983,5423,DEHRA DUN-LUCKNOW,10406,All
2023,4,DEHRA DUN,LUCKNOW,4956,4672,DEHRA DUN-LUCKNOW,9628,All
2023,5,DEHRA DUN,LUCKNOW,5066,4945,DEHRA DUN-LUCKNOW,10011,All
2016,6,DEHRA DUN,MADURAI,4,0,DEHRA DUN-MADURAI,4,All
2016,7,DEHRA DUN,MADURAI,7,0,DEHRA DUN-MADURAI,7,All
2016,8,DEHRA DUN,MADURAI,5,0,DEHRA DUN-MADURAI,5,All
2016,9,DEHRA DUN,MADURAI,9,0,DEHRA DUN-MADURAI,9,All
2016,10,DEHRA DUN,MADURAI,7,0,DEHRA DUN-MADURAI,7,All
2016,11,DEHRA DUN,MADURAI,10,0,DEHRA DUN-MADURAI,10,All
2016,12,DEHRA DUN,MADURAI,15,0,DEHRA DUN-MADURAI,15,All
2017,1,DEHRA DUN,MADURAI,3,0,DEHRA DUN-MADURAI,3,All
2017,2,DEHRA DUN,MADURAI,4,0,DEHRA DUN-MADURAI,4,All
2017,11,DEHRA DUN,MADURAI,13,0,DEHRA DUN-MADURAI,13,All
2017,12,DEHRA DUN,MADURAI,19,0,DEHRA DUN-MADURAI,19,All
2018,1,DEHRA DUN,MADURAI,73,0,DEHRA DUN-MADURAI,73,All
2018,2,DEHRA DUN,MADURAI,64,0,DEHRA DUN-MADURAI,64,All
2018,3,DEHRA DUN,MADURAI,94,0,DEHRA DUN-MADURAI,94,All
2018,4,DEHRA DUN,MADURAI,63,0,DEHRA DUN-MADURAI,63,All
2018,5,DEHRA DUN,MADURAI,44,0,DEHRA DUN-MADURAI,44,All
2018,6,DEHRA DUN,MADURAI,51,0,DEHRA DUN-MADURAI,51,All
2018,7,DEHRA DUN,MADURAI,57,0,DEHRA DUN-MADURAI,57,All
2018,8,DEHRA DUN,MADURAI,49,0,DEHRA DUN-MADURAI,49,All
2018,9,DEHRA DUN,MADURAI,66,0,DEHRA DUN-MADURAI,66,All
2019,5,DEHRA DUN,MUMBAI,11257,9672,DEHRA DUN-MUMBAI,20929,All
2019,6,DEHRA DUN,MUMBAI,14576,12004,DEHRA DUN-MUMBAI,26580,All
2019,7,DEHRA DUN,MUMBAI,9620,9224,DEHRA DUN-MUMBAI,18844,All
2019,8,DEHRA DUN,MUMBAI,9733,10111,DEHRA DUN-MUMBAI,19844,All
2019,9,DEHRA DUN,MUMBAI,11246,11481,DEHRA DUN-MUMBAI,22727,All
2019,10,DEHRA DUN,MUMBAI,12942,14622,DEHRA DUN-MUMBAI,27564,All
2019,11,DEHRA DUN,MUMBAI,16412,14774,DEHRA DUN-MUMBAI,31186,All
2019,12,DEHRA DUN,MUMBAI,16240,15136,DEHRA DUN-MUMBAI,31376,All
2020,1,DEHRA DUN,MUMBAI,14515,15278,DEHRA DUN-MUMBAI,29793,All
2020,2,DEHRA DUN,MUMBAI,13518,14709,DEHRA DUN-MUMBAI,28227,All
2020,3,DEHRA DUN,MUMBAI,10309,9951,DEHRA DUN-MUMBAI,20260,All
2020,5,DEHRA DUN,MUMBAI,43,303,DEHRA DUN-MUMBAI,346,All
2020,6,DEHRA DUN,MUMBAI,206,639,DEHRA DUN-MUMBAI,845,All
2020,7,DEHRA DUN,MUMBAI,644,1490,DEHRA DUN-MUMBAI,2134,All
2020,8,DEHRA DUN,MUMBAI,987,1343,DEHRA DUN-MUMBAI,2330,All
2020,9,DEHRA DUN,MUMBAI,2124,2616,DEHRA DUN-MUMBAI,4740,All
2020,10,DEHRA DUN,MUMBAI,3625,6314,DEHRA DUN-MUMBAI,9939,All
2020,11,DEHRA DUN,MUMBAI,8207,9874,DEHRA DUN-MUMBAI,18081,All
2020,12,DEHRA DUN,MUMBAI,9653,9685,DEHRA DUN-MUMBAI,19338,All
2021,1,DEHRA DUN,MUMBAI,10611,11690,DEHRA DUN-MUMBAI,22301,All
2021,2,DEHRA DUN,MUMBAI,11248,13820,DEHRA DUN-MUMBAI,25068,All
2021,3,DEHRA DUN,MUMBAI,10744,14529,DEHRA DUN-MUMBAI,25273,All
2021,4,DEHRA DUN,MUMBAI,5880,7935,DEHRA DUN-MUMBAI,13815,All
2021,6,DEHRA DUN,MUMBAI,2673,3438,DEHRA DUN-MUMBAI,6111,All
2021,7,DEHRA DUN,MUMBAI,4396,5256,DEHRA DUN-MUMBAI,9652,All
2021,8,DEHRA DUN,MUMBAI,5296,6494,DEHRA DUN-MUMBAI,11790,All
2021,9,DEHRA DUN,MUMBAI,6377,7914,DEHRA DUN-MUMBAI,14291,All
2021,10,DEHRA DUN,MUMBAI,8994,9541,DEHRA DUN-MUMBAI,18535,All
2021,11,DEHRA DUN,MUMBAI,12255,12305,DEHRA DUN-MUMBAI,24560,All
2021,12,DEHRA DUN,MUMBAI,13793,15513,DEHRA DUN-MUMBAI,29306,All
2022,1,DEHRA DUN,MUMBAI,8629,9271,DEHRA DUN-MUMBAI,17900,All
2022,2,DEHRA DUN,MUMBAI,8916,11008,DEHRA DUN-MUMBAI,19924,All
2022,3,DEHRA DUN,MUMBAI,16627,17539,DEHRA DUN-MUMBAI,34166,All
2022,4,DEHRA DUN,MUMBAI,14461,15928,DEHRA DUN-MUMBAI,30389,All
2022,5,DEHRA DUN,MUMBAI,18317,19856,DEHRA DUN-MUMBAI,38173,All
2022,6,DEHRA DUN,MUMBAI,13091,12407,DEHRA DUN-MUMBAI,25498,All
2022,7,DEHRA DUN,MUMBAI,9151,10648,DEHRA DUN-MUMBAI,19799,All
2022,8,DEHRA DUN,MUMBAI,9664,11222,DEHRA DUN-MUMBAI,20886,All
2022,9,DEHRA DUN,MUMBAI,12089,14923,DEHRA DUN-MUMBAI,27012,All
2022,10,DEHRA DUN,MUMBAI,16895,18730,DEHRA DUN-MUMBAI,35625,All
2022,11,DEHRA DUN,MUMBAI,13784,13183,DEHRA DUN-MUMBAI,26967,All
2022,12,DEHRA DUN,MUMBAI,15351,14633,DEHRA DUN-MUMBAI,29984,All
2018,10,DEHRA DUN,NAGPUR,1,0,DEHRA DUN-NAGPUR,1,All
2018,11,DEHRA DUN,NAGPUR,17,0,DEHRA DUN-NAGPUR,17,All
2021,11,DEHRA DUN,NAGPUR,0,66,DEHRA DUN-NAGPUR,66,All
2019,1,DEHRA DUN,PANTNAGAR,284,366,DEHRA DUN-PANTNAGAR,650,All
2019,2,DEHRA DUN,PANTNAGAR,249,305,DEHRA DUN-PANTNAGAR,554,All
2019,3,DEHRA DUN,PANTNAGAR,495,475,DEHRA DUN-PANTNAGAR,970,All
2019,4,DEHRA DUN,PANTNAGAR,287,374,DEHRA DUN-PANTNAGAR,661,All
2019,5,DEHRA DUN,PANTNAGAR,487,535,DEHRA DUN-PANTNAGAR,1022,All
2019,6,DEHRA DUN,PANTNAGAR,1014,1021,DEHRA DUN-PANTNAGAR,2035,All
2019,7,DEHRA DUN,PANTNAGAR,260,274,DEHRA DUN-PANTNAGAR,534,All
2019,8,DEHRA DUN,PANTNAGAR,317,319,DEHRA DUN-PANTNAGAR,636,All
2019,9,DEHRA DUN,PANTNAGAR,415,393,DEHRA DUN-PANTNAGAR,808,All
2019,10,DEHRA DUN,PANTNAGAR,849,830,DEHRA DUN-PANTNAGAR,1679,All
2019,11,DEHRA DUN,PANTNAGAR,635,612,DEHRA DUN-PANTNAGAR,1247,All
2019,12,DEHRA DUN,PANTNAGAR,526,515,DEHRA DUN-PANTNAGAR,1041,All
2020,1,DEHRA DUN,PANTNAGAR,587,595,DEHRA DUN-PANTNAGAR,1182,All
2020,2,DEHRA DUN,PANTNAGAR,516,527,DEHRA DUN-PANTNAGAR,1043,All
2020,3,DEHRA DUN,PANTNAGAR,492,416,DEHRA DUN-PANTNAGAR,908,All
2020,5,DEHRA DUN,PANTNAGAR,15,41,DEHRA DUN-PANTNAGAR,56,All
2020,6,DEHRA DUN,PANTNAGAR,119,476,DEHRA DUN-PANTNAGAR,595,All
2020,7,DEHRA DUN,PANTNAGAR,297,275,DEHRA DUN-PANTNAGAR,572,All
2020,8,DEHRA DUN,PANTNAGAR,292,439,DEHRA DUN-PANTNAGAR,731,All
2020,9,DEHRA DUN,PANTNAGAR,238,374,DEHRA DUN-PANTNAGAR,612,All
2020,10,DEHRA DUN,PANTNAGAR,451,531,DEHRA DUN-PANTNAGAR,982,All
2020,11,DEHRA DUN,PANTNAGAR,736,684,DEHRA DUN-PANTNAGAR,1420,All
2020,12,DEHRA DUN,PANTNAGAR,219,145,DEHRA DUN-PANTNAGAR,364,All
2021,2,DEHRA DUN,PANTNAGAR,121,121,DEHRA DUN-PANTNAGAR,242,All
2021,3,DEHRA DUN,PANTNAGAR,577,458,DEHRA DUN-PANTNAGAR,1035,All
2021,4,DEHRA DUN,PANTNAGAR,396,406,DEHRA DUN-PANTNAGAR,802,All
2021,6,DEHRA DUN,PANTNAGAR,102,98,DEHRA DUN-PANTNAGAR,200,All
2021,7,DEHRA DUN,PANTNAGAR,154,106,DEHRA DUN-PANTNAGAR,260,All
2021,8,DEHRA DUN,PANTNAGAR,237,239,DEHRA DUN-PANTNAGAR,476,All
2021,9,DEHRA DUN,PANTNAGAR,404,349,DEHRA DUN-PANTNAGAR,753,All
2021,10,DEHRA DUN,PANTNAGAR,650,508,DEHRA DUN-PANTNAGAR,1158,All
2021,11,DEHRA DUN,PANTNAGAR,777,762,DEHRA DUN-PANTNAGAR,1539,All
2021,12,DEHRA DUN,PANTNAGAR,592,596,DEHRA DUN-PANTNAGAR,1188,All
2022,1,DEHRA DUN,PANTNAGAR,263,229,DEHRA DUN-PANTNAGAR,492,All
2022,2,DEHRA DUN,PANTNAGAR,294,273,DEHRA DUN-PANTNAGAR,567,All
2022,3,DEHRA DUN,PANTNAGAR,587,561,DEHRA DUN-PANTNAGAR,1148,All
2022,4,DEHRA DUN,PANTNAGAR,1651,1586,DEHRA DUN-PANTNAGAR,3237,All
2022,5,DEHRA DUN,PANTNAGAR,1085,1115,DEHRA DUN-PANTNAGAR,2200,All
2022,6,DEHRA DUN,PANTNAGAR,1171,1302,DEHRA DUN-PANTNAGAR,2473,All
2022,7,DEHRA DUN,PANTNAGAR,545,572,DEHRA DUN-PANTNAGAR,1117,All
2022,8,DEHRA DUN,PANTNAGAR,723,790,DEHRA DUN-PANTNAGAR,1513,All
2022,9,DEHRA DUN,PANTNAGAR,943,987,DEHRA DUN-PANTNAGAR,1930,All
2022,10,DEHRA DUN,PANTNAGAR,242,230,DEHRA DUN-PANTNAGAR,472,All
2018,5,DEHRA DUN,PATNA,406,0,DEHRA DUN-PATNA,406,All
2018,6,DEHRA DUN,PATNA,252,0,DEHRA DUN-PATNA,252,All
2018,7,DEHRA DUN,PATNA,119,0,DEHRA DUN-PATNA,119,All
2018,8,DEHRA DUN,PATNA,153,0,DEHRA DUN-PATNA,153,All
2018,9,DEHRA DUN,PATNA,57,0,DEHRA DUN-PATNA,57,All
2018,10,DEHRA DUN,PATNA,467,0,DEHRA DUN-PATNA,467,All
2022,10,DEHRA DUN,PATNA,0,5,DEHRA DUN-PATNA,5,All
2022,11,DEHRA DUN,PATNA,0,243,DEHRA DUN-PATNA,243,All
2022,12,DEHRA DUN,PATNA,0,108,DEHRA DUN-PATNA,108,All
2023,2,DEHRA DUN,PATNA,0,458,DEHRA DUN-PATNA,458,All
2023,3,DEHRA DUN,PATNA,0,387,DEHRA DUN-PATNA,387,All
2019,1,DEHRA DUN,PITHORAGARH,80,79,DEHRA DUN-PITHORAGARH,159,All
2019,2,DEHRA DUN,PITHORAGARH,88,76,DEHRA DUN-PITHORAGARH,164,All
2019,9,DEHRA DUN,PITHORAGARH,252,268,DEHRA DUN-PITHORAGARH,520,All
2019,10,DEHRA DUN,PITHORAGARH,388,370,DEHRA DUN-PITHORAGARH,758,All
2019,11,DEHRA DUN,PITHORAGARH,76,82,DEHRA DUN-PITHORAGARH,158,All
2019,12,DEHRA DUN,PITHORAGARH,383,379,DEHRA DUN-PITHORAGARH,762,All
2020,1,DEHRA DUN,PITHORAGARH,227,285,DEHRA DUN-PITHORAGARH,512,All
2020,2,DEHRA DUN,PITHORAGARH,219,231,DEHRA DUN-PITHORAGARH,450,All
2020,3,DEHRA DUN,PITHORAGARH,135,134,DEHRA DUN-PITHORAGARH,269,All
2018,5,DEHRA DUN,PORT BLAIR,8,0,DEHRA DUN-PORT BLAIR,8,All
2022,3,DEHRA DUN,PUNE,106,47,DEHRA DUN-PUNE,153,All
2022,4,DEHRA DUN,PUNE,657,692,DEHRA DUN-PUNE,1349,All
2022,5,DEHRA DUN,PUNE,772,660,DEHRA DUN-PUNE,1432,All
2022,6,DEHRA DUN,PUNE,920,1030,DEHRA DUN-PUNE,1950,All
2022,7,DEHRA DUN,PUNE,759,1054,DEHRA DUN-PUNE,1813,All
2022,8,DEHRA DUN,PUNE,962,1053,DEHRA DUN-PUNE,2015,All
2022,9,DEHRA DUN,PUNE,802,1057,DEHRA DUN-PUNE,1859,All
2022,10,DEHRA DUN,PUNE,802,1011,DEHRA DUN-PUNE,1813,All
2022,11,DEHRA DUN,PUNE,893,0,DEHRA DUN-PUNE,893,All
2022,12,DEHRA DUN,PUNE,1053,0,DEHRA DUN-PUNE,1053,All
2023,2,DEHRA DUN,PUNE,3254,3153,DEHRA DUN-PUNE,6407,All
2023,3,DEHRA DUN,PUNE,3925,3769,DEHRA DUN-PUNE,7694,All
2023,4,DEHRA DUN,PUNE,3517,3750,DEHRA DUN-PUNE,7267,All
2023,5,DEHRA DUN,PUNE,4774,4807,DEHRA DUN-PUNE,9581,All
2017,12,DEHRA DUN,RAIPUR,37,0,DEHRA DUN-RAIPUR,37,All
2018,1,DEHRA DUN,RAIPUR,198,0,DEHRA DUN-RAIPUR,198,All
2018,2,DEHRA DUN,RAIPUR,247,0,DEHRA DUN-RAIPUR,247,All
2018,3,DEHRA DUN,RAIPUR,397,0,DEHRA DUN-RAIPUR,397,All
2018,4,DEHRA DUN,RAIPUR,394,0,DEHRA DUN-RAIPUR,394,All
2018,5,DEHRA DUN,RAIPUR,587,0,DEHRA DUN-RAIPUR,587,All
2018,6,DEHRA DUN,RAIPUR,352,0,DEHRA DUN-RAIPUR,352,All
2018,7,DEHRA DUN,RAIPUR,108,0,DEHRA DUN-RAIPUR,108,All
2018,10,DEHRA DUN,SHIRDI,11,0,DEHRA DUN-SHIRDI,11,All
2016,12,DEHRA DUN,SRINAGAR,0,259,DEHRA DUN-SRINAGAR,259,All
2017,1,DEHRA DUN,SRINAGAR,0,493,DEHRA DUN-SRINAGAR,493,All
2017,2,DEHRA DUN,SRINAGAR,0,546,DEHRA DUN-SRINAGAR,546,All
2017,3,DEHRA DUN,SRINAGAR,98,251,DEHRA DUN-SRINAGAR,349,All
2017,4,DEHRA DUN,SRINAGAR,872,1277,DEHRA DUN-SRINAGAR,2149,All
2017,5,DEHRA DUN,SRINAGAR,1239,1048,DEHRA DUN-SRINAGAR,2287,All
2017,6,DEHRA DUN,SRINAGAR,1814,1124,DEHRA DUN-SRINAGAR,2938,All
2017,7,DEHRA DUN,SRINAGAR,1705,2718,DEHRA DUN-SRINAGAR,4423,All
2017,8,DEHRA DUN,SRINAGAR,1032,1622,DEHRA DUN-SRINAGAR,2654,All
2017,9,DEHRA DUN,SRINAGAR,905,1952,DEHRA DUN-SRINAGAR,2857,All
2017,10,DEHRA DUN,SRINAGAR,1250,1629,DEHRA DUN-SRINAGAR,2879,All
2017,11,DEHRA DUN,SRINAGAR,1038,1743,DEHRA DUN-SRINAGAR,2781,All
2017,12,DEHRA DUN,SRINAGAR,1952,2560,DEHRA DUN-SRINAGAR,4512,All
2018,1,DEHRA DUN,SRINAGAR,2174,2917,DEHRA DUN-SRINAGAR,5091,All
2018,2,DEHRA DUN,SRINAGAR,2680,2848,DEHRA DUN-SRINAGAR,5528,All
2018,3,DEHRA DUN,SRINAGAR,2527,1337,DEHRA DUN-SRINAGAR,3864,All
2015,4,DEHRA DUN,TRIVANDRUM,149,108,DEHRA DUN-TRIVANDRUM,257,All
2015,5,DEHRA DUN,TRIVANDRUM,88,107,DEHRA DUN-TRIVANDRUM,195,All
2015,6,DEHRA DUN,TRIVANDRUM,136,142,DEHRA DUN-TRIVANDRUM,278,All
2015,7,DEHRA DUN,TRIVANDRUM,68,98,DEHRA DUN-TRIVANDRUM,166,All
2015,8,DEHRA DUN,TRIVANDRUM,97,87,DEHRA DUN-TRIVANDRUM,184,All
2015,9,DEHRA DUN,TRIVANDRUM,49,38,DEHRA DUN-TRIVANDRUM,87,All
2015,10,DEHRA DUN,TRIVANDRUM,81,67,DEHRA DUN-TRIVANDRUM,148,All
2015,11,DEHRA DUN,TRIVANDRUM,66,51,DEHRA DUN-TRIVANDRUM,117,All
2015,12,DEHRA DUN,TRIVANDRUM,111,60,DEHRA DUN-TRIVANDRUM,171,All
2016,1,DEHRA DUN,TRIVANDRUM,104,125,DEHRA DUN-TRIVANDRUM,229,All
2016,2,DEHRA DUN,TRIVANDRUM,95,78,DEHRA DUN-TRIVANDRUM,173,All
2016,3,DEHRA DUN,TRIVANDRUM,47,46,DEHRA DUN-TRIVANDRUM,93,All
2019,9,DEHRA DUN,VARANASI,111,108,DEHRA DUN-VARANASI,219,All
2019,10,DEHRA DUN,VARANASI,853,858,DEHRA DUN-VARANASI,1711,All
2019,11,DEHRA DUN,VARANASI,905,946,DEHRA DUN-VARANASI,1851,All
2019,12,DEHRA DUN,VARANASI,787,704,DEHRA DUN-VARANASI,1491,All
2020,1,DEHRA DUN,VARANASI,614,747,DEHRA DUN-VARANASI,1361,All
2020,2,DEHRA DUN,VARANASI,787,798,DEHRA DUN-VARANASI,1585,All
2020,3,DEHRA DUN,VARANASI,505,468,DEHRA DUN-VARANASI,973,All
2021,3,DEHRA DUN,VARANASI,0,7,DEHRA DUN-VARANASI,7,All
2021,4,DEHRA DUN,VARANASI,0,43,DEHRA DUN-VARANASI,43,All
2021,8,DEHRA DUN,VARANASI,326,250,DEHRA DUN-VARANASI,576,All
2021,9,DEHRA DUN,VARANASI,977,729,DEHRA DUN-VARANASI,1706,All
2021,10,DEHRA DUN,VARANASI,1409,1063,DEHRA DUN-VARANASI,2472,All
2022,3,DEHRA DUN,VARANASI,1162,1241,DEHRA DUN-VARANASI,2403,All
2022,4,DEHRA DUN,VARANASI,1193,1098,DEHRA DUN-VARANASI,2291,All
2022,5,DEHRA DUN,VARANASI,1308,1347,DEHRA DUN-VARANASI,2655,All
2022,6,DEHRA DUN,VARANASI,1329,1414,DEHRA DUN-VARANASI,2743,All
2022,7,DEHRA DUN,VARANASI,798,867,DEHRA DUN-VARANASI,1665,All
2022,8,DEHRA DUN,VARANASI,906,991,DEHRA DUN-VARANASI,1897,All
2022,9,DEHRA DUN,VARANASI,1052,851,DEHRA DUN-VARANASI,1903,All
2022,10,DEHRA DUN,VARANASI,1358,1215,DEHRA DUN-VARANASI,2573,All
2015,4,DELHI,AGARTALA,1180,1572,AGARTALA-DELHI,2752,All
2015,5,DELHI,AGARTALA,1550,1467,AGARTALA-DELHI,3017,All
2015,6,DELHI,AGARTALA,1523,1742,AGARTALA-DELHI,3265,All
2015,7,DELHI,AGARTALA,1289,1838,AGARTALA-DELHI,3127,All
2015,8,DELHI,AGARTALA,1212,1952,AGARTALA-DELHI,3164,All
2015,9,DELHI,AGARTALA,1534,1774,AGARTALA-DELHI,3308,All
2015,10,DELHI,AGARTALA,2535,2451,AGARTALA-DELHI,4986,All
2015,11,DELHI,AGARTALA,2901,3599,AGARTALA-DELHI,6500,All
2015,12,DELHI,AGARTALA,3271,2843,AGARTALA-DELHI,6114,All
2016,1,DELHI,AGARTALA,2590,2960,AGARTALA-DELHI,5550,All
2016,2,DELHI,AGARTALA,2173,2867,AGARTALA-DELHI,5040,All
2016,3,DELHI,AGARTALA,2400,3134,AGARTALA-DELHI,5534,All
2016,4,DELHI,AGARTALA,3009,3194,AGARTALA-DELHI,6203,All
2016,5,DELHI,AGARTALA,3820,3354,AGARTALA-DELHI,7174,All
2016,6,DELHI,AGARTALA,3507,2621,AGARTALA-DELHI,6128,All
2016,7,DELHI,AGARTALA,1991,1887,AGARTALA-DELHI,3878,All
2016,8,DELHI,AGARTALA,2175,2176,AGARTALA-DELHI,4351,All
2016,9,DELHI,AGARTALA,1727,1442,AGARTALA-DELHI,3169,All
2016,10,DELHI,AGARTALA,2471,2458,AGARTALA-DELHI,4929,All
2016,11,DELHI,AGARTALA,2597,2486,AGARTALA-DELHI,5083,All
2016,12,DELHI,AGARTALA,3396,2850,AGARTALA-DELHI,6246,All
2017,1,DELHI,AGARTALA,2861,2404,AGARTALA-DELHI,5265,All
2017,2,DELHI,AGARTALA,2098,2292,AGARTALA-DELHI,4390,All
2017,3,DELHI,AGARTALA,2041,2146,AGARTALA-DELHI,4187,All
2017,4,DELHI,AGARTALA,1691,1882,AGARTALA-DELHI,3573,All
2017,5,DELHI,AGARTALA,1744,1595,AGARTALA-DELHI,3339,All
2017,6,DELHI,AGARTALA,2080,1667,AGARTALA-DELHI,3747,All
2017,7,DELHI,AGARTALA,1941,2026,AGARTALA-DELHI,3967,All
2017,8,DELHI,AGARTALA,2255,2478,AGARTALA-DELHI,4733,All
2017,9,DELHI,AGARTALA,1649,1661,AGARTALA-DELHI,3310,All
2017,10,DELHI,AGARTALA,1744,1338,AGARTALA-DELHI,3082,All
2017,11,DELHI,AGARTALA,2232,2070,AGARTALA-DELHI,4302,All
2017,12,DELHI,AGARTALA,2803,2331,AGARTALA-DELHI,5134,All
2018,1,DELHI,AGARTALA,1981,1784,AGARTALA-DELHI,3765,All
2018,2,DELHI,AGARTALA,1546,1683,AGARTALA-DELHI,3229,All
2018,3,DELHI,AGARTALA,1822,1463,AGARTALA-DELHI,3285,All
2018,4,DELHI,AGARTALA,2040,1680,AGARTALA-DELHI,3720,All
2018,5,DELHI,AGARTALA,2524,2018,AGARTALA-DELHI,4542,All
2018,6,DELHI,AGARTALA,2030,2407,AGARTALA-DELHI,4437,All
2018,7,DELHI,AGARTALA,2190,2512,AGARTALA-DELHI,4702,All
2018,8,DELHI,AGARTALA,2649,3244,AGARTALA-DELHI,5893,All
2018,9,DELHI,AGARTALA,2256,2167,AGARTALA-DELHI,4423,All
2018,10,DELHI,AGARTALA,1921,2039,AGARTALA-DELHI,3960,All
2018,11,DELHI,AGARTALA,1987,1229,AGARTALA-DELHI,3216,All
2018,12,DELHI,AGARTALA,1813,2031,AGARTALA-DELHI,3844,All
2019,1,DELHI,AGARTALA,1950,1634,AGARTALA-DELHI,3584,All
2019,2,DELHI,AGARTALA,1541,1453,AGARTALA-DELHI,2994,All
2019,3,DELHI,AGARTALA,1943,2022,AGARTALA-DELHI,3965,All
2019,4,DELHI,AGARTALA,2705,2786,AGARTALA-DELHI,5491,All
2018,10,DELHI,AJMER,1517,1744,AJMER-DELHI,3261,All
2018,11,DELHI,AJMER,2247,2247,AJMER-DELHI,4494,All
2018,12,DELHI,AJMER,2052,2178,AJMER-DELHI,4230,All
2019,1,DELHI,AJMER,1865,1990,AJMER-DELHI,3855,All
2019,2,DELHI,AJMER,1961,2054,AJMER-DELHI,4015,All
2019,3,DELHI,AJMER,2114,2163,AJMER-DELHI,4277,All
2019,4,DELHI,AJMER,2092,2205,AJMER-DELHI,4297,All
2015,4,DELHI,ALLAHABAD,2532,2204,ALLAHABAD-DELHI,4736,All
2015,5,DELHI,ALLAHABAD,3688,3472,ALLAHABAD-DELHI,7160,All
2015,6,DELHI,ALLAHABAD,2411,2934,ALLAHABAD-DELHI,5345,All
2015,7,DELHI,ALLAHABAD,1960,2100,ALLAHABAD-DELHI,4060,All
2015,8,DELHI,ALLAHABAD,1681,1812,ALLAHABAD-DELHI,3493,All
2015,9,DELHI,ALLAHABAD,1685,1750,ALLAHABAD-DELHI,3435,All
2015,10,DELHI,ALLAHABAD,1894,2027,ALLAHABAD-DELHI,3921,All
2015,11,DELHI,ALLAHABAD,1941,1882,ALLAHABAD-DELHI,3823,All
2015,12,DELHI,ALLAHABAD,1861,1866,ALLAHABAD-DELHI,3727,All
2016,1,DELHI,ALLAHABAD,1563,1501,ALLAHABAD-DELHI,3064,All
2016,2,DELHI,ALLAHABAD,1738,1677,ALLAHABAD-DELHI,3415,All
2016,3,DELHI,ALLAHABAD,1784,1732,ALLAHABAD-DELHI,3516,All
2016,4,DELHI,ALLAHABAD,1731,1606,ALLAHABAD-DELHI,3337,All
2016,5,DELHI,ALLAHABAD,1518,1614,ALLAHABAD-DELHI,3132,All
2016,6,DELHI,ALLAHABAD,1617,1474,ALLAHABAD-DELHI,3091,All
2016,7,DELHI,ALLAHABAD,1847,1658,ALLAHABAD-DELHI,3505,All
2016,8,DELHI,ALLAHABAD,1982,2014,ALLAHABAD-DELHI,3996,All
2016,9,DELHI,ALLAHABAD,1953,1844,ALLAHABAD-DELHI,3797,All
2016,10,DELHI,ALLAHABAD,2459,1967,ALLAHABAD-DELHI,4426,All
2016,11,DELHI,ALLAHABAD,2592,2525,ALLAHABAD-DELHI,5117,All
2016,12,DELHI,ALLAHABAD,1599,1614,ALLAHABAD-DELHI,3213,All
2017,1,DELHI,ALLAHABAD,1837,1736,ALLAHABAD-DELHI,3573,All
2017,2,DELHI,ALLAHABAD,1674,1627,ALLAHABAD-DELHI,3301,All
2017,3,DELHI,ALLAHABAD,1837,1864,ALLAHABAD-DELHI,3701,All
2017,4,DELHI,ALLAHABAD,1850,1664,ALLAHABAD-DELHI,3514,All
2017,5,DELHI,ALLAHABAD,2025,1881,ALLAHABAD-DELHI,3906,All
2017,6,DELHI,ALLAHABAD,1775,1683,ALLAHABAD-DELHI,3458,All
2017,7,DELHI,ALLAHABAD,1991,1955,ALLAHABAD-DELHI,3946,All
2017,8,DELHI,ALLAHABAD,1978,1904,ALLAHABAD-DELHI,3882,All
2017,9,DELHI,ALLAHABAD,1891,1923,ALLAHABAD-DELHI,3814,All
2017,10,DELHI,ALLAHABAD,2000,1866,ALLAHABAD-DELHI,3866,All
2017,11,DELHI,ALLAHABAD,1797,1780,ALLAHABAD-DELHI,3577,All
2017,12,DELHI,ALLAHABAD,1962,1928,ALLAHABAD-DELHI,3890,All
2018,1,DELHI,ALLAHABAD,1904,1864,ALLAHABAD-DELHI,3768,All
2018,2,DELHI,ALLAHABAD,1826,1755,ALLAHABAD-DELHI,3581,All
2018,3,DELHI,ALLAHABAD,1769,1785,ALLAHABAD-DELHI,3554,All
2018,4,DELHI,ALLAHABAD,1913,1662,ALLAHABAD-DELHI,3575,All
2018,5,DELHI,ALLAHABAD,1981,1982,ALLAHABAD-DELHI,3963,All
2018,6,DELHI,ALLAHABAD,1865,1857,ALLAHABAD-DELHI,3722,All
2018,7,DELHI,ALLAHABAD,1758,1759,ALLAHABAD-DELHI,3517,All
2018,8,DELHI,ALLAHABAD,1703,1720,ALLAHABAD-DELHI,3423,All
2018,9,DELHI,ALLAHABAD,1653,1619,ALLAHABAD-DELHI,3272,All
2018,10,DELHI,ALLAHABAD,1793,1674,ALLAHABAD-DELHI,3467,All
2018,11,DELHI,ALLAHABAD,1742,1712,ALLAHABAD-DELHI,3454,All
2018,12,DELHI,ALLAHABAD,1791,1824,ALLAHABAD-DELHI,3615,All
2019,1,DELHI,ALLAHABAD,7233,7073,ALLAHABAD-DELHI,14306,All
2019,2,DELHI,ALLAHABAD,8778,8721,ALLAHABAD-DELHI,17499,All
2019,3,DELHI,ALLAHABAD,5903,6349,ALLAHABAD-DELHI,12252,All
2019,4,DELHI,ALLAHABAD,1565,1534,ALLAHABAD-DELHI,3099,All
2015,4,DELHI,AURANGABAD,3326,4512,AURANGABAD-DELHI,7838,All
2015,5,DELHI,AURANGABAD,3484,4606,AURANGABAD-DELHI,8090,All
2015,6,DELHI,AURANGABAD,3421,3929,AURANGABAD-DELHI,7350,All
2015,7,DELHI,AURANGABAD,3217,4079,AURANGABAD-DELHI,7296,All
2015,8,DELHI,AURANGABAD,3255,4166,AURANGABAD-DELHI,7421,All
2015,9,DELHI,AURANGABAD,3083,4036,AURANGABAD-DELHI,7119,All
2015,10,DELHI,AURANGABAD,1554,1581,AURANGABAD-DELHI,3135,All
2015,11,DELHI,AURANGABAD,3117,3882,AURANGABAD-DELHI,6999,All
2015,12,DELHI,AURANGABAD,3391,3897,AURANGABAD-DELHI,7288,All
2016,1,DELHI,AURANGABAD,3331,4059,AURANGABAD-DELHI,7390,All
2016,2,DELHI,AURANGABAD,3246,3932,AURANGABAD-DELHI,7178,All
2016,3,DELHI,AURANGABAD,3452,3953,AURANGABAD-DELHI,7405,All
2016,4,DELHI,AURANGABAD,3089,3715,AURANGABAD-DELHI,6804,All
2016,5,DELHI,AURANGABAD,3126,3548,AURANGABAD-DELHI,6674,All
2016,6,DELHI,AURANGABAD,2837,3054,AURANGABAD-DELHI,5891,All
2016,7,DELHI,AURANGABAD,2954,3293,AURANGABAD-DELHI,6247,All
2016,8,DELHI,AURANGABAD,2851,3324,AURANGABAD-DELHI,6175,All
2016,9,DELHI,AURANGABAD,2918,3306,AURANGABAD-DELHI,6224,All
2016,10,DELHI,AURANGABAD,2512,3091,AURANGABAD-DELHI,5603,All
2016,11,DELHI,AURANGABAD,2271,2842,AURANGABAD-DELHI,5113,All
2016,12,DELHI,AURANGABAD,3352,3464,AURANGABAD-DELHI,6816,All
2017,1,DELHI,AURANGABAD,3174,3565,AURANGABAD-DELHI,6739,All
2017,2,DELHI,AURANGABAD,2999,3217,AURANGABAD-DELHI,6216,All
2017,3,DELHI,AURANGABAD,3222,3365,AURANGABAD-DELHI,6587,All
2017,4,DELHI,AURANGABAD,3193,3756,AURANGABAD-DELHI,6949,All
2017,5,DELHI,AURANGABAD,3325,3672,AURANGABAD-DELHI,6997,All
2017,6,DELHI,AURANGABAD,3271,3611,AURANGABAD-DELHI,6882,All
2017,7,DELHI,AURANGABAD,3329,3765,AURANGABAD-DELHI,7094,All
2017,8,DELHI,AURANGABAD,3321,3859,AURANGABAD-DELHI,7180,All
2017,9,DELHI,AURANGABAD,2967,3396,AURANGABAD-DELHI,6363,All
2017,10,DELHI,AURANGABAD,2990,3356,AURANGABAD-DELHI,6346,All
2017,11,DELHI,AURANGABAD,3515,3532,AURANGABAD-DELHI,7047,All
2017,12,DELHI,AURANGABAD,4223,4190,AURANGABAD-DELHI,8413,All
2018,1,DELHI,AURANGABAD,3877,3695,AURANGABAD-DELHI,7572,All
2018,2,DELHI,AURANGABAD,3552,3654,AURANGABAD-DELHI,7206,All
2018,3,DELHI,AURANGABAD,3851,3901,AURANGABAD-DELHI,7752,All
2018,4,DELHI,AURANGABAD,3865,3588,AURANGABAD-DELHI,7453,All
2018,5,DELHI,AURANGABAD,4519,4070,AURANGABAD-DELHI,8589,All
2018,6,DELHI,AURANGABAD,4102,3761,AURANGABAD-DELHI,7863,All
2018,7,DELHI,AURANGABAD,4030,3648,AURANGABAD-DELHI,7678,All
2018,8,DELHI,AURANGABAD,3956,3793,AURANGABAD-DELHI,7749,All
2018,9,DELHI,AURANGABAD,3713,3734,AURANGABAD-DELHI,7447,All
2018,10,DELHI,AURANGABAD,3926,3920,AURANGABAD-DELHI,7846,All
2018,11,DELHI,AURANGABAD,4003,4317,AURANGABAD-DELHI,8320,All
2018,12,DELHI,AURANGABAD,4331,4313,AURANGABAD-DELHI,8644,All
2019,1,DELHI,AURANGABAD,3958,4259,AURANGABAD-DELHI,8217,All
2019,2,DELHI,AURANGABAD,3620,3471,AURANGABAD-DELHI,7091,All
2019,3,DELHI,AURANGABAD,3680,3381,AURANGABAD-DELHI,7061,All
2019,4,DELHI,AURANGABAD,3157,3357,AURANGABAD-DELHI,6514,All
2023,12,DELHI,Ayodhya International Airport ,195,229,Ayodhya International Airport -DELHI,424,All
2024,1,DELHI,Ayodhya International Airport ,6441,5608,Ayodhya International Airport -DELHI,12049,All
2024,2,DELHI,Ayodhya International Airport ,16800,16272,Ayodhya International Airport -DELHI,33072,All
2024,3,DELHI,Ayodhya International Airport ,20269,19511,Ayodhya International Airport -DELHI,39780,All
2024,4,DELHI,Ayodhya International Airport ,19483,17448,Ayodhya International Airport -DELHI,36931,All
2024,6,DELHI,Ayodhya International Airport ,18756,18837,Ayodhya International Airport -DELHI,37593,All
2024,7,DELHI,Ayodhya International Airport ,16005,16868,Ayodhya International Airport -DELHI,32873,All
2024,8,DELHI,Ayodhya International Airport ,14874,15113,Ayodhya International Airport -DELHI,29987,All
2024,9,DELHI,Ayodhya International Airport ,16017,16033,Ayodhya International Airport -DELHI,32050,All
2024,10,DELHI,Ayodhya International Airport ,18331,15677,Ayodhya International Airport -DELHI,34008,All
2024,11,DELHI,Ayodhya International Airport ,17018,16747,Ayodhya International Airport -DELHI,33765,All
2024,12,DELHI,Ayodhya International Airport ,17688,18321,Ayodhya International Airport -DELHI,36009,All
2025,1,DELHI,Ayodhya International Airport ,14062,14036,Ayodhya International Airport -DELHI,28098,All
2025,2,DELHI,Ayodhya International Airport ,11800,12343,Ayodhya International Airport -DELHI,24143,All
2025,3,DELHI,Ayodhya International Airport ,18320,16810,Ayodhya International Airport -DELHI,35130,All
2015,4,DELHI,BAGDOGRA,21546,23575,BAGDOGRA-DELHI,45121,All
2015,5,DELHI,BAGDOGRA,25159,26710,BAGDOGRA-DELHI,51869,All
2015,6,DELHI,BAGDOGRA,23539,27584,BAGDOGRA-DELHI,51123,All
2015,7,DELHI,BAGDOGRA,19469,24167,BAGDOGRA-DELHI,43636,All
2015,8,DELHI,BAGDOGRA,19850,23221,BAGDOGRA-DELHI,43071,All
2015,9,DELHI,BAGDOGRA,22657,22519,BAGDOGRA-DELHI,45176,All
2015,10,DELHI,BAGDOGRA,20570,23985,BAGDOGRA-DELHI,44555,All
2015,11,DELHI,BAGDOGRA,23480,26083,BAGDOGRA-DELHI,49563,All
2015,12,DELHI,BAGDOGRA,26386,24860,BAGDOGRA-DELHI,51246,All
2016,1,DELHI,BAGDOGRA,23498,21918,BAGDOGRA-DELHI,45416,All
2016,2,DELHI,BAGDOGRA,25402,24842,BAGDOGRA-DELHI,50244,All
2016,3,DELHI,BAGDOGRA,25927,28877,BAGDOGRA-DELHI,54804,All
2016,4,DELHI,BAGDOGRA,25377,28183,BAGDOGRA-DELHI,53560,All
2016,5,DELHI,BAGDOGRA,34238,37195,BAGDOGRA-DELHI,71433,All
2016,6,DELHI,BAGDOGRA,33659,39028,BAGDOGRA-DELHI,72687,All
2016,7,DELHI,BAGDOGRA,25949,30474,BAGDOGRA-DELHI,56423,All
2016,8,DELHI,BAGDOGRA,24401,26855,BAGDOGRA-DELHI,51256,All
2016,9,DELHI,BAGDOGRA,25716,27899,BAGDOGRA-DELHI,53615,All
2016,10,DELHI,BAGDOGRA,37050,30259,BAGDOGRA-DELHI,67309,All
2016,11,DELHI,BAGDOGRA,32422,33418,BAGDOGRA-DELHI,65840,All
2016,12,DELHI,BAGDOGRA,40805,31489,BAGDOGRA-DELHI,72294,All
2017,1,DELHI,BAGDOGRA,36286,32046,BAGDOGRA-DELHI,68332,All
2017,2,DELHI,BAGDOGRA,35508,30894,BAGDOGRA-DELHI,66402,All
2017,3,DELHI,BAGDOGRA,46985,43216,BAGDOGRA-DELHI,90201,All
2017,4,DELHI,BAGDOGRA,42944,43194,BAGDOGRA-DELHI,86138,All
2017,5,DELHI,BAGDOGRA,50030,50493,BAGDOGRA-DELHI,100523,All
2017,6,DELHI,BAGDOGRA,43247,50713,BAGDOGRA-DELHI,93960,All
2017,7,DELHI,BAGDOGRA,35603,44324,BAGDOGRA-DELHI,79927,All
2017,8,DELHI,BAGDOGRA,35888,39260,BAGDOGRA-DELHI,75148,All
2017,9,DELHI,BAGDOGRA,41224,40544,BAGDOGRA-DELHI,81768,All
2017,10,DELHI,BAGDOGRA,46060,44222,BAGDOGRA-DELHI,90282,All
2017,11,DELHI,BAGDOGRA,44127,43738,BAGDOGRA-DELHI,87865,All
2017,12,DELHI,BAGDOGRA,47134,43043,BAGDOGRA-DELHI,90177,All
2018,1,DELHI,BAGDOGRA,43059,43466,BAGDOGRA-DELHI,86525,All
2018,2,DELHI,BAGDOGRA,41935,40517,BAGDOGRA-DELHI,82452,All
2018,3,DELHI,BAGDOGRA,47832,45915,BAGDOGRA-DELHI,93747,All
2018,4,DELHI,BAGDOGRA,49463,48401,BAGDOGRA-DELHI,97864,All
2018,5,DELHI,BAGDOGRA,57699,53780,BAGDOGRA-DELHI,111479,All
2018,6,DELHI,BAGDOGRA,55384,50539,BAGDOGRA-DELHI,105923,All
2018,7,DELHI,BAGDOGRA,50127,46361,BAGDOGRA-DELHI,96488,All
2018,8,DELHI,BAGDOGRA,49337,46713,BAGDOGRA-DELHI,96050,All
2018,9,DELHI,BAGDOGRA,49870,47208,BAGDOGRA-DELHI,97078,All
2018,10,DELHI,BAGDOGRA,50019,47484,BAGDOGRA-DELHI,97503,All
2018,11,DELHI,BAGDOGRA,53339,50479,BAGDOGRA-DELHI,103818,All
2018,12,DELHI,BAGDOGRA,50838,49279,BAGDOGRA-DELHI,100117,All
2019,1,DELHI,BAGDOGRA,45555,46457,BAGDOGRA-DELHI,92012,All
2019,2,DELHI,BAGDOGRA,43087,42321,BAGDOGRA-DELHI,85408,All
2019,3,DELHI,BAGDOGRA,45949,45199,BAGDOGRA-DELHI,91148,All
2019,4,DELHI,BAGDOGRA,43689,43281,BAGDOGRA-DELHI,86970,All
2015,4,DELHI,CHANDIGARH,15954,17279,CHANDIGARH-DELHI,33233,All
2015,5,DELHI,CHANDIGARH,18372,19578,CHANDIGARH-DELHI,37950,All
2015,6,DELHI,CHANDIGARH,18572,19748,CHANDIGARH-DELHI,38320,All
2015,7,DELHI,CHANDIGARH,19999,20414,CHANDIGARH-DELHI,40413,All
2015,8,DELHI,CHANDIGARH,19293,20156,CHANDIGARH-DELHI,39449,All
2015,9,DELHI,CHANDIGARH,19364,19894,CHANDIGARH-DELHI,39258,All
2015,10,DELHI,CHANDIGARH,18101,16779,CHANDIGARH-DELHI,34880,All
2015,11,DELHI,CHANDIGARH,20747,20306,CHANDIGARH-DELHI,41053,All
2015,12,DELHI,CHANDIGARH,16393,16116,CHANDIGARH-DELHI,32509,All
2016,1,DELHI,CHANDIGARH,13745,13429,CHANDIGARH-DELHI,27174,All
2016,2,DELHI,CHANDIGARH,22917,22786,CHANDIGARH-DELHI,45703,All
2016,3,DELHI,CHANDIGARH,24228,25325,CHANDIGARH-DELHI,49553,All
2016,4,DELHI,CHANDIGARH,19304,19384,CHANDIGARH-DELHI,38688,All
2016,5,DELHI,CHANDIGARH,24914,25608,CHANDIGARH-DELHI,50522,All
2016,6,DELHI,CHANDIGARH,26942,29095,CHANDIGARH-DELHI,56037,All
2016,7,DELHI,CHANDIGARH,26359,25953,CHANDIGARH-DELHI,52312,All
2016,8,DELHI,CHANDIGARH,24979,25199,CHANDIGARH-DELHI,50178,All
2016,9,DELHI,CHANDIGARH,25496,26142,CHANDIGARH-DELHI,51638,All
2016,10,DELHI,CHANDIGARH,30067,27813,CHANDIGARH-DELHI,57880,All
2016,11,DELHI,CHANDIGARH,32800,34062,CHANDIGARH-DELHI,66862,All
2016,12,DELHI,CHANDIGARH,23546,23509,CHANDIGARH-DELHI,47055,All
2017,1,DELHI,CHANDIGARH,21339,20866,CHANDIGARH-DELHI,42205,All
2017,2,DELHI,CHANDIGARH,26647,27188,CHANDIGARH-DELHI,53835,All
2017,3,DELHI,CHANDIGARH,32945,34230,CHANDIGARH-DELHI,67175,All
2017,4,DELHI,CHANDIGARH,32866,32897,CHANDIGARH-DELHI,65763,All
2017,5,DELHI,CHANDIGARH,35958,37236,CHANDIGARH-DELHI,73194,All
2017,6,DELHI,CHANDIGARH,31304,34739,CHANDIGARH-DELHI,66043,All
2017,7,DELHI,CHANDIGARH,31193,31799,CHANDIGARH-DELHI,62992,All
2017,8,DELHI,CHANDIGARH,31475,32985,CHANDIGARH-DELHI,64460,All
2017,9,DELHI,CHANDIGARH,29496,28920,CHANDIGARH-DELHI,58416,All
2017,10,DELHI,CHANDIGARH,30198,29334,CHANDIGARH-DELHI,59532,All
2017,11,DELHI,CHANDIGARH,32503,30024,CHANDIGARH-DELHI,62527,All
2017,12,DELHI,CHANDIGARH,28457,28415,CHANDIGARH-DELHI,56872,All
2018,1,DELHI,CHANDIGARH,25008,25444,CHANDIGARH-DELHI,50452,All
2018,2,DELHI,CHANDIGARH,13648,13301,CHANDIGARH-DELHI,26949,All
2018,3,DELHI,CHANDIGARH,31336,31244,CHANDIGARH-DELHI,62580,All
2018,4,DELHI,CHANDIGARH,25016,24340,CHANDIGARH-DELHI,49356,All
2018,5,DELHI,CHANDIGARH,9068,8668,CHANDIGARH-DELHI,17736,All
2018,6,DELHI,CHANDIGARH,22512,22188,CHANDIGARH-DELHI,44700,All
2018,7,DELHI,CHANDIGARH,28293,26639,CHANDIGARH-DELHI,54932,All
2018,8,DELHI,CHANDIGARH,26478,26326,CHANDIGARH-DELHI,52804,All
2018,9,DELHI,CHANDIGARH,27306,26495,CHANDIGARH-DELHI,53801,All
2018,10,DELHI,CHANDIGARH,27476,26085,CHANDIGARH-DELHI,53561,All
2018,11,DELHI,CHANDIGARH,23684,23216,CHANDIGARH-DELHI,46900,All
2018,12,DELHI,CHANDIGARH,19682,19631,CHANDIGARH-DELHI,39313,All
2019,1,DELHI,CHANDIGARH,15747,15709,CHANDIGARH-DELHI,31456,All
2019,2,DELHI,CHANDIGARH,18714,18044,CHANDIGARH-DELHI,36758,All
2019,3,DELHI,CHANDIGARH,19149,17768,CHANDIGARH-DELHI,36917,All
2019,4,DELHI,CHANDIGARH,26781,24490,CHANDIGARH-DELHI,51271,All
2015,4,DELHI,CHENNAI,73576,79083,CHENNAI-DELHI,152659,All
2015,5,DELHI,CHENNAI,89573,80141,CHENNAI-DELHI,169714,All
2015,6,DELHI,CHENNAI,82683,74883,CHENNAI-DELHI,157566,All
2015,7,DELHI,CHENNAI,88395,82873,CHENNAI-DELHI,171268,All
2015,8,DELHI,CHENNAI,80492,86899,CHENNAI-DELHI,167391,All
2015,9,DELHI,CHENNAI,77229,85367,CHENNAI-DELHI,162596,All
2015,10,DELHI,CHENNAI,65530,67601,CHENNAI-DELHI,133131,All
2015,11,DELHI,CHENNAI,81742,83538,CHENNAI-DELHI,165280,All
2015,12,DELHI,CHENNAI,73971,60310,CHENNAI-DELHI,134281,All
2016,1,DELHI,CHENNAI,87027,89440,CHENNAI-DELHI,176467,All
2016,2,DELHI,CHENNAI,87379,92938,CHENNAI-DELHI,180317,All
2016,3,DELHI,CHENNAI,98056,101624,CHENNAI-DELHI,199680,All
2016,4,DELHI,CHENNAI,89311,98763,CHENNAI-DELHI,188074,All
2016,5,DELHI,CHENNAI,111559,104047,CHENNAI-DELHI,215606,All
2016,6,DELHI,CHENNAI,98764,91541,CHENNAI-DELHI,190305,All
2016,7,DELHI,CHENNAI,109848,105260,CHENNAI-DELHI,215108,All
2016,8,DELHI,CHENNAI,96918,105062,CHENNAI-DELHI,201980,All
2016,9,DELHI,CHENNAI,92530,107010,CHENNAI-DELHI,199540,All
2016,10,DELHI,CHENNAI,91223,93916,CHENNAI-DELHI,185139,All
2016,11,DELHI,CHENNAI,93231,94414,CHENNAI-DELHI,187645,All
2016,12,DELHI,CHENNAI,98375,88122,CHENNAI-DELHI,186497,All
2017,1,DELHI,CHENNAI,98276,102190,CHENNAI-DELHI,200466,All
2017,2,DELHI,CHENNAI,87319,93092,CHENNAI-DELHI,180411,All
2017,3,DELHI,CHENNAI,96464,98680,CHENNAI-DELHI,195144,All
2017,4,DELHI,CHENNAI,85213,96198,CHENNAI-DELHI,181411,All
2017,5,DELHI,CHENNAI,111880,101505,CHENNAI-DELHI,213385,All
2017,6,DELHI,CHENNAI,102714,94156,CHENNAI-DELHI,196870,All
2017,7,DELHI,CHENNAI,103923,94199,CHENNAI-DELHI,198122,All
2017,8,DELHI,CHENNAI,96711,101098,CHENNAI-DELHI,197809,All
2017,9,DELHI,CHENNAI,93556,109234,CHENNAI-DELHI,202790,All
2017,10,DELHI,CHENNAI,106560,107119,CHENNAI-DELHI,213679,All
2017,11,DELHI,CHENNAI,103502,103869,CHENNAI-DELHI,207371,All
2017,12,DELHI,CHENNAI,113772,108554,CHENNAI-DELHI,222326,All
2018,1,DELHI,CHENNAI,112241,113254,CHENNAI-DELHI,225495,All
2018,2,DELHI,CHENNAI,104729,110056,CHENNAI-DELHI,214785,All
2018,3,DELHI,CHENNAI,117970,116124,CHENNAI-DELHI,234094,All
2018,4,DELHI,CHENNAI,111211,124068,CHENNAI-DELHI,235279,All
2018,5,DELHI,CHENNAI,120715,113831,CHENNAI-DELHI,234546,All
2018,6,DELHI,CHENNAI,117664,108114,CHENNAI-DELHI,225778,All
2018,7,DELHI,CHENNAI,120460,115022,CHENNAI-DELHI,235482,All
2018,8,DELHI,CHENNAI,114570,122483,CHENNAI-DELHI,237053,All
2018,9,DELHI,CHENNAI,110193,124046,CHENNAI-DELHI,234239,All
2018,10,DELHI,CHENNAI,112870,117641,CHENNAI-DELHI,230511,All
2018,11,DELHI,CHENNAI,100919,99570,CHENNAI-DELHI,200489,All
2018,12,DELHI,CHENNAI,117680,107915,CHENNAI-DELHI,225595,All
2019,1,DELHI,CHENNAI,105731,108348,CHENNAI-DELHI,214079,All
2019,2,DELHI,CHENNAI,99519,103549,CHENNAI-DELHI,203068,All
2019,3,DELHI,CHENNAI,100211,99701,CHENNAI-DELHI,199912,All
2019,4,DELHI,CHENNAI,88835,96454,CHENNAI-DELHI,185289,All
2019,1,DELHI,DABOLIM,84720,87028,DABOLIM-DELHI,171748,All
2019,2,DELHI,DABOLIM,85799,86820,DABOLIM-DELHI,172619,All
2019,3,DELHI,DABOLIM,92911,95437,DABOLIM-DELHI,188348,All
2019,4,DELHI,DABOLIM,74817,83661,DABOLIM-DELHI,158478,All
2020,11,DELHI,DARBHANGA,4028,4000,DARBHANGA-DELHI,8028,All
2020,12,DELHI,DARBHANGA,4819,4803,DARBHANGA-DELHI,9622,All
2021,1,DELHI,DARBHANGA,3535,3651,DARBHANGA-DELHI,7186,All
2021,2,DELHI,DARBHANGA,7322,7279,DARBHANGA-DELHI,14601,All
2015,4,DELHI,DHARAMSALA,2809,2634,DELHI-DHARAMSALA,5443,All
2015,5,DELHI,DHARAMSALA,3943,3597,DELHI-DHARAMSALA,7540,All
2015,6,DELHI,DHARAMSALA,4357,3989,DELHI-DHARAMSALA,8346,All
2015,7,DELHI,DHARAMSALA,3161,2965,DELHI-DHARAMSALA,6126,All
2015,8,DELHI,DHARAMSALA,2845,2608,DELHI-DHARAMSALA,5453,All
2015,9,DELHI,DHARAMSALA,3429,2953,DELHI-DHARAMSALA,6382,All
2015,10,DELHI,DHARAMSALA,3973,3750,DELHI-DHARAMSALA,7723,All
2015,11,DELHI,DHARAMSALA,3615,3573,DELHI-DHARAMSALA,7188,All
2015,12,DELHI,DHARAMSALA,3400,3351,DELHI-DHARAMSALA,6751,All
2016,1,DELHI,DHARAMSALA,3055,3118,DELHI-DHARAMSALA,6173,All
2016,2,DELHI,DHARAMSALA,3338,2997,DELHI-DHARAMSALA,6335,All
2016,3,DELHI,DHARAMSALA,4464,3896,DELHI-DHARAMSALA,8360,All
2016,4,DELHI,DHARAMSALA,5398,4912,DELHI-DHARAMSALA,10310,All
2016,5,DELHI,DHARAMSALA,7111,5754,DELHI-DHARAMSALA,12865,All
2016,6,DELHI,DHARAMSALA,6291,5270,DELHI-DHARAMSALA,11561,All
2016,7,DELHI,DHARAMSALA,5391,4570,DELHI-DHARAMSALA,9961,All
2016,8,DELHI,DHARAMSALA,4986,4262,DELHI-DHARAMSALA,9248,All
2016,9,DELHI,DHARAMSALA,5283,4630,DELHI-DHARAMSALA,9913,All
2016,10,DELHI,DHARAMSALA,4228,3856,DELHI-DHARAMSALA,8084,All
2016,11,DELHI,DHARAMSALA,3897,3779,DELHI-DHARAMSALA,7676,All
2016,12,DELHI,DHARAMSALA,3917,3891,DELHI-DHARAMSALA,7808,All
2017,1,DELHI,DHARAMSALA,3587,3430,DELHI-DHARAMSALA,7017,All
2017,2,DELHI,DHARAMSALA,3606,3356,DELHI-DHARAMSALA,6962,All
2017,3,DELHI,DHARAMSALA,4616,4224,DELHI-DHARAMSALA,8840,All
2017,4,DELHI,DHARAMSALA,6176,5282,DELHI-DHARAMSALA,11458,All
2017,5,DELHI,DHARAMSALA,7342,5946,DELHI-DHARAMSALA,13288,All
2017,6,DELHI,DHARAMSALA,6850,5660,DELHI-DHARAMSALA,12510,All
2017,7,DELHI,DHARAMSALA,6930,6062,DELHI-DHARAMSALA,12992,All
2017,8,DELHI,DHARAMSALA,6853,5747,DELHI-DHARAMSALA,12600,All
2017,9,DELHI,DHARAMSALA,6926,6071,DELHI-DHARAMSALA,12997,All
2017,10,DELHI,DHARAMSALA,6629,5940,DELHI-DHARAMSALA,12569,All
2017,11,DELHI,DHARAMSALA,4647,4056,DELHI-DHARAMSALA,8703,All
2017,12,DELHI,DHARAMSALA,5950,5298,DELHI-DHARAMSALA,11248,All
2018,1,DELHI,DHARAMSALA,4766,4582,DELHI-DHARAMSALA,9348,All
2018,2,DELHI,DHARAMSALA,6215,5565,DELHI-DHARAMSALA,11780,All
2018,3,DELHI,DHARAMSALA,6467,5720,DELHI-DHARAMSALA,12187,All
2018,4,DELHI,DHARAMSALA,7156,6034,DELHI-DHARAMSALA,13190,All
2018,5,DELHI,DHARAMSALA,8380,7048,DELHI-DHARAMSALA,15428,All
2018,6,DELHI,DHARAMSALA,6520,5215,DELHI-DHARAMSALA,11735,All
2018,7,DELHI,DHARAMSALA,6584,5434,DELHI-DHARAMSALA,12018,All
2018,8,DELHI,DHARAMSALA,5808,4358,DELHI-DHARAMSALA,10166,All
2018,9,DELHI,DHARAMSALA,6798,5367,DELHI-DHARAMSALA,12165,All
2018,10,DELHI,DHARAMSALA,6514,5745,DELHI-DHARAMSALA,12259,All
2018,11,DELHI,DHARAMSALA,5121,4554,DELHI-DHARAMSALA,9675,All
2018,12,DELHI,DHARAMSALA,5325,4590,DELHI-DHARAMSALA,9915,All
2019,1,DELHI,DHARAMSALA,4352,3916,DELHI-DHARAMSALA,8268,All
2019,2,DELHI,DHARAMSALA,3784,3337,DELHI-DHARAMSALA,7121,All
2019,3,DELHI,DHARAMSALA,5257,4652,DELHI-DHARAMSALA,9909,All
2019,4,DELHI,DHARAMSALA,7299,6379,DELHI-DHARAMSALA,13678,All
2019,5,DELHI,DHARAMSALA,7557,5928,DELHI-DHARAMSALA,13485,All
2019,6,DELHI,DHARAMSALA,7343,5910,DELHI-DHARAMSALA,13253,All
2019,7,DELHI,DHARAMSALA,6883,5525,DELHI-DHARAMSALA,12408,All
2019,8,DELHI,DHARAMSALA,6567,5253,DELHI-DHARAMSALA,11820,All
2019,9,DELHI,DHARAMSALA,7651,5745,DELHI-DHARAMSALA,13396,All
2019,10,DELHI,DHARAMSALA,7036,5824,DELHI-DHARAMSALA,12860,All
2019,11,DELHI,DHARAMSALA,4822,4273,DELHI-DHARAMSALA,9095,All
2019,12,DELHI,DHARAMSALA,4240,3834,DELHI-DHARAMSALA,8074,All
2020,1,DELHI,DHARAMSALA,3830,3619,DELHI-DHARAMSALA,7449,All
2020,2,DELHI,DHARAMSALA,4283,3419,DELHI-DHARAMSALA,7702,All
2020,3,DELHI,DHARAMSALA,2660,2401,DELHI-DHARAMSALA,5061,All
2020,5,DELHI,DHARAMSALA,592,394,DELHI-DHARAMSALA,986,All
2020,6,DELHI,DHARAMSALA,3124,2097,DELHI-DHARAMSALA,5221,All
2020,7,DELHI,DHARAMSALA,3154,2417,DELHI-DHARAMSALA,5571,All
2020,8,DELHI,DHARAMSALA,2586,2774,DELHI-DHARAMSALA,5360,All
2020,9,DELHI,DHARAMSALA,3180,2897,DELHI-DHARAMSALA,6077,All
2020,10,DELHI,DHARAMSALA,5495,4300,DELHI-DHARAMSALA,9795,All
2020,11,DELHI,DHARAMSALA,5445,5229,DELHI-DHARAMSALA,10674,All
2020,12,DELHI,DHARAMSALA,5376,5524,DELHI-DHARAMSALA,10900,All
2021,1,DELHI,DHARAMSALA,4472,5095,DELHI-DHARAMSALA,9567,All
2021,2,DELHI,DHARAMSALA,5190,4940,DELHI-DHARAMSALA,10130,All
2021,3,DELHI,DHARAMSALA,6286,5443,DELHI-DHARAMSALA,11729,All
2021,4,DELHI,DHARAMSALA,5385,4516,DELHI-DHARAMSALA,9901,All
2021,6,DELHI,DHARAMSALA,2873,2295,DELHI-DHARAMSALA,5168,All
2021,7,DELHI,DHARAMSALA,4250,4315,DELHI-DHARAMSALA,8565,All
2021,8,DELHI,DHARAMSALA,4006,3874,DELHI-DHARAMSALA,7880,All
2021,9,DELHI,DHARAMSALA,4633,4318,DELHI-DHARAMSALA,8951,All
2021,10,DELHI,DHARAMSALA,6632,5437,DELHI-DHARAMSALA,12069,All
2021,11,DELHI,DHARAMSALA,6076,5510,DELHI-DHARAMSALA,11586,All
2021,12,DELHI,DHARAMSALA,7050,6566,DELHI-DHARAMSALA,13616,All
2022,1,DELHI,DHARAMSALA,3066,3638,DELHI-DHARAMSALA,6704,All
2022,2,DELHI,DHARAMSALA,3961,3738,DELHI-DHARAMSALA,7699,All
2022,3,DELHI,DHARAMSALA,7530,6541,DELHI-DHARAMSALA,14071,All
2022,4,DELHI,DHARAMSALA,9279,8061,DELHI-DHARAMSALA,17340,All
2022,5,DELHI,DHARAMSALA,9589,7751,DELHI-DHARAMSALA,17340,All
2022,6,DELHI,DHARAMSALA,8849,7040,DELHI-DHARAMSALA,15889,All
2022,7,DELHI,DHARAMSALA,5904,5274,DELHI-DHARAMSALA,11178,All
2022,8,DELHI,DHARAMSALA,5520,4636,DELHI-DHARAMSALA,10156,All
2022,9,DELHI,DHARAMSALA,5713,4773,DELHI-DHARAMSALA,10486,All
2022,10,DELHI,DHARAMSALA,5887,5453,DELHI-DHARAMSALA,11340,All
2022,11,DELHI,DHARAMSALA,6417,5260,DELHI-DHARAMSALA,11677,All
2022,12,DELHI,DHARAMSALA,6393,5351,DELHI-DHARAMSALA,11744,All
2023,1,DELHI,DHARAMSALA,4556,3784,DELHI-DHARAMSALA,8340,All
2023,2,DELHI,DHARAMSALA,5389,4003,DELHI-DHARAMSALA,9392,All
2023,3,DELHI,DHARAMSALA,7233,5635,DELHI-DHARAMSALA,12868,All
2023,4,DELHI,DHARAMSALA,11757,9915,DELHI-DHARAMSALA,21672,All
2023,5,DELHI,DHARAMSALA,14128,11649,DELHI-DHARAMSALA,25777,All
2023,6,DELHI,DHARAMSALA,15403,12339,DELHI-DHARAMSALA,27742,All
2023,7,DELHI,DHARAMSALA,7855,7580,DELHI-DHARAMSALA,15435,All
2023,8,DELHI,DHARAMSALA,6048,4777,DELHI-DHARAMSALA,10825,All
2023,9,DELHI,DHARAMSALA,8535,6591,DELHI-DHARAMSALA,15126,All
2023,10,DELHI,DHARAMSALA,8861,7344,DELHI-DHARAMSALA,16205,All
2023,11,DELHI,DHARAMSALA,6978,6419,DELHI-DHARAMSALA,13397,All
2023,12,DELHI,DHARAMSALA,7629,6530,DELHI-DHARAMSALA,14159,All
2024,1,DELHI,DHARAMSALA,6830,6269,DELHI-DHARAMSALA,13099,All
2024,2,DELHI,DHARAMSALA,7472,6390,DELHI-DHARAMSALA,13862,All
2024,3,DELHI,DHARAMSALA,9151,7629,DELHI-DHARAMSALA,16780,All
2024,4,DELHI,DHARAMSALA,10576,8189,DELHI-DHARAMSALA,18765,All
2024,6,DELHI,DHARAMSALA,10780,7357,DELHI-DHARAMSALA,18137,All
2024,7,DELHI,DHARAMSALA,8594,6713,DELHI-DHARAMSALA,15307,All
2024,8,DELHI,DHARAMSALA,7360,5843,DELHI-DHARAMSALA,13203,All
2024,9,DELHI,DHARAMSALA,8205,6222,DELHI-DHARAMSALA,14427,All
2024,10,DELHI,DHARAMSALA,9410,7760,DELHI-DHARAMSALA,17170,All
2024,11,DELHI,DHARAMSALA,7530,6259,DELHI-DHARAMSALA,13789,All
2024,12,DELHI,DHARAMSALA,7187,5838,DELHI-DHARAMSALA,13025,All
2025,1,DELHI,DHARAMSALA,5565,4904,DELHI-DHARAMSALA,10469,All
2025,2,DELHI,DHARAMSALA,4514,4064,DELHI-DHARAMSALA,8578,All
2025,3,DELHI,DHARAMSALA,7575,6213,DELHI-DHARAMSALA,13788,All
2015,4,DELHI,DIBRUGARH,5057,3923,DELHI-DIBRUGARH,8980,All
2015,5,DELHI,DIBRUGARH,5264,3873,DELHI-DIBRUGARH,9137,All
2015,6,DELHI,DIBRUGARH,4941,4571,DELHI-DIBRUGARH,9512,All
2015,7,DELHI,DIBRUGARH,4798,4662,DELHI-DIBRUGARH,9460,All
2015,8,DELHI,DIBRUGARH,4120,3932,DELHI-DIBRUGARH,8052,All
2015,9,DELHI,DIBRUGARH,4145,3493,DELHI-DIBRUGARH,7638,All
2015,10,DELHI,DIBRUGARH,4865,4364,DELHI-DIBRUGARH,9229,All
2015,11,DELHI,DIBRUGARH,5340,5225,DELHI-DIBRUGARH,10565,All
2015,12,DELHI,DIBRUGARH,5659,4788,DELHI-DIBRUGARH,10447,All
2016,1,DELHI,DIBRUGARH,4476,4788,DELHI-DIBRUGARH,9264,All
2016,2,DELHI,DIBRUGARH,4304,4091,DELHI-DIBRUGARH,8395,All
2016,3,DELHI,DIBRUGARH,4877,4682,DELHI-DIBRUGARH,9559,All
2016,4,DELHI,DIBRUGARH,4592,4288,DELHI-DIBRUGARH,8880,All
2016,5,DELHI,DIBRUGARH,4460,3298,DELHI-DIBRUGARH,7758,All
2016,6,DELHI,DIBRUGARH,3829,3194,DELHI-DIBRUGARH,7023,All
2016,7,DELHI,DIBRUGARH,4178,3361,DELHI-DIBRUGARH,7539,All
2016,8,DELHI,DIBRUGARH,3271,2684,DELHI-DIBRUGARH,5955,All
2016,9,DELHI,DIBRUGARH,3047,1424,DELHI-DIBRUGARH,4471,All
2016,10,DELHI,DIBRUGARH,3939,2238,DELHI-DIBRUGARH,6177,All
2016,11,DELHI,DIBRUGARH,4750,3243,DELHI-DIBRUGARH,7993,All
2016,12,DELHI,DIBRUGARH,5183,3364,DELHI-DIBRUGARH,8547,All
2017,1,DELHI,DIBRUGARH,4913,3238,DELHI-DIBRUGARH,8151,All
2017,2,DELHI,DIBRUGARH,4575,3171,DELHI-DIBRUGARH,7746,All
2017,3,DELHI,DIBRUGARH,5101,3501,DELHI-DIBRUGARH,8602,All
2017,4,DELHI,DIBRUGARH,5173,3690,DELHI-DIBRUGARH,8863,All
2017,5,DELHI,DIBRUGARH,5424,3247,DELHI-DIBRUGARH,8671,All
2017,6,DELHI,DIBRUGARH,5193,3277,DELHI-DIBRUGARH,8470,All
2017,7,DELHI,DIBRUGARH,5038,3171,DELHI-DIBRUGARH,8209,All
2017,8,DELHI,DIBRUGARH,4824,3001,DELHI-DIBRUGARH,7825,All
2017,9,DELHI,DIBRUGARH,5109,2584,DELHI-DIBRUGARH,7693,All
2017,10,DELHI,DIBRUGARH,5167,2565,DELHI-DIBRUGARH,7732,All
2017,11,DELHI,DIBRUGARH,4924,2899,DELHI-DIBRUGARH,7823,All
2017,12,DELHI,DIBRUGARH,4948,2565,DELHI-DIBRUGARH,7513,All
2018,1,DELHI,DIBRUGARH,4579,2896,DELHI-DIBRUGARH,7475,All
2018,2,DELHI,DIBRUGARH,4370,2667,DELHI-DIBRUGARH,7037,All
2018,3,DELHI,DIBRUGARH,4455,2737,DELHI-DIBRUGARH,7192,All
2018,4,DELHI,DIBRUGARH,4881,2300,DELHI-DIBRUGARH,7181,All
2018,5,DELHI,DIBRUGARH,5079,2672,DELHI-DIBRUGARH,7751,All
2018,6,DELHI,DIBRUGARH,4171,2946,DELHI-DIBRUGARH,7117,All
2018,7,DELHI,DIBRUGARH,4343,2591,DELHI-DIBRUGARH,6934,All
2018,8,DELHI,DIBRUGARH,3277,2475,DELHI-DIBRUGARH,5752,All
2018,9,DELHI,DIBRUGARH,3033,1758,DELHI-DIBRUGARH,4791,All
2018,10,DELHI,DIBRUGARH,4562,3089,DELHI-DIBRUGARH,7651,All
2018,11,DELHI,DIBRUGARH,4370,3780,DELHI-DIBRUGARH,8150,All
2018,12,DELHI,DIBRUGARH,4841,3617,DELHI-DIBRUGARH,8458,All
2019,1,DELHI,DIBRUGARH,4997,3520,DELHI-DIBRUGARH,8517,All
2019,2,DELHI,DIBRUGARH,4717,3121,DELHI-DIBRUGARH,7838,All
2019,3,DELHI,DIBRUGARH,5153,2937,DELHI-DIBRUGARH,8090,All
2019,4,DELHI,DIBRUGARH,5632,3025,DELHI-DIBRUGARH,8657,All
2019,5,DELHI,DIBRUGARH,6076,3315,DELHI-DIBRUGARH,9391,All
2019,6,DELHI,DIBRUGARH,5276,3107,DELHI-DIBRUGARH,8383,All
2019,7,DELHI,DIBRUGARH,5114,3027,DELHI-DIBRUGARH,8141,All
2019,8,DELHI,DIBRUGARH,5702,3037,DELHI-DIBRUGARH,8739,All
2019,9,DELHI,DIBRUGARH,6811,3770,DELHI-DIBRUGARH,10581,All
2019,10,DELHI,DIBRUGARH,9650,6666,DELHI-DIBRUGARH,16316,All
2019,11,DELHI,DIBRUGARH,8354,5211,DELHI-DIBRUGARH,13565,All
2019,12,DELHI,DIBRUGARH,8664,4608,DELHI-DIBRUGARH,13272,All
2020,1,DELHI,DIBRUGARH,6839,5181,DELHI-DIBRUGARH,12020,All
2020,2,DELHI,DIBRUGARH,7914,4893,DELHI-DIBRUGARH,12807,All
2020,3,DELHI,DIBRUGARH,7653,3117,DELHI-DIBRUGARH,10770,All
2020,5,DELHI,DIBRUGARH,301,0,DELHI-DIBRUGARH,301,All
2020,6,DELHI,DIBRUGARH,4086,1219,DELHI-DIBRUGARH,5305,All
2020,7,DELHI,DIBRUGARH,6352,3329,DELHI-DIBRUGARH,9681,All
2020,8,DELHI,DIBRUGARH,9388,5924,DELHI-DIBRUGARH,15312,All
2020,9,DELHI,DIBRUGARH,9334,6753,DELHI-DIBRUGARH,16087,All
2020,10,DELHI,DIBRUGARH,10333,7728,DELHI-DIBRUGARH,18061,All
2020,11,DELHI,DIBRUGARH,10829,8363,DELHI-DIBRUGARH,19192,All
2020,12,DELHI,DIBRUGARH,14509,9029,DELHI-DIBRUGARH,23538,All
2021,1,DELHI,DIBRUGARH,11399,9490,DELHI-DIBRUGARH,20889,All
2021,2,DELHI,DIBRUGARH,12299,10872,DELHI-DIBRUGARH,23171,All
2021,3,DELHI,DIBRUGARH,12878,9534,DELHI-DIBRUGARH,22412,All
2021,4,DELHI,DIBRUGARH,9929,6212,DELHI-DIBRUGARH,16141,All
2021,6,DELHI,DIBRUGARH,4599,3442,DELHI-DIBRUGARH,8041,All
2021,7,DELHI,DIBRUGARH,7728,6512,DELHI-DIBRUGARH,14240,All
2021,8,DELHI,DIBRUGARH,8709,7580,DELHI-DIBRUGARH,16289,All
2021,9,DELHI,DIBRUGARH,9059,7480,DELHI-DIBRUGARH,16539,All
2021,10,DELHI,DIBRUGARH,10784,9446,DELHI-DIBRUGARH,20230,All
2021,11,DELHI,DIBRUGARH,10334,8783,DELHI-DIBRUGARH,19117,All
2021,12,DELHI,DIBRUGARH,12405,8481,DELHI-DIBRUGARH,20886,All
2022,1,DELHI,DIBRUGARH,10919,5892,DELHI-DIBRUGARH,16811,All
2022,2,DELHI,DIBRUGARH,8229,6860,DELHI-DIBRUGARH,15089,All
2022,3,DELHI,DIBRUGARH,10822,9182,DELHI-DIBRUGARH,20004,All
2022,4,DELHI,DIBRUGARH,13269,9294,DELHI-DIBRUGARH,22563,All
2022,5,DELHI,DIBRUGARH,12914,8272,DELHI-DIBRUGARH,21186,All
2022,6,DELHI,DIBRUGARH,11765,8312,DELHI-DIBRUGARH,20077,All
2022,7,DELHI,DIBRUGARH,9106,8632,DELHI-DIBRUGARH,17738,All
2022,8,DELHI,DIBRUGARH,8763,8464,DELHI-DIBRUGARH,17227,All
2022,9,DELHI,DIBRUGARH,8482,8138,DELHI-DIBRUGARH,16620,All
2022,10,DELHI,DIBRUGARH,12390,9345,DELHI-DIBRUGARH,21735,All
2022,11,DELHI,DIBRUGARH,12104,9367,DELHI-DIBRUGARH,21471,All
2022,12,DELHI,DIBRUGARH,12623,8848,DELHI-DIBRUGARH,21471,All
2023,1,DELHI,DIBRUGARH,9970,8000,DELHI-DIBRUGARH,17970,All
2023,2,DELHI,DIBRUGARH,10188,8059,DELHI-DIBRUGARH,18247,All
2023,3,DELHI,DIBRUGARH,12547,9208,DELHI-DIBRUGARH,21755,All
2023,4,DELHI,DIBRUGARH,12445,8931,DELHI-DIBRUGARH,21376,All
2023,5,DELHI,DIBRUGARH,12807,9053,DELHI-DIBRUGARH,21860,All
2023,6,DELHI,DIBRUGARH,12302,8713,DELHI-DIBRUGARH,21015,All
2023,7,DELHI,DIBRUGARH,11959,9540,DELHI-DIBRUGARH,21499,All
2023,8,DELHI,DIBRUGARH,11277,8334,DELHI-DIBRUGARH,19611,All
2023,9,DELHI,DIBRUGARH,9338,8347,DELHI-DIBRUGARH,17685,All
2023,10,DELHI,DIBRUGARH,10366,9710,DELHI-DIBRUGARH,20076,All
2023,11,DELHI,DIBRUGARH,10160,9562,DELHI-DIBRUGARH,19722,All
2023,12,DELHI,DIBRUGARH,10485,9217,DELHI-DIBRUGARH,19702,All
2024,1,DELHI,DIBRUGARH,8802,8858,DELHI-DIBRUGARH,17660,All
2024,2,DELHI,DIBRUGARH,9663,9163,DELHI-DIBRUGARH,18826,All
2024,3,DELHI,DIBRUGARH,10575,10342,DELHI-DIBRUGARH,20917,All
2024,4,DELHI,DIBRUGARH,10353,9842,DELHI-DIBRUGARH,20195,All
2024,6,DELHI,DIBRUGARH,10054,9298,DELHI-DIBRUGARH,19352,All
2024,7,DELHI,DIBRUGARH,10016,10473,DELHI-DIBRUGARH,20489,All
2024,8,DELHI,DIBRUGARH,9386,9567,DELHI-DIBRUGARH,18953,All
2024,9,DELHI,DIBRUGARH,9541,8351,DELHI-DIBRUGARH,17892,All
2024,10,DELHI,DIBRUGARH,10554,10113,DELHI-DIBRUGARH,20667,All
2024,11,DELHI,DIBRUGARH,11726,10376,DELHI-DIBRUGARH,22102,All
2024,12,DELHI,DIBRUGARH,10673,9554,DELHI-DIBRUGARH,20227,All
2025,1,DELHI,DIBRUGARH,8843,9373,DELHI-DIBRUGARH,18216,All
2025,2,DELHI,DIBRUGARH,9453,9153,DELHI-DIBRUGARH,18606,All
2025,3,DELHI,DIBRUGARH,10275,9500,DELHI-DIBRUGARH,19775,All
2015,4,DELHI,DIMAPUR,647,766,DELHI-DIMAPUR,1413,All
2015,5,DELHI,DIMAPUR,1353,1381,DELHI-DIMAPUR,2734,All
2015,6,DELHI,DIMAPUR,1541,1648,DELHI-DIMAPUR,3189,All
2015,7,DELHI,DIMAPUR,1492,1750,DELHI-DIMAPUR,3242,All
2015,8,DELHI,DIMAPUR,1217,1431,DELHI-DIMAPUR,2648,All
2015,9,DELHI,DIMAPUR,1214,1209,DELHI-DIMAPUR,2423,All
2015,10,DELHI,DIMAPUR,1155,1269,DELHI-DIMAPUR,2424,All
2015,11,DELHI,DIMAPUR,1419,1473,DELHI-DIMAPUR,2892,All
2015,12,DELHI,DIMAPUR,2197,1318,DELHI-DIMAPUR,3515,All
2016,1,DELHI,DIMAPUR,1221,1739,DELHI-DIMAPUR,2960,All
2016,2,DELHI,DIMAPUR,1090,1262,DELHI-DIMAPUR,2352,All
2016,3,DELHI,DIMAPUR,1159,1074,DELHI-DIMAPUR,2233,All
2016,4,DELHI,DIMAPUR,1238,1179,DELHI-DIMAPUR,2417,All
2016,5,DELHI,DIMAPUR,1361,899,DELHI-DIMAPUR,2260,All
2016,6,DELHI,DIMAPUR,1229,1052,DELHI-DIMAPUR,2281,All
2016,7,DELHI,DIMAPUR,904,1140,DELHI-DIMAPUR,2044,All
2016,8,DELHI,DIMAPUR,689,691,DELHI-DIMAPUR,1380,All
2016,9,DELHI,DIMAPUR,393,461,DELHI-DIMAPUR,854,All
2016,10,DELHI,DIMAPUR,673,796,DELHI-DIMAPUR,1469,All
2016,11,DELHI,DIMAPUR,736,818,DELHI-DIMAPUR,1554,All
2016,12,DELHI,DIMAPUR,1098,838,DELHI-DIMAPUR,1936,All
2017,1,DELHI,DIMAPUR,652,989,DELHI-DIMAPUR,1641,All
2017,2,DELHI,DIMAPUR,419,565,DELHI-DIMAPUR,984,All
2017,3,DELHI,DIMAPUR,743,809,DELHI-DIMAPUR,1552,All
2017,4,DELHI,DIMAPUR,774,858,DELHI-DIMAPUR,1632,All
2017,5,DELHI,DIMAPUR,1374,1290,DELHI-DIMAPUR,2664,All
2017,6,DELHI,DIMAPUR,1309,1213,DELHI-DIMAPUR,2522,All
2017,7,DELHI,DIMAPUR,1525,729,DELHI-DIMAPUR,2254,All
2017,8,DELHI,DIMAPUR,1777,0,DELHI-DIMAPUR,1777,All
2017,9,DELHI,DIMAPUR,1669,0,DELHI-DIMAPUR,1669,All
2017,10,DELHI,DIMAPUR,1469,1413,DELHI-DIMAPUR,2882,All
2017,11,DELHI,DIMAPUR,1321,1736,DELHI-DIMAPUR,3057,All
2017,12,DELHI,DIMAPUR,1640,1344,DELHI-DIMAPUR,2984,All
2018,1,DELHI,DIMAPUR,1690,1385,DELHI-DIMAPUR,3075,All
2018,2,DELHI,DIMAPUR,1085,1373,DELHI-DIMAPUR,2458,All
2018,3,DELHI,DIMAPUR,1389,1423,DELHI-DIMAPUR,2812,All
2018,4,DELHI,DIMAPUR,1158,1339,DELHI-DIMAPUR,2497,All
2018,5,DELHI,DIMAPUR,1600,1428,DELHI-DIMAPUR,3028,All
2018,6,DELHI,DIMAPUR,1976,1937,DELHI-DIMAPUR,3913,All
2018,7,DELHI,DIMAPUR,1831,2206,DELHI-DIMAPUR,4037,All
2018,8,DELHI,DIMAPUR,1385,1884,DELHI-DIMAPUR,3269,All
2018,9,DELHI,DIMAPUR,1470,1347,DELHI-DIMAPUR,2817,All
2018,10,DELHI,DIMAPUR,1561,1682,DELHI-DIMAPUR,3243,All
2018,11,DELHI,DIMAPUR,1518,1165,DELHI-DIMAPUR,2683,All
2018,12,DELHI,DIMAPUR,1462,1625,DELHI-DIMAPUR,3087,All
2019,1,DELHI,DIMAPUR,1330,1763,DELHI-DIMAPUR,3093,All
2019,2,DELHI,DIMAPUR,1327,1507,DELHI-DIMAPUR,2834,All
2019,3,DELHI,DIMAPUR,1560,1748,DELHI-DIMAPUR,3308,All
2019,4,DELHI,DIMAPUR,1691,1866,DELHI-DIMAPUR,3557,All
2019,5,DELHI,DIMAPUR,1901,1948,DELHI-DIMAPUR,3849,All
2019,6,DELHI,DIMAPUR,2073,2305,DELHI-DIMAPUR,4378,All
2019,7,DELHI,DIMAPUR,1465,2203,DELHI-DIMAPUR,3668,All
2019,8,DELHI,DIMAPUR,1272,1688,DELHI-DIMAPUR,2960,All
2019,9,DELHI,DIMAPUR,1224,1442,DELHI-DIMAPUR,2666,All
2019,10,DELHI,DIMAPUR,1767,2251,DELHI-DIMAPUR,4018,All
2019,11,DELHI,DIMAPUR,1458,1909,DELHI-DIMAPUR,3367,All
2019,12,DELHI,DIMAPUR,1081,1738,DELHI-DIMAPUR,2819,All
2020,1,DELHI,DIMAPUR,1190,1435,DELHI-DIMAPUR,2625,All
2020,2,DELHI,DIMAPUR,1341,1747,DELHI-DIMAPUR,3088,All
2020,3,DELHI,DIMAPUR,1309,927,DELHI-DIMAPUR,2236,All
2020,12,DELHI,DIMAPUR,440,366,DELHI-DIMAPUR,806,All
2021,1,DELHI,DIMAPUR,1815,2089,DELHI-DIMAPUR,3904,All
2021,2,DELHI,DIMAPUR,1891,1926,DELHI-DIMAPUR,3817,All
2021,3,DELHI,DIMAPUR,2100,2050,DELHI-DIMAPUR,4150,All
2021,4,DELHI,DIMAPUR,2524,1938,DELHI-DIMAPUR,4462,All
2021,6,DELHI,DIMAPUR,475,696,DELHI-DIMAPUR,1171,All
2021,7,DELHI,DIMAPUR,1543,1759,DELHI-DIMAPUR,3302,All
2021,8,DELHI,DIMAPUR,2153,2417,DELHI-DIMAPUR,4570,All
2021,9,DELHI,DIMAPUR,1927,2348,DELHI-DIMAPUR,4275,All
2021,10,DELHI,DIMAPUR,2371,2897,DELHI-DIMAPUR,5268,All
2021,11,DELHI,DIMAPUR,2401,2420,DELHI-DIMAPUR,4821,All
2021,12,DELHI,DIMAPUR,2808,2499,DELHI-DIMAPUR,5307,All
2022,1,DELHI,DIMAPUR,2192,2538,DELHI-DIMAPUR,4730,All
2022,2,DELHI,DIMAPUR,2150,2592,DELHI-DIMAPUR,4742,All
2022,3,DELHI,DIMAPUR,3066,3669,DELHI-DIMAPUR,6735,All
2022,4,DELHI,DIMAPUR,2513,2697,DELHI-DIMAPUR,5210,All
2022,5,DELHI,DIMAPUR,2609,2643,DELHI-DIMAPUR,5252,All
2022,6,DELHI,DIMAPUR,2529,2586,DELHI-DIMAPUR,5115,All
2022,7,DELHI,DIMAPUR,2716,2924,DELHI-DIMAPUR,5640,All
2022,8,DELHI,DIMAPUR,2616,2788,DELHI-DIMAPUR,5404,All
2022,9,DELHI,DIMAPUR,2593,2747,DELHI-DIMAPUR,5340,All
2022,10,DELHI,DIMAPUR,2760,2880,DELHI-DIMAPUR,5640,All
2022,11,DELHI,DIMAPUR,2765,2772,DELHI-DIMAPUR,5537,All
2022,12,DELHI,DIMAPUR,2958,2852,DELHI-DIMAPUR,5810,All
2023,1,DELHI,DIMAPUR,2619,2923,DELHI-DIMAPUR,5542,All
2023,2,DELHI,DIMAPUR,2436,2414,DELHI-DIMAPUR,4850,All
2023,3,DELHI,DIMAPUR,2975,2941,DELHI-DIMAPUR,5916,All
2023,4,DELHI,DIMAPUR,2861,2791,DELHI-DIMAPUR,5652,All
2023,5,DELHI,DIMAPUR,3049,3008,DELHI-DIMAPUR,6057,All
2023,6,DELHI,DIMAPUR,2949,2883,DELHI-DIMAPUR,5832,All
2023,7,DELHI,DIMAPUR,2995,3061,DELHI-DIMAPUR,6056,All
2023,8,DELHI,DIMAPUR,2779,2821,DELHI-DIMAPUR,5600,All
2023,9,DELHI,DIMAPUR,2820,2690,DELHI-DIMAPUR,5510,All
2023,10,DELHI,DIMAPUR,3756,3514,DELHI-DIMAPUR,7270,All
2023,11,DELHI,DIMAPUR,3434,3232,DELHI-DIMAPUR,6666,All
2023,12,DELHI,DIMAPUR,4084,3758,DELHI-DIMAPUR,7842,All
2024,1,DELHI,DIMAPUR,3414,3479,DELHI-DIMAPUR,6893,All
2024,2,DELHI,DIMAPUR,3262,3250,DELHI-DIMAPUR,6512,All
2024,3,DELHI,DIMAPUR,3903,3789,DELHI-DIMAPUR,7692,All
2024,4,DELHI,DIMAPUR,3632,3430,DELHI-DIMAPUR,7062,All
2024,6,DELHI,DIMAPUR,3583,3450,DELHI-DIMAPUR,7033,All
2024,7,DELHI,DIMAPUR,3646,3816,DELHI-DIMAPUR,7462,All
2024,8,DELHI,DIMAPUR,3507,3491,DELHI-DIMAPUR,6998,All
2024,9,DELHI,DIMAPUR,3468,3339,DELHI-DIMAPUR,6807,All
2024,10,DELHI,DIMAPUR,5035,4721,DELHI-DIMAPUR,9756,All
2024,11,DELHI,DIMAPUR,5058,4866,DELHI-DIMAPUR,9924,All
2024,12,DELHI,DIMAPUR,5426,4829,DELHI-DIMAPUR,10255,All
2025,1,DELHI,DIMAPUR,4851,5338,DELHI-DIMAPUR,10189,All
2025,2,DELHI,DIMAPUR,4652,4708,DELHI-DIMAPUR,9360,All
2025,3,DELHI,DIMAPUR,5043,4784,DELHI-DIMAPUR,9827,All
2015,12,DELHI,DURGAPUR,209,280,DELHI-DURGAPUR,489,All
2016,1,DELHI,DURGAPUR,483,554,DELHI-DURGAPUR,1037,All
2016,2,DELHI,DURGAPUR,502,547,DELHI-DURGAPUR,1049,All
2016,3,DELHI,DURGAPUR,490,482,DELHI-DURGAPUR,972,All
2016,4,DELHI,DURGAPUR,750,676,DELHI-DURGAPUR,1426,All
2016,5,DELHI,DURGAPUR,618,641,DELHI-DURGAPUR,1259,All
2016,6,DELHI,DURGAPUR,394,283,DELHI-DURGAPUR,677,All
2017,3,DELHI,DURGAPUR,81,724,DELHI-DURGAPUR,805,All
2017,4,DELHI,DURGAPUR,642,660,DELHI-DURGAPUR,1302,All
2017,5,DELHI,DURGAPUR,822,695,DELHI-DURGAPUR,1517,All
2017,6,DELHI,DURGAPUR,694,608,DELHI-DURGAPUR,1302,All
2017,7,DELHI,DURGAPUR,191,210,DELHI-DURGAPUR,401,All
2018,4,DELHI,DURGAPUR,1122,1141,DELHI-DURGAPUR,2263,All
2018,5,DELHI,DURGAPUR,1762,1723,DELHI-DURGAPUR,3485,All
2018,6,DELHI,DURGAPUR,1859,1582,DELHI-DURGAPUR,3441,All
2018,7,DELHI,DURGAPUR,1309,1633,DELHI-DURGAPUR,2942,All
2018,8,DELHI,DURGAPUR,1578,1656,DELHI-DURGAPUR,3234,All
2018,9,DELHI,DURGAPUR,1602,1723,DELHI-DURGAPUR,3325,All
2018,10,DELHI,DURGAPUR,1873,1789,DELHI-DURGAPUR,3662,All
2018,11,DELHI,DURGAPUR,2102,1964,DELHI-DURGAPUR,4066,All
2018,12,DELHI,DURGAPUR,2044,1846,DELHI-DURGAPUR,3890,All
2019,1,DELHI,DURGAPUR,1996,1975,DELHI-DURGAPUR,3971,All
2019,2,DELHI,DURGAPUR,1840,1738,DELHI-DURGAPUR,3578,All
2019,3,DELHI,DURGAPUR,1830,1784,DELHI-DURGAPUR,3614,All
2019,4,DELHI,DURGAPUR,1592,1448,DELHI-DURGAPUR,3040,All
2019,5,DELHI,DURGAPUR,1939,1781,DELHI-DURGAPUR,3720,All
2019,6,DELHI,DURGAPUR,1765,1680,DELHI-DURGAPUR,3445,All
2019,7,DELHI,DURGAPUR,1373,1608,DELHI-DURGAPUR,2981,All
2019,8,DELHI,DURGAPUR,1091,1115,DELHI-DURGAPUR,2206,All
2019,9,DELHI,DURGAPUR,1196,1232,DELHI-DURGAPUR,2428,All
2019,10,DELHI,DURGAPUR,1817,1591,DELHI-DURGAPUR,3408,All
2019,11,DELHI,DURGAPUR,924,1010,DELHI-DURGAPUR,1934,All
2019,12,DELHI,DURGAPUR,959,906,DELHI-DURGAPUR,1865,All
2020,1,DELHI,DURGAPUR,845,927,DELHI-DURGAPUR,1772,All
2020,2,DELHI,DURGAPUR,790,818,DELHI-DURGAPUR,1608,All
2020,3,DELHI,DURGAPUR,712,594,DELHI-DURGAPUR,1306,All
2020,10,DELHI,DURGAPUR,714,678,DELHI-DURGAPUR,1392,All
2020,11,DELHI,DURGAPUR,2262,2273,DELHI-DURGAPUR,4535,All
2020,12,DELHI,DURGAPUR,2313,2396,DELHI-DURGAPUR,4709,All
2021,1,DELHI,DURGAPUR,2433,3096,DELHI-DURGAPUR,5529,All
2021,2,DELHI,DURGAPUR,3597,4350,DELHI-DURGAPUR,7947,All
2021,3,DELHI,DURGAPUR,4076,4926,DELHI-DURGAPUR,9002,All
2021,4,DELHI,DURGAPUR,2471,2242,DELHI-DURGAPUR,4713,All
2021,6,DELHI,DURGAPUR,528,522,DELHI-DURGAPUR,1050,All
2021,7,DELHI,DURGAPUR,677,872,DELHI-DURGAPUR,1549,All
2021,8,DELHI,DURGAPUR,2084,2523,DELHI-DURGAPUR,4607,All
2021,9,DELHI,DURGAPUR,2111,2336,DELHI-DURGAPUR,4447,All
2021,10,DELHI,DURGAPUR,4252,4337,DELHI-DURGAPUR,8589,All
2021,11,DELHI,DURGAPUR,4832,4760,DELHI-DURGAPUR,9592,All
2021,12,DELHI,DURGAPUR,4215,4185,DELHI-DURGAPUR,8400,All
2022,1,DELHI,DURGAPUR,1492,1498,DELHI-DURGAPUR,2990,All
2022,2,DELHI,DURGAPUR,1592,1687,DELHI-DURGAPUR,3279,All
2022,3,DELHI,DURGAPUR,3960,4332,DELHI-DURGAPUR,8292,All
2022,4,DELHI,DURGAPUR,4989,4566,DELHI-DURGAPUR,9555,All
2022,5,DELHI,DURGAPUR,4576,4668,DELHI-DURGAPUR,9244,All
2022,6,DELHI,DURGAPUR,4869,4427,DELHI-DURGAPUR,9296,All
2022,7,DELHI,DURGAPUR,4203,4859,DELHI-DURGAPUR,9062,All
2022,8,DELHI,DURGAPUR,4253,5029,DELHI-DURGAPUR,9282,All
2022,9,DELHI,DURGAPUR,4932,4107,DELHI-DURGAPUR,9039,All
2022,10,DELHI,DURGAPUR,6063,5610,DELHI-DURGAPUR,11673,All
2022,11,DELHI,DURGAPUR,5483,6368,DELHI-DURGAPUR,11851,All
2022,12,DELHI,DURGAPUR,4821,4170,DELHI-DURGAPUR,8991,All
2023,1,DELHI,DURGAPUR,4338,4115,DELHI-DURGAPUR,8453,All
2023,2,DELHI,DURGAPUR,3954,3764,DELHI-DURGAPUR,7718,All
2023,3,DELHI,DURGAPUR,4957,4726,DELHI-DURGAPUR,9683,All
2023,4,DELHI,DURGAPUR,5728,4707,DELHI-DURGAPUR,10435,All
2023,5,DELHI,DURGAPUR,6238,5702,DELHI-DURGAPUR,11940,All
2023,6,DELHI,DURGAPUR,6460,5534,DELHI-DURGAPUR,11994,All
2023,7,DELHI,DURGAPUR,4618,5277,DELHI-DURGAPUR,9895,All
2023,8,DELHI,DURGAPUR,4844,4696,DELHI-DURGAPUR,9540,All
2023,9,DELHI,DURGAPUR,5370,4778,DELHI-DURGAPUR,10148,All
2023,10,DELHI,DURGAPUR,6310,5340,DELHI-DURGAPUR,11650,All
2023,11,DELHI,DURGAPUR,5103,4621,DELHI-DURGAPUR,9724,All
2023,12,DELHI,DURGAPUR,5236,4913,DELHI-DURGAPUR,10149,All
2024,1,DELHI,DURGAPUR,5060,4928,DELHI-DURGAPUR,9988,All
2024,2,DELHI,DURGAPUR,4201,4185,DELHI-DURGAPUR,8386,All
2024,3,DELHI,DURGAPUR,4792,4696,DELHI-DURGAPUR,9488,All
2024,4,DELHI,DURGAPUR,4959,4358,DELHI-DURGAPUR,9317,All
2024,6,DELHI,DURGAPUR,5860,4404,DELHI-DURGAPUR,10264,All
2024,7,DELHI,DURGAPUR,5273,5548,DELHI-DURGAPUR,10821,All
2024,8,DELHI,DURGAPUR,4805,4599,DELHI-DURGAPUR,9404,All
2024,9,DELHI,DURGAPUR,4941,4028,DELHI-DURGAPUR,8969,All
2024,10,DELHI,DURGAPUR,9590,7257,DELHI-DURGAPUR,16847,All
2024,11,DELHI,DURGAPUR,5212,4945,DELHI-DURGAPUR,10157,All
2024,12,DELHI,DURGAPUR,5376,4783,DELHI-DURGAPUR,10159,All
2025,1,DELHI,DURGAPUR,4945,4785,DELHI-DURGAPUR,9730,All
2025,2,DELHI,DURGAPUR,4821,4821,DELHI-DURGAPUR,9642,All
2025,3,DELHI,DURGAPUR,5101,5109,DELHI-DURGAPUR,10210,All
2023,1,DELHI,Deoghar ,1748,1844,DELHI-Deoghar ,3592,All
2023,6,DELHI,Deoghar ,5278,5088,DELHI-Deoghar ,10366,All
2023,7,DELHI,Deoghar ,4801,5111,DELHI-Deoghar ,9912,All
2023,8,DELHI,Deoghar ,3945,4070,DELHI-Deoghar ,8015,All
2023,9,DELHI,Deoghar ,3766,3783,DELHI-Deoghar ,7549,All
2023,10,DELHI,Deoghar ,5158,4650,DELHI-Deoghar ,9808,All
2023,11,DELHI,Deoghar ,5175,4603,DELHI-Deoghar ,9778,All
2023,12,DELHI,Deoghar ,4348,4334,DELHI-Deoghar ,8682,All
2024,1,DELHI,Deoghar ,2299,2109,DELHI-Deoghar ,4408,All
2024,2,DELHI,Deoghar ,4091,4077,DELHI-Deoghar ,8168,All
2024,3,DELHI,Deoghar ,5544,5375,DELHI-Deoghar ,10919,All
2024,4,DELHI,Deoghar ,5343,5145,DELHI-Deoghar ,10488,All
2024,6,DELHI,Deoghar ,5145,4549,DELHI-Deoghar ,9694,All
2024,7,DELHI,Deoghar ,4861,5302,DELHI-Deoghar ,10163,All
2024,8,DELHI,Deoghar ,4948,5055,DELHI-Deoghar ,10003,All
2024,9,DELHI,Deoghar ,5091,5022,DELHI-Deoghar ,10113,All
2024,10,DELHI,Deoghar ,5458,4668,DELHI-Deoghar ,10126,All
2024,11,DELHI,Deoghar ,5277,5143,DELHI-Deoghar ,10420,All
2024,12,DELHI,Deoghar ,5676,5496,DELHI-Deoghar ,11172,All
2025,1,DELHI,Deoghar ,5533,5632,DELHI-Deoghar ,11165,All
2025,2,DELHI,Deoghar ,5219,5221,DELHI-Deoghar ,10440,All
2025,3,DELHI,Deoghar ,5330,5261,DELHI-Deoghar ,10591,All
2023,2,DELHI,Deoghar Airport,4265,4418,DELHI-Deoghar Airport,8683,All
2023,3,DELHI,Deoghar Airport,4789,4943,DELHI-Deoghar Airport,9732,All
2023,4,DELHI,Deoghar Airport,4720,4510,DELHI-Deoghar Airport,9230,All
2023,5,DELHI,Deoghar Airport,5364,5316,DELHI-Deoghar Airport,10680,All
2015,4,DELHI,GAYA,1787,1229,DELHI-GAYA,3016,All
2015,5,DELHI,GAYA,1178,699,DELHI-GAYA,1877,All
2015,6,DELHI,GAYA,1093,740,DELHI-GAYA,1833,All
2015,7,DELHI,GAYA,894,771,DELHI-GAYA,1665,All
2015,8,DELHI,GAYA,905,695,DELHI-GAYA,1600,All
2015,9,DELHI,GAYA,1183,901,DELHI-GAYA,2084,All
2015,10,DELHI,GAYA,19604,6564,DELHI-GAYA,26168,All
2015,11,DELHI,GAYA,3061,2227,DELHI-GAYA,5288,All
2015,12,DELHI,GAYA,3830,2615,DELHI-GAYA,6445,All
2016,1,DELHI,GAYA,3449,2330,DELHI-GAYA,5779,All
2016,2,DELHI,GAYA,3642,2569,DELHI-GAYA,6211,All
2016,3,DELHI,GAYA,3013,2239,DELHI-GAYA,5252,All
2016,4,DELHI,GAYA,3135,2057,DELHI-GAYA,5192,All
2016,5,DELHI,GAYA,3020,2202,DELHI-GAYA,5222,All
2016,6,DELHI,GAYA,3083,1890,DELHI-GAYA,4973,All
2016,7,DELHI,GAYA,3244,2629,DELHI-GAYA,5873,All
2016,8,DELHI,GAYA,2859,2448,DELHI-GAYA,5307,All
2016,9,DELHI,GAYA,3436,2680,DELHI-GAYA,6116,All
2016,10,DELHI,GAYA,3638,2356,DELHI-GAYA,5994,All
2016,11,DELHI,GAYA,779,543,DELHI-GAYA,1322,All
2016,12,DELHI,GAYA,3284,2429,DELHI-GAYA,5713,All
2017,1,DELHI,GAYA,3505,2780,DELHI-GAYA,6285,All
2017,2,DELHI,GAYA,3023,2318,DELHI-GAYA,5341,All
2017,3,DELHI,GAYA,1683,1657,DELHI-GAYA,3340,All
2017,4,DELHI,GAYA,1433,1268,DELHI-GAYA,2701,All
2017,5,DELHI,GAYA,1640,1426,DELHI-GAYA,3066,All
2017,6,DELHI,GAYA,2146,1919,DELHI-GAYA,4065,All
2017,7,DELHI,GAYA,1984,1911,DELHI-GAYA,3895,All
2017,8,DELHI,GAYA,2293,1641,DELHI-GAYA,3934,All
2017,9,DELHI,GAYA,2523,1978,DELHI-GAYA,4501,All
2017,10,DELHI,GAYA,2568,1808,DELHI-GAYA,4376,All
2017,11,DELHI,GAYA,2023,1526,DELHI-GAYA,3549,All
2017,12,DELHI,GAYA,2870,2180,DELHI-GAYA,5050,All
2018,1,DELHI,GAYA,3222,2452,DELHI-GAYA,5674,All
2018,2,DELHI,GAYA,2555,1832,DELHI-GAYA,4387,All
2018,3,DELHI,GAYA,2875,2186,DELHI-GAYA,5061,All
2018,4,DELHI,GAYA,2674,2081,DELHI-GAYA,4755,All
2018,5,DELHI,GAYA,2589,2365,DELHI-GAYA,4954,All
2018,6,DELHI,GAYA,2576,2277,DELHI-GAYA,4853,All
2018,7,DELHI,GAYA,2568,2339,DELHI-GAYA,4907,All
2018,8,DELHI,GAYA,2693,2526,DELHI-GAYA,5219,All
2018,9,DELHI,GAYA,2920,2460,DELHI-GAYA,5380,All
2018,10,DELHI,GAYA,3181,2475,DELHI-GAYA,5656,All
2018,11,DELHI,GAYA,2804,2052,DELHI-GAYA,4856,All
2018,12,DELHI,GAYA,3328,2402,DELHI-GAYA,5730,All
2019,1,DELHI,GAYA,2572,2010,DELHI-GAYA,4582,All
2019,2,DELHI,GAYA,2611,1803,DELHI-GAYA,4414,All
2019,3,DELHI,GAYA,2688,2032,DELHI-GAYA,4720,All
2019,4,DELHI,GAYA,2481,1898,DELHI-GAYA,4379,All
2019,5,DELHI,GAYA,2377,1813,DELHI-GAYA,4190,All
2019,6,DELHI,GAYA,2158,1739,DELHI-GAYA,3897,All
2019,7,DELHI,GAYA,1802,873,DELHI-GAYA,2675,All
2019,8,DELHI,GAYA,1569,4216,DELHI-GAYA,5785,All
2019,9,DELHI,GAYA,1855,1333,DELHI-GAYA,3188,All
2019,10,DELHI,GAYA,3241,2157,DELHI-GAYA,5398,All
2019,11,DELHI,GAYA,2931,2275,DELHI-GAYA,5206,All
2019,12,DELHI,GAYA,3566,2664,DELHI-GAYA,6230,All
2020,1,DELHI,GAYA,3271,2564,DELHI-GAYA,5835,All
2020,2,DELHI,GAYA,3035,2136,DELHI-GAYA,5171,All
2020,3,DELHI,GAYA,1581,1316,DELHI-GAYA,2897,All
2020,5,DELHI,GAYA,449,0,DELHI-GAYA,449,All
2020,6,DELHI,GAYA,679,0,DELHI-GAYA,679,All
2020,7,DELHI,GAYA,699,0,DELHI-GAYA,699,All
2020,8,DELHI,GAYA,419,3,DELHI-GAYA,422,All
2020,10,DELHI,GAYA,1450,1251,DELHI-GAYA,2701,All
2020,11,DELHI,GAYA,4063,2844,DELHI-GAYA,6907,All
2020,12,DELHI,GAYA,3616,4902,DELHI-GAYA,8518,All
2021,1,DELHI,GAYA,2394,2924,DELHI-GAYA,5318,All
2021,2,DELHI,GAYA,3031,3358,DELHI-GAYA,6389,All
2021,3,DELHI,GAYA,3724,3088,DELHI-GAYA,6812,All
2021,4,DELHI,GAYA,3030,2134,DELHI-GAYA,5164,All
2021,10,DELHI,GAYA,1983,1537,DELHI-GAYA,3520,All
2021,11,DELHI,GAYA,4684,4150,DELHI-GAYA,8834,All
2021,12,DELHI,GAYA,4579,4821,DELHI-GAYA,9400,All
2022,1,DELHI,GAYA,1156,1089,DELHI-GAYA,2245,All
2022,2,DELHI,GAYA,0,70,DELHI-GAYA,70,All
2022,3,DELHI,GAYA,2660,2643,DELHI-GAYA,5303,All
2022,4,DELHI,GAYA,4713,4231,DELHI-GAYA,8944,All
2022,5,DELHI,GAYA,4250,4328,DELHI-GAYA,8578,All
2022,6,DELHI,GAYA,4019,4267,DELHI-GAYA,8286,All
2022,7,DELHI,GAYA,3693,3949,DELHI-GAYA,7642,All
2022,8,DELHI,GAYA,3354,3682,DELHI-GAYA,7036,All
2022,9,DELHI,GAYA,4179,4002,DELHI-GAYA,8181,All
2022,10,DELHI,GAYA,5161,4087,DELHI-GAYA,9248,All
2022,11,DELHI,GAYA,4483,4576,DELHI-GAYA,9059,All
2022,12,DELHI,GAYA,4569,3660,DELHI-GAYA,8229,All
2023,1,DELHI,GAYA,3851,4409,DELHI-GAYA,8260,All
2023,2,DELHI,GAYA,4229,4252,DELHI-GAYA,8481,All
2023,3,DELHI,GAYA,4802,4979,DELHI-GAYA,9781,All
2023,4,DELHI,GAYA,4741,4470,DELHI-GAYA,9211,All
2023,5,DELHI,GAYA,5353,4821,DELHI-GAYA,10174,All
2023,6,DELHI,GAYA,5261,4748,DELHI-GAYA,10009,All
2023,7,DELHI,GAYA,4276,4715,DELHI-GAYA,8991,All
2023,8,DELHI,GAYA,4637,4539,DELHI-GAYA,9176,All
2023,9,DELHI,GAYA,4929,4851,DELHI-GAYA,9780,All
2023,10,DELHI,GAYA,4983,4735,DELHI-GAYA,9718,All
2023,11,DELHI,GAYA,5055,4191,DELHI-GAYA,9246,All
2023,12,DELHI,GAYA,4895,4718,DELHI-GAYA,9613,All
2024,1,DELHI,GAYA,4873,4940,DELHI-GAYA,9813,All
2024,2,DELHI,GAYA,4674,4511,DELHI-GAYA,9185,All
2024,3,DELHI,GAYA,5131,4725,DELHI-GAYA,9856,All
2024,4,DELHI,GAYA,5070,4527,DELHI-GAYA,9597,All
2024,6,DELHI,GAYA,5249,4699,DELHI-GAYA,9948,All
2024,7,DELHI,GAYA,4747,5184,DELHI-GAYA,9931,All
2024,8,DELHI,GAYA,4729,4846,DELHI-GAYA,9575,All
2024,9,DELHI,GAYA,4663,4438,DELHI-GAYA,9101,All
2024,10,DELHI,GAYA,5254,4456,DELHI-GAYA,9710,All
2024,11,DELHI,GAYA,5160,4914,DELHI-GAYA,10074,All
2024,12,DELHI,GAYA,5447,5266,DELHI-GAYA,10713,All
2025,1,DELHI,GAYA,4737,4827,DELHI-GAYA,9564,All
2025,2,DELHI,GAYA,4773,4834,DELHI-GAYA,9607,All
2025,3,DELHI,GAYA,5206,5140,DELHI-GAYA,10346,All
2015,4,DELHI,GOA,32319,37127,DELHI-GOA,69446,All
2015,5,DELHI,GOA,33067,33338,DELHI-GOA,66405,All
2015,6,DELHI,GOA,45409,44262,DELHI-GOA,89671,All
2015,7,DELHI,GOA,41998,42792,DELHI-GOA,84790,All
2015,8,DELHI,GOA,47259,48513,DELHI-GOA,95772,All
2015,9,DELHI,GOA,53507,52001,DELHI-GOA,105508,All
2015,10,DELHI,GOA,50860,54379,DELHI-GOA,105239,All
2015,11,DELHI,GOA,57320,54592,DELHI-GOA,111912,All
2015,12,DELHI,GOA,69282,62103,DELHI-GOA,131385,All
2016,1,DELHI,GOA,69208,73435,DELHI-GOA,142643,All
2016,2,DELHI,GOA,63508,65415,DELHI-GOA,128923,All
2016,3,DELHI,GOA,54160,65361,DELHI-GOA,119521,All
2016,4,DELHI,GOA,49713,54671,DELHI-GOA,104384,All
2016,5,DELHI,GOA,45392,52603,DELHI-GOA,97995,All
2016,6,DELHI,GOA,65559,62540,DELHI-GOA,128099,All
2016,7,DELHI,GOA,51916,53417,DELHI-GOA,105333,All
2016,8,DELHI,GOA,55066,55179,DELHI-GOA,110245,All
2016,9,DELHI,GOA,58849,59106,DELHI-GOA,117955,All
2016,10,DELHI,GOA,61218,65540,DELHI-GOA,126758,All
2016,11,DELHI,GOA,73243,68737,DELHI-GOA,141980,All
2016,12,DELHI,GOA,82099,75987,DELHI-GOA,158086,All
2017,1,DELHI,GOA,84067,87464,DELHI-GOA,171531,All
2017,2,DELHI,GOA,74730,75988,DELHI-GOA,150718,All
2017,3,DELHI,GOA,80374,84066,DELHI-GOA,164440,All
2017,4,DELHI,GOA,66739,74130,DELHI-GOA,140869,All
2017,5,DELHI,GOA,72072,68320,DELHI-GOA,140392,All
2017,6,DELHI,GOA,79193,74661,DELHI-GOA,153854,All
2017,7,DELHI,GOA,67365,68927,DELHI-GOA,136292,All
2017,8,DELHI,GOA,70031,69158,DELHI-GOA,139189,All
2017,9,DELHI,GOA,66316,66471,DELHI-GOA,132787,All
2017,10,DELHI,GOA,75904,78158,DELHI-GOA,154062,All
2017,11,DELHI,GOA,74603,72153,DELHI-GOA,146756,All
2017,12,DELHI,GOA,81864,78182,DELHI-GOA,160046,All
2018,1,DELHI,GOA,80463,83514,DELHI-GOA,163977,All
2018,2,DELHI,GOA,71697,73232,DELHI-GOA,144929,All
2018,3,DELHI,GOA,79403,80447,DELHI-GOA,159850,All
2018,4,DELHI,GOA,76642,85121,DELHI-GOA,161763,All
2018,5,DELHI,GOA,77775,72717,DELHI-GOA,150492,All
2018,6,DELHI,GOA,70233,63341,DELHI-GOA,133574,All
2018,7,DELHI,GOA,67103,58861,DELHI-GOA,125964,All
2018,8,DELHI,GOA,71021,70465,DELHI-GOA,141486,All
2018,9,DELHI,GOA,73060,70516,DELHI-GOA,143576,All
2018,10,DELHI,GOA,76502,79097,DELHI-GOA,155599,All
2018,11,DELHI,GOA,81974,79977,DELHI-GOA,161951,All
2018,12,DELHI,GOA,93836,89745,DELHI-GOA,183581,All
2015,9,DELHI,GORAKHPUR,348,238,DELHI-GORAKHPUR,586,All
2015,10,DELHI,GORAKHPUR,1435,922,DELHI-GORAKHPUR,2357,All
2015,11,DELHI,GORAKHPUR,797,486,DELHI-GORAKHPUR,1283,All
2016,1,DELHI,GORAKHPUR,258,184,DELHI-GORAKHPUR,442,All
2016,2,DELHI,GORAKHPUR,1365,1012,DELHI-GORAKHPUR,2377,All
2016,3,DELHI,GORAKHPUR,3025,2080,DELHI-GORAKHPUR,5105,All
2016,4,DELHI,GORAKHPUR,1696,1423,DELHI-GORAKHPUR,3119,All
2016,5,DELHI,GORAKHPUR,1408,1324,DELHI-GORAKHPUR,2732,All
2016,6,DELHI,GORAKHPUR,1528,1227,DELHI-GORAKHPUR,2755,All
2016,7,DELHI,GORAKHPUR,1424,1372,DELHI-GORAKHPUR,2796,All
2016,8,DELHI,GORAKHPUR,1507,1406,DELHI-GORAKHPUR,2913,All
2016,9,DELHI,GORAKHPUR,1478,1313,DELHI-GORAKHPUR,2791,All
2016,10,DELHI,GORAKHPUR,3699,3229,DELHI-GORAKHPUR,6928,All
2016,11,DELHI,GORAKHPUR,3207,2958,DELHI-GORAKHPUR,6165,All
2017,2,DELHI,GORAKHPUR,2562,2416,DELHI-GORAKHPUR,4978,All
2017,3,DELHI,GORAKHPUR,3961,3741,DELHI-GORAKHPUR,7702,All
2017,4,DELHI,GORAKHPUR,4188,3864,DELHI-GORAKHPUR,8052,All
2017,5,DELHI,GORAKHPUR,4408,4240,DELHI-GORAKHPUR,8648,All
2017,6,DELHI,GORAKHPUR,4171,4199,DELHI-GORAKHPUR,8370,All
2017,7,DELHI,GORAKHPUR,4363,4448,DELHI-GORAKHPUR,8811,All
2017,8,DELHI,GORAKHPUR,4255,4108,DELHI-GORAKHPUR,8363,All
2017,9,DELHI,GORAKHPUR,4241,4135,DELHI-GORAKHPUR,8376,All
2017,10,DELHI,GORAKHPUR,4337,4121,DELHI-GORAKHPUR,8458,All
2017,11,DELHI,GORAKHPUR,3039,2961,DELHI-GORAKHPUR,6000,All
2018,2,DELHI,GORAKHPUR,3181,3037,DELHI-GORAKHPUR,6218,All
2018,3,DELHI,GORAKHPUR,4983,4849,DELHI-GORAKHPUR,9832,All
2018,4,DELHI,GORAKHPUR,7400,7228,DELHI-GORAKHPUR,14628,All
2018,5,DELHI,GORAKHPUR,7253,7183,DELHI-GORAKHPUR,14436,All
2018,6,DELHI,GORAKHPUR,6911,6840,DELHI-GORAKHPUR,13751,All
2018,7,DELHI,GORAKHPUR,6986,7184,DELHI-GORAKHPUR,14170,All
2018,8,DELHI,GORAKHPUR,7049,6979,DELHI-GORAKHPUR,14028,All
2018,9,DELHI,GORAKHPUR,10708,10035,DELHI-GORAKHPUR,20743,All
2018,10,DELHI,GORAKHPUR,12082,10280,DELHI-GORAKHPUR,22362,All
2018,11,DELHI,GORAKHPUR,11709,11457,DELHI-GORAKHPUR,23166,All
2018,12,DELHI,GORAKHPUR,11627,12194,DELHI-GORAKHPUR,23821,All
2019,1,DELHI,GORAKHPUR,10366,10373,DELHI-GORAKHPUR,20739,All
2019,2,DELHI,GORAKHPUR,10772,10718,DELHI-GORAKHPUR,21490,All
2019,3,DELHI,GORAKHPUR,12071,11836,DELHI-GORAKHPUR,23907,All
2019,4,DELHI,GORAKHPUR,11651,10487,DELHI-GORAKHPUR,22138,All
2019,5,DELHI,GORAKHPUR,11778,10958,DELHI-GORAKHPUR,22736,All
2019,6,DELHI,GORAKHPUR,11241,12011,DELHI-GORAKHPUR,23252,All
2019,7,DELHI,GORAKHPUR,10297,11471,DELHI-GORAKHPUR,21768,All
2019,8,DELHI,GORAKHPUR,11288,11454,DELHI-GORAKHPUR,22742,All
2019,9,DELHI,GORAKHPUR,10647,10729,DELHI-GORAKHPUR,21376,All
2019,10,DELHI,GORAKHPUR,12321,10759,DELHI-GORAKHPUR,23080,All
2019,11,DELHI,GORAKHPUR,11341,11881,DELHI-GORAKHPUR,23222,All
2019,12,DELHI,GORAKHPUR,11342,11804,DELHI-GORAKHPUR,23146,All
2020,1,DELHI,GORAKHPUR,11096,11215,DELHI-GORAKHPUR,22311,All
2020,2,DELHI,GORAKHPUR,11890,11843,DELHI-GORAKHPUR,23733,All
2020,3,DELHI,GORAKHPUR,11642,9496,DELHI-GORAKHPUR,21138,All
2020,5,DELHI,GORAKHPUR,1234,720,DELHI-GORAKHPUR,1954,All
2020,6,DELHI,GORAKHPUR,9102,4945,DELHI-GORAKHPUR,14047,All
2020,7,DELHI,GORAKHPUR,6983,8943,DELHI-GORAKHPUR,15926,All
2020,8,DELHI,GORAKHPUR,5343,12064,DELHI-GORAKHPUR,17407,All
2020,9,DELHI,GORAKHPUR,5483,9875,DELHI-GORAKHPUR,15358,All
2020,10,DELHI,GORAKHPUR,7958,10697,DELHI-GORAKHPUR,18655,All
2020,11,DELHI,GORAKHPUR,12510,9986,DELHI-GORAKHPUR,22496,All
2020,12,DELHI,GORAKHPUR,9601,13089,DELHI-GORAKHPUR,22690,All
2021,1,DELHI,GORAKHPUR,7440,10642,DELHI-GORAKHPUR,18082,All
2021,2,DELHI,GORAKHPUR,7322,8313,DELHI-GORAKHPUR,15635,All
2021,3,DELHI,GORAKHPUR,10325,8114,DELHI-GORAKHPUR,18439,All
2021,4,DELHI,GORAKHPUR,13807,8073,DELHI-GORAKHPUR,21880,All
2021,6,DELHI,GORAKHPUR,6544,9892,DELHI-GORAKHPUR,16436,All
2021,7,DELHI,GORAKHPUR,8294,10230,DELHI-GORAKHPUR,18524,All
2021,8,DELHI,GORAKHPUR,10164,12054,DELHI-GORAKHPUR,22218,All
2021,9,DELHI,GORAKHPUR,9511,10918,DELHI-GORAKHPUR,20429,All
2021,10,DELHI,GORAKHPUR,15810,11931,DELHI-GORAKHPUR,27741,All
2021,11,DELHI,GORAKHPUR,17003,14777,DELHI-GORAKHPUR,31780,All
2021,12,DELHI,GORAKHPUR,14122,16985,DELHI-GORAKHPUR,31107,All
2022,1,DELHI,GORAKHPUR,9907,8381,DELHI-GORAKHPUR,18288,All
2022,2,DELHI,GORAKHPUR,10338,10066,DELHI-GORAKHPUR,20404,All
2022,3,DELHI,GORAKHPUR,13152,12070,DELHI-GORAKHPUR,25222,All
2022,4,DELHI,GORAKHPUR,15362,10998,DELHI-GORAKHPUR,26360,All
2022,5,DELHI,GORAKHPUR,14728,13762,DELHI-GORAKHPUR,28490,All
2022,6,DELHI,GORAKHPUR,11950,13410,DELHI-GORAKHPUR,25360,All
2022,7,DELHI,GORAKHPUR,10453,11340,DELHI-GORAKHPUR,21793,All
2022,8,DELHI,GORAKHPUR,10064,11456,DELHI-GORAKHPUR,21520,All
2022,9,DELHI,GORAKHPUR,12128,10868,DELHI-GORAKHPUR,22996,All
2022,10,DELHI,GORAKHPUR,12481,10270,DELHI-GORAKHPUR,22751,All
2022,11,DELHI,GORAKHPUR,12756,13122,DELHI-GORAKHPUR,25878,All
2022,12,DELHI,GORAKHPUR,13354,13984,DELHI-GORAKHPUR,27338,All
2023,1,DELHI,GORAKHPUR,13491,13904,DELHI-GORAKHPUR,27395,All
2023,2,DELHI,GORAKHPUR,14131,13972,DELHI-GORAKHPUR,28103,All
2023,3,DELHI,GORAKHPUR,14145,13876,DELHI-GORAKHPUR,28021,All
2023,4,DELHI,GORAKHPUR,13102,11350,DELHI-GORAKHPUR,24452,All
2023,5,DELHI,GORAKHPUR,13604,12777,DELHI-GORAKHPUR,26381,All
2023,6,DELHI,GORAKHPUR,12401,12033,DELHI-GORAKHPUR,24434,All
2023,7,DELHI,GORAKHPUR,11481,11802,DELHI-GORAKHPUR,23283,All
2023,8,DELHI,GORAKHPUR,11112,10560,DELHI-GORAKHPUR,21672,All
2023,9,DELHI,GORAKHPUR,9562,9266,DELHI-GORAKHPUR,18828,All
2023,10,DELHI,GORAKHPUR,12564,10398,DELHI-GORAKHPUR,22962,All
2023,11,DELHI,GORAKHPUR,15599,13469,DELHI-GORAKHPUR,29068,All
2023,12,DELHI,GORAKHPUR,14252,14490,DELHI-GORAKHPUR,28742,All
2024,1,DELHI,GORAKHPUR,12843,12629,DELHI-GORAKHPUR,25472,All
2024,2,DELHI,GORAKHPUR,9978,9426,DELHI-GORAKHPUR,19404,All
2024,3,DELHI,GORAKHPUR,10849,9521,DELHI-GORAKHPUR,20370,All
2024,4,DELHI,GORAKHPUR,11638,10623,DELHI-GORAKHPUR,22261,All
2024,6,DELHI,GORAKHPUR,14858,14361,DELHI-GORAKHPUR,29219,All
2024,7,DELHI,GORAKHPUR,14173,14509,DELHI-GORAKHPUR,28682,All
2024,8,DELHI,GORAKHPUR,13715,13816,DELHI-GORAKHPUR,27531,All
2024,9,DELHI,GORAKHPUR,14191,12931,DELHI-GORAKHPUR,27122,All
2024,10,DELHI,GORAKHPUR,16193,13021,DELHI-GORAKHPUR,29214,All
2024,11,DELHI,GORAKHPUR,17210,15926,DELHI-GORAKHPUR,33136,All
2024,12,DELHI,GORAKHPUR,19165,18626,DELHI-GORAKHPUR,37791,All
2025,1,DELHI,GORAKHPUR,17919,17025,DELHI-GORAKHPUR,34944,All
2025,2,DELHI,GORAKHPUR,17107,16237,DELHI-GORAKHPUR,33344,All
2025,3,DELHI,GORAKHPUR,22750,21092,DELHI-GORAKHPUR,43842,All
2015,4,DELHI,GUWAHATI,30573,28765,DELHI-GUWAHATI,59338,All
2015,5,DELHI,GUWAHATI,33126,28542,DELHI-GUWAHATI,61668,All
2015,6,DELHI,GUWAHATI,34229,32483,DELHI-GUWAHATI,66712,All
2015,7,DELHI,GUWAHATI,35136,34126,DELHI-GUWAHATI,69262,All
2015,8,DELHI,GUWAHATI,31032,30519,DELHI-GUWAHATI,61551,All
2015,9,DELHI,GUWAHATI,32127,29561,DELHI-GUWAHATI,61688,All
2015,10,DELHI,GUWAHATI,32310,30664,DELHI-GUWAHATI,62974,All
2015,11,DELHI,GUWAHATI,35451,31901,DELHI-GUWAHATI,67352,All
2015,12,DELHI,GUWAHATI,40263,36895,DELHI-GUWAHATI,77158,All
2016,1,DELHI,GUWAHATI,35903,39605,DELHI-GUWAHATI,75508,All
2016,2,DELHI,GUWAHATI,39622,40162,DELHI-GUWAHATI,79784,All
2016,3,DELHI,GUWAHATI,39218,39216,DELHI-GUWAHATI,78434,All
2016,4,DELHI,GUWAHATI,45854,40904,DELHI-GUWAHATI,86758,All
2016,5,DELHI,GUWAHATI,42444,37738,DELHI-GUWAHATI,80182,All
2016,6,DELHI,GUWAHATI,46661,43607,DELHI-GUWAHATI,90268,All
2016,7,DELHI,GUWAHATI,54103,52545,DELHI-GUWAHATI,106648,All
2016,8,DELHI,GUWAHATI,50391,50376,DELHI-GUWAHATI,100767,All
2016,9,DELHI,GUWAHATI,60299,56233,DELHI-GUWAHATI,116532,All
2016,10,DELHI,GUWAHATI,54299,57550,DELHI-GUWAHATI,111849,All
2016,11,DELHI,GUWAHATI,51769,55340,DELHI-GUWAHATI,107109,All
2016,12,DELHI,GUWAHATI,60647,63818,DELHI-GUWAHATI,124465,All
2017,1,DELHI,GUWAHATI,57394,66768,DELHI-GUWAHATI,124162,All
2017,2,DELHI,GUWAHATI,47913,52157,DELHI-GUWAHATI,100070,All
2017,3,DELHI,GUWAHATI,51584,53323,DELHI-GUWAHATI,104907,All
2017,4,DELHI,GUWAHATI,56895,53173,DELHI-GUWAHATI,110068,All
2017,5,DELHI,GUWAHATI,55706,51558,DELHI-GUWAHATI,107264,All
2017,6,DELHI,GUWAHATI,52606,50046,DELHI-GUWAHATI,102652,All
2017,7,DELHI,GUWAHATI,54396,53635,DELHI-GUWAHATI,108031,All
2017,8,DELHI,GUWAHATI,57272,54339,DELHI-GUWAHATI,111611,All
2017,9,DELHI,GUWAHATI,58617,57962,DELHI-GUWAHATI,116579,All
2017,10,DELHI,GUWAHATI,63795,64084,DELHI-GUWAHATI,127879,All
2017,11,DELHI,GUWAHATI,55230,58476,DELHI-GUWAHATI,113706,All
2017,12,DELHI,GUWAHATI,61497,60847,DELHI-GUWAHATI,122344,All
2018,1,DELHI,GUWAHATI,60469,62635,DELHI-GUWAHATI,123104,All
2018,2,DELHI,GUWAHATI,54797,56997,DELHI-GUWAHATI,111794,All
2018,3,DELHI,GUWAHATI,63536,60308,DELHI-GUWAHATI,123844,All
2018,4,DELHI,GUWAHATI,62566,61515,DELHI-GUWAHATI,124081,All
2018,5,DELHI,GUWAHATI,64953,58384,DELHI-GUWAHATI,123337,All
2018,6,DELHI,GUWAHATI,50658,53319,DELHI-GUWAHATI,103977,All
2018,7,DELHI,GUWAHATI,48945,56469,DELHI-GUWAHATI,105414,All
2018,8,DELHI,GUWAHATI,58283,60603,DELHI-GUWAHATI,118886,All
2018,9,DELHI,GUWAHATI,61219,60308,DELHI-GUWAHATI,121527,All
2018,10,DELHI,GUWAHATI,72041,73250,DELHI-GUWAHATI,145291,All
2018,11,DELHI,GUWAHATI,69514,68321,DELHI-GUWAHATI,137835,All
2018,12,DELHI,GUWAHATI,76182,74406,DELHI-GUWAHATI,150588,All
2019,1,DELHI,GUWAHATI,68107,73836,DELHI-GUWAHATI,141943,All
2019,2,DELHI,GUWAHATI,60607,62627,DELHI-GUWAHATI,123234,All
2019,3,DELHI,GUWAHATI,59193,58797,DELHI-GUWAHATI,117990,All
2019,4,DELHI,GUWAHATI,57386,55506,DELHI-GUWAHATI,112892,All
2019,5,DELHI,GUWAHATI,61109,58550,DELHI-GUWAHATI,119659,All
2019,6,DELHI,GUWAHATI,63928,62875,DELHI-GUWAHATI,126803,All
2019,7,DELHI,GUWAHATI,64381,62594,DELHI-GUWAHATI,126975,All
2019,8,DELHI,GUWAHATI,63271,61681,DELHI-GUWAHATI,124952,All
2019,9,DELHI,GUWAHATI,62540,58619,DELHI-GUWAHATI,121159,All
2019,10,DELHI,GUWAHATI,64157,61772,DELHI-GUWAHATI,125929,All
2019,11,DELHI,GUWAHATI,61700,61848,DELHI-GUWAHATI,123548,All
2019,12,DELHI,GUWAHATI,60682,50690,DELHI-GUWAHATI,111372,All
2020,1,DELHI,GUWAHATI,58710,59276,DELHI-GUWAHATI,117986,All
2020,2,DELHI,GUWAHATI,54567,56231,DELHI-GUWAHATI,110798,All
2020,3,DELHI,GUWAHATI,46366,34451,DELHI-GUWAHATI,80817,All
2020,5,DELHI,GUWAHATI,4318,1784,DELHI-GUWAHATI,6102,All
2020,6,DELHI,GUWAHATI,19263,11579,DELHI-GUWAHATI,30842,All
2020,7,DELHI,GUWAHATI,21664,14087,DELHI-GUWAHATI,35751,All
2020,8,DELHI,GUWAHATI,27813,22291,DELHI-GUWAHATI,50104,All
2020,9,DELHI,GUWAHATI,28070,31955,DELHI-GUWAHATI,60025,All
2020,10,DELHI,GUWAHATI,34925,43848,DELHI-GUWAHATI,78773,All
2020,11,DELHI,GUWAHATI,44446,47611,DELHI-GUWAHATI,92057,All
2020,12,DELHI,GUWAHATI,55990,41130,DELHI-GUWAHATI,97120,All
2021,1,DELHI,GUWAHATI,46168,46662,DELHI-GUWAHATI,92830,All
2021,2,DELHI,GUWAHATI,43549,50127,DELHI-GUWAHATI,93676,All
2021,3,DELHI,GUWAHATI,57729,52462,DELHI-GUWAHATI,110191,All
2021,4,DELHI,GUWAHATI,49521,48798,DELHI-GUWAHATI,98319,All
2021,6,DELHI,GUWAHATI,19249,23020,DELHI-GUWAHATI,42269,All
2021,7,DELHI,GUWAHATI,24251,29095,DELHI-GUWAHATI,53346,All
2021,8,DELHI,GUWAHATI,35436,44716,DELHI-GUWAHATI,80152,All
2021,9,DELHI,GUWAHATI,43235,43381,DELHI-GUWAHATI,86616,All
2021,10,DELHI,GUWAHATI,61118,62684,DELHI-GUWAHATI,123802,All
2021,11,DELHI,GUWAHATI,63754,60882,DELHI-GUWAHATI,124636,All
2021,12,DELHI,GUWAHATI,70885,60910,DELHI-GUWAHATI,131795,All
2022,1,DELHI,GUWAHATI,43249,41575,DELHI-GUWAHATI,84824,All
2022,2,DELHI,GUWAHATI,47243,50234,DELHI-GUWAHATI,97477,All
2022,3,DELHI,GUWAHATI,61085,62593,DELHI-GUWAHATI,123678,All
2022,4,DELHI,GUWAHATI,62009,61174,DELHI-GUWAHATI,123183,All
2022,5,DELHI,GUWAHATI,55032,55233,DELHI-GUWAHATI,110265,All
2022,6,DELHI,GUWAHATI,53555,53225,DELHI-GUWAHATI,106780,All
2022,7,DELHI,GUWAHATI,59693,60997,DELHI-GUWAHATI,120690,All
2022,8,DELHI,GUWAHATI,54259,55521,DELHI-GUWAHATI,109780,All
2022,9,DELHI,GUWAHATI,57965,56487,DELHI-GUWAHATI,114452,All
2022,10,DELHI,GUWAHATI,67085,69825,DELHI-GUWAHATI,136910,All
2022,11,DELHI,GUWAHATI,64548,70906,DELHI-GUWAHATI,135454,All
2022,12,DELHI,GUWAHATI,69161,68428,DELHI-GUWAHATI,137589,All
2023,1,DELHI,GUWAHATI,62199,69240,DELHI-GUWAHATI,131439,All
2023,2,DELHI,GUWAHATI,58437,64124,DELHI-GUWAHATI,122561,All
2023,3,DELHI,GUWAHATI,68481,72189,DELHI-GUWAHATI,140670,All
2023,4,DELHI,GUWAHATI,66839,71447,DELHI-GUWAHATI,138286,All
2023,5,DELHI,GUWAHATI,68103,70310,DELHI-GUWAHATI,138413,All
2023,6,DELHI,GUWAHATI,66655,68475,DELHI-GUWAHATI,135130,All
2023,7,DELHI,GUWAHATI,63546,68778,DELHI-GUWAHATI,132324,All
2023,8,DELHI,GUWAHATI,57290,65174,DELHI-GUWAHATI,122464,All
2023,9,DELHI,GUWAHATI,64275,62712,DELHI-GUWAHATI,126987,All
2023,10,DELHI,GUWAHATI,68917,67634,DELHI-GUWAHATI,136551,All
2023,11,DELHI,GUWAHATI,65832,61346,DELHI-GUWAHATI,127178,All
2023,12,DELHI,GUWAHATI,67357,62355,DELHI-GUWAHATI,129712,All
2024,1,DELHI,GUWAHATI,63194,65812,DELHI-GUWAHATI,129006,All
2024,2,DELHI,GUWAHATI,61836,62535,DELHI-GUWAHATI,124371,All
2024,3,DELHI,GUWAHATI,65945,63530,DELHI-GUWAHATI,129475,All
2024,4,DELHI,GUWAHATI,67932,62532,DELHI-GUWAHATI,130464,All
2024,6,DELHI,GUWAHATI,66172,62392,DELHI-GUWAHATI,128564,All
2024,7,DELHI,GUWAHATI,64085,65140,DELHI-GUWAHATI,129225,All
2024,8,DELHI,GUWAHATI,59721,61488,DELHI-GUWAHATI,121209,All
2024,9,DELHI,GUWAHATI,61688,56394,DELHI-GUWAHATI,118082,All
2024,10,DELHI,GUWAHATI,66246,64859,DELHI-GUWAHATI,131105,All
2024,11,DELHI,GUWAHATI,65523,63956,DELHI-GUWAHATI,129479,All
2024,12,DELHI,GUWAHATI,71432,66018,DELHI-GUWAHATI,137450,All
2025,1,DELHI,GUWAHATI,65528,68780,DELHI-GUWAHATI,134308,All
2025,2,DELHI,GUWAHATI,61255,60745,DELHI-GUWAHATI,122000,All
2025,3,DELHI,GUWAHATI,68842,64457,DELHI-GUWAHATI,133299,All
2015,4,DELHI,GWALIOR,68,0,DELHI-GWALIOR,68,All
2015,5,DELHI,GWALIOR,142,0,DELHI-GWALIOR,142,All
2015,6,DELHI,GWALIOR,169,0,DELHI-GWALIOR,169,All
2015,7,DELHI,GWALIOR,131,0,DELHI-GWALIOR,131,All
2015,8,DELHI,GWALIOR,203,0,DELHI-GWALIOR,203,All
2015,9,DELHI,GWALIOR,111,0,DELHI-GWALIOR,111,All
2015,10,DELHI,GWALIOR,100,0,DELHI-GWALIOR,100,All
2017,4,DELHI,GWALIOR,9,22,DELHI-GWALIOR,31,All
2017,5,DELHI,GWALIOR,8,40,DELHI-GWALIOR,48,All
2017,6,DELHI,GWALIOR,0,1858,DELHI-GWALIOR,1858,All
2017,7,DELHI,GWALIOR,0,2040,DELHI-GWALIOR,2040,All
2017,8,DELHI,GWALIOR,0,917,DELHI-GWALIOR,917,All
2017,9,DELHI,GWALIOR,1014,801,DELHI-GWALIOR,1815,All
2017,10,DELHI,GWALIOR,1067,656,DELHI-GWALIOR,1723,All
2017,11,DELHI,GWALIOR,1089,607,DELHI-GWALIOR,1696,All
2017,12,DELHI,GWALIOR,626,625,DELHI-GWALIOR,1251,All
2018,1,DELHI,GWALIOR,652,534,DELHI-GWALIOR,1186,All
2018,2,DELHI,GWALIOR,1071,543,DELHI-GWALIOR,1614,All
2018,3,DELHI,GWALIOR,1026,556,DELHI-GWALIOR,1582,All
2018,4,DELHI,GWALIOR,1025,602,DELHI-GWALIOR,1627,All
2018,5,DELHI,GWALIOR,379,546,DELHI-GWALIOR,925,All
2018,6,DELHI,GWALIOR,386,454,DELHI-GWALIOR,840,All
2018,7,DELHI,GWALIOR,378,503,DELHI-GWALIOR,881,All
2018,8,DELHI,GWALIOR,405,592,DELHI-GWALIOR,997,All
2018,9,DELHI,GWALIOR,344,501,DELHI-GWALIOR,845,All
2018,11,DELHI,GWALIOR,1623,0,DELHI-GWALIOR,1623,All
2018,12,DELHI,GWALIOR,1616,0,DELHI-GWALIOR,1616,All
2019,1,DELHI,GWALIOR,409,492,DELHI-GWALIOR,901,All
2019,2,DELHI,GWALIOR,1529,0,DELHI-GWALIOR,1529,All
2019,3,DELHI,GWALIOR,500,423,DELHI-GWALIOR,923,All
2019,4,DELHI,GWALIOR,423,470,DELHI-GWALIOR,893,All
2019,5,DELHI,GWALIOR,410,513,DELHI-GWALIOR,923,All
2019,6,DELHI,GWALIOR,371,561,DELHI-GWALIOR,932,All
2019,7,DELHI,GWALIOR,286,307,DELHI-GWALIOR,593,All
2019,8,DELHI,GWALIOR,292,513,DELHI-GWALIOR,805,All
2019,9,DELHI,GWALIOR,339,467,DELHI-GWALIOR,806,All
2019,10,DELHI,GWALIOR,383,509,DELHI-GWALIOR,892,All
2019,11,DELHI,GWALIOR,428,506,DELHI-GWALIOR,934,All
2019,12,DELHI,GWALIOR,410,566,DELHI-GWALIOR,976,All
2020,1,DELHI,GWALIOR,415,521,DELHI-GWALIOR,936,All
2020,2,DELHI,GWALIOR,370,482,DELHI-GWALIOR,852,All
2020,3,DELHI,GWALIOR,234,283,DELHI-GWALIOR,517,All
2021,1,DELHI,GWALIOR,233,331,DELHI-GWALIOR,564,All
2021,2,DELHI,GWALIOR,634,961,DELHI-GWALIOR,1595,All
2021,3,DELHI,GWALIOR,405,649,DELHI-GWALIOR,1054,All
2021,9,DELHI,GWALIOR,568,1463,DELHI-GWALIOR,2031,All
2021,10,DELHI,GWALIOR,861,1254,DELHI-GWALIOR,2115,All
2021,11,DELHI,GWALIOR,1198,1545,DELHI-GWALIOR,2743,All
2021,12,DELHI,GWALIOR,1135,1807,DELHI-GWALIOR,2942,All
2022,1,DELHI,GWALIOR,399,707,DELHI-GWALIOR,1106,All
2022,2,DELHI,GWALIOR,464,566,DELHI-GWALIOR,1030,All
2022,3,DELHI,GWALIOR,1073,1342,DELHI-GWALIOR,2415,All
2022,4,DELHI,GWALIOR,1111,1431,DELHI-GWALIOR,2542,All
2022,5,DELHI,GWALIOR,1098,1477,DELHI-GWALIOR,2575,All
2022,6,DELHI,GWALIOR,1741,2004,DELHI-GWALIOR,3745,All
2022,7,DELHI,GWALIOR,2055,2288,DELHI-GWALIOR,4343,All
2022,8,DELHI,GWALIOR,2100,2332,DELHI-GWALIOR,4432,All
2022,9,DELHI,GWALIOR,2617,3261,DELHI-GWALIOR,5878,All
2022,10,DELHI,GWALIOR,3553,3518,DELHI-GWALIOR,7071,All
2022,11,DELHI,GWALIOR,2774,3378,DELHI-GWALIOR,6152,All
2022,12,DELHI,GWALIOR,2343,2891,DELHI-GWALIOR,5234,All
2023,1,DELHI,GWALIOR,1713,2281,DELHI-GWALIOR,3994,All
2023,2,DELHI,GWALIOR,2915,3981,DELHI-GWALIOR,6896,All
2023,3,DELHI,GWALIOR,3082,4028,DELHI-GWALIOR,7110,All
2023,4,DELHI,GWALIOR,2480,3448,DELHI-GWALIOR,5928,All
2023,5,DELHI,GWALIOR,3250,3101,DELHI-GWALIOR,6351,All
2023,6,DELHI,GWALIOR,3927,3587,DELHI-GWALIOR,7514,All
2023,7,DELHI,GWALIOR,3466,3947,DELHI-GWALIOR,7413,All
2023,8,DELHI,GWALIOR,3933,4077,DELHI-GWALIOR,8010,All
2023,9,DELHI,GWALIOR,3436,3695,DELHI-GWALIOR,7131,All
2023,10,DELHI,GWALIOR,3956,4018,DELHI-GWALIOR,7974,All
2023,11,DELHI,GWALIOR,4122,4140,DELHI-GWALIOR,8262,All
2023,12,DELHI,GWALIOR,4031,4442,DELHI-GWALIOR,8473,All
2024,1,DELHI,GWALIOR,4012,3697,DELHI-GWALIOR,7709,All
2024,2,DELHI,GWALIOR,5387,6363,DELHI-GWALIOR,11750,All
2024,3,DELHI,GWALIOR,5887,6117,DELHI-GWALIOR,12004,All
2024,4,DELHI,GWALIOR,4970,6329,DELHI-GWALIOR,11299,All
2024,6,DELHI,GWALIOR,8847,7504,DELHI-GWALIOR,16351,All
2024,7,DELHI,GWALIOR,6938,6434,DELHI-GWALIOR,13372,All
2024,8,DELHI,GWALIOR,7720,6975,DELHI-GWALIOR,14695,All
2024,9,DELHI,GWALIOR,7152,6844,DELHI-GWALIOR,13996,All
2024,10,DELHI,GWALIOR,6480,5570,DELHI-GWALIOR,12050,All
2024,11,DELHI,GWALIOR,4311,5062,DELHI-GWALIOR,9373,All
2024,12,DELHI,GWALIOR,4696,4743,DELHI-GWALIOR,9439,All
2025,1,DELHI,GWALIOR,3407,3383,DELHI-GWALIOR,6790,All
2025,2,DELHI,GWALIOR,4107,4253,DELHI-GWALIOR,8360,All
2025,3,DELHI,GWALIOR,4809,4747,DELHI-GWALIOR,9556,All
2023,11,DELHI,Goa,28206,28171,DELHI-Goa,56377,All
2023,12,DELHI,Goa,42099,35619,DELHI-Goa,77718,All
2024,1,DELHI,Goa,48933,46039,DELHI-Goa,94972,All
2024,2,DELHI,Goa,41506,42380,DELHI-Goa,83886,All
2024,3,DELHI,Goa,43829,45256,DELHI-Goa,89085,All
2024,4,DELHI,Goa,26172,29482,DELHI-Goa,55654,All
2024,6,DELHI,Goa,40474,38175,DELHI-Goa,78649,All
2024,7,DELHI,Goa,33221,34544,DELHI-Goa,67765,All
2024,8,DELHI,Goa,36925,35602,DELHI-Goa,72527,All
2024,9,DELHI,Goa,38557,39097,DELHI-Goa,77654,All
2024,10,DELHI,Goa,33656,40272,DELHI-Goa,73928,All
2024,11,DELHI,Goa,46341,42057,DELHI-Goa,88398,All
2024,12,DELHI,Goa,53353,49521,DELHI-Goa,102874,All
2025,1,DELHI,Goa,54132,57872,DELHI-Goa,112004,All
2025,2,DELHI,Goa,50219,52841,DELHI-Goa,103060,All
2025,3,DELHI,Goa,53722,54897,DELHI-Goa,108619,All
2022,11,DELHI,HUBLI,2912,2810,DELHI-HUBLI,5722,All
2022,12,DELHI,HUBLI,5108,4773,DELHI-HUBLI,9881,All
2023,1,DELHI,HUBLI,4408,4289,DELHI-HUBLI,8697,All
2023,2,DELHI,HUBLI,4557,4776,DELHI-HUBLI,9333,All
2023,3,DELHI,HUBLI,4872,4916,DELHI-HUBLI,9788,All
2023,4,DELHI,HUBLI,4642,5129,DELHI-HUBLI,9771,All
2023,5,DELHI,HUBLI,5587,5200,DELHI-HUBLI,10787,All
2023,6,DELHI,HUBLI,5291,4415,DELHI-HUBLI,9706,All
2023,7,DELHI,HUBLI,4251,3587,DELHI-HUBLI,7838,All
2023,8,DELHI,HUBLI,4171,3954,DELHI-HUBLI,8125,All
2023,9,DELHI,HUBLI,4238,3792,DELHI-HUBLI,8030,All
2023,10,DELHI,HUBLI,4989,5271,DELHI-HUBLI,10260,All
2023,11,DELHI,HUBLI,5055,4924,DELHI-HUBLI,9979,All
2023,12,DELHI,HUBLI,5450,4966,DELHI-HUBLI,10416,All
2024,1,DELHI,HUBLI,5228,4493,DELHI-HUBLI,9721,All
2024,2,DELHI,HUBLI,4506,4252,DELHI-HUBLI,8758,All
2024,3,DELHI,HUBLI,4199,4026,DELHI-HUBLI,8225,All
2024,4,DELHI,HUBLI,4319,4199,DELHI-HUBLI,8518,All
2024,6,DELHI,HUBLI,4955,3698,DELHI-HUBLI,8653,All
2024,7,DELHI,HUBLI,4107,4124,DELHI-HUBLI,8231,All
2024,8,DELHI,HUBLI,3613,3873,DELHI-HUBLI,7486,All
2024,9,DELHI,HUBLI,3668,4011,DELHI-HUBLI,7679,All
2024,10,DELHI,HUBLI,4279,4982,DELHI-HUBLI,9261,All
2024,11,DELHI,HUBLI,4947,4501,DELHI-HUBLI,9448,All
2024,12,DELHI,HUBLI,5127,4847,DELHI-HUBLI,9974,All
2025,1,DELHI,HUBLI,4405,4490,DELHI-HUBLI,8895,All
2025,2,DELHI,HUBLI,4681,4767,DELHI-HUBLI,9448,All
2025,3,DELHI,HUBLI,4811,4724,DELHI-HUBLI,9535,All
2015,4,DELHI,HYDERABAD,67637,76573,DELHI-HYDERABAD,144210,All
2015,5,DELHI,HYDERABAD,80779,78087,DELHI-HYDERABAD,158866,All
2015,6,DELHI,HYDERABAD,81092,75806,DELHI-HYDERABAD,156898,All
2015,7,DELHI,HYDERABAD,87482,86752,DELHI-HYDERABAD,174234,All
2015,8,DELHI,HYDERABAD,79969,91471,DELHI-HYDERABAD,171440,All
2015,9,DELHI,HYDERABAD,75312,82326,DELHI-HYDERABAD,157638,All
2015,10,DELHI,HYDERABAD,65093,70501,DELHI-HYDERABAD,135594,All
2015,11,DELHI,HYDERABAD,87322,86304,DELHI-HYDERABAD,173626,All
2015,12,DELHI,HYDERABAD,105732,93945,DELHI-HYDERABAD,199677,All
2016,1,DELHI,HYDERABAD,89577,94961,DELHI-HYDERABAD,184538,All
2016,2,DELHI,HYDERABAD,86844,88885,DELHI-HYDERABAD,175729,All
2016,3,DELHI,HYDERABAD,90742,93002,DELHI-HYDERABAD,183744,All
2016,4,DELHI,HYDERABAD,88647,97719,DELHI-HYDERABAD,186366,All
2016,5,DELHI,HYDERABAD,103696,101240,DELHI-HYDERABAD,204936,All
2016,6,DELHI,HYDERABAD,94332,81820,DELHI-HYDERABAD,176152,All
2016,7,DELHI,HYDERABAD,97757,94546,DELHI-HYDERABAD,192303,All
2016,8,DELHI,HYDERABAD,92403,95620,DELHI-HYDERABAD,188023,All
2016,9,DELHI,HYDERABAD,86342,92321,DELHI-HYDERABAD,178663,All
2016,10,DELHI,HYDERABAD,90014,91745,DELHI-HYDERABAD,181759,All
2016,11,DELHI,HYDERABAD,98905,90121,DELHI-HYDERABAD,189026,All
2016,12,DELHI,HYDERABAD,108758,93272,DELHI-HYDERABAD,202030,All
2017,1,DELHI,HYDERABAD,95390,101563,DELHI-HYDERABAD,196953,All
2017,2,DELHI,HYDERABAD,90576,94055,DELHI-HYDERABAD,184631,All
2017,3,DELHI,HYDERABAD,95820,95827,DELHI-HYDERABAD,191647,All
2017,4,DELHI,HYDERABAD,93808,106733,DELHI-HYDERABAD,200541,All
2017,5,DELHI,HYDERABAD,114562,105850,DELHI-HYDERABAD,220412,All
2017,6,DELHI,HYDERABAD,107113,96511,DELHI-HYDERABAD,203624,All
2017,7,DELHI,HYDERABAD,106824,99221,DELHI-HYDERABAD,206045,All
2017,8,DELHI,HYDERABAD,98701,102410,DELHI-HYDERABAD,201111,All
2017,9,DELHI,HYDERABAD,93644,100815,DELHI-HYDERABAD,194459,All
2017,10,DELHI,HYDERABAD,110931,108792,DELHI-HYDERABAD,219723,All
2017,11,DELHI,HYDERABAD,111250,107723,DELHI-HYDERABAD,218973,All
2017,12,DELHI,HYDERABAD,128562,119595,DELHI-HYDERABAD,248157,All
2018,1,DELHI,HYDERABAD,122401,124708,DELHI-HYDERABAD,247109,All
2018,2,DELHI,HYDERABAD,114461,117743,DELHI-HYDERABAD,232204,All
2018,3,DELHI,HYDERABAD,127272,125347,DELHI-HYDERABAD,252619,All
2018,4,DELHI,HYDERABAD,124715,131204,DELHI-HYDERABAD,255919,All
2018,5,DELHI,HYDERABAD,135001,128349,DELHI-HYDERABAD,263350,All
2018,6,DELHI,HYDERABAD,125246,116747,DELHI-HYDERABAD,241993,All
2018,7,DELHI,HYDERABAD,127474,125856,DELHI-HYDERABAD,253330,All
2018,8,DELHI,HYDERABAD,123963,129429,DELHI-HYDERABAD,253392,All
2018,9,DELHI,HYDERABAD,115179,122143,DELHI-HYDERABAD,237322,All
2018,10,DELHI,HYDERABAD,111629,115801,DELHI-HYDERABAD,227430,All
2018,11,DELHI,HYDERABAD,108528,103431,DELHI-HYDERABAD,211959,All
2018,12,DELHI,HYDERABAD,120858,112501,DELHI-HYDERABAD,233359,All
2019,1,DELHI,HYDERABAD,101385,112933,DELHI-HYDERABAD,214318,All
2019,2,DELHI,HYDERABAD,117398,122706,DELHI-HYDERABAD,240104,All
2019,3,DELHI,HYDERABAD,125846,134927,DELHI-HYDERABAD,260773,All
2019,4,DELHI,HYDERABAD,114011,132566,DELHI-HYDERABAD,246577,All
2019,5,DELHI,HYDERABAD,130471,126604,DELHI-HYDERABAD,257075,All
2019,6,DELHI,HYDERABAD,129494,124265,DELHI-HYDERABAD,253759,All
2019,7,DELHI,HYDERABAD,131447,129543,DELHI-HYDERABAD,260990,All
2019,8,DELHI,HYDERABAD,124912,131290,DELHI-HYDERABAD,256202,All
2019,9,DELHI,HYDERABAD,118659,127189,DELHI-HYDERABAD,245848,All
2019,10,DELHI,HYDERABAD,130392,137997,DELHI-HYDERABAD,268389,All
2019,11,DELHI,HYDERABAD,137511,132547,DELHI-HYDERABAD,270058,All
2019,12,DELHI,HYDERABAD,131997,119371,DELHI-HYDERABAD,251368,All
2020,1,DELHI,HYDERABAD,117255,125871,DELHI-HYDERABAD,243126,All
2020,2,DELHI,HYDERABAD,116866,122665,DELHI-HYDERABAD,239531,All
2020,3,DELHI,HYDERABAD,73001,70217,DELHI-HYDERABAD,143218,All
2020,5,DELHI,HYDERABAD,3817,3445,DELHI-HYDERABAD,7262,All
2020,6,DELHI,HYDERABAD,24861,21974,DELHI-HYDERABAD,46835,All
2020,7,DELHI,HYDERABAD,25364,23380,DELHI-HYDERABAD,48744,All
2020,8,DELHI,HYDERABAD,37053,32199,DELHI-HYDERABAD,69252,All
2020,9,DELHI,HYDERABAD,40579,37237,DELHI-HYDERABAD,77816,All
2020,10,DELHI,HYDERABAD,49016,48962,DELHI-HYDERABAD,97978,All
2020,11,DELHI,HYDERABAD,57292,58719,DELHI-HYDERABAD,116011,All
2020,12,DELHI,HYDERABAD,80006,80744,DELHI-HYDERABAD,160750,All
2021,1,DELHI,HYDERABAD,71931,72116,DELHI-HYDERABAD,144047,All
2021,2,DELHI,HYDERABAD,67093,73934,DELHI-HYDERABAD,141027,All
2021,3,DELHI,HYDERABAD,73562,81848,DELHI-HYDERABAD,155410,All
2021,4,DELHI,HYDERABAD,54246,57058,DELHI-HYDERABAD,111304,All
2021,6,DELHI,HYDERABAD,31671,30912,DELHI-HYDERABAD,62583,All
2021,7,DELHI,HYDERABAD,55874,56316,DELHI-HYDERABAD,112190,All
2021,8,DELHI,HYDERABAD,72922,75427,DELHI-HYDERABAD,148349,All
2021,9,DELHI,HYDERABAD,72782,74230,DELHI-HYDERABAD,147012,All
2021,10,DELHI,HYDERABAD,84927,91342,DELHI-HYDERABAD,176269,All
2021,11,DELHI,HYDERABAD,99247,101967,DELHI-HYDERABAD,201214,All
2021,12,DELHI,HYDERABAD,111496,106499,DELHI-HYDERABAD,217995,All
2022,1,DELHI,HYDERABAD,62685,70068,DELHI-HYDERABAD,132753,All
2022,2,DELHI,HYDERABAD,78021,87077,DELHI-HYDERABAD,165098,All
2022,3,DELHI,HYDERABAD,101543,101690,DELHI-HYDERABAD,203233,All
2022,4,DELHI,HYDERABAD,105525,105063,DELHI-HYDERABAD,210588,All
2022,5,DELHI,HYDERABAD,115216,106326,DELHI-HYDERABAD,221542,All
2022,6,DELHI,HYDERABAD,109543,92991,DELHI-HYDERABAD,202534,All
2022,7,DELHI,HYDERABAD,108301,106499,DELHI-HYDERABAD,214800,All
2022,8,DELHI,HYDERABAD,106809,115518,DELHI-HYDERABAD,222327,All
2022,9,DELHI,HYDERABAD,98944,110713,DELHI-HYDERABAD,209657,All
2022,10,DELHI,HYDERABAD,105267,107808,DELHI-HYDERABAD,213075,All
2022,11,DELHI,HYDERABAD,110402,103108,DELHI-HYDERABAD,213510,All
2022,12,DELHI,HYDERABAD,114690,109120,DELHI-HYDERABAD,223810,All
2023,1,DELHI,HYDERABAD,109622,112496,DELHI-HYDERABAD,222118,All
2023,2,DELHI,HYDERABAD,106126,109659,DELHI-HYDERABAD,215785,All
2023,3,DELHI,HYDERABAD,115659,112419,DELHI-HYDERABAD,228078,All
2023,4,DELHI,HYDERABAD,114693,118938,DELHI-HYDERABAD,233631,All
2023,5,DELHI,HYDERABAD,131919,126346,DELHI-HYDERABAD,258265,All
2023,6,DELHI,HYDERABAD,127168,123459,DELHI-HYDERABAD,250627,All
2023,7,DELHI,HYDERABAD,127624,127502,DELHI-HYDERABAD,255126,All
2023,8,DELHI,HYDERABAD,120417,128958,DELHI-HYDERABAD,249375,All
2023,9,DELHI,HYDERABAD,112723,114994,DELHI-HYDERABAD,227717,All
2023,10,DELHI,HYDERABAD,119546,123570,DELHI-HYDERABAD,243116,All
2023,11,DELHI,HYDERABAD,119604,125301,DELHI-HYDERABAD,244905,All
2023,12,DELHI,HYDERABAD,141392,135004,DELHI-HYDERABAD,276396,All
2024,1,DELHI,HYDERABAD,125954,131108,DELHI-HYDERABAD,257062,All
2024,2,DELHI,HYDERABAD,127583,132845,DELHI-HYDERABAD,260428,All
2024,3,DELHI,HYDERABAD,136046,138489,DELHI-HYDERABAD,274535,All
2024,4,DELHI,HYDERABAD,123479,137642,DELHI-HYDERABAD,261121,All
2024,6,DELHI,HYDERABAD,143661,129569,DELHI-HYDERABAD,273230,All
2024,7,DELHI,HYDERABAD,145674,142694,DELHI-HYDERABAD,288368,All
2024,8,DELHI,HYDERABAD,136422,147330,DELHI-HYDERABAD,283752,All
2024,9,DELHI,HYDERABAD,123034,133886,DELHI-HYDERABAD,256920,All
2024,10,DELHI,HYDERABAD,126055,142602,DELHI-HYDERABAD,268657,All
2024,11,DELHI,HYDERABAD,147397,139733,DELHI-HYDERABAD,287130,All
2024,12,DELHI,HYDERABAD,146637,134591,DELHI-HYDERABAD,281228,All
2025,1,DELHI,HYDERABAD,127462,130615,DELHI-HYDERABAD,258077,All
2025,2,DELHI,HYDERABAD,131586,137712,DELHI-HYDERABAD,269298,All
2025,3,DELHI,HYDERABAD,140650,139203,DELHI-HYDERABAD,279853,All
2023,3,DELHI,"Hollongi Airport, Itanagar",291,346,"DELHI-Hollongi Airport, Itanagar",637,All
2023,4,DELHI,"Hollongi Airport, Itanagar",460,387,"DELHI-Hollongi Airport, Itanagar",847,All
2023,5,DELHI,"Hollongi Airport, Itanagar",301,277,"DELHI-Hollongi Airport, Itanagar",578,All
2015,4,DELHI,IMPHAL,5077,5540,DELHI-IMPHAL,10617,All
2015,5,DELHI,IMPHAL,7147,5343,DELHI-IMPHAL,12490,All
2015,6,DELHI,IMPHAL,6488,6979,DELHI-IMPHAL,13467,All
2015,7,DELHI,IMPHAL,6046,7833,DELHI-IMPHAL,13879,All
2015,8,DELHI,IMPHAL,5101,6908,DELHI-IMPHAL,12009,All
2015,9,DELHI,IMPHAL,5884,4954,DELHI-IMPHAL,10838,All
2015,10,DELHI,IMPHAL,4108,18316,DELHI-IMPHAL,22424,All
2015,11,DELHI,IMPHAL,6957,6444,DELHI-IMPHAL,13401,All
2015,12,DELHI,IMPHAL,8137,6057,DELHI-IMPHAL,14194,All
2016,1,DELHI,IMPHAL,5003,7601,DELHI-IMPHAL,12604,All
2016,2,DELHI,IMPHAL,4934,5366,DELHI-IMPHAL,10300,All
2016,3,DELHI,IMPHAL,5914,5373,DELHI-IMPHAL,11287,All
2016,4,DELHI,IMPHAL,5180,5582,DELHI-IMPHAL,10762,All
2016,5,DELHI,IMPHAL,6972,5175,DELHI-IMPHAL,12147,All
2016,6,DELHI,IMPHAL,5972,6134,DELHI-IMPHAL,12106,All
2016,7,DELHI,IMPHAL,4705,6423,DELHI-IMPHAL,11128,All
2016,8,DELHI,IMPHAL,4560,6059,DELHI-IMPHAL,10619,All
2016,9,DELHI,IMPHAL,3340,4134,DELHI-IMPHAL,7474,All
2016,10,DELHI,IMPHAL,5005,4413,DELHI-IMPHAL,9418,All
2016,11,DELHI,IMPHAL,5269,5697,DELHI-IMPHAL,10966,All
2016,12,DELHI,IMPHAL,7731,5798,DELHI-IMPHAL,13529,All
2017,1,DELHI,IMPHAL,5437,7301,DELHI-IMPHAL,12738,All
2017,2,DELHI,IMPHAL,5130,5717,DELHI-IMPHAL,10847,All
2017,3,DELHI,IMPHAL,5726,6294,DELHI-IMPHAL,12020,All
2017,4,DELHI,IMPHAL,4377,5748,DELHI-IMPHAL,10125,All
2017,5,DELHI,IMPHAL,6212,5369,DELHI-IMPHAL,11581,All
2017,6,DELHI,IMPHAL,5879,6360,DELHI-IMPHAL,12239,All
2017,7,DELHI,IMPHAL,4506,6242,DELHI-IMPHAL,10748,All
2017,8,DELHI,IMPHAL,4300,5494,DELHI-IMPHAL,9794,All
2017,9,DELHI,IMPHAL,3820,4346,DELHI-IMPHAL,8166,All
2017,10,DELHI,IMPHAL,4485,4293,DELHI-IMPHAL,8778,All
2017,11,DELHI,IMPHAL,4757,4814,DELHI-IMPHAL,9571,All
2017,12,DELHI,IMPHAL,6835,3717,DELHI-IMPHAL,10552,All
2018,1,DELHI,IMPHAL,5459,5586,DELHI-IMPHAL,11045,All
2018,2,DELHI,IMPHAL,5001,5671,DELHI-IMPHAL,10672,All
2018,3,DELHI,IMPHAL,6247,7138,DELHI-IMPHAL,13385,All
2018,4,DELHI,IMPHAL,9800,9516,DELHI-IMPHAL,19316,All
2018,5,DELHI,IMPHAL,11843,8851,DELHI-IMPHAL,20694,All
2018,6,DELHI,IMPHAL,14622,11242,DELHI-IMPHAL,25864,All
2018,7,DELHI,IMPHAL,11729,11421,DELHI-IMPHAL,23150,All
2018,8,DELHI,IMPHAL,9017,10905,DELHI-IMPHAL,19922,All
2018,9,DELHI,IMPHAL,10005,10083,DELHI-IMPHAL,20088,All
2018,10,DELHI,IMPHAL,12718,12163,DELHI-IMPHAL,24881,All
2018,11,DELHI,IMPHAL,15775,14524,DELHI-IMPHAL,30299,All
2018,12,DELHI,IMPHAL,18654,14631,DELHI-IMPHAL,33285,All
2019,1,DELHI,IMPHAL,14306,17783,DELHI-IMPHAL,32089,All
2019,2,DELHI,IMPHAL,12963,13153,DELHI-IMPHAL,26116,All
2019,3,DELHI,IMPHAL,14435,13830,DELHI-IMPHAL,28265,All
2019,4,DELHI,IMPHAL,11956,12282,DELHI-IMPHAL,24238,All
2019,5,DELHI,IMPHAL,14515,11931,DELHI-IMPHAL,26446,All
2019,6,DELHI,IMPHAL,11402,12581,DELHI-IMPHAL,23983,All
2019,7,DELHI,IMPHAL,11185,13174,DELHI-IMPHAL,24359,All
2019,8,DELHI,IMPHAL,9716,12553,DELHI-IMPHAL,22269,All
2019,9,DELHI,IMPHAL,9586,11264,DELHI-IMPHAL,20850,All
2019,10,DELHI,IMPHAL,13188,12944,DELHI-IMPHAL,26132,All
2019,11,DELHI,IMPHAL,9567,13180,DELHI-IMPHAL,22747,All
2019,12,DELHI,IMPHAL,10840,13111,DELHI-IMPHAL,23951,All
2020,1,DELHI,IMPHAL,8725,13409,DELHI-IMPHAL,22134,All
2020,2,DELHI,IMPHAL,9522,13495,DELHI-IMPHAL,23017,All
2020,3,DELHI,IMPHAL,8161,7134,DELHI-IMPHAL,15295,All
2020,5,DELHI,IMPHAL,1159,422,DELHI-IMPHAL,1581,All
2020,6,DELHI,IMPHAL,4625,2634,DELHI-IMPHAL,7259,All
2020,7,DELHI,IMPHAL,3610,2411,DELHI-IMPHAL,6021,All
2020,8,DELHI,IMPHAL,2638,2754,DELHI-IMPHAL,5392,All
2020,9,DELHI,IMPHAL,4878,5233,DELHI-IMPHAL,10111,All
2020,10,DELHI,IMPHAL,6662,7526,DELHI-IMPHAL,14188,All
2020,11,DELHI,IMPHAL,8317,8400,DELHI-IMPHAL,16717,All
2020,12,DELHI,IMPHAL,12084,7155,DELHI-IMPHAL,19239,All
2021,1,DELHI,IMPHAL,8631,10512,DELHI-IMPHAL,19143,All
2021,2,DELHI,IMPHAL,8269,9835,DELHI-IMPHAL,18104,All
2021,3,DELHI,IMPHAL,10404,10711,DELHI-IMPHAL,21115,All
2021,4,DELHI,IMPHAL,9482,9316,DELHI-IMPHAL,18798,All
2021,6,DELHI,IMPHAL,5499,4621,DELHI-IMPHAL,10120,All
2021,7,DELHI,IMPHAL,5695,6130,DELHI-IMPHAL,11825,All
2021,8,DELHI,IMPHAL,6121,7174,DELHI-IMPHAL,13295,All
2021,9,DELHI,IMPHAL,5920,7753,DELHI-IMPHAL,13673,All
2021,10,DELHI,IMPHAL,7503,8131,DELHI-IMPHAL,15634,All
2021,11,DELHI,IMPHAL,7952,8556,DELHI-IMPHAL,16508,All
2021,12,DELHI,IMPHAL,8156,6774,DELHI-IMPHAL,14930,All
2022,1,DELHI,IMPHAL,6548,7411,DELHI-IMPHAL,13959,All
2022,2,DELHI,IMPHAL,6276,6826,DELHI-IMPHAL,13102,All
2022,3,DELHI,IMPHAL,8163,9364,DELHI-IMPHAL,17527,All
2022,4,DELHI,IMPHAL,8687,9233,DELHI-IMPHAL,17920,All
2022,5,DELHI,IMPHAL,9865,9395,DELHI-IMPHAL,19260,All
2022,6,DELHI,IMPHAL,9771,9171,DELHI-IMPHAL,18942,All
2022,7,DELHI,IMPHAL,8868,8902,DELHI-IMPHAL,17770,All
2022,8,DELHI,IMPHAL,8387,8707,DELHI-IMPHAL,17094,All
2022,9,DELHI,IMPHAL,9157,8837,DELHI-IMPHAL,17994,All
2022,10,DELHI,IMPHAL,8938,8156,DELHI-IMPHAL,17094,All
2022,11,DELHI,IMPHAL,9938,10092,DELHI-IMPHAL,20030,All
2022,12,DELHI,IMPHAL,8454,7365,DELHI-IMPHAL,15819,All
2023,1,DELHI,IMPHAL,7277,8308,DELHI-IMPHAL,15585,All
2023,2,DELHI,IMPHAL,8991,9784,DELHI-IMPHAL,18775,All
2023,3,DELHI,IMPHAL,10517,10690,DELHI-IMPHAL,21207,All
2023,4,DELHI,IMPHAL,9900,10055,DELHI-IMPHAL,19955,All
2023,5,DELHI,IMPHAL,8214,9029,DELHI-IMPHAL,17243,All
2023,6,DELHI,IMPHAL,8484,8047,DELHI-IMPHAL,16531,All
2023,7,DELHI,IMPHAL,9059,9512,DELHI-IMPHAL,18571,All
2023,8,DELHI,IMPHAL,9219,9886,DELHI-IMPHAL,19105,All
2023,9,DELHI,IMPHAL,8374,8774,DELHI-IMPHAL,17148,All
2023,10,DELHI,IMPHAL,8602,7818,DELHI-IMPHAL,16420,All
2023,11,DELHI,IMPHAL,9085,8513,DELHI-IMPHAL,17598,All
2023,12,DELHI,IMPHAL,9551,7958,DELHI-IMPHAL,17509,All
2024,1,DELHI,IMPHAL,7719,8012,DELHI-IMPHAL,15731,All
2024,2,DELHI,IMPHAL,7227,6685,DELHI-IMPHAL,13912,All
2024,3,DELHI,IMPHAL,7244,6919,DELHI-IMPHAL,14163,All
2024,4,DELHI,IMPHAL,7023,6441,DELHI-IMPHAL,13464,All
2024,6,DELHI,IMPHAL,8167,7167,DELHI-IMPHAL,15334,All
2024,7,DELHI,IMPHAL,7756,8604,DELHI-IMPHAL,16360,All
2024,8,DELHI,IMPHAL,8157,9245,DELHI-IMPHAL,17402,All
2024,9,DELHI,IMPHAL,7485,7810,DELHI-IMPHAL,15295,All
2024,10,DELHI,IMPHAL,7072,6410,DELHI-IMPHAL,13482,All
2024,11,DELHI,IMPHAL,8795,8194,DELHI-IMPHAL,16989,All
2024,12,DELHI,IMPHAL,8379,7381,DELHI-IMPHAL,15760,All
2025,1,DELHI,IMPHAL,6783,6772,DELHI-IMPHAL,13555,All
2025,2,DELHI,IMPHAL,8068,8332,DELHI-IMPHAL,16400,All
2025,3,DELHI,IMPHAL,10530,10109,DELHI-IMPHAL,20639,All
2015,4,DELHI,INDORE,18609,20595,DELHI-INDORE,39204,All
2015,5,DELHI,INDORE,19250,20866,DELHI-INDORE,40116,All
2015,6,DELHI,INDORE,19377,18708,DELHI-INDORE,38085,All
2015,7,DELHI,INDORE,18483,18876,DELHI-INDORE,37359,All
2015,8,DELHI,INDORE,18947,20149,DELHI-INDORE,39096,All
2015,9,DELHI,INDORE,17624,19511,DELHI-INDORE,37135,All
2015,10,DELHI,INDORE,18369,30980,DELHI-INDORE,49349,All
2015,11,DELHI,INDORE,20077,20923,DELHI-INDORE,41000,All
2015,12,DELHI,INDORE,22517,22606,DELHI-INDORE,45123,All
2016,1,DELHI,INDORE,20592,22711,DELHI-INDORE,43303,All
2016,2,DELHI,INDORE,20050,21327,DELHI-INDORE,41377,All
2016,3,DELHI,INDORE,20538,21089,DELHI-INDORE,41627,All
2016,4,DELHI,INDORE,22981,23438,DELHI-INDORE,46419,All
2016,5,DELHI,INDORE,29715,30259,DELHI-INDORE,59974,All
2016,6,DELHI,INDORE,24110,22408,DELHI-INDORE,46518,All
2016,7,DELHI,INDORE,24355,24616,DELHI-INDORE,48971,All
2016,8,DELHI,INDORE,24201,25511,DELHI-INDORE,49712,All
2016,9,DELHI,INDORE,22488,23023,DELHI-INDORE,45511,All
2016,10,DELHI,INDORE,21331,22074,DELHI-INDORE,43405,All
2016,11,DELHI,INDORE,26315,25571,DELHI-INDORE,51886,All
2016,12,DELHI,INDORE,28751,27115,DELHI-INDORE,55866,All
2017,1,DELHI,INDORE,24744,26441,DELHI-INDORE,51185,All
2017,2,DELHI,INDORE,23695,24716,DELHI-INDORE,48411,All
2017,3,DELHI,INDORE,25753,26066,DELHI-INDORE,51819,All
2017,4,DELHI,INDORE,26098,28720,DELHI-INDORE,54818,All
2017,5,DELHI,INDORE,29081,30908,DELHI-INDORE,59989,All
2017,6,DELHI,INDORE,28496,26619,DELHI-INDORE,55115,All
2017,7,DELHI,INDORE,27426,27467,DELHI-INDORE,54893,All
2017,8,DELHI,INDORE,25933,27763,DELHI-INDORE,53696,All
2017,9,DELHI,INDORE,25053,26045,DELHI-INDORE,51098,All
2017,10,DELHI,INDORE,29158,29116,DELHI-INDORE,58274,All
2017,11,DELHI,INDORE,28381,27663,DELHI-INDORE,56044,All
2017,12,DELHI,INDORE,28978,28192,DELHI-INDORE,57170,All
2018,1,DELHI,INDORE,26292,27762,DELHI-INDORE,54054,All
2018,2,DELHI,INDORE,27329,28711,DELHI-INDORE,56040,All
2018,3,DELHI,INDORE,31913,31317,DELHI-INDORE,63230,All
2018,4,DELHI,INDORE,31228,33722,DELHI-INDORE,64950,All
2018,5,DELHI,INDORE,31824,32901,DELHI-INDORE,64725,All
2018,6,DELHI,INDORE,31775,28367,DELHI-INDORE,60142,All
2018,7,DELHI,INDORE,31660,32514,DELHI-INDORE,64174,All
2018,8,DELHI,INDORE,29820,31825,DELHI-INDORE,61645,All
2018,9,DELHI,INDORE,31268,32426,DELHI-INDORE,63694,All
2018,10,DELHI,INDORE,28533,29916,DELHI-INDORE,58449,All
2018,11,DELHI,INDORE,28380,27450,DELHI-INDORE,55830,All
2018,12,DELHI,INDORE,33060,31774,DELHI-INDORE,64834,All
2019,1,DELHI,INDORE,29137,31563,DELHI-INDORE,60700,All
2019,2,DELHI,INDORE,26169,28207,DELHI-INDORE,54376,All
2019,3,DELHI,INDORE,25297,26590,DELHI-INDORE,51887,All
2019,4,DELHI,INDORE,27292,29363,DELHI-INDORE,56655,All
2019,5,DELHI,INDORE,29137,30324,DELHI-INDORE,59461,All
2019,6,DELHI,INDORE,32437,30275,DELHI-INDORE,62712,All
2019,7,DELHI,INDORE,32109,31503,DELHI-INDORE,63612,All
2019,8,DELHI,INDORE,31809,32637,DELHI-INDORE,64446,All
2019,9,DELHI,INDORE,31032,32742,DELHI-INDORE,63774,All
2019,10,DELHI,INDORE,33526,35109,DELHI-INDORE,68635,All
2019,11,DELHI,INDORE,45789,42880,DELHI-INDORE,88669,All
2019,12,DELHI,INDORE,46932,42381,DELHI-INDORE,89313,All
2020,1,DELHI,INDORE,43470,46108,DELHI-INDORE,89578,All
2020,2,DELHI,INDORE,47615,49712,DELHI-INDORE,97327,All
2020,3,DELHI,INDORE,30436,28717,DELHI-INDORE,59153,All
2020,5,DELHI,INDORE,855,1114,DELHI-INDORE,1969,All
2020,6,DELHI,INDORE,5327,4618,DELHI-INDORE,9945,All
2020,7,DELHI,INDORE,5918,4980,DELHI-INDORE,10898,All
2020,8,DELHI,INDORE,8798,9366,DELHI-INDORE,18164,All
2020,9,DELHI,INDORE,8645,9352,DELHI-INDORE,17997,All
2020,10,DELHI,INDORE,12773,13218,DELHI-INDORE,25991,All
2020,11,DELHI,INDORE,17971,16880,DELHI-INDORE,34851,All
2020,12,DELHI,INDORE,23851,21639,DELHI-INDORE,45490,All
2021,1,DELHI,INDORE,19966,21289,DELHI-INDORE,41255,All
2021,2,DELHI,INDORE,21851,22899,DELHI-INDORE,44750,All
2021,3,DELHI,INDORE,20566,20892,DELHI-INDORE,41458,All
2021,4,DELHI,INDORE,14943,14011,DELHI-INDORE,28954,All
2021,6,DELHI,INDORE,10561,9875,DELHI-INDORE,20436,All
2021,7,DELHI,INDORE,18448,17993,DELHI-INDORE,36441,All
2021,8,DELHI,INDORE,25821,25321,DELHI-INDORE,51142,All
2021,9,DELHI,INDORE,25078,25235,DELHI-INDORE,50313,All
2021,10,DELHI,INDORE,28230,27309,DELHI-INDORE,55539,All
2021,11,DELHI,INDORE,30762,31267,DELHI-INDORE,62029,All
2021,12,DELHI,INDORE,33836,32777,DELHI-INDORE,66613,All
2022,1,DELHI,INDORE,16902,16765,DELHI-INDORE,33667,All
2022,2,DELHI,INDORE,25253,26560,DELHI-INDORE,51813,All
2022,3,DELHI,INDORE,33840,33905,DELHI-INDORE,67745,All
2022,4,DELHI,INDORE,31096,32136,DELHI-INDORE,63232,All
2022,5,DELHI,INDORE,30815,31666,DELHI-INDORE,62481,All
2022,6,DELHI,INDORE,31120,26719,DELHI-INDORE,57839,All
2022,7,DELHI,INDORE,26078,24788,DELHI-INDORE,50866,All
2022,8,DELHI,INDORE,27288,26879,DELHI-INDORE,54167,All
2022,9,DELHI,INDORE,27729,27906,DELHI-INDORE,55635,All
2022,10,DELHI,INDORE,32165,31712,DELHI-INDORE,63877,All
2022,11,DELHI,INDORE,34220,33756,DELHI-INDORE,67976,All
2022,12,DELHI,INDORE,35568,35084,DELHI-INDORE,70652,All
2023,1,DELHI,INDORE,32793,34202,DELHI-INDORE,66995,All
2023,2,DELHI,INDORE,32849,33805,DELHI-INDORE,66654,All
2023,3,DELHI,INDORE,35791,36998,DELHI-INDORE,72789,All
2023,4,DELHI,INDORE,35912,38514,DELHI-INDORE,74426,All
2023,5,DELHI,INDORE,37640,39113,DELHI-INDORE,76753,All
2023,6,DELHI,INDORE,34249,32903,DELHI-INDORE,67152,All
2023,7,DELHI,INDORE,33741,34546,DELHI-INDORE,68287,All
2023,8,DELHI,INDORE,37910,37434,DELHI-INDORE,75344,All
2023,9,DELHI,INDORE,35057,35976,DELHI-INDORE,71033,All
2023,10,DELHI,INDORE,35169,35723,DELHI-INDORE,70892,All
2023,11,DELHI,INDORE,34537,34326,DELHI-INDORE,68863,All
2023,12,DELHI,INDORE,39320,37650,DELHI-INDORE,76970,All
2024,1,DELHI,INDORE,35305,34948,DELHI-INDORE,70253,All
2024,2,DELHI,INDORE,35392,36331,DELHI-INDORE,71723,All
2024,3,DELHI,INDORE,39730,39799,DELHI-INDORE,79529,All
2024,4,DELHI,INDORE,34419,34987,DELHI-INDORE,69406,All
2024,6,DELHI,INDORE,34958,32844,DELHI-INDORE,67802,All
2024,7,DELHI,INDORE,37393,37983,DELHI-INDORE,75376,All
2024,8,DELHI,INDORE,38289,39077,DELHI-INDORE,77366,All
2024,9,DELHI,INDORE,38228,39655,DELHI-INDORE,77883,All
2024,10,DELHI,INDORE,38807,38105,DELHI-INDORE,76912,All
2024,11,DELHI,INDORE,40828,40386,DELHI-INDORE,81214,All
2024,12,DELHI,INDORE,45799,42247,DELHI-INDORE,88046,All
2025,1,DELHI,INDORE,40145,42688,DELHI-INDORE,82833,All
2025,2,DELHI,INDORE,37445,39569,DELHI-INDORE,77014,All
2025,3,DELHI,INDORE,42275,42875,DELHI-INDORE,85150,All
2023,6,DELHI,Itanagar,439,377,DELHI-Itanagar,816,All
2023,7,DELHI,Itanagar,441,490,DELHI-Itanagar,931,All
2023,8,DELHI,Itanagar,602,542,DELHI-Itanagar,1144,All
2023,9,DELHI,Itanagar,629,868,DELHI-Itanagar,1497,All
2023,10,DELHI,Itanagar,2822,2869,DELHI-Itanagar,5691,All
2023,11,DELHI,Itanagar,2891,2744,DELHI-Itanagar,5635,All
2023,12,DELHI,Itanagar,2921,2697,DELHI-Itanagar,5618,All
2024,1,DELHI,Itanagar,2224,2315,DELHI-Itanagar,4539,All
2024,2,DELHI,Itanagar,2726,2751,DELHI-Itanagar,5477,All
2024,3,DELHI,Itanagar,2845,2820,DELHI-Itanagar,5665,All
2024,4,DELHI,Itanagar,3045,2961,DELHI-Itanagar,6006,All
2024,6,DELHI,Itanagar,2939,2736,DELHI-Itanagar,5675,All
2024,7,DELHI,Itanagar,2835,3080,DELHI-Itanagar,5915,All
2024,8,DELHI,Itanagar,2902,3000,DELHI-Itanagar,5902,All
2024,9,DELHI,Itanagar,2795,2826,DELHI-Itanagar,5621,All
2024,10,DELHI,Itanagar,3106,3011,DELHI-Itanagar,6117,All
2024,11,DELHI,Itanagar,3006,2870,DELHI-Itanagar,5876,All
2024,12,DELHI,Itanagar,3102,2831,DELHI-Itanagar,5933,All
2025,1,DELHI,Itanagar,2802,2878,DELHI-Itanagar,5680,All
2025,2,DELHI,Itanagar,2714,2704,DELHI-Itanagar,5418,All
2025,3,DELHI,Itanagar,3103,3056,DELHI-Itanagar,6159,All
2015,4,DELHI,JABALPUR,2984,2936,DELHI-JABALPUR,5920,All
2015,5,DELHI,JABALPUR,2906,2851,DELHI-JABALPUR,5757,All
2015,6,DELHI,JABALPUR,2892,2774,DELHI-JABALPUR,5666,All
2015,7,DELHI,JABALPUR,4673,4733,DELHI-JABALPUR,9406,All
2015,8,DELHI,JABALPUR,4381,4531,DELHI-JABALPUR,8912,All
2015,9,DELHI,JABALPUR,4240,4285,DELHI-JABALPUR,8525,All
2015,10,DELHI,JABALPUR,4498,4496,DELHI-JABALPUR,8994,All
2015,11,DELHI,JABALPUR,4664,4466,DELHI-JABALPUR,9130,All
2015,12,DELHI,JABALPUR,962,876,DELHI-JABALPUR,1838,All
2016,1,DELHI,JABALPUR,571,569,DELHI-JABALPUR,1140,All
2016,2,DELHI,JABALPUR,3246,3304,DELHI-JABALPUR,6550,All
2016,3,DELHI,JABALPUR,3452,3414,DELHI-JABALPUR,6866,All
2016,4,DELHI,JABALPUR,3548,3598,DELHI-JABALPUR,7146,All
2016,5,DELHI,JABALPUR,3450,3455,DELHI-JABALPUR,6905,All
2016,6,DELHI,JABALPUR,3428,3225,DELHI-JABALPUR,6653,All
2016,7,DELHI,JABALPUR,3317,3403,DELHI-JABALPUR,6720,All
2016,8,DELHI,JABALPUR,3773,3955,DELHI-JABALPUR,7728,All
2016,9,DELHI,JABALPUR,3767,3707,DELHI-JABALPUR,7474,All
2016,10,DELHI,JABALPUR,4203,3925,DELHI-JABALPUR,8128,All
2016,11,DELHI,JABALPUR,4160,4204,DELHI-JABALPUR,8364,All
2016,12,DELHI,JABALPUR,3880,3806,DELHI-JABALPUR,7686,All
2017,1,DELHI,JABALPUR,3861,3954,DELHI-JABALPUR,7815,All
2017,2,DELHI,JABALPUR,3673,3700,DELHI-JABALPUR,7373,All
2017,3,DELHI,JABALPUR,4108,4158,DELHI-JABALPUR,8266,All
2017,4,DELHI,JABALPUR,4086,3938,DELHI-JABALPUR,8024,All
2017,5,DELHI,JABALPUR,4275,4047,DELHI-JABALPUR,8322,All
2017,6,DELHI,JABALPUR,4239,3919,DELHI-JABALPUR,8158,All
2017,7,DELHI,JABALPUR,4401,4310,DELHI-JABALPUR,8711,All
2017,8,DELHI,JABALPUR,4307,4127,DELHI-JABALPUR,8434,All
2017,9,DELHI,JABALPUR,4260,4137,DELHI-JABALPUR,8397,All
2017,10,DELHI,JABALPUR,4632,4441,DELHI-JABALPUR,9073,All
2017,11,DELHI,JABALPUR,4612,4537,DELHI-JABALPUR,9149,All
2017,12,DELHI,JABALPUR,6089,5958,DELHI-JABALPUR,12047,All
2018,1,DELHI,JABALPUR,5519,5691,DELHI-JABALPUR,11210,All
2018,2,DELHI,JABALPUR,4432,4359,DELHI-JABALPUR,8791,All
2018,3,DELHI,JABALPUR,4483,4440,DELHI-JABALPUR,8923,All
2018,4,DELHI,JABALPUR,4374,4465,DELHI-JABALPUR,8839,All
2018,5,DELHI,JABALPUR,4848,4679,DELHI-JABALPUR,9527,All
2018,6,DELHI,JABALPUR,4230,4145,DELHI-JABALPUR,8375,All
2018,7,DELHI,JABALPUR,4148,4109,DELHI-JABALPUR,8257,All
2018,8,DELHI,JABALPUR,3894,3914,DELHI-JABALPUR,7808,All
2018,9,DELHI,JABALPUR,3935,3722,DELHI-JABALPUR,7657,All
2018,10,DELHI,JABALPUR,4133,4059,DELHI-JABALPUR,8192,All
2018,11,DELHI,JABALPUR,4044,3924,DELHI-JABALPUR,7968,All
2018,12,DELHI,JABALPUR,4259,4160,DELHI-JABALPUR,8419,All
2019,1,DELHI,JABALPUR,4013,3877,DELHI-JABALPUR,7890,All
2019,2,DELHI,JABALPUR,3833,3874,DELHI-JABALPUR,7707,All
2019,3,DELHI,JABALPUR,4356,4268,DELHI-JABALPUR,8624,All
2019,4,DELHI,JABALPUR,5484,5516,DELHI-JABALPUR,11000,All
2019,5,DELHI,JABALPUR,6161,6220,DELHI-JABALPUR,12381,All
2019,6,DELHI,JABALPUR,6302,6037,DELHI-JABALPUR,12339,All
2019,7,DELHI,JABALPUR,5905,5949,DELHI-JABALPUR,11854,All
2019,8,DELHI,JABALPUR,6385,6358,DELHI-JABALPUR,12743,All
2019,9,DELHI,JABALPUR,4950,4759,DELHI-JABALPUR,9709,All
2019,10,DELHI,JABALPUR,6277,5926,DELHI-JABALPUR,12203,All
2019,11,DELHI,JABALPUR,4317,4270,DELHI-JABALPUR,8587,All
2019,12,DELHI,JABALPUR,4251,3953,DELHI-JABALPUR,8204,All
2020,1,DELHI,JABALPUR,4402,4276,DELHI-JABALPUR,8678,All
2020,2,DELHI,JABALPUR,4145,4072,DELHI-JABALPUR,8217,All
2020,3,DELHI,JABALPUR,2917,2618,DELHI-JABALPUR,5535,All
2020,5,DELHI,JABALPUR,469,238,DELHI-JABALPUR,707,All
2020,6,DELHI,JABALPUR,2671,1416,DELHI-JABALPUR,4087,All
2020,7,DELHI,JABALPUR,2306,1558,DELHI-JABALPUR,3864,All
2020,8,DELHI,JABALPUR,2373,2452,DELHI-JABALPUR,4825,All
2020,9,DELHI,JABALPUR,2728,2652,DELHI-JABALPUR,5380,All
2020,10,DELHI,JABALPUR,3041,2793,DELHI-JABALPUR,5834,All
2020,11,DELHI,JABALPUR,5409,4680,DELHI-JABALPUR,10089,All
2020,12,DELHI,JABALPUR,5679,5466,DELHI-JABALPUR,11145,All
2021,1,DELHI,JABALPUR,4385,4463,DELHI-JABALPUR,8848,All
2021,2,DELHI,JABALPUR,5297,5088,DELHI-JABALPUR,10385,All
2021,3,DELHI,JABALPUR,5715,5039,DELHI-JABALPUR,10754,All
2021,4,DELHI,JABALPUR,3075,2713,DELHI-JABALPUR,5788,All
2021,6,DELHI,JABALPUR,2171,2267,DELHI-JABALPUR,4438,All
2021,7,DELHI,JABALPUR,3225,3477,DELHI-JABALPUR,6702,All
2021,8,DELHI,JABALPUR,5249,5429,DELHI-JABALPUR,10678,All
2021,9,DELHI,JABALPUR,5768,6038,DELHI-JABALPUR,11806,All
2021,10,DELHI,JABALPUR,7553,7160,DELHI-JABALPUR,14713,All
2021,11,DELHI,JABALPUR,8610,8434,DELHI-JABALPUR,17044,All
2021,12,DELHI,JABALPUR,8513,8109,DELHI-JABALPUR,16622,All
2022,1,DELHI,JABALPUR,3860,3861,DELHI-JABALPUR,7721,All
2022,2,DELHI,JABALPUR,3319,3469,DELHI-JABALPUR,6788,All
2022,3,DELHI,JABALPUR,8102,7475,DELHI-JABALPUR,15577,All
2022,4,DELHI,JABALPUR,8025,7440,DELHI-JABALPUR,15465,All
2022,5,DELHI,JABALPUR,8642,7965,DELHI-JABALPUR,16607,All
2022,6,DELHI,JABALPUR,10022,8478,DELHI-JABALPUR,18500,All
2022,7,DELHI,JABALPUR,5726,5146,DELHI-JABALPUR,10872,All
2022,8,DELHI,JABALPUR,6185,6001,DELHI-JABALPUR,12186,All
2022,9,DELHI,JABALPUR,5286,5301,DELHI-JABALPUR,10587,All
2022,10,DELHI,JABALPUR,4783,4504,DELHI-JABALPUR,9287,All
2022,11,DELHI,JABALPUR,7765,7904,DELHI-JABALPUR,15669,All
2022,12,DELHI,JABALPUR,8137,7842,DELHI-JABALPUR,15979,All
2023,1,DELHI,JABALPUR,8118,8561,DELHI-JABALPUR,16679,All
2023,2,DELHI,JABALPUR,8715,9196,DELHI-JABALPUR,17911,All
2023,3,DELHI,JABALPUR,7101,6976,DELHI-JABALPUR,14077,All
2023,4,DELHI,JABALPUR,6883,6879,DELHI-JABALPUR,13762,All
2023,5,DELHI,JABALPUR,7416,7103,DELHI-JABALPUR,14519,All
2023,6,DELHI,JABALPUR,7045,6339,DELHI-JABALPUR,13384,All
2023,7,DELHI,JABALPUR,6621,6521,DELHI-JABALPUR,13142,All
2023,8,DELHI,JABALPUR,6699,6585,DELHI-JABALPUR,13284,All
2023,9,DELHI,JABALPUR,6366,6642,DELHI-JABALPUR,13008,All
2023,10,DELHI,JABALPUR,7107,6872,DELHI-JABALPUR,13979,All
2023,11,DELHI,JABALPUR,6969,6426,DELHI-JABALPUR,13395,All
2023,12,DELHI,JABALPUR,7474,6970,DELHI-JABALPUR,14444,All
2024,1,DELHI,JABALPUR,6307,6530,DELHI-JABALPUR,12837,All
2024,2,DELHI,JABALPUR,6779,6699,DELHI-JABALPUR,13478,All
2024,3,DELHI,JABALPUR,7684,7707,DELHI-JABALPUR,15391,All
2024,4,DELHI,JABALPUR,6654,6528,DELHI-JABALPUR,13182,All
2024,6,DELHI,JABALPUR,7056,6428,DELHI-JABALPUR,13484,All
2024,7,DELHI,JABALPUR,6520,6190,DELHI-JABALPUR,12710,All
2024,8,DELHI,JABALPUR,6194,5916,DELHI-JABALPUR,12110,All
2024,9,DELHI,JABALPUR,5797,5485,DELHI-JABALPUR,11282,All
2024,10,DELHI,JABALPUR,5863,5092,DELHI-JABALPUR,10955,All
2024,11,DELHI,JABALPUR,5773,5667,DELHI-JABALPUR,11440,All
2024,12,DELHI,JABALPUR,6136,5793,DELHI-JABALPUR,11929,All
2025,1,DELHI,JABALPUR,5674,5723,DELHI-JABALPUR,11397,All
2025,2,DELHI,JABALPUR,5358,5340,DELHI-JABALPUR,10698,All
2025,3,DELHI,JABALPUR,6024,5738,DELHI-JABALPUR,11762,All
2022,5,DELHI,JAGDALPUR,107,316,DELHI-JAGDALPUR,423,All
2022,6,DELHI,JAGDALPUR,320,447,DELHI-JAGDALPUR,767,All
2022,7,DELHI,JAGDALPUR,259,315,DELHI-JAGDALPUR,574,All
2022,8,DELHI,JAGDALPUR,260,329,DELHI-JAGDALPUR,589,All
2022,9,DELHI,JAGDALPUR,236,346,DELHI-JAGDALPUR,582,All
2022,10,DELHI,JAGDALPUR,288,482,DELHI-JAGDALPUR,770,All
2022,11,DELHI,JAGDALPUR,360,516,DELHI-JAGDALPUR,876,All
2022,12,DELHI,JAGDALPUR,393,460,DELHI-JAGDALPUR,853,All
2023,1,DELHI,JAGDALPUR,229,324,DELHI-JAGDALPUR,553,All
2023,2,DELHI,JAGDALPUR,280,480,DELHI-JAGDALPUR,760,All
2023,3,DELHI,JAGDALPUR,281,413,DELHI-JAGDALPUR,694,All
2023,4,DELHI,JAGDALPUR,370,538,DELHI-JAGDALPUR,908,All
2023,5,DELHI,JAGDALPUR,306,458,DELHI-JAGDALPUR,764,All
2023,6,DELHI,JAGDALPUR,317,473,DELHI-JAGDALPUR,790,All
2023,7,DELHI,JAGDALPUR,262,340,DELHI-JAGDALPUR,602,All
2023,8,DELHI,JAGDALPUR,237,429,DELHI-JAGDALPUR,666,All
2023,9,DELHI,JAGDALPUR,261,363,DELHI-JAGDALPUR,624,All
2023,10,DELHI,JAGDALPUR,322,417,DELHI-JAGDALPUR,739,All
2023,11,DELHI,JAGDALPUR,216,306,DELHI-JAGDALPUR,522,All
2023,12,DELHI,JAGDALPUR,377,413,DELHI-JAGDALPUR,790,All
2024,1,DELHI,JAGDALPUR,257,353,DELHI-JAGDALPUR,610,All
2024,2,DELHI,JAGDALPUR,294,444,DELHI-JAGDALPUR,738,All
2024,3,DELHI,JAGDALPUR,333,520,DELHI-JAGDALPUR,853,All
2024,4,DELHI,JAGDALPUR,306,490,DELHI-JAGDALPUR,796,All
2024,6,DELHI,JAGDALPUR,300,469,DELHI-JAGDALPUR,769,All
2024,7,DELHI,JAGDALPUR,223,302,DELHI-JAGDALPUR,525,All
2024,8,DELHI,JAGDALPUR,265,390,DELHI-JAGDALPUR,655,All
2024,9,DELHI,JAGDALPUR,223,411,DELHI-JAGDALPUR,634,All
2024,10,DELHI,JAGDALPUR,219,455,DELHI-JAGDALPUR,674,All
2024,11,DELHI,JAGDALPUR,359,476,DELHI-JAGDALPUR,835,All
2024,12,DELHI,JAGDALPUR,436,541,DELHI-JAGDALPUR,977,All
2025,1,DELHI,JAGDALPUR,0,25,DELHI-JAGDALPUR,25,All
2025,3,DELHI,JAGDALPUR,382,581,DELHI-JAGDALPUR,963,All
2015,4,DELHI,JAIPUR,20461,20637,DELHI-JAIPUR,41098,All
2015,5,DELHI,JAIPUR,19422,20944,DELHI-JAIPUR,40366,All
2015,6,DELHI,JAIPUR,20058,19366,DELHI-JAIPUR,39424,All
2015,7,DELHI,JAIPUR,23733,22881,DELHI-JAIPUR,46614,All
2015,8,DELHI,JAIPUR,22933,23449,DELHI-JAIPUR,46382,All
2015,9,DELHI,JAIPUR,23433,24319,DELHI-JAIPUR,47752,All
2015,10,DELHI,JAIPUR,22157,24983,DELHI-JAIPUR,47140,All
2015,11,DELHI,JAIPUR,26684,25418,DELHI-JAIPUR,52102,All
2015,12,DELHI,JAIPUR,27755,27009,DELHI-JAIPUR,54764,All
2016,1,DELHI,JAIPUR,24878,25000,DELHI-JAIPUR,49878,All
2016,2,DELHI,JAIPUR,26871,26894,DELHI-JAIPUR,53765,All
2016,3,DELHI,JAIPUR,27302,26214,DELHI-JAIPUR,53516,All
2016,4,DELHI,JAIPUR,26956,26575,DELHI-JAIPUR,53531,All
2016,5,DELHI,JAIPUR,27757,28864,DELHI-JAIPUR,56621,All
2016,6,DELHI,JAIPUR,26522,24386,DELHI-JAIPUR,50908,All
2016,7,DELHI,JAIPUR,32184,30623,DELHI-JAIPUR,62807,All
2016,8,DELHI,JAIPUR,34208,32953,DELHI-JAIPUR,67161,All
2016,9,DELHI,JAIPUR,33655,32355,DELHI-JAIPUR,66010,All
2016,10,DELHI,JAIPUR,34145,31834,DELHI-JAIPUR,65979,All
2016,11,DELHI,JAIPUR,33666,34569,DELHI-JAIPUR,68235,All
2016,12,DELHI,JAIPUR,34424,31679,DELHI-JAIPUR,66103,All
2017,1,DELHI,JAIPUR,35465,34634,DELHI-JAIPUR,70099,All
2017,2,DELHI,JAIPUR,29658,28976,DELHI-JAIPUR,58634,All
2017,3,DELHI,JAIPUR,31910,31154,DELHI-JAIPUR,63064,All
2017,4,DELHI,JAIPUR,32894,31794,DELHI-JAIPUR,64688,All
2017,5,DELHI,JAIPUR,27424,30526,DELHI-JAIPUR,57950,All
2017,6,DELHI,JAIPUR,28908,25823,DELHI-JAIPUR,54731,All
2017,7,DELHI,JAIPUR,29094,28003,DELHI-JAIPUR,57097,All
2017,8,DELHI,JAIPUR,29152,28991,DELHI-JAIPUR,58143,All
2017,9,DELHI,JAIPUR,29325,27593,DELHI-JAIPUR,56918,All
2017,10,DELHI,JAIPUR,35949,34881,DELHI-JAIPUR,70830,All
2017,11,DELHI,JAIPUR,32379,31823,DELHI-JAIPUR,64202,All
2017,12,DELHI,JAIPUR,34041,32222,DELHI-JAIPUR,66263,All
2018,1,DELHI,JAIPUR,31755,31452,DELHI-JAIPUR,63207,All
2018,2,DELHI,JAIPUR,32574,32134,DELHI-JAIPUR,64708,All
2018,3,DELHI,JAIPUR,31640,31922,DELHI-JAIPUR,63562,All
2018,4,DELHI,JAIPUR,34388,33925,DELHI-JAIPUR,68313,All
2018,5,DELHI,JAIPUR,27898,29444,DELHI-JAIPUR,57342,All
2018,6,DELHI,JAIPUR,29978,26730,DELHI-JAIPUR,56708,All
2018,7,DELHI,JAIPUR,34857,32283,DELHI-JAIPUR,67140,All
2018,8,DELHI,JAIPUR,32858,31670,DELHI-JAIPUR,64528,All
2018,9,DELHI,JAIPUR,35388,34123,DELHI-JAIPUR,69511,All
2018,10,DELHI,JAIPUR,33193,32744,DELHI-JAIPUR,65937,All
2018,11,DELHI,JAIPUR,24403,23346,DELHI-JAIPUR,47749,All
2018,12,DELHI,JAIPUR,29145,28604,DELHI-JAIPUR,57749,All
2019,1,DELHI,JAIPUR,26049,27698,DELHI-JAIPUR,53747,All
2019,2,DELHI,JAIPUR,25712,27297,DELHI-JAIPUR,53009,All
2019,3,DELHI,JAIPUR,24235,24889,DELHI-JAIPUR,49124,All
2019,4,DELHI,JAIPUR,20425,20937,DELHI-JAIPUR,41362,All
2019,5,DELHI,JAIPUR,17266,20573,DELHI-JAIPUR,37839,All
2019,6,DELHI,JAIPUR,20259,19104,DELHI-JAIPUR,39363,All
2019,7,DELHI,JAIPUR,21410,21130,DELHI-JAIPUR,42540,All
2019,8,DELHI,JAIPUR,23339,23360,DELHI-JAIPUR,46699,All
2019,9,DELHI,JAIPUR,22755,23009,DELHI-JAIPUR,45764,All
2019,10,DELHI,JAIPUR,26482,26692,DELHI-JAIPUR,53174,All
2019,11,DELHI,JAIPUR,33792,32566,DELHI-JAIPUR,66358,All
2019,12,DELHI,JAIPUR,32026,30065,DELHI-JAIPUR,62091,All
2020,1,DELHI,JAIPUR,27605,26831,DELHI-JAIPUR,54436,All
2020,2,DELHI,JAIPUR,32057,30869,DELHI-JAIPUR,62926,All
2020,3,DELHI,JAIPUR,15115,16544,DELHI-JAIPUR,31659,All
2020,5,DELHI,JAIPUR,2868,1099,DELHI-JAIPUR,3967,All
2020,6,DELHI,JAIPUR,7063,5083,DELHI-JAIPUR,12146,All
2020,7,DELHI,JAIPUR,5622,6050,DELHI-JAIPUR,11672,All
2020,8,DELHI,JAIPUR,5508,6358,DELHI-JAIPUR,11866,All
2020,9,DELHI,JAIPUR,4340,4994,DELHI-JAIPUR,9334,All
2020,10,DELHI,JAIPUR,7553,8241,DELHI-JAIPUR,15794,All
2020,11,DELHI,JAIPUR,10837,9759,DELHI-JAIPUR,20596,All
2020,12,DELHI,JAIPUR,17368,15821,DELHI-JAIPUR,33189,All
2021,1,DELHI,JAIPUR,14381,15721,DELHI-JAIPUR,30102,All
2021,2,DELHI,JAIPUR,17611,17748,DELHI-JAIPUR,35359,All
2021,3,DELHI,JAIPUR,17859,17214,DELHI-JAIPUR,35073,All
2021,4,DELHI,JAIPUR,9795,11108,DELHI-JAIPUR,20903,All
2021,6,DELHI,JAIPUR,7177,7554,DELHI-JAIPUR,14731,All
2021,7,DELHI,JAIPUR,11909,12515,DELHI-JAIPUR,24424,All
2021,8,DELHI,JAIPUR,13806,12852,DELHI-JAIPUR,26658,All
2021,9,DELHI,JAIPUR,18010,16581,DELHI-JAIPUR,34591,All
2021,10,DELHI,JAIPUR,20046,18514,DELHI-JAIPUR,38560,All
2021,11,DELHI,JAIPUR,25572,23073,DELHI-JAIPUR,48645,All
2021,12,DELHI,JAIPUR,26875,22876,DELHI-JAIPUR,49751,All
2022,1,DELHI,JAIPUR,11617,10898,DELHI-JAIPUR,22515,All
2022,2,DELHI,JAIPUR,18459,15729,DELHI-JAIPUR,34188,All
2022,3,DELHI,JAIPUR,22257,20938,DELHI-JAIPUR,43195,All
2022,4,DELHI,JAIPUR,17376,16049,DELHI-JAIPUR,33425,All
2022,5,DELHI,JAIPUR,18226,16936,DELHI-JAIPUR,35162,All
2022,6,DELHI,JAIPUR,20822,17541,DELHI-JAIPUR,38363,All
2022,7,DELHI,JAIPUR,22796,20360,DELHI-JAIPUR,43156,All
2022,8,DELHI,JAIPUR,25107,22015,DELHI-JAIPUR,47122,All
2022,9,DELHI,JAIPUR,24028,22700,DELHI-JAIPUR,46728,All
2022,10,DELHI,JAIPUR,27066,24033,DELHI-JAIPUR,51099,All
2022,11,DELHI,JAIPUR,29436,27824,DELHI-JAIPUR,57260,All
2022,12,DELHI,JAIPUR,38627,34799,DELHI-JAIPUR,73426,All
2023,1,DELHI,JAIPUR,36045,35935,DELHI-JAIPUR,71980,All
2023,2,DELHI,JAIPUR,33376,33552,DELHI-JAIPUR,66928,All
2023,3,DELHI,JAIPUR,30753,29649,DELHI-JAIPUR,60402,All
2023,4,DELHI,JAIPUR,26627,26419,DELHI-JAIPUR,53046,All
2023,5,DELHI,JAIPUR,28355,28785,DELHI-JAIPUR,57140,All
2023,6,DELHI,JAIPUR,26519,23936,DELHI-JAIPUR,50455,All
2023,7,DELHI,JAIPUR,24361,23648,DELHI-JAIPUR,48009,All
2023,8,DELHI,JAIPUR,24078,23326,DELHI-JAIPUR,47404,All
2023,9,DELHI,JAIPUR,21364,21976,DELHI-JAIPUR,43340,All
2023,10,DELHI,JAIPUR,22903,23187,DELHI-JAIPUR,46090,All
2023,11,DELHI,JAIPUR,29064,27809,DELHI-JAIPUR,56873,All
2023,12,DELHI,JAIPUR,32541,33371,DELHI-JAIPUR,65912,All
2024,1,DELHI,JAIPUR,27518,30537,DELHI-JAIPUR,58055,All
2024,2,DELHI,JAIPUR,24196,25419,DELHI-JAIPUR,49615,All
2024,3,DELHI,JAIPUR,25576,27161,DELHI-JAIPUR,52737,All
2024,4,DELHI,JAIPUR,24569,27097,DELHI-JAIPUR,51666,All
2024,6,DELHI,JAIPUR,24369,22624,DELHI-JAIPUR,46993,All
2024,7,DELHI,JAIPUR,24145,24875,DELHI-JAIPUR,49020,All
2024,8,DELHI,JAIPUR,24422,24964,DELHI-JAIPUR,49386,All
2024,9,DELHI,JAIPUR,25086,26267,DELHI-JAIPUR,51353,All
2024,10,DELHI,JAIPUR,26740,25575,DELHI-JAIPUR,52315,All
2024,11,DELHI,JAIPUR,26020,26158,DELHI-JAIPUR,52178,All
2024,12,DELHI,JAIPUR,29148,27091,DELHI-JAIPUR,56239,All
2025,1,DELHI,JAIPUR,22917,22556,DELHI-JAIPUR,45473,All
2025,2,DELHI,JAIPUR,22683,22915,DELHI-JAIPUR,45598,All
2025,3,DELHI,JAIPUR,22834,23600,DELHI-JAIPUR,46434,All
2017,10,DELHI,JAISALMER,190,194,DELHI-JAISALMER,384,All
2017,11,DELHI,JAISALMER,1837,1986,DELHI-JAISALMER,3823,All
2017,12,DELHI,JAISALMER,2267,2279,DELHI-JAISALMER,4546,All
2018,1,DELHI,JAISALMER,2250,2339,DELHI-JAISALMER,4589,All
2018,2,DELHI,JAISALMER,2381,2343,DELHI-JAISALMER,4724,All
2018,3,DELHI,JAISALMER,2318,2354,DELHI-JAISALMER,4672,All
2018,4,DELHI,JAISALMER,2054,2204,DELHI-JAISALMER,4258,All
2018,5,DELHI,JAISALMER,1230,1361,DELHI-JAISALMER,2591,All
2018,10,DELHI,JAISALMER,1783,1749,DELHI-JAISALMER,3532,All
2018,11,DELHI,JAISALMER,4119,4358,DELHI-JAISALMER,8477,All
2018,12,DELHI,JAISALMER,4048,4377,DELHI-JAISALMER,8425,All
2019,1,DELHI,JAISALMER,4139,4575,DELHI-JAISALMER,8714,All
2019,2,DELHI,JAISALMER,4370,5044,DELHI-JAISALMER,9414,All
2019,3,DELHI,JAISALMER,2089,2326,DELHI-JAISALMER,4415,All
2019,10,DELHI,JAISALMER,589,507,DELHI-JAISALMER,1096,All
2019,11,DELHI,JAISALMER,3826,3757,DELHI-JAISALMER,7583,All
2019,12,DELHI,JAISALMER,3991,3906,DELHI-JAISALMER,7897,All
2020,1,DELHI,JAISALMER,3528,3473,DELHI-JAISALMER,7001,All
2020,2,DELHI,JAISALMER,3853,3762,DELHI-JAISALMER,7615,All
2020,3,DELHI,JAISALMER,1406,2014,DELHI-JAISALMER,3420,All
2020,10,DELHI,JAISALMER,94,48,DELHI-JAISALMER,142,All
2020,11,DELHI,JAISALMER,793,933,DELHI-JAISALMER,1726,All
2020,12,DELHI,JAISALMER,1453,1459,DELHI-JAISALMER,2912,All
2021,1,DELHI,JAISALMER,2030,2213,DELHI-JAISALMER,4243,All
2021,2,DELHI,JAISALMER,593,498,DELHI-JAISALMER,1091,All
2021,3,DELHI,JAISALMER,929,950,DELHI-JAISALMER,1879,All
2021,10,DELHI,JAISALMER,122,84,DELHI-JAISALMER,206,All
2021,11,DELHI,JAISALMER,4304,4230,DELHI-JAISALMER,8534,All
2021,12,DELHI,JAISALMER,4861,4848,DELHI-JAISALMER,9709,All
2022,1,DELHI,JAISALMER,1961,2596,DELHI-JAISALMER,4557,All
2022,2,DELHI,JAISALMER,3558,3506,DELHI-JAISALMER,7064,All
2022,3,DELHI,JAISALMER,2875,2992,DELHI-JAISALMER,5867,All
2022,10,DELHI,JAISALMER,220,201,DELHI-JAISALMER,421,All
2022,11,DELHI,JAISALMER,5114,4943,DELHI-JAISALMER,10057,All
2022,12,DELHI,JAISALMER,6745,6488,DELHI-JAISALMER,13233,All
2023,1,DELHI,JAISALMER,6422,6711,DELHI-JAISALMER,13133,All
2023,2,DELHI,JAISALMER,6477,6745,DELHI-JAISALMER,13222,All
2023,3,DELHI,JAISALMER,2473,2586,DELHI-JAISALMER,5059,All
2023,10,DELHI,JAISALMER,2657,2815,DELHI-JAISALMER,5472,All
2023,11,DELHI,JAISALMER,4582,4433,DELHI-JAISALMER,9015,All
2023,12,DELHI,JAISALMER,9601,9199,DELHI-JAISALMER,18800,All
2024,1,DELHI,JAISALMER,7927,8039,DELHI-JAISALMER,15966,All
2024,2,DELHI,JAISALMER,4737,4877,DELHI-JAISALMER,9614,All
2024,3,DELHI,JAISALMER,2079,2143,DELHI-JAISALMER,4222,All
2024,10,DELHI,JAISALMER,3877,3945,DELHI-JAISALMER,7822,All
2024,11,DELHI,JAISALMER,5144,4945,DELHI-JAISALMER,10089,All
2024,12,DELHI,JAISALMER,5180,5149,DELHI-JAISALMER,10329,All
2025,1,DELHI,JAISALMER,5308,5392,DELHI-JAISALMER,10700,All
2025,2,DELHI,JAISALMER,5169,5095,DELHI-JAISALMER,10264,All
2025,3,DELHI,JAISALMER,2177,2068,DELHI-JAISALMER,4245,All
2015,4,DELHI,JAMMU,27750,22991,DELHI-JAMMU,50741,All
2015,5,DELHI,JAMMU,32751,24441,DELHI-JAMMU,57192,All
2015,6,DELHI,JAMMU,31471,22139,DELHI-JAMMU,53610,All
2015,7,DELHI,JAMMU,29707,22881,DELHI-JAMMU,52588,All
2015,8,DELHI,JAMMU,26479,20999,DELHI-JAMMU,47478,All
2015,9,DELHI,JAMMU,31445,24929,DELHI-JAMMU,56374,All
2015,10,DELHI,JAMMU,31508,31815,DELHI-JAMMU,63323,All
2015,11,DELHI,JAMMU,27405,25322,DELHI-JAMMU,52727,All
2015,12,DELHI,JAMMU,26105,24443,DELHI-JAMMU,50548,All
2016,1,DELHI,JAMMU,23624,21976,DELHI-JAMMU,45600,All
2016,2,DELHI,JAMMU,26733,23704,DELHI-JAMMU,50437,All
2016,3,DELHI,JAMMU,26455,23985,DELHI-JAMMU,50440,All
2016,4,DELHI,JAMMU,25176,20978,DELHI-JAMMU,46154,All
2016,5,DELHI,JAMMU,24908,19515,DELHI-JAMMU,44423,All
2016,6,DELHI,JAMMU,23357,17260,DELHI-JAMMU,40617,All
2016,7,DELHI,JAMMU,22640,19929,DELHI-JAMMU,42569,All
2016,8,DELHI,JAMMU,24197,21118,DELHI-JAMMU,45315,All
2016,9,DELHI,JAMMU,29805,23910,DELHI-JAMMU,53715,All
2016,10,DELHI,JAMMU,32415,24714,DELHI-JAMMU,57129,All
2016,11,DELHI,JAMMU,31139,30870,DELHI-JAMMU,62009,All
2016,12,DELHI,JAMMU,30558,28488,DELHI-JAMMU,59046,All
2017,1,DELHI,JAMMU,27765,26288,DELHI-JAMMU,54053,All
2017,2,DELHI,JAMMU,26525,26045,DELHI-JAMMU,52570,All
2017,3,DELHI,JAMMU,30395,31100,DELHI-JAMMU,61495,All
2017,4,DELHI,JAMMU,30332,31605,DELHI-JAMMU,61937,All
2017,5,DELHI,JAMMU,30326,29707,DELHI-JAMMU,60033,All
2017,6,DELHI,JAMMU,32048,30243,DELHI-JAMMU,62291,All
2017,7,DELHI,JAMMU,28994,27414,DELHI-JAMMU,56408,All
2017,8,DELHI,JAMMU,29684,26903,DELHI-JAMMU,56587,All
2017,9,DELHI,JAMMU,31286,26833,DELHI-JAMMU,58119,All
2017,10,DELHI,JAMMU,36084,31241,DELHI-JAMMU,67325,All
2017,11,DELHI,JAMMU,35348,27852,DELHI-JAMMU,63200,All
2017,12,DELHI,JAMMU,36437,29185,DELHI-JAMMU,65622,All
2018,1,DELHI,JAMMU,33935,25830,DELHI-JAMMU,59765,All
2018,2,DELHI,JAMMU,26274,27490,DELHI-JAMMU,53764,All
2018,3,DELHI,JAMMU,27487,30564,DELHI-JAMMU,58051,All
2018,4,DELHI,JAMMU,26565,26014,DELHI-JAMMU,52579,All
2018,5,DELHI,JAMMU,25736,24036,DELHI-JAMMU,49772,All
2018,6,DELHI,JAMMU,26470,26790,DELHI-JAMMU,53260,All
2018,7,DELHI,JAMMU,23921,24041,DELHI-JAMMU,47962,All
2018,8,DELHI,JAMMU,26884,24995,DELHI-JAMMU,51879,All
2018,9,DELHI,JAMMU,25611,23075,DELHI-JAMMU,48686,All
2018,10,DELHI,JAMMU,26943,22841,DELHI-JAMMU,49784,All
2018,11,DELHI,JAMMU,26799,19351,DELHI-JAMMU,46150,All
2018,12,DELHI,JAMMU,28397,20974,DELHI-JAMMU,49371,All
2019,1,DELHI,JAMMU,25913,19162,DELHI-JAMMU,45075,All
2019,2,DELHI,JAMMU,17525,19799,DELHI-JAMMU,37324,All
2019,3,DELHI,JAMMU,20387,23011,DELHI-JAMMU,43398,All
2019,4,DELHI,JAMMU,25992,25435,DELHI-JAMMU,51427,All
2019,5,DELHI,JAMMU,28738,27008,DELHI-JAMMU,55746,All
2019,6,DELHI,JAMMU,30218,27299,DELHI-JAMMU,57517,All
2019,7,DELHI,JAMMU,28029,26343,DELHI-JAMMU,54372,All
2019,8,DELHI,JAMMU,24747,23930,DELHI-JAMMU,48677,All
2019,9,DELHI,JAMMU,28682,26553,DELHI-JAMMU,55235,All
2019,10,DELHI,JAMMU,27406,24314,DELHI-JAMMU,51720,All
2019,11,DELHI,JAMMU,31061,29501,DELHI-JAMMU,60562,All
2019,12,DELHI,JAMMU,28423,26232,DELHI-JAMMU,54655,All
2020,1,DELHI,JAMMU,26980,23852,DELHI-JAMMU,50832,All
2020,2,DELHI,JAMMU,30692,27249,DELHI-JAMMU,57941,All
2020,3,DELHI,JAMMU,19998,17887,DELHI-JAMMU,37885,All
2020,5,DELHI,JAMMU,1333,960,DELHI-JAMMU,2293,All
2020,6,DELHI,JAMMU,11214,11715,DELHI-JAMMU,22929,All
2020,7,DELHI,JAMMU,16270,15486,DELHI-JAMMU,31756,All
2020,8,DELHI,JAMMU,23203,20223,DELHI-JAMMU,43426,All
2020,9,DELHI,JAMMU,31124,22922,DELHI-JAMMU,54046,All
2020,10,DELHI,JAMMU,40658,32680,DELHI-JAMMU,73338,All
2020,11,DELHI,JAMMU,39977,32075,DELHI-JAMMU,72052,All
2020,12,DELHI,JAMMU,35303,32367,DELHI-JAMMU,67670,All
2021,1,DELHI,JAMMU,32111,31798,DELHI-JAMMU,63909,All
2021,2,DELHI,JAMMU,35383,28855,DELHI-JAMMU,64238,All
2021,3,DELHI,JAMMU,35248,27070,DELHI-JAMMU,62318,All
2021,4,DELHI,JAMMU,26593,21157,DELHI-JAMMU,47750,All
2021,6,DELHI,JAMMU,17742,17969,DELHI-JAMMU,35711,All
2021,7,DELHI,JAMMU,21279,21653,DELHI-JAMMU,42932,All
2021,8,DELHI,JAMMU,30433,31929,DELHI-JAMMU,62362,All
2021,9,DELHI,JAMMU,32556,33194,DELHI-JAMMU,65750,All
2021,10,DELHI,JAMMU,42689,46201,DELHI-JAMMU,88890,All
2021,11,DELHI,JAMMU,45225,43218,DELHI-JAMMU,88443,All
2021,12,DELHI,JAMMU,45198,42680,DELHI-JAMMU,87878,All
2022,1,DELHI,JAMMU,28024,26543,DELHI-JAMMU,54567,All
2022,2,DELHI,JAMMU,31582,31087,DELHI-JAMMU,62669,All
2022,3,DELHI,JAMMU,43956,42135,DELHI-JAMMU,86091,All
2022,4,DELHI,JAMMU,42368,42599,DELHI-JAMMU,84967,All
2022,5,DELHI,JAMMU,38809,43659,DELHI-JAMMU,82468,All
2022,6,DELHI,JAMMU,34022,39039,DELHI-JAMMU,73061,All
2022,7,DELHI,JAMMU,29305,33853,DELHI-JAMMU,63158,All
2022,8,DELHI,JAMMU,31175,33611,DELHI-JAMMU,64786,All
2022,9,DELHI,JAMMU,38194,38062,DELHI-JAMMU,76256,All
2022,10,DELHI,JAMMU,34851,34021,DELHI-JAMMU,68872,All
2022,11,DELHI,JAMMU,31911,32737,DELHI-JAMMU,64648,All
2022,12,DELHI,JAMMU,28390,32690,DELHI-JAMMU,61080,All
2023,1,DELHI,JAMMU,27070,30162,DELHI-JAMMU,57232,All
2023,2,DELHI,JAMMU,28503,32966,DELHI-JAMMU,61469,All
2023,3,DELHI,JAMMU,30495,36846,DELHI-JAMMU,67341,All
2023,4,DELHI,JAMMU,28812,35126,DELHI-JAMMU,63938,All
2023,5,DELHI,JAMMU,24473,25956,DELHI-JAMMU,50429,All
2023,6,DELHI,JAMMU,26875,27374,DELHI-JAMMU,54249,All
2023,7,DELHI,JAMMU,28345,29677,DELHI-JAMMU,58022,All
2023,8,DELHI,JAMMU,29702,27701,DELHI-JAMMU,57403,All
2023,9,DELHI,JAMMU,30122,28184,DELHI-JAMMU,58306,All
2023,10,DELHI,JAMMU,31013,28541,DELHI-JAMMU,59554,All
2023,11,DELHI,JAMMU,28819,27979,DELHI-JAMMU,56798,All
2023,12,DELHI,JAMMU,25212,25374,DELHI-JAMMU,50586,All
2024,1,DELHI,JAMMU,18739,18865,DELHI-JAMMU,37604,All
2024,2,DELHI,JAMMU,22728,24350,DELHI-JAMMU,47078,All
2024,3,DELHI,JAMMU,28849,29160,DELHI-JAMMU,58009,All
2024,4,DELHI,JAMMU,30321,32129,DELHI-JAMMU,62450,All
2024,6,DELHI,JAMMU,28445,28488,DELHI-JAMMU,56933,All
2024,7,DELHI,JAMMU,27671,28110,DELHI-JAMMU,55781,All
2024,8,DELHI,JAMMU,27619,27275,DELHI-JAMMU,54894,All
2024,9,DELHI,JAMMU,29183,26292,DELHI-JAMMU,55475,All
2024,10,DELHI,JAMMU,31632,27561,DELHI-JAMMU,59193,All
2024,11,DELHI,JAMMU,30949,28847,DELHI-JAMMU,59796,All
2024,12,DELHI,JAMMU,26616,25722,DELHI-JAMMU,52338,All
2025,1,DELHI,JAMMU,21324,20608,DELHI-JAMMU,41932,All
2025,2,DELHI,JAMMU,26333,25869,DELHI-JAMMU,52202,All
2025,3,DELHI,JAMMU,33345,33833,DELHI-JAMMU,67178,All
2019,5,DELHI,JAMNAGAR,135,0,DELHI-JAMNAGAR,135,All
2019,5,DELHI,JHARSUGUDA,2713,2634,DELHI-JHARSUGUDA,5347,All
2019,6,DELHI,JHARSUGUDA,4223,4165,DELHI-JHARSUGUDA,8388,All
2019,7,DELHI,JHARSUGUDA,3744,3816,DELHI-JHARSUGUDA,7560,All
2019,8,DELHI,JHARSUGUDA,4219,4201,DELHI-JHARSUGUDA,8420,All
2019,9,DELHI,JHARSUGUDA,3901,3936,DELHI-JHARSUGUDA,7837,All
2019,10,DELHI,JHARSUGUDA,4774,4668,DELHI-JHARSUGUDA,9442,All
2019,11,DELHI,JHARSUGUDA,4720,4651,DELHI-JHARSUGUDA,9371,All
2019,12,DELHI,JHARSUGUDA,5032,4749,DELHI-JHARSUGUDA,9781,All
2020,1,DELHI,JHARSUGUDA,4536,4797,DELHI-JHARSUGUDA,9333,All
2020,2,DELHI,JHARSUGUDA,3908,4004,DELHI-JHARSUGUDA,7912,All
2020,3,DELHI,JHARSUGUDA,3629,2879,DELHI-JHARSUGUDA,6508,All
2020,5,DELHI,JHARSUGUDA,622,326,DELHI-JHARSUGUDA,948,All
2020,6,DELHI,JHARSUGUDA,3202,1663,DELHI-JHARSUGUDA,4865,All
2020,7,DELHI,JHARSUGUDA,2274,2165,DELHI-JHARSUGUDA,4439,All
2020,8,DELHI,JHARSUGUDA,2379,2401,DELHI-JHARSUGUDA,4780,All
2020,9,DELHI,JHARSUGUDA,1922,1854,DELHI-JHARSUGUDA,3776,All
2020,10,DELHI,JHARSUGUDA,2383,2405,DELHI-JHARSUGUDA,4788,All
2020,11,DELHI,JHARSUGUDA,2477,2456,DELHI-JHARSUGUDA,4933,All
2020,12,DELHI,JHARSUGUDA,2729,2673,DELHI-JHARSUGUDA,5402,All
2021,1,DELHI,JHARSUGUDA,3185,3326,DELHI-JHARSUGUDA,6511,All
2021,2,DELHI,JHARSUGUDA,4733,5023,DELHI-JHARSUGUDA,9756,All
2021,3,DELHI,JHARSUGUDA,5141,5259,DELHI-JHARSUGUDA,10400,All
2021,4,DELHI,JHARSUGUDA,3801,3326,DELHI-JHARSUGUDA,7127,All
2021,6,DELHI,JHARSUGUDA,2809,2973,DELHI-JHARSUGUDA,5782,All
2021,7,DELHI,JHARSUGUDA,4628,4490,DELHI-JHARSUGUDA,9118,All
2021,8,DELHI,JHARSUGUDA,4662,4404,DELHI-JHARSUGUDA,9066,All
2021,9,DELHI,JHARSUGUDA,4742,4483,DELHI-JHARSUGUDA,9225,All
2021,10,DELHI,JHARSUGUDA,5424,4617,DELHI-JHARSUGUDA,10041,All
2021,11,DELHI,JHARSUGUDA,5263,5072,DELHI-JHARSUGUDA,10335,All
2021,12,DELHI,JHARSUGUDA,5709,5469,DELHI-JHARSUGUDA,11178,All
2022,1,DELHI,JHARSUGUDA,2771,2635,DELHI-JHARSUGUDA,5406,All
2022,2,DELHI,JHARSUGUDA,3088,3153,DELHI-JHARSUGUDA,6241,All
2022,3,DELHI,JHARSUGUDA,5769,5681,DELHI-JHARSUGUDA,11450,All
2022,4,DELHI,JHARSUGUDA,5399,5317,DELHI-JHARSUGUDA,10716,All
2022,5,DELHI,JHARSUGUDA,5689,5617,DELHI-JHARSUGUDA,11306,All
2022,6,DELHI,JHARSUGUDA,5253,4652,DELHI-JHARSUGUDA,9905,All
2022,7,DELHI,JHARSUGUDA,3062,3097,DELHI-JHARSUGUDA,6159,All
2022,8,DELHI,JHARSUGUDA,3076,3090,DELHI-JHARSUGUDA,6166,All
2022,9,DELHI,JHARSUGUDA,2524,2560,DELHI-JHARSUGUDA,5084,All
2022,10,DELHI,JHARSUGUDA,2260,2209,DELHI-JHARSUGUDA,4469,All
2022,11,DELHI,JHARSUGUDA,3827,3546,DELHI-JHARSUGUDA,7373,All
2022,12,DELHI,JHARSUGUDA,5418,4742,DELHI-JHARSUGUDA,10160,All
2023,1,DELHI,JHARSUGUDA,4720,4856,DELHI-JHARSUGUDA,9576,All
2023,2,DELHI,JHARSUGUDA,4780,4913,DELHI-JHARSUGUDA,9693,All
2023,3,DELHI,JHARSUGUDA,5103,4919,DELHI-JHARSUGUDA,10022,All
2023,4,DELHI,JHARSUGUDA,4046,4032,DELHI-JHARSUGUDA,8078,All
2023,5,DELHI,JHARSUGUDA,4380,4396,DELHI-JHARSUGUDA,8776,All
2023,6,DELHI,JHARSUGUDA,4367,4337,DELHI-JHARSUGUDA,8704,All
2023,7,DELHI,JHARSUGUDA,4029,3859,DELHI-JHARSUGUDA,7888,All
2023,8,DELHI,JHARSUGUDA,3902,3648,DELHI-JHARSUGUDA,7550,All
2023,9,DELHI,JHARSUGUDA,3930,3859,DELHI-JHARSUGUDA,7789,All
2023,10,DELHI,JHARSUGUDA,4233,4125,DELHI-JHARSUGUDA,8358,All
2023,11,DELHI,JHARSUGUDA,5594,5443,DELHI-JHARSUGUDA,11037,All
2023,12,DELHI,JHARSUGUDA,5670,5587,DELHI-JHARSUGUDA,11257,All
2024,1,DELHI,JHARSUGUDA,5670,5470,DELHI-JHARSUGUDA,11140,All
2024,2,DELHI,JHARSUGUDA,5367,5431,DELHI-JHARSUGUDA,10798,All
2024,3,DELHI,JHARSUGUDA,5544,5289,DELHI-JHARSUGUDA,10833,All
2024,6,DELHI,JHARSUGUDA,5179,5074,DELHI-JHARSUGUDA,10253,All
2024,7,DELHI,JHARSUGUDA,5271,5179,DELHI-JHARSUGUDA,10450,All
2024,8,DELHI,JHARSUGUDA,5173,5062,DELHI-JHARSUGUDA,10235,All
2024,9,DELHI,JHARSUGUDA,5147,4811,DELHI-JHARSUGUDA,9958,All
2024,10,DELHI,JHARSUGUDA,5188,4784,DELHI-JHARSUGUDA,9972,All
2024,11,DELHI,JHARSUGUDA,5272,5076,DELHI-JHARSUGUDA,10348,All
2024,12,DELHI,JHARSUGUDA,5484,5082,DELHI-JHARSUGUDA,10566,All
2025,1,DELHI,JHARSUGUDA,5320,5232,DELHI-JHARSUGUDA,10552,All
2025,2,DELHI,JHARSUGUDA,4699,4643,DELHI-JHARSUGUDA,9342,All
2025,3,DELHI,JHARSUGUDA,5102,5324,DELHI-JHARSUGUDA,10426,All
2015,4,DELHI,JODHPUR,4721,4654,DELHI-JODHPUR,9375,All
2015,5,DELHI,JODHPUR,4462,4806,DELHI-JODHPUR,9268,All
2015,6,DELHI,JODHPUR,4458,4156,DELHI-JODHPUR,8614,All
2015,7,DELHI,JODHPUR,4739,4345,DELHI-JODHPUR,9084,All
2015,8,DELHI,JODHPUR,4860,4782,DELHI-JODHPUR,9642,All
2015,9,DELHI,JODHPUR,4803,4692,DELHI-JODHPUR,9495,All
2015,10,DELHI,JODHPUR,4758,3118,DELHI-JODHPUR,7876,All
2015,11,DELHI,JODHPUR,5247,5093,DELHI-JODHPUR,10340,All
2015,12,DELHI,JODHPUR,5466,5417,DELHI-JODHPUR,10883,All
2016,1,DELHI,JODHPUR,5079,5465,DELHI-JODHPUR,10544,All
2016,2,DELHI,JODHPUR,5258,5192,DELHI-JODHPUR,10450,All
2016,3,DELHI,JODHPUR,5315,5302,DELHI-JODHPUR,10617,All
2016,4,DELHI,JODHPUR,4837,4638,DELHI-JODHPUR,9475,All
2016,5,DELHI,JODHPUR,4321,4741,DELHI-JODHPUR,9062,All
2016,6,DELHI,JODHPUR,4664,4019,DELHI-JODHPUR,8683,All
2016,7,DELHI,JODHPUR,5245,4981,DELHI-JODHPUR,10226,All
2016,8,DELHI,JODHPUR,4825,4883,DELHI-JODHPUR,9708,All
2016,9,DELHI,JODHPUR,5056,4921,DELHI-JODHPUR,9977,All
2016,10,DELHI,JODHPUR,5345,5049,DELHI-JODHPUR,10394,All
2016,11,DELHI,JODHPUR,9250,9492,DELHI-JODHPUR,18742,All
2016,12,DELHI,JODHPUR,9399,8827,DELHI-JODHPUR,18226,All
2017,1,DELHI,JODHPUR,10312,11195,DELHI-JODHPUR,21507,All
2017,2,DELHI,JODHPUR,10739,11015,DELHI-JODHPUR,21754,All
2017,3,DELHI,JODHPUR,8938,9847,DELHI-JODHPUR,18785,All
2017,4,DELHI,JODHPUR,7428,7346,DELHI-JODHPUR,14774,All
2017,5,DELHI,JODHPUR,6264,6971,DELHI-JODHPUR,13235,All
2017,6,DELHI,JODHPUR,7113,6104,DELHI-JODHPUR,13217,All
2017,7,DELHI,JODHPUR,7501,7791,DELHI-JODHPUR,15292,All
2017,8,DELHI,JODHPUR,7916,8166,DELHI-JODHPUR,16082,All
2017,9,DELHI,JODHPUR,8063,7833,DELHI-JODHPUR,15896,All
2017,10,DELHI,JODHPUR,9294,8849,DELHI-JODHPUR,18143,All
2017,11,DELHI,JODHPUR,9917,9214,DELHI-JODHPUR,19131,All
2017,12,DELHI,JODHPUR,11301,11134,DELHI-JODHPUR,22435,All
2018,1,DELHI,JODHPUR,11035,11221,DELHI-JODHPUR,22256,All
2018,2,DELHI,JODHPUR,11100,11192,DELHI-JODHPUR,22292,All
2018,3,DELHI,JODHPUR,10610,10608,DELHI-JODHPUR,21218,All
2018,4,DELHI,JODHPUR,8412,7989,DELHI-JODHPUR,16401,All
2018,5,DELHI,JODHPUR,7052,7299,DELHI-JODHPUR,14351,All
2018,6,DELHI,JODHPUR,7280,6473,DELHI-JODHPUR,13753,All
2018,7,DELHI,JODHPUR,6575,6211,DELHI-JODHPUR,12786,All
2018,8,DELHI,JODHPUR,7979,7821,DELHI-JODHPUR,15800,All
2018,9,DELHI,JODHPUR,8023,7627,DELHI-JODHPUR,15650,All
2018,10,DELHI,JODHPUR,9260,9286,DELHI-JODHPUR,18546,All
2018,11,DELHI,JODHPUR,12299,11563,DELHI-JODHPUR,23862,All
2018,12,DELHI,JODHPUR,14277,13636,DELHI-JODHPUR,27913,All
2019,1,DELHI,JODHPUR,12736,13225,DELHI-JODHPUR,25961,All
2019,2,DELHI,JODHPUR,12218,12540,DELHI-JODHPUR,24758,All
2019,3,DELHI,JODHPUR,11000,11258,DELHI-JODHPUR,22258,All
2019,4,DELHI,JODHPUR,6266,5854,DELHI-JODHPUR,12120,All
2019,5,DELHI,JODHPUR,5094,5232,DELHI-JODHPUR,10326,All
2019,6,DELHI,JODHPUR,4621,4205,DELHI-JODHPUR,8826,All
2019,7,DELHI,JODHPUR,5125,4949,DELHI-JODHPUR,10074,All
2019,8,DELHI,JODHPUR,4025,4031,DELHI-JODHPUR,8056,All
2019,9,DELHI,JODHPUR,7665,7516,DELHI-JODHPUR,15181,All
2019,10,DELHI,JODHPUR,10075,9967,DELHI-JODHPUR,20042,All
2019,11,DELHI,JODHPUR,13637,12708,DELHI-JODHPUR,26345,All
2019,12,DELHI,JODHPUR,15905,15085,DELHI-JODHPUR,30990,All
2020,1,DELHI,JODHPUR,15013,15568,DELHI-JODHPUR,30581,All
2020,2,DELHI,JODHPUR,15179,15298,DELHI-JODHPUR,30477,All
2020,3,DELHI,JODHPUR,8300,8923,DELHI-JODHPUR,17223,All
2020,9,DELHI,JODHPUR,63,55,DELHI-JODHPUR,118,All
2020,10,DELHI,JODHPUR,2413,2038,DELHI-JODHPUR,4451,All
2020,11,DELHI,JODHPUR,5023,4045,DELHI-JODHPUR,9068,All
2020,12,DELHI,JODHPUR,6761,7625,DELHI-JODHPUR,14386,All
2021,1,DELHI,JODHPUR,8407,9647,DELHI-JODHPUR,18054,All
2021,2,DELHI,JODHPUR,9351,9004,DELHI-JODHPUR,18355,All
2021,3,DELHI,JODHPUR,8729,8759,DELHI-JODHPUR,17488,All
2021,4,DELHI,JODHPUR,7022,4901,DELHI-JODHPUR,11923,All
2021,6,DELHI,JODHPUR,2510,2159,DELHI-JODHPUR,4669,All
2021,7,DELHI,JODHPUR,5058,4650,DELHI-JODHPUR,9708,All
2021,8,DELHI,JODHPUR,6909,6769,DELHI-JODHPUR,13678,All
2021,9,DELHI,JODHPUR,7029,7413,DELHI-JODHPUR,14442,All
2021,10,DELHI,JODHPUR,11066,11458,DELHI-JODHPUR,22524,All
2021,11,DELHI,JODHPUR,15111,13654,DELHI-JODHPUR,28765,All
2021,12,DELHI,JODHPUR,12573,12355,DELHI-JODHPUR,24928,All
2022,1,DELHI,JODHPUR,6445,7294,DELHI-JODHPUR,13739,All
2022,2,DELHI,JODHPUR,10751,10608,DELHI-JODHPUR,21359,All
2022,3,DELHI,JODHPUR,12612,13173,DELHI-JODHPUR,25785,All
2022,4,DELHI,JODHPUR,9425,8888,DELHI-JODHPUR,18313,All
2022,5,DELHI,JODHPUR,6504,6835,DELHI-JODHPUR,13339,All
2022,6,DELHI,JODHPUR,4803,4698,DELHI-JODHPUR,9501,All
2022,7,DELHI,JODHPUR,7304,7040,DELHI-JODHPUR,14344,All
2022,8,DELHI,JODHPUR,7778,7676,DELHI-JODHPUR,15454,All
2022,9,DELHI,JODHPUR,9167,8900,DELHI-JODHPUR,18067,All
2022,10,DELHI,JODHPUR,12235,12521,DELHI-JODHPUR,24756,All
2022,11,DELHI,JODHPUR,14688,13558,DELHI-JODHPUR,28246,All
2022,12,DELHI,JODHPUR,15618,15092,DELHI-JODHPUR,30710,All
2023,1,DELHI,JODHPUR,13743,14361,DELHI-JODHPUR,28104,All
2023,2,DELHI,JODHPUR,12959,13266,DELHI-JODHPUR,26225,All
2023,3,DELHI,JODHPUR,13559,13941,DELHI-JODHPUR,27500,All
2023,4,DELHI,JODHPUR,9651,9981,DELHI-JODHPUR,19632,All
2023,5,DELHI,JODHPUR,9193,9594,DELHI-JODHPUR,18787,All
2023,6,DELHI,JODHPUR,9830,8792,DELHI-JODHPUR,18622,All
2023,7,DELHI,JODHPUR,10279,10182,DELHI-JODHPUR,20461,All
2023,8,DELHI,JODHPUR,10388,10466,DELHI-JODHPUR,20854,All
2023,9,DELHI,JODHPUR,9932,10123,DELHI-JODHPUR,20055,All
2023,10,DELHI,JODHPUR,10637,10839,DELHI-JODHPUR,21476,All
2023,11,DELHI,JODHPUR,15023,14377,DELHI-JODHPUR,29400,All
2023,12,DELHI,JODHPUR,16635,15453,DELHI-JODHPUR,32088,All
2024,1,DELHI,JODHPUR,13366,13750,DELHI-JODHPUR,27116,All
2024,2,DELHI,JODHPUR,13542,13862,DELHI-JODHPUR,27404,All
2024,3,DELHI,JODHPUR,13163,13767,DELHI-JODHPUR,26930,All
2024,4,DELHI,JODHPUR,9134,9234,DELHI-JODHPUR,18368,All
2024,6,DELHI,JODHPUR,9182,8055,DELHI-JODHPUR,17237,All
2024,7,DELHI,JODHPUR,9245,9053,DELHI-JODHPUR,18298,All
2024,8,DELHI,JODHPUR,9305,9505,DELHI-JODHPUR,18810,All
2024,9,DELHI,JODHPUR,8841,8787,DELHI-JODHPUR,17628,All
2024,10,DELHI,JODHPUR,9666,8862,DELHI-JODHPUR,18528,All
2024,11,DELHI,JODHPUR,15325,14659,DELHI-JODHPUR,29984,All
2024,12,DELHI,JODHPUR,16674,15675,DELHI-JODHPUR,32349,All
2025,1,DELHI,JODHPUR,15153,16299,DELHI-JODHPUR,31452,All
2025,2,DELHI,JODHPUR,14670,14939,DELHI-JODHPUR,29609,All
2025,3,DELHI,JODHPUR,14943,15013,DELHI-JODHPUR,29956,All
2017,2,DELHI,JORHAT,37,57,DELHI-JORHAT,94,All
2017,3,DELHI,JORHAT,116,181,DELHI-JORHAT,297,All
2017,6,DELHI,JORHAT,217,280,DELHI-JORHAT,497,All
2017,10,DELHI,JORHAT,395,327,DELHI-JORHAT,722,All
2017,11,DELHI,JORHAT,431,435,DELHI-JORHAT,866,All
2017,12,DELHI,JORHAT,513,504,DELHI-JORHAT,1017,All
2018,1,DELHI,JORHAT,391,473,DELHI-JORHAT,864,All
2018,2,DELHI,JORHAT,249,269,DELHI-JORHAT,518,All
2018,3,DELHI,JORHAT,558,436,DELHI-JORHAT,994,All
2018,4,DELHI,JORHAT,1936,1622,DELHI-JORHAT,3558,All
2018,5,DELHI,JORHAT,2481,1556,DELHI-JORHAT,4037,All
2018,6,DELHI,JORHAT,2485,2289,DELHI-JORHAT,4774,All
2018,7,DELHI,JORHAT,2228,2063,DELHI-JORHAT,4291,All
2018,8,DELHI,JORHAT,1557,1389,DELHI-JORHAT,2946,All
2018,9,DELHI,JORHAT,1433,1235,DELHI-JORHAT,2668,All
2018,10,DELHI,JORHAT,2497,2261,DELHI-JORHAT,4758,All
2018,11,DELHI,JORHAT,2116,1933,DELHI-JORHAT,4049,All
2018,12,DELHI,JORHAT,2772,2327,DELHI-JORHAT,5099,All
2019,1,DELHI,JORHAT,1803,1860,DELHI-JORHAT,3663,All
2019,2,DELHI,JORHAT,117,114,DELHI-JORHAT,231,All
2019,10,DELHI,JORHAT,103,96,DELHI-JORHAT,199,All
2019,11,DELHI,JORHAT,1326,1491,DELHI-JORHAT,2817,All
2019,12,DELHI,JORHAT,1680,1776,DELHI-JORHAT,3456,All
2020,1,DELHI,JORHAT,1562,1981,DELHI-JORHAT,3543,All
2020,2,DELHI,JORHAT,1851,2186,DELHI-JORHAT,4037,All
2020,3,DELHI,JORHAT,1434,1190,DELHI-JORHAT,2624,All
2020,9,DELHI,JORHAT,292,324,DELHI-JORHAT,616,All
2020,10,DELHI,JORHAT,275,348,DELHI-JORHAT,623,All
2021,3,DELHI,JORHAT,81,123,DELHI-JORHAT,204,All
2021,4,DELHI,JORHAT,742,577,DELHI-JORHAT,1319,All
2021,6,DELHI,JORHAT,374,395,DELHI-JORHAT,769,All
2021,7,DELHI,JORHAT,484,656,DELHI-JORHAT,1140,All
2021,8,DELHI,JORHAT,879,844,DELHI-JORHAT,1723,All
2021,9,DELHI,JORHAT,764,713,DELHI-JORHAT,1477,All
2021,10,DELHI,JORHAT,1054,936,DELHI-JORHAT,1990,All
2021,11,DELHI,JORHAT,1016,856,DELHI-JORHAT,1872,All
2021,12,DELHI,JORHAT,1003,905,DELHI-JORHAT,1908,All
2022,1,DELHI,JORHAT,527,557,DELHI-JORHAT,1084,All
2022,2,DELHI,JORHAT,504,357,DELHI-JORHAT,861,All
2022,3,DELHI,JORHAT,869,915,DELHI-JORHAT,1784,All
2022,4,DELHI,JORHAT,1077,1053,DELHI-JORHAT,2130,All
2022,5,DELHI,JORHAT,1107,1191,DELHI-JORHAT,2298,All
2022,6,DELHI,JORHAT,836,996,DELHI-JORHAT,1832,All
2022,7,DELHI,JORHAT,1031,1046,DELHI-JORHAT,2077,All
2022,8,DELHI,JORHAT,690,673,DELHI-JORHAT,1363,All
2022,9,DELHI,JORHAT,661,502,DELHI-JORHAT,1163,All
2022,10,DELHI,JORHAT,693,859,DELHI-JORHAT,1552,All
2022,11,DELHI,JORHAT,1078,936,DELHI-JORHAT,2014,All
2022,12,DELHI,JORHAT,1321,1247,DELHI-JORHAT,2568,All
2023,1,DELHI,JORHAT,1540,1583,DELHI-JORHAT,3123,All
2023,2,DELHI,JORHAT,1383,1433,DELHI-JORHAT,2816,All
2023,3,DELHI,JORHAT,1217,1428,DELHI-JORHAT,2645,All
2023,4,DELHI,JORHAT,1266,1317,DELHI-JORHAT,2583,All
2023,5,DELHI,JORHAT,778,837,DELHI-JORHAT,1615,All
2023,6,DELHI,JORHAT,816,626,DELHI-JORHAT,1442,All
2023,7,DELHI,JORHAT,754,865,DELHI-JORHAT,1619,All
2023,8,DELHI,JORHAT,573,806,DELHI-JORHAT,1379,All
2023,9,DELHI,JORHAT,602,726,DELHI-JORHAT,1328,All
2023,10,DELHI,JORHAT,828,849,DELHI-JORHAT,1677,All
2023,11,DELHI,JORHAT,68,736,DELHI-JORHAT,804,All
2023,12,DELHI,JORHAT,1084,928,DELHI-JORHAT,2012,All
2024,1,DELHI,JORHAT,1279,894,DELHI-JORHAT,2173,All
2024,2,DELHI,JORHAT,1210,928,DELHI-JORHAT,2138,All
2024,3,DELHI,JORHAT,1056,1038,DELHI-JORHAT,2094,All
2019,3,DELHI,Jharsuguda,145,183,DELHI-Jharsuguda,328,All
2019,4,DELHI,Jharsuguda,2323,2334,DELHI-Jharsuguda,4657,All
2020,10,DELHI,KANDLA,1167,1251,DELHI-KANDLA,2418,All
2020,11,DELHI,KANDLA,1896,1797,DELHI-KANDLA,3693,All
2020,12,DELHI,KANDLA,1971,1862,DELHI-KANDLA,3833,All
2021,1,DELHI,KANDLA,1853,1836,DELHI-KANDLA,3689,All
2021,2,DELHI,KANDLA,2086,1769,DELHI-KANDLA,3855,All
2021,3,DELHI,KANDLA,1934,1956,DELHI-KANDLA,3890,All
2021,4,DELHI,KANDLA,710,521,DELHI-KANDLA,1231,All
2021,6,DELHI,KANDLA,1083,801,DELHI-KANDLA,1884,All
2021,7,DELHI,KANDLA,1556,1370,DELHI-KANDLA,2926,All
2021,8,DELHI,KANDLA,2110,1907,DELHI-KANDLA,4017,All
2021,9,DELHI,KANDLA,1820,1703,DELHI-KANDLA,3523,All
2021,10,DELHI,KANDLA,2164,2081,DELHI-KANDLA,4245,All
2021,11,DELHI,KANDLA,2264,1951,DELHI-KANDLA,4215,All
2021,12,DELHI,KANDLA,2589,2111,DELHI-KANDLA,4700,All
2022,1,DELHI,KANDLA,1473,1321,DELHI-KANDLA,2794,All
2022,2,DELHI,KANDLA,1946,1915,DELHI-KANDLA,3861,All
2022,3,DELHI,KANDLA,2240,2148,DELHI-KANDLA,4388,All
2022,4,DELHI,KANDLA,2528,2137,DELHI-KANDLA,4665,All
2022,5,DELHI,KANDLA,2524,2032,DELHI-KANDLA,4556,All
2022,6,DELHI,KANDLA,2408,1787,DELHI-KANDLA,4195,All
2022,7,DELHI,KANDLA,1591,1405,DELHI-KANDLA,2996,All
2022,8,DELHI,KANDLA,1195,1105,DELHI-KANDLA,2300,All
2022,9,DELHI,KANDLA,1107,1052,DELHI-KANDLA,2159,All
2022,10,DELHI,KANDLA,1374,1410,DELHI-KANDLA,2784,All
2022,11,DELHI,KANDLA,1212,1030,DELHI-KANDLA,2242,All
2023,3,DELHI,KANDLA,211,152,DELHI-KANDLA,363,All
2023,4,DELHI,KANDLA,1354,1420,DELHI-KANDLA,2774,All
2023,5,DELHI,KANDLA,1923,1936,DELHI-KANDLA,3859,All
2023,6,DELHI,KANDLA,1422,1200,DELHI-KANDLA,2622,All
2023,7,DELHI,KANDLA,1502,1347,DELHI-KANDLA,2849,All
2023,8,DELHI,KANDLA,1171,1200,DELHI-KANDLA,2371,All
2023,9,DELHI,KANDLA,1494,1378,DELHI-KANDLA,2872,All
2023,10,DELHI,KANDLA,928,836,DELHI-KANDLA,1764,All
2023,11,DELHI,KANDLA,2144,2092,DELHI-KANDLA,4236,All
2023,12,DELHI,KANDLA,2425,2347,DELHI-KANDLA,4772,All
2024,1,DELHI,KANDLA,2497,2339,DELHI-KANDLA,4836,All
2024,2,DELHI,KANDLA,2256,2227,DELHI-KANDLA,4483,All
2024,3,DELHI,KANDLA,1960,2022,DELHI-KANDLA,3982,All
2024,4,DELHI,KANDLA,769,758,DELHI-KANDLA,1527,All
2024,6,DELHI,KANDLA,1146,977,DELHI-KANDLA,2123,All
2024,7,DELHI,KANDLA,1236,1126,DELHI-KANDLA,2362,All
2024,8,DELHI,KANDLA,533,576,DELHI-KANDLA,1109,All
2025,1,DELHI,KANDLA,409,378,DELHI-KANDLA,787,All
2019,5,DELHI,KANNUR,1844,1820,DELHI-KANNUR,3664,All
2019,6,DELHI,KANNUR,1797,1880,DELHI-KANNUR,3677,All
2019,7,DELHI,KANNUR,1738,1467,DELHI-KANNUR,3205,All
2019,8,DELHI,KANNUR,1438,1377,DELHI-KANNUR,2815,All
2019,9,DELHI,KANNUR,1397,1525,DELHI-KANNUR,2922,All
2019,10,DELHI,KANNUR,1434,1557,DELHI-KANNUR,2991,All
2019,11,DELHI,KANNUR,1527,1676,DELHI-KANNUR,3203,All
2019,12,DELHI,KANNUR,1712,1807,DELHI-KANNUR,3519,All
2020,1,DELHI,KANNUR,1590,1907,DELHI-KANNUR,3497,All
2020,2,DELHI,KANNUR,1392,1837,DELHI-KANNUR,3229,All
2020,3,DELHI,KANNUR,958,1157,DELHI-KANNUR,2115,All
2020,5,DELHI,KANNUR,469,72,DELHI-KANNUR,541,All
2020,6,DELHI,KANNUR,1681,755,DELHI-KANNUR,2436,All
2020,7,DELHI,KANNUR,951,641,DELHI-KANNUR,1592,All
2020,8,DELHI,KANNUR,789,504,DELHI-KANNUR,1293,All
2020,9,DELHI,KANNUR,1008,773,DELHI-KANNUR,1781,All
2020,10,DELHI,KANNUR,1251,964,DELHI-KANNUR,2215,All
2020,11,DELHI,KANNUR,1203,1022,DELHI-KANNUR,2225,All
2020,12,DELHI,KANNUR,1692,966,DELHI-KANNUR,2658,All
2021,1,DELHI,KANNUR,1147,838,DELHI-KANNUR,1985,All
2021,2,DELHI,KANNUR,1026,961,DELHI-KANNUR,1987,All
2021,3,DELHI,KANNUR,1073,787,DELHI-KANNUR,1860,All
2021,4,DELHI,KANNUR,1015,778,DELHI-KANNUR,1793,All
2021,6,DELHI,KANNUR,681,713,DELHI-KANNUR,1394,All
2021,7,DELHI,KANNUR,638,710,DELHI-KANNUR,1348,All
2021,8,DELHI,KANNUR,514,430,DELHI-KANNUR,944,All
2021,9,DELHI,KANNUR,362,559,DELHI-KANNUR,921,All
2021,10,DELHI,KANNUR,55,55,DELHI-KANNUR,110,All
2021,11,DELHI,KANNUR,681,654,DELHI-KANNUR,1335,All
2021,12,DELHI,KANNUR,959,786,DELHI-KANNUR,1745,All
2022,1,DELHI,KANNUR,444,764,DELHI-KANNUR,1208,All
2022,2,DELHI,KANNUR,613,799,DELHI-KANNUR,1412,All
2022,3,DELHI,KANNUR,631,859,DELHI-KANNUR,1490,All
2022,4,DELHI,KANNUR,1483,1403,DELHI-KANNUR,2886,All
2022,5,DELHI,KANNUR,1640,1381,DELHI-KANNUR,3021,All
2022,6,DELHI,KANNUR,2147,1597,DELHI-KANNUR,3744,All
2022,7,DELHI,KANNUR,2072,1356,DELHI-KANNUR,3428,All
2022,8,DELHI,KANNUR,1111,1579,DELHI-KANNUR,2690,All
2022,9,DELHI,KANNUR,1045,1493,DELHI-KANNUR,2538,All
2022,10,DELHI,KANNUR,1390,1522,DELHI-KANNUR,2912,All
2022,11,DELHI,KANNUR,1245,1195,DELHI-KANNUR,2440,All
2022,12,DELHI,KANNUR,1730,1531,DELHI-KANNUR,3261,All
2023,1,DELHI,KANNUR,1092,1685,DELHI-KANNUR,2777,All
2023,2,DELHI,KANNUR,545,798,DELHI-KANNUR,1343,All
2024,2,DELHI,KANNUR,30,40,DELHI-KANNUR,70,All
2024,8,DELHI,KANNUR,80,0,DELHI-KANNUR,80,All
2024,9,DELHI,KANNUR,0,65,DELHI-KANNUR,65,All
2024,12,DELHI,KANNUR,3728,3093,DELHI-KANNUR,6821,All
2025,1,DELHI,KANNUR,5407,5231,DELHI-KANNUR,10638,All
2025,2,DELHI,KANNUR,4840,4815,DELHI-KANNUR,9655,All
2025,3,DELHI,KANNUR,4710,4321,DELHI-KANNUR,9031,All
2016,12,DELHI,KANPUR,614,583,DELHI-KANPUR,1197,All
2017,1,DELHI,KANPUR,567,474,DELHI-KANPUR,1041,All
2017,2,DELHI,KANPUR,532,414,DELHI-KANPUR,946,All
2017,3,DELHI,KANPUR,456,414,DELHI-KANPUR,870,All
2017,4,DELHI,KANPUR,370,350,DELHI-KANPUR,720,All
2017,5,DELHI,KANPUR,588,477,DELHI-KANPUR,1065,All
2018,7,DELHI,KANPUR,2246,2222,DELHI-KANPUR,4468,All
2018,8,DELHI,KANPUR,2087,2027,DELHI-KANPUR,4114,All
2018,9,DELHI,KANPUR,2097,2113,DELHI-KANPUR,4210,All
2018,10,DELHI,KANPUR,2216,2040,DELHI-KANPUR,4256,All
2018,11,DELHI,KANPUR,1938,1841,DELHI-KANPUR,3779,All
2018,12,DELHI,KANPUR,2449,2381,DELHI-KANPUR,4830,All
2019,1,DELHI,KANPUR,1850,1840,DELHI-KANPUR,3690,All
2019,2,DELHI,KANPUR,2184,2151,DELHI-KANPUR,4335,All
2019,3,DELHI,KANPUR,2346,2387,DELHI-KANPUR,4733,All
2019,4,DELHI,KANPUR,2323,1877,DELHI-KANPUR,4200,All
2019,5,DELHI,KANPUR,2363,2059,DELHI-KANPUR,4422,All
2019,6,DELHI,KANPUR,2447,2210,DELHI-KANPUR,4657,All
2019,7,DELHI,KANPUR,2585,2164,DELHI-KANPUR,4749,All
2019,8,DELHI,KANPUR,2485,1976,DELHI-KANPUR,4461,All
2019,9,DELHI,KANPUR,2237,2013,DELHI-KANPUR,4250,All
2019,10,DELHI,KANPUR,2580,2032,DELHI-KANPUR,4612,All
2019,11,DELHI,KANPUR,2603,2486,DELHI-KANPUR,5089,All
2019,12,DELHI,KANPUR,2386,2294,DELHI-KANPUR,4680,All
2020,1,DELHI,KANPUR,1931,1818,DELHI-KANPUR,3749,All
2020,2,DELHI,KANPUR,2433,2273,DELHI-KANPUR,4706,All
2020,3,DELHI,KANPUR,1636,1365,DELHI-KANPUR,3001,All
2020,5,DELHI,KANPUR,472,256,DELHI-KANPUR,728,All
2020,6,DELHI,KANPUR,1901,873,DELHI-KANPUR,2774,All
2020,7,DELHI,KANPUR,1702,1335,DELHI-KANPUR,3037,All
2020,8,DELHI,KANPUR,1165,1868,DELHI-KANPUR,3033,All
2020,9,DELHI,KANPUR,1586,2027,DELHI-KANPUR,3613,All
2020,10,DELHI,KANPUR,2223,2125,DELHI-KANPUR,4348,All
2020,11,DELHI,KANPUR,2498,2048,DELHI-KANPUR,4546,All
2020,12,DELHI,KANPUR,2146,2640,DELHI-KANPUR,4786,All
2021,1,DELHI,KANPUR,1680,1850,DELHI-KANPUR,3530,All
2021,2,DELHI,KANPUR,2121,2074,DELHI-KANPUR,4195,All
2021,3,DELHI,KANPUR,2275,2193,DELHI-KANPUR,4468,All
2021,4,DELHI,KANPUR,1672,1323,DELHI-KANPUR,2995,All
2021,6,DELHI,KANPUR,929,830,DELHI-KANPUR,1759,All
2021,7,DELHI,KANPUR,1996,1962,DELHI-KANPUR,3958,All
2021,8,DELHI,KANPUR,2127,2141,DELHI-KANPUR,4268,All
2021,9,DELHI,KANPUR,2269,2425,DELHI-KANPUR,4694,All
2021,10,DELHI,KANPUR,2634,2402,DELHI-KANPUR,5036,All
2021,11,DELHI,KANPUR,2270,2197,DELHI-KANPUR,4467,All
2021,12,DELHI,KANPUR,2325,2364,DELHI-KANPUR,4689,All
2022,1,DELHI,KANPUR,1226,1208,DELHI-KANPUR,2434,All
2022,2,DELHI,KANPUR,1737,1725,DELHI-KANPUR,3462,All
2022,3,DELHI,KANPUR,2324,2303,DELHI-KANPUR,4627,All
2022,4,DELHI,KANPUR,2470,2468,DELHI-KANPUR,4938,All
2022,5,DELHI,KANPUR,2523,2452,DELHI-KANPUR,4975,All
2022,6,DELHI,KANPUR,2499,2531,DELHI-KANPUR,5030,All
2022,7,DELHI,KANPUR,1864,1956,DELHI-KANPUR,3820,All
2022,8,DELHI,KANPUR,1636,1720,DELHI-KANPUR,3356,All
2022,9,DELHI,KANPUR,1573,1415,DELHI-KANPUR,2988,All
2022,10,DELHI,KANPUR,1674,1501,DELHI-KANPUR,3175,All
2022,11,DELHI,KANPUR,1595,1428,DELHI-KANPUR,3023,All
2022,12,DELHI,KANPUR,1551,1664,DELHI-KANPUR,3215,All
2023,1,DELHI,KANPUR,951,997,DELHI-KANPUR,1948,All
2023,2,DELHI,KANPUR,66,82,DELHI-KANPUR,148,All
2023,3,DELHI,KANPUR,1085,924,DELHI-KANPUR,2009,All
2023,4,DELHI,KANPUR,1629,1426,DELHI-KANPUR,3055,All
2023,5,DELHI,KANPUR,835,687,DELHI-KANPUR,1522,All
2023,7,DELHI,KANPUR,3677,4240,DELHI-KANPUR,7917,All
2023,8,DELHI,KANPUR,4241,4497,DELHI-KANPUR,8738,All
2023,9,DELHI,KANPUR,4229,4522,DELHI-KANPUR,8751,All
2023,10,DELHI,KANPUR,4489,4296,DELHI-KANPUR,8785,All
2023,11,DELHI,KANPUR,5027,4212,DELHI-KANPUR,9239,All
2023,12,DELHI,KANPUR,5050,5418,DELHI-KANPUR,10468,All
2024,1,DELHI,KANPUR,4258,4401,DELHI-KANPUR,8659,All
2024,2,DELHI,KANPUR,4568,4417,DELHI-KANPUR,8985,All
2024,3,DELHI,KANPUR,4678,4454,DELHI-KANPUR,9132,All
2024,4,DELHI,KANPUR,4748,4066,DELHI-KANPUR,8814,All
2024,6,DELHI,KANPUR,4643,4535,DELHI-KANPUR,9178,All
2024,7,DELHI,KANPUR,4927,4788,DELHI-KANPUR,9715,All
2024,8,DELHI,KANPUR,4574,4901,DELHI-KANPUR,9475,All
2024,9,DELHI,KANPUR,4443,4540,DELHI-KANPUR,8983,All
2024,10,DELHI,KANPUR,4731,3810,DELHI-KANPUR,8541,All
2024,11,DELHI,KANPUR,4999,5231,DELHI-KANPUR,10230,All
2024,12,DELHI,KANPUR,4848,5049,DELHI-KANPUR,9897,All
2025,1,DELHI,KANPUR,4755,5004,DELHI-KANPUR,9759,All
2025,2,DELHI,KANPUR,4861,4943,DELHI-KANPUR,9804,All
2025,3,DELHI,KANPUR,5071,5190,DELHI-KANPUR,10261,All
2015,4,DELHI,KHAJURAHO,650,662,DELHI-KHAJURAHO,1312,All
2015,5,DELHI,KHAJURAHO,308,289,DELHI-KHAJURAHO,597,All
2015,6,DELHI,KHAJURAHO,202,222,DELHI-KHAJURAHO,424,All
2015,7,DELHI,KHAJURAHO,337,319,DELHI-KHAJURAHO,656,All
2015,8,DELHI,KHAJURAHO,273,188,DELHI-KHAJURAHO,461,All
2015,9,DELHI,KHAJURAHO,286,300,DELHI-KHAJURAHO,586,All
2015,10,DELHI,KHAJURAHO,10299,1604,DELHI-KHAJURAHO,11903,All
2015,11,DELHI,KHAJURAHO,553,759,DELHI-KHAJURAHO,1312,All
2015,12,DELHI,KHAJURAHO,1138,1314,DELHI-KHAJURAHO,2452,All
2016,1,DELHI,KHAJURAHO,944,1187,DELHI-KHAJURAHO,2131,All
2016,2,DELHI,KHAJURAHO,634,743,DELHI-KHAJURAHO,1377,All
2016,3,DELHI,KHAJURAHO,761,779,DELHI-KHAJURAHO,1540,All
2016,4,DELHI,KHAJURAHO,672,908,DELHI-KHAJURAHO,1580,All
2016,5,DELHI,KHAJURAHO,339,400,DELHI-KHAJURAHO,739,All
2016,6,DELHI,KHAJURAHO,337,395,DELHI-KHAJURAHO,732,All
2016,7,DELHI,KHAJURAHO,411,393,DELHI-KHAJURAHO,804,All
2016,8,DELHI,KHAJURAHO,230,138,DELHI-KHAJURAHO,368,All
2016,9,DELHI,KHAJURAHO,290,266,DELHI-KHAJURAHO,556,All
2016,10,DELHI,KHAJURAHO,580,687,DELHI-KHAJURAHO,1267,All
2016,11,DELHI,KHAJURAHO,465,630,DELHI-KHAJURAHO,1095,All
2016,12,DELHI,KHAJURAHO,537,749,DELHI-KHAJURAHO,1286,All
2017,1,DELHI,KHAJURAHO,523,696,DELHI-KHAJURAHO,1219,All
2017,2,DELHI,KHAJURAHO,527,611,DELHI-KHAJURAHO,1138,All
2017,3,DELHI,KHAJURAHO,663,558,DELHI-KHAJURAHO,1221,All
2017,4,DELHI,KHAJURAHO,680,387,DELHI-KHAJURAHO,1067,All
2017,5,DELHI,KHAJURAHO,359,286,DELHI-KHAJURAHO,645,All
2017,6,DELHI,KHAJURAHO,242,339,DELHI-KHAJURAHO,581,All
2017,7,DELHI,KHAJURAHO,284,323,DELHI-KHAJURAHO,607,All
2017,8,DELHI,KHAJURAHO,176,71,DELHI-KHAJURAHO,247,All
2017,9,DELHI,KHAJURAHO,257,224,DELHI-KHAJURAHO,481,All
2017,10,DELHI,KHAJURAHO,499,608,DELHI-KHAJURAHO,1107,All
2017,11,DELHI,KHAJURAHO,494,512,DELHI-KHAJURAHO,1006,All
2017,12,DELHI,KHAJURAHO,829,972,DELHI-KHAJURAHO,1801,All
2018,1,DELHI,KHAJURAHO,654,892,DELHI-KHAJURAHO,1546,All
2018,2,DELHI,KHAJURAHO,697,634,DELHI-KHAJURAHO,1331,All
2018,3,DELHI,KHAJURAHO,522,644,DELHI-KHAJURAHO,1166,All
2018,4,DELHI,KHAJURAHO,500,486,DELHI-KHAJURAHO,986,All
2018,5,DELHI,KHAJURAHO,211,367,DELHI-KHAJURAHO,578,All
2018,6,DELHI,KHAJURAHO,294,431,DELHI-KHAJURAHO,725,All
2018,7,DELHI,KHAJURAHO,403,382,DELHI-KHAJURAHO,785,All
2018,8,DELHI,KHAJURAHO,291,126,DELHI-KHAJURAHO,417,All
2018,9,DELHI,KHAJURAHO,307,228,DELHI-KHAJURAHO,535,All
2018,10,DELHI,KHAJURAHO,676,696,DELHI-KHAJURAHO,1372,All
2018,11,DELHI,KHAJURAHO,451,502,DELHI-KHAJURAHO,953,All
2018,12,DELHI,KHAJURAHO,709,1028,DELHI-KHAJURAHO,1737,All
2019,1,DELHI,KHAJURAHO,603,892,DELHI-KHAJURAHO,1495,All
2019,2,DELHI,KHAJURAHO,354,460,DELHI-KHAJURAHO,814,All
2019,3,DELHI,KHAJURAHO,135,159,DELHI-KHAJURAHO,294,All
2019,4,DELHI,KHAJURAHO,152,244,DELHI-KHAJURAHO,396,All
2019,5,DELHI,KHAJURAHO,212,379,DELHI-KHAJURAHO,591,All
2019,6,DELHI,KHAJURAHO,52,94,DELHI-KHAJURAHO,146,All
2019,7,DELHI,KHAJURAHO,212,300,DELHI-KHAJURAHO,512,All
2019,8,DELHI,KHAJURAHO,108,116,DELHI-KHAJURAHO,224,All
2019,9,DELHI,KHAJURAHO,167,142,DELHI-KHAJURAHO,309,All
2019,10,DELHI,KHAJURAHO,189,200,DELHI-KHAJURAHO,389,All
2019,11,DELHI,KHAJURAHO,304,341,DELHI-KHAJURAHO,645,All
2019,12,DELHI,KHAJURAHO,458,479,DELHI-KHAJURAHO,937,All
2020,1,DELHI,KHAJURAHO,705,867,DELHI-KHAJURAHO,1572,All
2020,2,DELHI,KHAJURAHO,834,946,DELHI-KHAJURAHO,1780,All
2020,3,DELHI,KHAJURAHO,318,537,DELHI-KHAJURAHO,855,All
2022,2,DELHI,KHAJURAHO,290,234,DELHI-KHAJURAHO,524,All
2022,3,DELHI,KHAJURAHO,523,539,DELHI-KHAJURAHO,1062,All
2022,4,DELHI,KHAJURAHO,532,479,DELHI-KHAJURAHO,1011,All
2022,5,DELHI,KHAJURAHO,516,488,DELHI-KHAJURAHO,1004,All
2022,6,DELHI,KHAJURAHO,439,445,DELHI-KHAJURAHO,884,All
2022,7,DELHI,KHAJURAHO,500,549,DELHI-KHAJURAHO,1049,All
2022,8,DELHI,KHAJURAHO,470,498,DELHI-KHAJURAHO,968,All
2022,9,DELHI,KHAJURAHO,452,396,DELHI-KHAJURAHO,848,All
2022,10,DELHI,KHAJURAHO,1158,1122,DELHI-KHAJURAHO,2280,All
2022,11,DELHI,KHAJURAHO,1552,1557,DELHI-KHAJURAHO,3109,All
2022,12,DELHI,KHAJURAHO,2110,2130,DELHI-KHAJURAHO,4240,All
2023,1,DELHI,KHAJURAHO,1936,2062,DELHI-KHAJURAHO,3998,All
2023,2,DELHI,KHAJURAHO,2120,2060,DELHI-KHAJURAHO,4180,All
2023,3,DELHI,KHAJURAHO,1860,2063,DELHI-KHAJURAHO,3923,All
2023,4,DELHI,KHAJURAHO,1618,1597,DELHI-KHAJURAHO,3215,All
2023,5,DELHI,KHAJURAHO,1997,2046,DELHI-KHAJURAHO,4043,All
2023,6,DELHI,KHAJURAHO,1901,1760,DELHI-KHAJURAHO,3661,All
2023,7,DELHI,KHAJURAHO,1652,1732,DELHI-KHAJURAHO,3384,All
2023,8,DELHI,KHAJURAHO,1937,1905,DELHI-KHAJURAHO,3842,All
2023,9,DELHI,KHAJURAHO,2067,2150,DELHI-KHAJURAHO,4217,All
2023,10,DELHI,KHAJURAHO,2029,1978,DELHI-KHAJURAHO,4007,All
2023,11,DELHI,KHAJURAHO,2332,2239,DELHI-KHAJURAHO,4571,All
2023,12,DELHI,KHAJURAHO,2709,2685,DELHI-KHAJURAHO,5394,All
2024,1,DELHI,KHAJURAHO,2501,2669,DELHI-KHAJURAHO,5170,All
2024,2,DELHI,KHAJURAHO,2358,2345,DELHI-KHAJURAHO,4703,All
2024,3,DELHI,KHAJURAHO,2295,2393,DELHI-KHAJURAHO,4688,All
2024,4,DELHI,KHAJURAHO,1703,1683,DELHI-KHAJURAHO,3386,All
2024,6,DELHI,KHAJURAHO,836,807,DELHI-KHAJURAHO,1643,All
2024,7,DELHI,KHAJURAHO,653,763,DELHI-KHAJURAHO,1416,All
2024,8,DELHI,KHAJURAHO,478,314,DELHI-KHAJURAHO,792,All
2024,10,DELHI,KHAJURAHO,1617,1216,DELHI-KHAJURAHO,2833,All
2024,11,DELHI,KHAJURAHO,3985,4207,DELHI-KHAJURAHO,8192,All
2024,12,DELHI,KHAJURAHO,4067,4031,DELHI-KHAJURAHO,8098,All
2025,1,DELHI,KHAJURAHO,3382,3856,DELHI-KHAJURAHO,7238,All
2025,2,DELHI,KHAJURAHO,2818,2574,DELHI-KHAJURAHO,5392,All
2025,3,DELHI,KHAJURAHO,3112,2971,DELHI-KHAJURAHO,6083,All
2019,5,DELHI,KOCHI,48297,40345,DELHI-KOCHI,88642,All
2019,6,DELHI,KOCHI,47615,47290,DELHI-KOCHI,94905,All
2019,7,DELHI,KOCHI,49171,47452,DELHI-KOCHI,96623,All
2019,8,DELHI,KOCHI,41657,45375,DELHI-KOCHI,87032,All
2019,9,DELHI,KOCHI,46918,53109,DELHI-KOCHI,100027,All
2019,10,DELHI,KOCHI,43506,46935,DELHI-KOCHI,90441,All
2019,11,DELHI,KOCHI,47815,44296,DELHI-KOCHI,92111,All
2019,12,DELHI,KOCHI,48856,43258,DELHI-KOCHI,92114,All
2020,1,DELHI,KOCHI,45676,48157,DELHI-KOCHI,93833,All
2020,2,DELHI,KOCHI,43346,47040,DELHI-KOCHI,90386,All
2020,3,DELHI,KOCHI,25065,25459,DELHI-KOCHI,50524,All
2020,5,DELHI,KOCHI,2916,1127,DELHI-KOCHI,4043,All
2020,6,DELHI,KOCHI,10811,6236,DELHI-KOCHI,17047,All
2020,7,DELHI,KOCHI,8600,9434,DELHI-KOCHI,18034,All
2020,8,DELHI,KOCHI,9647,11205,DELHI-KOCHI,20852,All
2020,9,DELHI,KOCHI,13403,12550,DELHI-KOCHI,25953,All
2020,10,DELHI,KOCHI,19961,14531,DELHI-KOCHI,34492,All
2020,11,DELHI,KOCHI,17877,16176,DELHI-KOCHI,34053,All
2020,12,DELHI,KOCHI,27688,17514,DELHI-KOCHI,45202,All
2021,1,DELHI,KOCHI,25840,24488,DELHI-KOCHI,50328,All
2021,2,DELHI,KOCHI,21964,27286,DELHI-KOCHI,49250,All
2021,3,DELHI,KOCHI,22316,28497,DELHI-KOCHI,50813,All
2021,4,DELHI,KOCHI,21783,21676,DELHI-KOCHI,43459,All
2021,6,DELHI,KOCHI,8767,10882,DELHI-KOCHI,19649,All
2021,7,DELHI,KOCHI,13338,15341,DELHI-KOCHI,28679,All
2021,8,DELHI,KOCHI,26146,21046,DELHI-KOCHI,47192,All
2021,9,DELHI,KOCHI,18893,21458,DELHI-KOCHI,40351,All
2021,10,DELHI,KOCHI,23495,27970,DELHI-KOCHI,51465,All
2021,11,DELHI,KOCHI,26858,29166,DELHI-KOCHI,56024,All
2021,12,DELHI,KOCHI,35759,28787,DELHI-KOCHI,64546,All
2022,1,DELHI,KOCHI,20473,26016,DELHI-KOCHI,46489,All
2022,2,DELHI,KOCHI,22610,26964,DELHI-KOCHI,49574,All
2022,3,DELHI,KOCHI,36335,34020,DELHI-KOCHI,70355,All
2022,4,DELHI,KOCHI,37740,38614,DELHI-KOCHI,76354,All
2022,5,DELHI,KOCHI,41691,39100,DELHI-KOCHI,80791,All
2022,6,DELHI,KOCHI,38597,36632,DELHI-KOCHI,75229,All
2022,7,DELHI,KOCHI,34795,35223,DELHI-KOCHI,70018,All
2022,8,DELHI,KOCHI,35341,34905,DELHI-KOCHI,70246,All
2022,9,DELHI,KOCHI,34062,39829,DELHI-KOCHI,73891,All
2022,10,DELHI,KOCHI,36428,40908,DELHI-KOCHI,77336,All
2022,11,DELHI,KOCHI,39329,38168,DELHI-KOCHI,77497,All
2022,12,DELHI,KOCHI,44532,40063,DELHI-KOCHI,84595,All
2023,11,DELHI,KOCHI,42731,43644,DELHI-KOCHI,86375,All
2023,12,DELHI,KOCHI,48555,43559,DELHI-KOCHI,92114,All
2024,1,DELHI,KOCHI,43050,43939,DELHI-KOCHI,86989,All
2024,2,DELHI,KOCHI,41711,43050,DELHI-KOCHI,84761,All
2024,3,DELHI,KOCHI,43576,41911,DELHI-KOCHI,85487,All
2024,4,DELHI,KOCHI,41472,42138,DELHI-KOCHI,83610,All
2024,6,DELHI,KOCHI,42280,39832,DELHI-KOCHI,82112,All
2024,7,DELHI,KOCHI,42595,40594,DELHI-KOCHI,83189,All
2024,8,DELHI,KOCHI,42495,43492,DELHI-KOCHI,85987,All
2024,9,DELHI,KOCHI,42434,43017,DELHI-KOCHI,85451,All
2024,10,DELHI,KOCHI,35515,42875,DELHI-KOCHI,78390,All
2024,11,DELHI,KOCHI,43876,41262,DELHI-KOCHI,85138,All
2024,12,DELHI,KOCHI,45869,38776,DELHI-KOCHI,84645,All
2025,1,DELHI,KOCHI,41969,45024,DELHI-KOCHI,86993,All
2025,2,DELHI,KOCHI,41278,43011,DELHI-KOCHI,84289,All
2025,3,DELHI,KOCHI,41534,38604,DELHI-KOCHI,80138,All
2019,5,DELHI,KOLKATA,126329,118518,DELHI-KOLKATA,244847,All
2019,6,DELHI,KOLKATA,130131,123535,DELHI-KOLKATA,253666,All
2019,7,DELHI,KOLKATA,129835,129263,DELHI-KOLKATA,259098,All
2019,8,DELHI,KOLKATA,131442,126749,DELHI-KOLKATA,258191,All
2019,9,DELHI,KOLKATA,127623,117648,DELHI-KOLKATA,245271,All
2019,10,DELHI,KOLKATA,156390,142887,DELHI-KOLKATA,299277,All
2019,11,DELHI,KOLKATA,154850,153837,DELHI-KOLKATA,308687,All
2019,12,DELHI,KOLKATA,168261,146971,DELHI-KOLKATA,315232,All
2020,1,DELHI,KOLKATA,148504,148728,DELHI-KOLKATA,297232,All
2020,2,DELHI,KOLKATA,139873,144366,DELHI-KOLKATA,284239,All
2020,3,DELHI,KOLKATA,107195,84445,DELHI-KOLKATA,191640,All
2020,4,DELHI,KOLKATA,0,0,DELHI-KOLKATA,0,All
2020,5,DELHI,KOLKATA,3542,1930,DELHI-KOLKATA,5472,All
2020,6,DELHI,KOLKATA,47765,21939,DELHI-KOLKATA,69704,All
2020,7,DELHI,KOLKATA,6686,4859,DELHI-KOLKATA,11545,All
2020,8,DELHI,KOLKATA,0,4538,DELHI-KOLKATA,4538,All
2020,9,DELHI,KOLKATA,29556,43315,DELHI-KOLKATA,72871,All
2020,10,DELHI,KOLKATA,36463,48377,DELHI-KOLKATA,84840,All
2020,11,DELHI,KOLKATA,39172,49413,DELHI-KOLKATA,88585,All
2020,12,DELHI,KOLKATA,58207,53415,DELHI-KOLKATA,111622,All
2021,1,DELHI,KOLKATA,74965,71588,DELHI-KOLKATA,146553,All
2021,2,DELHI,KOLKATA,81898,78093,DELHI-KOLKATA,159991,All
2021,3,DELHI,KOLKATA,92927,89740,DELHI-KOLKATA,182667,All
2021,4,DELHI,KOLKATA,81347,58188,DELHI-KOLKATA,139535,All
2021,6,DELHI,KOLKATA,31252,33575,DELHI-KOLKATA,64827,All
2021,7,DELHI,KOLKATA,53837,53219,DELHI-KOLKATA,107056,All
2021,8,DELHI,KOLKATA,73816,76512,DELHI-KOLKATA,150328,All
2021,9,DELHI,KOLKATA,78472,78382,DELHI-KOLKATA,156854,All
2021,10,DELHI,KOLKATA,117852,110718,DELHI-KOLKATA,228570,All
2021,11,DELHI,KOLKATA,121632,111326,DELHI-KOLKATA,232958,All
2021,12,DELHI,KOLKATA,129929,113548,DELHI-KOLKATA,243477,All
2022,1,DELHI,KOLKATA,46033,55147,DELHI-KOLKATA,101180,All
2022,2,DELHI,KOLKATA,82061,87175,DELHI-KOLKATA,169236,All
2022,3,DELHI,KOLKATA,115990,117734,DELHI-KOLKATA,233724,All
2022,4,DELHI,KOLKATA,115328,101655,DELHI-KOLKATA,216983,All
2022,5,DELHI,KOLKATA,117834,111106,DELHI-KOLKATA,228940,All
2022,6,DELHI,KOLKATA,120274,98822,DELHI-KOLKATA,219096,All
2022,7,DELHI,KOLKATA,103244,97231,DELHI-KOLKATA,200475,All
2022,8,DELHI,KOLKATA,99209,101324,DELHI-KOLKATA,200533,All
2022,9,DELHI,KOLKATA,112036,103131,DELHI-KOLKATA,215167,All
2022,10,DELHI,KOLKATA,133758,122366,DELHI-KOLKATA,256124,All
2022,11,DELHI,KOLKATA,115176,110749,DELHI-KOLKATA,225925,All
2022,12,DELHI,KOLKATA,129427,117374,DELHI-KOLKATA,246801,All
2023,1,DELHI,KOLKATA,115389,114833,DELHI-KOLKATA,230222,All
2023,2,DELHI,KOLKATA,109646,110634,DELHI-KOLKATA,220280,All
2023,3,DELHI,KOLKATA,125504,117873,DELHI-KOLKATA,243377,All
2023,4,DELHI,KOLKATA,127300,110717,DELHI-KOLKATA,238017,All
2023,5,DELHI,KOLKATA,126070,119634,DELHI-KOLKATA,245704,All
2023,6,DELHI,KOLKATA,117487,109512,DELHI-KOLKATA,226999,All
2023,7,DELHI,KOLKATA,107528,112810,DELHI-KOLKATA,220338,All
2023,8,DELHI,KOLKATA,112938,114296,DELHI-KOLKATA,227234,All
2023,9,DELHI,KOLKATA,110987,108189,DELHI-KOLKATA,219176,All
2023,10,DELHI,KOLKATA,124895,119209,DELHI-KOLKATA,244104,All
2023,11,DELHI,KOLKATA,124240,112853,DELHI-KOLKATA,237093,All
2023,12,DELHI,KOLKATA,128495,120795,DELHI-KOLKATA,249290,All
2024,1,DELHI,KOLKATA,119251,118865,DELHI-KOLKATA,238116,All
2024,2,DELHI,KOLKATA,115415,113691,DELHI-KOLKATA,229106,All
2024,3,DELHI,KOLKATA,125476,120424,DELHI-KOLKATA,245900,All
2024,4,DELHI,KOLKATA,121262,107008,DELHI-KOLKATA,228270,All
2024,6,DELHI,KOLKATA,116303,101109,DELHI-KOLKATA,217412,All
2024,7,DELHI,KOLKATA,109039,112902,DELHI-KOLKATA,221941,All
2024,8,DELHI,KOLKATA,102142,103636,DELHI-KOLKATA,205778,All
2024,9,DELHI,KOLKATA,108371,100242,DELHI-KOLKATA,208613,All
2024,10,DELHI,KOLKATA,129537,119736,DELHI-KOLKATA,249273,All
2024,11,DELHI,KOLKATA,125031,122788,DELHI-KOLKATA,247819,All
2024,12,DELHI,KOLKATA,130761,122625,DELHI-KOLKATA,253386,All
2025,1,DELHI,KOLKATA,121831,123163,DELHI-KOLKATA,244994,All
2025,2,DELHI,KOLKATA,115354,114877,DELHI-KOLKATA,230231,All
2025,3,DELHI,KOLKATA,127340,122804,DELHI-KOLKATA,250144,All
2019,5,DELHI,KOZHIKODE,2079,2336,DELHI-KOZHIKODE,4415,All
2019,6,DELHI,KOZHIKODE,2245,3610,DELHI-KOZHIKODE,5855,All
2019,7,DELHI,KOZHIKODE,2089,3148,DELHI-KOZHIKODE,5237,All
2019,8,DELHI,KOZHIKODE,2054,2769,DELHI-KOZHIKODE,4823,All
2019,9,DELHI,KOZHIKODE,2145,2784,DELHI-KOZHIKODE,4929,All
2019,10,DELHI,KOZHIKODE,2127,2797,DELHI-KOZHIKODE,4924,All
2019,11,DELHI,KOZHIKODE,2322,2401,DELHI-KOZHIKODE,4723,All
2019,12,DELHI,KOZHIKODE,2913,2488,DELHI-KOZHIKODE,5401,All
2020,1,DELHI,KOZHIKODE,2217,2428,DELHI-KOZHIKODE,4645,All
2020,2,DELHI,KOZHIKODE,2137,2132,DELHI-KOZHIKODE,4269,All
2020,3,DELHI,KOZHIKODE,1957,1336,DELHI-KOZHIKODE,3293,All
2020,7,DELHI,KOZHIKODE,370,360,DELHI-KOZHIKODE,730,All
2020,8,DELHI,KOZHIKODE,551,652,DELHI-KOZHIKODE,1203,All
2020,9,DELHI,KOZHIKODE,1305,1029,DELHI-KOZHIKODE,2334,All
2020,10,DELHI,KOZHIKODE,1298,1319,DELHI-KOZHIKODE,2617,All
2020,11,DELHI,KOZHIKODE,1673,1898,DELHI-KOZHIKODE,3571,All
2020,12,DELHI,KOZHIKODE,2881,2482,DELHI-KOZHIKODE,5363,All
2021,1,DELHI,KOZHIKODE,3042,3609,DELHI-KOZHIKODE,6651,All
2021,2,DELHI,KOZHIKODE,4879,5449,DELHI-KOZHIKODE,10328,All
2021,3,DELHI,KOZHIKODE,5701,6623,DELHI-KOZHIKODE,12324,All
2021,4,DELHI,KOZHIKODE,4679,5324,DELHI-KOZHIKODE,10003,All
2021,6,DELHI,KOZHIKODE,1954,2906,DELHI-KOZHIKODE,4860,All
2021,7,DELHI,KOZHIKODE,2887,3784,DELHI-KOZHIKODE,6671,All
2021,8,DELHI,KOZHIKODE,4821,5197,DELHI-KOZHIKODE,10018,All
2021,9,DELHI,KOZHIKODE,4467,5586,DELHI-KOZHIKODE,10053,All
2021,10,DELHI,KOZHIKODE,6367,7299,DELHI-KOZHIKODE,13666,All
2021,11,DELHI,KOZHIKODE,6374,6363,DELHI-KOZHIKODE,12737,All
2021,12,DELHI,KOZHIKODE,7189,6798,DELHI-KOZHIKODE,13987,All
2022,1,DELHI,KOZHIKODE,6245,6747,DELHI-KOZHIKODE,12992,All
2022,2,DELHI,KOZHIKODE,6186,7142,DELHI-KOZHIKODE,13328,All
2022,3,DELHI,KOZHIKODE,7494,7316,DELHI-KOZHIKODE,14810,All
2022,4,DELHI,KOZHIKODE,6646,6876,DELHI-KOZHIKODE,13522,All
2022,5,DELHI,KOZHIKODE,7072,6955,DELHI-KOZHIKODE,14027,All
2022,6,DELHI,KOZHIKODE,7056,6921,DELHI-KOZHIKODE,13977,All
2022,7,DELHI,KOZHIKODE,7192,7422,DELHI-KOZHIKODE,14614,All
2022,8,DELHI,KOZHIKODE,8155,8418,DELHI-KOZHIKODE,16573,All
2022,9,DELHI,KOZHIKODE,8625,9416,DELHI-KOZHIKODE,18041,All
2022,10,DELHI,KOZHIKODE,9366,9750,DELHI-KOZHIKODE,19116,All
2022,11,DELHI,KOZHIKODE,7314,7492,DELHI-KOZHIKODE,14806,All
2022,12,DELHI,KOZHIKODE,7696,7326,DELHI-KOZHIKODE,15022,All
2023,1,DELHI,KOZHIKODE,6692,7097,DELHI-KOZHIKODE,13789,All
2023,2,DELHI,KOZHIKODE,5748,5695,DELHI-KOZHIKODE,11443,All
2023,3,DELHI,KOZHIKODE,5429,5016,DELHI-KOZHIKODE,10445,All
2023,4,DELHI,KOZHIKODE,4995,5259,DELHI-KOZHIKODE,10254,All
2023,5,DELHI,KOZHIKODE,5393,5331,DELHI-KOZHIKODE,10724,All
2023,6,DELHI,KOZHIKODE,5523,4962,DELHI-KOZHIKODE,10485,All
2023,7,DELHI,KOZHIKODE,5131,4764,DELHI-KOZHIKODE,9895,All
2023,8,DELHI,KOZHIKODE,5267,5376,DELHI-KOZHIKODE,10643,All
2023,9,DELHI,KOZHIKODE,4483,5010,DELHI-KOZHIKODE,9493,All
2023,10,DELHI,KOZHIKODE,4996,5300,DELHI-KOZHIKODE,10296,All
2023,11,DELHI,KOZHIKODE,5053,5166,DELHI-KOZHIKODE,10219,All
2023,12,DELHI,KOZHIKODE,5503,5244,DELHI-KOZHIKODE,10747,All
2024,1,DELHI,KOZHIKODE,5154,5169,DELHI-KOZHIKODE,10323,All
2024,2,DELHI,KOZHIKODE,4713,4730,DELHI-KOZHIKODE,9443,All
2024,3,DELHI,KOZHIKODE,4718,4579,DELHI-KOZHIKODE,9297,All
2024,4,DELHI,KOZHIKODE,4983,5126,DELHI-KOZHIKODE,10109,All
2024,6,DELHI,KOZHIKODE,5106,4855,DELHI-KOZHIKODE,9961,All
2024,7,DELHI,KOZHIKODE,4978,4646,DELHI-KOZHIKODE,9624,All
2024,8,DELHI,KOZHIKODE,4768,4946,DELHI-KOZHIKODE,9714,All
2024,9,DELHI,KOZHIKODE,4904,5150,DELHI-KOZHIKODE,10054,All
2024,10,DELHI,KOZHIKODE,5029,5121,DELHI-KOZHIKODE,10150,All
2024,11,DELHI,KOZHIKODE,5108,4844,DELHI-KOZHIKODE,9952,All
2024,12,DELHI,KOZHIKODE,5719,5409,DELHI-KOZHIKODE,11128,All
2025,1,DELHI,KOZHIKODE,5819,5677,DELHI-KOZHIKODE,11496,All
2025,2,DELHI,KOZHIKODE,5263,5262,DELHI-KOZHIKODE,10525,All
2025,3,DELHI,KOZHIKODE,4767,4255,DELHI-KOZHIKODE,9022,All
2015,4,DELHI,KULLU,667,425,DELHI-KULLU,1092,All
2015,5,DELHI,KULLU,741,519,DELHI-KULLU,1260,All
2015,6,DELHI,KULLU,727,539,DELHI-KULLU,1266,All
2015,7,DELHI,KULLU,665,546,DELHI-KULLU,1211,All
2015,8,DELHI,KULLU,527,413,DELHI-KULLU,940,All
2015,9,DELHI,KULLU,950,598,DELHI-KULLU,1548,All
2015,10,DELHI,KULLU,1079,893,DELHI-KULLU,1972,All
2015,11,DELHI,KULLU,888,749,DELHI-KULLU,1637,All
2015,12,DELHI,KULLU,879,684,DELHI-KULLU,1563,All
2016,1,DELHI,KULLU,671,684,DELHI-KULLU,1355,All
2016,2,DELHI,KULLU,745,618,DELHI-KULLU,1363,All
2016,3,DELHI,KULLU,997,707,DELHI-KULLU,1704,All
2016,4,DELHI,KULLU,1393,1016,DELHI-KULLU,2409,All
2016,5,DELHI,KULLU,1357,927,DELHI-KULLU,2284,All
2016,6,DELHI,KULLU,1309,908,DELHI-KULLU,2217,All
2016,7,DELHI,KULLU,1188,800,DELHI-KULLU,1988,All
2016,8,DELHI,KULLU,943,772,DELHI-KULLU,1715,All
2016,9,DELHI,KULLU,1252,885,DELHI-KULLU,2137,All
2016,10,DELHI,KULLU,1272,1047,DELHI-KULLU,2319,All
2016,11,DELHI,KULLU,1014,912,DELHI-KULLU,1926,All
2016,12,DELHI,KULLU,327,211,DELHI-KULLU,538,All
2017,1,DELHI,KULLU,521,457,DELHI-KULLU,978,All
2017,2,DELHI,KULLU,826,635,DELHI-KULLU,1461,All
2017,3,DELHI,KULLU,1204,718,DELHI-KULLU,1922,All
2017,4,DELHI,KULLU,1312,778,DELHI-KULLU,2090,All
2017,5,DELHI,KULLU,1582,943,DELHI-KULLU,2525,All
2017,6,DELHI,KULLU,1476,860,DELHI-KULLU,2336,All
2017,7,DELHI,KULLU,1378,769,DELHI-KULLU,2147,All
2017,8,DELHI,KULLU,1248,651,DELHI-KULLU,1899,All
2017,9,DELHI,KULLU,1310,760,DELHI-KULLU,2070,All
2017,10,DELHI,KULLU,1276,870,DELHI-KULLU,2146,All
2017,11,DELHI,KULLU,1074,635,DELHI-KULLU,1709,All
2017,12,DELHI,KULLU,1204,693,DELHI-KULLU,1897,All
2018,1,DELHI,KULLU,645,417,DELHI-KULLU,1062,All
2018,2,DELHI,KULLU,819,367,DELHI-KULLU,1186,All
2018,3,DELHI,KULLU,1300,565,DELHI-KULLU,1865,All
2018,4,DELHI,KULLU,1153,513,DELHI-KULLU,1666,All
2018,5,DELHI,KULLU,1580,587,DELHI-KULLU,2167,All
2018,6,DELHI,KULLU,1346,432,DELHI-KULLU,1778,All
2018,7,DELHI,KULLU,930,391,DELHI-KULLU,1321,All
2018,8,DELHI,KULLU,743,323,DELHI-KULLU,1066,All
2018,9,DELHI,KULLU,1057,382,DELHI-KULLU,1439,All
2018,10,DELHI,KULLU,1036,453,DELHI-KULLU,1489,All
2018,11,DELHI,KULLU,881,399,DELHI-KULLU,1280,All
2018,12,DELHI,KULLU,882,370,DELHI-KULLU,1252,All
2019,1,DELHI,KULLU,854,321,DELHI-KULLU,1175,All
2019,2,DELHI,KULLU,758,309,DELHI-KULLU,1067,All
2019,3,DELHI,KULLU,996,431,DELHI-KULLU,1427,All
2019,4,DELHI,KULLU,1145,390,DELHI-KULLU,1535,All
2019,5,DELHI,KULLU,1209,396,DELHI-KULLU,1605,All
2019,6,DELHI,KULLU,1209,381,DELHI-KULLU,1590,All
2019,7,DELHI,KULLU,900,219,DELHI-KULLU,1119,All
2019,8,DELHI,KULLU,638,215,DELHI-KULLU,853,All
2019,9,DELHI,KULLU,845,289,DELHI-KULLU,1134,All
2019,10,DELHI,KULLU,1047,365,DELHI-KULLU,1412,All
2019,11,DELHI,KULLU,872,336,DELHI-KULLU,1208,All
2019,12,DELHI,KULLU,987,340,DELHI-KULLU,1327,All
2020,1,DELHI,KULLU,780,276,DELHI-KULLU,1056,All
2020,2,DELHI,KULLU,676,352,DELHI-KULLU,1028,All
2020,3,DELHI,KULLU,424,222,DELHI-KULLU,646,All
2020,7,DELHI,KULLU,95,27,DELHI-KULLU,122,All
2020,8,DELHI,KULLU,257,106,DELHI-KULLU,363,All
2020,9,DELHI,KULLU,347,87,DELHI-KULLU,434,All
2020,10,DELHI,KULLU,475,169,DELHI-KULLU,644,All
2020,11,DELHI,KULLU,552,230,DELHI-KULLU,782,All
2020,12,DELHI,KULLU,885,287,DELHI-KULLU,1172,All
2021,1,DELHI,KULLU,814,278,DELHI-KULLU,1092,All
2021,2,DELHI,KULLU,621,212,DELHI-KULLU,833,All
2021,3,DELHI,KULLU,665,331,DELHI-KULLU,996,All
2021,4,DELHI,KULLU,545,196,DELHI-KULLU,741,All
2021,6,DELHI,KULLU,1122,348,DELHI-KULLU,1470,All
2021,7,DELHI,KULLU,620,253,DELHI-KULLU,873,All
2021,8,DELHI,KULLU,544,206,DELHI-KULLU,750,All
2021,9,DELHI,KULLU,567,230,DELHI-KULLU,797,All
2021,10,DELHI,KULLU,774,349,DELHI-KULLU,1123,All
2021,11,DELHI,KULLU,739,370,DELHI-KULLU,1109,All
2021,12,DELHI,KULLU,846,279,DELHI-KULLU,1125,All
2022,1,DELHI,KULLU,586,175,DELHI-KULLU,761,All
2022,2,DELHI,KULLU,731,202,DELHI-KULLU,933,All
2022,3,DELHI,KULLU,909,318,DELHI-KULLU,1227,All
2022,4,DELHI,KULLU,739,370,DELHI-KULLU,1109,All
2022,5,DELHI,KULLU,846,279,DELHI-KULLU,1125,All
2022,6,DELHI,KULLU,739,370,DELHI-KULLU,1109,All
2022,7,DELHI,KULLU,731,202,DELHI-KULLU,933,All
2022,8,DELHI,KULLU,846,279,DELHI-KULLU,1125,All
2022,9,DELHI,KULLU,739,370,DELHI-KULLU,1109,All
2022,10,DELHI,KULLU,675,418,DELHI-KULLU,1093,All
2022,11,DELHI,KULLU,596,364,DELHI-KULLU,960,All
2022,12,DELHI,KULLU,669,336,DELHI-KULLU,1005,All
2023,1,DELHI,KULLU,211,94,DELHI-KULLU,305,All
2023,2,DELHI,KULLU,575,273,DELHI-KULLU,848,All
2023,3,DELHI,KULLU,733,419,DELHI-KULLU,1152,All
2023,4,DELHI,KULLU,133,91,DELHI-KULLU,224,All
2023,5,DELHI,KULLU,97,71,DELHI-KULLU,168,All
2023,6,DELHI,KULLU,155,253,DELHI-KULLU,408,All
2023,7,DELHI,KULLU,55,101,DELHI-KULLU,156,All
2023,8,DELHI,KULLU,80,69,DELHI-KULLU,149,All
2023,9,DELHI,KULLU,81,55,DELHI-KULLU,136,All
2023,10,DELHI,KULLU,376,307,DELHI-KULLU,683,All
2023,11,DELHI,KULLU,367,190,DELHI-KULLU,557,All
2023,12,DELHI,KULLU,387,225,DELHI-KULLU,612,All
2024,1,DELHI,KULLU,145,120,DELHI-KULLU,265,All
2024,2,DELHI,KULLU,589,296,DELHI-KULLU,885,All
2024,3,DELHI,KULLU,709,457,DELHI-KULLU,1166,All
2024,4,DELHI,KULLU,1069,620,DELHI-KULLU,1689,All
2024,6,DELHI,KULLU,1879,728,DELHI-KULLU,2607,All
2024,7,DELHI,KULLU,673,334,DELHI-KULLU,1007,All
2024,8,DELHI,KULLU,640,231,DELHI-KULLU,871,All
2024,9,DELHI,KULLU,939,398,DELHI-KULLU,1337,All
2024,10,DELHI,KULLU,1018,595,DELHI-KULLU,1613,All
2024,11,DELHI,KULLU,423,261,DELHI-KULLU,684,All
2024,12,DELHI,KULLU,427,234,DELHI-KULLU,661,All
2025,1,DELHI,KULLU,474,277,DELHI-KULLU,751,All
2025,2,DELHI,KULLU,367,156,DELHI-KULLU,523,All
2025,3,DELHI,KULLU,543,260,DELHI-KULLU,803,All
2023,1,DELHI,Kushinagar,270,228,DELHI-Kushinagar,498,All
2023,6,DELHI,Kushinagar,2182,2159,DELHI-Kushinagar,4341,All
2023,7,DELHI,Kushinagar,1152,1613,DELHI-Kushinagar,2765,All
2023,8,DELHI,Kushinagar,877,939,DELHI-Kushinagar,1816,All
2023,9,DELHI,Kushinagar,922,1291,DELHI-Kushinagar,2213,All
2023,10,DELHI,Kushinagar,384,324,DELHI-Kushinagar,708,All
2023,11,DELHI,Kushinagar,234,161,DELHI-Kushinagar,395,All
2021,11,DELHI,Kushinagar International Airport,234,234,DELHI-Kushinagar International Airport,468,All
2021,12,DELHI,Kushinagar International Airport,1338,1350,DELHI-Kushinagar International Airport,2688,All
2022,1,DELHI,Kushinagar International Airport,1037,820,DELHI-Kushinagar International Airport,1857,All
2022,2,DELHI,Kushinagar International Airport,1495,1503,DELHI-Kushinagar International Airport,2998,All
2022,3,DELHI,Kushinagar International Airport,1524,1429,DELHI-Kushinagar International Airport,2953,All
2022,4,DELHI,Kushinagar International Airport,1748,1529,DELHI-Kushinagar International Airport,3277,All
2022,5,DELHI,Kushinagar International Airport,1844,1807,DELHI-Kushinagar International Airport,3651,All
2022,6,DELHI,Kushinagar International Airport,1761,2076,DELHI-Kushinagar International Airport,3837,All
2022,7,DELHI,Kushinagar International Airport,1285,1508,DELHI-Kushinagar International Airport,2793,All
2022,8,DELHI,Kushinagar International Airport,613,754,DELHI-Kushinagar International Airport,1367,All
2022,9,DELHI,Kushinagar International Airport,232,223,DELHI-Kushinagar International Airport,455,All
2022,10,DELHI,Kushinagar International Airport,741,536,DELHI-Kushinagar International Airport,1277,All
2022,11,DELHI,Kushinagar International Airport,256,239,DELHI-Kushinagar International Airport,495,All
2022,12,DELHI,Kushinagar International Airport,635,635,DELHI-Kushinagar International Airport,1270,All
2023,2,DELHI,Kushinagar International Airport,1009,754,DELHI-Kushinagar International Airport,1763,All
2023,3,DELHI,Kushinagar International Airport,948,915,DELHI-Kushinagar International Airport,1863,All
2023,4,DELHI,Kushinagar International Airport,954,756,DELHI-Kushinagar International Airport,1710,All
2023,5,DELHI,Kushinagar International Airport,2154,2020,DELHI-Kushinagar International Airport,4174,All
2015,4,DELHI,LEH,14700,11336,DELHI-LEH,26036,All
2015,5,DELHI,LEH,19635,18022,DELHI-LEH,37657,All
2015,6,DELHI,LEH,17307,18200,DELHI-LEH,35507,All
2015,7,DELHI,LEH,15936,16306,DELHI-LEH,32242,All
2015,8,DELHI,LEH,15528,17157,DELHI-LEH,32685,All
2015,9,DELHI,LEH,14440,17805,DELHI-LEH,32245,All
2015,10,DELHI,LEH,7057,9461,DELHI-LEH,16518,All
2015,11,DELHI,LEH,4549,12205,DELHI-LEH,16754,All
2015,12,DELHI,LEH,4819,8148,DELHI-LEH,12967,All
2016,1,DELHI,LEH,6234,7896,DELHI-LEH,14130,All
2016,2,DELHI,LEH,10026,7582,DELHI-LEH,17608,All
2016,3,DELHI,LEH,13013,7356,DELHI-LEH,20369,All
2016,4,DELHI,LEH,18137,13558,DELHI-LEH,31695,All
2016,5,DELHI,LEH,23255,22417,DELHI-LEH,45672,All
2016,6,DELHI,LEH,24469,25416,DELHI-LEH,49885,All
2016,7,DELHI,LEH,22283,23137,DELHI-LEH,45420,All
2016,8,DELHI,LEH,21106,22732,DELHI-LEH,43838,All
2016,9,DELHI,LEH,19266,22398,DELHI-LEH,41664,All
2016,10,DELHI,LEH,10679,20224,DELHI-LEH,30903,All
2016,11,DELHI,LEH,5696,10327,DELHI-LEH,16023,All
2016,12,DELHI,LEH,5113,11926,DELHI-LEH,17039,All
2017,1,DELHI,LEH,6613,9791,DELHI-LEH,16404,All
2017,2,DELHI,LEH,13085,7889,DELHI-LEH,20974,All
2017,3,DELHI,LEH,16790,7173,DELHI-LEH,23963,All
2017,4,DELHI,LEH,17180,12049,DELHI-LEH,29229,All
2017,5,DELHI,LEH,27961,26280,DELHI-LEH,54241,All
2017,6,DELHI,LEH,32629,35421,DELHI-LEH,68050,All
2017,7,DELHI,LEH,28942,33263,DELHI-LEH,62205,All
2017,8,DELHI,LEH,26377,30412,DELHI-LEH,56789,All
2017,9,DELHI,LEH,27134,32871,DELHI-LEH,60005,All
2017,10,DELHI,LEH,15688,25845,DELHI-LEH,41533,All
2017,11,DELHI,LEH,7848,15808,DELHI-LEH,23656,All
2017,12,DELHI,LEH,8489,17054,DELHI-LEH,25543,All
2018,1,DELHI,LEH,9681,15668,DELHI-LEH,25349,All
2018,2,DELHI,LEH,15350,9984,DELHI-LEH,25334,All
2018,3,DELHI,LEH,19593,8614,DELHI-LEH,28207,All
2018,4,DELHI,LEH,26429,19601,DELHI-LEH,46030,All
2018,5,DELHI,LEH,39249,35297,DELHI-LEH,74546,All
2018,6,DELHI,LEH,36306,38122,DELHI-LEH,74428,All
2018,7,DELHI,LEH,36359,37593,DELHI-LEH,73952,All
2018,8,DELHI,LEH,33608,36073,DELHI-LEH,69681,All
2018,9,DELHI,LEH,33148,34863,DELHI-LEH,68011,All
2018,10,DELHI,LEH,20781,26409,DELHI-LEH,47190,All
2018,11,DELHI,LEH,10805,20192,DELHI-LEH,30997,All
2018,12,DELHI,LEH,10344,22045,DELHI-LEH,32389,All
2019,1,DELHI,LEH,13122,18922,DELHI-LEH,32044,All
2019,2,DELHI,LEH,18307,11621,DELHI-LEH,29928,All
2019,3,DELHI,LEH,20784,9836,DELHI-LEH,30620,All
2019,4,DELHI,LEH,28292,17510,DELHI-LEH,45802,All
2019,5,DELHI,LEH,34131,33575,DELHI-LEH,67706,All
2019,6,DELHI,LEH,34960,37162,DELHI-LEH,72122,All
2019,7,DELHI,LEH,31836,33853,DELHI-LEH,65689,All
2019,8,DELHI,LEH,31062,32462,DELHI-LEH,63524,All
2019,9,DELHI,LEH,27695,31342,DELHI-LEH,59037,All
2019,10,DELHI,LEH,22448,25446,DELHI-LEH,47894,All
2019,11,DELHI,LEH,12763,12028,DELHI-LEH,24791,All
2019,12,DELHI,LEH,11395,15228,DELHI-LEH,26623,All
2020,1,DELHI,LEH,12391,14390,DELHI-LEH,26781,All
2020,2,DELHI,LEH,16265,12277,DELHI-LEH,28542,All
2020,3,DELHI,LEH,14078,8925,DELHI-LEH,23003,All
2020,5,DELHI,LEH,1493,416,DELHI-LEH,1909,All
2020,6,DELHI,LEH,7235,4347,DELHI-LEH,11582,All
2020,7,DELHI,LEH,11766,7269,DELHI-LEH,19035,All
2020,8,DELHI,LEH,8782,9495,DELHI-LEH,18277,All
2020,9,DELHI,LEH,6876,11067,DELHI-LEH,17943,All
2020,10,DELHI,LEH,6862,15949,DELHI-LEH,22811,All
2020,11,DELHI,LEH,6438,13607,DELHI-LEH,20045,All
2020,12,DELHI,LEH,5768,9834,DELHI-LEH,15602,All
2021,1,DELHI,LEH,9354,13059,DELHI-LEH,22413,All
2021,2,DELHI,LEH,18548,11377,DELHI-LEH,29925,All
2021,3,DELHI,LEH,29998,11397,DELHI-LEH,41395,All
2021,4,DELHI,LEH,34012,18560,DELHI-LEH,52572,All
2021,6,DELHI,LEH,27570,20220,DELHI-LEH,47790,All
2021,7,DELHI,LEH,51908,51775,DELHI-LEH,103683,All
2021,8,DELHI,LEH,50029,55479,DELHI-LEH,105508,All
2021,9,DELHI,LEH,52137,60144,DELHI-LEH,112281,All
2021,10,DELHI,LEH,35485,60040,DELHI-LEH,95525,All
2021,11,DELHI,LEH,21350,28545,DELHI-LEH,49895,All
2021,12,DELHI,LEH,15230,22010,DELHI-LEH,37240,All
2022,1,DELHI,LEH,11363,13492,DELHI-LEH,24855,All
2022,2,DELHI,LEH,26000,13903,DELHI-LEH,39903,All
2022,3,DELHI,LEH,42193,16300,DELHI-LEH,58493,All
2022,4,DELHI,LEH,54140,38230,DELHI-LEH,92370,All
2022,5,DELHI,LEH,60408,50707,DELHI-LEH,111115,All
2022,6,DELHI,LEH,56960,51199,DELHI-LEH,108159,All
2022,7,DELHI,LEH,58515,64779,DELHI-LEH,123294,All
2022,8,DELHI,LEH,52647,54785,DELHI-LEH,107432,All
2022,9,DELHI,LEH,40697,44078,DELHI-LEH,84775,All
2022,10,DELHI,LEH,28754,39894,DELHI-LEH,68648,All
2022,11,DELHI,LEH,16883,21627,DELHI-LEH,38510,All
2022,12,DELHI,LEH,15805,22396,DELHI-LEH,38201,All
2023,1,DELHI,LEH,18472,18707,DELHI-LEH,37179,All
2023,2,DELHI,LEH,25521,15848,DELHI-LEH,41369,All
2023,3,DELHI,LEH,37317,16724,DELHI-LEH,54041,All
2023,4,DELHI,LEH,57086,39256,DELHI-LEH,96342,All
2023,5,DELHI,LEH,40276,39481,DELHI-LEH,79757,All
2023,6,DELHI,LEH,45191,46362,DELHI-LEH,91553,All
2023,7,DELHI,LEH,44941,47014,DELHI-LEH,91955,All
2023,8,DELHI,LEH,45345,51415,DELHI-LEH,96760,All
2023,9,DELHI,LEH,47787,49194,DELHI-LEH,96981,All
2023,10,DELHI,LEH,29760,44109,DELHI-LEH,73869,All
2023,11,DELHI,LEH,19992,21553,DELHI-LEH,41545,All
2023,12,DELHI,LEH,22225,23586,DELHI-LEH,45811,All
2024,1,DELHI,LEH,21739,21517,DELHI-LEH,43256,All
2024,2,DELHI,LEH,22295,16162,DELHI-LEH,38457,All
2024,3,DELHI,LEH,23951,17786,DELHI-LEH,41737,All
2024,4,DELHI,LEH,50900,36066,DELHI-LEH,86966,All
2024,6,DELHI,LEH,50603,52457,DELHI-LEH,103060,All
2024,7,DELHI,LEH,47621,50451,DELHI-LEH,98072,All
2024,8,DELHI,LEH,45734,50413,DELHI-LEH,96147,All
2024,9,DELHI,LEH,43578,48262,DELHI-LEH,91840,All
2024,10,DELHI,LEH,29274,45541,DELHI-LEH,74815,All
2024,11,DELHI,LEH,23362,24558,DELHI-LEH,47920,All
2024,12,DELHI,LEH,22532,24793,DELHI-LEH,47325,All
2025,1,DELHI,LEH,18865,22722,DELHI-LEH,41587,All
2025,2,DELHI,LEH,21119,16723,DELHI-LEH,37842,All
2025,3,DELHI,LEH,31355,20062,DELHI-LEH,51417,All
2015,4,DELHI,LUCKNOW,53557,48957,DELHI-LUCKNOW,102514,All
2015,5,DELHI,LUCKNOW,60568,53407,DELHI-LUCKNOW,113975,All
2015,6,DELHI,LUCKNOW,64164,67313,DELHI-LUCKNOW,131477,All
2015,7,DELHI,LUCKNOW,58925,61344,DELHI-LUCKNOW,120269,All
2015,8,DELHI,LUCKNOW,60524,62085,DELHI-LUCKNOW,122609,All
2015,9,DELHI,LUCKNOW,62224,57143,DELHI-LUCKNOW,119367,All
2015,10,DELHI,LUCKNOW,56111,51243,DELHI-LUCKNOW,107354,All
2015,11,DELHI,LUCKNOW,71058,64340,DELHI-LUCKNOW,135398,All
2015,12,DELHI,LUCKNOW,63160,64010,DELHI-LUCKNOW,127170,All
2016,1,DELHI,LUCKNOW,56728,57403,DELHI-LUCKNOW,114131,All
2016,2,DELHI,LUCKNOW,69447,67345,DELHI-LUCKNOW,136792,All
2016,3,DELHI,LUCKNOW,74670,72330,DELHI-LUCKNOW,147000,All
2016,4,DELHI,LUCKNOW,75786,70259,DELHI-LUCKNOW,146045,All
2016,5,DELHI,LUCKNOW,73333,76027,DELHI-LUCKNOW,149360,All
2016,6,DELHI,LUCKNOW,75855,72194,DELHI-LUCKNOW,148049,All
2016,7,DELHI,LUCKNOW,83161,81330,DELHI-LUCKNOW,164491,All
2016,8,DELHI,LUCKNOW,82721,81528,DELHI-LUCKNOW,164249,All
2016,9,DELHI,LUCKNOW,84336,79644,DELHI-LUCKNOW,163980,All
2016,10,DELHI,LUCKNOW,92899,72719,DELHI-LUCKNOW,165618,All
2016,11,DELHI,LUCKNOW,92883,92317,DELHI-LUCKNOW,185200,All
2016,12,DELHI,LUCKNOW,81121,77133,DELHI-LUCKNOW,158254,All
2017,1,DELHI,LUCKNOW,81535,79695,DELHI-LUCKNOW,161230,All
2017,2,DELHI,LUCKNOW,82328,77026,DELHI-LUCKNOW,159354,All
2017,3,DELHI,LUCKNOW,83314,79541,DELHI-LUCKNOW,162855,All
2017,4,DELHI,LUCKNOW,84544,69723,DELHI-LUCKNOW,154267,All
2017,5,DELHI,LUCKNOW,87979,78732,DELHI-LUCKNOW,166711,All
2017,6,DELHI,LUCKNOW,86713,79756,DELHI-LUCKNOW,166469,All
2017,7,DELHI,LUCKNOW,76142,78583,DELHI-LUCKNOW,154725,All
2017,8,DELHI,LUCKNOW,84605,78111,DELHI-LUCKNOW,162716,All
2017,9,DELHI,LUCKNOW,81268,75230,DELHI-LUCKNOW,156498,All
2017,10,DELHI,LUCKNOW,92809,83301,DELHI-LUCKNOW,176110,All
2017,11,DELHI,LUCKNOW,88853,85862,DELHI-LUCKNOW,174715,All
2017,12,DELHI,LUCKNOW,90692,88519,DELHI-LUCKNOW,179211,All
2018,1,DELHI,LUCKNOW,93951,90738,DELHI-LUCKNOW,184689,All
2018,2,DELHI,LUCKNOW,91838,86180,DELHI-LUCKNOW,178018,All
2018,3,DELHI,LUCKNOW,99261,97818,DELHI-LUCKNOW,197079,All
2018,4,DELHI,LUCKNOW,93153,89396,DELHI-LUCKNOW,182549,All
2018,5,DELHI,LUCKNOW,82991,82249,DELHI-LUCKNOW,165240,All
2018,6,DELHI,LUCKNOW,81969,74514,DELHI-LUCKNOW,156483,All
2018,7,DELHI,LUCKNOW,74943,77549,DELHI-LUCKNOW,152492,All
2018,8,DELHI,LUCKNOW,77403,75827,DELHI-LUCKNOW,153230,All
2018,9,DELHI,LUCKNOW,70614,70109,DELHI-LUCKNOW,140723,All
2018,10,DELHI,LUCKNOW,80468,70381,DELHI-LUCKNOW,150849,All
2018,11,DELHI,LUCKNOW,71966,64568,DELHI-LUCKNOW,136534,All
2018,12,DELHI,LUCKNOW,72245,71051,DELHI-LUCKNOW,143296,All
2019,1,DELHI,LUCKNOW,67830,66310,DELHI-LUCKNOW,134140,All
2019,2,DELHI,LUCKNOW,71408,68372,DELHI-LUCKNOW,139780,All
2019,3,DELHI,LUCKNOW,66509,65314,DELHI-LUCKNOW,131823,All
2019,4,DELHI,LUCKNOW,68251,63298,DELHI-LUCKNOW,131549,All
2019,5,DELHI,LUCKNOW,74738,70288,DELHI-LUCKNOW,145026,All
2019,6,DELHI,LUCKNOW,73280,74252,DELHI-LUCKNOW,147532,All
2019,7,DELHI,LUCKNOW,73309,74518,DELHI-LUCKNOW,147827,All
2019,8,DELHI,LUCKNOW,80345,82003,DELHI-LUCKNOW,162348,All
2019,9,DELHI,LUCKNOW,79247,80072,DELHI-LUCKNOW,159319,All
2019,10,DELHI,LUCKNOW,93385,82304,DELHI-LUCKNOW,175689,All
2019,11,DELHI,LUCKNOW,85771,85194,DELHI-LUCKNOW,170965,All
2019,12,DELHI,LUCKNOW,76626,76377,DELHI-LUCKNOW,153003,All
2020,1,DELHI,LUCKNOW,72999,70681,DELHI-LUCKNOW,143680,All
2020,2,DELHI,LUCKNOW,84372,80187,DELHI-LUCKNOW,164559,All
2020,3,DELHI,LUCKNOW,49376,41337,DELHI-LUCKNOW,90713,All
2020,5,DELHI,LUCKNOW,4145,2493,DELHI-LUCKNOW,6638,All
2020,6,DELHI,LUCKNOW,17521,10390,DELHI-LUCKNOW,27911,All
2020,7,DELHI,LUCKNOW,13399,13784,DELHI-LUCKNOW,27183,All
2020,8,DELHI,LUCKNOW,16109,25921,DELHI-LUCKNOW,42030,All
2020,9,DELHI,LUCKNOW,18967,26091,DELHI-LUCKNOW,45058,All
2020,10,DELHI,LUCKNOW,32298,31393,DELHI-LUCKNOW,63691,All
2020,11,DELHI,LUCKNOW,41283,31255,DELHI-LUCKNOW,72538,All
2020,12,DELHI,LUCKNOW,38013,44361,DELHI-LUCKNOW,82374,All
2021,1,DELHI,LUCKNOW,36341,39038,DELHI-LUCKNOW,75379,All
2021,2,DELHI,LUCKNOW,35556,35988,DELHI-LUCKNOW,71544,All
2021,3,DELHI,LUCKNOW,40706,37332,DELHI-LUCKNOW,78038,All
2021,4,DELHI,LUCKNOW,35110,24924,DELHI-LUCKNOW,60034,All
2021,6,DELHI,LUCKNOW,19220,22352,DELHI-LUCKNOW,41572,All
2021,7,DELHI,LUCKNOW,28625,29818,DELHI-LUCKNOW,58443,All
2021,8,DELHI,LUCKNOW,36402,39248,DELHI-LUCKNOW,75650,All
2021,9,DELHI,LUCKNOW,36730,40676,DELHI-LUCKNOW,77406,All
2021,10,DELHI,LUCKNOW,50682,47406,DELHI-LUCKNOW,98088,All
2021,11,DELHI,LUCKNOW,60736,62246,DELHI-LUCKNOW,122982,All
2021,12,DELHI,LUCKNOW,53178,63661,DELHI-LUCKNOW,116839,All
2022,1,DELHI,LUCKNOW,29970,29187,DELHI-LUCKNOW,59157,All
2022,2,DELHI,LUCKNOW,35627,36579,DELHI-LUCKNOW,72206,All
2022,3,DELHI,LUCKNOW,47751,49970,DELHI-LUCKNOW,97721,All
2022,4,DELHI,LUCKNOW,48702,44656,DELHI-LUCKNOW,93358,All
2022,5,DELHI,LUCKNOW,46238,45318,DELHI-LUCKNOW,91556,All
2022,6,DELHI,LUCKNOW,43095,48931,DELHI-LUCKNOW,92026,All
2022,7,DELHI,LUCKNOW,41793,43841,DELHI-LUCKNOW,85634,All
2022,8,DELHI,LUCKNOW,49217,54186,DELHI-LUCKNOW,103403,All
2022,9,DELHI,LUCKNOW,54315,55941,DELHI-LUCKNOW,110256,All
2022,10,DELHI,LUCKNOW,65939,56081,DELHI-LUCKNOW,122020,All
2022,11,DELHI,LUCKNOW,64080,64144,DELHI-LUCKNOW,128224,All
2022,12,DELHI,LUCKNOW,67285,70011,DELHI-LUCKNOW,137296,All
2023,1,DELHI,LUCKNOW,61632,63673,DELHI-LUCKNOW,125305,All
2023,2,DELHI,LUCKNOW,64886,63968,DELHI-LUCKNOW,128854,All
2023,3,DELHI,LUCKNOW,61862,63348,DELHI-LUCKNOW,125210,All
2023,4,DELHI,LUCKNOW,63761,61325,DELHI-LUCKNOW,125086,All
2023,5,DELHI,LUCKNOW,66519,63540,DELHI-LUCKNOW,130059,All
2023,6,DELHI,LUCKNOW,61962,60782,DELHI-LUCKNOW,122744,All
2023,7,DELHI,LUCKNOW,57944,58815,DELHI-LUCKNOW,116759,All
2023,8,DELHI,LUCKNOW,63065,60274,DELHI-LUCKNOW,123339,All
2023,9,DELHI,LUCKNOW,60201,58957,DELHI-LUCKNOW,119158,All
2023,10,DELHI,LUCKNOW,63774,56036,DELHI-LUCKNOW,119810,All
2023,11,DELHI,LUCKNOW,67049,57883,DELHI-LUCKNOW,124932,All
2023,12,DELHI,LUCKNOW,69718,70203,DELHI-LUCKNOW,139921,All
2024,1,DELHI,LUCKNOW,65374,64617,DELHI-LUCKNOW,129991,All
2024,2,DELHI,LUCKNOW,66488,63670,DELHI-LUCKNOW,130158,All
2024,3,DELHI,LUCKNOW,67683,61845,DELHI-LUCKNOW,129528,All
2024,4,DELHI,LUCKNOW,62994,54113,DELHI-LUCKNOW,117107,All
2024,6,DELHI,LUCKNOW,68311,60352,DELHI-LUCKNOW,128663,All
2024,7,DELHI,LUCKNOW,61487,62671,DELHI-LUCKNOW,124158,All
2024,8,DELHI,LUCKNOW,60609,62645,DELHI-LUCKNOW,123254,All
2024,9,DELHI,LUCKNOW,56770,58292,DELHI-LUCKNOW,115062,All
2024,10,DELHI,LUCKNOW,64283,50978,DELHI-LUCKNOW,115261,All
2024,11,DELHI,LUCKNOW,62768,61879,DELHI-LUCKNOW,124647,All
2024,12,DELHI,LUCKNOW,63093,66509,DELHI-LUCKNOW,129602,All
2025,1,DELHI,LUCKNOW,62684,61073,DELHI-LUCKNOW,123757,All
2025,2,DELHI,LUCKNOW,58569,58841,DELHI-LUCKNOW,117410,All
2025,3,DELHI,LUCKNOW,49424,48411,DELHI-LUCKNOW,97835,All
2017,9,DELHI,LUDHIANA,900,1003,DELHI-LUDHIANA,1903,All
2017,10,DELHI,LUDHIANA,867,917,DELHI-LUDHIANA,1784,All
2017,11,DELHI,LUDHIANA,317,308,DELHI-LUDHIANA,625,All
2017,12,DELHI,LUDHIANA,622,604,DELHI-LUDHIANA,1226,All
2018,1,DELHI,LUDHIANA,483,483,DELHI-LUDHIANA,966,All
2018,2,DELHI,LUDHIANA,849,811,DELHI-LUDHIANA,1660,All
2018,3,DELHI,LUDHIANA,1005,768,DELHI-LUDHIANA,1773,All
2018,4,DELHI,LUDHIANA,784,571,DELHI-LUDHIANA,1355,All
2018,5,DELHI,LUDHIANA,746,468,DELHI-LUDHIANA,1214,All
2018,6,DELHI,LUDHIANA,630,381,DELHI-LUDHIANA,1011,All
2018,7,DELHI,LUDHIANA,693,545,DELHI-LUDHIANA,1238,All
2018,8,DELHI,LUDHIANA,915,840,DELHI-LUDHIANA,1755,All
2018,9,DELHI,LUDHIANA,966,858,DELHI-LUDHIANA,1824,All
2018,10,DELHI,LUDHIANA,727,754,DELHI-LUDHIANA,1481,All
2018,11,DELHI,LUDHIANA,1016,916,DELHI-LUDHIANA,1932,All
2018,12,DELHI,LUDHIANA,737,799,DELHI-LUDHIANA,1536,All
2019,1,DELHI,LUDHIANA,646,642,DELHI-LUDHIANA,1288,All
2019,2,DELHI,LUDHIANA,639,615,DELHI-LUDHIANA,1254,All
2019,3,DELHI,LUDHIANA,759,724,DELHI-LUDHIANA,1483,All
2019,4,DELHI,LUDHIANA,889,696,DELHI-LUDHIANA,1585,All
2019,5,DELHI,LUDHIANA,833,615,DELHI-LUDHIANA,1448,All
2019,6,DELHI,LUDHIANA,939,661,DELHI-LUDHIANA,1600,All
2019,7,DELHI,LUDHIANA,986,741,DELHI-LUDHIANA,1727,All
2019,8,DELHI,LUDHIANA,747,687,DELHI-LUDHIANA,1434,All
2019,9,DELHI,LUDHIANA,764,707,DELHI-LUDHIANA,1471,All
2019,10,DELHI,LUDHIANA,844,747,DELHI-LUDHIANA,1591,All
2019,11,DELHI,LUDHIANA,629,475,DELHI-LUDHIANA,1104,All
2019,12,DELHI,LUDHIANA,497,437,DELHI-LUDHIANA,934,All
2020,1,DELHI,LUDHIANA,580,521,DELHI-LUDHIANA,1101,All
2020,2,DELHI,LUDHIANA,811,724,DELHI-LUDHIANA,1535,All
2020,3,DELHI,LUDHIANA,429,385,DELHI-LUDHIANA,814,All
2020,5,DELHI,LUDHIANA,56,34,DELHI-LUDHIANA,90,All
2020,6,DELHI,LUDHIANA,537,208,DELHI-LUDHIANA,745,All
2020,7,DELHI,LUDHIANA,332,195,DELHI-LUDHIANA,527,All
2020,8,DELHI,LUDHIANA,407,294,DELHI-LUDHIANA,701,All
2020,9,DELHI,LUDHIANA,39,25,DELHI-LUDHIANA,64,All
2020,10,DELHI,LUDHIANA,194,173,DELHI-LUDHIANA,367,All
2020,11,DELHI,LUDHIANA,359,370,DELHI-LUDHIANA,729,All
2020,12,DELHI,LUDHIANA,668,687,DELHI-LUDHIANA,1355,All
2021,1,DELHI,LUDHIANA,271,302,DELHI-LUDHIANA,573,All
2021,2,DELHI,LUDHIANA,575,530,DELHI-LUDHIANA,1105,All
2021,3,DELHI,LUDHIANA,265,213,DELHI-LUDHIANA,478,All
2021,4,DELHI,LUDHIANA,111,72,DELHI-LUDHIANA,183,All
2015,10,DELHI,MADURAI,186,213,DELHI-MADURAI,399,All
2015,11,DELHI,MADURAI,797,826,DELHI-MADURAI,1623,All
2015,12,DELHI,MADURAI,859,651,DELHI-MADURAI,1510,All
2016,1,DELHI,MADURAI,865,921,DELHI-MADURAI,1786,All
2016,2,DELHI,MADURAI,803,707,DELHI-MADURAI,1510,All
2016,3,DELHI,MADURAI,831,791,DELHI-MADURAI,1622,All
2016,4,DELHI,MADURAI,603,596,DELHI-MADURAI,1199,All
2016,5,DELHI,MADURAI,445,429,DELHI-MADURAI,874,All
2016,6,DELHI,MADURAI,717,759,DELHI-MADURAI,1476,All
2016,7,DELHI,MADURAI,480,525,DELHI-MADURAI,1005,All
2016,8,DELHI,MADURAI,492,494,DELHI-MADURAI,986,All
2016,9,DELHI,MADURAI,427,462,DELHI-MADURAI,889,All
2016,10,DELHI,MADURAI,809,860,DELHI-MADURAI,1669,All
2016,11,DELHI,MADURAI,1111,1108,DELHI-MADURAI,2219,All
2016,12,DELHI,MADURAI,816,783,DELHI-MADURAI,1599,All
2017,1,DELHI,MADURAI,937,1150,DELHI-MADURAI,2087,All
2017,2,DELHI,MADURAI,1334,1552,DELHI-MADURAI,2886,All
2017,3,DELHI,MADURAI,2325,2189,DELHI-MADURAI,4514,All
2017,4,DELHI,MADURAI,1996,2440,DELHI-MADURAI,4436,All
2017,5,DELHI,MADURAI,2913,2051,DELHI-MADURAI,4964,All
2017,6,DELHI,MADURAI,3127,2647,DELHI-MADURAI,5774,All
2017,7,DELHI,MADURAI,2483,2261,DELHI-MADURAI,4744,All
2017,8,DELHI,MADURAI,2420,2579,DELHI-MADURAI,4999,All
2017,9,DELHI,MADURAI,2684,2691,DELHI-MADURAI,5375,All
2017,10,DELHI,MADURAI,4012,3754,DELHI-MADURAI,7766,All
2017,11,DELHI,MADURAI,4506,4585,DELHI-MADURAI,9091,All
2017,12,DELHI,MADURAI,5933,4273,DELHI-MADURAI,10206,All
2018,1,DELHI,MADURAI,5389,5641,DELHI-MADURAI,11030,All
2018,2,DELHI,MADURAI,4639,5043,DELHI-MADURAI,9682,All
2018,3,DELHI,MADURAI,5439,5334,DELHI-MADURAI,10773,All
2018,4,DELHI,MADURAI,4064,4274,DELHI-MADURAI,8338,All
2018,5,DELHI,MADURAI,5362,4276,DELHI-MADURAI,9638,All
2018,6,DELHI,MADURAI,5225,4890,DELHI-MADURAI,10115,All
2018,7,DELHI,MADURAI,4826,4428,DELHI-MADURAI,9254,All
2018,8,DELHI,MADURAI,5591,4545,DELHI-MADURAI,10136,All
2018,9,DELHI,MADURAI,4918,3972,DELHI-MADURAI,8890,All
2018,10,DELHI,MADURAI,3961,3470,DELHI-MADURAI,7431,All
2018,11,DELHI,MADURAI,2979,2935,DELHI-MADURAI,5914,All
2018,12,DELHI,MADURAI,3795,3231,DELHI-MADURAI,7026,All
2019,1,DELHI,MADURAI,3175,3883,DELHI-MADURAI,7058,All
2019,2,DELHI,MADURAI,3174,2905,DELHI-MADURAI,6079,All
2019,3,DELHI,MADURAI,3243,2716,DELHI-MADURAI,5959,All
2019,4,DELHI,MADURAI,2788,2942,DELHI-MADURAI,5730,All
2019,5,DELHI,MADURAI,2810,2277,DELHI-MADURAI,5087,All
2019,6,DELHI,MADURAI,2923,2925,DELHI-MADURAI,5848,All
2019,7,DELHI,MADURAI,2888,3025,DELHI-MADURAI,5913,All
2019,8,DELHI,MADURAI,2884,3017,DELHI-MADURAI,5901,All
2019,9,DELHI,MADURAI,2526,2307,DELHI-MADURAI,4833,All
2019,10,DELHI,MADURAI,2724,2550,DELHI-MADURAI,5274,All
2019,11,DELHI,MADURAI,3532,3127,DELHI-MADURAI,6659,All
2019,12,DELHI,MADURAI,4316,3474,DELHI-MADURAI,7790,All
2020,1,DELHI,MADURAI,3155,2915,DELHI-MADURAI,6070,All
2020,2,DELHI,MADURAI,3544,3688,DELHI-MADURAI,7232,All
2020,3,DELHI,MADURAI,2815,2537,DELHI-MADURAI,5352,All
2020,5,DELHI,MADURAI,131,107,DELHI-MADURAI,238,All
2020,8,DELHI,MADURAI,1100,827,DELHI-MADURAI,1927,All
2020,9,DELHI,MADURAI,3517,2748,DELHI-MADURAI,6265,All
2020,10,DELHI,MADURAI,5207,3735,DELHI-MADURAI,8942,All
2020,11,DELHI,MADURAI,5409,5388,DELHI-MADURAI,10797,All
2020,12,DELHI,MADURAI,6839,4820,DELHI-MADURAI,11659,All
2021,1,DELHI,MADURAI,5860,5323,DELHI-MADURAI,11183,All
2021,2,DELHI,MADURAI,4944,5302,DELHI-MADURAI,10246,All
2021,3,DELHI,MADURAI,3576,3877,DELHI-MADURAI,7453,All
2021,4,DELHI,MADURAI,0,1376,DELHI-MADURAI,1376,All
2021,7,DELHI,MADURAI,1619,1315,DELHI-MADURAI,2934,All
2021,8,DELHI,MADURAI,2523,2341,DELHI-MADURAI,4864,All
2021,9,DELHI,MADURAI,2068,2579,DELHI-MADURAI,4647,All
2021,10,DELHI,MADURAI,2122,2442,DELHI-MADURAI,4564,All
2021,11,DELHI,MADURAI,5903,6190,DELHI-MADURAI,12093,All
2021,12,DELHI,MADURAI,6548,6608,DELHI-MADURAI,13156,All
2022,1,DELHI,MADURAI,2384,2747,DELHI-MADURAI,5131,All
2022,3,DELHI,MADURAI,646,732,DELHI-MADURAI,1378,All
2022,4,DELHI,MADURAI,3836,3975,DELHI-MADURAI,7811,All
2022,5,DELHI,MADURAI,4591,4333,DELHI-MADURAI,8924,All
2022,6,DELHI,MADURAI,5330,5473,DELHI-MADURAI,10803,All
2022,7,DELHI,MADURAI,4960,5277,DELHI-MADURAI,10237,All
2022,8,DELHI,MADURAI,3323,3234,DELHI-MADURAI,6557,All
2022,9,DELHI,MADURAI,2937,3192,DELHI-MADURAI,6129,All
2022,10,DELHI,MADURAI,3746,3902,DELHI-MADURAI,7648,All
2022,11,DELHI,MADURAI,5216,4891,DELHI-MADURAI,10107,All
2022,12,DELHI,MADURAI,5704,4336,DELHI-MADURAI,10040,All
2023,1,DELHI,MADURAI,4930,5443,DELHI-MADURAI,10373,All
2023,2,DELHI,MADURAI,5181,5445,DELHI-MADURAI,10626,All
2023,3,DELHI,MADURAI,5847,5821,DELHI-MADURAI,11668,All
2023,4,DELHI,MADURAI,5548,5872,DELHI-MADURAI,11420,All
2023,5,DELHI,MADURAI,6571,5674,DELHI-MADURAI,12245,All
2023,6,DELHI,MADURAI,6250,5421,DELHI-MADURAI,11671,All
2023,7,DELHI,MADURAI,5745,5761,DELHI-MADURAI,11506,All
2023,8,DELHI,MADURAI,5835,6095,DELHI-MADURAI,11930,All
2023,9,DELHI,MADURAI,5910,5932,DELHI-MADURAI,11842,All
2023,10,DELHI,MADURAI,5915,6083,DELHI-MADURAI,11998,All
2023,11,DELHI,MADURAI,4992,4762,DELHI-MADURAI,9754,All
2023,12,DELHI,MADURAI,5540,5241,DELHI-MADURAI,10781,All
2024,1,DELHI,MADURAI,3907,3980,DELHI-MADURAI,7887,All
2024,2,DELHI,MADURAI,4810,4825,DELHI-MADURAI,9635,All
2024,3,DELHI,MADURAI,5124,4821,DELHI-MADURAI,9945,All
2024,4,DELHI,MADURAI,4979,4795,DELHI-MADURAI,9774,All
2024,6,DELHI,MADURAI,5063,4727,DELHI-MADURAI,9790,All
2024,7,DELHI,MADURAI,6062,5617,DELHI-MADURAI,11679,All
2024,8,DELHI,MADURAI,5448,5377,DELHI-MADURAI,10825,All
2024,9,DELHI,MADURAI,4490,4365,DELHI-MADURAI,8855,All
2024,10,DELHI,MADURAI,4951,4894,DELHI-MADURAI,9845,All
2024,11,DELHI,MADURAI,5864,5759,DELHI-MADURAI,11623,All
2024,12,DELHI,MADURAI,6389,6061,DELHI-MADURAI,12450,All
2025,1,DELHI,MADURAI,6453,6325,DELHI-MADURAI,12778,All
2025,2,DELHI,MADURAI,5932,6031,DELHI-MADURAI,11963,All
2025,3,DELHI,MADURAI,6279,5893,DELHI-MADURAI,12172,All
2015,4,DELHI,MANGALORE,1984,1054,DELHI-MANGALORE,3038,All
2015,5,DELHI,MANGALORE,2345,1171,DELHI-MANGALORE,3516,All
2015,6,DELHI,MANGALORE,2103,785,DELHI-MANGALORE,2888,All
2015,7,DELHI,MANGALORE,1778,649,DELHI-MANGALORE,2427,All
2015,8,DELHI,MANGALORE,1622,798,DELHI-MANGALORE,2420,All
2015,9,DELHI,MANGALORE,1111,679,DELHI-MANGALORE,1790,All
2015,10,DELHI,MANGALORE,979,802,DELHI-MANGALORE,1781,All
2015,11,DELHI,MANGALORE,799,1565,DELHI-MANGALORE,2364,All
2015,12,DELHI,MANGALORE,919,1395,DELHI-MANGALORE,2314,All
2016,1,DELHI,MANGALORE,834,1186,DELHI-MANGALORE,2020,All
2016,2,DELHI,MANGALORE,516,734,DELHI-MANGALORE,1250,All
2016,3,DELHI,MANGALORE,531,888,DELHI-MANGALORE,1419,All
2016,4,DELHI,MANGALORE,594,609,DELHI-MANGALORE,1203,All
2016,5,DELHI,MANGALORE,930,700,DELHI-MANGALORE,1630,All
2016,6,DELHI,MANGALORE,566,407,DELHI-MANGALORE,973,All
2016,7,DELHI,MANGALORE,914,447,DELHI-MANGALORE,1361,All
2016,8,DELHI,MANGALORE,737,697,DELHI-MANGALORE,1434,All
2016,9,DELHI,MANGALORE,626,827,DELHI-MANGALORE,1453,All
2016,10,DELHI,MANGALORE,406,484,DELHI-MANGALORE,890,All
2016,11,DELHI,MANGALORE,543,397,DELHI-MANGALORE,940,All
2016,12,DELHI,MANGALORE,437,529,DELHI-MANGALORE,966,All
2017,1,DELHI,MANGALORE,2151,2135,DELHI-MANGALORE,4286,All
2017,2,DELHI,MANGALORE,2825,2857,DELHI-MANGALORE,5682,All
2017,3,DELHI,MANGALORE,3128,2779,DELHI-MANGALORE,5907,All
2017,4,DELHI,MANGALORE,3506,3750,DELHI-MANGALORE,7256,All
2017,5,DELHI,MANGALORE,4624,3757,DELHI-MANGALORE,8381,All
2017,6,DELHI,MANGALORE,3763,3289,DELHI-MANGALORE,7052,All
2017,7,DELHI,MANGALORE,3774,3205,DELHI-MANGALORE,6979,All
2017,8,DELHI,MANGALORE,3722,3594,DELHI-MANGALORE,7316,All
2017,9,DELHI,MANGALORE,2958,3754,DELHI-MANGALORE,6712,All
2017,10,DELHI,MANGALORE,3643,3493,DELHI-MANGALORE,7136,All
2017,11,DELHI,MANGALORE,2999,2764,DELHI-MANGALORE,5763,All
2017,12,DELHI,MANGALORE,4331,3561,DELHI-MANGALORE,7892,All
2018,1,DELHI,MANGALORE,3739,4164,DELHI-MANGALORE,7903,All
2018,2,DELHI,MANGALORE,3343,3582,DELHI-MANGALORE,6925,All
2018,3,DELHI,MANGALORE,3515,3347,DELHI-MANGALORE,6862,All
2018,4,DELHI,MANGALORE,3774,4022,DELHI-MANGALORE,7796,All
2018,5,DELHI,MANGALORE,4353,3318,DELHI-MANGALORE,7671,All
2018,6,DELHI,MANGALORE,3255,2320,DELHI-MANGALORE,5575,All
2018,7,DELHI,MANGALORE,3632,2606,DELHI-MANGALORE,6238,All
2018,8,DELHI,MANGALORE,4351,4116,DELHI-MANGALORE,8467,All
2018,9,DELHI,MANGALORE,3704,3949,DELHI-MANGALORE,7653,All
2018,10,DELHI,MANGALORE,3642,3488,DELHI-MANGALORE,7130,All
2018,11,DELHI,MANGALORE,4255,3960,DELHI-MANGALORE,8215,All
2018,12,DELHI,MANGALORE,4023,3659,DELHI-MANGALORE,7682,All
2019,1,DELHI,MANGALORE,2935,2718,DELHI-MANGALORE,5653,All
2019,2,DELHI,MANGALORE,605,408,DELHI-MANGALORE,1013,All
2019,3,DELHI,MANGALORE,1077,877,DELHI-MANGALORE,1954,All
2019,4,DELHI,MANGALORE,85,0,DELHI-MANGALORE,85,All
2019,5,DELHI,MANGALORE,131,0,DELHI-MANGALORE,131,All
2019,6,DELHI,MANGALORE,262,0,DELHI-MANGALORE,262,All
2019,7,DELHI,MANGALORE,297,0,DELHI-MANGALORE,297,All
2019,8,DELHI,MANGALORE,2810,3136,DELHI-MANGALORE,5946,All
2019,9,DELHI,MANGALORE,1779,2587,DELHI-MANGALORE,4366,All
2019,10,DELHI,MANGALORE,2881,2820,DELHI-MANGALORE,5701,All
2019,11,DELHI,MANGALORE,6663,5927,DELHI-MANGALORE,12590,All
2019,12,DELHI,MANGALORE,8406,7052,DELHI-MANGALORE,15458,All
2020,1,DELHI,MANGALORE,6452,6637,DELHI-MANGALORE,13089,All
2020,2,DELHI,MANGALORE,1635,1854,DELHI-MANGALORE,3489,All
2020,9,DELHI,MANGALORE,232,163,DELHI-MANGALORE,395,All
2020,10,DELHI,MANGALORE,350,322,DELHI-MANGALORE,672,All
2020,11,DELHI,MANGALORE,2078,1562,DELHI-MANGALORE,3640,All
2020,12,DELHI,MANGALORE,1870,1525,DELHI-MANGALORE,3395,All
2021,1,DELHI,MANGALORE,2792,2812,DELHI-MANGALORE,5604,All
2021,2,DELHI,MANGALORE,2515,2527,DELHI-MANGALORE,5042,All
2021,3,DELHI,MANGALORE,1380,2219,DELHI-MANGALORE,3599,All
2022,3,DELHI,MANGALORE,28,51,DELHI-MANGALORE,79,All
2022,4,DELHI,MANGALORE,480,386,DELHI-MANGALORE,866,All
2022,5,DELHI,MANGALORE,498,467,DELHI-MANGALORE,965,All
2022,6,DELHI,MANGALORE,697,981,DELHI-MANGALORE,1678,All
2022,7,DELHI,MANGALORE,2584,2596,DELHI-MANGALORE,5180,All
2022,8,DELHI,MANGALORE,2215,1826,DELHI-MANGALORE,4041,All
2022,9,DELHI,MANGALORE,1582,1705,DELHI-MANGALORE,3287,All
2022,10,DELHI,MANGALORE,3336,3463,DELHI-MANGALORE,6799,All
2022,11,DELHI,MANGALORE,1751,1644,DELHI-MANGALORE,3395,All
2022,12,DELHI,MANGALORE,3031,2801,DELHI-MANGALORE,5832,All
2023,1,DELHI,MANGALORE,3062,3149,DELHI-MANGALORE,6211,All
2023,2,DELHI,MANGALORE,4592,4726,DELHI-MANGALORE,9318,All
2023,3,DELHI,MANGALORE,5290,5105,DELHI-MANGALORE,10395,All
2023,4,DELHI,MANGALORE,4461,4603,DELHI-MANGALORE,9064,All
2023,5,DELHI,MANGALORE,5276,4760,DELHI-MANGALORE,10036,All
2023,6,DELHI,MANGALORE,4957,4187,DELHI-MANGALORE,9144,All
2023,7,DELHI,MANGALORE,4604,4507,DELHI-MANGALORE,9111,All
2023,8,DELHI,MANGALORE,4577,4985,DELHI-MANGALORE,9562,All
2023,9,DELHI,MANGALORE,4229,4529,DELHI-MANGALORE,8758,All
2023,10,DELHI,MANGALORE,5153,5331,DELHI-MANGALORE,10484,All
2023,11,DELHI,MANGALORE,5156,5166,DELHI-MANGALORE,10322,All
2023,12,DELHI,MANGALORE,5469,5291,DELHI-MANGALORE,10760,All
2024,1,DELHI,MANGALORE,4985,5212,DELHI-MANGALORE,10197,All
2024,2,DELHI,MANGALORE,4387,4866,DELHI-MANGALORE,9253,All
2024,3,DELHI,MANGALORE,5038,5519,DELHI-MANGALORE,10557,All
2024,4,DELHI,MANGALORE,5787,5833,DELHI-MANGALORE,11620,All
2024,6,DELHI,MANGALORE,6012,5448,DELHI-MANGALORE,11460,All
2024,7,DELHI,MANGALORE,5907,5533,DELHI-MANGALORE,11440,All
2024,8,DELHI,MANGALORE,5849,5722,DELHI-MANGALORE,11571,All
2024,9,DELHI,MANGALORE,5091,5125,DELHI-MANGALORE,10216,All
2024,10,DELHI,MANGALORE,4725,5200,DELHI-MANGALORE,9925,All
2024,11,DELHI,MANGALORE,5229,5198,DELHI-MANGALORE,10427,All
2024,12,DELHI,MANGALORE,5624,5233,DELHI-MANGALORE,10857,All
2025,1,DELHI,MANGALORE,5280,5379,DELHI-MANGALORE,10659,All
2025,2,DELHI,MANGALORE,10023,10257,DELHI-MANGALORE,20280,All
2025,3,DELHI,MANGALORE,8973,8600,DELHI-MANGALORE,17573,All
2019,5,DELHI,MUMBAI,295629,291304,DELHI-MUMBAI,586933,All
2019,6,DELHI,MUMBAI,298329,275226,DELHI-MUMBAI,573555,All
2019,7,DELHI,MUMBAI,284412,285976,DELHI-MUMBAI,570388,All
2019,8,DELHI,MUMBAI,294305,299669,DELHI-MUMBAI,593974,All
2019,9,DELHI,MUMBAI,291390,298080,DELHI-MUMBAI,589470,All
2019,10,DELHI,MUMBAI,265724,311493,DELHI-MUMBAI,577217,All
2019,11,DELHI,MUMBAI,330592,312511,DELHI-MUMBAI,643103,All
2019,12,DELHI,MUMBAI,329523,308509,DELHI-MUMBAI,638032,All
2020,1,DELHI,MUMBAI,300279,310952,DELHI-MUMBAI,611231,All
2020,2,DELHI,MUMBAI,300263,316755,DELHI-MUMBAI,617018,All
2020,3,DELHI,MUMBAI,159694,162116,DELHI-MUMBAI,321810,All
2020,4,DELHI,MUMBAI,0,0,DELHI-MUMBAI,0,All
2020,5,DELHI,MUMBAI,1833,7504,DELHI-MUMBAI,9337,All
2020,6,DELHI,MUMBAI,16666,25098,DELHI-MUMBAI,41764,All
2020,7,DELHI,MUMBAI,19535,24770,DELHI-MUMBAI,44305,All
2020,8,DELHI,MUMBAI,47611,33986,DELHI-MUMBAI,81597,All
2020,9,DELHI,MUMBAI,68570,46043,DELHI-MUMBAI,114613,All
2020,10,DELHI,MUMBAI,78866,70394,DELHI-MUMBAI,149260,All
2020,11,DELHI,MUMBAI,82502,90314,DELHI-MUMBAI,172816,All
2020,12,DELHI,MUMBAI,84095,69612,DELHI-MUMBAI,153707,All
2021,1,DELHI,MUMBAI,101188,102366,DELHI-MUMBAI,203554,All
2021,2,DELHI,MUMBAI,114288,124450,DELHI-MUMBAI,238738,All
2021,3,DELHI,MUMBAI,104952,115900,DELHI-MUMBAI,220852,All
2021,4,DELHI,MUMBAI,55256,77619,DELHI-MUMBAI,132875,All
2021,6,DELHI,MUMBAI,58959,53255,DELHI-MUMBAI,112214,All
2021,7,DELHI,MUMBAI,89662,86293,DELHI-MUMBAI,175955,All
2021,8,DELHI,MUMBAI,124739,117300,DELHI-MUMBAI,242039,All
2021,9,DELHI,MUMBAI,130155,126438,DELHI-MUMBAI,256593,All
2021,10,DELHI,MUMBAI,173611,188404,DELHI-MUMBAI,362015,All
2021,11,DELHI,MUMBAI,226760,218697,DELHI-MUMBAI,445457,All
2021,12,DELHI,MUMBAI,230602,203917,DELHI-MUMBAI,434519,All
2022,1,DELHI,MUMBAI,104898,106462,DELHI-MUMBAI,211360,All
2022,2,DELHI,MUMBAI,162764,166458,DELHI-MUMBAI,329222,All
2022,3,DELHI,MUMBAI,226538,223097,DELHI-MUMBAI,449635,All
2022,4,DELHI,MUMBAI,214247,228842,DELHI-MUMBAI,443089,All
2022,5,DELHI,MUMBAI,257349,254051,DELHI-MUMBAI,511400,All
2022,6,DELHI,MUMBAI,220435,184662,DELHI-MUMBAI,405097,All
2022,7,DELHI,MUMBAI,188988,184716,DELHI-MUMBAI,373704,All
2022,8,DELHI,MUMBAI,213319,203888,DELHI-MUMBAI,417207,All
2022,9,DELHI,MUMBAI,216928,221065,DELHI-MUMBAI,437993,All
2022,10,DELHI,MUMBAI,208688,243264,DELHI-MUMBAI,451952,All
2022,11,DELHI,MUMBAI,259241,234757,DELHI-MUMBAI,493998,All
2022,12,DELHI,MUMBAI,276687,254987,DELHI-MUMBAI,531674,All
2023,11,DELHI,MUMBAI,254129,276279,DELHI-MUMBAI,530408,All
2023,12,DELHI,MUMBAI,308682,284574,DELHI-MUMBAI,593256,All
2024,1,DELHI,MUMBAI,284143,289788,DELHI-MUMBAI,573931,All
2024,2,DELHI,MUMBAI,280016,293493,DELHI-MUMBAI,573509,All
2024,3,DELHI,MUMBAI,290453,288891,DELHI-MUMBAI,579344,All
2024,4,DELHI,MUMBAI,276200,302589,DELHI-MUMBAI,578789,All
2024,6,DELHI,MUMBAI,290790,262604,DELHI-MUMBAI,553394,All
2024,7,DELHI,MUMBAI,277921,269329,DELHI-MUMBAI,547250,All
2024,8,DELHI,MUMBAI,290187,290300,DELHI-MUMBAI,580487,All
2024,9,DELHI,MUMBAI,288534,292814,DELHI-MUMBAI,581348,All
2024,10,DELHI,MUMBAI,261087,298125,DELHI-MUMBAI,559212,All
2024,11,DELHI,MUMBAI,296267,283790,DELHI-MUMBAI,580057,All
2024,12,DELHI,MUMBAI,295226,271126,DELHI-MUMBAI,566352,All
2025,1,DELHI,MUMBAI,279457,282359,DELHI-MUMBAI,561816,All
2025,2,DELHI,MUMBAI,271320,283669,DELHI-MUMBAI,554989,All
2025,3,DELHI,MUMBAI,290413,285382,DELHI-MUMBAI,575795,All
2015,4,DELHI,NAGPUR,9873,11583,DELHI-NAGPUR,21456,All
2015,5,DELHI,NAGPUR,13946,14461,DELHI-NAGPUR,28407,All
2015,6,DELHI,NAGPUR,15204,12886,DELHI-NAGPUR,28090,All
2015,7,DELHI,NAGPUR,11753,11222,DELHI-NAGPUR,22975,All
2015,8,DELHI,NAGPUR,10401,10675,DELHI-NAGPUR,21076,All
2015,9,DELHI,NAGPUR,10442,10963,DELHI-NAGPUR,21405,All
2015,10,DELHI,NAGPUR,14018,17115,DELHI-NAGPUR,31133,All
2015,11,DELHI,NAGPUR,13996,14537,DELHI-NAGPUR,28533,All
2015,12,DELHI,NAGPUR,16298,15073,DELHI-NAGPUR,31371,All
2016,1,DELHI,NAGPUR,12632,13507,DELHI-NAGPUR,26139,All
2016,2,DELHI,NAGPUR,12633,13240,DELHI-NAGPUR,25873,All
2016,3,DELHI,NAGPUR,14691,14847,DELHI-NAGPUR,29538,All
2016,4,DELHI,NAGPUR,14847,16150,DELHI-NAGPUR,30997,All
2016,5,DELHI,NAGPUR,18010,18670,DELHI-NAGPUR,36680,All
2016,6,DELHI,NAGPUR,17145,15131,DELHI-NAGPUR,32276,All
2016,7,DELHI,NAGPUR,15598,16466,DELHI-NAGPUR,32064,All
2016,8,DELHI,NAGPUR,15121,16130,DELHI-NAGPUR,31251,All
2016,9,DELHI,NAGPUR,14847,16007,DELHI-NAGPUR,30854,All
2016,10,DELHI,NAGPUR,18063,18885,DELHI-NAGPUR,36948,All
2016,11,DELHI,NAGPUR,22362,23554,DELHI-NAGPUR,45916,All
2016,12,DELHI,NAGPUR,23550,22444,DELHI-NAGPUR,45994,All
2017,1,DELHI,NAGPUR,20778,22273,DELHI-NAGPUR,43051,All
2017,2,DELHI,NAGPUR,18729,18311,DELHI-NAGPUR,37040,All
2017,3,DELHI,NAGPUR,18769,17919,DELHI-NAGPUR,36688,All
2017,4,DELHI,NAGPUR,17762,18549,DELHI-NAGPUR,36311,All
2017,5,DELHI,NAGPUR,23218,24946,DELHI-NAGPUR,48164,All
2017,6,DELHI,NAGPUR,23342,21898,DELHI-NAGPUR,45240,All
2017,7,DELHI,NAGPUR,19283,21199,DELHI-NAGPUR,40482,All
2017,8,DELHI,NAGPUR,19806,20139,DELHI-NAGPUR,39945,All
2017,9,DELHI,NAGPUR,17636,18423,DELHI-NAGPUR,36059,All
2017,10,DELHI,NAGPUR,23346,23730,DELHI-NAGPUR,47076,All
2017,11,DELHI,NAGPUR,24379,24385,DELHI-NAGPUR,48764,All
2017,12,DELHI,NAGPUR,28586,27935,DELHI-NAGPUR,56521,All
2018,1,DELHI,NAGPUR,27710,28013,DELHI-NAGPUR,55723,All
2018,2,DELHI,NAGPUR,24598,24530,DELHI-NAGPUR,49128,All
2018,3,DELHI,NAGPUR,26786,26273,DELHI-NAGPUR,53059,All
2018,4,DELHI,NAGPUR,27695,28277,DELHI-NAGPUR,55972,All
2018,5,DELHI,NAGPUR,27959,28203,DELHI-NAGPUR,56162,All
2018,6,DELHI,NAGPUR,26928,24565,DELHI-NAGPUR,51493,All
2018,7,DELHI,NAGPUR,26547,25365,DELHI-NAGPUR,51912,All
2018,8,DELHI,NAGPUR,23612,23275,DELHI-NAGPUR,46887,All
2018,9,DELHI,NAGPUR,22908,23365,DELHI-NAGPUR,46273,All
2018,10,DELHI,NAGPUR,25350,25612,DELHI-NAGPUR,50962,All
2018,11,DELHI,NAGPUR,25411,22946,DELHI-NAGPUR,48357,All
2018,12,DELHI,NAGPUR,35141,31367,DELHI-NAGPUR,66508,All
2019,1,DELHI,NAGPUR,32681,34290,DELHI-NAGPUR,66971,All
2019,2,DELHI,NAGPUR,24160,23955,DELHI-NAGPUR,48115,All
2019,3,DELHI,NAGPUR,20758,19658,DELHI-NAGPUR,40416,All
2019,4,DELHI,NAGPUR,19414,20484,DELHI-NAGPUR,39898,All
2019,5,DELHI,NAGPUR,32005,32983,DELHI-NAGPUR,64988,All
2019,6,DELHI,NAGPUR,35287,33533,DELHI-NAGPUR,68820,All
2019,7,DELHI,NAGPUR,31890,31880,DELHI-NAGPUR,63770,All
2019,8,DELHI,NAGPUR,30664,31067,DELHI-NAGPUR,61731,All
2019,9,DELHI,NAGPUR,32781,33219,DELHI-NAGPUR,66000,All
2019,10,DELHI,NAGPUR,34346,34968,DELHI-NAGPUR,69314,All
2019,11,DELHI,NAGPUR,35884,34762,DELHI-NAGPUR,70646,All
2019,12,DELHI,NAGPUR,34414,33012,DELHI-NAGPUR,67426,All
2020,1,DELHI,NAGPUR,29633,31149,DELHI-NAGPUR,60782,All
2020,2,DELHI,NAGPUR,29292,30845,DELHI-NAGPUR,60137,All
2020,3,DELHI,NAGPUR,18266,16629,DELHI-NAGPUR,34895,All
2020,5,DELHI,NAGPUR,596,544,DELHI-NAGPUR,1140,All
2020,6,DELHI,NAGPUR,4522,3443,DELHI-NAGPUR,7965,All
2020,7,DELHI,NAGPUR,3600,3870,DELHI-NAGPUR,7470,All
2020,8,DELHI,NAGPUR,6158,5819,DELHI-NAGPUR,11977,All
2020,9,DELHI,NAGPUR,7787,7808,DELHI-NAGPUR,15595,All
2020,10,DELHI,NAGPUR,12568,12035,DELHI-NAGPUR,24603,All
2020,11,DELHI,NAGPUR,15029,14573,DELHI-NAGPUR,29602,All
2020,12,DELHI,NAGPUR,16197,15362,DELHI-NAGPUR,31559,All
2021,1,DELHI,NAGPUR,14856,16533,DELHI-NAGPUR,31389,All
2021,2,DELHI,NAGPUR,15413,16176,DELHI-NAGPUR,31589,All
2021,3,DELHI,NAGPUR,11497,12806,DELHI-NAGPUR,24303,All
2021,4,DELHI,NAGPUR,8057,8581,DELHI-NAGPUR,16638,All
2021,6,DELHI,NAGPUR,9244,8981,DELHI-NAGPUR,18225,All
2021,7,DELHI,NAGPUR,12278,14514,DELHI-NAGPUR,26792,All
2021,8,DELHI,NAGPUR,15601,15816,DELHI-NAGPUR,31417,All
2021,9,DELHI,NAGPUR,15138,16681,DELHI-NAGPUR,31819,All
2021,10,DELHI,NAGPUR,19108,18755,DELHI-NAGPUR,37863,All
2021,11,DELHI,NAGPUR,20136,20693,DELHI-NAGPUR,40829,All
2021,12,DELHI,NAGPUR,28483,26664,DELHI-NAGPUR,55147,All
2022,1,DELHI,NAGPUR,13128,14347,DELHI-NAGPUR,27475,All
2022,2,DELHI,NAGPUR,15413,18004,DELHI-NAGPUR,33417,All
2022,3,DELHI,NAGPUR,20088,21622,DELHI-NAGPUR,41710,All
2022,4,DELHI,NAGPUR,21421,23163,DELHI-NAGPUR,44584,All
2022,5,DELHI,NAGPUR,26300,26836,DELHI-NAGPUR,53136,All
2022,6,DELHI,NAGPUR,26140,21917,DELHI-NAGPUR,48057,All
2022,7,DELHI,NAGPUR,17881,17901,DELHI-NAGPUR,35782,All
2022,8,DELHI,NAGPUR,19821,19341,DELHI-NAGPUR,39162,All
2022,9,DELHI,NAGPUR,17402,18814,DELHI-NAGPUR,36216,All
2022,10,DELHI,NAGPUR,14862,15582,DELHI-NAGPUR,30444,All
2022,11,DELHI,NAGPUR,21950,20269,DELHI-NAGPUR,42219,All
2022,12,DELHI,NAGPUR,25156,22842,DELHI-NAGPUR,47998,All
2023,1,DELHI,NAGPUR,22618,25123,DELHI-NAGPUR,47741,All
2023,2,DELHI,NAGPUR,24611,26448,DELHI-NAGPUR,51059,All
2023,3,DELHI,NAGPUR,26271,26512,DELHI-NAGPUR,52783,All
2023,4,DELHI,NAGPUR,22241,24906,DELHI-NAGPUR,47147,All
2023,5,DELHI,NAGPUR,21694,20643,DELHI-NAGPUR,42337,All
2023,6,DELHI,NAGPUR,19369,17878,DELHI-NAGPUR,37247,All
2023,7,DELHI,NAGPUR,21184,20835,DELHI-NAGPUR,42019,All
2023,8,DELHI,NAGPUR,22482,22328,DELHI-NAGPUR,44810,All
2023,9,DELHI,NAGPUR,19772,20520,DELHI-NAGPUR,40292,All
2023,10,DELHI,NAGPUR,20034,21062,DELHI-NAGPUR,41096,All
2023,11,DELHI,NAGPUR,21533,21473,DELHI-NAGPUR,43006,All
2023,12,DELHI,NAGPUR,28188,25343,DELHI-NAGPUR,53531,All
2024,1,DELHI,NAGPUR,22875,24507,DELHI-NAGPUR,47382,All
2024,2,DELHI,NAGPUR,22792,23175,DELHI-NAGPUR,45967,All
2024,3,DELHI,NAGPUR,24178,24048,DELHI-NAGPUR,48226,All
2024,4,DELHI,NAGPUR,23944,25116,DELHI-NAGPUR,49060,All
2024,6,DELHI,NAGPUR,25576,22222,DELHI-NAGPUR,47798,All
2024,7,DELHI,NAGPUR,23166,22695,DELHI-NAGPUR,45861,All
2024,8,DELHI,NAGPUR,24813,24660,DELHI-NAGPUR,49473,All
2024,9,DELHI,NAGPUR,27515,28316,DELHI-NAGPUR,55831,All
2024,10,DELHI,NAGPUR,29249,28685,DELHI-NAGPUR,57934,All
2024,11,DELHI,NAGPUR,32759,31491,DELHI-NAGPUR,64250,All
2024,12,DELHI,NAGPUR,35176,30796,DELHI-NAGPUR,65972,All
2025,1,DELHI,NAGPUR,29134,30007,DELHI-NAGPUR,59141,All
2025,2,DELHI,NAGPUR,29570,31388,DELHI-NAGPUR,60958,All
2025,3,DELHI,NAGPUR,30548,29359,DELHI-NAGPUR,59907,All
2018,11,DELHI,NANDED,448,438,DELHI-NANDED,886,All
2018,12,DELHI,NANDED,993,902,DELHI-NANDED,1895,All
2019,1,DELHI,NANDED,804,793,DELHI-NANDED,1597,All
2019,2,DELHI,NANDED,808,749,DELHI-NANDED,1557,All
2019,3,DELHI,NANDED,815,798,DELHI-NANDED,1613,All
2019,4,DELHI,NANDED,757,733,DELHI-NANDED,1490,All
2019,5,DELHI,NANDED,757,661,DELHI-NANDED,1418,All
2019,6,DELHI,NANDED,1264,959,DELHI-NANDED,2223,All
2019,7,DELHI,NANDED,926,946,DELHI-NANDED,1872,All
2019,8,DELHI,NANDED,1005,980,DELHI-NANDED,1985,All
2019,9,DELHI,NANDED,1027,892,DELHI-NANDED,1919,All
2019,10,DELHI,NANDED,931,900,DELHI-NANDED,1831,All
2019,11,DELHI,NANDED,937,771,DELHI-NANDED,1708,All
2019,12,DELHI,NANDED,958,839,DELHI-NANDED,1797,All
2020,1,DELHI,NANDED,1192,1135,DELHI-NANDED,2327,All
2020,2,DELHI,NANDED,1137,1205,DELHI-NANDED,2342,All
2020,3,DELHI,NANDED,665,600,DELHI-NANDED,1265,All
2020,12,DELHI,NANDED,121,85,DELHI-NANDED,206,All
2021,1,DELHI,NANDED,317,379,DELHI-NANDED,696,All
2021,2,DELHI,NANDED,378,446,DELHI-NANDED,824,All
2021,3,DELHI,NANDED,478,418,DELHI-NANDED,896,All
2021,4,DELHI,NANDED,197,138,DELHI-NANDED,335,All
2021,8,DELHI,NANDED,384,315,DELHI-NANDED,699,All
2021,9,DELHI,NANDED,220,212,DELHI-NANDED,432,All
2021,10,DELHI,NANDED,400,367,DELHI-NANDED,767,All
2018,6,DELHI,NASIK,897,881,DELHI-NASIK,1778,All
2018,7,DELHI,NASIK,1487,1508,DELHI-NASIK,2995,All
2018,8,DELHI,NASIK,1805,1731,DELHI-NASIK,3536,All
2018,9,DELHI,NASIK,1591,1469,DELHI-NASIK,3060,All
2018,10,DELHI,NASIK,1749,1809,DELHI-NASIK,3558,All
2018,11,DELHI,NASIK,1742,1525,DELHI-NASIK,3267,All
2018,12,DELHI,NASIK,1849,1684,DELHI-NASIK,3533,All
2019,1,DELHI,NASIK,1777,1685,DELHI-NASIK,3462,All
2019,2,DELHI,NASIK,1721,1739,DELHI-NASIK,3460,All
2019,3,DELHI,NASIK,1555,1490,DELHI-NASIK,3045,All
2019,4,DELHI,NASIK,513,497,DELHI-NASIK,1010,All
2020,11,DELHI,NASIK,291,230,DELHI-NASIK,521,All
2020,12,DELHI,NASIK,1890,1702,DELHI-NASIK,3592,All
2021,1,DELHI,NASIK,1603,1878,DELHI-NASIK,3481,All
2021,2,DELHI,NASIK,1776,1939,DELHI-NASIK,3715,All
2021,3,DELHI,NASIK,1172,1141,DELHI-NASIK,2313,All
2021,4,DELHI,NASIK,114,134,DELHI-NASIK,248,All
2021,7,DELHI,NASIK,477,496,DELHI-NASIK,973,All
2021,8,DELHI,NASIK,796,829,DELHI-NASIK,1625,All
2021,9,DELHI,NASIK,736,822,DELHI-NASIK,1558,All
2021,10,DELHI,NASIK,1077,950,DELHI-NASIK,2027,All
2021,11,DELHI,NASIK,383,523,DELHI-NASIK,906,All
2021,12,DELHI,NASIK,410,515,DELHI-NASIK,925,All
2022,1,DELHI,NASIK,312,370,DELHI-NASIK,682,All
2022,2,DELHI,NASIK,332,366,DELHI-NASIK,698,All
2022,3,DELHI,NASIK,468,445,DELHI-NASIK,913,All
2022,4,DELHI,NASIK,383,523,DELHI-NASIK,906,All
2022,5,DELHI,NASIK,594,678,DELHI-NASIK,1272,All
2022,6,DELHI,NASIK,383,523,DELHI-NASIK,906,All
2022,7,DELHI,NASIK,332,366,DELHI-NASIK,698,All
2022,8,DELHI,NASIK,3389,3364,DELHI-NASIK,6753,All
2022,9,DELHI,NASIK,2700,3154,DELHI-NASIK,5854,All
2022,10,DELHI,NASIK,3971,4531,DELHI-NASIK,8502,All
2022,11,DELHI,NASIK,1942,1733,DELHI-NASIK,3675,All
2022,12,DELHI,NASIK,4976,4231,DELHI-NASIK,9207,All
2023,1,DELHI,NASIK,4723,4760,DELHI-NASIK,9483,All
2023,2,DELHI,NASIK,4650,4903,DELHI-NASIK,9553,All
2023,3,DELHI,NASIK,2584,2680,DELHI-NASIK,5264,All
2023,4,DELHI,NASIK,2364,2412,DELHI-NASIK,4776,All
2023,5,DELHI,NASIK,1250,1247,DELHI-NASIK,2497,All
2023,6,DELHI,NASIK,0,207,DELHI-NASIK,207,All
2023,7,DELHI,NASIK,158,0,DELHI-NASIK,158,All
2023,10,DELHI,NASIK,172,159,DELHI-NASIK,331,All
2024,6,DELHI,NASIK,5041,4762,DELHI-NASIK,9803,All
2024,7,DELHI,NASIK,4413,4618,DELHI-NASIK,9031,All
2024,8,DELHI,NASIK,4561,4894,DELHI-NASIK,9455,All
2024,9,DELHI,NASIK,4415,5055,DELHI-NASIK,9470,All
2024,10,DELHI,NASIK,4950,5171,DELHI-NASIK,10121,All
2024,11,DELHI,NASIK,5011,5099,DELHI-NASIK,10110,All
2024,12,DELHI,NASIK,4498,4322,DELHI-NASIK,8820,All
2025,1,DELHI,NASIK,4341,4611,DELHI-NASIK,8952,All
2025,2,DELHI,NASIK,4712,4836,DELHI-NASIK,9548,All
2025,3,DELHI,NASIK,5300,5360,DELHI-NASIK,10660,All
2021,1,DELHI,PAKYONG,249,186,DELHI-PAKYONG,435,All
2021,2,DELHI,PAKYONG,1204,1029,DELHI-PAKYONG,2233,All
2021,3,DELHI,PAKYONG,2015,1603,DELHI-PAKYONG,3618,All
2021,4,DELHI,PAKYONG,1474,1229,DELHI-PAKYONG,2703,All
2021,6,DELHI,PAKYONG,253,311,DELHI-PAKYONG,564,All
2021,7,DELHI,PAKYONG,92,84,DELHI-PAKYONG,176,All
2021,8,DELHI,PAKYONG,166,159,DELHI-PAKYONG,325,All
2021,9,DELHI,PAKYONG,452,347,DELHI-PAKYONG,799,All
2021,10,DELHI,PAKYONG,781,551,DELHI-PAKYONG,1332,All
2021,11,DELHI,PAKYONG,2008,1598,DELHI-PAKYONG,3606,All
2021,12,DELHI,PAKYONG,2315,1895,DELHI-PAKYONG,4210,All
2022,1,DELHI,PAKYONG,1472,1366,DELHI-PAKYONG,2838,All
2022,2,DELHI,PAKYONG,1728,1428,DELHI-PAKYONG,3156,All
2022,3,DELHI,PAKYONG,2081,1713,DELHI-PAKYONG,3794,All
2022,4,DELHI,PAKYONG,1335,1135,DELHI-PAKYONG,2470,All
2022,5,DELHI,PAKYONG,1159,1074,DELHI-PAKYONG,2233,All
2022,6,DELHI,PAKYONG,140,102,DELHI-PAKYONG,242,All
2022,8,DELHI,PAKYONG,709,613,DELHI-PAKYONG,1322,All
2022,9,DELHI,PAKYONG,723,520,DELHI-PAKYONG,1243,All
2022,10,DELHI,PAKYONG,1400,1250,DELHI-PAKYONG,2650,All
2023,3,DELHI,PAKYONG,294,220,DELHI-PAKYONG,514,All
2023,4,DELHI,PAKYONG,1551,1522,DELHI-PAKYONG,3073,All
2023,5,DELHI,PAKYONG,1764,1627,DELHI-PAKYONG,3391,All
2023,6,DELHI,PAKYONG,791,618,DELHI-PAKYONG,1409,All
2023,9,DELHI,PAKYONG,937,753,DELHI-PAKYONG,1690,All
2023,10,DELHI,PAKYONG,85,65,DELHI-PAKYONG,150,All
2024,3,DELHI,PAKYONG,67,74,DELHI-PAKYONG,141,All
2024,4,DELHI,PAKYONG,1155,880,DELHI-PAKYONG,2035,All
2024,6,DELHI,PAKYONG,444,360,DELHI-PAKYONG,804,All
2015,4,DELHI,PANTNAGAR,392,388,DELHI-PANTNAGAR,780,All
2015,5,DELHI,PANTNAGAR,480,467,DELHI-PANTNAGAR,947,All
2015,6,DELHI,PANTNAGAR,312,348,DELHI-PANTNAGAR,660,All
2015,7,DELHI,PANTNAGAR,199,183,DELHI-PANTNAGAR,382,All
2015,8,DELHI,PANTNAGAR,109,104,DELHI-PANTNAGAR,213,All
2015,9,DELHI,PANTNAGAR,249,200,DELHI-PANTNAGAR,449,All
2015,10,DELHI,PANTNAGAR,419,425,DELHI-PANTNAGAR,844,All
2015,11,DELHI,PANTNAGAR,479,429,DELHI-PANTNAGAR,908,All
2015,12,DELHI,PANTNAGAR,294,272,DELHI-PANTNAGAR,566,All
2016,1,DELHI,PANTNAGAR,169,183,DELHI-PANTNAGAR,352,All
2016,2,DELHI,PANTNAGAR,395,338,DELHI-PANTNAGAR,733,All
2016,3,DELHI,PANTNAGAR,488,522,DELHI-PANTNAGAR,1010,All
2016,4,DELHI,PANTNAGAR,534,430,DELHI-PANTNAGAR,964,All
2016,5,DELHI,PANTNAGAR,461,350,DELHI-PANTNAGAR,811,All
2016,6,DELHI,PANTNAGAR,232,215,DELHI-PANTNAGAR,447,All
2016,7,DELHI,PANTNAGAR,400,357,DELHI-PANTNAGAR,757,All
2016,8,DELHI,PANTNAGAR,538,541,DELHI-PANTNAGAR,1079,All
2016,9,DELHI,PANTNAGAR,580,549,DELHI-PANTNAGAR,1129,All
2016,10,DELHI,PANTNAGAR,597,556,DELHI-PANTNAGAR,1153,All
2016,11,DELHI,PANTNAGAR,718,756,DELHI-PANTNAGAR,1474,All
2016,12,DELHI,PANTNAGAR,423,361,DELHI-PANTNAGAR,784,All
2017,1,DELHI,PANTNAGAR,291,251,DELHI-PANTNAGAR,542,All
2017,2,DELHI,PANTNAGAR,653,582,DELHI-PANTNAGAR,1235,All
2017,3,DELHI,PANTNAGAR,690,746,DELHI-PANTNAGAR,1436,All
2017,4,DELHI,PANTNAGAR,789,833,DELHI-PANTNAGAR,1622,All
2017,5,DELHI,PANTNAGAR,771,817,DELHI-PANTNAGAR,1588,All
2017,6,DELHI,PANTNAGAR,761,819,DELHI-PANTNAGAR,1580,All
2017,7,DELHI,PANTNAGAR,648,670,DELHI-PANTNAGAR,1318,All
2017,8,DELHI,PANTNAGAR,656,595,DELHI-PANTNAGAR,1251,All
2017,9,DELHI,PANTNAGAR,694,730,DELHI-PANTNAGAR,1424,All
2017,10,DELHI,PANTNAGAR,590,615,DELHI-PANTNAGAR,1205,All
2017,11,DELHI,PANTNAGAR,502,517,DELHI-PANTNAGAR,1019,All
2017,12,DELHI,PANTNAGAR,338,394,DELHI-PANTNAGAR,732,All
2018,1,DELHI,PANTNAGAR,183,166,DELHI-PANTNAGAR,349,All
2018,2,DELHI,PANTNAGAR,555,529,DELHI-PANTNAGAR,1084,All
2018,3,DELHI,PANTNAGAR,588,558,DELHI-PANTNAGAR,1146,All
2018,4,DELHI,PANTNAGAR,559,564,DELHI-PANTNAGAR,1123,All
2018,5,DELHI,PANTNAGAR,1170,1052,DELHI-PANTNAGAR,2222,All
2018,6,DELHI,PANTNAGAR,533,622,DELHI-PANTNAGAR,1155,All
2018,7,DELHI,PANTNAGAR,520,544,DELHI-PANTNAGAR,1064,All
2018,8,DELHI,PANTNAGAR,342,319,DELHI-PANTNAGAR,661,All
2018,9,DELHI,PANTNAGAR,459,485,DELHI-PANTNAGAR,944,All
2018,10,DELHI,PANTNAGAR,546,533,DELHI-PANTNAGAR,1079,All
2018,11,DELHI,PANTNAGAR,600,556,DELHI-PANTNAGAR,1156,All
2018,12,DELHI,PANTNAGAR,406,371,DELHI-PANTNAGAR,777,All
2019,1,DELHI,PANTNAGAR,448,394,DELHI-PANTNAGAR,842,All
2019,2,DELHI,PANTNAGAR,315,291,DELHI-PANTNAGAR,606,All
2019,3,DELHI,PANTNAGAR,681,646,DELHI-PANTNAGAR,1327,All
2019,4,DELHI,PANTNAGAR,484,493,DELHI-PANTNAGAR,977,All
2019,5,DELHI,PANTNAGAR,636,596,DELHI-PANTNAGAR,1232,All
2019,6,DELHI,PANTNAGAR,1260,1254,DELHI-PANTNAGAR,2514,All
2019,7,DELHI,PANTNAGAR,501,510,DELHI-PANTNAGAR,1011,All
2019,8,DELHI,PANTNAGAR,518,530,DELHI-PANTNAGAR,1048,All
2019,9,DELHI,PANTNAGAR,478,466,DELHI-PANTNAGAR,944,All
2019,10,DELHI,PANTNAGAR,651,546,DELHI-PANTNAGAR,1197,All
2019,11,DELHI,PANTNAGAR,526,519,DELHI-PANTNAGAR,1045,All
2019,12,DELHI,PANTNAGAR,406,395,DELHI-PANTNAGAR,801,All
2020,1,DELHI,PANTNAGAR,372,404,DELHI-PANTNAGAR,776,All
2020,2,DELHI,PANTNAGAR,575,554,DELHI-PANTNAGAR,1129,All
2020,3,DELHI,PANTNAGAR,326,369,DELHI-PANTNAGAR,695,All
2020,6,DELHI,PANTNAGAR,433,4,DELHI-PANTNAGAR,437,All
2020,7,DELHI,PANTNAGAR,459,240,DELHI-PANTNAGAR,699,All
2020,8,DELHI,PANTNAGAR,451,356,DELHI-PANTNAGAR,807,All
2020,9,DELHI,PANTNAGAR,333,254,DELHI-PANTNAGAR,587,All
2020,10,DELHI,PANTNAGAR,334,269,DELHI-PANTNAGAR,603,All
2020,11,DELHI,PANTNAGAR,332,309,DELHI-PANTNAGAR,641,All
2020,12,DELHI,PANTNAGAR,65,122,DELHI-PANTNAGAR,187,All
2021,2,DELHI,PANTNAGAR,46,76,DELHI-PANTNAGAR,122,All
2021,3,DELHI,PANTNAGAR,193,208,DELHI-PANTNAGAR,401,All
2021,4,DELHI,PANTNAGAR,154,183,DELHI-PANTNAGAR,337,All
2021,6,DELHI,PANTNAGAR,153,112,DELHI-PANTNAGAR,265,All
2021,7,DELHI,PANTNAGAR,144,141,DELHI-PANTNAGAR,285,All
2021,8,DELHI,PANTNAGAR,238,160,DELHI-PANTNAGAR,398,All
2021,9,DELHI,PANTNAGAR,353,317,DELHI-PANTNAGAR,670,All
2021,10,DELHI,PANTNAGAR,300,280,DELHI-PANTNAGAR,580,All
2021,11,DELHI,PANTNAGAR,296,396,DELHI-PANTNAGAR,692,All
2021,12,DELHI,PANTNAGAR,380,340,DELHI-PANTNAGAR,720,All
2022,1,DELHI,PANTNAGAR,200,148,DELHI-PANTNAGAR,348,All
2022,2,DELHI,PANTNAGAR,196,179,DELHI-PANTNAGAR,375,All
2022,3,DELHI,PANTNAGAR,535,480,DELHI-PANTNAGAR,1015,All
2022,4,DELHI,PANTNAGAR,3340,3250,DELHI-PANTNAGAR,6590,All
2022,5,DELHI,PANTNAGAR,4485,3851,DELHI-PANTNAGAR,8336,All
2022,6,DELHI,PANTNAGAR,3267,3460,DELHI-PANTNAGAR,6727,All
2022,7,DELHI,PANTNAGAR,1509,1808,DELHI-PANTNAGAR,3317,All
2022,8,DELHI,PANTNAGAR,1764,1956,DELHI-PANTNAGAR,3720,All
2022,9,DELHI,PANTNAGAR,2238,2204,DELHI-PANTNAGAR,4442,All
2022,10,DELHI,PANTNAGAR,1943,1763,DELHI-PANTNAGAR,3706,All
2022,11,DELHI,PANTNAGAR,2066,2107,DELHI-PANTNAGAR,4173,All
2022,12,DELHI,PANTNAGAR,1800,1869,DELHI-PANTNAGAR,3669,All
2023,1,DELHI,PANTNAGAR,210,160,DELHI-PANTNAGAR,370,All
2023,2,DELHI,PANTNAGAR,1564,1645,DELHI-PANTNAGAR,3209,All
2023,3,DELHI,PANTNAGAR,2291,2338,DELHI-PANTNAGAR,4629,All
2023,4,DELHI,PANTNAGAR,3848,3750,DELHI-PANTNAGAR,7598,All
2023,5,DELHI,PANTNAGAR,4348,4123,DELHI-PANTNAGAR,8471,All
2023,6,DELHI,PANTNAGAR,4316,4210,DELHI-PANTNAGAR,8526,All
2023,7,DELHI,PANTNAGAR,2386,2749,DELHI-PANTNAGAR,5135,All
2023,8,DELHI,PANTNAGAR,2541,2581,DELHI-PANTNAGAR,5122,All
2023,9,DELHI,PANTNAGAR,3544,3569,DELHI-PANTNAGAR,7113,All
2023,10,DELHI,PANTNAGAR,3768,3940,DELHI-PANTNAGAR,7708,All
2023,11,DELHI,PANTNAGAR,2922,2902,DELHI-PANTNAGAR,5824,All
2023,12,DELHI,PANTNAGAR,2820,2600,DELHI-PANTNAGAR,5420,All
2024,1,DELHI,PANTNAGAR,58,56,DELHI-PANTNAGAR,114,All
2024,2,DELHI,PANTNAGAR,3124,3135,DELHI-PANTNAGAR,6259,All
2024,3,DELHI,PANTNAGAR,3144,2956,DELHI-PANTNAGAR,6100,All
2024,4,DELHI,PANTNAGAR,4604,4303,DELHI-PANTNAGAR,8907,All
2024,6,DELHI,PANTNAGAR,4278,3857,DELHI-PANTNAGAR,8135,All
2024,7,DELHI,PANTNAGAR,3568,3150,DELHI-PANTNAGAR,6718,All
2024,8,DELHI,PANTNAGAR,4127,3683,DELHI-PANTNAGAR,7810,All
2024,9,DELHI,PANTNAGAR,4076,3742,DELHI-PANTNAGAR,7818,All
2024,10,DELHI,PANTNAGAR,4815,4157,DELHI-PANTNAGAR,8972,All
2024,11,DELHI,PANTNAGAR,4093,4036,DELHI-PANTNAGAR,8129,All
2024,12,DELHI,PANTNAGAR,4405,4418,DELHI-PANTNAGAR,8823,All
2025,1,DELHI,PANTNAGAR,3497,3417,DELHI-PANTNAGAR,6914,All
2025,2,DELHI,PANTNAGAR,3721,3710,DELHI-PANTNAGAR,7431,All
2025,3,DELHI,PANTNAGAR,4002,3866,DELHI-PANTNAGAR,7868,All
2018,4,DELHI,PATHANKOT,405,406,DELHI-PATHANKOT,811,All
2018,5,DELHI,PATHANKOT,581,578,DELHI-PATHANKOT,1159,All
2018,6,DELHI,PATHANKOT,467,435,DELHI-PATHANKOT,902,All
2018,7,DELHI,PATHANKOT,485,506,DELHI-PATHANKOT,991,All
2018,8,DELHI,PATHANKOT,448,507,DELHI-PATHANKOT,955,All
2018,9,DELHI,PATHANKOT,520,494,DELHI-PATHANKOT,1014,All
2018,10,DELHI,PATHANKOT,592,571,DELHI-PATHANKOT,1163,All
2018,11,DELHI,PATHANKOT,573,579,DELHI-PATHANKOT,1152,All
2018,12,DELHI,PATHANKOT,469,492,DELHI-PATHANKOT,961,All
2019,1,DELHI,PATHANKOT,509,541,DELHI-PATHANKOT,1050,All
2019,2,DELHI,PATHANKOT,350,402,DELHI-PATHANKOT,752,All
2019,3,DELHI,PATHANKOT,483,512,DELHI-PATHANKOT,995,All
2019,4,DELHI,PATHANKOT,589,579,DELHI-PATHANKOT,1168,All
2019,5,DELHI,PATHANKOT,552,529,DELHI-PATHANKOT,1081,All
2019,6,DELHI,PATHANKOT,734,723,DELHI-PATHANKOT,1457,All
2019,7,DELHI,PATHANKOT,454,427,DELHI-PATHANKOT,881,All
2019,8,DELHI,PATHANKOT,509,494,DELHI-PATHANKOT,1003,All
2019,9,DELHI,PATHANKOT,461,447,DELHI-PATHANKOT,908,All
2019,10,DELHI,PATHANKOT,555,560,DELHI-PATHANKOT,1115,All
2019,11,DELHI,PATHANKOT,516,527,DELHI-PATHANKOT,1043,All
2019,12,DELHI,PATHANKOT,374,381,DELHI-PATHANKOT,755,All
2020,1,DELHI,PATHANKOT,432,433,DELHI-PATHANKOT,865,All
2020,2,DELHI,PATHANKOT,483,490,DELHI-PATHANKOT,973,All
2020,3,DELHI,PATHANKOT,483,414,DELHI-PATHANKOT,897,All
2020,5,DELHI,PATHANKOT,80,47,DELHI-PATHANKOT,127,All
2020,6,DELHI,PATHANKOT,626,574,DELHI-PATHANKOT,1200,All
2020,7,DELHI,PATHANKOT,366,448,DELHI-PATHANKOT,814,All
2020,8,DELHI,PATHANKOT,418,499,DELHI-PATHANKOT,917,All
2020,9,DELHI,PATHANKOT,475,380,DELHI-PATHANKOT,855,All
2020,10,DELHI,PATHANKOT,603,528,DELHI-PATHANKOT,1131,All
2020,11,DELHI,PATHANKOT,649,679,DELHI-PATHANKOT,1328,All
2020,12,DELHI,PATHANKOT,650,664,DELHI-PATHANKOT,1314,All
2021,1,DELHI,PATHANKOT,414,510,DELHI-PATHANKOT,924,All
2021,2,DELHI,PATHANKOT,375,340,DELHI-PATHANKOT,715,All
2021,3,DELHI,PATHANKOT,292,247,DELHI-PATHANKOT,539,All
2021,4,DELHI,PATHANKOT,464,336,DELHI-PATHANKOT,800,All
2021,6,DELHI,PATHANKOT,405,381,DELHI-PATHANKOT,786,All
2021,7,DELHI,PATHANKOT,593,613,DELHI-PATHANKOT,1206,All
2021,8,DELHI,PATHANKOT,531,572,DELHI-PATHANKOT,1103,All
2021,9,DELHI,PATHANKOT,572,576,DELHI-PATHANKOT,1148,All
2021,10,DELHI,PATHANKOT,681,653,DELHI-PATHANKOT,1334,All
2021,11,DELHI,PATHANKOT,524,576,DELHI-PATHANKOT,1100,All
2021,12,DELHI,PATHANKOT,604,592,DELHI-PATHANKOT,1196,All
2022,1,DELHI,PATHANKOT,232,211,DELHI-PATHANKOT,443,All
2022,2,DELHI,PATHANKOT,406,390,DELHI-PATHANKOT,796,All
2022,4,DELHI,PATHANKOT,524,576,DELHI-PATHANKOT,1100,All
2022,5,DELHI,PATHANKOT,604,592,DELHI-PATHANKOT,1196,All
2022,6,DELHI,PATHANKOT,524,576,DELHI-PATHANKOT,1100,All
2022,7,DELHI,PATHANKOT,406,390,DELHI-PATHANKOT,796,All
2022,8,DELHI,PATHANKOT,604,592,DELHI-PATHANKOT,1196,All
2022,9,DELHI,PATHANKOT,524,576,DELHI-PATHANKOT,1100,All
2015,4,DELHI,PATNA,42363,35792,DELHI-PATNA,78155,All
2015,5,DELHI,PATNA,45567,40416,DELHI-PATNA,85983,All
2015,6,DELHI,PATNA,38357,41942,DELHI-PATNA,80299,All
2015,7,DELHI,PATNA,40231,40472,DELHI-PATNA,80703,All
2015,8,DELHI,PATNA,36871,38262,DELHI-PATNA,75133,All
2015,9,DELHI,PATNA,40070,33017,DELHI-PATNA,73087,All
2015,10,DELHI,PATNA,37690,29173,DELHI-PATNA,66863,All
2015,11,DELHI,PATNA,47242,40651,DELHI-PATNA,87893,All
2015,12,DELHI,PATNA,41031,41510,DELHI-PATNA,82541,All
2016,1,DELHI,PATNA,38746,39119,DELHI-PATNA,77865,All
2016,2,DELHI,PATNA,41251,39686,DELHI-PATNA,80937,All
2016,3,DELHI,PATNA,49322,44069,DELHI-PATNA,93391,All
2016,4,DELHI,PATNA,53241,47845,DELHI-PATNA,101086,All
2016,5,DELHI,PATNA,50634,47505,DELHI-PATNA,98139,All
2016,6,DELHI,PATNA,51099,46768,DELHI-PATNA,97867,All
2016,7,DELHI,PATNA,52296,54475,DELHI-PATNA,106771,All
2016,8,DELHI,PATNA,52000,52135,DELHI-PATNA,104135,All
2016,9,DELHI,PATNA,53410,49929,DELHI-PATNA,103339,All
2016,10,DELHI,PATNA,67079,53381,DELHI-PATNA,120460,All
2016,11,DELHI,PATNA,64992,67379,DELHI-PATNA,132371,All
2016,12,DELHI,PATNA,50557,55227,DELHI-PATNA,105784,All
2017,1,DELHI,PATNA,51387,55221,DELHI-PATNA,106608,All
2017,2,DELHI,PATNA,57002,55726,DELHI-PATNA,112728,All
2017,3,DELHI,PATNA,64972,64867,DELHI-PATNA,129839,All
2017,4,DELHI,PATNA,74477,64983,DELHI-PATNA,139460,All
2017,5,DELHI,PATNA,78071,74927,DELHI-PATNA,152998,All
2017,6,DELHI,PATNA,72838,74222,DELHI-PATNA,147060,All
2017,7,DELHI,PATNA,60452,71959,DELHI-PATNA,132411,All
2017,8,DELHI,PATNA,67946,64650,DELHI-PATNA,132596,All
2017,9,DELHI,PATNA,65632,65778,DELHI-PATNA,131410,All
2017,10,DELHI,PATNA,82219,74390,DELHI-PATNA,156609,All
2017,11,DELHI,PATNA,72139,74049,DELHI-PATNA,146188,All
2017,12,DELHI,PATNA,59685,63585,DELHI-PATNA,123270,All
2018,1,DELHI,PATNA,60145,62391,DELHI-PATNA,122536,All
2018,2,DELHI,PATNA,71510,66707,DELHI-PATNA,138217,All
2018,3,DELHI,PATNA,79766,81971,DELHI-PATNA,161737,All
2018,4,DELHI,PATNA,80852,75827,DELHI-PATNA,156679,All
2018,5,DELHI,PATNA,78193,82108,DELHI-PATNA,160301,All
2018,6,DELHI,PATNA,82920,78065,DELHI-PATNA,160985,All
2018,7,DELHI,PATNA,84905,94027,DELHI-PATNA,178932,All
2018,8,DELHI,PATNA,87854,84832,DELHI-PATNA,172686,All
2018,9,DELHI,PATNA,85863,87061,DELHI-PATNA,172924,All
2018,10,DELHI,PATNA,91318,82875,DELHI-PATNA,174193,All
2018,11,DELHI,PATNA,74609,71757,DELHI-PATNA,146366,All
2018,12,DELHI,PATNA,68794,70261,DELHI-PATNA,139055,All
2019,1,DELHI,PATNA,63810,65699,DELHI-PATNA,129509,All
2019,2,DELHI,PATNA,75191,75417,DELHI-PATNA,150608,All
2019,3,DELHI,PATNA,75720,74173,DELHI-PATNA,149893,All
2019,4,DELHI,PATNA,72436,72508,DELHI-PATNA,144944,All
2019,5,DELHI,PATNA,93221,89707,DELHI-PATNA,182928,All
2019,6,DELHI,PATNA,102665,110260,DELHI-PATNA,212925,All
2019,7,DELHI,PATNA,94940,107486,DELHI-PATNA,202426,All
2019,8,DELHI,PATNA,96341,97070,DELHI-PATNA,193411,All
2019,9,DELHI,PATNA,93317,93052,DELHI-PATNA,186369,All
2019,10,DELHI,PATNA,104665,88854,DELHI-PATNA,193519,All
2019,11,DELHI,PATNA,100325,105980,DELHI-PATNA,206305,All
2019,12,DELHI,PATNA,76481,77830,DELHI-PATNA,154311,All
2020,1,DELHI,PATNA,68057,69777,DELHI-PATNA,137834,All
2020,2,DELHI,PATNA,94838,87586,DELHI-PATNA,182424,All
2020,3,DELHI,PATNA,76458,60085,DELHI-PATNA,136543,All
2020,5,DELHI,PATNA,7783,3104,DELHI-PATNA,10887,All
2020,6,DELHI,PATNA,54134,21639,DELHI-PATNA,75773,All
2020,7,DELHI,PATNA,43482,33027,DELHI-PATNA,76509,All
2020,8,DELHI,PATNA,35093,59502,DELHI-PATNA,94595,All
2020,9,DELHI,PATNA,40945,65275,DELHI-PATNA,106220,All
2020,10,DELHI,PATNA,65305,67720,DELHI-PATNA,133025,All
2020,11,DELHI,PATNA,84136,55353,DELHI-PATNA,139489,All
2020,12,DELHI,PATNA,50030,53920,DELHI-PATNA,103950,All
2021,1,DELHI,PATNA,47957,60348,DELHI-PATNA,108305,All
2021,2,DELHI,PATNA,51012,52981,DELHI-PATNA,103993,All
2021,3,DELHI,PATNA,63272,56822,DELHI-PATNA,120094,All
2021,4,DELHI,PATNA,81483,50187,DELHI-PATNA,131670,All
2021,6,DELHI,PATNA,30807,42493,DELHI-PATNA,73300,All
2021,7,DELHI,PATNA,44276,44479,DELHI-PATNA,88755,All
2021,8,DELHI,PATNA,50623,53517,DELHI-PATNA,104140,All
2021,9,DELHI,PATNA,49183,49054,DELHI-PATNA,98237,All
2021,10,DELHI,PATNA,78676,57498,DELHI-PATNA,136174,All
2021,11,DELHI,PATNA,92615,81090,DELHI-PATNA,173705,All
2021,12,DELHI,PATNA,70211,79627,DELHI-PATNA,149838,All
2022,1,DELHI,PATNA,47065,39121,DELHI-PATNA,86186,All
2022,2,DELHI,PATNA,64801,65132,DELHI-PATNA,129933,All
2022,3,DELHI,PATNA,73630,68967,DELHI-PATNA,142597,All
2022,4,DELHI,PATNA,74674,54762,DELHI-PATNA,129436,All
2022,5,DELHI,PATNA,70609,69703,DELHI-PATNA,140312,All
2022,6,DELHI,PATNA,68285,72086,DELHI-PATNA,140371,All
2022,7,DELHI,PATNA,58077,58270,DELHI-PATNA,116347,All
2022,8,DELHI,PATNA,58530,59931,DELHI-PATNA,118461,All
2022,9,DELHI,PATNA,62906,57028,DELHI-PATNA,119934,All
2022,10,DELHI,PATNA,65636,48386,DELHI-PATNA,114022,All
2022,11,DELHI,PATNA,63137,71450,DELHI-PATNA,134587,All
2022,12,DELHI,PATNA,66119,64799,DELHI-PATNA,130918,All
2023,1,DELHI,PATNA,58670,55759,DELHI-PATNA,114429,All
2023,2,DELHI,PATNA,67620,62851,DELHI-PATNA,130471,All
2023,3,DELHI,PATNA,71395,69442,DELHI-PATNA,140837,All
2023,4,DELHI,PATNA,65434,60843,DELHI-PATNA,126277,All
2023,5,DELHI,PATNA,60971,59131,DELHI-PATNA,120102,All
2023,6,DELHI,PATNA,57708,55693,DELHI-PATNA,113401,All
2023,7,DELHI,PATNA,54054,55244,DELHI-PATNA,109298,All
2023,8,DELHI,PATNA,58994,59218,DELHI-PATNA,118212,All
2023,9,DELHI,PATNA,56824,56606,DELHI-PATNA,113430,All
2023,10,DELHI,PATNA,65666,59125,DELHI-PATNA,124791,All
2023,11,DELHI,PATNA,64438,55050,DELHI-PATNA,119488,All
2023,12,DELHI,PATNA,58802,58905,DELHI-PATNA,117707,All
2024,1,DELHI,PATNA,50016,50150,DELHI-PATNA,100166,All
2024,2,DELHI,PATNA,60299,58354,DELHI-PATNA,118653,All
2024,3,DELHI,PATNA,67213,61223,DELHI-PATNA,128436,All
2024,4,DELHI,PATNA,59649,54607,DELHI-PATNA,114256,All
2024,6,DELHI,PATNA,58646,55868,DELHI-PATNA,114514,All
2024,7,DELHI,PATNA,57143,60790,DELHI-PATNA,117933,All
2024,8,DELHI,PATNA,56818,57380,DELHI-PATNA,114198,All
2024,9,DELHI,PATNA,56957,49206,DELHI-PATNA,106163,All
2024,10,DELHI,PATNA,63596,47019,DELHI-PATNA,110615,All
2024,11,DELHI,PATNA,65663,62281,DELHI-PATNA,127944,All
2024,12,DELHI,PATNA,58882,57141,DELHI-PATNA,116023,All
2025,1,DELHI,PATNA,52105,49844,DELHI-PATNA,101949,All
2025,2,DELHI,PATNA,49737,49302,DELHI-PATNA,99039,All
2025,3,DELHI,PATNA,60291,55448,DELHI-PATNA,115739,All
2024,11,DELHI,PITHORAGARH,282,230,DELHI-PITHORAGARH,512,All
2024,12,DELHI,PITHORAGARH,280,243,DELHI-PITHORAGARH,523,All
2025,1,DELHI,PITHORAGARH,258,223,DELHI-PITHORAGARH,481,All
2025,2,DELHI,PITHORAGARH,279,235,DELHI-PITHORAGARH,514,All
2025,3,DELHI,PITHORAGARH,302,213,DELHI-PITHORAGARH,515,All
2022,4,DELHI,PORBANDAR,95,91,DELHI-PORBANDAR,186,All
2022,5,DELHI,PORBANDAR,875,920,DELHI-PORBANDAR,1795,All
2022,6,DELHI,PORBANDAR,860,614,DELHI-PORBANDAR,1474,All
2022,7,DELHI,PORBANDAR,450,346,DELHI-PORBANDAR,796,All
2022,8,DELHI,PORBANDAR,92,102,DELHI-PORBANDAR,194,All
2015,4,DELHI,PORT BLAIR,2806,2782,DELHI-PORT BLAIR,5588,All
2015,5,DELHI,PORT BLAIR,3078,3068,DELHI-PORT BLAIR,6146,All
2015,6,DELHI,PORT BLAIR,1386,788,DELHI-PORT BLAIR,2174,All
2015,7,DELHI,PORT BLAIR,1453,1466,DELHI-PORT BLAIR,2919,All
2015,8,DELHI,PORT BLAIR,1424,1488,DELHI-PORT BLAIR,2912,All
2015,9,DELHI,PORT BLAIR,1471,1402,DELHI-PORT BLAIR,2873,All
2015,10,DELHI,PORT BLAIR,9007,3042,DELHI-PORT BLAIR,12049,All
2015,11,DELHI,PORT BLAIR,2962,2961,DELHI-PORT BLAIR,5923,All
2015,12,DELHI,PORT BLAIR,4265,3278,DELHI-PORT BLAIR,7543,All
2016,1,DELHI,PORT BLAIR,4155,4418,DELHI-PORT BLAIR,8573,All
2016,2,DELHI,PORT BLAIR,4176,3517,DELHI-PORT BLAIR,7693,All
2016,3,DELHI,PORT BLAIR,4224,3863,DELHI-PORT BLAIR,8087,All
2016,4,DELHI,PORT BLAIR,3071,3661,DELHI-PORT BLAIR,6732,All
2016,5,DELHI,PORT BLAIR,2966,3606,DELHI-PORT BLAIR,6572,All
2016,6,DELHI,PORT BLAIR,2930,3465,DELHI-PORT BLAIR,6395,All
2016,7,DELHI,PORT BLAIR,1768,2799,DELHI-PORT BLAIR,4567,All
2016,8,DELHI,PORT BLAIR,2723,3125,DELHI-PORT BLAIR,5848,All
2016,9,DELHI,PORT BLAIR,2317,2483,DELHI-PORT BLAIR,4800,All
2016,10,DELHI,PORT BLAIR,2884,2613,DELHI-PORT BLAIR,5497,All
2016,11,DELHI,PORT BLAIR,4489,3838,DELHI-PORT BLAIR,8327,All
2016,12,DELHI,PORT BLAIR,4744,3698,DELHI-PORT BLAIR,8442,All
2017,1,DELHI,PORT BLAIR,4915,4691,DELHI-PORT BLAIR,9606,All
2017,2,DELHI,PORT BLAIR,4301,3843,DELHI-PORT BLAIR,8144,All
2017,3,DELHI,PORT BLAIR,5064,4758,DELHI-PORT BLAIR,9822,All
2017,4,DELHI,PORT BLAIR,4599,5166,DELHI-PORT BLAIR,9765,All
2017,5,DELHI,PORT BLAIR,5013,4784,DELHI-PORT BLAIR,9797,All
2017,6,DELHI,PORT BLAIR,5692,5214,DELHI-PORT BLAIR,10906,All
2017,7,DELHI,PORT BLAIR,2225,2360,DELHI-PORT BLAIR,4585,All
2017,8,DELHI,PORT BLAIR,1959,2186,DELHI-PORT BLAIR,4145,All
2017,9,DELHI,PORT BLAIR,2528,2795,DELHI-PORT BLAIR,5323,All
2017,10,DELHI,PORT BLAIR,3852,3129,DELHI-PORT BLAIR,6981,All
2017,11,DELHI,PORT BLAIR,5368,4892,DELHI-PORT BLAIR,10260,All
2017,12,DELHI,PORT BLAIR,9958,8192,DELHI-PORT BLAIR,18150,All
2018,1,DELHI,PORT BLAIR,13768,13220,DELHI-PORT BLAIR,26988,All
2018,2,DELHI,PORT BLAIR,10135,9679,DELHI-PORT BLAIR,19814,All
2018,3,DELHI,PORT BLAIR,10048,8348,DELHI-PORT BLAIR,18396,All
2018,4,DELHI,PORT BLAIR,11061,11326,DELHI-PORT BLAIR,22387,All
2018,5,DELHI,PORT BLAIR,10704,10344,DELHI-PORT BLAIR,21048,All
2018,6,DELHI,PORT BLAIR,9849,8765,DELHI-PORT BLAIR,18614,All
2018,7,DELHI,PORT BLAIR,4398,3960,DELHI-PORT BLAIR,8358,All
2018,8,DELHI,PORT BLAIR,5739,4865,DELHI-PORT BLAIR,10604,All
2018,9,DELHI,PORT BLAIR,8669,7014,DELHI-PORT BLAIR,15683,All
2018,10,DELHI,PORT BLAIR,7855,6816,DELHI-PORT BLAIR,14671,All
2018,11,DELHI,PORT BLAIR,9326,8141,DELHI-PORT BLAIR,17467,All
2018,12,DELHI,PORT BLAIR,9472,8343,DELHI-PORT BLAIR,17815,All
2019,1,DELHI,PORT BLAIR,8404,6345,DELHI-PORT BLAIR,14749,All
2019,2,DELHI,PORT BLAIR,7500,6364,DELHI-PORT BLAIR,13864,All
2019,3,DELHI,PORT BLAIR,7722,6911,DELHI-PORT BLAIR,14633,All
2019,4,DELHI,PORT BLAIR,6679,6134,DELHI-PORT BLAIR,12813,All
2019,5,DELHI,PORT BLAIR,7361,6740,DELHI-PORT BLAIR,14101,All
2019,6,DELHI,PORT BLAIR,8054,7116,DELHI-PORT BLAIR,15170,All
2019,7,DELHI,PORT BLAIR,4051,2841,DELHI-PORT BLAIR,6892,All
2019,8,DELHI,PORT BLAIR,3337,2822,DELHI-PORT BLAIR,6159,All
2019,9,DELHI,PORT BLAIR,4700,3789,DELHI-PORT BLAIR,8489,All
2019,10,DELHI,PORT BLAIR,6947,6300,DELHI-PORT BLAIR,13247,All
2019,11,DELHI,PORT BLAIR,9968,6442,DELHI-PORT BLAIR,16410,All
2019,12,DELHI,PORT BLAIR,10106,6821,DELHI-PORT BLAIR,16927,All
2020,1,DELHI,PORT BLAIR,9260,6183,DELHI-PORT BLAIR,15443,All
2020,2,DELHI,PORT BLAIR,7323,5505,DELHI-PORT BLAIR,12828,All
2020,3,DELHI,PORT BLAIR,4124,3486,DELHI-PORT BLAIR,7610,All
2020,6,DELHI,PORT BLAIR,933,275,DELHI-PORT BLAIR,1208,All
2020,7,DELHI,PORT BLAIR,124,124,DELHI-PORT BLAIR,248,All
2020,8,DELHI,PORT BLAIR,462,574,DELHI-PORT BLAIR,1036,All
2020,9,DELHI,PORT BLAIR,921,815,DELHI-PORT BLAIR,1736,All
2020,10,DELHI,PORT BLAIR,681,772,DELHI-PORT BLAIR,1453,All
2020,11,DELHI,PORT BLAIR,1382,1482,DELHI-PORT BLAIR,2864,All
2020,12,DELHI,PORT BLAIR,2726,2225,DELHI-PORT BLAIR,4951,All
2021,1,DELHI,PORT BLAIR,2576,2481,DELHI-PORT BLAIR,5057,All
2021,2,DELHI,PORT BLAIR,4315,3396,DELHI-PORT BLAIR,7711,All
2021,3,DELHI,PORT BLAIR,5984,5121,DELHI-PORT BLAIR,11105,All
2021,4,DELHI,PORT BLAIR,3514,3898,DELHI-PORT BLAIR,7412,All
2021,6,DELHI,PORT BLAIR,2044,1359,DELHI-PORT BLAIR,3403,All
2021,7,DELHI,PORT BLAIR,1714,1245,DELHI-PORT BLAIR,2959,All
2021,8,DELHI,PORT BLAIR,1664,1473,DELHI-PORT BLAIR,3137,All
2021,9,DELHI,PORT BLAIR,2660,2459,DELHI-PORT BLAIR,5119,All
2021,10,DELHI,PORT BLAIR,4697,4043,DELHI-PORT BLAIR,8740,All
2021,11,DELHI,PORT BLAIR,6399,5249,DELHI-PORT BLAIR,11648,All
2021,12,DELHI,PORT BLAIR,6886,5603,DELHI-PORT BLAIR,12489,All
2022,1,DELHI,PORT BLAIR,3150,4342,DELHI-PORT BLAIR,7492,All
2022,2,DELHI,PORT BLAIR,5134,3951,DELHI-PORT BLAIR,9085,All
2022,3,DELHI,PORT BLAIR,3333,3420,DELHI-PORT BLAIR,6753,All
2022,4,DELHI,PORT BLAIR,3012,3041,DELHI-PORT BLAIR,6053,All
2022,5,DELHI,PORT BLAIR,3677,3071,DELHI-PORT BLAIR,6748,All
2022,6,DELHI,PORT BLAIR,6239,5718,DELHI-PORT BLAIR,11957,All
2022,7,DELHI,PORT BLAIR,3453,3584,DELHI-PORT BLAIR,7037,All
2022,8,DELHI,PORT BLAIR,3924,3463,DELHI-PORT BLAIR,7387,All
2022,9,DELHI,PORT BLAIR,4715,4236,DELHI-PORT BLAIR,8951,All
2022,10,DELHI,PORT BLAIR,4316,4176,DELHI-PORT BLAIR,8492,All
2022,11,DELHI,PORT BLAIR,4150,3523,DELHI-PORT BLAIR,7673,All
2022,12,DELHI,PORT BLAIR,5122,4416,DELHI-PORT BLAIR,9538,All
2023,1,DELHI,PORT BLAIR,4586,4469,DELHI-PORT BLAIR,9055,All
2023,2,DELHI,PORT BLAIR,3539,3607,DELHI-PORT BLAIR,7146,All
2023,3,DELHI,PORT BLAIR,3738,3925,DELHI-PORT BLAIR,7663,All
2023,4,DELHI,PORT BLAIR,2917,3824,DELHI-PORT BLAIR,6741,All
2023,5,DELHI,PORT BLAIR,3516,3922,DELHI-PORT BLAIR,7438,All
2023,6,DELHI,PORT BLAIR,4830,4248,DELHI-PORT BLAIR,9078,All
2023,7,DELHI,PORT BLAIR,3954,3805,DELHI-PORT BLAIR,7759,All
2023,8,DELHI,PORT BLAIR,4174,3986,DELHI-PORT BLAIR,8160,All
2023,9,DELHI,PORT BLAIR,4943,4347,DELHI-PORT BLAIR,9290,All
2023,10,DELHI,PORT BLAIR,4325,4332,DELHI-PORT BLAIR,8657,All
2023,11,DELHI,PORT BLAIR,3254,2817,DELHI-PORT BLAIR,6071,All
2023,12,DELHI,PORT BLAIR,6882,5422,DELHI-PORT BLAIR,12304,All
2024,1,DELHI,PORT BLAIR,5163,5196,DELHI-PORT BLAIR,10359,All
2024,2,DELHI,PORT BLAIR,3310,3573,DELHI-PORT BLAIR,6883,All
2024,3,DELHI,PORT BLAIR,3725,4073,DELHI-PORT BLAIR,7798,All
2024,4,DELHI,PORT BLAIR,3291,2966,DELHI-PORT BLAIR,6257,All
2024,6,DELHI,PORT BLAIR,2618,2525,DELHI-PORT BLAIR,5143,All
2024,7,DELHI,PORT BLAIR,2359,2136,DELHI-PORT BLAIR,4495,All
2024,8,DELHI,PORT BLAIR,2376,1993,DELHI-PORT BLAIR,4369,All
2024,9,DELHI,PORT BLAIR,2847,2253,DELHI-PORT BLAIR,5100,All
2024,10,DELHI,PORT BLAIR,3364,3052,DELHI-PORT BLAIR,6416,All
2024,11,DELHI,PORT BLAIR,8845,7698,DELHI-PORT BLAIR,16543,All
2024,12,DELHI,PORT BLAIR,8295,7777,DELHI-PORT BLAIR,16072,All
2025,1,DELHI,PORT BLAIR,5679,6002,DELHI-PORT BLAIR,11681,All
2025,2,DELHI,PORT BLAIR,2139,2363,DELHI-PORT BLAIR,4502,All
2025,3,DELHI,PORT BLAIR,2033,2179,DELHI-PORT BLAIR,4212,All
2015,4,DELHI,PUNE,67005,74142,DELHI-PUNE,141147,All
2015,5,DELHI,PUNE,75884,74926,DELHI-PUNE,150810,All
2015,6,DELHI,PUNE,72794,67440,DELHI-PUNE,140234,All
2015,7,DELHI,PUNE,72835,74406,DELHI-PUNE,147241,All
2015,8,DELHI,PUNE,71363,71847,DELHI-PUNE,143210,All
2015,9,DELHI,PUNE,71409,72684,DELHI-PUNE,144093,All
2015,10,DELHI,PUNE,61617,65451,DELHI-PUNE,127068,All
2015,11,DELHI,PUNE,74437,75435,DELHI-PUNE,149872,All
2015,12,DELHI,PUNE,85545,78361,DELHI-PUNE,163906,All
2016,1,DELHI,PUNE,73349,78407,DELHI-PUNE,151756,All
2016,2,DELHI,PUNE,75028,76913,DELHI-PUNE,151941,All
2016,3,DELHI,PUNE,80121,82335,DELHI-PUNE,162456,All
2016,4,DELHI,PUNE,82407,91176,DELHI-PUNE,173583,All
2016,5,DELHI,PUNE,98298,97585,DELHI-PUNE,195883,All
2016,6,DELHI,PUNE,94447,84541,DELHI-PUNE,178988,All
2016,7,DELHI,PUNE,93491,94598,DELHI-PUNE,188089,All
2016,8,DELHI,PUNE,89659,91100,DELHI-PUNE,180759,All
2016,9,DELHI,PUNE,90116,93807,DELHI-PUNE,183923,All
2016,10,DELHI,PUNE,81734,98603,DELHI-PUNE,180337,All
2016,11,DELHI,PUNE,104019,94247,DELHI-PUNE,198266,All
2016,12,DELHI,PUNE,105384,99164,DELHI-PUNE,204548,All
2017,1,DELHI,PUNE,101614,105872,DELHI-PUNE,207486,All
2017,2,DELHI,PUNE,94669,96507,DELHI-PUNE,191176,All
2017,3,DELHI,PUNE,105364,105063,DELHI-PUNE,210427,All
2017,4,DELHI,PUNE,100121,109368,DELHI-PUNE,209489,All
2017,5,DELHI,PUNE,117171,114764,DELHI-PUNE,231935,All
2017,6,DELHI,PUNE,111457,103335,DELHI-PUNE,214792,All
2017,7,DELHI,PUNE,109804,106484,DELHI-PUNE,216288,All
2017,8,DELHI,PUNE,108115,106059,DELHI-PUNE,214174,All
2017,9,DELHI,PUNE,98943,103969,DELHI-PUNE,202912,All
2017,10,DELHI,PUNE,108526,115072,DELHI-PUNE,223598,All
2017,11,DELHI,PUNE,110789,111024,DELHI-PUNE,221813,All
2017,12,DELHI,PUNE,122194,114413,DELHI-PUNE,236607,All
2018,1,DELHI,PUNE,116185,116192,DELHI-PUNE,232377,All
2018,2,DELHI,PUNE,109638,111858,DELHI-PUNE,221496,All
2018,3,DELHI,PUNE,119581,116231,DELHI-PUNE,235812,All
2018,4,DELHI,PUNE,110647,121071,DELHI-PUNE,231718,All
2018,5,DELHI,PUNE,123114,122311,DELHI-PUNE,245425,All
2018,6,DELHI,PUNE,129724,106548,DELHI-PUNE,236272,All
2018,7,DELHI,PUNE,125388,111664,DELHI-PUNE,237052,All
2018,8,DELHI,PUNE,113386,115126,DELHI-PUNE,228512,All
2018,9,DELHI,PUNE,112006,111356,DELHI-PUNE,223362,All
2018,10,DELHI,PUNE,112397,119449,DELHI-PUNE,231846,All
2018,11,DELHI,PUNE,109073,108939,DELHI-PUNE,218012,All
2018,12,DELHI,PUNE,116797,112351,DELHI-PUNE,229148,All
2019,1,DELHI,PUNE,114665,118083,DELHI-PUNE,232748,All
2019,2,DELHI,PUNE,109630,110745,DELHI-PUNE,220375,All
2019,3,DELHI,PUNE,108135,108017,DELHI-PUNE,216152,All
2019,4,DELHI,PUNE,100342,107300,DELHI-PUNE,207642,All
2019,5,DELHI,PUNE,117421,116058,DELHI-PUNE,233479,All
2019,6,DELHI,PUNE,116108,106301,DELHI-PUNE,222409,All
2019,7,DELHI,PUNE,117104,115610,DELHI-PUNE,232714,All
2019,8,DELHI,PUNE,112287,112753,DELHI-PUNE,225040,All
2019,9,DELHI,PUNE,108084,111158,DELHI-PUNE,219242,All
2019,10,DELHI,PUNE,101550,113841,DELHI-PUNE,215391,All
2019,11,DELHI,PUNE,116319,111755,DELHI-PUNE,228074,All
2019,12,DELHI,PUNE,118845,112453,DELHI-PUNE,231298,All
2020,1,DELHI,PUNE,114621,113425,DELHI-PUNE,228046,All
2020,2,DELHI,PUNE,112066,115126,DELHI-PUNE,227192,All
2020,3,DELHI,PUNE,62945,70781,DELHI-PUNE,133726,All
2020,5,DELHI,PUNE,3022,7254,DELHI-PUNE,10276,All
2020,6,DELHI,PUNE,19022,30052,DELHI-PUNE,49074,All
2020,7,DELHI,PUNE,18684,23891,DELHI-PUNE,42575,All
2020,8,DELHI,PUNE,34121,28519,DELHI-PUNE,62640,All
2020,9,DELHI,PUNE,43093,32209,DELHI-PUNE,75302,All
2020,10,DELHI,PUNE,46890,43963,DELHI-PUNE,90853,All
2020,11,DELHI,PUNE,49768,51530,DELHI-PUNE,101298,All
2020,12,DELHI,PUNE,47562,36799,DELHI-PUNE,84361,All
2021,1,DELHI,PUNE,51204,46231,DELHI-PUNE,97435,All
2021,2,DELHI,PUNE,51252,51527,DELHI-PUNE,102779,All
2021,3,DELHI,PUNE,44219,48961,DELHI-PUNE,93180,All
2021,4,DELHI,PUNE,31119,36546,DELHI-PUNE,67665,All
2021,6,DELHI,PUNE,30374,23288,DELHI-PUNE,53662,All
2021,7,DELHI,PUNE,44097,38090,DELHI-PUNE,82187,All
2021,8,DELHI,PUNE,58432,55277,DELHI-PUNE,113709,All
2021,9,DELHI,PUNE,59852,59358,DELHI-PUNE,119210,All
2021,10,DELHI,PUNE,38210,40572,DELHI-PUNE,78782,All
2021,11,DELHI,PUNE,81765,81429,DELHI-PUNE,163194,All
2021,12,DELHI,PUNE,99881,85793,DELHI-PUNE,185674,All
2022,1,DELHI,PUNE,54946,57907,DELHI-PUNE,112853,All
2022,2,DELHI,PUNE,75909,74534,DELHI-PUNE,150443,All
2022,3,DELHI,PUNE,99692,96075,DELHI-PUNE,195767,All
2022,4,DELHI,PUNE,93641,95295,DELHI-PUNE,188936,All
2022,5,DELHI,PUNE,107142,102917,DELHI-PUNE,210059,All
2022,6,DELHI,PUNE,98654,82302,DELHI-PUNE,180956,All
2022,7,DELHI,PUNE,88473,82655,DELHI-PUNE,171128,All
2022,8,DELHI,PUNE,101115,94019,DELHI-PUNE,195134,All
2022,9,DELHI,PUNE,95708,101652,DELHI-PUNE,197360,All
2022,10,DELHI,PUNE,91892,109085,DELHI-PUNE,200977,All
2022,11,DELHI,PUNE,116754,104822,DELHI-PUNE,221576,All
2022,12,DELHI,PUNE,124744,119862,DELHI-PUNE,244606,All
2023,1,DELHI,PUNE,118262,120180,DELHI-PUNE,238442,All
2023,2,DELHI,PUNE,117775,121304,DELHI-PUNE,239079,All
2023,3,DELHI,PUNE,121572,122112,DELHI-PUNE,243684,All
2023,4,DELHI,PUNE,121081,127791,DELHI-PUNE,248872,All
2023,5,DELHI,PUNE,113552,112066,DELHI-PUNE,225618,All
2023,6,DELHI,PUNE,116447,111182,DELHI-PUNE,227629,All
2023,7,DELHI,PUNE,120731,109572,DELHI-PUNE,230303,All
2023,8,DELHI,PUNE,120850,122363,DELHI-PUNE,243213,All
2023,9,DELHI,PUNE,118785,116240,DELHI-PUNE,235025,All
2023,10,DELHI,PUNE,112293,121003,DELHI-PUNE,233296,All
2023,11,DELHI,PUNE,106287,113905,DELHI-PUNE,220192,All
2023,12,DELHI,PUNE,122630,115946,DELHI-PUNE,238576,All
2024,1,DELHI,PUNE,113725,113497,DELHI-PUNE,227222,All
2024,2,DELHI,PUNE,113664,116998,DELHI-PUNE,230662,All
2024,3,DELHI,PUNE,121645,123334,DELHI-PUNE,244979,All
2024,4,DELHI,PUNE,118809,123871,DELHI-PUNE,242680,All
2024,6,DELHI,PUNE,127274,112743,DELHI-PUNE,240017,All
2024,7,DELHI,PUNE,123462,117729,DELHI-PUNE,241191,All
2024,8,DELHI,PUNE,119895,118496,DELHI-PUNE,238391,All
2024,9,DELHI,PUNE,115280,118046,DELHI-PUNE,233326,All
2024,10,DELHI,PUNE,113908,129527,DELHI-PUNE,243435,All
2024,11,DELHI,PUNE,125164,123018,DELHI-PUNE,248182,All
2024,12,DELHI,PUNE,134175,125760,DELHI-PUNE,259935,All
2025,1,DELHI,PUNE,124651,124066,DELHI-PUNE,248717,All
2025,2,DELHI,PUNE,110248,112173,DELHI-PUNE,222421,All
2025,3,DELHI,PUNE,126739,122769,DELHI-PUNE,249508,All
2015,4,DELHI,RAIPUR,13521,14476,DELHI-RAIPUR,27997,All
2015,5,DELHI,RAIPUR,16396,16908,DELHI-RAIPUR,33304,All
2015,6,DELHI,RAIPUR,15073,14224,DELHI-RAIPUR,29297,All
2015,7,DELHI,RAIPUR,13543,14139,DELHI-RAIPUR,27682,All
2015,8,DELHI,RAIPUR,12675,13326,DELHI-RAIPUR,26001,All
2015,9,DELHI,RAIPUR,12658,13374,DELHI-RAIPUR,26032,All
2015,10,DELHI,RAIPUR,19212,13274,DELHI-RAIPUR,32486,All
2015,11,DELHI,RAIPUR,16735,17066,DELHI-RAIPUR,33801,All
2015,12,DELHI,RAIPUR,18514,18701,DELHI-RAIPUR,37215,All
2016,1,DELHI,RAIPUR,16835,18218,DELHI-RAIPUR,35053,All
2016,2,DELHI,RAIPUR,16397,17216,DELHI-RAIPUR,33613,All
2016,3,DELHI,RAIPUR,17113,17726,DELHI-RAIPUR,34839,All
2016,4,DELHI,RAIPUR,19122,20038,DELHI-RAIPUR,39160,All
2016,5,DELHI,RAIPUR,22529,23153,DELHI-RAIPUR,45682,All
2016,6,DELHI,RAIPUR,22713,21356,DELHI-RAIPUR,44069,All
2016,7,DELHI,RAIPUR,21090,21749,DELHI-RAIPUR,42839,All
2016,8,DELHI,RAIPUR,19853,20021,DELHI-RAIPUR,39874,All
2016,9,DELHI,RAIPUR,18716,19532,DELHI-RAIPUR,38248,All
2016,10,DELHI,RAIPUR,20566,20660,DELHI-RAIPUR,41226,All
2016,11,DELHI,RAIPUR,20920,21800,DELHI-RAIPUR,42720,All
2016,12,DELHI,RAIPUR,22029,21028,DELHI-RAIPUR,43057,All
2017,1,DELHI,RAIPUR,19378,19866,DELHI-RAIPUR,39244,All
2017,2,DELHI,RAIPUR,19281,19556,DELHI-RAIPUR,38837,All
2017,3,DELHI,RAIPUR,20036,20652,DELHI-RAIPUR,40688,All
2017,4,DELHI,RAIPUR,13909,13835,DELHI-RAIPUR,27744,All
2017,5,DELHI,RAIPUR,14893,14968,DELHI-RAIPUR,29861,All
2017,6,DELHI,RAIPUR,13233,13042,DELHI-RAIPUR,26275,All
2017,7,DELHI,RAIPUR,18627,18891,DELHI-RAIPUR,37518,All
2017,8,DELHI,RAIPUR,21621,21949,DELHI-RAIPUR,43570,All
2017,9,DELHI,RAIPUR,20805,21674,DELHI-RAIPUR,42479,All
2017,10,DELHI,RAIPUR,22191,21610,DELHI-RAIPUR,43801,All
2017,11,DELHI,RAIPUR,27217,27250,DELHI-RAIPUR,54467,All
2017,12,DELHI,RAIPUR,31789,30553,DELHI-RAIPUR,62342,All
2018,1,DELHI,RAIPUR,29217,29551,DELHI-RAIPUR,58768,All
2018,2,DELHI,RAIPUR,28583,29401,DELHI-RAIPUR,57984,All
2018,3,DELHI,RAIPUR,31980,31671,DELHI-RAIPUR,63651,All
2018,4,DELHI,RAIPUR,30550,31406,DELHI-RAIPUR,61956,All
2018,5,DELHI,RAIPUR,30255,30602,DELHI-RAIPUR,60857,All
2018,6,DELHI,RAIPUR,30954,28412,DELHI-RAIPUR,59366,All
2018,7,DELHI,RAIPUR,31777,31926,DELHI-RAIPUR,63703,All
2018,8,DELHI,RAIPUR,30545,29733,DELHI-RAIPUR,60278,All
2018,9,DELHI,RAIPUR,30375,30108,DELHI-RAIPUR,60483,All
2018,10,DELHI,RAIPUR,31145,30658,DELHI-RAIPUR,61803,All
2018,11,DELHI,RAIPUR,25007,23807,DELHI-RAIPUR,48814,All
2018,12,DELHI,RAIPUR,30103,28278,DELHI-RAIPUR,58381,All
2019,1,DELHI,RAIPUR,27633,28557,DELHI-RAIPUR,56190,All
2019,2,DELHI,RAIPUR,21500,22005,DELHI-RAIPUR,43505,All
2019,3,DELHI,RAIPUR,23449,23322,DELHI-RAIPUR,46771,All
2019,4,DELHI,RAIPUR,27056,29252,DELHI-RAIPUR,56308,All
2019,5,DELHI,RAIPUR,32373,33138,DELHI-RAIPUR,65511,All
2019,6,DELHI,RAIPUR,34480,31488,DELHI-RAIPUR,65968,All
2019,7,DELHI,RAIPUR,32716,32261,DELHI-RAIPUR,64977,All
2019,8,DELHI,RAIPUR,34077,34011,DELHI-RAIPUR,68088,All
2019,9,DELHI,RAIPUR,32712,32619,DELHI-RAIPUR,65331,All
2019,10,DELHI,RAIPUR,32630,32196,DELHI-RAIPUR,64826,All
2019,11,DELHI,RAIPUR,34518,34365,DELHI-RAIPUR,68883,All
2019,12,DELHI,RAIPUR,33901,31941,DELHI-RAIPUR,65842,All
2020,1,DELHI,RAIPUR,30720,31690,DELHI-RAIPUR,62410,All
2020,2,DELHI,RAIPUR,30702,32402,DELHI-RAIPUR,63104,All
2020,3,DELHI,RAIPUR,22523,18228,DELHI-RAIPUR,40751,All
2020,5,DELHI,RAIPUR,2403,1291,DELHI-RAIPUR,3694,All
2020,6,DELHI,RAIPUR,11446,7858,DELHI-RAIPUR,19304,All
2020,7,DELHI,RAIPUR,8957,8426,DELHI-RAIPUR,17383,All
2020,8,DELHI,RAIPUR,12856,11986,DELHI-RAIPUR,24842,All
2020,9,DELHI,RAIPUR,13121,16341,DELHI-RAIPUR,29462,All
2020,10,DELHI,RAIPUR,21060,24408,DELHI-RAIPUR,45468,All
2020,11,DELHI,RAIPUR,27944,27823,DELHI-RAIPUR,55767,All
2020,12,DELHI,RAIPUR,31892,28869,DELHI-RAIPUR,60761,All
2021,1,DELHI,RAIPUR,28552,29332,DELHI-RAIPUR,57884,All
2021,2,DELHI,RAIPUR,29742,31931,DELHI-RAIPUR,61673,All
2021,3,DELHI,RAIPUR,28152,29626,DELHI-RAIPUR,57778,All
2021,4,DELHI,RAIPUR,15552,13674,DELHI-RAIPUR,29226,All
2021,6,DELHI,RAIPUR,13969,13874,DELHI-RAIPUR,27843,All
2021,7,DELHI,RAIPUR,22843,22935,DELHI-RAIPUR,45778,All
2021,8,DELHI,RAIPUR,24875,25926,DELHI-RAIPUR,50801,All
2021,9,DELHI,RAIPUR,23489,24983,DELHI-RAIPUR,48472,All
2021,10,DELHI,RAIPUR,29509,28542,DELHI-RAIPUR,58051,All
2021,11,DELHI,RAIPUR,32824,33721,DELHI-RAIPUR,66545,All
2021,12,DELHI,RAIPUR,34398,32082,DELHI-RAIPUR,66480,All
2022,1,DELHI,RAIPUR,17707,15364,DELHI-RAIPUR,33071,All
2022,2,DELHI,RAIPUR,22992,25385,DELHI-RAIPUR,48377,All
2022,3,DELHI,RAIPUR,32014,31772,DELHI-RAIPUR,63786,All
2022,4,DELHI,RAIPUR,29013,30305,DELHI-RAIPUR,59318,All
2022,5,DELHI,RAIPUR,30857,31726,DELHI-RAIPUR,62583,All
2022,6,DELHI,RAIPUR,33621,29961,DELHI-RAIPUR,63582,All
2022,7,DELHI,RAIPUR,27119,28087,DELHI-RAIPUR,55206,All
2022,8,DELHI,RAIPUR,27319,27588,DELHI-RAIPUR,54907,All
2022,9,DELHI,RAIPUR,27807,29770,DELHI-RAIPUR,57577,All
2022,10,DELHI,RAIPUR,31028,30043,DELHI-RAIPUR,61071,All
2022,11,DELHI,RAIPUR,29990,29432,DELHI-RAIPUR,59422,All
2022,12,DELHI,RAIPUR,34001,30588,DELHI-RAIPUR,64589,All
2023,1,DELHI,RAIPUR,27461,28831,DELHI-RAIPUR,56292,All
2023,2,DELHI,RAIPUR,29747,30603,DELHI-RAIPUR,60350,All
2023,3,DELHI,RAIPUR,32428,33036,DELHI-RAIPUR,65464,All
2023,4,DELHI,RAIPUR,30860,32112,DELHI-RAIPUR,62972,All
2023,5,DELHI,RAIPUR,33867,33745,DELHI-RAIPUR,67612,All
2023,6,DELHI,RAIPUR,31221,30489,DELHI-RAIPUR,61710,All
2023,7,DELHI,RAIPUR,30366,30077,DELHI-RAIPUR,60443,All
2023,8,DELHI,RAIPUR,30862,30915,DELHI-RAIPUR,61777,All
2023,9,DELHI,RAIPUR,31096,31429,DELHI-RAIPUR,62525,All
2023,10,DELHI,RAIPUR,32061,31536,DELHI-RAIPUR,63597,All
2023,11,DELHI,RAIPUR,31498,31383,DELHI-RAIPUR,62881,All
2023,12,DELHI,RAIPUR,35440,34390,DELHI-RAIPUR,69830,All
2024,1,DELHI,RAIPUR,31441,31985,DELHI-RAIPUR,63426,All
2024,2,DELHI,RAIPUR,30970,31021,DELHI-RAIPUR,61991,All
2024,3,DELHI,RAIPUR,32143,32491,DELHI-RAIPUR,64634,All
2024,4,DELHI,RAIPUR,32853,32989,DELHI-RAIPUR,65842,All
2024,6,DELHI,RAIPUR,31498,30419,DELHI-RAIPUR,61917,All
2024,7,DELHI,RAIPUR,32584,32632,DELHI-RAIPUR,65216,All
2024,8,DELHI,RAIPUR,32864,32665,DELHI-RAIPUR,65529,All
2024,9,DELHI,RAIPUR,32375,32462,DELHI-RAIPUR,64837,All
2024,10,DELHI,RAIPUR,32874,31337,DELHI-RAIPUR,64211,All
2024,11,DELHI,RAIPUR,33906,34578,DELHI-RAIPUR,68484,All
2024,12,DELHI,RAIPUR,35745,33850,DELHI-RAIPUR,69595,All
2025,1,DELHI,RAIPUR,30851,31028,DELHI-RAIPUR,61879,All
2025,2,DELHI,RAIPUR,32189,33466,DELHI-RAIPUR,65655,All
2025,3,DELHI,RAIPUR,33941,34355,DELHI-RAIPUR,68296,All
2024,12,DELHI,RAJAHMUNDRY,3516,2189,DELHI-RAJAHMUNDRY,5705,All
2025,1,DELHI,RAJAHMUNDRY,4061,4854,DELHI-RAJAHMUNDRY,8915,All
2025,2,DELHI,RAJAHMUNDRY,4117,4642,DELHI-RAJAHMUNDRY,8759,All
2025,3,DELHI,RAJAHMUNDRY,3716,3603,DELHI-RAJAHMUNDRY,7319,All
2015,4,DELHI,RAJKOT,1529,1697,DELHI-RAJKOT,3226,All
2015,5,DELHI,RAJKOT,1752,1788,DELHI-RAJKOT,3540,All
2015,6,DELHI,RAJKOT,1660,1460,DELHI-RAJKOT,3120,All
2015,7,DELHI,RAJKOT,1676,1437,DELHI-RAJKOT,3113,All
2015,8,DELHI,RAJKOT,1613,1472,DELHI-RAJKOT,3085,All
2015,9,DELHI,RAJKOT,1343,1226,DELHI-RAJKOT,2569,All
2015,10,DELHI,RAJKOT,1732,1636,DELHI-RAJKOT,3368,All
2015,11,DELHI,RAJKOT,1820,1792,DELHI-RAJKOT,3612,All
2015,12,DELHI,RAJKOT,1941,1793,DELHI-RAJKOT,3734,All
2016,1,DELHI,RAJKOT,1396,1595,DELHI-RAJKOT,2991,All
2016,2,DELHI,RAJKOT,1347,1497,DELHI-RAJKOT,2844,All
2016,3,DELHI,RAJKOT,1406,1587,DELHI-RAJKOT,2993,All
2016,4,DELHI,RAJKOT,1462,1559,DELHI-RAJKOT,3021,All
2016,5,DELHI,RAJKOT,1468,1506,DELHI-RAJKOT,2974,All
2016,6,DELHI,RAJKOT,815,665,DELHI-RAJKOT,1480,All
2016,7,DELHI,RAJKOT,906,882,DELHI-RAJKOT,1788,All
2016,8,DELHI,RAJKOT,1032,1138,DELHI-RAJKOT,2170,All
2016,9,DELHI,RAJKOT,856,881,DELHI-RAJKOT,1737,All
2016,10,DELHI,RAJKOT,902,1048,DELHI-RAJKOT,1950,All
2016,11,DELHI,RAJKOT,1430,1204,DELHI-RAJKOT,2634,All
2016,12,DELHI,RAJKOT,1290,1167,DELHI-RAJKOT,2457,All
2017,1,DELHI,RAJKOT,1143,1209,DELHI-RAJKOT,2352,All
2017,2,DELHI,RAJKOT,1074,1144,DELHI-RAJKOT,2218,All
2017,3,DELHI,RAJKOT,189,259,DELHI-RAJKOT,448,All
2017,4,DELHI,RAJKOT,801,805,DELHI-RAJKOT,1606,All
2017,5,DELHI,RAJKOT,1487,1241,DELHI-RAJKOT,2728,All
2017,6,DELHI,RAJKOT,3053,2163,DELHI-RAJKOT,5216,All
2017,7,DELHI,RAJKOT,2925,2936,DELHI-RAJKOT,5861,All
2017,8,DELHI,RAJKOT,2903,2601,DELHI-RAJKOT,5504,All
2017,9,DELHI,RAJKOT,2775,2560,DELHI-RAJKOT,5335,All
2017,10,DELHI,RAJKOT,2319,2475,DELHI-RAJKOT,4794,All
2017,11,DELHI,RAJKOT,3111,2476,DELHI-RAJKOT,5587,All
2017,12,DELHI,RAJKOT,3615,2876,DELHI-RAJKOT,6491,All
2018,1,DELHI,RAJKOT,3503,3118,DELHI-RAJKOT,6621,All
2018,2,DELHI,RAJKOT,2947,2782,DELHI-RAJKOT,5729,All
2018,3,DELHI,RAJKOT,2984,2911,DELHI-RAJKOT,5895,All
2018,4,DELHI,RAJKOT,2720,2890,DELHI-RAJKOT,5610,All
2018,5,DELHI,RAJKOT,2882,2923,DELHI-RAJKOT,5805,All
2018,6,DELHI,RAJKOT,2991,2617,DELHI-RAJKOT,5608,All
2018,7,DELHI,RAJKOT,2916,2701,DELHI-RAJKOT,5617,All
2018,8,DELHI,RAJKOT,3182,3143,DELHI-RAJKOT,6325,All
2018,9,DELHI,RAJKOT,3311,3151,DELHI-RAJKOT,6462,All
2018,10,DELHI,RAJKOT,3498,3417,DELHI-RAJKOT,6915,All
2018,11,DELHI,RAJKOT,2664,2938,DELHI-RAJKOT,5602,All
2018,12,DELHI,RAJKOT,3552,3342,DELHI-RAJKOT,6894,All
2019,1,DELHI,RAJKOT,3464,3557,DELHI-RAJKOT,7021,All
2019,2,DELHI,RAJKOT,3161,3184,DELHI-RAJKOT,6345,All
2019,3,DELHI,RAJKOT,3417,3428,DELHI-RAJKOT,6845,All
2019,4,DELHI,RAJKOT,3112,3280,DELHI-RAJKOT,6392,All
2019,5,DELHI,RAJKOT,3395,3460,DELHI-RAJKOT,6855,All
2019,6,DELHI,RAJKOT,3339,2843,DELHI-RAJKOT,6182,All
2019,7,DELHI,RAJKOT,3309,3115,DELHI-RAJKOT,6424,All
2019,8,DELHI,RAJKOT,4396,4356,DELHI-RAJKOT,8752,All
2019,9,DELHI,RAJKOT,5002,4695,DELHI-RAJKOT,9697,All
2019,10,DELHI,RAJKOT,4473,5114,DELHI-RAJKOT,9587,All
2019,11,DELHI,RAJKOT,6450,4847,DELHI-RAJKOT,11297,All
2019,12,DELHI,RAJKOT,6255,5600,DELHI-RAJKOT,11855,All
2020,1,DELHI,RAJKOT,4204,4131,DELHI-RAJKOT,8335,All
2020,2,DELHI,RAJKOT,4065,3958,DELHI-RAJKOT,8023,All
2020,3,DELHI,RAJKOT,2234,2279,DELHI-RAJKOT,4513,All
2020,7,DELHI,RAJKOT,318,206,DELHI-RAJKOT,524,All
2020,8,DELHI,RAJKOT,682,484,DELHI-RAJKOT,1166,All
2020,9,DELHI,RAJKOT,1668,1572,DELHI-RAJKOT,3240,All
2020,10,DELHI,RAJKOT,3462,3275,DELHI-RAJKOT,6737,All
2020,11,DELHI,RAJKOT,4242,4096,DELHI-RAJKOT,8338,All
2020,12,DELHI,RAJKOT,5102,4278,DELHI-RAJKOT,9380,All
2021,1,DELHI,RAJKOT,5421,5267,DELHI-RAJKOT,10688,All
2021,2,DELHI,RAJKOT,6906,6701,DELHI-RAJKOT,13607,All
2021,3,DELHI,RAJKOT,7607,7873,DELHI-RAJKOT,15480,All
2021,4,DELHI,RAJKOT,3837,4450,DELHI-RAJKOT,8287,All
2021,6,DELHI,RAJKOT,1841,1798,DELHI-RAJKOT,3639,All
2021,7,DELHI,RAJKOT,4479,4365,DELHI-RAJKOT,8844,All
2021,8,DELHI,RAJKOT,6478,6701,DELHI-RAJKOT,13179,All
2021,9,DELHI,RAJKOT,7197,6980,DELHI-RAJKOT,14177,All
2021,10,DELHI,RAJKOT,8768,9549,DELHI-RAJKOT,18317,All
2021,11,DELHI,RAJKOT,9504,9646,DELHI-RAJKOT,19150,All
2021,12,DELHI,RAJKOT,9675,9197,DELHI-RAJKOT,18872,All
2022,1,DELHI,RAJKOT,5455,6041,DELHI-RAJKOT,11496,All
2022,2,DELHI,RAJKOT,7967,8570,DELHI-RAJKOT,16537,All
2022,3,DELHI,RAJKOT,10655,10878,DELHI-RAJKOT,21533,All
2022,4,DELHI,RAJKOT,12047,13758,DELHI-RAJKOT,25805,All
2022,5,DELHI,RAJKOT,13847,14405,DELHI-RAJKOT,28252,All
2022,6,DELHI,RAJKOT,13044,11319,DELHI-RAJKOT,24363,All
2022,7,DELHI,RAJKOT,9444,9772,DELHI-RAJKOT,19216,All
2022,8,DELHI,RAJKOT,12236,12378,DELHI-RAJKOT,24614,All
2022,9,DELHI,RAJKOT,13451,13702,DELHI-RAJKOT,27153,All
2022,10,DELHI,RAJKOT,12442,13811,DELHI-RAJKOT,26253,All
2022,11,DELHI,RAJKOT,15011,12625,DELHI-RAJKOT,27636,All
2022,12,DELHI,RAJKOT,15627,14497,DELHI-RAJKOT,30124,All
2023,1,DELHI,RAJKOT,15600,15740,DELHI-RAJKOT,31340,All
2023,2,DELHI,RAJKOT,13760,14074,DELHI-RAJKOT,27834,All
2023,3,DELHI,RAJKOT,13819,13512,DELHI-RAJKOT,27331,All
2023,4,DELHI,RAJKOT,10521,10553,DELHI-RAJKOT,21074,All
2023,5,DELHI,RAJKOT,11134,11036,DELHI-RAJKOT,22170,All
2023,6,DELHI,RAJKOT,9808,8649,DELHI-RAJKOT,18457,All
2023,7,DELHI,RAJKOT,10423,8963,DELHI-RAJKOT,19386,All
2023,8,DELHI,RAJKOT,10440,9404,DELHI-RAJKOT,19844,All
2023,9,DELHI,RAJKOT,2539,2467,DELHI-RAJKOT,5006,All
2015,4,DELHI,RANCHI,16183,15314,DELHI-RANCHI,31497,All
2015,5,DELHI,RANCHI,16805,16362,DELHI-RANCHI,33167,All
2015,6,DELHI,RANCHI,18155,16687,DELHI-RANCHI,34842,All
2015,7,DELHI,RANCHI,16583,16161,DELHI-RANCHI,32744,All
2015,8,DELHI,RANCHI,14115,14065,DELHI-RANCHI,28180,All
2015,9,DELHI,RANCHI,15394,14471,DELHI-RANCHI,29865,All
2015,10,DELHI,RANCHI,15179,11460,DELHI-RANCHI,26639,All
2015,11,DELHI,RANCHI,17321,15726,DELHI-RANCHI,33047,All
2015,12,DELHI,RANCHI,22206,19762,DELHI-RANCHI,41968,All
2016,1,DELHI,RANCHI,19692,18709,DELHI-RANCHI,38401,All
2016,2,DELHI,RANCHI,16617,15556,DELHI-RANCHI,32173,All
2016,3,DELHI,RANCHI,16935,15976,DELHI-RANCHI,32911,All
2016,4,DELHI,RANCHI,17083,16586,DELHI-RANCHI,33669,All
2016,5,DELHI,RANCHI,20969,19899,DELHI-RANCHI,40868,All
2016,6,DELHI,RANCHI,21858,18700,DELHI-RANCHI,40558,All
2016,7,DELHI,RANCHI,22408,21948,DELHI-RANCHI,44356,All
2016,8,DELHI,RANCHI,21470,21368,DELHI-RANCHI,42838,All
2016,9,DELHI,RANCHI,22057,20448,DELHI-RANCHI,42505,All
2016,10,DELHI,RANCHI,31885,24924,DELHI-RANCHI,56809,All
2016,11,DELHI,RANCHI,31576,31561,DELHI-RANCHI,63137,All
2016,12,DELHI,RANCHI,37063,32954,DELHI-RANCHI,70017,All
2017,1,DELHI,RANCHI,33795,31409,DELHI-RANCHI,65204,All
2017,2,DELHI,RANCHI,30243,28307,DELHI-RANCHI,58550,All
2017,3,DELHI,RANCHI,33951,31091,DELHI-RANCHI,65042,All
2017,4,DELHI,RANCHI,34796,29893,DELHI-RANCHI,64689,All
2017,5,DELHI,RANCHI,43675,39609,DELHI-RANCHI,83284,All
2017,6,DELHI,RANCHI,41055,36437,DELHI-RANCHI,77492,All
2017,7,DELHI,RANCHI,35293,34675,DELHI-RANCHI,69968,All
2017,8,DELHI,RANCHI,38402,34141,DELHI-RANCHI,72543,All
2017,9,DELHI,RANCHI,35544,33171,DELHI-RANCHI,68715,All
2017,10,DELHI,RANCHI,41991,37634,DELHI-RANCHI,79625,All
2017,11,DELHI,RANCHI,46843,42615,DELHI-RANCHI,89458,All
2017,12,DELHI,RANCHI,54160,48616,DELHI-RANCHI,102776,All
2018,1,DELHI,RANCHI,49152,47271,DELHI-RANCHI,96423,All
2018,2,DELHI,RANCHI,49222,45701,DELHI-RANCHI,94923,All
2018,3,DELHI,RANCHI,52220,49978,DELHI-RANCHI,102198,All
2018,4,DELHI,RANCHI,52317,45515,DELHI-RANCHI,97832,All
2018,5,DELHI,RANCHI,49812,47187,DELHI-RANCHI,96999,All
2018,6,DELHI,RANCHI,58621,45438,DELHI-RANCHI,104059,All
2018,7,DELHI,RANCHI,55745,47209,DELHI-RANCHI,102954,All
2018,8,DELHI,RANCHI,44298,40797,DELHI-RANCHI,85095,All
2018,9,DELHI,RANCHI,44173,41783,DELHI-RANCHI,85956,All
2018,10,DELHI,RANCHI,46095,43191,DELHI-RANCHI,89286,All
2018,11,DELHI,RANCHI,42499,40748,DELHI-RANCHI,83247,All
2018,12,DELHI,RANCHI,54283,49325,DELHI-RANCHI,103608,All
2019,1,DELHI,RANCHI,47389,48948,DELHI-RANCHI,96337,All
2019,2,DELHI,RANCHI,44673,44906,DELHI-RANCHI,89579,All
2019,3,DELHI,RANCHI,49410,47685,DELHI-RANCHI,97095,All
2019,4,DELHI,RANCHI,43707,39441,DELHI-RANCHI,83148,All
2019,5,DELHI,RANCHI,51972,47043,DELHI-RANCHI,99015,All
2019,6,DELHI,RANCHI,57592,53135,DELHI-RANCHI,110727,All
2019,7,DELHI,RANCHI,54328,53575,DELHI-RANCHI,107903,All
2019,8,DELHI,RANCHI,54460,52271,DELHI-RANCHI,106731,All
2019,9,DELHI,RANCHI,53016,51086,DELHI-RANCHI,104102,All
2019,10,DELHI,RANCHI,58957,49947,DELHI-RANCHI,108904,All
2019,11,DELHI,RANCHI,58081,56867,DELHI-RANCHI,114948,All
2019,12,DELHI,RANCHI,54193,47736,DELHI-RANCHI,101929,All
2020,1,DELHI,RANCHI,44964,47621,DELHI-RANCHI,92585,All
2020,2,DELHI,RANCHI,49525,51043,DELHI-RANCHI,100568,All
2020,3,DELHI,RANCHI,40431,31187,DELHI-RANCHI,71618,All
2020,5,DELHI,RANCHI,3335,1116,DELHI-RANCHI,4451,All
2020,6,DELHI,RANCHI,21044,8416,DELHI-RANCHI,29460,All
2020,7,DELHI,RANCHI,16719,10880,DELHI-RANCHI,27599,All
2020,8,DELHI,RANCHI,16866,21601,DELHI-RANCHI,38467,All
2020,9,DELHI,RANCHI,19055,26585,DELHI-RANCHI,45640,All
2020,10,DELHI,RANCHI,27512,29120,DELHI-RANCHI,56632,All
2020,11,DELHI,RANCHI,32705,30833,DELHI-RANCHI,63538,All
2020,12,DELHI,RANCHI,41398,35925,DELHI-RANCHI,77323,All
2021,1,DELHI,RANCHI,31210,39018,DELHI-RANCHI,70228,All
2021,2,DELHI,RANCHI,31301,35304,DELHI-RANCHI,66605,All
2021,3,DELHI,RANCHI,37109,32728,DELHI-RANCHI,69837,All
2021,4,DELHI,RANCHI,33253,22323,DELHI-RANCHI,55576,All
2021,6,DELHI,RANCHI,14503,17903,DELHI-RANCHI,32406,All
2021,7,DELHI,RANCHI,23607,25641,DELHI-RANCHI,49248,All
2021,8,DELHI,RANCHI,31164,32449,DELHI-RANCHI,63613,All
2021,9,DELHI,RANCHI,30050,30890,DELHI-RANCHI,60940,All
2021,10,DELHI,RANCHI,43046,38100,DELHI-RANCHI,81146,All
2021,11,DELHI,RANCHI,51185,47874,DELHI-RANCHI,99059,All
2021,12,DELHI,RANCHI,47180,44956,DELHI-RANCHI,92136,All
2022,1,DELHI,RANCHI,25945,22828,DELHI-RANCHI,48773,All
2022,2,DELHI,RANCHI,35389,37582,DELHI-RANCHI,72971,All
2022,3,DELHI,RANCHI,42839,41057,DELHI-RANCHI,83896,All
2022,4,DELHI,RANCHI,41238,35518,DELHI-RANCHI,76756,All
2022,5,DELHI,RANCHI,38140,38333,DELHI-RANCHI,76473,All
2022,6,DELHI,RANCHI,40002,35915,DELHI-RANCHI,75917,All
2022,7,DELHI,RANCHI,30695,31623,DELHI-RANCHI,62318,All
2022,8,DELHI,RANCHI,30669,31540,DELHI-RANCHI,62209,All
2022,9,DELHI,RANCHI,29545,28469,DELHI-RANCHI,58014,All
2022,10,DELHI,RANCHI,42418,36422,DELHI-RANCHI,78840,All
2022,11,DELHI,RANCHI,34489,39498,DELHI-RANCHI,73987,All
2022,12,DELHI,RANCHI,45124,41624,DELHI-RANCHI,86748,All
2023,1,DELHI,RANCHI,38660,42896,DELHI-RANCHI,81556,All
2023,2,DELHI,RANCHI,42264,43717,DELHI-RANCHI,85981,All
2023,3,DELHI,RANCHI,39492,39141,DELHI-RANCHI,78633,All
2023,4,DELHI,RANCHI,45030,44763,DELHI-RANCHI,89793,All
2023,5,DELHI,RANCHI,39193,38824,DELHI-RANCHI,78017,All
2023,6,DELHI,RANCHI,38357,37754,DELHI-RANCHI,76111,All
2023,7,DELHI,RANCHI,35257,40469,DELHI-RANCHI,75726,All
2023,8,DELHI,RANCHI,37373,41976,DELHI-RANCHI,79349,All
2023,9,DELHI,RANCHI,35746,38676,DELHI-RANCHI,74422,All
2023,10,DELHI,RANCHI,44518,39522,DELHI-RANCHI,84040,All
2023,11,DELHI,RANCHI,39838,34565,DELHI-RANCHI,74403,All
2023,12,DELHI,RANCHI,42162,40366,DELHI-RANCHI,82528,All
2024,1,DELHI,RANCHI,36184,36519,DELHI-RANCHI,72703,All
2024,2,DELHI,RANCHI,37492,37449,DELHI-RANCHI,74941,All
2024,3,DELHI,RANCHI,41943,38479,DELHI-RANCHI,80422,All
2024,4,DELHI,RANCHI,39009,36052,DELHI-RANCHI,75061,All
2024,6,DELHI,RANCHI,40028,35641,DELHI-RANCHI,75669,All
2024,7,DELHI,RANCHI,37688,38692,DELHI-RANCHI,76380,All
2024,8,DELHI,RANCHI,37546,37345,DELHI-RANCHI,74891,All
2024,9,DELHI,RANCHI,36097,33485,DELHI-RANCHI,69582,All
2024,10,DELHI,RANCHI,42716,36729,DELHI-RANCHI,79445,All
2024,11,DELHI,RANCHI,44144,42874,DELHI-RANCHI,87018,All
2024,12,DELHI,RANCHI,44830,42528,DELHI-RANCHI,87358,All
2025,1,DELHI,RANCHI,40297,41115,DELHI-RANCHI,81412,All
2025,2,DELHI,RANCHI,38920,38841,DELHI-RANCHI,77761,All
2025,3,DELHI,RANCHI,42853,41437,DELHI-RANCHI,84290,All
2023,11,DELHI,Rajkot International Airport,9515,9558,DELHI-Rajkot International Airport,19073,All
2023,12,DELHI,Rajkot International Airport,10627,9709,DELHI-Rajkot International Airport,20336,All
2024,1,DELHI,Rajkot International Airport,9917,9803,DELHI-Rajkot International Airport,19720,All
2024,2,DELHI,Rajkot International Airport,8982,8925,DELHI-Rajkot International Airport,17907,All
2024,3,DELHI,Rajkot International Airport,8490,8746,DELHI-Rajkot International Airport,17236,All
2024,4,DELHI,Rajkot International Airport,9716,9990,DELHI-Rajkot International Airport,19706,All
2024,6,DELHI,Rajkot International Airport,10102,8120,DELHI-Rajkot International Airport,18222,All
2024,7,DELHI,Rajkot International Airport,8919,7552,DELHI-Rajkot International Airport,16471,All
2024,8,DELHI,Rajkot International Airport,8798,8791,DELHI-Rajkot International Airport,17589,All
2024,9,DELHI,Rajkot International Airport,8446,8286,DELHI-Rajkot International Airport,16732,All
2024,10,DELHI,Rajkot International Airport,8145,8614,DELHI-Rajkot International Airport,16759,All
2024,11,DELHI,Rajkot International Airport,9946,9326,DELHI-Rajkot International Airport,19272,All
2024,12,DELHI,Rajkot International Airport,9913,9590,DELHI-Rajkot International Airport,19503,All
2025,1,DELHI,Rajkot International Airport,10633,10789,DELHI-Rajkot International Airport,21422,All
2025,2,DELHI,Rajkot International Airport,9033,9416,DELHI-Rajkot International Airport,18449,All
2025,3,DELHI,Rajkot International Airport,10049,9604,DELHI-Rajkot International Airport,19653,All
2022,5,DELHI,SHILLONG,296,188,DELHI-SHILLONG,484,All
2022,6,DELHI,SHILLONG,47,48,DELHI-SHILLONG,95,All
2023,2,DELHI,SHILLONG,69,38,DELHI-SHILLONG,107,All
2023,3,DELHI,SHILLONG,632,472,DELHI-SHILLONG,1104,All
2023,4,DELHI,SHILLONG,633,595,DELHI-SHILLONG,1228,All
2023,5,DELHI,SHILLONG,714,692,DELHI-SHILLONG,1406,All
2023,6,DELHI,SHILLONG,703,690,DELHI-SHILLONG,1393,All
2023,7,DELHI,SHILLONG,671,556,DELHI-SHILLONG,1227,All
2023,8,DELHI,SHILLONG,403,409,DELHI-SHILLONG,812,All
2023,9,DELHI,SHILLONG,487,448,DELHI-SHILLONG,935,All
2023,10,DELHI,SHILLONG,638,541,DELHI-SHILLONG,1179,All
2023,11,DELHI,SHILLONG,636,621,DELHI-SHILLONG,1257,All
2023,12,DELHI,SHILLONG,714,714,DELHI-SHILLONG,1428,All
2024,1,DELHI,SHILLONG,702,702,DELHI-SHILLONG,1404,All
2024,2,DELHI,SHILLONG,606,577,DELHI-SHILLONG,1183,All
2024,3,DELHI,SHILLONG,720,668,DELHI-SHILLONG,1388,All
2024,4,DELHI,SHILLONG,798,588,DELHI-SHILLONG,1386,All
2024,6,DELHI,SHILLONG,627,523,DELHI-SHILLONG,1150,All
2024,7,DELHI,SHILLONG,693,658,DELHI-SHILLONG,1351,All
2024,8,DELHI,SHILLONG,445,470,DELHI-SHILLONG,915,All
2024,9,DELHI,SHILLONG,502,338,DELHI-SHILLONG,840,All
2024,10,DELHI,SHILLONG,579,537,DELHI-SHILLONG,1116,All
2024,11,DELHI,SHILLONG,633,536,DELHI-SHILLONG,1169,All
2024,12,DELHI,SHILLONG,618,561,DELHI-SHILLONG,1179,All
2025,1,DELHI,SHILLONG,616,611,DELHI-SHILLONG,1227,All
2025,2,DELHI,SHILLONG,602,449,DELHI-SHILLONG,1051,All
2025,3,DELHI,SHILLONG,785,555,DELHI-SHILLONG,1340,All
2018,2,DELHI,SHIRDI,0,57,DELHI-SHIRDI,57,All
2018,10,DELHI,SHIRDI,4469,4605,DELHI-SHIRDI,9074,All
2018,11,DELHI,SHIRDI,5596,5566,DELHI-SHIRDI,11162,All
2018,12,DELHI,SHIRDI,5784,5698,DELHI-SHIRDI,11482,All
2019,1,DELHI,SHIRDI,5821,5828,DELHI-SHIRDI,11649,All
2019,2,DELHI,SHIRDI,5289,5284,DELHI-SHIRDI,10573,All
2019,3,DELHI,SHIRDI,8679,8680,DELHI-SHIRDI,17359,All
2019,4,DELHI,SHIRDI,9653,10215,DELHI-SHIRDI,19868,All
2019,5,DELHI,SHIRDI,10130,10505,DELHI-SHIRDI,20635,All
2019,6,DELHI,SHIRDI,10035,9668,DELHI-SHIRDI,19703,All
2019,7,DELHI,SHIRDI,10316,10617,DELHI-SHIRDI,20933,All
2019,8,DELHI,SHIRDI,10836,11171,DELHI-SHIRDI,22007,All
2019,9,DELHI,SHIRDI,10309,10863,DELHI-SHIRDI,21172,All
2019,10,DELHI,SHIRDI,8464,9518,DELHI-SHIRDI,17982,All
2019,11,DELHI,SHIRDI,4514,4123,DELHI-SHIRDI,8637,All
2019,12,DELHI,SHIRDI,2607,2378,DELHI-SHIRDI,4985,All
2020,1,DELHI,SHIRDI,5822,5823,DELHI-SHIRDI,11645,All
2020,2,DELHI,SHIRDI,12693,12410,DELHI-SHIRDI,25103,All
2020,3,DELHI,SHIRDI,7610,8458,DELHI-SHIRDI,16068,All
2020,7,DELHI,SHIRDI,198,155,DELHI-SHIRDI,353,All
2020,8,DELHI,SHIRDI,41,14,DELHI-SHIRDI,55,All
2020,10,DELHI,SHIRDI,94,76,DELHI-SHIRDI,170,All
2020,11,DELHI,SHIRDI,383,333,DELHI-SHIRDI,716,All
2020,12,DELHI,SHIRDI,2391,1812,DELHI-SHIRDI,4203,All
2021,1,DELHI,SHIRDI,4253,4683,DELHI-SHIRDI,8936,All
2021,2,DELHI,SHIRDI,3895,4091,DELHI-SHIRDI,7986,All
2021,3,DELHI,SHIRDI,3190,3394,DELHI-SHIRDI,6584,All
2021,4,DELHI,SHIRDI,1070,989,DELHI-SHIRDI,2059,All
2021,10,DELHI,SHIRDI,2324,2671,DELHI-SHIRDI,4995,All
2021,11,DELHI,SHIRDI,6586,6174,DELHI-SHIRDI,12760,All
2021,12,DELHI,SHIRDI,8679,7527,DELHI-SHIRDI,16206,All
2022,1,DELHI,SHIRDI,1686,2118,DELHI-SHIRDI,3804,All
2022,2,DELHI,SHIRDI,4235,3930,DELHI-SHIRDI,8165,All
2022,3,DELHI,SHIRDI,7785,7864,DELHI-SHIRDI,15649,All
2022,4,DELHI,SHIRDI,9703,9647,DELHI-SHIRDI,19350,All
2022,5,DELHI,SHIRDI,9633,9502,DELHI-SHIRDI,19135,All
2022,6,DELHI,SHIRDI,10187,9193,DELHI-SHIRDI,19380,All
2022,7,DELHI,SHIRDI,8805,8666,DELHI-SHIRDI,17471,All
2022,8,DELHI,SHIRDI,10005,9586,DELHI-SHIRDI,19591,All
2022,9,DELHI,SHIRDI,9014,8957,DELHI-SHIRDI,17971,All
2022,10,DELHI,SHIRDI,9192,9849,DELHI-SHIRDI,19041,All
2022,11,DELHI,SHIRDI,9812,8851,DELHI-SHIRDI,18663,All
2022,12,DELHI,SHIRDI,11107,10180,DELHI-SHIRDI,21287,All
2023,1,DELHI,SHIRDI,10072,10269,DELHI-SHIRDI,20341,All
2023,2,DELHI,SHIRDI,9584,9453,DELHI-SHIRDI,19037,All
2023,3,DELHI,SHIRDI,12008,11350,DELHI-SHIRDI,23358,All
2023,4,DELHI,SHIRDI,9772,10356,DELHI-SHIRDI,20128,All
2023,5,DELHI,SHIRDI,9111,9283,DELHI-SHIRDI,18394,All
2023,6,DELHI,SHIRDI,7643,6672,DELHI-SHIRDI,14315,All
2023,7,DELHI,SHIRDI,7436,7283,DELHI-SHIRDI,14719,All
2023,8,DELHI,SHIRDI,10436,10192,DELHI-SHIRDI,20628,All
2023,9,DELHI,SHIRDI,10691,10328,DELHI-SHIRDI,21019,All
2023,10,DELHI,SHIRDI,9797,10359,DELHI-SHIRDI,20156,All
2023,11,DELHI,SHIRDI,11089,11404,DELHI-SHIRDI,22493,All
2023,12,DELHI,SHIRDI,12416,12383,DELHI-SHIRDI,24799,All
2024,1,DELHI,SHIRDI,11904,12200,DELHI-SHIRDI,24104,All
2024,2,DELHI,SHIRDI,10533,10835,DELHI-SHIRDI,21368,All
2024,3,DELHI,SHIRDI,11767,11622,DELHI-SHIRDI,23389,All
2024,4,DELHI,SHIRDI,9628,10204,DELHI-SHIRDI,19832,All
2024,6,DELHI,SHIRDI,8560,7740,DELHI-SHIRDI,16300,All
2024,7,DELHI,SHIRDI,10019,9647,DELHI-SHIRDI,19666,All
2024,8,DELHI,SHIRDI,10312,9785,DELHI-SHIRDI,20097,All
2024,9,DELHI,SHIRDI,7344,7366,DELHI-SHIRDI,14710,All
2024,10,DELHI,SHIRDI,6183,6965,DELHI-SHIRDI,13148,All
2024,11,DELHI,SHIRDI,10684,8991,DELHI-SHIRDI,19675,All
2024,12,DELHI,SHIRDI,11755,10395,DELHI-SHIRDI,22150,All
2025,1,DELHI,SHIRDI,11034,11154,DELHI-SHIRDI,22188,All
2025,2,DELHI,SHIRDI,9753,9952,DELHI-SHIRDI,19705,All
2025,3,DELHI,SHIRDI,11257,10888,DELHI-SHIRDI,22145,All
2017,7,DELHI,SILCHAR,385,339,DELHI-SILCHAR,724,All
2017,8,DELHI,SILCHAR,771,775,DELHI-SILCHAR,1546,All
2017,9,DELHI,SILCHAR,814,672,DELHI-SILCHAR,1486,All
2017,10,DELHI,SILCHAR,741,651,DELHI-SILCHAR,1392,All
2017,11,DELHI,SILCHAR,1109,859,DELHI-SILCHAR,1968,All
2017,12,DELHI,SILCHAR,1358,952,DELHI-SILCHAR,2310,All
2018,1,DELHI,SILCHAR,863,728,DELHI-SILCHAR,1591,All
2018,2,DELHI,SILCHAR,871,697,DELHI-SILCHAR,1568,All
2018,3,DELHI,SILCHAR,1113,869,DELHI-SILCHAR,1982,All
2018,4,DELHI,SILCHAR,1955,1905,DELHI-SILCHAR,3860,All
2018,5,DELHI,SILCHAR,2515,1526,DELHI-SILCHAR,4041,All
2018,6,DELHI,SILCHAR,2187,2178,DELHI-SILCHAR,4365,All
2018,7,DELHI,SILCHAR,2045,1965,DELHI-SILCHAR,4010,All
2018,8,DELHI,SILCHAR,1726,1412,DELHI-SILCHAR,3138,All
2018,9,DELHI,SILCHAR,1244,1318,DELHI-SILCHAR,2562,All
2018,10,DELHI,SILCHAR,2552,2547,DELHI-SILCHAR,5099,All
2018,11,DELHI,SILCHAR,3045,2772,DELHI-SILCHAR,5817,All
2018,12,DELHI,SILCHAR,3086,2532,DELHI-SILCHAR,5618,All
2019,1,DELHI,SILCHAR,2501,2424,DELHI-SILCHAR,4925,All
2019,2,DELHI,SILCHAR,1702,1679,DELHI-SILCHAR,3381,All
2019,3,DELHI,SILCHAR,1690,1433,DELHI-SILCHAR,3123,All
2019,4,DELHI,SILCHAR,830,1117,DELHI-SILCHAR,1947,All
2019,5,DELHI,SILCHAR,835,1127,DELHI-SILCHAR,1962,All
2019,6,DELHI,SILCHAR,1370,1412,DELHI-SILCHAR,2782,All
2019,7,DELHI,SILCHAR,1320,1569,DELHI-SILCHAR,2889,All
2019,8,DELHI,SILCHAR,1726,1856,DELHI-SILCHAR,3582,All
2019,9,DELHI,SILCHAR,1839,1773,DELHI-SILCHAR,3612,All
2019,10,DELHI,SILCHAR,1340,1476,DELHI-SILCHAR,2816,All
2019,11,DELHI,SILCHAR,1861,1660,DELHI-SILCHAR,3521,All
2019,12,DELHI,SILCHAR,1634,2266,DELHI-SILCHAR,3900,All
2020,1,DELHI,SILCHAR,1785,1424,DELHI-SILCHAR,3209,All
2020,2,DELHI,SILCHAR,1650,1625,DELHI-SILCHAR,3275,All
2020,3,DELHI,SILCHAR,1018,837,DELHI-SILCHAR,1855,All
2020,5,DELHI,SILCHAR,120,102,DELHI-SILCHAR,222,All
2020,6,DELHI,SILCHAR,1778,1627,DELHI-SILCHAR,3405,All
2020,7,DELHI,SILCHAR,1466,1336,DELHI-SILCHAR,2802,All
2020,8,DELHI,SILCHAR,2035,1703,DELHI-SILCHAR,3738,All
2020,9,DELHI,SILCHAR,2002,1619,DELHI-SILCHAR,3621,All
2020,10,DELHI,SILCHAR,2324,2093,DELHI-SILCHAR,4417,All
2020,11,DELHI,SILCHAR,2824,2876,DELHI-SILCHAR,5700,All
2020,12,DELHI,SILCHAR,3467,2201,DELHI-SILCHAR,5668,All
2021,1,DELHI,SILCHAR,2674,2347,DELHI-SILCHAR,5021,All
2021,2,DELHI,SILCHAR,2613,2648,DELHI-SILCHAR,5261,All
2021,3,DELHI,SILCHAR,2514,2683,DELHI-SILCHAR,5197,All
2021,4,DELHI,SILCHAR,1582,1698,DELHI-SILCHAR,3280,All
2021,9,DELHI,SILCHAR,1167,1060,DELHI-SILCHAR,2227,All
2021,10,DELHI,SILCHAR,1072,1243,DELHI-SILCHAR,2315,All
2021,11,DELHI,SILCHAR,1903,1871,DELHI-SILCHAR,3774,All
2021,12,DELHI,SILCHAR,1828,1816,DELHI-SILCHAR,3644,All
2022,1,DELHI,SILCHAR,1503,1359,DELHI-SILCHAR,2862,All
2022,2,DELHI,SILCHAR,1110,739,DELHI-SILCHAR,1849,All
2022,3,DELHI,SILCHAR,1317,1339,DELHI-SILCHAR,2656,All
2022,4,DELHI,SILCHAR,1763,1662,DELHI-SILCHAR,3425,All
2022,5,DELHI,SILCHAR,1744,2028,DELHI-SILCHAR,3772,All
2022,6,DELHI,SILCHAR,1937,1840,DELHI-SILCHAR,3777,All
2022,7,DELHI,SILCHAR,2332,2335,DELHI-SILCHAR,4667,All
2022,8,DELHI,SILCHAR,1974,2011,DELHI-SILCHAR,3985,All
2022,9,DELHI,SILCHAR,1967,1602,DELHI-SILCHAR,3569,All
2022,10,DELHI,SILCHAR,2002,2343,DELHI-SILCHAR,4345,All
2022,11,DELHI,SILCHAR,1667,1402,DELHI-SILCHAR,3069,All
2022,12,DELHI,SILCHAR,1351,1584,DELHI-SILCHAR,2935,All
2023,1,DELHI,SILCHAR,1418,1388,DELHI-SILCHAR,2806,All
2023,2,DELHI,SILCHAR,1029,1077,DELHI-SILCHAR,2106,All
2023,3,DELHI,SILCHAR,658,808,DELHI-SILCHAR,1466,All
2023,4,DELHI,SILCHAR,619,726,DELHI-SILCHAR,1345,All
2023,5,DELHI,SILCHAR,642,527,DELHI-SILCHAR,1169,All
2023,6,DELHI,SILCHAR,569,208,DELHI-SILCHAR,777,All
2023,7,DELHI,SILCHAR,411,361,DELHI-SILCHAR,772,All
2023,8,DELHI,SILCHAR,419,377,DELHI-SILCHAR,796,All
2023,9,DELHI,SILCHAR,409,314,DELHI-SILCHAR,723,All
2023,10,DELHI,SILCHAR,503,392,DELHI-SILCHAR,895,All
2023,11,DELHI,SILCHAR,37,449,DELHI-SILCHAR,486,All
2023,12,DELHI,SILCHAR,1025,668,DELHI-SILCHAR,1693,All
2024,1,DELHI,SILCHAR,1010,760,DELHI-SILCHAR,1770,All
2024,2,DELHI,SILCHAR,694,847,DELHI-SILCHAR,1541,All
2024,3,DELHI,SILCHAR,722,896,DELHI-SILCHAR,1618,All
2024,4,DELHI,SILCHAR,342,497,DELHI-SILCHAR,839,All
2024,6,DELHI,SILCHAR,386,462,DELHI-SILCHAR,848,All
2024,7,DELHI,SILCHAR,486,577,DELHI-SILCHAR,1063,All
2024,8,DELHI,SILCHAR,552,1082,DELHI-SILCHAR,1634,All
2024,9,DELHI,SILCHAR,448,912,DELHI-SILCHAR,1360,All
2024,10,DELHI,SILCHAR,415,786,DELHI-SILCHAR,1201,All
2024,11,DELHI,SILCHAR,654,1193,DELHI-SILCHAR,1847,All
2024,12,DELHI,SILCHAR,544,1190,DELHI-SILCHAR,1734,All
2025,3,DELHI,SILCHAR,988,1203,DELHI-SILCHAR,2191,All
2017,4,DELHI,SIMLA,104,49,DELHI-SIMLA,153,All
2017,5,DELHI,SIMLA,691,299,DELHI-SIMLA,990,All
2017,6,DELHI,SIMLA,551,250,DELHI-SIMLA,801,All
2017,7,DELHI,SIMLA,482,197,DELHI-SIMLA,679,All
2017,8,DELHI,SIMLA,386,163,DELHI-SIMLA,549,All
2017,9,DELHI,SIMLA,631,280,DELHI-SIMLA,911,All
2017,10,DELHI,SIMLA,187,76,DELHI-SIMLA,263,All
2017,11,DELHI,SIMLA,637,268,DELHI-SIMLA,905,All
2017,12,DELHI,SIMLA,679,278,DELHI-SIMLA,957,All
2018,1,DELHI,SIMLA,672,291,DELHI-SIMLA,963,All
2018,2,DELHI,SIMLA,800,331,DELHI-SIMLA,1131,All
2018,3,DELHI,SIMLA,645,265,DELHI-SIMLA,910,All
2018,4,DELHI,SIMLA,697,285,DELHI-SIMLA,982,All
2018,5,DELHI,SIMLA,946,409,DELHI-SIMLA,1355,All
2018,6,DELHI,SIMLA,460,186,DELHI-SIMLA,646,All
2018,7,DELHI,SIMLA,254,104,DELHI-SIMLA,358,All
2018,8,DELHI,SIMLA,263,107,DELHI-SIMLA,370,All
2018,9,DELHI,SIMLA,311,128,DELHI-SIMLA,439,All
2018,10,DELHI,SIMLA,330,140,DELHI-SIMLA,470,All
2018,11,DELHI,SIMLA,389,152,DELHI-SIMLA,541,All
2018,12,DELHI,SIMLA,714,309,DELHI-SIMLA,1023,All
2019,1,DELHI,SIMLA,291,128,DELHI-SIMLA,419,All
2019,2,DELHI,SIMLA,457,180,DELHI-SIMLA,637,All
2019,3,DELHI,SIMLA,286,118,DELHI-SIMLA,404,All
2019,4,DELHI,SIMLA,207,91,DELHI-SIMLA,298,All
2019,5,DELHI,SIMLA,513,222,DELHI-SIMLA,735,All
2019,6,DELHI,SIMLA,455,201,DELHI-SIMLA,656,All
2019,7,DELHI,SIMLA,24,9,DELHI-SIMLA,33,All
2019,8,DELHI,SIMLA,84,25,DELHI-SIMLA,109,All
2019,9,DELHI,SIMLA,219,85,DELHI-SIMLA,304,All
2019,10,DELHI,SIMLA,645,343,DELHI-SIMLA,988,All
2019,11,DELHI,SIMLA,201,103,DELHI-SIMLA,304,All
2019,12,DELHI,SIMLA,590,302,DELHI-SIMLA,892,All
2020,1,DELHI,SIMLA,160,71,DELHI-SIMLA,231,All
2020,2,DELHI,SIMLA,355,161,DELHI-SIMLA,516,All
2020,3,DELHI,SIMLA,91,47,DELHI-SIMLA,138,All
2022,10,DELHI,SIMLA,871,551,DELHI-SIMLA,1422,All
2022,11,DELHI,SIMLA,1016,701,DELHI-SIMLA,1717,All
2022,12,DELHI,SIMLA,1065,733,DELHI-SIMLA,1798,All
2023,1,DELHI,SIMLA,723,483,DELHI-SIMLA,1206,All
2023,2,DELHI,SIMLA,831,576,DELHI-SIMLA,1407,All
2023,3,DELHI,SIMLA,756,533,DELHI-SIMLA,1289,All
2023,4,DELHI,SIMLA,792,372,DELHI-SIMLA,1164,All
2023,5,DELHI,SIMLA,808,417,DELHI-SIMLA,1225,All
2023,6,DELHI,SIMLA,823,428,DELHI-SIMLA,1251,All
2023,7,DELHI,SIMLA,428,234,DELHI-SIMLA,662,All
2023,8,DELHI,SIMLA,300,161,DELHI-SIMLA,461,All
2023,9,DELHI,SIMLA,583,287,DELHI-SIMLA,870,All
2023,10,DELHI,SIMLA,881,573,DELHI-SIMLA,1454,All
2023,11,DELHI,SIMLA,990,587,DELHI-SIMLA,1577,All
2023,12,DELHI,SIMLA,1026,591,DELHI-SIMLA,1617,All
2024,1,DELHI,SIMLA,967,538,DELHI-SIMLA,1505,All
2024,2,DELHI,SIMLA,698,366,DELHI-SIMLA,1064,All
2024,3,DELHI,SIMLA,1026,542,DELHI-SIMLA,1568,All
2024,4,DELHI,SIMLA,1161,591,DELHI-SIMLA,1752,All
2024,6,DELHI,SIMLA,1049,514,DELHI-SIMLA,1563,All
2024,7,DELHI,SIMLA,133,72,DELHI-SIMLA,205,All
2024,8,DELHI,SIMLA,410,239,DELHI-SIMLA,649,All
2024,9,DELHI,SIMLA,529,270,DELHI-SIMLA,799,All
2024,10,DELHI,SIMLA,1197,711,DELHI-SIMLA,1908,All
2024,11,DELHI,SIMLA,1036,661,DELHI-SIMLA,1697,All
2024,12,DELHI,SIMLA,993,598,DELHI-SIMLA,1591,All
2025,1,DELHI,SIMLA,1028,610,DELHI-SIMLA,1638,All
2025,2,DELHI,SIMLA,895,526,DELHI-SIMLA,1421,All
2025,3,DELHI,SIMLA,921,520,DELHI-SIMLA,1441,All
2015,4,DELHI,SRINAGAR,47322,54892,DELHI-SRINAGAR,102214,All
2015,5,DELHI,SRINAGAR,69023,70829,DELHI-SRINAGAR,139852,All
2015,6,DELHI,SRINAGAR,68668,77053,DELHI-SRINAGAR,145721,All
2015,7,DELHI,SRINAGAR,62591,69713,DELHI-SRINAGAR,132304,All
2015,8,DELHI,SRINAGAR,47899,64415,DELHI-SRINAGAR,112314,All
2015,9,DELHI,SRINAGAR,53219,57799,DELHI-SRINAGAR,111018,All
2015,10,DELHI,SRINAGAR,50723,63546,DELHI-SRINAGAR,114269,All
2015,11,DELHI,SRINAGAR,36649,42500,DELHI-SRINAGAR,79149,All
2015,12,DELHI,SRINAGAR,37862,45303,DELHI-SRINAGAR,83165,All
2016,1,DELHI,SRINAGAR,36579,46448,DELHI-SRINAGAR,83027,All
2016,2,DELHI,SRINAGAR,45120,43489,DELHI-SRINAGAR,88609,All
2016,3,DELHI,SRINAGAR,53754,49533,DELHI-SRINAGAR,103287,All
2016,4,DELHI,SRINAGAR,70903,71241,DELHI-SRINAGAR,142144,All
2016,5,DELHI,SRINAGAR,92411,89398,DELHI-SRINAGAR,181809,All
2016,6,DELHI,SRINAGAR,86095,92033,DELHI-SRINAGAR,178128,All
2016,7,DELHI,SRINAGAR,56887,75812,DELHI-SRINAGAR,132699,All
2016,8,DELHI,SRINAGAR,30074,52294,DELHI-SRINAGAR,82368,All
2016,9,DELHI,SRINAGAR,33816,43929,DELHI-SRINAGAR,77745,All
2016,10,DELHI,SRINAGAR,31330,47580,DELHI-SRINAGAR,78910,All
2016,11,DELHI,SRINAGAR,24791,26437,DELHI-SRINAGAR,51228,All
2016,12,DELHI,SRINAGAR,33976,35449,DELHI-SRINAGAR,69425,All
2017,1,DELHI,SRINAGAR,28403,30170,DELHI-SRINAGAR,58573,All
2017,2,DELHI,SRINAGAR,39312,39271,DELHI-SRINAGAR,78583,All
2017,3,DELHI,SRINAGAR,59765,51847,DELHI-SRINAGAR,111612,All
2017,4,DELHI,SRINAGAR,72837,65837,DELHI-SRINAGAR,138674,All
2017,5,DELHI,SRINAGAR,82236,73833,DELHI-SRINAGAR,156069,All
2017,6,DELHI,SRINAGAR,73173,64029,DELHI-SRINAGAR,137202,All
2017,7,DELHI,SRINAGAR,72356,75813,DELHI-SRINAGAR,148169,All
2017,8,DELHI,SRINAGAR,57264,59718,DELHI-SRINAGAR,116982,All
2017,9,DELHI,SRINAGAR,53938,59338,DELHI-SRINAGAR,113276,All
2017,10,DELHI,SRINAGAR,56412,60071,DELHI-SRINAGAR,116483,All
2017,11,DELHI,SRINAGAR,45350,51301,DELHI-SRINAGAR,96651,All
2017,12,DELHI,SRINAGAR,56554,61538,DELHI-SRINAGAR,118092,All
2018,1,DELHI,SRINAGAR,56124,64193,DELHI-SRINAGAR,120317,All
2018,2,DELHI,SRINAGAR,57598,54202,DELHI-SRINAGAR,111800,All
2018,3,DELHI,SRINAGAR,67749,57013,DELHI-SRINAGAR,124762,All
2018,4,DELHI,SRINAGAR,76879,75576,DELHI-SRINAGAR,152455,All
2018,5,DELHI,SRINAGAR,82191,74095,DELHI-SRINAGAR,156286,All
2018,6,DELHI,SRINAGAR,77320,77151,DELHI-SRINAGAR,154471,All
2018,7,DELHI,SRINAGAR,74441,77913,DELHI-SRINAGAR,152354,All
2018,8,DELHI,SRINAGAR,67653,69457,DELHI-SRINAGAR,137110,All
2018,9,DELHI,SRINAGAR,66355,67922,DELHI-SRINAGAR,134277,All
2018,10,DELHI,SRINAGAR,59362,69210,DELHI-SRINAGAR,128572,All
2018,11,DELHI,SRINAGAR,56206,57418,DELHI-SRINAGAR,113624,All
2018,12,DELHI,SRINAGAR,59720,63054,DELHI-SRINAGAR,122774,All
2019,1,DELHI,SRINAGAR,52228,55001,DELHI-SRINAGAR,107229,All
2019,2,DELHI,SRINAGAR,59932,55814,DELHI-SRINAGAR,115746,All
2019,3,DELHI,SRINAGAR,64774,55443,DELHI-SRINAGAR,120217,All
2019,4,DELHI,SRINAGAR,75900,74984,DELHI-SRINAGAR,150884,All
2019,5,DELHI,SRINAGAR,80555,74917,DELHI-SRINAGAR,155472,All
2019,6,DELHI,SRINAGAR,84961,82119,DELHI-SRINAGAR,167080,All
2019,7,DELHI,SRINAGAR,86651,86419,DELHI-SRINAGAR,173070,All
2019,8,DELHI,SRINAGAR,53806,75083,DELHI-SRINAGAR,128889,All
2019,9,DELHI,SRINAGAR,67156,71035,DELHI-SRINAGAR,138191,All
2019,10,DELHI,SRINAGAR,64439,77209,DELHI-SRINAGAR,141648,All
2019,11,DELHI,SRINAGAR,55998,57305,DELHI-SRINAGAR,113303,All
2019,12,DELHI,SRINAGAR,43731,43899,DELHI-SRINAGAR,87630,All
2020,1,DELHI,SRINAGAR,50554,54177,DELHI-SRINAGAR,104731,All
2020,2,DELHI,SRINAGAR,59602,57227,DELHI-SRINAGAR,116829,All
2020,3,DELHI,SRINAGAR,48184,36218,DELHI-SRINAGAR,84402,All
2020,5,DELHI,SRINAGAR,6222,3021,DELHI-SRINAGAR,9243,All
2020,6,DELHI,SRINAGAR,38724,31356,DELHI-SRINAGAR,70080,All
2020,7,DELHI,SRINAGAR,47064,37683,DELHI-SRINAGAR,84747,All
2020,8,DELHI,SRINAGAR,60556,39689,DELHI-SRINAGAR,100245,All
2020,9,DELHI,SRINAGAR,62163,48371,DELHI-SRINAGAR,110534,All
2020,10,DELHI,SRINAGAR,55468,66987,DELHI-SRINAGAR,122455,All
2020,11,DELHI,SRINAGAR,55702,79329,DELHI-SRINAGAR,135031,All
2020,12,DELHI,SRINAGAR,56173,60836,DELHI-SRINAGAR,117009,All
2021,1,DELHI,SRINAGAR,60591,76102,DELHI-SRINAGAR,136693,All
2021,2,DELHI,SRINAGAR,82658,84203,DELHI-SRINAGAR,166861,All
2021,3,DELHI,SRINAGAR,110527,98205,DELHI-SRINAGAR,208732,All
2021,4,DELHI,SRINAGAR,82419,81034,DELHI-SRINAGAR,163453,All
2021,6,DELHI,SRINAGAR,67386,48404,DELHI-SRINAGAR,115790,All
2021,7,DELHI,SRINAGAR,81014,73131,DELHI-SRINAGAR,154145,All
2021,8,DELHI,SRINAGAR,83858,84936,DELHI-SRINAGAR,168794,All
2021,9,DELHI,SRINAGAR,90619,87469,DELHI-SRINAGAR,178088,All
2021,10,DELHI,SRINAGAR,98345,116208,DELHI-SRINAGAR,214553,All
2021,11,DELHI,SRINAGAR,105296,119120,DELHI-SRINAGAR,224416,All
2021,12,DELHI,SRINAGAR,112474,118951,DELHI-SRINAGAR,231425,All
2022,1,DELHI,SRINAGAR,74157,80633,DELHI-SRINAGAR,154790,All
2022,2,DELHI,SRINAGAR,89067,84240,DELHI-SRINAGAR,173307,All
2022,3,DELHI,SRINAGAR,128266,116888,DELHI-SRINAGAR,245154,All
2022,4,DELHI,SRINAGAR,144415,129740,DELHI-SRINAGAR,274155,All
2022,5,DELHI,SRINAGAR,156583,144381,DELHI-SRINAGAR,300964,All
2022,6,DELHI,SRINAGAR,147395,143065,DELHI-SRINAGAR,290460,All
2022,7,DELHI,SRINAGAR,129341,130870,DELHI-SRINAGAR,260211,All
2022,8,DELHI,SRINAGAR,97144,106229,DELHI-SRINAGAR,203373,All
2022,9,DELHI,SRINAGAR,102122,102313,DELHI-SRINAGAR,204435,All
2022,10,DELHI,SRINAGAR,113218,120959,DELHI-SRINAGAR,234177,All
2022,11,DELHI,SRINAGAR,97619,107105,DELHI-SRINAGAR,204724,All
2022,12,DELHI,SRINAGAR,106471,108512,DELHI-SRINAGAR,214983,All
2023,1,DELHI,SRINAGAR,94458,101026,DELHI-SRINAGAR,195484,All
2023,2,DELHI,SRINAGAR,102888,98621,DELHI-SRINAGAR,201509,All
2023,3,DELHI,SRINAGAR,112999,104430,DELHI-SRINAGAR,217429,All
2023,4,DELHI,SRINAGAR,128026,131460,DELHI-SRINAGAR,259486,All
2023,5,DELHI,SRINAGAR,124708,124449,DELHI-SRINAGAR,249157,All
2023,6,DELHI,SRINAGAR,131747,127337,DELHI-SRINAGAR,259084,All
2023,7,DELHI,SRINAGAR,128587,138256,DELHI-SRINAGAR,266843,All
2023,8,DELHI,SRINAGAR,99768,113610,DELHI-SRINAGAR,213378,All
2023,9,DELHI,SRINAGAR,111489,103820,DELHI-SRINAGAR,215309,All
2023,10,DELHI,SRINAGAR,95371,113527,DELHI-SRINAGAR,208898,All
2023,11,DELHI,SRINAGAR,88470,93513,DELHI-SRINAGAR,181983,All
2023,12,DELHI,SRINAGAR,98692,98126,DELHI-SRINAGAR,196818,All
2024,1,DELHI,SRINAGAR,88501,93899,DELHI-SRINAGAR,182400,All
2024,2,DELHI,SRINAGAR,96158,88774,DELHI-SRINAGAR,184932,All
2024,3,DELHI,SRINAGAR,107123,100072,DELHI-SRINAGAR,207195,All
2024,4,DELHI,SRINAGAR,125671,122211,DELHI-SRINAGAR,247882,All
2024,6,DELHI,SRINAGAR,132450,129277,DELHI-SRINAGAR,261727,All
2024,7,DELHI,SRINAGAR,106367,110873,DELHI-SRINAGAR,217240,All
2024,8,DELHI,SRINAGAR,77395,86335,DELHI-SRINAGAR,163730,All
2024,9,DELHI,SRINAGAR,80495,78520,DELHI-SRINAGAR,159015,All
2024,10,DELHI,SRINAGAR,82538,94620,DELHI-SRINAGAR,177158,All
2024,11,DELHI,SRINAGAR,78534,80069,DELHI-SRINAGAR,158603,All
2024,12,DELHI,SRINAGAR,80676,82620,DELHI-SRINAGAR,163296,All
2025,1,DELHI,SRINAGAR,76135,78528,DELHI-SRINAGAR,154663,All
2025,2,DELHI,SRINAGAR,76199,73778,DELHI-SRINAGAR,149977,All
2025,3,DELHI,SRINAGAR,95385,86117,DELHI-SRINAGAR,181502,All
2015,4,DELHI,SURAT,1446,1491,DELHI-SURAT,2937,All
2015,5,DELHI,SURAT,1707,1732,DELHI-SURAT,3439,All
2015,6,DELHI,SURAT,1592,1513,DELHI-SURAT,3105,All
2015,7,DELHI,SURAT,1524,1496,DELHI-SURAT,3020,All
2015,8,DELHI,SURAT,1570,1501,DELHI-SURAT,3071,All
2015,9,DELHI,SURAT,1459,1338,DELHI-SURAT,2797,All
2015,10,DELHI,SURAT,4178,7382,DELHI-SURAT,11560,All
2015,11,DELHI,SURAT,5469,5376,DELHI-SURAT,10845,All
2015,12,DELHI,SURAT,6493,5683,DELHI-SURAT,12176,All
2016,1,DELHI,SURAT,5481,5513,DELHI-SURAT,10994,All
2016,2,DELHI,SURAT,5392,5143,DELHI-SURAT,10535,All
2016,3,DELHI,SURAT,5946,5757,DELHI-SURAT,11703,All
2016,4,DELHI,SURAT,5944,6025,DELHI-SURAT,11969,All
2016,5,DELHI,SURAT,6659,6430,DELHI-SURAT,13089,All
2016,6,DELHI,SURAT,6281,5226,DELHI-SURAT,11507,All
2016,7,DELHI,SURAT,6207,5828,DELHI-SURAT,12035,All
2016,8,DELHI,SURAT,6001,5465,DELHI-SURAT,11466,All
2016,9,DELHI,SURAT,5795,5445,DELHI-SURAT,11240,All
2016,10,DELHI,SURAT,6055,6202,DELHI-SURAT,12257,All
2016,11,DELHI,SURAT,6560,5721,DELHI-SURAT,12281,All
2016,12,DELHI,SURAT,9060,7826,DELHI-SURAT,16886,All
2017,1,DELHI,SURAT,9034,9204,DELHI-SURAT,18238,All
2017,2,DELHI,SURAT,8145,8259,DELHI-SURAT,16404,All
2017,3,DELHI,SURAT,10387,10124,DELHI-SURAT,20511,All
2017,4,DELHI,SURAT,17001,17488,DELHI-SURAT,34489,All
2017,5,DELHI,SURAT,19463,18185,DELHI-SURAT,37648,All
2017,6,DELHI,SURAT,19431,16899,DELHI-SURAT,36330,All
2017,7,DELHI,SURAT,18491,17407,DELHI-SURAT,35898,All
2017,8,DELHI,SURAT,17979,17344,DELHI-SURAT,35323,All
2017,9,DELHI,SURAT,17665,16916,DELHI-SURAT,34581,All
2017,10,DELHI,SURAT,17388,17991,DELHI-SURAT,35379,All
2017,11,DELHI,SURAT,17854,16523,DELHI-SURAT,34377,All
2017,12,DELHI,SURAT,12933,12064,DELHI-SURAT,24997,All
2018,1,DELHI,SURAT,12782,12899,DELHI-SURAT,25681,All
2018,2,DELHI,SURAT,15307,15498,DELHI-SURAT,30805,All
2018,3,DELHI,SURAT,18338,18177,DELHI-SURAT,36515,All
2018,4,DELHI,SURAT,17281,18307,DELHI-SURAT,35588,All
2018,5,DELHI,SURAT,18101,18482,DELHI-SURAT,36583,All
2018,6,DELHI,SURAT,17621,16084,DELHI-SURAT,33705,All
2018,7,DELHI,SURAT,17576,17697,DELHI-SURAT,35273,All
2018,8,DELHI,SURAT,20788,20225,DELHI-SURAT,41013,All
2018,9,DELHI,SURAT,22634,21728,DELHI-SURAT,44362,All
2018,10,DELHI,SURAT,21261,21274,DELHI-SURAT,42535,All
2018,11,DELHI,SURAT,23684,20832,DELHI-SURAT,44516,All
2018,12,DELHI,SURAT,27606,22211,DELHI-SURAT,49817,All
2019,1,DELHI,SURAT,25453,24387,DELHI-SURAT,49840,All
2019,2,DELHI,SURAT,24494,23492,DELHI-SURAT,47986,All
2019,3,DELHI,SURAT,22257,20012,DELHI-SURAT,42269,All
2019,4,DELHI,SURAT,20547,21474,DELHI-SURAT,42021,All
2019,5,DELHI,SURAT,23281,23292,DELHI-SURAT,46573,All
2019,6,DELHI,SURAT,23162,20324,DELHI-SURAT,43486,All
2019,7,DELHI,SURAT,23767,22061,DELHI-SURAT,45828,All
2019,8,DELHI,SURAT,22485,22173,DELHI-SURAT,44658,All
2019,9,DELHI,SURAT,23352,22086,DELHI-SURAT,45438,All
2019,10,DELHI,SURAT,19461,22841,DELHI-SURAT,42302,All
2019,11,DELHI,SURAT,26099,21791,DELHI-SURAT,47890,All
2019,12,DELHI,SURAT,23416,20672,DELHI-SURAT,44088,All
2020,1,DELHI,SURAT,22378,22589,DELHI-SURAT,44967,All
2020,2,DELHI,SURAT,23164,23299,DELHI-SURAT,46463,All
2020,3,DELHI,SURAT,14752,13706,DELHI-SURAT,28458,All
2020,5,DELHI,SURAT,420,931,DELHI-SURAT,1351,All
2020,6,DELHI,SURAT,2479,3919,DELHI-SURAT,6398,All
2020,7,DELHI,SURAT,3356,3624,DELHI-SURAT,6980,All
2020,8,DELHI,SURAT,7635,4721,DELHI-SURAT,12356,All
2020,9,DELHI,SURAT,15043,7928,DELHI-SURAT,22971,All
2020,10,DELHI,SURAT,15896,12026,DELHI-SURAT,27922,All
2020,11,DELHI,SURAT,15048,14606,DELHI-SURAT,29654,All
2020,12,DELHI,SURAT,16821,12191,DELHI-SURAT,29012,All
2021,1,DELHI,SURAT,16817,15259,DELHI-SURAT,32076,All
2021,2,DELHI,SURAT,16545,16840,DELHI-SURAT,33385,All
2021,3,DELHI,SURAT,16394,16557,DELHI-SURAT,32951,All
2021,4,DELHI,SURAT,10514,15289,DELHI-SURAT,25803,All
2021,6,DELHI,SURAT,8678,7999,DELHI-SURAT,16677,All
2021,7,DELHI,SURAT,13844,13405,DELHI-SURAT,27249,All
2021,8,DELHI,SURAT,14549,14239,DELHI-SURAT,28788,All
2021,9,DELHI,SURAT,15969,15972,DELHI-SURAT,31941,All
2021,10,DELHI,SURAT,17221,19387,DELHI-SURAT,36608,All
2021,11,DELHI,SURAT,29903,26566,DELHI-SURAT,56469,All
2021,12,DELHI,SURAT,30464,25630,DELHI-SURAT,56094,All
2022,1,DELHI,SURAT,14690,14182,DELHI-SURAT,28872,All
2022,2,DELHI,SURAT,18450,19664,DELHI-SURAT,38114,All
2022,3,DELHI,SURAT,25748,25720,DELHI-SURAT,51468,All
2022,4,DELHI,SURAT,20005,20947,DELHI-SURAT,40952,All
2022,5,DELHI,SURAT,25219,25983,DELHI-SURAT,51202,All
2022,6,DELHI,SURAT,25471,19389,DELHI-SURAT,44860,All
2022,7,DELHI,SURAT,18484,18294,DELHI-SURAT,36778,All
2022,8,DELHI,SURAT,18063,17627,DELHI-SURAT,35690,All
2022,9,DELHI,SURAT,17950,17529,DELHI-SURAT,35479,All
2022,10,DELHI,SURAT,15272,18668,DELHI-SURAT,33940,All
2022,11,DELHI,SURAT,19352,16105,DELHI-SURAT,35457,All
2022,12,DELHI,SURAT,20357,18534,DELHI-SURAT,38891,All
2023,1,DELHI,SURAT,19510,19691,DELHI-SURAT,39201,All
2023,2,DELHI,SURAT,19711,20475,DELHI-SURAT,40186,All
2023,3,DELHI,SURAT,21288,21106,DELHI-SURAT,42394,All
2023,4,DELHI,SURAT,21106,23019,DELHI-SURAT,44125,All
2023,5,DELHI,SURAT,23997,23454,DELHI-SURAT,47451,All
2023,6,DELHI,SURAT,23488,19663,DELHI-SURAT,43151,All
2023,7,DELHI,SURAT,21768,18592,DELHI-SURAT,40360,All
2023,8,DELHI,SURAT,21700,20503,DELHI-SURAT,42203,All
2023,9,DELHI,SURAT,20971,20530,DELHI-SURAT,41501,All
2023,10,DELHI,SURAT,20526,20414,DELHI-SURAT,40940,All
2023,11,DELHI,SURAT,15080,15609,DELHI-SURAT,30689,All
2023,12,DELHI,SURAT,17866,16019,DELHI-SURAT,33885,All
2024,1,DELHI,SURAT,16469,16384,DELHI-SURAT,32853,All
2024,2,DELHI,SURAT,15143,15659,DELHI-SURAT,30802,All
2024,3,DELHI,SURAT,18266,18571,DELHI-SURAT,36837,All
2024,4,DELHI,SURAT,20705,21123,DELHI-SURAT,41828,All
2024,6,DELHI,SURAT,25856,23201,DELHI-SURAT,49057,All
2024,7,DELHI,SURAT,27081,24855,DELHI-SURAT,51936,All
2024,8,DELHI,SURAT,26001,24829,DELHI-SURAT,50830,All
2024,9,DELHI,SURAT,25834,24413,DELHI-SURAT,50247,All
2024,10,DELHI,SURAT,23594,25977,DELHI-SURAT,49571,All
2024,11,DELHI,SURAT,29117,27192,DELHI-SURAT,56309,All
2024,12,DELHI,SURAT,31466,28035,DELHI-SURAT,59501,All
2025,1,DELHI,SURAT,28817,29105,DELHI-SURAT,57922,All
2025,2,DELHI,SURAT,25094,26143,DELHI-SURAT,51237,All
2025,3,DELHI,SURAT,27292,26471,DELHI-SURAT,53763,All
2018,4,DELHI,TEZPUR,5,6,DELHI-TEZPUR,11,All
2018,5,DELHI,TEZPUR,69,46,DELHI-TEZPUR,115,All
2018,6,DELHI,TEZPUR,40,33,DELHI-TEZPUR,73,All
2018,3,DELHI,TIRUCHIRAPALLY,112,76,DELHI-TIRUCHIRAPALLY,188,All
2018,4,DELHI,TIRUCHIRAPALLY,646,500,DELHI-TIRUCHIRAPALLY,1146,All
2018,5,DELHI,TIRUCHIRAPALLY,1026,402,DELHI-TIRUCHIRAPALLY,1428,All
2018,6,DELHI,TIRUCHIRAPALLY,1102,501,DELHI-TIRUCHIRAPALLY,1603,All
2018,7,DELHI,TIRUCHIRAPALLY,636,267,DELHI-TIRUCHIRAPALLY,903,All
2018,8,DELHI,TIRUCHIRAPALLY,452,218,DELHI-TIRUCHIRAPALLY,670,All
2018,9,DELHI,TIRUCHIRAPALLY,400,275,DELHI-TIRUCHIRAPALLY,675,All
2018,10,DELHI,TIRUCHIRAPALLY,371,265,DELHI-TIRUCHIRAPALLY,636,All
2020,5,DELHI,TIRUCHIRAPALLY,0,0,DELHI-TIRUCHIRAPALLY,0,All
2020,10,DELHI,TIRUCHIRAPALLY,32,54,DELHI-TIRUCHIRAPALLY,86,All
2020,11,DELHI,TIRUCHIRAPALLY,387,383,DELHI-TIRUCHIRAPALLY,770,All
2020,12,DELHI,TIRUCHIRAPALLY,527,303,DELHI-TIRUCHIRAPALLY,830,All
2021,1,DELHI,TIRUCHIRAPALLY,610,322,DELHI-TIRUCHIRAPALLY,932,All
2021,2,DELHI,TIRUCHIRAPALLY,239,377,DELHI-TIRUCHIRAPALLY,616,All
2021,3,DELHI,TIRUCHIRAPALLY,301,302,DELHI-TIRUCHIRAPALLY,603,All
2022,1,DELHI,TIRUCHIRAPALLY,195,106,DELHI-TIRUCHIRAPALLY,301,All
2022,3,DELHI,TIRUCHIRAPALLY,134,117,DELHI-TIRUCHIRAPALLY,251,All
2022,4,DELHI,TIRUCHIRAPALLY,870,611,DELHI-TIRUCHIRAPALLY,1481,All
2022,5,DELHI,TIRUCHIRAPALLY,1020,525,DELHI-TIRUCHIRAPALLY,1545,All
2022,6,DELHI,TIRUCHIRAPALLY,895,784,DELHI-TIRUCHIRAPALLY,1679,All
2022,7,DELHI,TIRUCHIRAPALLY,1083,897,DELHI-TIRUCHIRAPALLY,1980,All
2022,8,DELHI,TIRUCHIRAPALLY,1222,999,DELHI-TIRUCHIRAPALLY,2221,All
2022,9,DELHI,TIRUCHIRAPALLY,955,1043,DELHI-TIRUCHIRAPALLY,1998,All
2022,10,DELHI,TIRUCHIRAPALLY,1177,939,DELHI-TIRUCHIRAPALLY,2116,All
2022,11,DELHI,TIRUCHIRAPALLY,854,761,DELHI-TIRUCHIRAPALLY,1615,All
2022,12,DELHI,TIRUCHIRAPALLY,1025,827,DELHI-TIRUCHIRAPALLY,1852,All
2023,1,DELHI,TIRUCHIRAPALLY,1392,803,DELHI-TIRUCHIRAPALLY,2195,All
2023,2,DELHI,TIRUCHIRAPALLY,1393,958,DELHI-TIRUCHIRAPALLY,2351,All
2023,3,DELHI,TIRUCHIRAPALLY,955,754,DELHI-TIRUCHIRAPALLY,1709,All
2023,4,DELHI,TIRUCHIRAPALLY,920,759,DELHI-TIRUCHIRAPALLY,1679,All
2023,5,DELHI,TIRUCHIRAPALLY,788,596,DELHI-TIRUCHIRAPALLY,1384,All
2023,6,DELHI,TIRUCHIRAPALLY,885,883,DELHI-TIRUCHIRAPALLY,1768,All
2023,7,DELHI,TIRUCHIRAPALLY,566,527,DELHI-TIRUCHIRAPALLY,1093,All
2023,8,DELHI,TIRUCHIRAPALLY,427,371,DELHI-TIRUCHIRAPALLY,798,All
2023,9,DELHI,TIRUCHIRAPALLY,493,407,DELHI-TIRUCHIRAPALLY,900,All
2023,10,DELHI,TIRUCHIRAPALLY,473,391,DELHI-TIRUCHIRAPALLY,864,All
2015,4,DELHI,TIRUPATI,1252,1119,DELHI-TIRUPATI,2371,All
2015,5,DELHI,TIRUPATI,1508,1141,DELHI-TIRUPATI,2649,All
2015,6,DELHI,TIRUPATI,1314,1037,DELHI-TIRUPATI,2351,All
2015,7,DELHI,TIRUPATI,1320,1091,DELHI-TIRUPATI,2411,All
2015,8,DELHI,TIRUPATI,1296,1085,DELHI-TIRUPATI,2381,All
2015,9,DELHI,TIRUPATI,1169,1142,DELHI-TIRUPATI,2311,All
2015,10,DELHI,TIRUPATI,249,1191,DELHI-TIRUPATI,1440,All
2015,11,DELHI,TIRUPATI,422,432,DELHI-TIRUPATI,854,All
2015,12,DELHI,TIRUPATI,1346,1093,DELHI-TIRUPATI,2439,All
2016,1,DELHI,TIRUPATI,1355,1202,DELHI-TIRUPATI,2557,All
2016,2,DELHI,TIRUPATI,1136,988,DELHI-TIRUPATI,2124,All
2016,3,DELHI,TIRUPATI,1717,1244,DELHI-TIRUPATI,2961,All
2016,4,DELHI,TIRUPATI,1685,1462,DELHI-TIRUPATI,3147,All
2016,5,DELHI,TIRUPATI,1957,1605,DELHI-TIRUPATI,3562,All
2016,6,DELHI,TIRUPATI,2100,1868,DELHI-TIRUPATI,3968,All
2016,7,DELHI,TIRUPATI,1973,1804,DELHI-TIRUPATI,3777,All
2016,8,DELHI,TIRUPATI,2035,1766,DELHI-TIRUPATI,3801,All
2016,9,DELHI,TIRUPATI,1961,1615,DELHI-TIRUPATI,3576,All
2016,10,DELHI,TIRUPATI,1605,1360,DELHI-TIRUPATI,2965,All
2016,11,DELHI,TIRUPATI,2002,1688,DELHI-TIRUPATI,3690,All
2016,12,DELHI,TIRUPATI,1934,1468,DELHI-TIRUPATI,3402,All
2017,1,DELHI,TIRUPATI,2346,2110,DELHI-TIRUPATI,4456,All
2017,2,DELHI,TIRUPATI,2161,1898,DELHI-TIRUPATI,4059,All
2017,3,DELHI,TIRUPATI,2303,2105,DELHI-TIRUPATI,4408,All
2017,4,DELHI,TIRUPATI,2139,1887,DELHI-TIRUPATI,4026,All
2017,5,DELHI,TIRUPATI,1943,1677,DELHI-TIRUPATI,3620,All
2017,6,DELHI,TIRUPATI,1995,1667,DELHI-TIRUPATI,3662,All
2017,7,DELHI,TIRUPATI,2082,1919,DELHI-TIRUPATI,4001,All
2017,8,DELHI,TIRUPATI,2174,1857,DELHI-TIRUPATI,4031,All
2017,9,DELHI,TIRUPATI,1867,1759,DELHI-TIRUPATI,3626,All
2017,10,DELHI,TIRUPATI,1322,1239,DELHI-TIRUPATI,2561,All
2017,11,DELHI,TIRUPATI,1138,958,DELHI-TIRUPATI,2096,All
2017,12,DELHI,TIRUPATI,1512,1257,DELHI-TIRUPATI,2769,All
2018,1,DELHI,TIRUPATI,2017,1743,DELHI-TIRUPATI,3760,All
2018,2,DELHI,TIRUPATI,2223,2012,DELHI-TIRUPATI,4235,All
2018,3,DELHI,TIRUPATI,2856,2459,DELHI-TIRUPATI,5315,All
2018,4,DELHI,TIRUPATI,1751,1910,DELHI-TIRUPATI,3661,All
2018,5,DELHI,TIRUPATI,1510,1424,DELHI-TIRUPATI,2934,All
2018,6,DELHI,TIRUPATI,1474,1310,DELHI-TIRUPATI,2784,All
2018,7,DELHI,TIRUPATI,1689,1633,DELHI-TIRUPATI,3322,All
2018,8,DELHI,TIRUPATI,1793,1637,DELHI-TIRUPATI,3430,All
2018,9,DELHI,TIRUPATI,1878,1519,DELHI-TIRUPATI,3397,All
2018,10,DELHI,TIRUPATI,1259,1172,DELHI-TIRUPATI,2431,All
2018,11,DELHI,TIRUPATI,1526,1204,DELHI-TIRUPATI,2730,All
2018,12,DELHI,TIRUPATI,1707,1575,DELHI-TIRUPATI,3282,All
2019,1,DELHI,TIRUPATI,1608,1461,DELHI-TIRUPATI,3069,All
2019,2,DELHI,TIRUPATI,1658,1583,DELHI-TIRUPATI,3241,All
2019,3,DELHI,TIRUPATI,2060,1811,DELHI-TIRUPATI,3871,All
2019,4,DELHI,TIRUPATI,1561,1217,DELHI-TIRUPATI,2778,All
2019,5,DELHI,TIRUPATI,1226,900,DELHI-TIRUPATI,2126,All
2019,6,DELHI,TIRUPATI,1434,977,DELHI-TIRUPATI,2411,All
2019,7,DELHI,TIRUPATI,1934,1375,DELHI-TIRUPATI,3309,All
2019,8,DELHI,TIRUPATI,1751,1382,DELHI-TIRUPATI,3133,All
2019,9,DELHI,TIRUPATI,1535,1369,DELHI-TIRUPATI,2904,All
2019,10,DELHI,TIRUPATI,1184,978,DELHI-TIRUPATI,2162,All
2019,11,DELHI,TIRUPATI,2082,1931,DELHI-TIRUPATI,4013,All
2019,12,DELHI,TIRUPATI,2948,2564,DELHI-TIRUPATI,5512,All
2020,1,DELHI,TIRUPATI,2826,2404,DELHI-TIRUPATI,5230,All
2020,2,DELHI,TIRUPATI,2900,2510,DELHI-TIRUPATI,5410,All
2020,3,DELHI,TIRUPATI,1881,1527,DELHI-TIRUPATI,3408,All
2020,6,DELHI,TIRUPATI,127,98,DELHI-TIRUPATI,225,All
2020,7,DELHI,TIRUPATI,581,349,DELHI-TIRUPATI,930,All
2020,8,DELHI,TIRUPATI,808,545,DELHI-TIRUPATI,1353,All
2020,9,DELHI,TIRUPATI,809,668,DELHI-TIRUPATI,1477,All
2020,10,DELHI,TIRUPATI,924,726,DELHI-TIRUPATI,1650,All
2020,11,DELHI,TIRUPATI,1004,778,DELHI-TIRUPATI,1782,All
2020,12,DELHI,TIRUPATI,1318,996,DELHI-TIRUPATI,2314,All
2021,1,DELHI,TIRUPATI,1564,1336,DELHI-TIRUPATI,2900,All
2021,2,DELHI,TIRUPATI,1679,1401,DELHI-TIRUPATI,3080,All
2021,3,DELHI,TIRUPATI,1970,1786,DELHI-TIRUPATI,3756,All
2021,4,DELHI,TIRUPATI,1426,1401,DELHI-TIRUPATI,2827,All
2021,6,DELHI,TIRUPATI,489,442,DELHI-TIRUPATI,931,All
2021,7,DELHI,TIRUPATI,1163,1020,DELHI-TIRUPATI,2183,All
2021,8,DELHI,TIRUPATI,2005,1758,DELHI-TIRUPATI,3763,All
2021,9,DELHI,TIRUPATI,1893,1843,DELHI-TIRUPATI,3736,All
2021,10,DELHI,TIRUPATI,2079,2042,DELHI-TIRUPATI,4121,All
2021,11,DELHI,TIRUPATI,2671,2870,DELHI-TIRUPATI,5541,All
2021,12,DELHI,TIRUPATI,5390,4157,DELHI-TIRUPATI,9547,All
2022,1,DELHI,TIRUPATI,2546,1762,DELHI-TIRUPATI,4308,All
2022,2,DELHI,TIRUPATI,2223,1267,DELHI-TIRUPATI,3490,All
2022,3,DELHI,TIRUPATI,2795,2096,DELHI-TIRUPATI,4891,All
2022,4,DELHI,TIRUPATI,2129,1908,DELHI-TIRUPATI,4037,All
2022,5,DELHI,TIRUPATI,2818,1926,DELHI-TIRUPATI,4744,All
2022,6,DELHI,TIRUPATI,2881,2427,DELHI-TIRUPATI,5308,All
2022,7,DELHI,TIRUPATI,2682,2219,DELHI-TIRUPATI,4901,All
2022,8,DELHI,TIRUPATI,3154,2397,DELHI-TIRUPATI,5551,All
2022,9,DELHI,TIRUPATI,2750,2023,DELHI-TIRUPATI,4773,All
2022,10,DELHI,TIRUPATI,2465,2130,DELHI-TIRUPATI,4595,All
2022,11,DELHI,TIRUPATI,2446,2425,DELHI-TIRUPATI,4871,All
2022,12,DELHI,TIRUPATI,2570,2451,DELHI-TIRUPATI,5021,All
2023,1,DELHI,TIRUPATI,2357,1662,DELHI-TIRUPATI,4019,All
2023,2,DELHI,TIRUPATI,1871,1576,DELHI-TIRUPATI,3447,All
2023,3,DELHI,TIRUPATI,2207,1654,DELHI-TIRUPATI,3861,All
2023,4,DELHI,TIRUPATI,2021,1681,DELHI-TIRUPATI,3702,All
2023,5,DELHI,TIRUPATI,1425,1010,DELHI-TIRUPATI,2435,All
2023,6,DELHI,TIRUPATI,1554,947,DELHI-TIRUPATI,2501,All
2023,7,DELHI,TIRUPATI,1226,916,DELHI-TIRUPATI,2142,All
2023,8,DELHI,TIRUPATI,1520,1324,DELHI-TIRUPATI,2844,All
2023,9,DELHI,TIRUPATI,1580,1236,DELHI-TIRUPATI,2816,All
2023,10,DELHI,TIRUPATI,1228,1330,DELHI-TIRUPATI,2558,All
2023,11,DELHI,TIRUPATI,793,600,DELHI-TIRUPATI,1393,All
2023,12,DELHI,TIRUPATI,1414,858,DELHI-TIRUPATI,2272,All
2024,1,DELHI,TIRUPATI,1436,948,DELHI-TIRUPATI,2384,All
2024,2,DELHI,TIRUPATI,1584,1071,DELHI-TIRUPATI,2655,All
2024,3,DELHI,TIRUPATI,2474,1639,DELHI-TIRUPATI,4113,All
2024,4,DELHI,TIRUPATI,1639,1142,DELHI-TIRUPATI,2781,All
2024,6,DELHI,TIRUPATI,1048,751,DELHI-TIRUPATI,1799,All
2024,7,DELHI,TIRUPATI,1208,796,DELHI-TIRUPATI,2004,All
2024,8,DELHI,TIRUPATI,1165,911,DELHI-TIRUPATI,2076,All
2024,9,DELHI,TIRUPATI,1114,764,DELHI-TIRUPATI,1878,All
2024,10,DELHI,TIRUPATI,3104,3706,DELHI-TIRUPATI,6810,All
2024,11,DELHI,TIRUPATI,5609,4343,DELHI-TIRUPATI,9952,All
2024,12,DELHI,TIRUPATI,5240,4630,DELHI-TIRUPATI,9870,All
2025,1,DELHI,TIRUPATI,3259,3357,DELHI-TIRUPATI,6616,All
2025,2,DELHI,TIRUPATI,4251,4671,DELHI-TIRUPATI,8922,All
2025,3,DELHI,TIRUPATI,4481,4260,DELHI-TIRUPATI,8741,All
2015,4,DELHI,TRIVANDRUM,7175,8232,DELHI-TRIVANDRUM,15407,All
2015,5,DELHI,TRIVANDRUM,8227,7549,DELHI-TRIVANDRUM,15776,All
2015,6,DELHI,TRIVANDRUM,7407,9547,DELHI-TRIVANDRUM,16954,All
2015,7,DELHI,TRIVANDRUM,6726,6767,DELHI-TRIVANDRUM,13493,All
2015,8,DELHI,TRIVANDRUM,7712,7835,DELHI-TRIVANDRUM,15547,All
2015,9,DELHI,TRIVANDRUM,6646,8248,DELHI-TRIVANDRUM,14894,All
2015,10,DELHI,TRIVANDRUM,26428,9604,DELHI-TRIVANDRUM,36032,All
2015,11,DELHI,TRIVANDRUM,6367,7188,DELHI-TRIVANDRUM,13555,All
2015,12,DELHI,TRIVANDRUM,8092,8447,DELHI-TRIVANDRUM,16539,All
2016,1,DELHI,TRIVANDRUM,9036,11368,DELHI-TRIVANDRUM,20404,All
2016,2,DELHI,TRIVANDRUM,8345,9616,DELHI-TRIVANDRUM,17961,All
2016,3,DELHI,TRIVANDRUM,8804,10811,DELHI-TRIVANDRUM,19615,All
2016,4,DELHI,TRIVANDRUM,8885,9276,DELHI-TRIVANDRUM,18161,All
2016,5,DELHI,TRIVANDRUM,10669,9164,DELHI-TRIVANDRUM,19833,All
2016,6,DELHI,TRIVANDRUM,10709,13010,DELHI-TRIVANDRUM,23719,All
2016,7,DELHI,TRIVANDRUM,11724,11679,DELHI-TRIVANDRUM,23403,All
2016,8,DELHI,TRIVANDRUM,10181,11723,DELHI-TRIVANDRUM,21904,All
2016,9,DELHI,TRIVANDRUM,10333,11860,DELHI-TRIVANDRUM,22193,All
2016,10,DELHI,TRIVANDRUM,10021,12041,DELHI-TRIVANDRUM,22062,All
2016,11,DELHI,TRIVANDRUM,13072,14053,DELHI-TRIVANDRUM,27125,All
2016,12,DELHI,TRIVANDRUM,15620,16219,DELHI-TRIVANDRUM,31839,All
2017,1,DELHI,TRIVANDRUM,16186,18001,DELHI-TRIVANDRUM,34187,All
2017,2,DELHI,TRIVANDRUM,14839,16575,DELHI-TRIVANDRUM,31414,All
2017,3,DELHI,TRIVANDRUM,12736,15456,DELHI-TRIVANDRUM,28192,All
2017,4,DELHI,TRIVANDRUM,16280,18615,DELHI-TRIVANDRUM,34895,All
2017,5,DELHI,TRIVANDRUM,20066,19014,DELHI-TRIVANDRUM,39080,All
2017,6,DELHI,TRIVANDRUM,21226,23936,DELHI-TRIVANDRUM,45162,All
2017,7,DELHI,TRIVANDRUM,18036,19908,DELHI-TRIVANDRUM,37944,All
2017,8,DELHI,TRIVANDRUM,18600,18744,DELHI-TRIVANDRUM,37344,All
2017,9,DELHI,TRIVANDRUM,19848,22980,DELHI-TRIVANDRUM,42828,All
2017,10,DELHI,TRIVANDRUM,20532,22750,DELHI-TRIVANDRUM,43282,All
2017,11,DELHI,TRIVANDRUM,23421,24544,DELHI-TRIVANDRUM,47965,All
2017,12,DELHI,TRIVANDRUM,24165,24878,DELHI-TRIVANDRUM,49043,All
2018,1,DELHI,TRIVANDRUM,19367,24479,DELHI-TRIVANDRUM,43846,All
2018,2,DELHI,TRIVANDRUM,16551,19041,DELHI-TRIVANDRUM,35592,All
2018,3,DELHI,TRIVANDRUM,18893,21746,DELHI-TRIVANDRUM,40639,All
2018,4,DELHI,TRIVANDRUM,16989,19195,DELHI-TRIVANDRUM,36184,All
2018,5,DELHI,TRIVANDRUM,19435,17470,DELHI-TRIVANDRUM,36905,All
2018,6,DELHI,TRIVANDRUM,17490,18855,DELHI-TRIVANDRUM,36345,All
2018,7,DELHI,TRIVANDRUM,17519,16956,DELHI-TRIVANDRUM,34475,All
2018,8,DELHI,TRIVANDRUM,25202,27842,DELHI-TRIVANDRUM,53044,All
2018,9,DELHI,TRIVANDRUM,14695,16986,DELHI-TRIVANDRUM,31681,All
2018,10,DELHI,TRIVANDRUM,15186,16460,DELHI-TRIVANDRUM,31646,All
2018,11,DELHI,TRIVANDRUM,16275,16052,DELHI-TRIVANDRUM,32327,All
2018,12,DELHI,TRIVANDRUM,17255,17467,DELHI-TRIVANDRUM,34722,All
2019,1,DELHI,TRIVANDRUM,16325,18673,DELHI-TRIVANDRUM,34998,All
2019,2,DELHI,TRIVANDRUM,14929,16121,DELHI-TRIVANDRUM,31050,All
2019,3,DELHI,TRIVANDRUM,16087,18291,DELHI-TRIVANDRUM,34378,All
2019,4,DELHI,TRIVANDRUM,12418,12689,DELHI-TRIVANDRUM,25107,All
2019,5,DELHI,TRIVANDRUM,13398,11516,DELHI-TRIVANDRUM,24914,All
2019,6,DELHI,TRIVANDRUM,12002,12631,DELHI-TRIVANDRUM,24633,All
2019,7,DELHI,TRIVANDRUM,12999,12541,DELHI-TRIVANDRUM,25540,All
2019,8,DELHI,TRIVANDRUM,14069,13743,DELHI-TRIVANDRUM,27812,All
2019,9,DELHI,TRIVANDRUM,11798,13143,DELHI-TRIVANDRUM,24941,All
2019,10,DELHI,TRIVANDRUM,14071,15193,DELHI-TRIVANDRUM,29264,All
2019,11,DELHI,TRIVANDRUM,18912,18422,DELHI-TRIVANDRUM,37334,All
2019,12,DELHI,TRIVANDRUM,22537,20790,DELHI-TRIVANDRUM,43327,All
2020,1,DELHI,TRIVANDRUM,20131,22980,DELHI-TRIVANDRUM,43111,All
2020,2,DELHI,TRIVANDRUM,17116,18719,DELHI-TRIVANDRUM,35835,All
2020,3,DELHI,TRIVANDRUM,9527,10868,DELHI-TRIVANDRUM,20395,All
2020,5,DELHI,TRIVANDRUM,450,320,DELHI-TRIVANDRUM,770,All
2020,6,DELHI,TRIVANDRUM,4134,2235,DELHI-TRIVANDRUM,6369,All
2020,7,DELHI,TRIVANDRUM,2218,1925,DELHI-TRIVANDRUM,4143,All
2020,8,DELHI,TRIVANDRUM,4749,2481,DELHI-TRIVANDRUM,7230,All
2020,9,DELHI,TRIVANDRUM,5321,4432,DELHI-TRIVANDRUM,9753,All
2020,10,DELHI,TRIVANDRUM,5246,4960,DELHI-TRIVANDRUM,10206,All
2020,11,DELHI,TRIVANDRUM,5022,5119,DELHI-TRIVANDRUM,10141,All
2020,12,DELHI,TRIVANDRUM,8372,6128,DELHI-TRIVANDRUM,14500,All
2021,1,DELHI,TRIVANDRUM,8394,7968,DELHI-TRIVANDRUM,16362,All
2021,2,DELHI,TRIVANDRUM,6347,7973,DELHI-TRIVANDRUM,14320,All
2021,3,DELHI,TRIVANDRUM,6407,7981,DELHI-TRIVANDRUM,14388,All
2021,4,DELHI,TRIVANDRUM,6297,6086,DELHI-TRIVANDRUM,12383,All
2021,6,DELHI,TRIVANDRUM,3713,3223,DELHI-TRIVANDRUM,6936,All
2021,7,DELHI,TRIVANDRUM,4404,4539,DELHI-TRIVANDRUM,8943,All
2021,8,DELHI,TRIVANDRUM,6494,6114,DELHI-TRIVANDRUM,12608,All
2021,9,DELHI,TRIVANDRUM,4834,6791,DELHI-TRIVANDRUM,11625,All
2021,10,DELHI,TRIVANDRUM,5816,7023,DELHI-TRIVANDRUM,12839,All
2021,11,DELHI,TRIVANDRUM,7456,7307,DELHI-TRIVANDRUM,14763,All
2021,12,DELHI,TRIVANDRUM,11807,10060,DELHI-TRIVANDRUM,21867,All
2022,1,DELHI,TRIVANDRUM,6323,8820,DELHI-TRIVANDRUM,15143,All
2022,2,DELHI,TRIVANDRUM,6164,7784,DELHI-TRIVANDRUM,13948,All
2022,3,DELHI,TRIVANDRUM,9287,9851,DELHI-TRIVANDRUM,19138,All
2022,4,DELHI,TRIVANDRUM,11618,12089,DELHI-TRIVANDRUM,23707,All
2022,5,DELHI,TRIVANDRUM,12827,11553,DELHI-TRIVANDRUM,24380,All
2022,6,DELHI,TRIVANDRUM,12911,12446,DELHI-TRIVANDRUM,25357,All
2022,7,DELHI,TRIVANDRUM,13064,12886,DELHI-TRIVANDRUM,25950,All
2022,8,DELHI,TRIVANDRUM,9628,9865,DELHI-TRIVANDRUM,19493,All
2022,9,DELHI,TRIVANDRUM,9243,10277,DELHI-TRIVANDRUM,19520,All
2022,10,DELHI,TRIVANDRUM,10261,11163,DELHI-TRIVANDRUM,21424,All
2022,11,DELHI,TRIVANDRUM,14260,14819,DELHI-TRIVANDRUM,29079,All
2022,12,DELHI,TRIVANDRUM,21187,19179,DELHI-TRIVANDRUM,40366,All
2023,1,DELHI,TRIVANDRUM,13616,15635,DELHI-TRIVANDRUM,29251,All
2023,2,DELHI,TRIVANDRUM,14239,15976,DELHI-TRIVANDRUM,30215,All
2023,3,DELHI,TRIVANDRUM,18208,19191,DELHI-TRIVANDRUM,37399,All
2023,4,DELHI,TRIVANDRUM,19049,20129,DELHI-TRIVANDRUM,39178,All
2023,5,DELHI,TRIVANDRUM,21346,19938,DELHI-TRIVANDRUM,41284,All
2023,6,DELHI,TRIVANDRUM,20254,18254,DELHI-TRIVANDRUM,38508,All
2023,7,DELHI,TRIVANDRUM,18986,16576,DELHI-TRIVANDRUM,35562,All
2023,8,DELHI,TRIVANDRUM,19212,20102,DELHI-TRIVANDRUM,39314,All
2023,9,DELHI,TRIVANDRUM,16960,19258,DELHI-TRIVANDRUM,36218,All
2023,10,DELHI,TRIVANDRUM,17998,19963,DELHI-TRIVANDRUM,37961,All
2023,11,DELHI,TRIVANDRUM,19419,18323,DELHI-TRIVANDRUM,37742,All
2023,12,DELHI,TRIVANDRUM,22153,20023,DELHI-TRIVANDRUM,42176,All
2024,1,DELHI,TRIVANDRUM,20725,21057,DELHI-TRIVANDRUM,41782,All
2024,2,DELHI,TRIVANDRUM,18896,19649,DELHI-TRIVANDRUM,38545,All
2024,3,DELHI,TRIVANDRUM,20087,18804,DELHI-TRIVANDRUM,38891,All
2024,4,DELHI,TRIVANDRUM,18408,19837,DELHI-TRIVANDRUM,38245,All
2024,6,DELHI,TRIVANDRUM,19022,18259,DELHI-TRIVANDRUM,37281,All
2024,7,DELHI,TRIVANDRUM,19312,17627,DELHI-TRIVANDRUM,36939,All
2024,8,DELHI,TRIVANDRUM,17892,18995,DELHI-TRIVANDRUM,36887,All
2024,9,DELHI,TRIVANDRUM,17783,18301,DELHI-TRIVANDRUM,36084,All
2024,10,DELHI,TRIVANDRUM,16091,20155,DELHI-TRIVANDRUM,36246,All
2024,11,DELHI,TRIVANDRUM,19110,19319,DELHI-TRIVANDRUM,38429,All
2024,12,DELHI,TRIVANDRUM,19001,18923,DELHI-TRIVANDRUM,37924,All
2025,1,DELHI,TRIVANDRUM,19415,21735,DELHI-TRIVANDRUM,41150,All
2025,2,DELHI,TRIVANDRUM,19826,21202,DELHI-TRIVANDRUM,41028,All
2025,3,DELHI,TRIVANDRUM,19839,21369,DELHI-TRIVANDRUM,41208,All
2015,4,DELHI,UDAIPUR,7663,7976,DELHI-UDAIPUR,15639,All
2015,5,DELHI,UDAIPUR,7441,7646,DELHI-UDAIPUR,15087,All
2015,6,DELHI,UDAIPUR,7600,6924,DELHI-UDAIPUR,14524,All
2015,7,DELHI,UDAIPUR,8970,8423,DELHI-UDAIPUR,17393,All
2015,8,DELHI,UDAIPUR,9388,9423,DELHI-UDAIPUR,18811,All
2015,9,DELHI,UDAIPUR,9097,8621,DELHI-UDAIPUR,17718,All
2015,10,DELHI,UDAIPUR,7949,9092,DELHI-UDAIPUR,17041,All
2015,11,DELHI,UDAIPUR,18426,18148,DELHI-UDAIPUR,36574,All
2015,12,DELHI,UDAIPUR,20739,19203,DELHI-UDAIPUR,39942,All
2016,1,DELHI,UDAIPUR,17810,19646,DELHI-UDAIPUR,37456,All
2016,2,DELHI,UDAIPUR,19071,19803,DELHI-UDAIPUR,38874,All
2016,3,DELHI,UDAIPUR,19405,19895,DELHI-UDAIPUR,39300,All
2016,4,DELHI,UDAIPUR,14615,15568,DELHI-UDAIPUR,30183,All
2016,5,DELHI,UDAIPUR,16390,15767,DELHI-UDAIPUR,32157,All
2016,6,DELHI,UDAIPUR,17853,14741,DELHI-UDAIPUR,32594,All
2016,7,DELHI,UDAIPUR,17717,16400,DELHI-UDAIPUR,34117,All
2016,8,DELHI,UDAIPUR,17411,17073,DELHI-UDAIPUR,34484,All
2016,9,DELHI,UDAIPUR,18783,19464,DELHI-UDAIPUR,38247,All
2016,10,DELHI,UDAIPUR,19369,20365,DELHI-UDAIPUR,39734,All
2016,11,DELHI,UDAIPUR,23069,21640,DELHI-UDAIPUR,44709,All
2016,12,DELHI,UDAIPUR,26183,24858,DELHI-UDAIPUR,51041,All
2017,1,DELHI,UDAIPUR,23984,24438,DELHI-UDAIPUR,48422,All
2017,2,DELHI,UDAIPUR,21961,21837,DELHI-UDAIPUR,43798,All
2017,3,DELHI,UDAIPUR,19799,21169,DELHI-UDAIPUR,40968,All
2017,4,DELHI,UDAIPUR,15169,15494,DELHI-UDAIPUR,30663,All
2017,5,DELHI,UDAIPUR,14663,14512,DELHI-UDAIPUR,29175,All
2017,6,DELHI,UDAIPUR,18047,14270,DELHI-UDAIPUR,32317,All
2017,7,DELHI,UDAIPUR,16540,16462,DELHI-UDAIPUR,33002,All
2017,8,DELHI,UDAIPUR,18111,17938,DELHI-UDAIPUR,36049,All
2017,9,DELHI,UDAIPUR,17383,16607,DELHI-UDAIPUR,33990,All
2017,10,DELHI,UDAIPUR,17124,17945,DELHI-UDAIPUR,35069,All
2017,11,DELHI,UDAIPUR,20274,20574,DELHI-UDAIPUR,40848,All
2017,12,DELHI,UDAIPUR,26365,25952,DELHI-UDAIPUR,52317,All
2018,1,DELHI,UDAIPUR,24221,26692,DELHI-UDAIPUR,50913,All
2018,2,DELHI,UDAIPUR,22495,23154,DELHI-UDAIPUR,45649,All
2018,3,DELHI,UDAIPUR,24287,23878,DELHI-UDAIPUR,48165,All
2018,4,DELHI,UDAIPUR,19996,20428,DELHI-UDAIPUR,40424,All
2018,5,DELHI,UDAIPUR,16984,16737,DELHI-UDAIPUR,33721,All
2018,6,DELHI,UDAIPUR,18763,14770,DELHI-UDAIPUR,33533,All
2018,7,DELHI,UDAIPUR,17096,16340,DELHI-UDAIPUR,33436,All
2018,8,DELHI,UDAIPUR,19102,18406,DELHI-UDAIPUR,37508,All
2018,9,DELHI,UDAIPUR,18557,17967,DELHI-UDAIPUR,36524,All
2018,10,DELHI,UDAIPUR,17625,18663,DELHI-UDAIPUR,36288,All
2018,11,DELHI,UDAIPUR,18917,18916,DELHI-UDAIPUR,37833,All
2018,12,DELHI,UDAIPUR,22089,21137,DELHI-UDAIPUR,43226,All
2019,1,DELHI,UDAIPUR,20271,21635,DELHI-UDAIPUR,41906,All
2019,2,DELHI,UDAIPUR,20182,20800,DELHI-UDAIPUR,40982,All
2019,3,DELHI,UDAIPUR,18379,19920,DELHI-UDAIPUR,38299,All
2019,4,DELHI,UDAIPUR,12290,13539,DELHI-UDAIPUR,25829,All
2019,5,DELHI,UDAIPUR,12146,12136,DELHI-UDAIPUR,24282,All
2019,6,DELHI,UDAIPUR,18358,16245,DELHI-UDAIPUR,34603,All
2019,7,DELHI,UDAIPUR,16760,17833,DELHI-UDAIPUR,34593,All
2019,8,DELHI,UDAIPUR,17220,18331,DELHI-UDAIPUR,35551,All
2019,9,DELHI,UDAIPUR,18575,17968,DELHI-UDAIPUR,36543,All
2019,10,DELHI,UDAIPUR,19412,21020,DELHI-UDAIPUR,40432,All
2019,11,DELHI,UDAIPUR,26372,25857,DELHI-UDAIPUR,52229,All
2019,12,DELHI,UDAIPUR,26336,25623,DELHI-UDAIPUR,51959,All
2020,1,DELHI,UDAIPUR,22622,25605,DELHI-UDAIPUR,48227,All
2020,2,DELHI,UDAIPUR,26388,26850,DELHI-UDAIPUR,53238,All
2020,3,DELHI,UDAIPUR,12506,15444,DELHI-UDAIPUR,27950,All
2020,5,DELHI,UDAIPUR,368,222,DELHI-UDAIPUR,590,All
2020,6,DELHI,UDAIPUR,2038,1022,DELHI-UDAIPUR,3060,All
2020,7,DELHI,UDAIPUR,1795,1005,DELHI-UDAIPUR,2800,All
2020,8,DELHI,UDAIPUR,2621,2128,DELHI-UDAIPUR,4749,All
2020,9,DELHI,UDAIPUR,3394,3109,DELHI-UDAIPUR,6503,All
2020,10,DELHI,UDAIPUR,5416,5221,DELHI-UDAIPUR,10637,All
2020,11,DELHI,UDAIPUR,8832,7529,DELHI-UDAIPUR,16361,All
2020,12,DELHI,UDAIPUR,12644,12037,DELHI-UDAIPUR,24681,All
2021,1,DELHI,UDAIPUR,13627,14640,DELHI-UDAIPUR,28267,All
2021,2,DELHI,UDAIPUR,16967,16277,DELHI-UDAIPUR,33244,All
2021,3,DELHI,UDAIPUR,15026,16001,DELHI-UDAIPUR,31027,All
2021,4,DELHI,UDAIPUR,6292,6465,DELHI-UDAIPUR,12757,All
2021,6,DELHI,UDAIPUR,3394,2478,DELHI-UDAIPUR,5872,All
2021,7,DELHI,UDAIPUR,9009,7842,DELHI-UDAIPUR,16851,All
2021,8,DELHI,UDAIPUR,12256,12558,DELHI-UDAIPUR,24814,All
2021,9,DELHI,UDAIPUR,14959,14568,DELHI-UDAIPUR,29527,All
2021,10,DELHI,UDAIPUR,17256,17837,DELHI-UDAIPUR,35093,All
2021,11,DELHI,UDAIPUR,23105,22886,DELHI-UDAIPUR,45991,All
2021,12,DELHI,UDAIPUR,30568,30418,DELHI-UDAIPUR,60986,All
2022,1,DELHI,UDAIPUR,10563,13223,DELHI-UDAIPUR,23786,All
2022,2,DELHI,UDAIPUR,19738,18589,DELHI-UDAIPUR,38327,All
2022,3,DELHI,UDAIPUR,21040,22257,DELHI-UDAIPUR,43297,All
2022,4,DELHI,UDAIPUR,13947,14297,DELHI-UDAIPUR,28244,All
2022,5,DELHI,UDAIPUR,12836,13141,DELHI-UDAIPUR,25977,All
2022,6,DELHI,UDAIPUR,14232,13319,DELHI-UDAIPUR,27551,All
2022,7,DELHI,UDAIPUR,15489,15570,DELHI-UDAIPUR,31059,All
2022,8,DELHI,UDAIPUR,16458,17177,DELHI-UDAIPUR,33635,All
2022,9,DELHI,UDAIPUR,17375,17339,DELHI-UDAIPUR,34714,All
2022,10,DELHI,UDAIPUR,19784,20923,DELHI-UDAIPUR,40707,All
2022,11,DELHI,UDAIPUR,31299,29958,DELHI-UDAIPUR,61257,All
2022,12,DELHI,UDAIPUR,39287,36819,DELHI-UDAIPUR,76106,All
2023,1,DELHI,UDAIPUR,29672,34036,DELHI-UDAIPUR,63708,All
2023,2,DELHI,UDAIPUR,32663,34260,DELHI-UDAIPUR,66923,All
2023,3,DELHI,UDAIPUR,31721,33171,DELHI-UDAIPUR,64892,All
2023,4,DELHI,UDAIPUR,18620,20167,DELHI-UDAIPUR,38787,All
2023,5,DELHI,UDAIPUR,18863,20031,DELHI-UDAIPUR,38894,All
2023,6,DELHI,UDAIPUR,20757,18017,DELHI-UDAIPUR,38774,All
2023,7,DELHI,UDAIPUR,20374,20428,DELHI-UDAIPUR,40802,All
2023,8,DELHI,UDAIPUR,20822,20816,DELHI-UDAIPUR,41638,All
2023,9,DELHI,UDAIPUR,20213,19884,DELHI-UDAIPUR,40097,All
2023,10,DELHI,UDAIPUR,21071,21528,DELHI-UDAIPUR,42599,All
2023,11,DELHI,UDAIPUR,26828,25618,DELHI-UDAIPUR,52446,All
2023,12,DELHI,UDAIPUR,32815,28978,DELHI-UDAIPUR,61793,All
2024,1,DELHI,UDAIPUR,28195,29071,DELHI-UDAIPUR,57266,All
2024,2,DELHI,UDAIPUR,26915,28222,DELHI-UDAIPUR,55137,All
2024,3,DELHI,UDAIPUR,28890,29147,DELHI-UDAIPUR,58037,All
2024,4,DELHI,UDAIPUR,17339,19267,DELHI-UDAIPUR,36606,All
2024,6,DELHI,UDAIPUR,21198,18197,DELHI-UDAIPUR,39395,All
2024,7,DELHI,UDAIPUR,21624,21461,DELHI-UDAIPUR,43085,All
2024,8,DELHI,UDAIPUR,20950,21375,DELHI-UDAIPUR,42325,All
2024,9,DELHI,UDAIPUR,18815,19415,DELHI-UDAIPUR,38230,All
2024,10,DELHI,UDAIPUR,19399,19944,DELHI-UDAIPUR,39343,All
2024,11,DELHI,UDAIPUR,32595,30206,DELHI-UDAIPUR,62801,All
2024,12,DELHI,UDAIPUR,37534,35228,DELHI-UDAIPUR,72762,All
2025,1,DELHI,UDAIPUR,31596,34558,DELHI-UDAIPUR,66154,All
2025,2,DELHI,UDAIPUR,31967,33200,DELHI-UDAIPUR,65167,All
2025,3,DELHI,UDAIPUR,30444,31022,DELHI-UDAIPUR,61466,All
2023,4,DELHI,UTTARLAI,24,30,DELHI-UTTARLAI,54,All
2023,12,DELHI,UTTARLAI,72,0,DELHI-UTTARLAI,72,All
2019,5,DELHI,VADODARA,21538,21884,DELHI-VADODARA,43422,All
2019,6,DELHI,VADODARA,26743,21964,DELHI-VADODARA,48707,All
2019,7,DELHI,VADODARA,24950,25010,DELHI-VADODARA,49960,All
2019,8,DELHI,VADODARA,23389,24210,DELHI-VADODARA,47599,All
2019,9,DELHI,VADODARA,26691,25672,DELHI-VADODARA,52363,All
2019,10,DELHI,VADODARA,24935,28514,DELHI-VADODARA,53449,All
2019,11,DELHI,VADODARA,28818,25428,DELHI-VADODARA,54246,All
2019,12,DELHI,VADODARA,28122,24034,DELHI-VADODARA,52156,All
2020,1,DELHI,VADODARA,26476,28586,DELHI-VADODARA,55062,All
2020,2,DELHI,VADODARA,24857,28633,DELHI-VADODARA,53490,All
2020,3,DELHI,VADODARA,13663,14449,DELHI-VADODARA,28112,All
2020,5,DELHI,VADODARA,534,614,DELHI-VADODARA,1148,All
2020,6,DELHI,VADODARA,3509,2417,DELHI-VADODARA,5926,All
2020,7,DELHI,VADODARA,2799,3247,DELHI-VADODARA,6046,All
2020,8,DELHI,VADODARA,3163,4096,DELHI-VADODARA,7259,All
2020,9,DELHI,VADODARA,4400,5024,DELHI-VADODARA,9424,All
2020,10,DELHI,VADODARA,6123,6930,DELHI-VADODARA,13053,All
2020,11,DELHI,VADODARA,6826,8319,DELHI-VADODARA,15145,All
2020,12,DELHI,VADODARA,8935,8661,DELHI-VADODARA,17596,All
2021,1,DELHI,VADODARA,9106,10128,DELHI-VADODARA,19234,All
2021,2,DELHI,VADODARA,8340,9516,DELHI-VADODARA,17856,All
2021,3,DELHI,VADODARA,7903,8639,DELHI-VADODARA,16542,All
2021,4,DELHI,VADODARA,5784,6638,DELHI-VADODARA,12422,All
2021,6,DELHI,VADODARA,5880,4651,DELHI-VADODARA,10531,All
2021,7,DELHI,VADODARA,8772,7728,DELHI-VADODARA,16500,All
2021,8,DELHI,VADODARA,10942,10944,DELHI-VADODARA,21886,All
2021,9,DELHI,VADODARA,11611,11705,DELHI-VADODARA,23316,All
2021,10,DELHI,VADODARA,15072,16021,DELHI-VADODARA,31093,All
2021,11,DELHI,VADODARA,21666,20752,DELHI-VADODARA,42418,All
2021,12,DELHI,VADODARA,20168,19258,DELHI-VADODARA,39426,All
2022,1,DELHI,VADODARA,11104,11381,DELHI-VADODARA,22485,All
2022,2,DELHI,VADODARA,12350,16110,DELHI-VADODARA,28460,All
2022,3,DELHI,VADODARA,16195,18633,DELHI-VADODARA,34828,All
2022,4,DELHI,VADODARA,17119,20080,DELHI-VADODARA,37199,All
2022,5,DELHI,VADODARA,20017,22831,DELHI-VADODARA,42848,All
2022,6,DELHI,VADODARA,20036,16785,DELHI-VADODARA,36821,All
2022,7,DELHI,VADODARA,15326,15647,DELHI-VADODARA,30973,All
2022,8,DELHI,VADODARA,15517,15781,DELHI-VADODARA,31298,All
2022,9,DELHI,VADODARA,16651,17270,DELHI-VADODARA,33921,All
2022,10,DELHI,VADODARA,16523,20200,DELHI-VADODARA,36723,All
2022,11,DELHI,VADODARA,23932,18872,DELHI-VADODARA,42804,All
2022,12,DELHI,VADODARA,23752,20042,DELHI-VADODARA,43794,All
2023,1,DELHI,VADODARA,21393,23210,DELHI-VADODARA,44603,All
2023,2,DELHI,VADODARA,19620,22746,DELHI-VADODARA,42366,All
2023,3,DELHI,VADODARA,19537,22044,DELHI-VADODARA,41581,All
2023,4,DELHI,VADODARA,16818,20605,DELHI-VADODARA,37423,All
2023,5,DELHI,VADODARA,22896,24204,DELHI-VADODARA,47100,All
2023,6,DELHI,VADODARA,22177,17691,DELHI-VADODARA,39868,All
2023,7,DELHI,VADODARA,17358,16901,DELHI-VADODARA,34259,All
2023,8,DELHI,VADODARA,18206,16972,DELHI-VADODARA,35178,All
2023,9,DELHI,VADODARA,19163,18612,DELHI-VADODARA,37775,All
2023,10,DELHI,VADODARA,18804,18576,DELHI-VADODARA,37380,All
2023,11,DELHI,VADODARA,19406,20334,DELHI-VADODARA,39740,All
2023,12,DELHI,VADODARA,22227,19317,DELHI-VADODARA,41544,All
2024,1,DELHI,VADODARA,20088,19771,DELHI-VADODARA,39859,All
2024,2,DELHI,VADODARA,16133,19452,DELHI-VADODARA,35585,All
2024,3,DELHI,VADODARA,18826,20271,DELHI-VADODARA,39097,All
2024,4,DELHI,VADODARA,21196,23288,DELHI-VADODARA,44484,All
2024,6,DELHI,VADODARA,21758,18371,DELHI-VADODARA,40129,All
2024,7,DELHI,VADODARA,20136,19473,DELHI-VADODARA,39609,All
2024,8,DELHI,VADODARA,20105,21048,DELHI-VADODARA,41153,All
2024,9,DELHI,VADODARA,21328,21741,DELHI-VADODARA,43069,All
2024,10,DELHI,VADODARA,20161,23025,DELHI-VADODARA,43186,All
2024,11,DELHI,VADODARA,26388,24255,DELHI-VADODARA,50643,All
2024,12,DELHI,VADODARA,28957,24242,DELHI-VADODARA,53199,All
2025,1,DELHI,VADODARA,26730,26932,DELHI-VADODARA,53662,All
2025,2,DELHI,VADODARA,24725,26566,DELHI-VADODARA,51291,All
2025,3,DELHI,VADODARA,23434,25169,DELHI-VADODARA,48603,All
2015,4,DELHI,VARANASI,25494,23472,DELHI-VARANASI,48966,All
2015,5,DELHI,VARANASI,29132,26512,DELHI-VARANASI,55644,All
2015,6,DELHI,VARANASI,26145,28599,DELHI-VARANASI,54744,All
2015,7,DELHI,VARANASI,25095,26548,DELHI-VARANASI,51643,All
2015,8,DELHI,VARANASI,25830,27860,DELHI-VARANASI,53690,All
2015,9,DELHI,VARANASI,25066,24160,DELHI-VARANASI,49226,All
2015,10,DELHI,VARANASI,27864,27170,DELHI-VARANASI,55034,All
2015,11,DELHI,VARANASI,37487,33982,DELHI-VARANASI,71469,All
2015,12,DELHI,VARANASI,34450,34976,DELHI-VARANASI,69426,All
2016,1,DELHI,VARANASI,33551,34390,DELHI-VARANASI,67941,All
2016,2,DELHI,VARANASI,35622,36095,DELHI-VARANASI,71717,All
2016,3,DELHI,VARANASI,39743,40109,DELHI-VARANASI,79852,All
2016,4,DELHI,VARANASI,40347,36760,DELHI-VARANASI,77107,All
2016,5,DELHI,VARANASI,35395,36663,DELHI-VARANASI,72058,All
2016,6,DELHI,VARANASI,34922,32403,DELHI-VARANASI,67325,All
2016,7,DELHI,VARANASI,37559,36780,DELHI-VARANASI,74339,All
2016,8,DELHI,VARANASI,36811,36950,DELHI-VARANASI,73761,All
2016,9,DELHI,VARANASI,36187,33595,DELHI-VARANASI,69782,All
2016,10,DELHI,VARANASI,41217,35189,DELHI-VARANASI,76406,All
2016,11,DELHI,VARANASI,45293,45343,DELHI-VARANASI,90636,All
2016,12,DELHI,VARANASI,38839,39489,DELHI-VARANASI,78328,All
2017,1,DELHI,VARANASI,43187,44143,DELHI-VARANASI,87330,All
2017,2,DELHI,VARANASI,43976,43252,DELHI-VARANASI,87228,All
2017,3,DELHI,VARANASI,35245,36327,DELHI-VARANASI,71572,All
2017,4,DELHI,VARANASI,27093,28928,DELHI-VARANASI,56021,All
2017,5,DELHI,VARANASI,26239,26977,DELHI-VARANASI,53216,All
2017,6,DELHI,VARANASI,31970,32909,DELHI-VARANASI,64879,All
2017,7,DELHI,VARANASI,31370,32781,DELHI-VARANASI,64151,All
2017,8,DELHI,VARANASI,33068,33430,DELHI-VARANASI,66498,All
2017,9,DELHI,VARANASI,29389,28791,DELHI-VARANASI,58180,All
2017,10,DELHI,VARANASI,39505,36780,DELHI-VARANASI,76285,All
2017,11,DELHI,VARANASI,39370,38940,DELHI-VARANASI,78310,All
2017,12,DELHI,VARANASI,42716,43193,DELHI-VARANASI,85909,All
2018,1,DELHI,VARANASI,45504,45071,DELHI-VARANASI,90575,All
2018,2,DELHI,VARANASI,43043,42404,DELHI-VARANASI,85447,All
2018,3,DELHI,VARANASI,48897,49433,DELHI-VARANASI,98330,All
2018,4,DELHI,VARANASI,42102,39886,DELHI-VARANASI,81988,All
2018,5,DELHI,VARANASI,39156,39009,DELHI-VARANASI,78165,All
2018,6,DELHI,VARANASI,40205,36068,DELHI-VARANASI,76273,All
2018,7,DELHI,VARANASI,40101,41763,DELHI-VARANASI,81864,All
2018,8,DELHI,VARANASI,40190,39542,DELHI-VARANASI,79732,All
2018,9,DELHI,VARANASI,38611,38083,DELHI-VARANASI,76694,All
2018,10,DELHI,VARANASI,40473,37194,DELHI-VARANASI,77667,All
2018,11,DELHI,VARANASI,41591,38497,DELHI-VARANASI,80088,All
2018,12,DELHI,VARANASI,43737,42601,DELHI-VARANASI,86338,All
2019,1,DELHI,VARANASI,43853,43586,DELHI-VARANASI,87439,All
2019,2,DELHI,VARANASI,44006,45184,DELHI-VARANASI,89190,All
2019,3,DELHI,VARANASI,38968,41341,DELHI-VARANASI,80309,All
2019,4,DELHI,VARANASI,30709,29431,DELHI-VARANASI,60140,All
2019,5,DELHI,VARANASI,34248,31856,DELHI-VARANASI,66104,All
2019,6,DELHI,VARANASI,35166,37907,DELHI-VARANASI,73073,All
2019,7,DELHI,VARANASI,33407,33934,DELHI-VARANASI,67341,All
2019,8,DELHI,VARANASI,33947,34240,DELHI-VARANASI,68187,All
2019,9,DELHI,VARANASI,32732,34503,DELHI-VARANASI,67235,All
2019,10,DELHI,VARANASI,38155,34504,DELHI-VARANASI,72659,All
2019,11,DELHI,VARANASI,45234,46906,DELHI-VARANASI,92140,All
2019,12,DELHI,VARANASI,36591,35690,DELHI-VARANASI,72281,All
2020,1,DELHI,VARANASI,36442,36706,DELHI-VARANASI,73148,All
2020,2,DELHI,VARANASI,44711,45358,DELHI-VARANASI,90069,All
2020,3,DELHI,VARANASI,29291,28000,DELHI-VARANASI,57291,All
2020,5,DELHI,VARANASI,3517,1308,DELHI-VARANASI,4825,All
2020,6,DELHI,VARANASI,16818,5834,DELHI-VARANASI,22652,All
2020,7,DELHI,VARANASI,11151,7548,DELHI-VARANASI,18699,All
2020,8,DELHI,VARANASI,10766,21414,DELHI-VARANASI,32180,All
2020,9,DELHI,VARANASI,11442,22909,DELHI-VARANASI,34351,All
2020,10,DELHI,VARANASI,19666,18707,DELHI-VARANASI,38373,All
2020,11,DELHI,VARANASI,33717,18853,DELHI-VARANASI,52570,All
2020,12,DELHI,VARANASI,21232,29983,DELHI-VARANASI,51215,All
2021,1,DELHI,VARANASI,17957,19035,DELHI-VARANASI,36992,All
2021,2,DELHI,VARANASI,20003,19695,DELHI-VARANASI,39698,All
2021,3,DELHI,VARANASI,24031,20113,DELHI-VARANASI,44144,All
2021,4,DELHI,VARANASI,33232,16936,DELHI-VARANASI,50168,All
2021,6,DELHI,VARANASI,9941,12222,DELHI-VARANASI,22163,All
2021,7,DELHI,VARANASI,14398,15684,DELHI-VARANASI,30082,All
2021,8,DELHI,VARANASI,18524,20075,DELHI-VARANASI,38599,All
2021,9,DELHI,VARANASI,19724,19178,DELHI-VARANASI,38902,All
2021,10,DELHI,VARANASI,27325,23576,DELHI-VARANASI,50901,All
2021,11,DELHI,VARANASI,43196,37230,DELHI-VARANASI,80426,All
2021,12,DELHI,VARANASI,30271,36374,DELHI-VARANASI,66645,All
2022,1,DELHI,VARANASI,18306,16531,DELHI-VARANASI,34837,All
2022,2,DELHI,VARANASI,29093,27654,DELHI-VARANASI,56747,All
2022,3,DELHI,VARANASI,37602,36061,DELHI-VARANASI,73663,All
2022,4,DELHI,VARANASI,38843,31470,DELHI-VARANASI,70313,All
2022,5,DELHI,VARANASI,34385,27985,DELHI-VARANASI,62370,All
2022,6,DELHI,VARANASI,29031,29508,DELHI-VARANASI,58539,All
2022,7,DELHI,VARANASI,23523,23492,DELHI-VARANASI,47015,All
2022,8,DELHI,VARANASI,23877,24438,DELHI-VARANASI,48315,All
2022,9,DELHI,VARANASI,29241,27406,DELHI-VARANASI,56647,All
2022,10,DELHI,VARANASI,31683,28104,DELHI-VARANASI,59787,All
2022,11,DELHI,VARANASI,39910,39947,DELHI-VARANASI,79857,All
2022,12,DELHI,VARANASI,31573,31647,DELHI-VARANASI,63220,All
2023,1,DELHI,VARANASI,30161,29868,DELHI-VARANASI,60029,All
2023,2,DELHI,VARANASI,36410,35999,DELHI-VARANASI,72409,All
2023,3,DELHI,VARANASI,40398,40010,DELHI-VARANASI,80408,All
2023,4,DELHI,VARANASI,32398,31115,DELHI-VARANASI,63513,All
2023,5,DELHI,VARANASI,34461,31652,DELHI-VARANASI,66113,All
2023,6,DELHI,VARANASI,32277,31721,DELHI-VARANASI,63998,All
2023,7,DELHI,VARANASI,31286,32193,DELHI-VARANASI,63479,All
2023,8,DELHI,VARANASI,32890,32369,DELHI-VARANASI,65259,All
2023,9,DELHI,VARANASI,31078,31030,DELHI-VARANASI,62108,All
2023,10,DELHI,VARANASI,33855,31916,DELHI-VARANASI,65771,All
2023,11,DELHI,VARANASI,39627,35421,DELHI-VARANASI,75048,All
2023,12,DELHI,VARANASI,32657,32979,DELHI-VARANASI,65636,All
2024,1,DELHI,VARANASI,26000,26929,DELHI-VARANASI,52929,All
2024,2,DELHI,VARANASI,32282,32071,DELHI-VARANASI,64353,All
2024,3,DELHI,VARANASI,36544,34936,DELHI-VARANASI,71480,All
2024,4,DELHI,VARANASI,34189,31359,DELHI-VARANASI,65548,All
2024,6,DELHI,VARANASI,33150,31200,DELHI-VARANASI,64350,All
2024,7,DELHI,VARANASI,32150,35449,DELHI-VARANASI,67599,All
2024,8,DELHI,VARANASI,31958,34202,DELHI-VARANASI,66160,All
2024,9,DELHI,VARANASI,30898,31104,DELHI-VARANASI,62002,All
2024,10,DELHI,VARANASI,35107,28857,DELHI-VARANASI,63964,All
2024,11,DELHI,VARANASI,44949,45963,DELHI-VARANASI,90912,All
2024,12,DELHI,VARANASI,33605,34720,DELHI-VARANASI,68325,All
2025,1,DELHI,VARANASI,27370,28440,DELHI-VARANASI,55810,All
2025,2,DELHI,VARANASI,41053,41988,DELHI-VARANASI,83041,All
2025,3,DELHI,VARANASI,46057,47732,DELHI-VARANASI,93789,All
2015,4,DELHI,VIJAYAWADA,3545,3669,DELHI-VIJAYAWADA,7214,All
2015,5,DELHI,VIJAYAWADA,3948,3693,DELHI-VIJAYAWADA,7641,All
2015,6,DELHI,VIJAYAWADA,3217,3000,DELHI-VIJAYAWADA,6217,All
2015,7,DELHI,VIJAYAWADA,3401,3470,DELHI-VIJAYAWADA,6871,All
2015,8,DELHI,VIJAYAWADA,3009,3239,DELHI-VIJAYAWADA,6248,All
2015,9,DELHI,VIJAYAWADA,2714,2973,DELHI-VIJAYAWADA,5687,All
2015,10,DELHI,VIJAYAWADA,5858,1193,DELHI-VIJAYAWADA,7051,All
2015,11,DELHI,VIJAYAWADA,3045,3278,DELHI-VIJAYAWADA,6323,All
2015,12,DELHI,VIJAYAWADA,4050,3657,DELHI-VIJAYAWADA,7707,All
2016,1,DELHI,VIJAYAWADA,3269,3833,DELHI-VIJAYAWADA,7102,All
2016,2,DELHI,VIJAYAWADA,3256,3191,DELHI-VIJAYAWADA,6447,All
2016,3,DELHI,VIJAYAWADA,3206,3283,DELHI-VIJAYAWADA,6489,All
2016,4,DELHI,VIJAYAWADA,4220,4366,DELHI-VIJAYAWADA,8586,All
2016,5,DELHI,VIJAYAWADA,6490,6193,DELHI-VIJAYAWADA,12683,All
2016,6,DELHI,VIJAYAWADA,6071,4575,DELHI-VIJAYAWADA,10646,All
2016,7,DELHI,VIJAYAWADA,6618,6037,DELHI-VIJAYAWADA,12655,All
2016,8,DELHI,VIJAYAWADA,6373,6555,DELHI-VIJAYAWADA,12928,All
2016,9,DELHI,VIJAYAWADA,5120,5824,DELHI-VIJAYAWADA,10944,All
2016,10,DELHI,VIJAYAWADA,5848,5249,DELHI-VIJAYAWADA,11097,All
2016,11,DELHI,VIJAYAWADA,5629,5478,DELHI-VIJAYAWADA,11107,All
2016,12,DELHI,VIJAYAWADA,7444,5481,DELHI-VIJAYAWADA,12925,All
2017,1,DELHI,VIJAYAWADA,6411,6824,DELHI-VIJAYAWADA,13235,All
2017,2,DELHI,VIJAYAWADA,6195,6417,DELHI-VIJAYAWADA,12612,All
2017,3,DELHI,VIJAYAWADA,6322,6288,DELHI-VIJAYAWADA,12610,All
2017,4,DELHI,VIJAYAWADA,6333,6921,DELHI-VIJAYAWADA,13254,All
2017,5,DELHI,VIJAYAWADA,8016,7512,DELHI-VIJAYAWADA,15528,All
2017,6,DELHI,VIJAYAWADA,7451,6532,DELHI-VIJAYAWADA,13983,All
2017,7,DELHI,VIJAYAWADA,7757,7083,DELHI-VIJAYAWADA,14840,All
2017,8,DELHI,VIJAYAWADA,6573,7088,DELHI-VIJAYAWADA,13661,All
2017,9,DELHI,VIJAYAWADA,6091,6820,DELHI-VIJAYAWADA,12911,All
2017,10,DELHI,VIJAYAWADA,5931,5988,DELHI-VIJAYAWADA,11919,All
2017,11,DELHI,VIJAYAWADA,5574,5105,DELHI-VIJAYAWADA,10679,All
2017,12,DELHI,VIJAYAWADA,6834,5887,DELHI-VIJAYAWADA,12721,All
2018,1,DELHI,VIJAYAWADA,7101,7967,DELHI-VIJAYAWADA,15068,All
2018,2,DELHI,VIJAYAWADA,7470,7771,DELHI-VIJAYAWADA,15241,All
2018,3,DELHI,VIJAYAWADA,7966,7967,DELHI-VIJAYAWADA,15933,All
2018,4,DELHI,VIJAYAWADA,7636,8958,DELHI-VIJAYAWADA,16594,All
2018,5,DELHI,VIJAYAWADA,9243,8670,DELHI-VIJAYAWADA,17913,All
2018,6,DELHI,VIJAYAWADA,9264,7230,DELHI-VIJAYAWADA,16494,All
2018,7,DELHI,VIJAYAWADA,8335,8499,DELHI-VIJAYAWADA,16834,All
2018,8,DELHI,VIJAYAWADA,7674,7872,DELHI-VIJAYAWADA,15546,All
2018,9,DELHI,VIJAYAWADA,6587,7164,DELHI-VIJAYAWADA,13751,All
2018,10,DELHI,VIJAYAWADA,10702,10528,DELHI-VIJAYAWADA,21230,All
2018,11,DELHI,VIJAYAWADA,10790,9455,DELHI-VIJAYAWADA,20245,All
2018,12,DELHI,VIJAYAWADA,13491,10070,DELHI-VIJAYAWADA,23561,All
2019,1,DELHI,VIJAYAWADA,10014,11552,DELHI-VIJAYAWADA,21566,All
2019,2,DELHI,VIJAYAWADA,10398,9923,DELHI-VIJAYAWADA,20321,All
2019,3,DELHI,VIJAYAWADA,9959,9717,DELHI-VIJAYAWADA,19676,All
2019,4,DELHI,VIJAYAWADA,8607,9665,DELHI-VIJAYAWADA,18272,All
2019,5,DELHI,VIJAYAWADA,14364,13345,DELHI-VIJAYAWADA,27709,All
2019,6,DELHI,VIJAYAWADA,14140,12448,DELHI-VIJAYAWADA,26588,All
2019,7,DELHI,VIJAYAWADA,10213,10417,DELHI-VIJAYAWADA,20630,All
2019,8,DELHI,VIJAYAWADA,9102,10650,DELHI-VIJAYAWADA,19752,All
2019,9,DELHI,VIJAYAWADA,6965,7668,DELHI-VIJAYAWADA,14633,All
2019,10,DELHI,VIJAYAWADA,7719,7565,DELHI-VIJAYAWADA,15284,All
2019,11,DELHI,VIJAYAWADA,7834,7224,DELHI-VIJAYAWADA,15058,All
2019,12,DELHI,VIJAYAWADA,8818,8345,DELHI-VIJAYAWADA,17163,All
2020,1,DELHI,VIJAYAWADA,6689,7700,DELHI-VIJAYAWADA,14389,All
2020,2,DELHI,VIJAYAWADA,7199,8124,DELHI-VIJAYAWADA,15323,All
2020,3,DELHI,VIJAYAWADA,5393,4996,DELHI-VIJAYAWADA,10389,All
2020,5,DELHI,VIJAYAWADA,404,463,DELHI-VIJAYAWADA,867,All
2020,6,DELHI,VIJAYAWADA,1375,1266,DELHI-VIJAYAWADA,2641,All
2020,7,DELHI,VIJAYAWADA,1512,1456,DELHI-VIJAYAWADA,2968,All
2020,8,DELHI,VIJAYAWADA,2239,2279,DELHI-VIJAYAWADA,4518,All
2020,9,DELHI,VIJAYAWADA,3615,3409,DELHI-VIJAYAWADA,7024,All
2020,10,DELHI,VIJAYAWADA,5477,5330,DELHI-VIJAYAWADA,10807,All
2020,11,DELHI,VIJAYAWADA,6314,6343,DELHI-VIJAYAWADA,12657,All
2020,12,DELHI,VIJAYAWADA,8809,8116,DELHI-VIJAYAWADA,16925,All
2021,1,DELHI,VIJAYAWADA,9188,10039,DELHI-VIJAYAWADA,19227,All
2021,2,DELHI,VIJAYAWADA,7538,9027,DELHI-VIJAYAWADA,16565,All
2021,3,DELHI,VIJAYAWADA,7928,8424,DELHI-VIJAYAWADA,16352,All
2021,4,DELHI,VIJAYAWADA,7879,7569,DELHI-VIJAYAWADA,15448,All
2021,6,DELHI,VIJAYAWADA,3803,3722,DELHI-VIJAYAWADA,7525,All
2021,7,DELHI,VIJAYAWADA,7016,6699,DELHI-VIJAYAWADA,13715,All
2021,8,DELHI,VIJAYAWADA,7788,8319,DELHI-VIJAYAWADA,16107,All
2021,9,DELHI,VIJAYAWADA,6907,7596,DELHI-VIJAYAWADA,14503,All
2021,10,DELHI,VIJAYAWADA,9285,9655,DELHI-VIJAYAWADA,18940,All
2021,11,DELHI,VIJAYAWADA,8790,9092,DELHI-VIJAYAWADA,17882,All
2021,12,DELHI,VIJAYAWADA,9427,9442,DELHI-VIJAYAWADA,18869,All
2022,1,DELHI,VIJAYAWADA,7120,7299,DELHI-VIJAYAWADA,14419,All
2022,2,DELHI,VIJAYAWADA,7878,8472,DELHI-VIJAYAWADA,16350,All
2022,3,DELHI,VIJAYAWADA,7012,7081,DELHI-VIJAYAWADA,14093,All
2022,4,DELHI,VIJAYAWADA,5128,5186,DELHI-VIJAYAWADA,10314,All
2022,5,DELHI,VIJAYAWADA,6459,6421,DELHI-VIJAYAWADA,12880,All
2022,6,DELHI,VIJAYAWADA,9344,9219,DELHI-VIJAYAWADA,18563,All
2022,7,DELHI,VIJAYAWADA,10038,9948,DELHI-VIJAYAWADA,19986,All
2022,8,DELHI,VIJAYAWADA,9154,10112,DELHI-VIJAYAWADA,19266,All
2022,9,DELHI,VIJAYAWADA,8440,9511,DELHI-VIJAYAWADA,17951,All
2022,10,DELHI,VIJAYAWADA,8855,8974,DELHI-VIJAYAWADA,17829,All
2022,11,DELHI,VIJAYAWADA,8870,8358,DELHI-VIJAYAWADA,17228,All
2022,12,DELHI,VIJAYAWADA,9811,8487,DELHI-VIJAYAWADA,18298,All
2023,1,DELHI,VIJAYAWADA,7930,8489,DELHI-VIJAYAWADA,16419,All
2023,2,DELHI,VIJAYAWADA,8084,8747,DELHI-VIJAYAWADA,16831,All
2023,3,DELHI,VIJAYAWADA,9032,8825,DELHI-VIJAYAWADA,17857,All
2023,4,DELHI,VIJAYAWADA,8782,9325,DELHI-VIJAYAWADA,18107,All
2023,5,DELHI,VIJAYAWADA,10038,9643,DELHI-VIJAYAWADA,19681,All
2023,6,DELHI,VIJAYAWADA,9619,9093,DELHI-VIJAYAWADA,18712,All
2023,7,DELHI,VIJAYAWADA,9649,9848,DELHI-VIJAYAWADA,19497,All
2023,8,DELHI,VIJAYAWADA,8831,9364,DELHI-VIJAYAWADA,18195,All
2023,9,DELHI,VIJAYAWADA,7359,8348,DELHI-VIJAYAWADA,15707,All
2023,10,DELHI,VIJAYAWADA,8048,7899,DELHI-VIJAYAWADA,15947,All
2023,11,DELHI,VIJAYAWADA,7998,7198,DELHI-VIJAYAWADA,15196,All
2023,12,DELHI,VIJAYAWADA,10021,7405,DELHI-VIJAYAWADA,17426,All
2024,1,DELHI,VIJAYAWADA,7545,7780,DELHI-VIJAYAWADA,15325,All
2024,2,DELHI,VIJAYAWADA,7768,7649,DELHI-VIJAYAWADA,15417,All
2024,3,DELHI,VIJAYAWADA,9177,7878,DELHI-VIJAYAWADA,17055,All
2024,4,DELHI,VIJAYAWADA,8235,9315,DELHI-VIJAYAWADA,17550,All
2024,6,DELHI,VIJAYAWADA,10333,8915,DELHI-VIJAYAWADA,19248,All
2024,7,DELHI,VIJAYAWADA,10093,9771,DELHI-VIJAYAWADA,19864,All
2024,8,DELHI,VIJAYAWADA,8651,9355,DELHI-VIJAYAWADA,18006,All
2024,9,DELHI,VIJAYAWADA,8266,9507,DELHI-VIJAYAWADA,17773,All
2024,10,DELHI,VIJAYAWADA,11094,12439,DELHI-VIJAYAWADA,23533,All
2024,11,DELHI,VIJAYAWADA,12853,11816,DELHI-VIJAYAWADA,24669,All
2024,12,DELHI,VIJAYAWADA,15609,13732,DELHI-VIJAYAWADA,29341,All
2025,1,DELHI,VIJAYAWADA,11019,12998,DELHI-VIJAYAWADA,24017,All
2025,2,DELHI,VIJAYAWADA,13278,15686,DELHI-VIJAYAWADA,28964,All
2025,3,DELHI,VIJAYAWADA,11502,12234,DELHI-VIJAYAWADA,23736,All
2015,4,DELHI,VISAKHAPATNAM,8101,8264,DELHI-VISAKHAPATNAM,16365,All
2015,5,DELHI,VISAKHAPATNAM,10719,9548,DELHI-VISAKHAPATNAM,20267,All
2015,6,DELHI,VISAKHAPATNAM,10252,8106,DELHI-VISAKHAPATNAM,18358,All
2015,7,DELHI,VISAKHAPATNAM,8918,8701,DELHI-VISAKHAPATNAM,17619,All
2015,8,DELHI,VISAKHAPATNAM,7729,8307,DELHI-VISAKHAPATNAM,16036,All
2015,9,DELHI,VISAKHAPATNAM,7564,7654,DELHI-VISAKHAPATNAM,15218,All
2015,10,DELHI,VISAKHAPATNAM,7213,6649,DELHI-VISAKHAPATNAM,13862,All
2015,11,DELHI,VISAKHAPATNAM,12001,11593,DELHI-VISAKHAPATNAM,23594,All
2015,12,DELHI,VISAKHAPATNAM,18206,14558,DELHI-VISAKHAPATNAM,32764,All
2016,1,DELHI,VISAKHAPATNAM,16317,17766,DELHI-VISAKHAPATNAM,34083,All
2016,2,DELHI,VISAKHAPATNAM,14772,15919,DELHI-VISAKHAPATNAM,30691,All
2016,3,DELHI,VISAKHAPATNAM,16340,18294,DELHI-VISAKHAPATNAM,34634,All
2016,4,DELHI,VISAKHAPATNAM,16259,17981,DELHI-VISAKHAPATNAM,34240,All
2016,5,DELHI,VISAKHAPATNAM,20022,19937,DELHI-VISAKHAPATNAM,39959,All
2016,6,DELHI,VISAKHAPATNAM,17753,15557,DELHI-VISAKHAPATNAM,33310,All
2016,7,DELHI,VISAKHAPATNAM,14974,14471,DELHI-VISAKHAPATNAM,29445,All
2016,8,DELHI,VISAKHAPATNAM,12193,12023,DELHI-VISAKHAPATNAM,24216,All
2016,9,DELHI,VISAKHAPATNAM,10719,11541,DELHI-VISAKHAPATNAM,22260,All
2016,10,DELHI,VISAKHAPATNAM,11751,11647,DELHI-VISAKHAPATNAM,23398,All
2016,11,DELHI,VISAKHAPATNAM,12839,12350,DELHI-VISAKHAPATNAM,25189,All
2016,12,DELHI,VISAKHAPATNAM,15559,11543,DELHI-VISAKHAPATNAM,27102,All
2017,1,DELHI,VISAKHAPATNAM,13144,13904,DELHI-VISAKHAPATNAM,27048,All
2017,2,DELHI,VISAKHAPATNAM,11003,11506,DELHI-VISAKHAPATNAM,22509,All
2017,3,DELHI,VISAKHAPATNAM,10874,10869,DELHI-VISAKHAPATNAM,21743,All
2017,4,DELHI,VISAKHAPATNAM,10856,11640,DELHI-VISAKHAPATNAM,22496,All
2017,5,DELHI,VISAKHAPATNAM,15152,14186,DELHI-VISAKHAPATNAM,29338,All
2017,6,DELHI,VISAKHAPATNAM,14208,11978,DELHI-VISAKHAPATNAM,26186,All
2017,7,DELHI,VISAKHAPATNAM,10777,10725,DELHI-VISAKHAPATNAM,21502,All
2017,8,DELHI,VISAKHAPATNAM,10337,11472,DELHI-VISAKHAPATNAM,21809,All
2017,9,DELHI,VISAKHAPATNAM,9585,10873,DELHI-VISAKHAPATNAM,20458,All
2017,10,DELHI,VISAKHAPATNAM,14040,14004,DELHI-VISAKHAPATNAM,28044,All
2017,11,DELHI,VISAKHAPATNAM,14514,13395,DELHI-VISAKHAPATNAM,27909,All
2017,12,DELHI,VISAKHAPATNAM,15394,12850,DELHI-VISAKHAPATNAM,28244,All
2018,1,DELHI,VISAKHAPATNAM,15327,16416,DELHI-VISAKHAPATNAM,31743,All
2018,2,DELHI,VISAKHAPATNAM,13160,13675,DELHI-VISAKHAPATNAM,26835,All
2018,3,DELHI,VISAKHAPATNAM,16277,15655,DELHI-VISAKHAPATNAM,31932,All
2018,4,DELHI,VISAKHAPATNAM,15491,16271,DELHI-VISAKHAPATNAM,31762,All
2018,5,DELHI,VISAKHAPATNAM,15533,15570,DELHI-VISAKHAPATNAM,31103,All
2018,6,DELHI,VISAKHAPATNAM,16339,14172,DELHI-VISAKHAPATNAM,30511,All
2018,7,DELHI,VISAKHAPATNAM,16759,17445,DELHI-VISAKHAPATNAM,34204,All
2018,8,DELHI,VISAKHAPATNAM,16631,16649,DELHI-VISAKHAPATNAM,33280,All
2018,9,DELHI,VISAKHAPATNAM,16523,17445,DELHI-VISAKHAPATNAM,33968,All
2018,10,DELHI,VISAKHAPATNAM,17402,17693,DELHI-VISAKHAPATNAM,35095,All
2018,11,DELHI,VISAKHAPATNAM,14512,13363,DELHI-VISAKHAPATNAM,27875,All
2018,12,DELHI,VISAKHAPATNAM,16209,14946,DELHI-VISAKHAPATNAM,31155,All
2019,1,DELHI,VISAKHAPATNAM,13999,15675,DELHI-VISAKHAPATNAM,29674,All
2019,2,DELHI,VISAKHAPATNAM,13981,14298,DELHI-VISAKHAPATNAM,28279,All
2019,3,DELHI,VISAKHAPATNAM,14181,13594,DELHI-VISAKHAPATNAM,27775,All
2019,4,DELHI,VISAKHAPATNAM,12178,13079,DELHI-VISAKHAPATNAM,25257,All
2019,5,DELHI,VISAKHAPATNAM,19802,18635,DELHI-VISAKHAPATNAM,38437,All
2019,6,DELHI,VISAKHAPATNAM,21542,19608,DELHI-VISAKHAPATNAM,41150,All
2019,7,DELHI,VISAKHAPATNAM,19694,19199,DELHI-VISAKHAPATNAM,38893,All
2019,8,DELHI,VISAKHAPATNAM,19139,19094,DELHI-VISAKHAPATNAM,38233,All
2019,9,DELHI,VISAKHAPATNAM,17011,17707,DELHI-VISAKHAPATNAM,34718,All
2019,10,DELHI,VISAKHAPATNAM,17272,17624,DELHI-VISAKHAPATNAM,34896,All
2019,11,DELHI,VISAKHAPATNAM,21544,20480,DELHI-VISAKHAPATNAM,42024,All
2019,12,DELHI,VISAKHAPATNAM,22295,19514,DELHI-VISAKHAPATNAM,41809,All
2020,1,DELHI,VISAKHAPATNAM,19329,18992,DELHI-VISAKHAPATNAM,38321,All
2020,2,DELHI,VISAKHAPATNAM,16647,18600,DELHI-VISAKHAPATNAM,35247,All
2020,3,DELHI,VISAKHAPATNAM,11864,10152,DELHI-VISAKHAPATNAM,22016,All
2020,5,DELHI,VISAKHAPATNAM,1083,1043,DELHI-VISAKHAPATNAM,2126,All
2020,6,DELHI,VISAKHAPATNAM,6192,4794,DELHI-VISAKHAPATNAM,10986,All
2020,7,DELHI,VISAKHAPATNAM,6592,4585,DELHI-VISAKHAPATNAM,11177,All
2020,8,DELHI,VISAKHAPATNAM,8372,6851,DELHI-VISAKHAPATNAM,15223,All
2020,9,DELHI,VISAKHAPATNAM,9545,9011,DELHI-VISAKHAPATNAM,18556,All
2020,10,DELHI,VISAKHAPATNAM,11508,10901,DELHI-VISAKHAPATNAM,22409,All
2020,11,DELHI,VISAKHAPATNAM,12545,13084,DELHI-VISAKHAPATNAM,25629,All
2020,12,DELHI,VISAKHAPATNAM,15262,11576,DELHI-VISAKHAPATNAM,26838,All
2021,1,DELHI,VISAKHAPATNAM,13215,12685,DELHI-VISAKHAPATNAM,25900,All
2021,2,DELHI,VISAKHAPATNAM,11845,12276,DELHI-VISAKHAPATNAM,24121,All
2021,3,DELHI,VISAKHAPATNAM,13186,12919,DELHI-VISAKHAPATNAM,26105,All
2021,4,DELHI,VISAKHAPATNAM,12607,11069,DELHI-VISAKHAPATNAM,23676,All
2021,6,DELHI,VISAKHAPATNAM,6469,8485,DELHI-VISAKHAPATNAM,14954,All
2021,7,DELHI,VISAKHAPATNAM,9367,10541,DELHI-VISAKHAPATNAM,19908,All
2021,8,DELHI,VISAKHAPATNAM,14694,13929,DELHI-VISAKHAPATNAM,28623,All
2021,9,DELHI,VISAKHAPATNAM,12378,13342,DELHI-VISAKHAPATNAM,25720,All
2021,10,DELHI,VISAKHAPATNAM,14672,15207,DELHI-VISAKHAPATNAM,29879,All
2021,11,DELHI,VISAKHAPATNAM,19109,20022,DELHI-VISAKHAPATNAM,39131,All
2021,12,DELHI,VISAKHAPATNAM,21294,18126,DELHI-VISAKHAPATNAM,39420,All
2022,1,DELHI,VISAKHAPATNAM,13773,13526,DELHI-VISAKHAPATNAM,27299,All
2022,2,DELHI,VISAKHAPATNAM,13728,15420,DELHI-VISAKHAPATNAM,29148,All
2022,3,DELHI,VISAKHAPATNAM,19334,18712,DELHI-VISAKHAPATNAM,38046,All
2022,4,DELHI,VISAKHAPATNAM,18312,17821,DELHI-VISAKHAPATNAM,36133,All
2022,5,DELHI,VISAKHAPATNAM,20841,18250,DELHI-VISAKHAPATNAM,39091,All
2022,6,DELHI,VISAKHAPATNAM,22750,19420,DELHI-VISAKHAPATNAM,42170,All
2022,7,DELHI,VISAKHAPATNAM,17198,16673,DELHI-VISAKHAPATNAM,33871,All
2022,8,DELHI,VISAKHAPATNAM,16718,19139,DELHI-VISAKHAPATNAM,35857,All
2022,9,DELHI,VISAKHAPATNAM,16091,17541,DELHI-VISAKHAPATNAM,33632,All
2022,10,DELHI,VISAKHAPATNAM,19915,19939,DELHI-VISAKHAPATNAM,39854,All
2022,11,DELHI,VISAKHAPATNAM,17932,17095,DELHI-VISAKHAPATNAM,35027,All
2022,12,DELHI,VISAKHAPATNAM,27751,21561,DELHI-VISAKHAPATNAM,49312,All
2023,1,DELHI,VISAKHAPATNAM,23349,24650,DELHI-VISAKHAPATNAM,47999,All
2023,2,DELHI,VISAKHAPATNAM,19179,21710,DELHI-VISAKHAPATNAM,40889,All
2023,3,DELHI,VISAKHAPATNAM,21145,21770,DELHI-VISAKHAPATNAM,42915,All
2023,4,DELHI,VISAKHAPATNAM,18800,19265,DELHI-VISAKHAPATNAM,38065,All
2023,5,DELHI,VISAKHAPATNAM,25823,24534,DELHI-VISAKHAPATNAM,50357,All
2023,6,DELHI,VISAKHAPATNAM,24303,22920,DELHI-VISAKHAPATNAM,47223,All
2023,7,DELHI,VISAKHAPATNAM,21671,21779,DELHI-VISAKHAPATNAM,43450,All
2023,8,DELHI,VISAKHAPATNAM,19260,19603,DELHI-VISAKHAPATNAM,38863,All
2023,9,DELHI,VISAKHAPATNAM,18289,19045,DELHI-VISAKHAPATNAM,37334,All
2023,10,DELHI,VISAKHAPATNAM,19361,19902,DELHI-VISAKHAPATNAM,39263,All
2023,11,DELHI,VISAKHAPATNAM,17979,17940,DELHI-VISAKHAPATNAM,35919,All
2023,12,DELHI,VISAKHAPATNAM,18464,17944,DELHI-VISAKHAPATNAM,36408,All
2024,1,DELHI,VISAKHAPATNAM,15973,16468,DELHI-VISAKHAPATNAM,32441,All
2024,2,DELHI,VISAKHAPATNAM,16634,17573,DELHI-VISAKHAPATNAM,34207,All
2024,3,DELHI,VISAKHAPATNAM,18073,17974,DELHI-VISAKHAPATNAM,36047,All
2024,4,DELHI,VISAKHAPATNAM,17436,19731,DELHI-VISAKHAPATNAM,37167,All
2024,6,DELHI,VISAKHAPATNAM,22549,20143,DELHI-VISAKHAPATNAM,42692,All
2024,7,DELHI,VISAKHAPATNAM,21833,20815,DELHI-VISAKHAPATNAM,42648,All
2024,8,DELHI,VISAKHAPATNAM,22215,23129,DELHI-VISAKHAPATNAM,45344,All
2024,9,DELHI,VISAKHAPATNAM,20494,22470,DELHI-VISAKHAPATNAM,42964,All
2024,10,DELHI,VISAKHAPATNAM,23116,23048,DELHI-VISAKHAPATNAM,46164,All
2024,11,DELHI,VISAKHAPATNAM,22674,21115,DELHI-VISAKHAPATNAM,43789,All
2024,12,DELHI,VISAKHAPATNAM,25144,19573,DELHI-VISAKHAPATNAM,44717,All
2025,1,DELHI,VISAKHAPATNAM,21264,22075,DELHI-VISAKHAPATNAM,43339,All
2025,2,DELHI,VISAKHAPATNAM,20077,22792,DELHI-VISAKHAPATNAM,42869,All
2025,3,DELHI,VISAKHAPATNAM,20424,20136,DELHI-VISAKHAPATNAM,40560,All
2023,10,DHARAMSALA,GUWAHATI,0,101,DHARAMSALA-GUWAHATI,101,All
2021,2,DHARAMSALA,HISSAR,0,1,DHARAMSALA-HISSAR,1,All
2021,3,DHARAMSALA,HISSAR,4,2,DHARAMSALA-HISSAR,6,All
2021,6,DHARAMSALA,HISSAR,1,14,DHARAMSALA-HISSAR,15,All
2021,7,DHARAMSALA,HISSAR,7,13,DHARAMSALA-HISSAR,20,All
2019,3,DHARAMSALA,JAIPUR,54,65,DHARAMSALA-JAIPUR,119,All
2019,4,DHARAMSALA,JAIPUR,1450,1478,DHARAMSALA-JAIPUR,2928,All
2019,5,DHARAMSALA,JAIPUR,1527,1814,DHARAMSALA-JAIPUR,3341,All
2019,6,DHARAMSALA,JAIPUR,1446,1864,DHARAMSALA-JAIPUR,3310,All
2019,7,DHARAMSALA,JAIPUR,1388,1006,DHARAMSALA-JAIPUR,2394,All
2019,8,DHARAMSALA,JAIPUR,962,847,DHARAMSALA-JAIPUR,1809,All
2019,9,DHARAMSALA,JAIPUR,97,78,DHARAMSALA-JAIPUR,175,All
2022,3,DHARAMSALA,JAIPUR,109,154,DHARAMSALA-JAIPUR,263,All
2022,4,DHARAMSALA,JAIPUR,1113,1927,DHARAMSALA-JAIPUR,3040,All
2022,5,DHARAMSALA,JAIPUR,1249,1606,DHARAMSALA-JAIPUR,2855,All
2022,6,DHARAMSALA,JAIPUR,1012,1379,DHARAMSALA-JAIPUR,2391,All
2022,7,DHARAMSALA,JAIPUR,109,168,DHARAMSALA-JAIPUR,277,All
2022,8,DHARAMSALA,JAIPUR,0,65,DHARAMSALA-JAIPUR,65,All
2022,9,DHARAMSALA,JAIPUR,0,5,DHARAMSALA-JAIPUR,5,All
2022,10,DHARAMSALA,JAIPUR,0,84,DHARAMSALA-JAIPUR,84,All
2023,10,DHARAMSALA,JAIPUR,81,0,DHARAMSALA-JAIPUR,81,All
2024,4,DHARAMSALA,JAIPUR,62,93,DHARAMSALA-JAIPUR,155,All
2024,6,DHARAMSALA,JAIPUR,132,258,DHARAMSALA-JAIPUR,390,All
2024,7,DHARAMSALA,JAIPUR,50,109,DHARAMSALA-JAIPUR,159,All
2024,8,DHARAMSALA,JAIPUR,61,73,DHARAMSALA-JAIPUR,134,All
2024,9,DHARAMSALA,JAIPUR,67,101,DHARAMSALA-JAIPUR,168,All
2024,10,DHARAMSALA,JAIPUR,115,131,DHARAMSALA-JAIPUR,246,All
2024,11,DHARAMSALA,JAIPUR,31,22,DHARAMSALA-JAIPUR,53,All
2024,12,DHARAMSALA,JAIPUR,37,69,DHARAMSALA-JAIPUR,106,All
2025,3,DHARAMSALA,JAIPUR,49,110,DHARAMSALA-JAIPUR,159,All
2019,10,DHARAMSALA,JAMMU,0,5,DHARAMSALA-JAMMU,5,All
2019,5,DHARAMSALA,KANPUR,0,3,DHARAMSALA-KANPUR,3,All
2019,6,DHARAMSALA,KANPUR,0,9,DHARAMSALA-KANPUR,9,All
2019,7,DHARAMSALA,KANPUR,0,11,DHARAMSALA-KANPUR,11,All
2019,8,DHARAMSALA,KANPUR,0,6,DHARAMSALA-KANPUR,6,All
2019,9,DHARAMSALA,KANPUR,0,2,DHARAMSALA-KANPUR,2,All
2019,10,DHARAMSALA,KANPUR,0,1,DHARAMSALA-KANPUR,1,All
2023,11,DHARAMSALA,KULLU,0,8,DHARAMSALA-KULLU,8,All
2023,12,DHARAMSALA,KULLU,0,15,DHARAMSALA-KULLU,15,All
2024,2,DHARAMSALA,KULLU,0,11,DHARAMSALA-KULLU,11,All
2023,10,DHARAMSALA,LUCKNOW,45,0,DHARAMSALA-LUCKNOW,45,All
2019,5,DHARAMSALA,SIMLA,9,9,DHARAMSALA-SIMLA,18,All
2019,6,DHARAMSALA,SIMLA,33,8,DHARAMSALA-SIMLA,41,All
2019,7,DHARAMSALA,SIMLA,7,7,DHARAMSALA-SIMLA,14,All
2019,8,DHARAMSALA,SIMLA,1,6,DHARAMSALA-SIMLA,7,All
2019,9,DHARAMSALA,SIMLA,1,2,DHARAMSALA-SIMLA,3,All
2019,10,DHARAMSALA,SIMLA,10,3,DHARAMSALA-SIMLA,13,All
2019,11,DHARAMSALA,SIMLA,4,6,DHARAMSALA-SIMLA,10,All
2019,12,DHARAMSALA,SIMLA,4,8,DHARAMSALA-SIMLA,12,All
2020,1,DHARAMSALA,SIMLA,23,37,DHARAMSALA-SIMLA,60,All
2020,2,DHARAMSALA,SIMLA,5,10,DHARAMSALA-SIMLA,15,All
2020,3,DHARAMSALA,SIMLA,5,11,DHARAMSALA-SIMLA,16,All
2020,6,DHARAMSALA,SIMLA,1,6,DHARAMSALA-SIMLA,7,All
2020,7,DHARAMSALA,SIMLA,1,0,DHARAMSALA-SIMLA,1,All
2020,9,DHARAMSALA,SIMLA,0,1,DHARAMSALA-SIMLA,1,All
2020,10,DHARAMSALA,SIMLA,13,2,DHARAMSALA-SIMLA,15,All
2020,11,DHARAMSALA,SIMLA,36,20,DHARAMSALA-SIMLA,56,All
2020,12,DHARAMSALA,SIMLA,17,11,DHARAMSALA-SIMLA,28,All
2021,1,DHARAMSALA,SIMLA,8,9,DHARAMSALA-SIMLA,17,All
2021,2,DHARAMSALA,SIMLA,27,9,DHARAMSALA-SIMLA,36,All
2021,3,DHARAMSALA,SIMLA,19,12,DHARAMSALA-SIMLA,31,All
2021,4,DHARAMSALA,SIMLA,23,12,DHARAMSALA-SIMLA,35,All
2021,6,DHARAMSALA,SIMLA,10,6,DHARAMSALA-SIMLA,16,All
2021,7,DHARAMSALA,SIMLA,7,3,DHARAMSALA-SIMLA,10,All
2021,8,DHARAMSALA,SIMLA,3,0,DHARAMSALA-SIMLA,3,All
2021,9,DHARAMSALA,SIMLA,21,9,DHARAMSALA-SIMLA,30,All
2021,10,DHARAMSALA,SIMLA,25,20,DHARAMSALA-SIMLA,45,All
2021,11,DHARAMSALA,SIMLA,16,14,DHARAMSALA-SIMLA,30,All
2021,12,DHARAMSALA,SIMLA,9,6,DHARAMSALA-SIMLA,15,All
2022,12,DHARAMSALA,SIMLA,36,13,DHARAMSALA-SIMLA,49,All
2023,1,DHARAMSALA,SIMLA,40,22,DHARAMSALA-SIMLA,62,All
2023,2,DHARAMSALA,SIMLA,59,33,DHARAMSALA-SIMLA,92,All
2023,3,DHARAMSALA,SIMLA,44,55,DHARAMSALA-SIMLA,99,All
2023,4,DHARAMSALA,SIMLA,46,31,DHARAMSALA-SIMLA,77,All
2023,5,DHARAMSALA,SIMLA,100,92,DHARAMSALA-SIMLA,192,All
2023,6,DHARAMSALA,SIMLA,48,40,DHARAMSALA-SIMLA,88,All
2023,7,DHARAMSALA,SIMLA,70,42,DHARAMSALA-SIMLA,112,All
2023,8,DHARAMSALA,SIMLA,35,55,DHARAMSALA-SIMLA,90,All
2023,9,DHARAMSALA,SIMLA,111,79,DHARAMSALA-SIMLA,190,All
2023,10,DHARAMSALA,SIMLA,285,177,DHARAMSALA-SIMLA,462,All
2023,11,DHARAMSALA,SIMLA,162,157,DHARAMSALA-SIMLA,319,All
2023,12,DHARAMSALA,SIMLA,168,142,DHARAMSALA-SIMLA,310,All
2024,1,DHARAMSALA,SIMLA,98,70,DHARAMSALA-SIMLA,168,All
2024,2,DHARAMSALA,SIMLA,76,58,DHARAMSALA-SIMLA,134,All
2024,3,DHARAMSALA,SIMLA,158,171,DHARAMSALA-SIMLA,329,All
2024,4,DHARAMSALA,SIMLA,120,113,DHARAMSALA-SIMLA,233,All
2024,6,DHARAMSALA,SIMLA,171,172,DHARAMSALA-SIMLA,343,All
2024,8,DHARAMSALA,SIMLA,66,35,DHARAMSALA-SIMLA,101,All
2024,9,DHARAMSALA,SIMLA,131,94,DHARAMSALA-SIMLA,225,All
2024,10,DHARAMSALA,SIMLA,254,268,DHARAMSALA-SIMLA,522,All
2024,11,DHARAMSALA,SIMLA,249,203,DHARAMSALA-SIMLA,452,All
2024,12,DHARAMSALA,SIMLA,153,190,DHARAMSALA-SIMLA,343,All
2025,1,DHARAMSALA,SIMLA,213,208,DHARAMSALA-SIMLA,421,All
2025,2,DHARAMSALA,SIMLA,239,222,DHARAMSALA-SIMLA,461,All
2025,3,DHARAMSALA,SIMLA,211,208,DHARAMSALA-SIMLA,419,All
2025,3,DHARAMSALA,UDAIPUR,2,0,DHARAMSALA-UDAIPUR,2,All
2019,4,DIBRUGARH,BAGDOGRA,2616,2543,BAGDOGRA-DIBRUGARH,5159,All
2015,4,DIBRUGARH,DIMAPUR,5,35,DIBRUGARH-DIMAPUR,40,All
2015,5,DIBRUGARH,DIMAPUR,4,0,DIBRUGARH-DIMAPUR,4,All
2015,6,DIBRUGARH,DIMAPUR,0,2,DIBRUGARH-DIMAPUR,2,All
2015,7,DIBRUGARH,DIMAPUR,2,1,DIBRUGARH-DIMAPUR,3,All
2015,8,DIBRUGARH,DIMAPUR,6,8,DIBRUGARH-DIMAPUR,14,All
2015,9,DIBRUGARH,DIMAPUR,2,6,DIBRUGARH-DIMAPUR,8,All
2015,10,DIBRUGARH,DIMAPUR,469,2437,DIBRUGARH-DIMAPUR,2906,All
2015,11,DIBRUGARH,DIMAPUR,4,7,DIBRUGARH-DIMAPUR,11,All
2015,12,DIBRUGARH,DIMAPUR,4,10,DIBRUGARH-DIMAPUR,14,All
2016,1,DIBRUGARH,DIMAPUR,5,5,DIBRUGARH-DIMAPUR,10,All
2016,2,DIBRUGARH,DIMAPUR,4,3,DIBRUGARH-DIMAPUR,7,All
2016,3,DIBRUGARH,DIMAPUR,8,4,DIBRUGARH-DIMAPUR,12,All
2016,4,DIBRUGARH,DIMAPUR,6,6,DIBRUGARH-DIMAPUR,12,All
2016,5,DIBRUGARH,DIMAPUR,17,12,DIBRUGARH-DIMAPUR,29,All
2016,6,DIBRUGARH,DIMAPUR,11,1,DIBRUGARH-DIMAPUR,12,All
2016,7,DIBRUGARH,DIMAPUR,3,4,DIBRUGARH-DIMAPUR,7,All
2016,8,DIBRUGARH,DIMAPUR,11,11,DIBRUGARH-DIMAPUR,22,All
2016,9,DIBRUGARH,DIMAPUR,15,13,DIBRUGARH-DIMAPUR,28,All
2016,10,DIBRUGARH,DIMAPUR,6,4,DIBRUGARH-DIMAPUR,10,All
2019,12,DIBRUGARH,DIMAPUR,1,0,DIBRUGARH-DIMAPUR,1,All
2021,3,DIBRUGARH,DIMAPUR,10,5,DIBRUGARH-DIMAPUR,15,All
2021,4,DIBRUGARH,DIMAPUR,27,43,DIBRUGARH-DIMAPUR,70,All
2021,11,DIBRUGARH,DIMAPUR,154,65,DIBRUGARH-DIMAPUR,219,All
2021,12,DIBRUGARH,DIMAPUR,579,178,DIBRUGARH-DIMAPUR,757,All
2022,1,DIBRUGARH,DIMAPUR,181,223,DIBRUGARH-DIMAPUR,404,All
2022,3,DIBRUGARH,DIMAPUR,152,50,DIBRUGARH-DIMAPUR,202,All
2022,4,DIBRUGARH,DIMAPUR,215,130,DIBRUGARH-DIMAPUR,345,All
2022,5,DIBRUGARH,DIMAPUR,193,90,DIBRUGARH-DIMAPUR,283,All
2022,6,DIBRUGARH,DIMAPUR,252,92,DIBRUGARH-DIMAPUR,344,All
2022,7,DIBRUGARH,DIMAPUR,143,103,DIBRUGARH-DIMAPUR,246,All
2022,8,DIBRUGARH,DIMAPUR,119,54,DIBRUGARH-DIMAPUR,173,All
2022,9,DIBRUGARH,DIMAPUR,109,57,DIBRUGARH-DIMAPUR,166,All
2022,10,DIBRUGARH,DIMAPUR,86,101,DIBRUGARH-DIMAPUR,187,All
2022,11,DIBRUGARH,DIMAPUR,75,75,DIBRUGARH-DIMAPUR,150,All
2022,12,DIBRUGARH,DIMAPUR,300,141,DIBRUGARH-DIMAPUR,441,All
2023,1,DIBRUGARH,DIMAPUR,58,150,DIBRUGARH-DIMAPUR,208,All
2023,2,DIBRUGARH,DIMAPUR,46,45,DIBRUGARH-DIMAPUR,91,All
2023,3,DIBRUGARH,DIMAPUR,54,43,DIBRUGARH-DIMAPUR,97,All
2023,4,DIBRUGARH,DIMAPUR,80,95,DIBRUGARH-DIMAPUR,175,All
2023,5,DIBRUGARH,DIMAPUR,68,63,DIBRUGARH-DIMAPUR,131,All
2023,6,DIBRUGARH,DIMAPUR,118,214,DIBRUGARH-DIMAPUR,332,All
2023,7,DIBRUGARH,DIMAPUR,201,230,DIBRUGARH-DIMAPUR,431,All
2023,8,DIBRUGARH,DIMAPUR,330,194,DIBRUGARH-DIMAPUR,524,All
2023,9,DIBRUGARH,DIMAPUR,361,164,DIBRUGARH-DIMAPUR,525,All
2023,10,DIBRUGARH,DIMAPUR,166,196,DIBRUGARH-DIMAPUR,362,All
2023,11,DIBRUGARH,DIMAPUR,459,289,DIBRUGARH-DIMAPUR,748,All
2023,12,DIBRUGARH,DIMAPUR,749,520,DIBRUGARH-DIMAPUR,1269,All
2024,1,DIBRUGARH,DIMAPUR,509,631,DIBRUGARH-DIMAPUR,1140,All
2024,2,DIBRUGARH,DIMAPUR,328,224,DIBRUGARH-DIMAPUR,552,All
2024,3,DIBRUGARH,DIMAPUR,340,191,DIBRUGARH-DIMAPUR,531,All
2015,4,DIBRUGARH,GUWAHATI,2177,1802,DIBRUGARH-GUWAHATI,3979,All
2015,5,DIBRUGARH,GUWAHATI,1934,1701,DIBRUGARH-GUWAHATI,3635,All
2015,6,DIBRUGARH,GUWAHATI,1968,1465,DIBRUGARH-GUWAHATI,3433,All
2015,7,DIBRUGARH,GUWAHATI,2226,2059,DIBRUGARH-GUWAHATI,4285,All
2015,8,DIBRUGARH,GUWAHATI,1627,1640,DIBRUGARH-GUWAHATI,3267,All
2015,9,DIBRUGARH,GUWAHATI,1570,1742,DIBRUGARH-GUWAHATI,3312,All
2015,10,DIBRUGARH,GUWAHATI,1801,1884,DIBRUGARH-GUWAHATI,3685,All
2015,11,DIBRUGARH,GUWAHATI,1749,1452,DIBRUGARH-GUWAHATI,3201,All
2015,12,DIBRUGARH,GUWAHATI,1695,1850,DIBRUGARH-GUWAHATI,3545,All
2016,1,DIBRUGARH,GUWAHATI,1721,1704,DIBRUGARH-GUWAHATI,3425,All
2016,2,DIBRUGARH,GUWAHATI,2311,1974,DIBRUGARH-GUWAHATI,4285,All
2016,3,DIBRUGARH,GUWAHATI,2365,1724,DIBRUGARH-GUWAHATI,4089,All
2016,4,DIBRUGARH,GUWAHATI,2112,945,DIBRUGARH-GUWAHATI,3057,All
2016,5,DIBRUGARH,GUWAHATI,2078,997,DIBRUGARH-GUWAHATI,3075,All
2016,6,DIBRUGARH,GUWAHATI,2360,1152,DIBRUGARH-GUWAHATI,3512,All
2016,7,DIBRUGARH,GUWAHATI,2557,1177,DIBRUGARH-GUWAHATI,3734,All
2016,8,DIBRUGARH,GUWAHATI,1930,1148,DIBRUGARH-GUWAHATI,3078,All
2016,9,DIBRUGARH,GUWAHATI,2247,1107,DIBRUGARH-GUWAHATI,3354,All
2016,10,DIBRUGARH,GUWAHATI,2661,1262,DIBRUGARH-GUWAHATI,3923,All
2016,11,DIBRUGARH,GUWAHATI,2820,1322,DIBRUGARH-GUWAHATI,4142,All
2016,12,DIBRUGARH,GUWAHATI,2906,1554,DIBRUGARH-GUWAHATI,4460,All
2017,1,DIBRUGARH,GUWAHATI,2667,1448,DIBRUGARH-GUWAHATI,4115,All
2017,2,DIBRUGARH,GUWAHATI,3081,1330,DIBRUGARH-GUWAHATI,4411,All
2017,3,DIBRUGARH,GUWAHATI,3022,1339,DIBRUGARH-GUWAHATI,4361,All
2017,4,DIBRUGARH,GUWAHATI,3117,1347,DIBRUGARH-GUWAHATI,4464,All
2017,5,DIBRUGARH,GUWAHATI,2959,1372,DIBRUGARH-GUWAHATI,4331,All
2017,6,DIBRUGARH,GUWAHATI,2910,1192,DIBRUGARH-GUWAHATI,4102,All
2017,7,DIBRUGARH,GUWAHATI,3064,633,DIBRUGARH-GUWAHATI,3697,All
2017,8,DIBRUGARH,GUWAHATI,2623,0,DIBRUGARH-GUWAHATI,2623,All
2017,9,DIBRUGARH,GUWAHATI,2354,0,DIBRUGARH-GUWAHATI,2354,All
2017,10,DIBRUGARH,GUWAHATI,4464,2161,DIBRUGARH-GUWAHATI,6625,All
2017,11,DIBRUGARH,GUWAHATI,4407,2072,DIBRUGARH-GUWAHATI,6479,All
2017,12,DIBRUGARH,GUWAHATI,4226,2022,DIBRUGARH-GUWAHATI,6248,All
2018,1,DIBRUGARH,GUWAHATI,4385,1997,DIBRUGARH-GUWAHATI,6382,All
2018,2,DIBRUGARH,GUWAHATI,4042,1918,DIBRUGARH-GUWAHATI,5960,All
2018,3,DIBRUGARH,GUWAHATI,4483,1971,DIBRUGARH-GUWAHATI,6454,All
2018,4,DIBRUGARH,GUWAHATI,4622,1972,DIBRUGARH-GUWAHATI,6594,All
2018,5,DIBRUGARH,GUWAHATI,4228,1938,DIBRUGARH-GUWAHATI,6166,All
2018,6,DIBRUGARH,GUWAHATI,3989,2070,DIBRUGARH-GUWAHATI,6059,All
2018,7,DIBRUGARH,GUWAHATI,4612,2149,DIBRUGARH-GUWAHATI,6761,All
2018,8,DIBRUGARH,GUWAHATI,4424,2198,DIBRUGARH-GUWAHATI,6622,All
2018,9,DIBRUGARH,GUWAHATI,4260,2132,DIBRUGARH-GUWAHATI,6392,All
2018,10,DIBRUGARH,GUWAHATI,3812,2078,DIBRUGARH-GUWAHATI,5890,All
2018,11,DIBRUGARH,GUWAHATI,3672,2041,DIBRUGARH-GUWAHATI,5713,All
2018,12,DIBRUGARH,GUWAHATI,3851,2099,DIBRUGARH-GUWAHATI,5950,All
2019,1,DIBRUGARH,GUWAHATI,4205,2167,DIBRUGARH-GUWAHATI,6372,All
2019,2,DIBRUGARH,GUWAHATI,4162,2239,DIBRUGARH-GUWAHATI,6401,All
2019,3,DIBRUGARH,GUWAHATI,3802,2049,DIBRUGARH-GUWAHATI,5851,All
2019,4,DIBRUGARH,GUWAHATI,4265,2008,DIBRUGARH-GUWAHATI,6273,All
2019,5,DIBRUGARH,GUWAHATI,4129,1885,DIBRUGARH-GUWAHATI,6014,All
2019,6,DIBRUGARH,GUWAHATI,5060,2289,DIBRUGARH-GUWAHATI,7349,All
2019,7,DIBRUGARH,GUWAHATI,5834,3182,DIBRUGARH-GUWAHATI,9016,All
2019,8,DIBRUGARH,GUWAHATI,5101,2317,DIBRUGARH-GUWAHATI,7418,All
2019,9,DIBRUGARH,GUWAHATI,4726,2292,DIBRUGARH-GUWAHATI,7018,All
2019,10,DIBRUGARH,GUWAHATI,5689,3091,DIBRUGARH-GUWAHATI,8780,All
2019,11,DIBRUGARH,GUWAHATI,5974,3793,DIBRUGARH-GUWAHATI,9767,All
2019,12,DIBRUGARH,GUWAHATI,5150,3534,DIBRUGARH-GUWAHATI,8684,All
2020,1,DIBRUGARH,GUWAHATI,6224,4147,DIBRUGARH-GUWAHATI,10371,All
2020,2,DIBRUGARH,GUWAHATI,6380,3634,DIBRUGARH-GUWAHATI,10014,All
2020,3,DIBRUGARH,GUWAHATI,3981,2238,DIBRUGARH-GUWAHATI,6219,All
2020,6,DIBRUGARH,GUWAHATI,266,559,DIBRUGARH-GUWAHATI,825,All
2020,9,DIBRUGARH,GUWAHATI,282,0,DIBRUGARH-GUWAHATI,282,All
2020,10,DIBRUGARH,GUWAHATI,1734,269,DIBRUGARH-GUWAHATI,2003,All
2020,11,DIBRUGARH,GUWAHATI,2312,1875,DIBRUGARH-GUWAHATI,4187,All
2020,12,DIBRUGARH,GUWAHATI,2724,2752,DIBRUGARH-GUWAHATI,5476,All
2021,1,DIBRUGARH,GUWAHATI,3143,2917,DIBRUGARH-GUWAHATI,6060,All
2021,2,DIBRUGARH,GUWAHATI,3425,3261,DIBRUGARH-GUWAHATI,6686,All
2021,3,DIBRUGARH,GUWAHATI,3164,2653,DIBRUGARH-GUWAHATI,5817,All
2021,4,DIBRUGARH,GUWAHATI,2864,1782,DIBRUGARH-GUWAHATI,4646,All
2021,6,DIBRUGARH,GUWAHATI,732,291,DIBRUGARH-GUWAHATI,1023,All
2021,7,DIBRUGARH,GUWAHATI,1753,1126,DIBRUGARH-GUWAHATI,2879,All
2021,8,DIBRUGARH,GUWAHATI,2181,1573,DIBRUGARH-GUWAHATI,3754,All
2021,9,DIBRUGARH,GUWAHATI,2097,1695,DIBRUGARH-GUWAHATI,3792,All
2021,10,DIBRUGARH,GUWAHATI,2473,2087,DIBRUGARH-GUWAHATI,4560,All
2021,11,DIBRUGARH,GUWAHATI,3296,2777,DIBRUGARH-GUWAHATI,6073,All
2021,12,DIBRUGARH,GUWAHATI,4848,3298,DIBRUGARH-GUWAHATI,8146,All
2022,1,DIBRUGARH,GUWAHATI,2350,1558,DIBRUGARH-GUWAHATI,3908,All
2022,2,DIBRUGARH,GUWAHATI,1526,1215,DIBRUGARH-GUWAHATI,2741,All
2022,3,DIBRUGARH,GUWAHATI,2652,2570,DIBRUGARH-GUWAHATI,5222,All
2022,4,DIBRUGARH,GUWAHATI,5116,4452,DIBRUGARH-GUWAHATI,9568,All
2022,5,DIBRUGARH,GUWAHATI,4228,2546,DIBRUGARH-GUWAHATI,6774,All
2022,6,DIBRUGARH,GUWAHATI,3633,2341,DIBRUGARH-GUWAHATI,5974,All
2022,7,DIBRUGARH,GUWAHATI,3269,2702,DIBRUGARH-GUWAHATI,5971,All
2022,8,DIBRUGARH,GUWAHATI,1817,1251,DIBRUGARH-GUWAHATI,3068,All
2022,9,DIBRUGARH,GUWAHATI,2260,1606,DIBRUGARH-GUWAHATI,3866,All
2022,10,DIBRUGARH,GUWAHATI,3276,357,DIBRUGARH-GUWAHATI,3633,All
2022,11,DIBRUGARH,GUWAHATI,5496,2972,DIBRUGARH-GUWAHATI,8468,All
2022,12,DIBRUGARH,GUWAHATI,5789,3061,DIBRUGARH-GUWAHATI,8850,All
2023,1,DIBRUGARH,GUWAHATI,6214,3356,DIBRUGARH-GUWAHATI,9570,All
2023,2,DIBRUGARH,GUWAHATI,5823,3987,DIBRUGARH-GUWAHATI,9810,All
2023,3,DIBRUGARH,GUWAHATI,6815,4055,DIBRUGARH-GUWAHATI,10870,All
2023,4,DIBRUGARH,GUWAHATI,8246,4853,DIBRUGARH-GUWAHATI,13099,All
2023,5,DIBRUGARH,GUWAHATI,7853,5725,DIBRUGARH-GUWAHATI,13578,All
2023,6,DIBRUGARH,GUWAHATI,8085,5807,DIBRUGARH-GUWAHATI,13892,All
2023,7,DIBRUGARH,GUWAHATI,8947,6288,DIBRUGARH-GUWAHATI,15235,All
2023,8,DIBRUGARH,GUWAHATI,8552,5920,DIBRUGARH-GUWAHATI,14472,All
2023,9,DIBRUGARH,GUWAHATI,8050,8669,DIBRUGARH-GUWAHATI,16719,All
2023,10,DIBRUGARH,GUWAHATI,7788,9017,DIBRUGARH-GUWAHATI,16805,All
2023,11,DIBRUGARH,GUWAHATI,7699,8138,DIBRUGARH-GUWAHATI,15837,All
2023,12,DIBRUGARH,GUWAHATI,8666,8962,DIBRUGARH-GUWAHATI,17628,All
2024,1,DIBRUGARH,GUWAHATI,8771,8343,DIBRUGARH-GUWAHATI,17114,All
2024,2,DIBRUGARH,GUWAHATI,6258,6975,DIBRUGARH-GUWAHATI,13233,All
2024,3,DIBRUGARH,GUWAHATI,7051,8349,DIBRUGARH-GUWAHATI,15400,All
2024,4,DIBRUGARH,GUWAHATI,6809,8807,DIBRUGARH-GUWAHATI,15616,All
2024,6,DIBRUGARH,GUWAHATI,5996,8184,DIBRUGARH-GUWAHATI,14180,All
2024,7,DIBRUGARH,GUWAHATI,7677,9274,DIBRUGARH-GUWAHATI,16951,All
2024,8,DIBRUGARH,GUWAHATI,6708,8946,DIBRUGARH-GUWAHATI,15654,All
2024,9,DIBRUGARH,GUWAHATI,5827,8152,DIBRUGARH-GUWAHATI,13979,All
2024,10,DIBRUGARH,GUWAHATI,7288,9413,DIBRUGARH-GUWAHATI,16701,All
2024,11,DIBRUGARH,GUWAHATI,7448,8120,DIBRUGARH-GUWAHATI,15568,All
2024,12,DIBRUGARH,GUWAHATI,7122,8744,DIBRUGARH-GUWAHATI,15866,All
2025,1,DIBRUGARH,GUWAHATI,6943,8541,DIBRUGARH-GUWAHATI,15484,All
2025,2,DIBRUGARH,GUWAHATI,7921,8827,DIBRUGARH-GUWAHATI,16748,All
2025,3,DIBRUGARH,GUWAHATI,9511,10047,DIBRUGARH-GUWAHATI,19558,All
2021,9,DIBRUGARH,HYDERABAD,190,117,DIBRUGARH-HYDERABAD,307,All
2021,10,DIBRUGARH,HYDERABAD,337,358,DIBRUGARH-HYDERABAD,695,All
2022,1,DIBRUGARH,HYDERABAD,0,60,DIBRUGARH-HYDERABAD,60,All
2024,6,DIBRUGARH,HYDERABAD,181,381,DIBRUGARH-HYDERABAD,562,All
2024,7,DIBRUGARH,HYDERABAD,166,233,DIBRUGARH-HYDERABAD,399,All
2024,8,DIBRUGARH,HYDERABAD,131,225,DIBRUGARH-HYDERABAD,356,All
2024,9,DIBRUGARH,HYDERABAD,175,203,DIBRUGARH-HYDERABAD,378,All
2024,10,DIBRUGARH,HYDERABAD,302,283,DIBRUGARH-HYDERABAD,585,All
2024,11,DIBRUGARH,HYDERABAD,555,479,DIBRUGARH-HYDERABAD,1034,All
2024,12,DIBRUGARH,HYDERABAD,436,320,DIBRUGARH-HYDERABAD,756,All
2025,3,DIBRUGARH,HYDERABAD,185,301,DIBRUGARH-HYDERABAD,486,All
2023,3,DIBRUGARH,"Hollongi Airport, Itanagar",7,4,"DIBRUGARH-Hollongi Airport, Itanagar",11,All
2023,4,DIBRUGARH,"Hollongi Airport, Itanagar",37,31,"DIBRUGARH-Hollongi Airport, Itanagar",68,All
2023,5,DIBRUGARH,"Hollongi Airport, Itanagar",52,66,"DIBRUGARH-Hollongi Airport, Itanagar",118,All
2021,7,DIBRUGARH,IMPHAL,280,209,DIBRUGARH-IMPHAL,489,All
2021,8,DIBRUGARH,IMPHAL,418,314,DIBRUGARH-IMPHAL,732,All
2021,9,DIBRUGARH,IMPHAL,492,524,DIBRUGARH-IMPHAL,1016,All
2021,10,DIBRUGARH,IMPHAL,656,613,DIBRUGARH-IMPHAL,1269,All
2021,11,DIBRUGARH,IMPHAL,712,999,DIBRUGARH-IMPHAL,1711,All
2021,12,DIBRUGARH,IMPHAL,1052,760,DIBRUGARH-IMPHAL,1812,All
2022,1,DIBRUGARH,IMPHAL,566,526,DIBRUGARH-IMPHAL,1092,All
2022,3,DIBRUGARH,IMPHAL,727,757,DIBRUGARH-IMPHAL,1484,All
2022,4,DIBRUGARH,IMPHAL,750,876,DIBRUGARH-IMPHAL,1626,All
2022,5,DIBRUGARH,IMPHAL,657,891,DIBRUGARH-IMPHAL,1548,All
2022,6,DIBRUGARH,IMPHAL,610,725,DIBRUGARH-IMPHAL,1335,All
2022,7,DIBRUGARH,IMPHAL,770,912,DIBRUGARH-IMPHAL,1682,All
2022,8,DIBRUGARH,IMPHAL,685,841,DIBRUGARH-IMPHAL,1526,All
2022,9,DIBRUGARH,IMPHAL,758,922,DIBRUGARH-IMPHAL,1680,All
2022,10,DIBRUGARH,IMPHAL,1414,1460,DIBRUGARH-IMPHAL,2874,All
2022,11,DIBRUGARH,IMPHAL,1276,1305,DIBRUGARH-IMPHAL,2581,All
2022,12,DIBRUGARH,IMPHAL,1779,1083,DIBRUGARH-IMPHAL,2862,All
2023,1,DIBRUGARH,IMPHAL,1157,1443,DIBRUGARH-IMPHAL,2600,All
2023,2,DIBRUGARH,IMPHAL,1121,1015,DIBRUGARH-IMPHAL,2136,All
2023,3,DIBRUGARH,IMPHAL,1692,1378,DIBRUGARH-IMPHAL,3070,All
2023,4,DIBRUGARH,IMPHAL,1443,1478,DIBRUGARH-IMPHAL,2921,All
2023,5,DIBRUGARH,IMPHAL,831,1837,DIBRUGARH-IMPHAL,2668,All
2023,6,DIBRUGARH,IMPHAL,821,1036,DIBRUGARH-IMPHAL,1857,All
2023,7,DIBRUGARH,IMPHAL,1074,1008,DIBRUGARH-IMPHAL,2082,All
2023,8,DIBRUGARH,IMPHAL,1025,1020,DIBRUGARH-IMPHAL,2045,All
2023,9,DIBRUGARH,IMPHAL,1002,950,DIBRUGARH-IMPHAL,1952,All
2023,10,DIBRUGARH,IMPHAL,1254,1153,DIBRUGARH-IMPHAL,2407,All
2023,11,DIBRUGARH,IMPHAL,2142,1776,DIBRUGARH-IMPHAL,3918,All
2023,12,DIBRUGARH,IMPHAL,3779,2170,DIBRUGARH-IMPHAL,5949,All
2024,1,DIBRUGARH,IMPHAL,2293,2776,DIBRUGARH-IMPHAL,5069,All
2024,2,DIBRUGARH,IMPHAL,2008,1719,DIBRUGARH-IMPHAL,3727,All
2024,3,DIBRUGARH,IMPHAL,2937,2952,DIBRUGARH-IMPHAL,5889,All
2024,4,DIBRUGARH,IMPHAL,3191,3171,DIBRUGARH-IMPHAL,6362,All
2024,6,DIBRUGARH,IMPHAL,3376,2642,DIBRUGARH-IMPHAL,6018,All
2024,7,DIBRUGARH,IMPHAL,2177,3046,DIBRUGARH-IMPHAL,5223,All
2024,8,DIBRUGARH,IMPHAL,1681,1942,DIBRUGARH-IMPHAL,3623,All
2024,9,DIBRUGARH,IMPHAL,1283,1638,DIBRUGARH-IMPHAL,2921,All
2024,10,DIBRUGARH,IMPHAL,2378,1991,DIBRUGARH-IMPHAL,4369,All
2024,11,DIBRUGARH,IMPHAL,1835,2122,DIBRUGARH-IMPHAL,3957,All
2024,12,DIBRUGARH,IMPHAL,3198,2125,DIBRUGARH-IMPHAL,5323,All
2025,1,DIBRUGARH,IMPHAL,2866,2688,DIBRUGARH-IMPHAL,5554,All
2025,2,DIBRUGARH,IMPHAL,2101,2091,DIBRUGARH-IMPHAL,4192,All
2025,3,DIBRUGARH,IMPHAL,2733,2081,DIBRUGARH-IMPHAL,4814,All
2023,1,DIBRUGARH,Itanagar,67,66,DIBRUGARH-Itanagar,133,All
2023,6,DIBRUGARH,Itanagar,14,32,DIBRUGARH-Itanagar,46,All
2023,7,DIBRUGARH,Itanagar,38,28,DIBRUGARH-Itanagar,66,All
2023,8,DIBRUGARH,Itanagar,45,49,DIBRUGARH-Itanagar,94,All
2023,9,DIBRUGARH,Itanagar,81,67,DIBRUGARH-Itanagar,148,All
2023,10,DIBRUGARH,Itanagar,31,79,DIBRUGARH-Itanagar,110,All
2023,11,DIBRUGARH,Itanagar,2,10,DIBRUGARH-Itanagar,12,All
2023,12,DIBRUGARH,Itanagar,40,34,DIBRUGARH-Itanagar,74,All
2024,1,DIBRUGARH,Itanagar,15,29,DIBRUGARH-Itanagar,44,All
2024,2,DIBRUGARH,Itanagar,25,32,DIBRUGARH-Itanagar,57,All
2024,3,DIBRUGARH,Itanagar,24,72,DIBRUGARH-Itanagar,96,All
2024,4,DIBRUGARH,Itanagar,58,87,DIBRUGARH-Itanagar,145,All
2024,6,DIBRUGARH,Itanagar,20,29,DIBRUGARH-Itanagar,49,All
2024,7,DIBRUGARH,Itanagar,22,50,DIBRUGARH-Itanagar,72,All
2024,8,DIBRUGARH,Itanagar,22,38,DIBRUGARH-Itanagar,60,All
2024,9,DIBRUGARH,Itanagar,16,35,DIBRUGARH-Itanagar,51,All
2024,10,DIBRUGARH,Itanagar,8,19,DIBRUGARH-Itanagar,27,All
2024,11,DIBRUGARH,Itanagar,9,12,DIBRUGARH-Itanagar,21,All
2024,12,DIBRUGARH,Itanagar,2,2,DIBRUGARH-Itanagar,4,All
2023,11,DIBRUGARH,JAIPUR,14,0,DIBRUGARH-JAIPUR,14,All
2019,5,DIBRUGARH,KOLKATA,7947,9009,DIBRUGARH-KOLKATA,16956,All
2019,6,DIBRUGARH,KOLKATA,8922,9358,DIBRUGARH-KOLKATA,18280,All
2019,7,DIBRUGARH,KOLKATA,10814,10777,DIBRUGARH-KOLKATA,21591,All
2019,8,DIBRUGARH,KOLKATA,9206,9104,DIBRUGARH-KOLKATA,18310,All
2019,9,DIBRUGARH,KOLKATA,8809,8933,DIBRUGARH-KOLKATA,17742,All
2019,10,DIBRUGARH,KOLKATA,9771,9357,DIBRUGARH-KOLKATA,19128,All
2019,11,DIBRUGARH,KOLKATA,10334,9939,DIBRUGARH-KOLKATA,20273,All
2019,12,DIBRUGARH,KOLKATA,9630,10116,DIBRUGARH-KOLKATA,19746,All
2020,1,DIBRUGARH,KOLKATA,11183,10671,DIBRUGARH-KOLKATA,21854,All
2020,2,DIBRUGARH,KOLKATA,9958,10305,DIBRUGARH-KOLKATA,20263,All
2020,3,DIBRUGARH,KOLKATA,6649,7792,DIBRUGARH-KOLKATA,14441,All
2020,5,DIBRUGARH,KOLKATA,122,216,DIBRUGARH-KOLKATA,338,All
2020,6,DIBRUGARH,KOLKATA,4414,7254,DIBRUGARH-KOLKATA,11668,All
2020,7,DIBRUGARH,KOLKATA,3681,2944,DIBRUGARH-KOLKATA,6625,All
2020,8,DIBRUGARH,KOLKATA,3473,3747,DIBRUGARH-KOLKATA,7220,All
2020,9,DIBRUGARH,KOLKATA,5042,6110,DIBRUGARH-KOLKATA,11152,All
2020,10,DIBRUGARH,KOLKATA,8244,8093,DIBRUGARH-KOLKATA,16337,All
2020,11,DIBRUGARH,KOLKATA,10371,9296,DIBRUGARH-KOLKATA,19667,All
2020,12,DIBRUGARH,KOLKATA,9270,10438,DIBRUGARH-KOLKATA,19708,All
2021,1,DIBRUGARH,KOLKATA,10700,9406,DIBRUGARH-KOLKATA,20106,All
2021,2,DIBRUGARH,KOLKATA,10979,9078,DIBRUGARH-KOLKATA,20057,All
2021,3,DIBRUGARH,KOLKATA,9167,8803,DIBRUGARH-KOLKATA,17970,All
2021,4,DIBRUGARH,KOLKATA,6774,7117,DIBRUGARH-KOLKATA,13891,All
2021,6,DIBRUGARH,KOLKATA,4114,3254,DIBRUGARH-KOLKATA,7368,All
2021,7,DIBRUGARH,KOLKATA,5050,3153,DIBRUGARH-KOLKATA,8203,All
2021,8,DIBRUGARH,KOLKATA,6546,5089,DIBRUGARH-KOLKATA,11635,All
2021,9,DIBRUGARH,KOLKATA,7337,5644,DIBRUGARH-KOLKATA,12981,All
2021,10,DIBRUGARH,KOLKATA,8492,6972,DIBRUGARH-KOLKATA,15464,All
2021,11,DIBRUGARH,KOLKATA,10849,9853,DIBRUGARH-KOLKATA,20702,All
2021,12,DIBRUGARH,KOLKATA,10356,11297,DIBRUGARH-KOLKATA,21653,All
2022,1,DIBRUGARH,KOLKATA,7077,7037,DIBRUGARH-KOLKATA,14114,All
2022,2,DIBRUGARH,KOLKATA,7745,7157,DIBRUGARH-KOLKATA,14902,All
2022,3,DIBRUGARH,KOLKATA,10863,9197,DIBRUGARH-KOLKATA,20060,All
2022,4,DIBRUGARH,KOLKATA,10856,10043,DIBRUGARH-KOLKATA,20899,All
2022,5,DIBRUGARH,KOLKATA,9553,9363,DIBRUGARH-KOLKATA,18916,All
2022,6,DIBRUGARH,KOLKATA,9380,7742,DIBRUGARH-KOLKATA,17122,All
2022,7,DIBRUGARH,KOLKATA,10389,8803,DIBRUGARH-KOLKATA,19192,All
2022,8,DIBRUGARH,KOLKATA,9963,8966,DIBRUGARH-KOLKATA,18929,All
2022,9,DIBRUGARH,KOLKATA,9195,9247,DIBRUGARH-KOLKATA,18442,All
2022,10,DIBRUGARH,KOLKATA,9694,8934,DIBRUGARH-KOLKATA,18628,All
2022,11,DIBRUGARH,KOLKATA,6583,6640,DIBRUGARH-KOLKATA,13223,All
2022,12,DIBRUGARH,KOLKATA,6826,7380,DIBRUGARH-KOLKATA,14206,All
2023,1,DIBRUGARH,KOLKATA,6614,6980,DIBRUGARH-KOLKATA,13594,All
2023,2,DIBRUGARH,KOLKATA,6029,6096,DIBRUGARH-KOLKATA,12125,All
2023,3,DIBRUGARH,KOLKATA,6734,6897,DIBRUGARH-KOLKATA,13631,All
2023,4,DIBRUGARH,KOLKATA,6620,6585,DIBRUGARH-KOLKATA,13205,All
2023,5,DIBRUGARH,KOLKATA,6588,6918,DIBRUGARH-KOLKATA,13506,All
2023,6,DIBRUGARH,KOLKATA,6594,6043,DIBRUGARH-KOLKATA,12637,All
2023,7,DIBRUGARH,KOLKATA,6944,6471,DIBRUGARH-KOLKATA,13415,All
2023,8,DIBRUGARH,KOLKATA,6342,6043,DIBRUGARH-KOLKATA,12385,All
2023,9,DIBRUGARH,KOLKATA,6734,6459,DIBRUGARH-KOLKATA,13193,All
2023,10,DIBRUGARH,KOLKATA,7038,7267,DIBRUGARH-KOLKATA,14305,All
2023,11,DIBRUGARH,KOLKATA,8896,9785,DIBRUGARH-KOLKATA,18681,All
2023,12,DIBRUGARH,KOLKATA,9610,11536,DIBRUGARH-KOLKATA,21146,All
2024,1,DIBRUGARH,KOLKATA,10307,11141,DIBRUGARH-KOLKATA,21448,All
2024,2,DIBRUGARH,KOLKATA,9017,10026,DIBRUGARH-KOLKATA,19043,All
2024,3,DIBRUGARH,KOLKATA,11032,11428,DIBRUGARH-KOLKATA,22460,All
2024,4,DIBRUGARH,KOLKATA,11245,11497,DIBRUGARH-KOLKATA,22742,All
2024,6,DIBRUGARH,KOLKATA,10411,8841,DIBRUGARH-KOLKATA,19252,All
2024,7,DIBRUGARH,KOLKATA,12143,10723,DIBRUGARH-KOLKATA,22866,All
2024,8,DIBRUGARH,KOLKATA,10258,8435,DIBRUGARH-KOLKATA,18693,All
2024,9,DIBRUGARH,KOLKATA,9997,8625,DIBRUGARH-KOLKATA,18622,All
2024,10,DIBRUGARH,KOLKATA,11661,11381,DIBRUGARH-KOLKATA,23042,All
2024,11,DIBRUGARH,KOLKATA,11527,11162,DIBRUGARH-KOLKATA,22689,All
2024,12,DIBRUGARH,KOLKATA,10538,10542,DIBRUGARH-KOLKATA,21080,All
2025,1,DIBRUGARH,KOLKATA,10676,10225,DIBRUGARH-KOLKATA,20901,All
2025,2,DIBRUGARH,KOLKATA,9036,8766,DIBRUGARH-KOLKATA,17802,All
2025,3,DIBRUGARH,KOLKATA,9996,9797,DIBRUGARH-KOLKATA,19793,All
2022,11,DIBRUGARH,LILABARI,12,8,DIBRUGARH-LILABARI,20,All
2019,10,DIBRUGARH,LUCKNOW,1,0,DIBRUGARH-LUCKNOW,1,All
2019,9,DIBRUGARH,MUMBAI,0,226,DIBRUGARH-MUMBAI,226,All
2019,10,DIBRUGARH,MUMBAI,0,274,DIBRUGARH-MUMBAI,274,All
2019,11,DIBRUGARH,MUMBAI,0,310,DIBRUGARH-MUMBAI,310,All
2019,12,DIBRUGARH,MUMBAI,0,387,DIBRUGARH-MUMBAI,387,All
2020,1,DIBRUGARH,MUMBAI,0,293,DIBRUGARH-MUMBAI,293,All
2020,2,DIBRUGARH,MUMBAI,0,302,DIBRUGARH-MUMBAI,302,All
2020,3,DIBRUGARH,MUMBAI,0,242,DIBRUGARH-MUMBAI,242,All
2021,3,DIBRUGARH,MUMBAI,23,39,DIBRUGARH-MUMBAI,62,All
2021,4,DIBRUGARH,MUMBAI,106,291,DIBRUGARH-MUMBAI,397,All
2021,6,DIBRUGARH,MUMBAI,259,232,DIBRUGARH-MUMBAI,491,All
2021,7,DIBRUGARH,MUMBAI,193,135,DIBRUGARH-MUMBAI,328,All
2021,11,DIBRUGARH,MUMBAI,237,494,DIBRUGARH-MUMBAI,731,All
2021,12,DIBRUGARH,MUMBAI,412,600,DIBRUGARH-MUMBAI,1012,All
2022,1,DIBRUGARH,MUMBAI,343,345,DIBRUGARH-MUMBAI,688,All
2022,2,DIBRUGARH,MUMBAI,364,256,DIBRUGARH-MUMBAI,620,All
2022,3,DIBRUGARH,MUMBAI,385,397,DIBRUGARH-MUMBAI,782,All
2022,4,DIBRUGARH,MUMBAI,253,404,DIBRUGARH-MUMBAI,657,All
2022,5,DIBRUGARH,MUMBAI,580,941,DIBRUGARH-MUMBAI,1521,All
2022,6,DIBRUGARH,MUMBAI,731,910,DIBRUGARH-MUMBAI,1641,All
2022,7,DIBRUGARH,MUMBAI,577,792,DIBRUGARH-MUMBAI,1369,All
2022,8,DIBRUGARH,MUMBAI,325,612,DIBRUGARH-MUMBAI,937,All
2022,9,DIBRUGARH,MUMBAI,265,542,DIBRUGARH-MUMBAI,807,All
2022,10,DIBRUGARH,MUMBAI,411,628,DIBRUGARH-MUMBAI,1039,All
2022,11,DIBRUGARH,MUMBAI,61,68,DIBRUGARH-MUMBAI,129,All
2022,12,DIBRUGARH,MUMBAI,155,75,DIBRUGARH-MUMBAI,230,All
2022,11,DIBRUGARH,PASIGHAT,5,2,DIBRUGARH-PASIGHAT,7,All
2022,12,DIBRUGARH,PASIGHAT,8,10,DIBRUGARH-PASIGHAT,18,All
2015,4,DIBRUGARH,PUNE,0,243,DIBRUGARH-PUNE,243,All
2021,10,DIBRUGARH,SHILLONG,26,7,DIBRUGARH-SHILLONG,33,All
2021,11,DIBRUGARH,SHILLONG,419,359,DIBRUGARH-SHILLONG,778,All
2021,12,DIBRUGARH,SHILLONG,606,558,DIBRUGARH-SHILLONG,1164,All
2022,1,DIBRUGARH,SHILLONG,428,362,DIBRUGARH-SHILLONG,790,All
2022,2,DIBRUGARH,SHILLONG,285,292,DIBRUGARH-SHILLONG,577,All
2022,3,DIBRUGARH,SHILLONG,570,461,DIBRUGARH-SHILLONG,1031,All
2022,4,DIBRUGARH,SHILLONG,353,422,DIBRUGARH-SHILLONG,775,All
2022,5,DIBRUGARH,SHILLONG,230,374,DIBRUGARH-SHILLONG,604,All
2022,6,DIBRUGARH,SHILLONG,199,307,DIBRUGARH-SHILLONG,506,All
2022,7,DIBRUGARH,SHILLONG,304,452,DIBRUGARH-SHILLONG,756,All
2022,8,DIBRUGARH,SHILLONG,169,189,DIBRUGARH-SHILLONG,358,All
2022,9,DIBRUGARH,SHILLONG,131,184,DIBRUGARH-SHILLONG,315,All
2022,10,DIBRUGARH,SHILLONG,191,285,DIBRUGARH-SHILLONG,476,All
2022,11,DIBRUGARH,SHILLONG,119,242,DIBRUGARH-SHILLONG,361,All
2022,12,DIBRUGARH,SHILLONG,174,351,DIBRUGARH-SHILLONG,525,All
2023,1,DIBRUGARH,SHILLONG,118,147,DIBRUGARH-SHILLONG,265,All
2023,2,DIBRUGARH,SHILLONG,140,190,DIBRUGARH-SHILLONG,330,All
2023,3,DIBRUGARH,SHILLONG,156,303,DIBRUGARH-SHILLONG,459,All
2023,4,DIBRUGARH,SHILLONG,187,365,DIBRUGARH-SHILLONG,552,All
2023,5,DIBRUGARH,SHILLONG,233,398,DIBRUGARH-SHILLONG,631,All
2023,6,DIBRUGARH,SHILLONG,224,319,DIBRUGARH-SHILLONG,543,All
2023,7,DIBRUGARH,SHILLONG,517,491,DIBRUGARH-SHILLONG,1008,All
2023,8,DIBRUGARH,SHILLONG,418,479,DIBRUGARH-SHILLONG,897,All
2023,9,DIBRUGARH,SHILLONG,419,479,DIBRUGARH-SHILLONG,898,All
2023,10,DIBRUGARH,SHILLONG,410,525,DIBRUGARH-SHILLONG,935,All
2023,11,DIBRUGARH,SHILLONG,210,317,DIBRUGARH-SHILLONG,527,All
2023,12,DIBRUGARH,SHILLONG,407,498,DIBRUGARH-SHILLONG,905,All
2024,1,DIBRUGARH,SHILLONG,289,355,DIBRUGARH-SHILLONG,644,All
2024,2,DIBRUGARH,SHILLONG,210,180,DIBRUGARH-SHILLONG,390,All
2024,3,DIBRUGARH,SHILLONG,276,305,DIBRUGARH-SHILLONG,581,All
2024,4,DIBRUGARH,SHILLONG,153,204,DIBRUGARH-SHILLONG,357,All
2024,6,DIBRUGARH,SHILLONG,266,307,DIBRUGARH-SHILLONG,573,All
2024,7,DIBRUGARH,SHILLONG,533,377,DIBRUGARH-SHILLONG,910,All
2024,8,DIBRUGARH,SHILLONG,244,201,DIBRUGARH-SHILLONG,445,All
2024,9,DIBRUGARH,SHILLONG,177,205,DIBRUGARH-SHILLONG,382,All
2024,10,DIBRUGARH,SHILLONG,374,374,DIBRUGARH-SHILLONG,748,All
2017,10,DIBRUGARH,SILCHAR,131,74,DIBRUGARH-SILCHAR,205,All
2017,11,DIBRUGARH,SILCHAR,109,147,DIBRUGARH-SILCHAR,256,All
2017,12,DIBRUGARH,SILCHAR,134,153,DIBRUGARH-SILCHAR,287,All
2018,1,DIBRUGARH,SILCHAR,193,193,DIBRUGARH-SILCHAR,386,All
2018,2,DIBRUGARH,SILCHAR,113,124,DIBRUGARH-SILCHAR,237,All
2018,3,DIBRUGARH,SILCHAR,172,257,DIBRUGARH-SILCHAR,429,All
2018,4,DIBRUGARH,SILCHAR,206,197,DIBRUGARH-SILCHAR,403,All
2018,5,DIBRUGARH,SILCHAR,161,168,DIBRUGARH-SILCHAR,329,All
2018,6,DIBRUGARH,SILCHAR,124,112,DIBRUGARH-SILCHAR,236,All
2018,7,DIBRUGARH,SILCHAR,194,168,DIBRUGARH-SILCHAR,362,All
2018,8,DIBRUGARH,SILCHAR,152,149,DIBRUGARH-SILCHAR,301,All
2022,10,DIBRUGARH,TEZU,0,7,DIBRUGARH-TEZU,7,All
2022,11,DIBRUGARH,TEZU,7,31,DIBRUGARH-TEZU,38,All
2022,12,DIBRUGARH,TEZU,7,34,DIBRUGARH-TEZU,41,All
2023,1,DIBRUGARH,TEZU,6,28,DIBRUGARH-TEZU,34,All
2023,4,DIBRUGARH,TEZU,0,5,DIBRUGARH-TEZU,5,All
2023,5,DIBRUGARH,TEZU,1,18,DIBRUGARH-TEZU,19,All
2023,6,DIBRUGARH,TEZU,0,4,DIBRUGARH-TEZU,4,All
2023,7,DIBRUGARH,TEZU,2,23,DIBRUGARH-TEZU,25,All
2023,8,DIBRUGARH,TEZU,1,20,DIBRUGARH-TEZU,21,All
2023,9,DIBRUGARH,TEZU,1,35,DIBRUGARH-TEZU,36,All
2023,10,DIBRUGARH,TEZU,1,10,DIBRUGARH-TEZU,11,All
2023,11,DIBRUGARH,TEZU,5,1,DIBRUGARH-TEZU,6,All
2023,12,DIBRUGARH,TEZU,15,16,DIBRUGARH-TEZU,31,All
2024,1,DIBRUGARH,TEZU,16,15,DIBRUGARH-TEZU,31,All
2024,2,DIBRUGARH,TEZU,21,11,DIBRUGARH-TEZU,32,All
2024,3,DIBRUGARH,TEZU,36,25,DIBRUGARH-TEZU,61,All
2024,4,DIBRUGARH,TEZU,39,26,DIBRUGARH-TEZU,65,All
2024,6,DIBRUGARH,TEZU,9,8,DIBRUGARH-TEZU,17,All
2024,7,DIBRUGARH,TEZU,10,27,DIBRUGARH-TEZU,37,All
2024,8,DIBRUGARH,TEZU,11,5,DIBRUGARH-TEZU,16,All
2024,9,DIBRUGARH,TEZU,8,8,DIBRUGARH-TEZU,16,All
2024,10,DIBRUGARH,TEZU,5,5,DIBRUGARH-TEZU,10,All
2024,11,DIBRUGARH,TEZU,10,14,DIBRUGARH-TEZU,24,All
2024,12,DIBRUGARH,TEZU,1,7,DIBRUGARH-TEZU,8,All
2022,12,DIBRUGARH,ZIRO,18,22,DIBRUGARH-ZIRO,40,All
2019,12,DIMAPUR,GUWAHATI,496,379,DIMAPUR-GUWAHATI,875,All
2020,1,DIMAPUR,GUWAHATI,530,260,DIMAPUR-GUWAHATI,790,All
2020,2,DIMAPUR,GUWAHATI,561,390,DIMAPUR-GUWAHATI,951,All
2020,3,DIMAPUR,GUWAHATI,500,547,DIMAPUR-GUWAHATI,1047,All
2020,6,DIMAPUR,GUWAHATI,248,183,DIMAPUR-GUWAHATI,431,All
2020,7,DIMAPUR,GUWAHATI,244,242,DIMAPUR-GUWAHATI,486,All
2020,8,DIMAPUR,GUWAHATI,380,302,DIMAPUR-GUWAHATI,682,All
2020,9,DIMAPUR,GUWAHATI,393,159,DIMAPUR-GUWAHATI,552,All
2020,10,DIMAPUR,GUWAHATI,302,202,DIMAPUR-GUWAHATI,504,All
2020,11,DIMAPUR,GUWAHATI,393,342,DIMAPUR-GUWAHATI,735,All
2020,12,DIMAPUR,GUWAHATI,434,446,DIMAPUR-GUWAHATI,880,All
2021,1,DIMAPUR,GUWAHATI,579,540,DIMAPUR-GUWAHATI,1119,All
2021,2,DIMAPUR,GUWAHATI,516,516,DIMAPUR-GUWAHATI,1032,All
2021,3,DIMAPUR,GUWAHATI,583,565,DIMAPUR-GUWAHATI,1148,All
2021,4,DIMAPUR,GUWAHATI,326,370,DIMAPUR-GUWAHATI,696,All
2021,6,DIMAPUR,GUWAHATI,354,369,DIMAPUR-GUWAHATI,723,All
2021,7,DIMAPUR,GUWAHATI,540,467,DIMAPUR-GUWAHATI,1007,All
2021,8,DIMAPUR,GUWAHATI,407,422,DIMAPUR-GUWAHATI,829,All
2021,9,DIMAPUR,GUWAHATI,528,523,DIMAPUR-GUWAHATI,1051,All
2021,10,DIMAPUR,GUWAHATI,659,626,DIMAPUR-GUWAHATI,1285,All
2021,11,DIMAPUR,GUWAHATI,762,673,DIMAPUR-GUWAHATI,1435,All
2021,12,DIMAPUR,GUWAHATI,943,779,DIMAPUR-GUWAHATI,1722,All
2022,1,DIMAPUR,GUWAHATI,767,463,DIMAPUR-GUWAHATI,1230,All
2022,2,DIMAPUR,GUWAHATI,793,438,DIMAPUR-GUWAHATI,1231,All
2022,3,DIMAPUR,GUWAHATI,1094,722,DIMAPUR-GUWAHATI,1816,All
2022,4,DIMAPUR,GUWAHATI,762,673,DIMAPUR-GUWAHATI,1435,All
2022,5,DIMAPUR,GUWAHATI,943,779,DIMAPUR-GUWAHATI,1722,All
2022,6,DIMAPUR,GUWAHATI,770,673,DIMAPUR-GUWAHATI,1443,All
2022,7,DIMAPUR,GUWAHATI,793,438,DIMAPUR-GUWAHATI,1231,All
2022,8,DIMAPUR,GUWAHATI,943,780,DIMAPUR-GUWAHATI,1723,All
2022,9,DIMAPUR,GUWAHATI,762,673,DIMAPUR-GUWAHATI,1435,All
2022,10,DIMAPUR,GUWAHATI,1498,1276,DIMAPUR-GUWAHATI,2774,All
2022,11,DIMAPUR,GUWAHATI,1986,1665,DIMAPUR-GUWAHATI,3651,All
2022,12,DIMAPUR,GUWAHATI,2707,2865,DIMAPUR-GUWAHATI,5572,All
2023,1,DIMAPUR,GUWAHATI,2766,2010,DIMAPUR-GUWAHATI,4776,All
2023,2,DIMAPUR,GUWAHATI,1536,1148,DIMAPUR-GUWAHATI,2684,All
2023,3,DIMAPUR,GUWAHATI,2105,1463,DIMAPUR-GUWAHATI,3568,All
2023,4,DIMAPUR,GUWAHATI,2069,1401,DIMAPUR-GUWAHATI,3470,All
2023,5,DIMAPUR,GUWAHATI,2001,1423,DIMAPUR-GUWAHATI,3424,All
2023,6,DIMAPUR,GUWAHATI,2444,1653,DIMAPUR-GUWAHATI,4097,All
2023,7,DIMAPUR,GUWAHATI,2476,1935,DIMAPUR-GUWAHATI,4411,All
2023,8,DIMAPUR,GUWAHATI,2563,1598,DIMAPUR-GUWAHATI,4161,All
2023,9,DIMAPUR,GUWAHATI,2354,1401,DIMAPUR-GUWAHATI,3755,All
2023,10,DIMAPUR,GUWAHATI,2578,2129,DIMAPUR-GUWAHATI,4707,All
2023,11,DIMAPUR,GUWAHATI,1837,1541,DIMAPUR-GUWAHATI,3378,All
2023,12,DIMAPUR,GUWAHATI,2202,1835,DIMAPUR-GUWAHATI,4037,All
2024,1,DIMAPUR,GUWAHATI,2859,1514,DIMAPUR-GUWAHATI,4373,All
2024,2,DIMAPUR,GUWAHATI,2598,1219,DIMAPUR-GUWAHATI,3817,All
2024,3,DIMAPUR,GUWAHATI,2665,1441,DIMAPUR-GUWAHATI,4106,All
2024,4,DIMAPUR,GUWAHATI,2364,1435,DIMAPUR-GUWAHATI,3799,All
2024,6,DIMAPUR,GUWAHATI,1883,1435,DIMAPUR-GUWAHATI,3318,All
2024,7,DIMAPUR,GUWAHATI,2769,2031,DIMAPUR-GUWAHATI,4800,All
2024,8,DIMAPUR,GUWAHATI,2496,1731,DIMAPUR-GUWAHATI,4227,All
2024,9,DIMAPUR,GUWAHATI,1684,1122,DIMAPUR-GUWAHATI,2806,All
2024,10,DIMAPUR,GUWAHATI,1430,1394,DIMAPUR-GUWAHATI,2824,All
2024,11,DIMAPUR,GUWAHATI,1549,1990,DIMAPUR-GUWAHATI,3539,All
2024,12,DIMAPUR,GUWAHATI,4331,5664,DIMAPUR-GUWAHATI,9995,All
2025,1,DIMAPUR,GUWAHATI,7826,5041,DIMAPUR-GUWAHATI,12867,All
2025,2,DIMAPUR,GUWAHATI,5325,4842,DIMAPUR-GUWAHATI,10167,All
2025,3,DIMAPUR,GUWAHATI,5703,6174,DIMAPUR-GUWAHATI,11877,All
2022,2,DIMAPUR,HYDERABAD,0,37,DIMAPUR-HYDERABAD,37,All
2022,3,DIMAPUR,HYDERABAD,0,15,DIMAPUR-HYDERABAD,15,All
2019,12,DIMAPUR,IMPHAL,460,487,DIMAPUR-IMPHAL,947,All
2020,1,DIMAPUR,IMPHAL,577,642,DIMAPUR-IMPHAL,1219,All
2020,2,DIMAPUR,IMPHAL,815,843,DIMAPUR-IMPHAL,1658,All
2020,3,DIMAPUR,IMPHAL,819,821,DIMAPUR-IMPHAL,1640,All
2020,6,DIMAPUR,IMPHAL,49,110,DIMAPUR-IMPHAL,159,All
2020,7,DIMAPUR,IMPHAL,248,170,DIMAPUR-IMPHAL,418,All
2020,8,DIMAPUR,IMPHAL,327,155,DIMAPUR-IMPHAL,482,All
2020,9,DIMAPUR,IMPHAL,408,293,DIMAPUR-IMPHAL,701,All
2020,10,DIMAPUR,IMPHAL,494,529,DIMAPUR-IMPHAL,1023,All
2020,11,DIMAPUR,IMPHAL,625,614,DIMAPUR-IMPHAL,1239,All
2020,12,DIMAPUR,IMPHAL,646,611,DIMAPUR-IMPHAL,1257,All
2021,1,DIMAPUR,IMPHAL,757,738,DIMAPUR-IMPHAL,1495,All
2021,2,DIMAPUR,IMPHAL,729,661,DIMAPUR-IMPHAL,1390,All
2021,3,DIMAPUR,IMPHAL,715,691,DIMAPUR-IMPHAL,1406,All
2021,4,DIMAPUR,IMPHAL,549,538,DIMAPUR-IMPHAL,1087,All
2021,6,DIMAPUR,IMPHAL,242,180,DIMAPUR-IMPHAL,422,All
2021,7,DIMAPUR,IMPHAL,471,448,DIMAPUR-IMPHAL,919,All
2021,8,DIMAPUR,IMPHAL,764,679,DIMAPUR-IMPHAL,1443,All
2021,9,DIMAPUR,IMPHAL,986,868,DIMAPUR-IMPHAL,1854,All
2021,10,DIMAPUR,IMPHAL,1050,960,DIMAPUR-IMPHAL,2010,All
2021,11,DIMAPUR,IMPHAL,1127,1350,DIMAPUR-IMPHAL,2477,All
2021,12,DIMAPUR,IMPHAL,1029,1131,DIMAPUR-IMPHAL,2160,All
2022,1,DIMAPUR,IMPHAL,863,1026,DIMAPUR-IMPHAL,1889,All
2022,2,DIMAPUR,IMPHAL,885,898,DIMAPUR-IMPHAL,1783,All
2022,3,DIMAPUR,IMPHAL,1074,1211,DIMAPUR-IMPHAL,2285,All
2022,4,DIMAPUR,IMPHAL,1127,1350,DIMAPUR-IMPHAL,2477,All
2022,5,DIMAPUR,IMPHAL,1029,1131,DIMAPUR-IMPHAL,2160,All
2022,6,DIMAPUR,IMPHAL,1127,1350,DIMAPUR-IMPHAL,2477,All
2022,7,DIMAPUR,IMPHAL,885,898,DIMAPUR-IMPHAL,1783,All
2022,8,DIMAPUR,IMPHAL,1029,1131,DIMAPUR-IMPHAL,2160,All
2022,9,DIMAPUR,IMPHAL,1127,1350,DIMAPUR-IMPHAL,2477,All
2022,10,DIMAPUR,IMPHAL,1289,1291,DIMAPUR-IMPHAL,2580,All
2022,11,DIMAPUR,IMPHAL,1339,592,DIMAPUR-IMPHAL,1931,All
2022,12,DIMAPUR,IMPHAL,1218,659,DIMAPUR-IMPHAL,1877,All
2023,1,DIMAPUR,IMPHAL,1505,819,DIMAPUR-IMPHAL,2324,All
2023,2,DIMAPUR,IMPHAL,1058,591,DIMAPUR-IMPHAL,1649,All
2023,3,DIMAPUR,IMPHAL,978,486,DIMAPUR-IMPHAL,1464,All
2023,4,DIMAPUR,IMPHAL,644,566,DIMAPUR-IMPHAL,1210,All
2023,5,DIMAPUR,IMPHAL,745,796,DIMAPUR-IMPHAL,1541,All
2023,6,DIMAPUR,IMPHAL,651,698,DIMAPUR-IMPHAL,1349,All
2023,7,DIMAPUR,IMPHAL,573,577,DIMAPUR-IMPHAL,1150,All
2023,8,DIMAPUR,IMPHAL,674,687,DIMAPUR-IMPHAL,1361,All
2023,9,DIMAPUR,IMPHAL,559,618,DIMAPUR-IMPHAL,1177,All
2023,10,DIMAPUR,IMPHAL,558,548,DIMAPUR-IMPHAL,1106,All
2023,12,DIMAPUR,IMPHAL,416,276,DIMAPUR-IMPHAL,692,All
2024,1,DIMAPUR,IMPHAL,640,700,DIMAPUR-IMPHAL,1340,All
2024,2,DIMAPUR,IMPHAL,716,518,DIMAPUR-IMPHAL,1234,All
2024,3,DIMAPUR,IMPHAL,855,793,DIMAPUR-IMPHAL,1648,All
2024,4,DIMAPUR,IMPHAL,632,687,DIMAPUR-IMPHAL,1319,All
2024,6,DIMAPUR,IMPHAL,806,720,DIMAPUR-IMPHAL,1526,All
2024,7,DIMAPUR,IMPHAL,768,770,DIMAPUR-IMPHAL,1538,All
2024,8,DIMAPUR,IMPHAL,660,660,DIMAPUR-IMPHAL,1320,All
2024,9,DIMAPUR,IMPHAL,767,738,DIMAPUR-IMPHAL,1505,All
2024,10,DIMAPUR,IMPHAL,434,450,DIMAPUR-IMPHAL,884,All
2024,11,DIMAPUR,IMPHAL,326,388,DIMAPUR-IMPHAL,714,All
2024,12,DIMAPUR,IMPHAL,546,478,DIMAPUR-IMPHAL,1024,All
2025,1,DIMAPUR,IMPHAL,505,490,DIMAPUR-IMPHAL,995,All
2025,2,DIMAPUR,IMPHAL,509,502,DIMAPUR-IMPHAL,1011,All
2025,3,DIMAPUR,IMPHAL,511,475,DIMAPUR-IMPHAL,986,All
2024,4,DIMAPUR,JAIPUR,12,0,DIMAPUR-JAIPUR,12,All
2019,5,DIMAPUR,KOLKATA,5172,6044,DIMAPUR-KOLKATA,11216,All
2019,6,DIMAPUR,KOLKATA,5587,5129,DIMAPUR-KOLKATA,10716,All
2019,7,DIMAPUR,KOLKATA,6734,7068,DIMAPUR-KOLKATA,13802,All
2019,8,DIMAPUR,KOLKATA,5882,5524,DIMAPUR-KOLKATA,11406,All
2019,9,DIMAPUR,KOLKATA,5512,5865,DIMAPUR-KOLKATA,11377,All
2019,10,DIMAPUR,KOLKATA,5615,6035,DIMAPUR-KOLKATA,11650,All
2019,11,DIMAPUR,KOLKATA,5685,6579,DIMAPUR-KOLKATA,12264,All
2019,12,DIMAPUR,KOLKATA,7296,8060,DIMAPUR-KOLKATA,15356,All
2020,1,DIMAPUR,KOLKATA,7662,7158,DIMAPUR-KOLKATA,14820,All
2020,2,DIMAPUR,KOLKATA,5617,5527,DIMAPUR-KOLKATA,11144,All
2020,3,DIMAPUR,KOLKATA,3500,4897,DIMAPUR-KOLKATA,8397,All
2020,6,DIMAPUR,KOLKATA,1322,2093,DIMAPUR-KOLKATA,3415,All
2020,7,DIMAPUR,KOLKATA,1486,1702,DIMAPUR-KOLKATA,3188,All
2020,8,DIMAPUR,KOLKATA,1171,1472,DIMAPUR-KOLKATA,2643,All
2020,9,DIMAPUR,KOLKATA,2773,2802,DIMAPUR-KOLKATA,5575,All
2020,10,DIMAPUR,KOLKATA,4557,4078,DIMAPUR-KOLKATA,8635,All
2020,11,DIMAPUR,KOLKATA,5146,4949,DIMAPUR-KOLKATA,10095,All
2020,12,DIMAPUR,KOLKATA,5334,6453,DIMAPUR-KOLKATA,11787,All
2021,1,DIMAPUR,KOLKATA,7367,4314,DIMAPUR-KOLKATA,11681,All
2021,2,DIMAPUR,KOLKATA,6542,4321,DIMAPUR-KOLKATA,10863,All
2021,3,DIMAPUR,KOLKATA,5821,5616,DIMAPUR-KOLKATA,11437,All
2021,4,DIMAPUR,KOLKATA,4746,5245,DIMAPUR-KOLKATA,9991,All
2021,6,DIMAPUR,KOLKATA,2675,3247,DIMAPUR-KOLKATA,5922,All
2021,7,DIMAPUR,KOLKATA,3197,2537,DIMAPUR-KOLKATA,5734,All
2021,8,DIMAPUR,KOLKATA,4353,3663,DIMAPUR-KOLKATA,8016,All
2021,9,DIMAPUR,KOLKATA,4743,4383,DIMAPUR-KOLKATA,9126,All
2021,10,DIMAPUR,KOLKATA,5490,4927,DIMAPUR-KOLKATA,10417,All
2021,11,DIMAPUR,KOLKATA,6490,6165,DIMAPUR-KOLKATA,12655,All
2021,12,DIMAPUR,KOLKATA,6715,7769,DIMAPUR-KOLKATA,14484,All
2022,1,DIMAPUR,KOLKATA,4530,3455,DIMAPUR-KOLKATA,7985,All
2022,2,DIMAPUR,KOLKATA,4846,3083,DIMAPUR-KOLKATA,7929,All
2022,3,DIMAPUR,KOLKATA,5941,4371,DIMAPUR-KOLKATA,10312,All
2022,4,DIMAPUR,KOLKATA,5767,4983,DIMAPUR-KOLKATA,10750,All
2022,5,DIMAPUR,KOLKATA,4417,4394,DIMAPUR-KOLKATA,8811,All
2022,6,DIMAPUR,KOLKATA,5628,4129,DIMAPUR-KOLKATA,9757,All
2022,7,DIMAPUR,KOLKATA,6107,4610,DIMAPUR-KOLKATA,10717,All
2022,8,DIMAPUR,KOLKATA,5570,4405,DIMAPUR-KOLKATA,9975,All
2022,9,DIMAPUR,KOLKATA,6146,4877,DIMAPUR-KOLKATA,11023,All
2022,10,DIMAPUR,KOLKATA,6191,5511,DIMAPUR-KOLKATA,11702,All
2022,11,DIMAPUR,KOLKATA,5744,5891,DIMAPUR-KOLKATA,11635,All
2022,12,DIMAPUR,KOLKATA,6532,6661,DIMAPUR-KOLKATA,13193,All
2023,1,DIMAPUR,KOLKATA,6376,5263,DIMAPUR-KOLKATA,11639,All
2023,2,DIMAPUR,KOLKATA,4898,4610,DIMAPUR-KOLKATA,9508,All
2023,3,DIMAPUR,KOLKATA,6026,5911,DIMAPUR-KOLKATA,11937,All
2023,4,DIMAPUR,KOLKATA,6281,6059,DIMAPUR-KOLKATA,12340,All
2023,5,DIMAPUR,KOLKATA,5835,6311,DIMAPUR-KOLKATA,12146,All
2023,6,DIMAPUR,KOLKATA,5618,5635,DIMAPUR-KOLKATA,11253,All
2023,7,DIMAPUR,KOLKATA,6226,6157,DIMAPUR-KOLKATA,12383,All
2023,8,DIMAPUR,KOLKATA,5907,6125,DIMAPUR-KOLKATA,12032,All
2023,9,DIMAPUR,KOLKATA,5545,5420,DIMAPUR-KOLKATA,10965,All
2023,10,DIMAPUR,KOLKATA,5825,5883,DIMAPUR-KOLKATA,11708,All
2023,11,DIMAPUR,KOLKATA,6027,6780,DIMAPUR-KOLKATA,12807,All
2023,12,DIMAPUR,KOLKATA,6265,7378,DIMAPUR-KOLKATA,13643,All
2024,1,DIMAPUR,KOLKATA,6928,6435,DIMAPUR-KOLKATA,13363,All
2024,2,DIMAPUR,KOLKATA,5349,5470,DIMAPUR-KOLKATA,10819,All
2024,3,DIMAPUR,KOLKATA,5191,6002,DIMAPUR-KOLKATA,11193,All
2024,4,DIMAPUR,KOLKATA,5097,5789,DIMAPUR-KOLKATA,10886,All
2024,6,DIMAPUR,KOLKATA,5519,5522,DIMAPUR-KOLKATA,11041,All
2024,7,DIMAPUR,KOLKATA,6361,6032,DIMAPUR-KOLKATA,12393,All
2024,8,DIMAPUR,KOLKATA,5570,5425,DIMAPUR-KOLKATA,10995,All
2024,9,DIMAPUR,KOLKATA,5555,5345,DIMAPUR-KOLKATA,10900,All
2024,10,DIMAPUR,KOLKATA,5909,5412,DIMAPUR-KOLKATA,11321,All
2024,11,DIMAPUR,KOLKATA,5607,6866,DIMAPUR-KOLKATA,12473,All
2024,12,DIMAPUR,KOLKATA,5075,5217,DIMAPUR-KOLKATA,10292,All
2025,1,DIMAPUR,KOLKATA,5386,4656,DIMAPUR-KOLKATA,10042,All
2025,2,DIMAPUR,KOLKATA,4232,3337,DIMAPUR-KOLKATA,7569,All
2025,3,DIMAPUR,KOLKATA,4861,4281,DIMAPUR-KOLKATA,9142,All
2022,11,DIMAPUR,LILABARI,0,8,DIMAPUR-LILABARI,8,All
2022,12,DIMAPUR,LILABARI,0,15,DIMAPUR-LILABARI,15,All
2023,2,DIMAPUR,LILABARI,0,2,DIMAPUR-LILABARI,2,All
2023,3,DIMAPUR,LILABARI,0,4,DIMAPUR-LILABARI,4,All
2018,11,DIMAPUR,LUCKNOW,28,0,DIMAPUR-LUCKNOW,28,All
2021,10,DIMAPUR,MUMBAI,6,4,DIMAPUR-MUMBAI,10,All
2021,11,DIMAPUR,MUMBAI,38,103,DIMAPUR-MUMBAI,141,All
2021,12,DIMAPUR,MUMBAI,33,67,DIMAPUR-MUMBAI,100,All
2022,1,DIMAPUR,MUMBAI,49,45,DIMAPUR-MUMBAI,94,All
2022,2,DIMAPUR,MUMBAI,71,82,DIMAPUR-MUMBAI,153,All
2022,3,DIMAPUR,MUMBAI,98,74,DIMAPUR-MUMBAI,172,All
2022,4,DIMAPUR,MUMBAI,29,106,DIMAPUR-MUMBAI,135,All
2022,5,DIMAPUR,MUMBAI,164,189,DIMAPUR-MUMBAI,353,All
2022,6,DIMAPUR,MUMBAI,120,170,DIMAPUR-MUMBAI,290,All
2022,7,DIMAPUR,MUMBAI,84,150,DIMAPUR-MUMBAI,234,All
2022,8,DIMAPUR,MUMBAI,116,153,DIMAPUR-MUMBAI,269,All
2022,9,DIMAPUR,MUMBAI,77,169,DIMAPUR-MUMBAI,246,All
2022,10,DIMAPUR,MUMBAI,113,202,DIMAPUR-MUMBAI,315,All
2022,11,DIMAPUR,MUMBAI,262,218,DIMAPUR-MUMBAI,480,All
2022,12,DIMAPUR,MUMBAI,168,248,DIMAPUR-MUMBAI,416,All
2023,4,DIMAPUR,RANCHI,5,0,DIMAPUR-RANCHI,5,All
2018,5,DIMAPUR,SHILLONG,2,1,DIMAPUR-SHILLONG,3,All
2021,11,DIMAPUR,SHILLONG,29,37,DIMAPUR-SHILLONG,66,All
2021,12,DIMAPUR,SHILLONG,255,364,DIMAPUR-SHILLONG,619,All
2022,1,DIMAPUR,SHILLONG,222,92,DIMAPUR-SHILLONG,314,All
2022,2,DIMAPUR,SHILLONG,183,109,DIMAPUR-SHILLONG,292,All
2022,3,DIMAPUR,SHILLONG,315,161,DIMAPUR-SHILLONG,476,All
2022,4,DIMAPUR,SHILLONG,29,37,DIMAPUR-SHILLONG,66,All
2022,5,DIMAPUR,SHILLONG,255,364,DIMAPUR-SHILLONG,619,All
2022,6,DIMAPUR,SHILLONG,29,37,DIMAPUR-SHILLONG,66,All
2022,7,DIMAPUR,SHILLONG,183,109,DIMAPUR-SHILLONG,292,All
2022,8,DIMAPUR,SHILLONG,255,364,DIMAPUR-SHILLONG,619,All
2022,9,DIMAPUR,SHILLONG,29,37,DIMAPUR-SHILLONG,66,All
2022,10,DIMAPUR,SHILLONG,376,379,DIMAPUR-SHILLONG,755,All
2022,11,DIMAPUR,SHILLONG,336,329,DIMAPUR-SHILLONG,665,All
2022,12,DIMAPUR,SHILLONG,397,593,DIMAPUR-SHILLONG,990,All
2023,1,DIMAPUR,SHILLONG,560,419,DIMAPUR-SHILLONG,979,All
2023,2,DIMAPUR,SHILLONG,275,220,DIMAPUR-SHILLONG,495,All
2023,3,DIMAPUR,SHILLONG,297,268,DIMAPUR-SHILLONG,565,All
2023,4,DIMAPUR,SHILLONG,406,466,DIMAPUR-SHILLONG,872,All
2023,5,DIMAPUR,SHILLONG,274,260,DIMAPUR-SHILLONG,534,All
2023,6,DIMAPUR,SHILLONG,359,433,DIMAPUR-SHILLONG,792,All
2023,7,DIMAPUR,SHILLONG,524,494,DIMAPUR-SHILLONG,1018,All
2023,8,DIMAPUR,SHILLONG,391,441,DIMAPUR-SHILLONG,832,All
2023,9,DIMAPUR,SHILLONG,335,396,DIMAPUR-SHILLONG,731,All
2023,10,DIMAPUR,SHILLONG,383,412,DIMAPUR-SHILLONG,795,All
2023,11,DIMAPUR,SHILLONG,360,574,DIMAPUR-SHILLONG,934,All
2023,12,DIMAPUR,SHILLONG,373,698,DIMAPUR-SHILLONG,1071,All
2024,1,DIMAPUR,SHILLONG,512,452,DIMAPUR-SHILLONG,964,All
2024,2,DIMAPUR,SHILLONG,462,400,DIMAPUR-SHILLONG,862,All
2024,3,DIMAPUR,SHILLONG,453,556,DIMAPUR-SHILLONG,1009,All
2024,4,DIMAPUR,SHILLONG,634,693,DIMAPUR-SHILLONG,1327,All
2024,6,DIMAPUR,SHILLONG,711,618,DIMAPUR-SHILLONG,1329,All
2024,7,DIMAPUR,SHILLONG,1007,941,DIMAPUR-SHILLONG,1948,All
2024,8,DIMAPUR,SHILLONG,1124,1017,DIMAPUR-SHILLONG,2141,All
2024,9,DIMAPUR,SHILLONG,1008,849,DIMAPUR-SHILLONG,1857,All
2024,10,DIMAPUR,SHILLONG,815,784,DIMAPUR-SHILLONG,1599,All
2023,3,DIMAPUR,SILCHAR,5,8,DIMAPUR-SILCHAR,13,All
2023,5,DIU,KESHOD,46,0,DIU-KESHOD,46,All
2024,1,DIU,KESHOD,70,40,DIU-KESHOD,110,All
2024,10,DIU,KESHOD,5,13,DIU-KESHOD,18,All
2024,11,DIU,KESHOD,12,62,DIU-KESHOD,74,All
2024,12,DIU,KESHOD,4,36,DIU-KESHOD,40,All
2025,1,DIU,KESHOD,5,26,DIU-KESHOD,31,All
2025,2,DIU,KESHOD,5,34,DIU-KESHOD,39,All
2025,3,DIU,KESHOD,8,15,DIU-KESHOD,23,All
2019,5,DIU,MUMBAI,754,827,DIU-MUMBAI,1581,All
2019,6,DIU,MUMBAI,600,664,DIU-MUMBAI,1264,All
2019,7,DIU,MUMBAI,497,601,DIU-MUMBAI,1098,All
2019,8,DIU,MUMBAI,511,588,DIU-MUMBAI,1099,All
2019,9,DIU,MUMBAI,643,712,DIU-MUMBAI,1355,All
2019,10,DIU,MUMBAI,799,863,DIU-MUMBAI,1662,All
2019,11,DIU,MUMBAI,892,1026,DIU-MUMBAI,1918,All
2019,12,DIU,MUMBAI,1408,1575,DIU-MUMBAI,2983,All
2020,1,DIU,MUMBAI,1370,1508,DIU-MUMBAI,2878,All
2020,2,DIU,MUMBAI,1561,1581,DIU-MUMBAI,3142,All
2020,3,DIU,MUMBAI,839,729,DIU-MUMBAI,1568,All
2020,5,DIU,MUMBAI,5,33,DIU-MUMBAI,38,All
2020,6,DIU,MUMBAI,183,241,DIU-MUMBAI,424,All
2020,7,DIU,MUMBAI,305,277,DIU-MUMBAI,582,All
2020,8,DIU,MUMBAI,399,365,DIU-MUMBAI,764,All
2020,9,DIU,MUMBAI,499,541,DIU-MUMBAI,1040,All
2020,10,DIU,MUMBAI,567,577,DIU-MUMBAI,1144,All
2020,11,DIU,MUMBAI,785,826,DIU-MUMBAI,1611,All
2020,12,DIU,MUMBAI,871,880,DIU-MUMBAI,1751,All
2021,1,DIU,MUMBAI,987,1028,DIU-MUMBAI,2015,All
2021,2,DIU,MUMBAI,1042,1055,DIU-MUMBAI,2097,All
2021,3,DIU,MUMBAI,927,793,DIU-MUMBAI,1720,All
2021,4,DIU,MUMBAI,537,542,DIU-MUMBAI,1079,All
2021,6,DIU,MUMBAI,637,692,DIU-MUMBAI,1329,All
2021,7,DIU,MUMBAI,734,877,DIU-MUMBAI,1611,All
2021,8,DIU,MUMBAI,1086,1151,DIU-MUMBAI,2237,All
2021,9,DIU,MUMBAI,942,892,DIU-MUMBAI,1834,All
2021,10,DIU,MUMBAI,1396,1410,DIU-MUMBAI,2806,All
2021,11,DIU,MUMBAI,1677,1673,DIU-MUMBAI,3350,All
2021,12,DIU,MUMBAI,1855,1697,DIU-MUMBAI,3552,All
2022,1,DIU,MUMBAI,1175,954,DIU-MUMBAI,2129,All
2022,2,DIU,MUMBAI,1335,1181,DIU-MUMBAI,2516,All
2022,3,DIU,MUMBAI,1974,1825,DIU-MUMBAI,3799,All
2022,4,DIU,MUMBAI,1677,1673,DIU-MUMBAI,3350,All
2022,5,DIU,MUMBAI,1855,1697,DIU-MUMBAI,3552,All
2022,6,DIU,MUMBAI,1677,1673,DIU-MUMBAI,3350,All
2022,7,DIU,MUMBAI,1335,1181,DIU-MUMBAI,2516,All
2022,8,DIU,MUMBAI,1855,1697,DIU-MUMBAI,3552,All
2022,9,DIU,MUMBAI,1677,1673,DIU-MUMBAI,3350,All
2022,10,DIU,MUMBAI,1478,1523,DIU-MUMBAI,3001,All
2022,11,DIU,MUMBAI,1796,1753,DIU-MUMBAI,3549,All
2022,12,DIU,MUMBAI,1771,1721,DIU-MUMBAI,3492,All
2023,11,DIU,MUMBAI,1371,1496,DIU-MUMBAI,2867,All
2023,12,DIU,MUMBAI,1719,1720,DIU-MUMBAI,3439,All
2024,1,DIU,MUMBAI,1801,1792,DIU-MUMBAI,3593,All
2024,2,DIU,MUMBAI,1867,1773,DIU-MUMBAI,3640,All
2024,3,DIU,MUMBAI,1755,1697,DIU-MUMBAI,3452,All
2024,4,DIU,MUMBAI,1400,1275,DIU-MUMBAI,2675,All
2024,6,DIU,MUMBAI,1347,1143,DIU-MUMBAI,2490,All
2024,7,DIU,MUMBAI,429,555,DIU-MUMBAI,984,All
2024,8,DIU,MUMBAI,1092,1206,DIU-MUMBAI,2298,All
2024,9,DIU,MUMBAI,1022,889,DIU-MUMBAI,1911,All
2024,10,DIU,MUMBAI,944,1100,DIU-MUMBAI,2044,All
2024,11,DIU,MUMBAI,1749,1766,DIU-MUMBAI,3515,All
2024,12,DIU,MUMBAI,1607,1601,DIU-MUMBAI,3208,All
2025,1,DIU,MUMBAI,1218,1162,DIU-MUMBAI,2380,All
2025,2,DIU,MUMBAI,1335,1364,DIU-MUMBAI,2699,All
2025,3,DIU,MUMBAI,780,680,DIU-MUMBAI,1460,All
2015,4,DIU,PORBANDAR,1,0,DIU-PORBANDAR,1,All
2015,5,DIU,PORBANDAR,8,0,DIU-PORBANDAR,8,All
2015,6,DIU,PORBANDAR,5,0,DIU-PORBANDAR,5,All
2015,8,DIU,PORBANDAR,1,0,DIU-PORBANDAR,1,All
2015,9,DIU,PORBANDAR,4,0,DIU-PORBANDAR,4,All
2015,10,DIU,PORBANDAR,8,0,DIU-PORBANDAR,8,All
2016,1,DIU,PORBANDAR,2,0,DIU-PORBANDAR,2,All
2016,2,DIU,PORBANDAR,3,0,DIU-PORBANDAR,3,All
2021,12,DIU,PUNE,0,2,DIU-PUNE,2,All
2022,5,DIU,PUNE,0,2,DIU-PUNE,2,All
2022,8,DIU,PUNE,0,2,DIU-PUNE,2,All
2023,10,DIU,SURAT,55,47,DIU-SURAT,102,All
2023,11,DIU,SURAT,1097,1167,DIU-SURAT,2264,All
2023,12,DIU,SURAT,1300,1125,DIU-SURAT,2425,All
2024,1,DIU,SURAT,1581,1312,DIU-SURAT,2893,All
2024,2,DIU,SURAT,1151,1129,DIU-SURAT,2280,All
2024,3,DIU,SURAT,1318,1192,DIU-SURAT,2510,All
2024,4,DIU,SURAT,1207,943,DIU-SURAT,2150,All
2024,6,DIU,SURAT,1135,852,DIU-SURAT,1987,All
2024,7,DIU,SURAT,383,335,DIU-SURAT,718,All
2024,8,DIU,SURAT,1262,1026,DIU-SURAT,2288,All
2024,9,DIU,SURAT,1196,973,DIU-SURAT,2169,All
2024,10,DIU,SURAT,1358,1397,DIU-SURAT,2755,All
2024,11,DIU,SURAT,1934,1589,DIU-SURAT,3523,All
2024,12,DIU,SURAT,1760,1544,DIU-SURAT,3304,All
2025,1,DIU,SURAT,2005,1864,DIU-SURAT,3869,All
2025,2,DIU,SURAT,1900,1770,DIU-SURAT,3670,All
2025,3,DIU,SURAT,1903,1487,DIU-SURAT,3390,All
2022,3,DURGAPUR,GUWAHATI,97,142,DURGAPUR-GUWAHATI,239,All
2022,4,DURGAPUR,GUWAHATI,859,1035,DURGAPUR-GUWAHATI,1894,All
2022,5,DURGAPUR,GUWAHATI,615,426,DURGAPUR-GUWAHATI,1041,All
2022,6,DURGAPUR,GUWAHATI,184,225,DURGAPUR-GUWAHATI,409,All
2022,7,DURGAPUR,GUWAHATI,137,130,DURGAPUR-GUWAHATI,267,All
2024,8,DURGAPUR,GUWAHATI,52,32,DURGAPUR-GUWAHATI,84,All
2024,9,DURGAPUR,GUWAHATI,426,414,DURGAPUR-GUWAHATI,840,All
2024,10,DURGAPUR,GUWAHATI,391,433,DURGAPUR-GUWAHATI,824,All
2024,11,DURGAPUR,GUWAHATI,615,566,DURGAPUR-GUWAHATI,1181,All
2024,12,DURGAPUR,GUWAHATI,808,617,DURGAPUR-GUWAHATI,1425,All
2025,1,DURGAPUR,GUWAHATI,675,533,DURGAPUR-GUWAHATI,1208,All
2025,2,DURGAPUR,GUWAHATI,548,427,DURGAPUR-GUWAHATI,975,All
2025,3,DURGAPUR,GUWAHATI,577,468,DURGAPUR-GUWAHATI,1045,All
2019,5,DURGAPUR,HYDERABAD,1771,1777,DURGAPUR-HYDERABAD,3548,All
2019,6,DURGAPUR,HYDERABAD,1564,1409,DURGAPUR-HYDERABAD,2973,All
2019,7,DURGAPUR,HYDERABAD,1458,1196,DURGAPUR-HYDERABAD,2654,All
2019,8,DURGAPUR,HYDERABAD,1390,1478,DURGAPUR-HYDERABAD,2868,All
2019,9,DURGAPUR,HYDERABAD,1239,1159,DURGAPUR-HYDERABAD,2398,All
2019,10,DURGAPUR,HYDERABAD,1622,1910,DURGAPUR-HYDERABAD,3532,All
2019,11,DURGAPUR,HYDERABAD,2010,1675,DURGAPUR-HYDERABAD,3685,All
2019,12,DURGAPUR,HYDERABAD,1926,1837,DURGAPUR-HYDERABAD,3763,All
2020,1,DURGAPUR,HYDERABAD,1999,1879,DURGAPUR-HYDERABAD,3878,All
2020,2,DURGAPUR,HYDERABAD,1864,1954,DURGAPUR-HYDERABAD,3818,All
2020,3,DURGAPUR,HYDERABAD,1275,1595,DURGAPUR-HYDERABAD,2870,All
2021,4,DURGAPUR,HYDERABAD,174,438,DURGAPUR-HYDERABAD,612,All
2021,7,DURGAPUR,HYDERABAD,222,127,DURGAPUR-HYDERABAD,349,All
2021,8,DURGAPUR,HYDERABAD,1369,1061,DURGAPUR-HYDERABAD,2430,All
2021,9,DURGAPUR,HYDERABAD,778,524,DURGAPUR-HYDERABAD,1302,All
2021,10,DURGAPUR,HYDERABAD,1764,1754,DURGAPUR-HYDERABAD,3518,All
2021,11,DURGAPUR,HYDERABAD,2898,2282,DURGAPUR-HYDERABAD,5180,All
2021,12,DURGAPUR,HYDERABAD,4144,3340,DURGAPUR-HYDERABAD,7484,All
2022,1,DURGAPUR,HYDERABAD,2554,2698,DURGAPUR-HYDERABAD,5252,All
2022,2,DURGAPUR,HYDERABAD,2533,2322,DURGAPUR-HYDERABAD,4855,All
2022,3,DURGAPUR,HYDERABAD,3182,2527,DURGAPUR-HYDERABAD,5709,All
2022,4,DURGAPUR,HYDERABAD,2616,2760,DURGAPUR-HYDERABAD,5376,All
2022,5,DURGAPUR,HYDERABAD,3418,2614,DURGAPUR-HYDERABAD,6032,All
2022,6,DURGAPUR,HYDERABAD,3271,2320,DURGAPUR-HYDERABAD,5591,All
2022,7,DURGAPUR,HYDERABAD,2508,2270,DURGAPUR-HYDERABAD,4778,All
2022,8,DURGAPUR,HYDERABAD,2667,2035,DURGAPUR-HYDERABAD,4702,All
2022,9,DURGAPUR,HYDERABAD,2321,2226,DURGAPUR-HYDERABAD,4547,All
2022,10,DURGAPUR,HYDERABAD,3389,3552,DURGAPUR-HYDERABAD,6941,All
2022,11,DURGAPUR,HYDERABAD,2612,2511,DURGAPUR-HYDERABAD,5123,All
2022,12,DURGAPUR,HYDERABAD,1314,1540,DURGAPUR-HYDERABAD,2854,All
2023,1,DURGAPUR,HYDERABAD,3375,4023,DURGAPUR-HYDERABAD,7398,All
2023,2,DURGAPUR,HYDERABAD,4145,4100,DURGAPUR-HYDERABAD,8245,All
2023,3,DURGAPUR,HYDERABAD,4794,4670,DURGAPUR-HYDERABAD,9464,All
2023,4,DURGAPUR,HYDERABAD,4612,4831,DURGAPUR-HYDERABAD,9443,All
2023,5,DURGAPUR,HYDERABAD,3361,3251,DURGAPUR-HYDERABAD,6612,All
2023,6,DURGAPUR,HYDERABAD,2936,2533,DURGAPUR-HYDERABAD,5469,All
2023,7,DURGAPUR,HYDERABAD,4396,3897,DURGAPUR-HYDERABAD,8293,All
2023,8,DURGAPUR,HYDERABAD,4828,4554,DURGAPUR-HYDERABAD,9382,All
2023,9,DURGAPUR,HYDERABAD,4467,4399,DURGAPUR-HYDERABAD,8866,All
2023,10,DURGAPUR,HYDERABAD,3669,4728,DURGAPUR-HYDERABAD,8397,All
2023,11,DURGAPUR,HYDERABAD,3952,4001,DURGAPUR-HYDERABAD,7953,All
2023,12,DURGAPUR,HYDERABAD,4621,3942,DURGAPUR-HYDERABAD,8563,All
2024,1,DURGAPUR,HYDERABAD,3994,4324,DURGAPUR-HYDERABAD,8318,All
2024,2,DURGAPUR,HYDERABAD,3687,4044,DURGAPUR-HYDERABAD,7731,All
2024,3,DURGAPUR,HYDERABAD,4013,4420,DURGAPUR-HYDERABAD,8433,All
2024,4,DURGAPUR,HYDERABAD,4213,4866,DURGAPUR-HYDERABAD,9079,All
2024,6,DURGAPUR,HYDERABAD,5045,4925,DURGAPUR-HYDERABAD,9970,All
2024,7,DURGAPUR,HYDERABAD,5976,5120,DURGAPUR-HYDERABAD,11096,All
2024,8,DURGAPUR,HYDERABAD,5201,5011,DURGAPUR-HYDERABAD,10212,All
2024,9,DURGAPUR,HYDERABAD,4483,5275,DURGAPUR-HYDERABAD,9758,All
2024,10,DURGAPUR,HYDERABAD,4245,5251,DURGAPUR-HYDERABAD,9496,All
2024,11,DURGAPUR,HYDERABAD,5112,4388,DURGAPUR-HYDERABAD,9500,All
2024,12,DURGAPUR,HYDERABAD,4724,4640,DURGAPUR-HYDERABAD,9364,All
2025,1,DURGAPUR,HYDERABAD,4906,5156,DURGAPUR-HYDERABAD,10062,All
2025,2,DURGAPUR,HYDERABAD,4344,4707,DURGAPUR-HYDERABAD,9051,All
2025,3,DURGAPUR,HYDERABAD,4854,5060,DURGAPUR-HYDERABAD,9914,All
2021,12,DURGAPUR,JAIPUR,205,189,DURGAPUR-JAIPUR,394,All
2024,7,DURGAPUR,JAIPUR,16,0,DURGAPUR-JAIPUR,16,All
2022,6,DURGAPUR,KOLKATA,0,132,DURGAPUR-KOLKATA,132,All
2023,9,DURGAPUR,KOLKATA,0,230,DURGAPUR-KOLKATA,230,All
2025,2,DURGAPUR,KOLKATA,51,0,DURGAPUR-KOLKATA,51,All
2021,7,DURGAPUR,LEH,0,2,DURGAPUR-LEH,2,All
2022,12,DURGAPUR,LUCKNOW,3,0,DURGAPUR-LUCKNOW,3,All
2019,6,DURGAPUR,MUMBAI,682,453,DURGAPUR-MUMBAI,1135,All
2019,7,DURGAPUR,MUMBAI,2691,2496,DURGAPUR-MUMBAI,5187,All
2019,8,DURGAPUR,MUMBAI,2366,2506,DURGAPUR-MUMBAI,4872,All
2019,9,DURGAPUR,MUMBAI,2098,2330,DURGAPUR-MUMBAI,4428,All
2019,10,DURGAPUR,MUMBAI,3231,3990,DURGAPUR-MUMBAI,7221,All
2019,11,DURGAPUR,MUMBAI,3835,3169,DURGAPUR-MUMBAI,7004,All
2019,12,DURGAPUR,MUMBAI,4109,4001,DURGAPUR-MUMBAI,8110,All
2020,1,DURGAPUR,MUMBAI,3761,3814,DURGAPUR-MUMBAI,7575,All
2020,2,DURGAPUR,MUMBAI,3923,3709,DURGAPUR-MUMBAI,7632,All
2020,3,DURGAPUR,MUMBAI,2508,3150,DURGAPUR-MUMBAI,5658,All
2020,9,DURGAPUR,MUMBAI,1437,916,DURGAPUR-MUMBAI,2353,All
2020,10,DURGAPUR,MUMBAI,1800,1718,DURGAPUR-MUMBAI,3518,All
2020,11,DURGAPUR,MUMBAI,1849,1835,DURGAPUR-MUMBAI,3684,All
2020,12,DURGAPUR,MUMBAI,1869,1857,DURGAPUR-MUMBAI,3726,All
2021,1,DURGAPUR,MUMBAI,1856,1765,DURGAPUR-MUMBAI,3621,All
2021,2,DURGAPUR,MUMBAI,1743,1823,DURGAPUR-MUMBAI,3566,All
2021,3,DURGAPUR,MUMBAI,2090,2118,DURGAPUR-MUMBAI,4208,All
2021,4,DURGAPUR,MUMBAI,916,1889,DURGAPUR-MUMBAI,2805,All
2021,6,DURGAPUR,MUMBAI,1595,988,DURGAPUR-MUMBAI,2583,All
2021,7,DURGAPUR,MUMBAI,1850,1803,DURGAPUR-MUMBAI,3653,All
2021,8,DURGAPUR,MUMBAI,1856,1692,DURGAPUR-MUMBAI,3548,All
2021,9,DURGAPUR,MUMBAI,1607,1714,DURGAPUR-MUMBAI,3321,All
2021,10,DURGAPUR,MUMBAI,2141,2432,DURGAPUR-MUMBAI,4573,All
2021,11,DURGAPUR,MUMBAI,2280,2454,DURGAPUR-MUMBAI,4734,All
2021,12,DURGAPUR,MUMBAI,5349,4247,DURGAPUR-MUMBAI,9596,All
2022,1,DURGAPUR,MUMBAI,1776,1913,DURGAPUR-MUMBAI,3689,All
2022,2,DURGAPUR,MUMBAI,1879,1851,DURGAPUR-MUMBAI,3730,All
2022,3,DURGAPUR,MUMBAI,4227,3840,DURGAPUR-MUMBAI,8067,All
2022,4,DURGAPUR,MUMBAI,4631,4846,DURGAPUR-MUMBAI,9477,All
2022,5,DURGAPUR,MUMBAI,5514,4967,DURGAPUR-MUMBAI,10481,All
2022,6,DURGAPUR,MUMBAI,5060,4004,DURGAPUR-MUMBAI,9064,All
2022,7,DURGAPUR,MUMBAI,3604,3360,DURGAPUR-MUMBAI,6964,All
2022,8,DURGAPUR,MUMBAI,3716,2825,DURGAPUR-MUMBAI,6541,All
2022,9,DURGAPUR,MUMBAI,3058,3391,DURGAPUR-MUMBAI,6449,All
2022,10,DURGAPUR,MUMBAI,3576,3912,DURGAPUR-MUMBAI,7488,All
2022,11,DURGAPUR,MUMBAI,3725,3443,DURGAPUR-MUMBAI,7168,All
2022,12,DURGAPUR,MUMBAI,4716,4560,DURGAPUR-MUMBAI,9276,All
2023,11,DURGAPUR,MUMBAI,3451,4091,DURGAPUR-MUMBAI,7542,All
2023,12,DURGAPUR,MUMBAI,4979,4717,DURGAPUR-MUMBAI,9696,All
2024,1,DURGAPUR,MUMBAI,4122,4078,DURGAPUR-MUMBAI,8200,All
2024,2,DURGAPUR,MUMBAI,3366,3537,DURGAPUR-MUMBAI,6903,All
2024,3,DURGAPUR,MUMBAI,2347,2400,DURGAPUR-MUMBAI,4747,All
2024,4,DURGAPUR,MUMBAI,2287,2845,DURGAPUR-MUMBAI,5132,All
2024,6,DURGAPUR,MUMBAI,2731,2708,DURGAPUR-MUMBAI,5439,All
2024,7,DURGAPUR,MUMBAI,2936,2376,DURGAPUR-MUMBAI,5312,All
2024,8,DURGAPUR,MUMBAI,2372,2048,DURGAPUR-MUMBAI,4420,All
2024,9,DURGAPUR,MUMBAI,1982,2128,DURGAPUR-MUMBAI,4110,All
2024,10,DURGAPUR,MUMBAI,2117,2884,DURGAPUR-MUMBAI,5001,All
2024,11,DURGAPUR,MUMBAI,2952,2838,DURGAPUR-MUMBAI,5790,All
2024,12,DURGAPUR,MUMBAI,2767,2810,DURGAPUR-MUMBAI,5577,All
2025,1,DURGAPUR,MUMBAI,3033,3146,DURGAPUR-MUMBAI,6179,All
2025,2,DURGAPUR,MUMBAI,2513,2808,DURGAPUR-MUMBAI,5321,All
2025,3,DURGAPUR,MUMBAI,2692,3142,DURGAPUR-MUMBAI,5834,All
2021,10,DURGAPUR,PUNE,3,9,DURGAPUR-PUNE,12,All
2021,11,DURGAPUR,PUNE,128,111,DURGAPUR-PUNE,239,All
2019,9,DURGAPUR,RAIPUR,0,0,DURGAPUR-RAIPUR,0,All
2025,3,DURGAPUR,RAIPUR,4,0,DURGAPUR-RAIPUR,4,All
2022,8,DURGAPUR,SHIRDI,0,1,DURGAPUR-SHIRDI,1,All
2022,9,DURGAPUR,SHIRDI,0,4,DURGAPUR-SHIRDI,4,All
2022,10,DURGAPUR,SHIRDI,0,3,DURGAPUR-SHIRDI,3,All
2022,7,DURGAPUR,SRINAGAR,0,9,DURGAPUR-SRINAGAR,9,All
2022,8,DURGAPUR,SRINAGAR,0,3,DURGAPUR-SRINAGAR,3,All
2022,9,DURGAPUR,SRINAGAR,0,5,DURGAPUR-SRINAGAR,5,All
2022,10,DURGAPUR,SRINAGAR,0,1,DURGAPUR-SRINAGAR,1,All
2023,11,DURGAPUR,SURAT,0,20,DURGAPUR-SURAT,20,All
2023,12,DURGAPUR,SURAT,0,7,DURGAPUR-SURAT,7,All
2024,1,DURGAPUR,SURAT,0,43,DURGAPUR-SURAT,43,All
2024,2,DURGAPUR,SURAT,0,30,DURGAPUR-SURAT,30,All
2024,3,DURGAPUR,SURAT,0,18,DURGAPUR-SURAT,18,All
2024,6,DURGAPUR,SURAT,0,4,DURGAPUR-SURAT,4,All
2024,7,DURGAPUR,SURAT,0,3,DURGAPUR-SURAT,3,All
2024,8,DURGAPUR,SURAT,0,8,DURGAPUR-SURAT,8,All
2024,9,DURGAPUR,SURAT,0,11,DURGAPUR-SURAT,11,All
2024,10,DURGAPUR,SURAT,0,16,DURGAPUR-SURAT,16,All
2022,3,DURGAPUR,TRIVANDRUM,1,13,DURGAPUR-TRIVANDRUM,14,All
2022,4,DURGAPUR,TRIVANDRUM,37,50,DURGAPUR-TRIVANDRUM,87,All
2022,5,DURGAPUR,TRIVANDRUM,78,67,DURGAPUR-TRIVANDRUM,145,All
2022,6,DURGAPUR,TRIVANDRUM,12,0,DURGAPUR-TRIVANDRUM,12,All
2022,7,DURGAPUR,TRIVANDRUM,49,55,DURGAPUR-TRIVANDRUM,104,All
2022,8,DURGAPUR,TRIVANDRUM,53,78,DURGAPUR-TRIVANDRUM,131,All
2022,9,DURGAPUR,TRIVANDRUM,93,82,DURGAPUR-TRIVANDRUM,175,All
2022,10,DURGAPUR,TRIVANDRUM,49,114,DURGAPUR-TRIVANDRUM,163,All
2022,3,DURGAPUR,VADODARA,0,6,DURGAPUR-VADODARA,6,All
2022,4,DURGAPUR,VADODARA,0,62,DURGAPUR-VADODARA,62,All
2022,5,DURGAPUR,VADODARA,0,49,DURGAPUR-VADODARA,49,All
2022,6,DURGAPUR,VADODARA,0,38,DURGAPUR-VADODARA,38,All
2022,7,DURGAPUR,VADODARA,0,15,DURGAPUR-VADODARA,15,All
2022,8,DURGAPUR,VADODARA,0,7,DURGAPUR-VADODARA,7,All
2022,11,DURGAPUR,VADODARA,0,44,DURGAPUR-VADODARA,44,All
2022,12,DURGAPUR,VADODARA,0,8,DURGAPUR-VADODARA,8,All
2023,1,DURGAPUR,VADODARA,0,17,DURGAPUR-VADODARA,17,All
2023,2,DURGAPUR,VADODARA,0,18,DURGAPUR-VADODARA,18,All
2023,3,DURGAPUR,VADODARA,0,16,DURGAPUR-VADODARA,16,All
2023,4,DURGAPUR,VADODARA,0,19,DURGAPUR-VADODARA,19,All
2023,5,DURGAPUR,VADODARA,0,42,DURGAPUR-VADODARA,42,All
2023,6,DURGAPUR,VADODARA,0,11,DURGAPUR-VADODARA,11,All
2023,7,DURGAPUR,VADODARA,0,11,DURGAPUR-VADODARA,11,All
2023,8,DURGAPUR,VADODARA,0,12,DURGAPUR-VADODARA,12,All
2023,9,DURGAPUR,VADODARA,0,12,DURGAPUR-VADODARA,12,All
2023,10,DURGAPUR,VADODARA,0,20,DURGAPUR-VADODARA,20,All
2024,3,DehraDun,Ayodhya International Airport ,615,537,Ayodhya International Airport -DehraDun,1152,All
2024,4,DehraDun,Ayodhya International Airport ,148,130,Ayodhya International Airport -DehraDun,278,All
2024,6,DehraDun,Ayodhya International Airport ,141,123,Ayodhya International Airport -DehraDun,264,All
2024,7,DehraDun,Ayodhya International Airport ,169,143,Ayodhya International Airport -DehraDun,312,All
2024,8,DehraDun,Ayodhya International Airport ,225,239,Ayodhya International Airport -DehraDun,464,All
2024,9,DehraDun,Ayodhya International Airport ,184,143,Ayodhya International Airport -DehraDun,327,All
2024,10,DehraDun,Ayodhya International Airport ,63,64,Ayodhya International Airport -DehraDun,127,All
2023,1,DehraDun,DELHI,20790,20724,DehraDun-DELHI,41514,All
2023,6,DehraDun,DELHI,24207,24465,DehraDun-DELHI,48672,All
2023,7,DehraDun,DELHI,22432,23527,DehraDun-DELHI,45959,All
2023,8,DehraDun,DELHI,20473,21029,DehraDun-DELHI,41502,All
2023,9,DehraDun,DELHI,21780,24098,DehraDun-DELHI,45878,All
2023,10,DehraDun,DELHI,23102,22482,DehraDun-DELHI,45584,All
2023,11,DehraDun,DELHI,23192,23937,DehraDun-DELHI,47129,All
2023,12,DehraDun,DELHI,22045,21704,DehraDun-DELHI,43749,All
2024,1,DehraDun,DELHI,20428,20025,DehraDun-DELHI,40453,All
2024,2,DehraDun,DELHI,22259,23095,DehraDun-DELHI,45354,All
2024,3,DehraDun,DELHI,24616,25225,DehraDun-DELHI,49841,All
2024,4,DehraDun,DELHI,22486,22911,DehraDun-DELHI,45397,All
2024,6,DehraDun,DELHI,26774,26180,DehraDun-DELHI,52954,All
2024,7,DehraDun,DELHI,23804,23938,DehraDun-DELHI,47742,All
2024,8,DehraDun,DELHI,24017,23639,DehraDun-DELHI,47656,All
2024,9,DehraDun,DELHI,23986,24346,DehraDun-DELHI,48332,All
2024,10,DehraDun,DELHI,24688,24744,DehraDun-DELHI,49432,All
2024,11,DehraDun,DELHI,23748,24207,DehraDun-DELHI,47955,All
2024,12,DehraDun,DELHI,23214,22577,DehraDun-DELHI,45791,All
2025,1,DehraDun,DELHI,21933,21801,DehraDun-DELHI,43734,All
2025,2,DehraDun,DELHI,23023,23999,DehraDun-DELHI,47022,All
2025,3,DehraDun,DELHI,27814,28477,DehraDun-DELHI,56291,All
2023,9,DehraDun,GHAZIABAD,28,25,DehraDun-GHAZIABAD,53,All
2023,10,DehraDun,GHAZIABAD,9,9,DehraDun-GHAZIABAD,18,All
2023,11,DehraDun,GHAZIABAD,13,0,DehraDun-GHAZIABAD,13,All
2023,12,DehraDun,GHAZIABAD,0,2,DehraDun-GHAZIABAD,2,All
2024,1,DehraDun,GHAZIABAD,1,1,DehraDun-GHAZIABAD,2,All
2023,6,DehraDun,GUWAHATI,165,251,DehraDun-GUWAHATI,416,All
2023,7,DehraDun,GUWAHATI,556,600,DehraDun-GUWAHATI,1156,All
2023,8,DehraDun,GUWAHATI,283,281,DehraDun-GUWAHATI,564,All
2023,9,DehraDun,GUWAHATI,199,166,DehraDun-GUWAHATI,365,All
2023,10,DehraDun,GUWAHATI,131,90,DehraDun-GUWAHATI,221,All
2024,3,DehraDun,GUWAHATI,4,2,DehraDun-GUWAHATI,6,All
2024,4,DehraDun,GUWAHATI,133,137,DehraDun-GUWAHATI,270,All
2024,6,DehraDun,GUWAHATI,163,288,DehraDun-GUWAHATI,451,All
2024,7,DehraDun,GUWAHATI,318,308,DehraDun-GUWAHATI,626,All
2024,8,DehraDun,GUWAHATI,359,122,DehraDun-GUWAHATI,481,All
2024,9,DehraDun,GUWAHATI,234,137,DehraDun-GUWAHATI,371,All
2024,10,DehraDun,GUWAHATI,207,192,DehraDun-GUWAHATI,399,All
2024,11,DehraDun,GUWAHATI,260,433,DehraDun-GUWAHATI,693,All
2024,12,DehraDun,GUWAHATI,231,223,DehraDun-GUWAHATI,454,All
2025,3,DehraDun,GUWAHATI,195,183,DehraDun-GUWAHATI,378,All
2023,11,DehraDun,Goa,2061,2030,DehraDun-Goa,4091,All
2023,12,DehraDun,Goa,2222,1918,DehraDun-Goa,4140,All
2024,1,DehraDun,Goa,1150,1141,DehraDun-Goa,2291,All
2024,2,DehraDun,HINDON AIRPORT,3,5,DehraDun-HINDON AIRPORT,8,All
2023,1,DehraDun,HYDERABAD,3845,3098,DehraDun-HYDERABAD,6943,All
2023,6,DehraDun,HYDERABAD,5357,4980,DehraDun-HYDERABAD,10337,All
2023,7,DehraDun,HYDERABAD,4499,3869,DehraDun-HYDERABAD,8368,All
2023,8,DehraDun,HYDERABAD,3523,3558,DehraDun-HYDERABAD,7081,All
2023,9,DehraDun,HYDERABAD,4477,4926,DehraDun-HYDERABAD,9403,All
2023,10,DehraDun,HYDERABAD,5236,5394,DehraDun-HYDERABAD,10630,All
2023,11,DehraDun,HYDERABAD,5169,4984,DehraDun-HYDERABAD,10153,All
2023,12,DehraDun,HYDERABAD,5553,4583,DehraDun-HYDERABAD,10136,All
2024,1,DehraDun,HYDERABAD,4687,5207,DehraDun-HYDERABAD,9894,All
2024,2,DehraDun,HYDERABAD,4624,4806,DehraDun-HYDERABAD,9430,All
2024,3,DehraDun,HYDERABAD,4704,4916,DehraDun-HYDERABAD,9620,All
2024,4,DehraDun,HYDERABAD,4432,4862,DehraDun-HYDERABAD,9294,All
2024,6,DehraDun,HYDERABAD,4968,4467,DehraDun-HYDERABAD,9435,All
2024,7,DehraDun,HYDERABAD,4541,4800,DehraDun-HYDERABAD,9341,All
2024,8,DehraDun,HYDERABAD,3897,4622,DehraDun-HYDERABAD,8519,All
2024,9,DehraDun,HYDERABAD,4059,4546,DehraDun-HYDERABAD,8605,All
2024,10,DehraDun,HYDERABAD,4437,5009,DehraDun-HYDERABAD,9446,All
2024,11,DehraDun,HYDERABAD,4803,4079,DehraDun-HYDERABAD,8882,All
2024,12,DehraDun,HYDERABAD,5402,4841,DehraDun-HYDERABAD,10243,All
2025,1,DehraDun,HYDERABAD,4237,4540,DehraDun-HYDERABAD,8777,All
2025,2,DehraDun,HYDERABAD,4289,4720,DehraDun-HYDERABAD,9009,All
2025,3,DehraDun,HYDERABAD,4885,4840,DehraDun-HYDERABAD,9725,All
2023,6,DehraDun,INDORE,10,0,DehraDun-INDORE,10,All
2024,10,DehraDun,INDORE,68,74,DehraDun-INDORE,142,All
2024,11,DehraDun,INDORE,400,398,DehraDun-INDORE,798,All
2024,12,DehraDun,INDORE,426,429,DehraDun-INDORE,855,All
2025,3,DehraDun,INDORE,468,492,DehraDun-INDORE,960,All
2023,1,DehraDun,JAIPUR,1953,1751,DehraDun-JAIPUR,3704,All
2023,6,DehraDun,JAIPUR,2951,2684,DehraDun-JAIPUR,5635,All
2023,7,DehraDun,JAIPUR,2697,2481,DehraDun-JAIPUR,5178,All
2023,8,DehraDun,JAIPUR,2831,2569,DehraDun-JAIPUR,5400,All
2023,9,DehraDun,JAIPUR,2505,2706,DehraDun-JAIPUR,5211,All
2023,10,DehraDun,JAIPUR,2756,2675,DehraDun-JAIPUR,5431,All
2023,11,DehraDun,JAIPUR,3488,3238,DehraDun-JAIPUR,6726,All
2023,12,DehraDun,JAIPUR,3642,3262,DehraDun-JAIPUR,6904,All
2024,1,DehraDun,JAIPUR,2396,2915,DehraDun-JAIPUR,5311,All
2024,2,DehraDun,JAIPUR,2875,3396,DehraDun-JAIPUR,6271,All
2024,3,DehraDun,JAIPUR,3635,3556,DehraDun-JAIPUR,7191,All
2024,4,DehraDun,JAIPUR,3500,3424,DehraDun-JAIPUR,6924,All
2024,6,DehraDun,JAIPUR,3853,3238,DehraDun-JAIPUR,7091,All
2024,7,DehraDun,JAIPUR,3240,2871,DehraDun-JAIPUR,6111,All
2024,8,DehraDun,JAIPUR,2711,2691,DehraDun-JAIPUR,5402,All
2024,9,DehraDun,JAIPUR,3426,3350,DehraDun-JAIPUR,6776,All
2024,10,DehraDun,JAIPUR,3843,3392,DehraDun-JAIPUR,7235,All
2024,11,DehraDun,JAIPUR,3960,3448,DehraDun-JAIPUR,7408,All
2024,12,DehraDun,JAIPUR,2816,2603,DehraDun-JAIPUR,5419,All
2025,1,DehraDun,JAIPUR,1691,1787,DehraDun-JAIPUR,3478,All
2025,2,DehraDun,JAIPUR,3008,2890,DehraDun-JAIPUR,5898,All
2025,3,DehraDun,JAIPUR,3635,3404,DehraDun-JAIPUR,7039,All
2023,6,DehraDun,JAMMU,235,185,DehraDun-JAMMU,420,All
2023,7,DehraDun,JAMMU,239,235,DehraDun-JAMMU,474,All
2023,6,DehraDun,KOLKATA,1850,1588,DehraDun-KOLKATA,3438,All
2023,7,DehraDun,KOLKATA,2103,2131,DehraDun-KOLKATA,4234,All
2023,8,DehraDun,KOLKATA,2112,2124,DehraDun-KOLKATA,4236,All
2023,9,DehraDun,KOLKATA,2599,2593,DehraDun-KOLKATA,5192,All
2023,10,DehraDun,KOLKATA,2722,2721,DehraDun-KOLKATA,5443,All
2024,3,DehraDun,KOLKATA,164,150,DehraDun-KOLKATA,314,All
2024,4,DehraDun,KOLKATA,2692,2575,DehraDun-KOLKATA,5267,All
2024,6,DehraDun,KOLKATA,2856,2465,DehraDun-KOLKATA,5321,All
2024,7,DehraDun,KOLKATA,2868,2709,DehraDun-KOLKATA,5577,All
2024,8,DehraDun,KOLKATA,2417,2389,DehraDun-KOLKATA,4806,All
2024,9,DehraDun,KOLKATA,2498,2539,DehraDun-KOLKATA,5037,All
2024,10,DehraDun,KOLKATA,2569,2187,DehraDun-KOLKATA,4756,All
2024,11,DehraDun,KOLKATA,2626,2330,DehraDun-KOLKATA,4956,All
2024,12,DehraDun,KOLKATA,2896,2532,DehraDun-KOLKATA,5428,All
2025,1,DehraDun,KOLKATA,2810,3063,DehraDun-KOLKATA,5873,All
2025,2,DehraDun,KOLKATA,2935,2881,DehraDun-KOLKATA,5816,All
2025,3,DehraDun,KOLKATA,3329,3120,DehraDun-KOLKATA,6449,All
2024,6,DehraDun,KULLU,223,129,DehraDun-KULLU,352,All
2024,7,DehraDun,KULLU,147,152,DehraDun-KULLU,299,All
2024,8,DehraDun,KULLU,87,117,DehraDun-KULLU,204,All
2024,9,DehraDun,KULLU,139,121,DehraDun-KULLU,260,All
2024,10,DehraDun,KULLU,391,321,DehraDun-KULLU,712,All
2024,11,DehraDun,KULLU,355,246,DehraDun-KULLU,601,All
2024,12,DehraDun,KULLU,57,15,DehraDun-KULLU,72,All
2025,1,DehraDun,KULLU,243,138,DehraDun-KULLU,381,All
2025,2,DehraDun,KULLU,103,65,DehraDun-KULLU,168,All
2025,3,DehraDun,KULLU,140,72,DehraDun-KULLU,212,All
2023,1,DehraDun,LUCKNOW,4215,4278,DehraDun-LUCKNOW,8493,All
2023,6,DehraDun,LUCKNOW,5074,5144,DehraDun-LUCKNOW,10218,All
2023,7,DehraDun,LUCKNOW,5096,5137,DehraDun-LUCKNOW,10233,All
2023,8,DehraDun,LUCKNOW,5187,5240,DehraDun-LUCKNOW,10427,All
2023,9,DehraDun,LUCKNOW,4518,4521,DehraDun-LUCKNOW,9039,All
2023,10,DehraDun,LUCKNOW,4864,4962,DehraDun-LUCKNOW,9826,All
2023,11,DehraDun,LUCKNOW,4715,4317,DehraDun-LUCKNOW,9032,All
2023,12,DehraDun,LUCKNOW,4427,4499,DehraDun-LUCKNOW,8926,All
2024,1,DehraDun,LUCKNOW,3970,4308,DehraDun-LUCKNOW,8278,All
2024,2,DehraDun,LUCKNOW,3774,3986,DehraDun-LUCKNOW,7760,All
2024,3,DehraDun,LUCKNOW,4146,4299,DehraDun-LUCKNOW,8445,All
2024,4,DehraDun,LUCKNOW,4209,4119,DehraDun-LUCKNOW,8328,All
2024,6,DehraDun,LUCKNOW,4342,4233,DehraDun-LUCKNOW,8575,All
2024,7,DehraDun,LUCKNOW,3569,3987,DehraDun-LUCKNOW,7556,All
2024,8,DehraDun,LUCKNOW,3900,4442,DehraDun-LUCKNOW,8342,All
2024,9,DehraDun,LUCKNOW,4066,4431,DehraDun-LUCKNOW,8497,All
2024,10,DehraDun,LUCKNOW,4974,4505,DehraDun-LUCKNOW,9479,All
2024,11,DehraDun,LUCKNOW,3651,4255,DehraDun-LUCKNOW,7906,All
2024,12,DehraDun,LUCKNOW,4015,4191,DehraDun-LUCKNOW,8206,All
2025,1,DehraDun,LUCKNOW,3741,3905,DehraDun-LUCKNOW,7646,All
2025,2,DehraDun,LUCKNOW,4092,4275,DehraDun-LUCKNOW,8367,All
2025,3,DehraDun,LUCKNOW,3096,3916,DehraDun-LUCKNOW,7012,All
2023,11,DehraDun,MUMBAI,10259,9787,DehraDun-MUMBAI,20046,All
2023,12,DehraDun,MUMBAI,11081,10092,DehraDun-MUMBAI,21173,All
2024,1,DehraDun,MUMBAI,10010,9315,DehraDun-MUMBAI,19325,All
2024,2,DehraDun,MUMBAI,9843,9461,DehraDun-MUMBAI,19304,All
2024,3,DehraDun,MUMBAI,13180,13003,DehraDun-MUMBAI,26183,All
2024,4,DehraDun,MUMBAI,13996,14801,DehraDun-MUMBAI,28797,All
2024,6,DehraDun,MUMBAI,15943,13082,DehraDun-MUMBAI,29025,All
2024,7,DehraDun,MUMBAI,11271,9655,DehraDun-MUMBAI,20926,All
2024,8,DehraDun,MUMBAI,11120,10345,DehraDun-MUMBAI,21465,All
2024,9,DehraDun,MUMBAI,12829,13217,DehraDun-MUMBAI,26046,All
2024,10,DehraDun,MUMBAI,9222,9551,DehraDun-MUMBAI,18773,All
2024,11,DehraDun,MUMBAI,9734,9160,DehraDun-MUMBAI,18894,All
2024,12,DehraDun,MUMBAI,10183,9559,DehraDun-MUMBAI,19742,All
2025,1,DehraDun,MUMBAI,9259,9624,DehraDun-MUMBAI,18883,All
2025,2,DehraDun,MUMBAI,8891,9307,DehraDun-MUMBAI,18198,All
2025,3,DehraDun,MUMBAI,12577,12097,DehraDun-MUMBAI,24674,All
2024,3,DehraDun,PANTNAGAR,17,34,DehraDun-PANTNAGAR,51,All
2024,6,DehraDun,PANTNAGAR,19,86,DehraDun-PANTNAGAR,105,All
2024,7,DehraDun,PANTNAGAR,16,25,DehraDun-PANTNAGAR,41,All
2024,8,DehraDun,PANTNAGAR,15,53,DehraDun-PANTNAGAR,68,All
2024,9,DehraDun,PANTNAGAR,34,30,DehraDun-PANTNAGAR,64,All
2024,2,DehraDun,PITHORAGARH,120,133,DehraDun-PITHORAGARH,253,All
2024,3,DehraDun,PITHORAGARH,207,190,DehraDun-PITHORAGARH,397,All
2024,4,DehraDun,PITHORAGARH,235,247,DehraDun-PITHORAGARH,482,All
2024,6,DehraDun,PITHORAGARH,251,245,DehraDun-PITHORAGARH,496,All
2024,7,DehraDun,PITHORAGARH,92,117,DehraDun-PITHORAGARH,209,All
2024,8,DehraDun,PITHORAGARH,165,183,DehraDun-PITHORAGARH,348,All
2024,9,DehraDun,PITHORAGARH,184,185,DehraDun-PITHORAGARH,369,All
2024,10,DehraDun,PITHORAGARH,265,254,DehraDun-PITHORAGARH,519,All
2024,11,DehraDun,PITHORAGARH,320,328,DehraDun-PITHORAGARH,648,All
2024,12,DehraDun,PITHORAGARH,211,202,DehraDun-PITHORAGARH,413,All
2025,1,DehraDun,PITHORAGARH,162,140,DehraDun-PITHORAGARH,302,All
2025,2,DehraDun,PITHORAGARH,144,158,DehraDun-PITHORAGARH,302,All
2025,3,DehraDun,PITHORAGARH,249,246,DehraDun-PITHORAGARH,495,All
2023,1,DehraDun,PUNE,2836,2407,DehraDun-PUNE,5243,All
2023,6,DehraDun,PUNE,4516,4206,DehraDun-PUNE,8722,All
2023,7,DehraDun,PUNE,3182,3075,DehraDun-PUNE,6257,All
2023,8,DehraDun,PUNE,2633,2912,DehraDun-PUNE,5545,All
2023,9,DehraDun,PUNE,3562,3994,DehraDun-PUNE,7556,All
2023,10,DehraDun,PUNE,4353,4656,DehraDun-PUNE,9009,All
2023,11,DehraDun,PUNE,4276,4167,DehraDun-PUNE,8443,All
2023,12,DehraDun,PUNE,4459,3753,DehraDun-PUNE,8212,All
2024,1,DehraDun,PUNE,4021,3844,DehraDun-PUNE,7865,All
2024,2,DehraDun,PUNE,3872,4000,DehraDun-PUNE,7872,All
2024,3,DehraDun,PUNE,4122,4296,DehraDun-PUNE,8418,All
2024,4,DehraDun,PUNE,4222,4557,DehraDun-PUNE,8779,All
2024,6,DehraDun,PUNE,4437,3962,DehraDun-PUNE,8399,All
2024,7,DehraDun,PUNE,4458,4241,DehraDun-PUNE,8699,All
2024,8,DehraDun,PUNE,3856,3972,DehraDun-PUNE,7828,All
2024,9,DehraDun,PUNE,3841,4104,DehraDun-PUNE,7945,All
2024,10,DehraDun,PUNE,3605,4341,DehraDun-PUNE,7946,All
2024,11,DehraDun,PUNE,4173,4024,DehraDun-PUNE,8197,All
2024,12,DehraDun,PUNE,4602,4284,DehraDun-PUNE,8886,All
2025,1,DehraDun,PUNE,4444,4463,DehraDun-PUNE,8907,All
2025,2,DehraDun,PUNE,4045,4217,DehraDun-PUNE,8262,All
2025,3,DehraDun,PUNE,4306,4355,DehraDun-PUNE,8661,All
2025,2,DehraDun,SRINAGAR,862,940,DehraDun-SRINAGAR,1802,All
2025,3,DehraDun,SRINAGAR,1575,1139,DehraDun-SRINAGAR,2714,All
2024,4,Deoghar ,JAIPUR,8,0,Deoghar -JAIPUR,8,All
2023,1,Deoghar ,KOLKATA,1063,1161,Deoghar -KOLKATA,2224,All
2023,6,Deoghar ,KOLKATA,1883,1278,Deoghar -KOLKATA,3161,All
2023,7,Deoghar ,KOLKATA,1639,921,Deoghar -KOLKATA,2560,All
2023,8,Deoghar ,KOLKATA,1054,799,Deoghar -KOLKATA,1853,All
2023,9,Deoghar ,KOLKATA,1286,892,Deoghar -KOLKATA,2178,All
2023,10,Deoghar ,KOLKATA,1560,1256,Deoghar -KOLKATA,2816,All
2023,11,Deoghar ,KOLKATA,1737,2008,Deoghar -KOLKATA,3745,All
2023,12,Deoghar ,KOLKATA,1635,1391,Deoghar -KOLKATA,3026,All
2024,1,Deoghar ,KOLKATA,800,791,Deoghar -KOLKATA,1591,All
2024,2,Deoghar ,KOLKATA,1391,1509,Deoghar -KOLKATA,2900,All
2024,3,Deoghar ,KOLKATA,1850,2007,Deoghar -KOLKATA,3857,All
2024,4,Deoghar ,KOLKATA,1828,1855,Deoghar -KOLKATA,3683,All
2024,6,Deoghar ,KOLKATA,1866,1719,Deoghar -KOLKATA,3585,All
2024,7,Deoghar ,KOLKATA,1895,1831,Deoghar -KOLKATA,3726,All
2024,8,Deoghar ,KOLKATA,1953,1595,Deoghar -KOLKATA,3548,All
2024,9,Deoghar ,KOLKATA,1914,1798,Deoghar -KOLKATA,3712,All
2024,10,Deoghar ,KOLKATA,1710,1833,Deoghar -KOLKATA,3543,All
2024,11,Deoghar ,KOLKATA,2105,2010,Deoghar -KOLKATA,4115,All
2024,12,Deoghar ,KOLKATA,2196,1682,Deoghar -KOLKATA,3878,All
2025,1,Deoghar ,KOLKATA,1891,1674,Deoghar -KOLKATA,3565,All
2025,2,Deoghar ,KOLKATA,1881,1663,Deoghar -KOLKATA,3544,All
2025,3,Deoghar ,KOLKATA,1999,2108,Deoghar -KOLKATA,4107,All
2024,12,Deoghar ,MUMBAI,2283,2205,Deoghar -MUMBAI,4488,All
2025,1,Deoghar ,MUMBAI,2160,2011,Deoghar -MUMBAI,4171,All
2025,2,Deoghar ,MUMBAI,1994,2087,Deoghar -MUMBAI,4081,All
2025,3,Deoghar ,MUMBAI,2114,2198,Deoghar -MUMBAI,4312,All
2023,6,Deoghar ,PATNA,501,617,Deoghar -PATNA,1118,All
2023,7,Deoghar ,PATNA,513,328,Deoghar -PATNA,841,All
2023,8,Deoghar ,PATNA,353,353,Deoghar -PATNA,706,All
2023,9,Deoghar ,PATNA,259,219,Deoghar -PATNA,478,All
2023,10,Deoghar ,PATNA,517,459,Deoghar -PATNA,976,All
2023,11,Deoghar ,PATNA,450,316,Deoghar -PATNA,766,All
2023,12,Deoghar ,PATNA,331,663,Deoghar -PATNA,994,All
2024,1,Deoghar ,PATNA,262,258,Deoghar -PATNA,520,All
2024,2,Deoghar ,PATNA,547,522,Deoghar -PATNA,1069,All
2024,3,Deoghar ,PATNA,637,761,Deoghar -PATNA,1398,All
2024,4,Deoghar ,PATNA,571,730,Deoghar -PATNA,1301,All
2024,6,Deoghar ,PATNA,259,233,Deoghar -PATNA,492,All
2024,7,Deoghar ,PATNA,402,298,Deoghar -PATNA,700,All
2024,8,Deoghar ,PATNA,351,256,Deoghar -PATNA,607,All
2024,9,Deoghar ,PATNA,533,492,Deoghar -PATNA,1025,All
2024,10,Deoghar ,PATNA,630,620,Deoghar -PATNA,1250,All
2024,11,Deoghar ,PATNA,519,489,Deoghar -PATNA,1008,All
2024,12,Deoghar ,PATNA,590,530,Deoghar -PATNA,1120,All
2025,1,Deoghar ,PATNA,816,366,Deoghar -PATNA,1182,All
2025,2,Deoghar ,PATNA,761,688,Deoghar -PATNA,1449,All
2023,6,Deoghar ,RANCHI,738,789,Deoghar -RANCHI,1527,All
2023,7,Deoghar ,RANCHI,656,677,Deoghar -RANCHI,1333,All
2023,8,Deoghar ,RANCHI,418,487,Deoghar -RANCHI,905,All
2023,9,Deoghar ,RANCHI,540,608,Deoghar -RANCHI,1148,All
2023,10,Deoghar ,RANCHI,481,480,Deoghar -RANCHI,961,All
2023,11,Deoghar ,RANCHI,534,589,Deoghar -RANCHI,1123,All
2023,12,Deoghar ,RANCHI,489,435,Deoghar -RANCHI,924,All
2024,1,Deoghar ,RANCHI,183,185,Deoghar -RANCHI,368,All
2024,2,Deoghar ,RANCHI,390,491,Deoghar -RANCHI,881,All
2024,3,Deoghar ,RANCHI,672,667,Deoghar -RANCHI,1339,All
2024,4,Deoghar ,RANCHI,460,556,Deoghar -RANCHI,1016,All
2024,6,Deoghar ,RANCHI,301,338,Deoghar -RANCHI,639,All
2024,7,Deoghar ,RANCHI,340,477,Deoghar -RANCHI,817,All
2024,8,Deoghar ,RANCHI,413,490,Deoghar -RANCHI,903,All
2024,9,Deoghar ,RANCHI,351,640,Deoghar -RANCHI,991,All
2024,10,Deoghar ,RANCHI,499,690,Deoghar -RANCHI,1189,All
2024,11,Deoghar ,RANCHI,711,867,Deoghar -RANCHI,1578,All
2024,12,Deoghar ,RANCHI,670,787,Deoghar -RANCHI,1457,All
2025,1,Deoghar ,RANCHI,427,971,Deoghar -RANCHI,1398,All
2025,2,Deoghar ,RANCHI,623,793,Deoghar -RANCHI,1416,All
2022,7,Deoghar Airport,DELHI,335,345,DELHI-Deoghar Airport,680,All
2022,8,Deoghar Airport,DELHI,3923,3721,DELHI-Deoghar Airport,7644,All
2022,9,Deoghar Airport,DELHI,2681,2933,DELHI-Deoghar Airport,5614,All
2022,10,Deoghar Airport,DELHI,3590,4760,DELHI-Deoghar Airport,8350,All
2022,11,Deoghar Airport,DELHI,3768,3579,DELHI-Deoghar Airport,7347,All
2022,12,Deoghar Airport,DELHI,3164,3348,DELHI-Deoghar Airport,6512,All
2022,7,Deoghar Airport,KOLKATA,812,665,Deoghar Airport-KOLKATA,1477,All
2022,8,Deoghar Airport,KOLKATA,724,661,Deoghar Airport-KOLKATA,1385,All
2022,9,Deoghar Airport,KOLKATA,516,414,Deoghar Airport-KOLKATA,930,All
2022,10,Deoghar Airport,KOLKATA,634,812,Deoghar Airport-KOLKATA,1446,All
2022,11,Deoghar Airport,KOLKATA,1046,839,Deoghar Airport-KOLKATA,1885,All
2022,12,Deoghar Airport,KOLKATA,972,809,Deoghar Airport-KOLKATA,1781,All
2023,2,Deoghar Airport,KOLKATA,1359,1362,Deoghar Airport-KOLKATA,2721,All
2023,3,Deoghar Airport,KOLKATA,1541,1327,Deoghar Airport-KOLKATA,2868,All
2023,4,Deoghar Airport,KOLKATA,1493,1352,Deoghar Airport-KOLKATA,2845,All
2023,5,Deoghar Airport,KOLKATA,1747,1532,Deoghar Airport-KOLKATA,3279,All
2023,3,Deoghar Airport,PATNA,44,74,Deoghar Airport-PATNA,118,All
2023,4,Deoghar Airport,PATNA,610,584,Deoghar Airport-PATNA,1194,All
2023,5,Deoghar Airport,PATNA,485,476,Deoghar Airport-PATNA,961,All
2023,3,Deoghar Airport,RANCHI,87,65,Deoghar Airport-RANCHI,152,All
2023,4,Deoghar Airport,RANCHI,568,437,Deoghar Airport-RANCHI,1005,All
2023,5,Deoghar Airport,RANCHI,685,606,Deoghar Airport-RANCHI,1291,All
2022,9,GAYA,JAIPUR,6,0,GAYA-JAIPUR,6,All
2019,8,GAYA,KOLKATA,1679,1447,GAYA-KOLKATA,3126,All
2019,9,GAYA,KOLKATA,2433,2022,GAYA-KOLKATA,4455,All
2019,10,GAYA,KOLKATA,2393,2660,GAYA-KOLKATA,5053,All
2019,11,GAYA,KOLKATA,3293,3130,GAYA-KOLKATA,6423,All
2019,12,GAYA,KOLKATA,3049,2088,GAYA-KOLKATA,5137,All
2020,1,GAYA,KOLKATA,2373,1793,GAYA-KOLKATA,4166,All
2020,2,GAYA,KOLKATA,3036,2133,GAYA-KOLKATA,5169,All
2020,3,GAYA,KOLKATA,2366,1767,GAYA-KOLKATA,4133,All
2021,8,GAYA,KOLKATA,307,219,GAYA-KOLKATA,526,All
2021,9,GAYA,KOLKATA,111,74,GAYA-KOLKATA,185,All
2021,10,GAYA,KOLKATA,432,443,GAYA-KOLKATA,875,All
2021,11,GAYA,KOLKATA,786,704,GAYA-KOLKATA,1490,All
2021,12,GAYA,KOLKATA,928,599,GAYA-KOLKATA,1527,All
2022,1,GAYA,KOLKATA,572,492,GAYA-KOLKATA,1064,All
2022,2,GAYA,KOLKATA,772,727,GAYA-KOLKATA,1499,All
2022,3,GAYA,KOLKATA,1006,979,GAYA-KOLKATA,1985,All
2022,4,GAYA,KOLKATA,1857,1637,GAYA-KOLKATA,3494,All
2022,5,GAYA,KOLKATA,2631,1997,GAYA-KOLKATA,4628,All
2022,6,GAYA,KOLKATA,1226,1073,GAYA-KOLKATA,2299,All
2022,7,GAYA,KOLKATA,1084,1025,GAYA-KOLKATA,2109,All
2022,8,GAYA,KOLKATA,1122,1111,GAYA-KOLKATA,2233,All
2022,9,GAYA,KOLKATA,1092,1050,GAYA-KOLKATA,2142,All
2022,10,GAYA,KOLKATA,1130,1238,GAYA-KOLKATA,2368,All
2022,11,GAYA,KOLKATA,3249,2237,GAYA-KOLKATA,5486,All
2022,12,GAYA,KOLKATA,2770,2466,GAYA-KOLKATA,5236,All
2023,1,GAYA,KOLKATA,3089,2025,GAYA-KOLKATA,5114,All
2023,2,GAYA,KOLKATA,3715,3489,GAYA-KOLKATA,7204,All
2023,3,GAYA,KOLKATA,4626,3689,GAYA-KOLKATA,8315,All
2023,4,GAYA,KOLKATA,4159,3796,GAYA-KOLKATA,7955,All
2023,5,GAYA,KOLKATA,4035,4304,GAYA-KOLKATA,8339,All
2023,6,GAYA,KOLKATA,4517,3639,GAYA-KOLKATA,8156,All
2023,7,GAYA,KOLKATA,4010,3783,GAYA-KOLKATA,7793,All
2023,8,GAYA,KOLKATA,3177,3434,GAYA-KOLKATA,6611,All
2023,9,GAYA,KOLKATA,3542,4381,GAYA-KOLKATA,7923,All
2023,10,GAYA,KOLKATA,4431,4419,GAYA-KOLKATA,8850,All
2023,11,GAYA,KOLKATA,4039,4502,GAYA-KOLKATA,8541,All
2023,12,GAYA,KOLKATA,4541,3964,GAYA-KOLKATA,8505,All
2024,1,GAYA,KOLKATA,4630,3730,GAYA-KOLKATA,8360,All
2024,2,GAYA,KOLKATA,4027,4387,GAYA-KOLKATA,8414,All
2024,3,GAYA,KOLKATA,4886,4742,GAYA-KOLKATA,9628,All
2024,4,GAYA,KOLKATA,4659,4719,GAYA-KOLKATA,9378,All
2024,6,GAYA,KOLKATA,4607,4170,GAYA-KOLKATA,8777,All
2024,7,GAYA,KOLKATA,4382,4539,GAYA-KOLKATA,8921,All
2024,8,GAYA,KOLKATA,4213,4384,GAYA-KOLKATA,8597,All
2024,9,GAYA,KOLKATA,4562,4615,GAYA-KOLKATA,9177,All
2024,10,GAYA,KOLKATA,3617,4459,GAYA-KOLKATA,8076,All
2024,11,GAYA,KOLKATA,5055,4642,GAYA-KOLKATA,9697,All
2024,12,GAYA,KOLKATA,5355,3908,GAYA-KOLKATA,9263,All
2025,1,GAYA,KOLKATA,4138,4455,GAYA-KOLKATA,8593,All
2025,2,GAYA,KOLKATA,4675,4612,GAYA-KOLKATA,9287,All
2025,3,GAYA,KOLKATA,5035,5020,GAYA-KOLKATA,10055,All
2017,9,GAYA,LUCKNOW,0,4,GAYA-LUCKNOW,4,All
2020,6,GAYA,LUCKNOW,0,68,GAYA-LUCKNOW,68,All
2020,7,GAYA,MUMBAI,0,355,GAYA-MUMBAI,355,All
2020,12,GAYA,MUMBAI,505,139,GAYA-MUMBAI,644,All
2021,1,GAYA,MUMBAI,1390,707,GAYA-MUMBAI,2097,All
2021,2,GAYA,MUMBAI,299,240,GAYA-MUMBAI,539,All
2022,3,GAYA,MUMBAI,79,45,GAYA-MUMBAI,124,All
2022,4,GAYA,MUMBAI,247,236,GAYA-MUMBAI,483,All
2022,5,GAYA,MUMBAI,470,461,GAYA-MUMBAI,931,All
2022,10,GAYA,MUMBAI,0,10,GAYA-MUMBAI,10,All
2022,11,GAYA,MUMBAI,188,279,GAYA-MUMBAI,467,All
2022,12,GAYA,MUMBAI,322,178,GAYA-MUMBAI,500,All
2015,4,GAYA,VARANASI,48,0,GAYA-VARANASI,48,All
2015,5,GAYA,VARANASI,4,0,GAYA-VARANASI,4,All
2015,6,GAYA,VARANASI,1,0,GAYA-VARANASI,1,All
2015,7,GAYA,VARANASI,2,0,GAYA-VARANASI,2,All
2015,8,GAYA,VARANASI,6,0,GAYA-VARANASI,6,All
2015,9,GAYA,VARANASI,15,0,GAYA-VARANASI,15,All
2015,10,GAYA,VARANASI,11715,0,GAYA-VARANASI,11715,All
2015,11,GAYA,VARANASI,241,0,GAYA-VARANASI,241,All
2015,12,GAYA,VARANASI,265,0,GAYA-VARANASI,265,All
2016,1,GAYA,VARANASI,299,0,GAYA-VARANASI,299,All
2016,2,GAYA,VARANASI,366,0,GAYA-VARANASI,366,All
2016,3,GAYA,VARANASI,284,0,GAYA-VARANASI,284,All
2016,4,GAYA,VARANASI,83,0,GAYA-VARANASI,83,All
2016,5,GAYA,VARANASI,75,0,GAYA-VARANASI,75,All
2016,6,GAYA,VARANASI,57,0,GAYA-VARANASI,57,All
2016,7,GAYA,VARANASI,142,0,GAYA-VARANASI,142,All
2016,8,GAYA,VARANASI,91,0,GAYA-VARANASI,91,All
2016,9,GAYA,VARANASI,211,0,GAYA-VARANASI,211,All
2016,10,GAYA,VARANASI,237,0,GAYA-VARANASI,237,All
2016,11,GAYA,VARANASI,73,0,GAYA-VARANASI,73,All
2016,12,GAYA,VARANASI,355,0,GAYA-VARANASI,355,All
2017,1,GAYA,VARANASI,385,0,GAYA-VARANASI,385,All
2017,2,GAYA,VARANASI,562,0,GAYA-VARANASI,562,All
2017,3,GAYA,VARANASI,52,0,GAYA-VARANASI,52,All
2017,4,GAYA,VARANASI,21,0,GAYA-VARANASI,21,All
2017,5,GAYA,VARANASI,22,0,GAYA-VARANASI,22,All
2017,6,GAYA,VARANASI,142,0,GAYA-VARANASI,142,All
2017,7,GAYA,VARANASI,177,0,GAYA-VARANASI,177,All
2017,8,GAYA,VARANASI,200,0,GAYA-VARANASI,200,All
2017,9,GAYA,VARANASI,391,0,GAYA-VARANASI,391,All
2017,10,GAYA,VARANASI,349,0,GAYA-VARANASI,349,All
2017,11,GAYA,VARANASI,275,0,GAYA-VARANASI,275,All
2017,12,GAYA,VARANASI,471,0,GAYA-VARANASI,471,All
2018,1,GAYA,VARANASI,659,0,GAYA-VARANASI,659,All
2018,2,GAYA,VARANASI,507,0,GAYA-VARANASI,507,All
2018,3,GAYA,VARANASI,655,0,GAYA-VARANASI,655,All
2018,4,GAYA,VARANASI,175,0,GAYA-VARANASI,175,All
2018,5,GAYA,VARANASI,166,0,GAYA-VARANASI,166,All
2018,6,GAYA,VARANASI,122,0,GAYA-VARANASI,122,All
2018,7,GAYA,VARANASI,286,0,GAYA-VARANASI,286,All
2018,8,GAYA,VARANASI,202,0,GAYA-VARANASI,202,All
2018,9,GAYA,VARANASI,402,0,GAYA-VARANASI,402,All
2018,10,GAYA,VARANASI,559,0,GAYA-VARANASI,559,All
2018,11,GAYA,VARANASI,591,0,GAYA-VARANASI,591,All
2018,12,GAYA,VARANASI,729,0,GAYA-VARANASI,729,All
2019,1,GAYA,VARANASI,595,0,GAYA-VARANASI,595,All
2019,2,GAYA,VARANASI,669,0,GAYA-VARANASI,669,All
2019,3,GAYA,VARANASI,655,0,GAYA-VARANASI,655,All
2019,4,GAYA,VARANASI,300,0,GAYA-VARANASI,300,All
2019,5,GAYA,VARANASI,145,0,GAYA-VARANASI,145,All
2019,6,GAYA,VARANASI,196,0,GAYA-VARANASI,196,All
2019,7,GAYA,VARANASI,48,0,GAYA-VARANASI,48,All
2019,8,GAYA,VARANASI,568,429,GAYA-VARANASI,997,All
2019,9,GAYA,VARANASI,1058,959,GAYA-VARANASI,2017,All
2019,10,GAYA,VARANASI,989,845,GAYA-VARANASI,1834,All
2019,11,GAYA,VARANASI,1711,1085,GAYA-VARANASI,2796,All
2019,12,GAYA,VARANASI,1723,1131,GAYA-VARANASI,2854,All
2020,1,GAYA,VARANASI,1860,1217,GAYA-VARANASI,3077,All
2020,2,GAYA,VARANASI,2013,1407,GAYA-VARANASI,3420,All
2020,3,GAYA,VARANASI,998,1008,GAYA-VARANASI,2006,All
2021,3,GAYA,VARANASI,2,0,GAYA-VARANASI,2,All
2021,4,GAYA,VARANASI,25,0,GAYA-VARANASI,25,All
2021,10,GAYA,VARANASI,38,0,GAYA-VARANASI,38,All
2020,1,GHAZIABAD,HUBLI,616,628,GHAZIABAD-HUBLI,1244,All
2020,2,GHAZIABAD,HUBLI,748,783,GHAZIABAD-HUBLI,1531,All
2020,8,GHAZIABAD,HUBLI,154,145,GHAZIABAD-HUBLI,299,All
2020,9,GHAZIABAD,HUBLI,397,301,GHAZIABAD-HUBLI,698,All
2020,10,GHAZIABAD,HUBLI,394,381,GHAZIABAD-HUBLI,775,All
2020,11,GHAZIABAD,HUBLI,682,707,GHAZIABAD-HUBLI,1389,All
2020,12,GHAZIABAD,HUBLI,744,668,GHAZIABAD-HUBLI,1412,All
2021,1,GHAZIABAD,HUBLI,766,763,GHAZIABAD-HUBLI,1529,All
2021,2,GHAZIABAD,HUBLI,729,727,GHAZIABAD-HUBLI,1456,All
2021,3,GHAZIABAD,HUBLI,811,808,GHAZIABAD-HUBLI,1619,All
2021,4,GHAZIABAD,HUBLI,705,699,GHAZIABAD-HUBLI,1404,All
2021,6,GHAZIABAD,HUBLI,657,675,GHAZIABAD-HUBLI,1332,All
2021,7,GHAZIABAD,HUBLI,780,801,GHAZIABAD-HUBLI,1581,All
2021,8,GHAZIABAD,HUBLI,808,840,GHAZIABAD-HUBLI,1648,All
2021,9,GHAZIABAD,HUBLI,747,794,GHAZIABAD-HUBLI,1541,All
2021,10,GHAZIABAD,HUBLI,784,779,GHAZIABAD-HUBLI,1563,All
2021,11,GHAZIABAD,HUBLI,759,761,GHAZIABAD-HUBLI,1520,All
2021,12,GHAZIABAD,HUBLI,855,839,GHAZIABAD-HUBLI,1694,All
2022,1,GHAZIABAD,HUBLI,782,767,GHAZIABAD-HUBLI,1549,All
2022,2,GHAZIABAD,HUBLI,737,725,GHAZIABAD-HUBLI,1462,All
2022,3,GHAZIABAD,HUBLI,766,810,GHAZIABAD-HUBLI,1576,All
2022,4,GHAZIABAD,HUBLI,738,733,GHAZIABAD-HUBLI,1471,All
2022,5,GHAZIABAD,HUBLI,822,836,GHAZIABAD-HUBLI,1658,All
2022,6,GHAZIABAD,HUBLI,792,781,GHAZIABAD-HUBLI,1573,All
2022,7,GHAZIABAD,HUBLI,776,758,GHAZIABAD-HUBLI,1534,All
2022,8,GHAZIABAD,HUBLI,794,765,GHAZIABAD-HUBLI,1559,All
2022,9,GHAZIABAD,HUBLI,716,708,GHAZIABAD-HUBLI,1424,All
2022,10,GHAZIABAD,HUBLI,653,721,GHAZIABAD-HUBLI,1374,All
2022,11,GHAZIABAD,HUBLI,649,573,GHAZIABAD-HUBLI,1222,All
2022,12,GHAZIABAD,HUBLI,574,525,GHAZIABAD-HUBLI,1099,All
2023,1,GHAZIABAD,HUBLI,405,341,GHAZIABAD-HUBLI,746,All
2022,11,GHAZIABAD,KALABURAGI,398,386,GHAZIABAD-KALABURAGI,784,All
2023,1,GHAZIABAD,KALABURAGI,43,38,GHAZIABAD-KALABURAGI,81,All
2020,11,GHAZIABAD,"KALABURAGI, KARNATAKA",155,175,"GHAZIABAD-KALABURAGI, KARNATAKA",330,All
2020,12,GHAZIABAD,"KALABURAGI, KARNATAKA",298,252,"GHAZIABAD-KALABURAGI, KARNATAKA",550,All
2021,1,GHAZIABAD,"KALABURAGI, KARNATAKA",329,373,"GHAZIABAD-KALABURAGI, KARNATAKA",702,All
2021,2,GHAZIABAD,"KALABURAGI, KARNATAKA",418,467,"GHAZIABAD-KALABURAGI, KARNATAKA",885,All
2021,3,GHAZIABAD,"KALABURAGI, KARNATAKA",493,537,"GHAZIABAD-KALABURAGI, KARNATAKA",1030,All
2021,4,GHAZIABAD,"KALABURAGI, KARNATAKA",501,436,"GHAZIABAD-KALABURAGI, KARNATAKA",937,All
2021,6,GHAZIABAD,"KALABURAGI, KARNATAKA",211,187,"GHAZIABAD-KALABURAGI, KARNATAKA",398,All
2021,7,GHAZIABAD,"KALABURAGI, KARNATAKA",509,551,"GHAZIABAD-KALABURAGI, KARNATAKA",1060,All
2021,8,GHAZIABAD,"KALABURAGI, KARNATAKA",504,487,"GHAZIABAD-KALABURAGI, KARNATAKA",991,All
2021,9,GHAZIABAD,"KALABURAGI, KARNATAKA",432,473,"GHAZIABAD-KALABURAGI, KARNATAKA",905,All
2021,10,GHAZIABAD,"KALABURAGI, KARNATAKA",436,495,"GHAZIABAD-KALABURAGI, KARNATAKA",931,All
2021,11,GHAZIABAD,"KALABURAGI, KARNATAKA",524,484,"GHAZIABAD-KALABURAGI, KARNATAKA",1008,All
2021,12,GHAZIABAD,"KALABURAGI, KARNATAKA",507,533,"GHAZIABAD-KALABURAGI, KARNATAKA",1040,All
2022,1,GHAZIABAD,"KALABURAGI, KARNATAKA",268,299,"GHAZIABAD-KALABURAGI, KARNATAKA",567,All
2022,2,GHAZIABAD,"KALABURAGI, KARNATAKA",410,468,"GHAZIABAD-KALABURAGI, KARNATAKA",878,All
2022,3,GHAZIABAD,"KALABURAGI, KARNATAKA",562,570,"GHAZIABAD-KALABURAGI, KARNATAKA",1132,All
2022,4,GHAZIABAD,"KALABURAGI, KARNATAKA",490,493,"GHAZIABAD-KALABURAGI, KARNATAKA",983,All
2022,5,GHAZIABAD,"KALABURAGI, KARNATAKA",554,586,"GHAZIABAD-KALABURAGI, KARNATAKA",1140,All
2022,6,GHAZIABAD,"KALABURAGI, KARNATAKA",376,346,"GHAZIABAD-KALABURAGI, KARNATAKA",722,All
2022,7,GHAZIABAD,"KALABURAGI, KARNATAKA",386,390,"GHAZIABAD-KALABURAGI, KARNATAKA",776,All
2022,8,GHAZIABAD,"KALABURAGI, KARNATAKA",298,337,"GHAZIABAD-KALABURAGI, KARNATAKA",635,All
2022,9,GHAZIABAD,"KALABURAGI, KARNATAKA",253,292,"GHAZIABAD-KALABURAGI, KARNATAKA",545,All
2022,10,GHAZIABAD,"KALABURAGI, KARNATAKA",158,176,"GHAZIABAD-KALABURAGI, KARNATAKA",334,All
2022,12,GHAZIABAD,"KALABURAGI, KARNATAKA",313,290,"GHAZIABAD-KALABURAGI, KARNATAKA",603,All
2023,9,GHAZIABAD,LUDHIANA,130,138,GHAZIABAD-LUDHIANA,268,All
2023,10,GHAZIABAD,LUDHIANA,91,123,GHAZIABAD-LUDHIANA,214,All
2023,11,GHAZIABAD,LUDHIANA,70,68,GHAZIABAD-LUDHIANA,138,All
2023,12,GHAZIABAD,LUDHIANA,18,18,GHAZIABAD-LUDHIANA,36,All
2020,1,GHAZIABAD,PITHORAGARH,136,144,GHAZIABAD-PITHORAGARH,280,All
2020,2,GHAZIABAD,PITHORAGARH,120,122,GHAZIABAD-PITHORAGARH,242,All
2017,6,GOA,CHANDIGARH,129,0,CHANDIGARH-GOA,129,All
2017,7,GOA,CHANDIGARH,138,0,CHANDIGARH-GOA,138,All
2017,8,GOA,CHANDIGARH,356,0,CHANDIGARH-GOA,356,All
2017,9,GOA,CHANDIGARH,230,0,CHANDIGARH-GOA,230,All
2017,12,GOA,CHANDIGARH,0,3,CHANDIGARH-GOA,3,All
2018,1,GOA,CHANDIGARH,0,8,CHANDIGARH-GOA,8,All
2018,2,GOA,CHANDIGARH,0,4,CHANDIGARH-GOA,4,All
2018,3,GOA,CHANDIGARH,0,3,CHANDIGARH-GOA,3,All
2015,4,GOA,CHENNAI,5931,4452,CHENNAI-GOA,10383,All
2015,5,GOA,CHENNAI,4284,2696,CHENNAI-GOA,6980,All
2015,6,GOA,CHENNAI,4793,3421,CHENNAI-GOA,8214,All
2015,7,GOA,CHENNAI,5959,5813,CHENNAI-GOA,11772,All
2015,8,GOA,CHENNAI,5655,6214,CHENNAI-GOA,11869,All
2015,9,GOA,CHENNAI,5908,6900,CHENNAI-GOA,12808,All
2015,10,GOA,CHENNAI,8831,5550,CHENNAI-GOA,14381,All
2015,11,GOA,CHENNAI,5977,5677,CHENNAI-GOA,11654,All
2015,12,GOA,CHENNAI,5270,4999,CHENNAI-GOA,10269,All
2016,1,GOA,CHENNAI,7845,7030,CHENNAI-GOA,14875,All
2016,2,GOA,CHENNAI,7010,6356,CHENNAI-GOA,13366,All
2016,3,GOA,CHENNAI,6968,6349,CHENNAI-GOA,13317,All
2016,4,GOA,CHENNAI,6868,6769,CHENNAI-GOA,13637,All
2016,5,GOA,CHENNAI,7344,6756,CHENNAI-GOA,14100,All
2016,6,GOA,CHENNAI,4693,3679,CHENNAI-GOA,8372,All
2016,7,GOA,CHENNAI,6184,5888,CHENNAI-GOA,12072,All
2016,8,GOA,CHENNAI,5811,6016,CHENNAI-GOA,11827,All
2016,9,GOA,CHENNAI,6259,6384,CHENNAI-GOA,12643,All
2016,10,GOA,CHENNAI,6558,6117,CHENNAI-GOA,12675,All
2016,11,GOA,CHENNAI,6186,6300,CHENNAI-GOA,12486,All
2016,12,GOA,CHENNAI,6206,6258,CHENNAI-GOA,12464,All
2017,1,GOA,CHENNAI,6574,6826,CHENNAI-GOA,13400,All
2017,2,GOA,CHENNAI,5588,6801,CHENNAI-GOA,12389,All
2017,3,GOA,CHENNAI,6326,9286,CHENNAI-GOA,15612,All
2017,4,GOA,CHENNAI,10921,13753,CHENNAI-GOA,24674,All
2017,5,GOA,CHENNAI,11972,12069,CHENNAI-GOA,24041,All
2017,6,GOA,CHENNAI,9631,8502,CHENNAI-GOA,18133,All
2017,7,GOA,CHENNAI,10893,9768,CHENNAI-GOA,20661,All
2017,8,GOA,CHENNAI,7445,7572,CHENNAI-GOA,15017,All
2017,9,GOA,CHENNAI,6927,7751,CHENNAI-GOA,14678,All
2017,10,GOA,CHENNAI,7133,7253,CHENNAI-GOA,14386,All
2017,11,GOA,CHENNAI,6729,7396,CHENNAI-GOA,14125,All
2017,12,GOA,CHENNAI,11484,12737,CHENNAI-GOA,24221,All
2018,1,GOA,CHENNAI,13129,12677,CHENNAI-GOA,25806,All
2018,2,GOA,CHENNAI,11322,11273,CHENNAI-GOA,22595,All
2018,3,GOA,CHENNAI,12088,11528,CHENNAI-GOA,23616,All
2018,4,GOA,CHENNAI,11060,11397,CHENNAI-GOA,22457,All
2018,5,GOA,CHENNAI,11862,12525,CHENNAI-GOA,24387,All
2018,6,GOA,CHENNAI,11390,10424,CHENNAI-GOA,21814,All
2018,7,GOA,CHENNAI,12441,11325,CHENNAI-GOA,23766,All
2018,8,GOA,CHENNAI,10776,11126,CHENNAI-GOA,21902,All
2018,9,GOA,CHENNAI,10965,11523,CHENNAI-GOA,22488,All
2018,10,GOA,CHENNAI,15865,15526,CHENNAI-GOA,31391,All
2018,11,GOA,CHENNAI,12786,13104,CHENNAI-GOA,25890,All
2018,12,GOA,CHENNAI,13589,13683,CHENNAI-GOA,27272,All
2018,6,GOA,HUBLI,94,193,GOA-HUBLI,287,All
2018,7,GOA,HUBLI,1216,1375,GOA-HUBLI,2591,All
2018,8,GOA,HUBLI,506,788,GOA-HUBLI,1294,All
2018,9,GOA,HUBLI,1151,1435,GOA-HUBLI,2586,All
2018,10,GOA,HUBLI,1678,1787,GOA-HUBLI,3465,All
2018,11,GOA,HUBLI,1397,1889,GOA-HUBLI,3286,All
2018,12,GOA,HUBLI,1568,1841,GOA-HUBLI,3409,All
2015,4,GOA,HYDERABAD,6071,6190,GOA-HYDERABAD,12261,All
2015,5,GOA,HYDERABAD,6532,6592,GOA-HYDERABAD,13124,All
2015,6,GOA,HYDERABAD,6608,6343,GOA-HYDERABAD,12951,All
2015,7,GOA,HYDERABAD,7208,6980,GOA-HYDERABAD,14188,All
2015,8,GOA,HYDERABAD,7191,7100,GOA-HYDERABAD,14291,All
2015,9,GOA,HYDERABAD,6629,6653,GOA-HYDERABAD,13282,All
2015,10,GOA,HYDERABAD,7652,9482,GOA-HYDERABAD,17134,All
2015,11,GOA,HYDERABAD,6004,6037,GOA-HYDERABAD,12041,All
2015,12,GOA,HYDERABAD,7973,8358,GOA-HYDERABAD,16331,All
2016,1,GOA,HYDERABAD,7758,7605,GOA-HYDERABAD,15363,All
2016,2,GOA,HYDERABAD,7113,7124,GOA-HYDERABAD,14237,All
2016,3,GOA,HYDERABAD,7442,7715,GOA-HYDERABAD,15157,All
2016,4,GOA,HYDERABAD,7366,7355,GOA-HYDERABAD,14721,All
2016,5,GOA,HYDERABAD,8806,9252,GOA-HYDERABAD,18058,All
2016,6,GOA,HYDERABAD,9347,8552,GOA-HYDERABAD,17899,All
2016,7,GOA,HYDERABAD,11985,11740,GOA-HYDERABAD,23725,All
2016,8,GOA,HYDERABAD,12420,11806,GOA-HYDERABAD,24226,All
2016,9,GOA,HYDERABAD,12762,12536,GOA-HYDERABAD,25298,All
2016,10,GOA,HYDERABAD,17355,16208,GOA-HYDERABAD,33563,All
2016,11,GOA,HYDERABAD,16479,17168,GOA-HYDERABAD,33647,All
2016,12,GOA,HYDERABAD,17435,17461,GOA-HYDERABAD,34896,All
2017,1,GOA,HYDERABAD,23288,20214,GOA-HYDERABAD,43502,All
2017,2,GOA,HYDERABAD,24352,22110,GOA-HYDERABAD,46462,All
2017,3,GOA,HYDERABAD,26597,23211,GOA-HYDERABAD,49808,All
2017,4,GOA,HYDERABAD,23085,21278,GOA-HYDERABAD,44363,All
2017,5,GOA,HYDERABAD,24171,22627,GOA-HYDERABAD,46798,All
2017,6,GOA,HYDERABAD,22437,19927,GOA-HYDERABAD,42364,All
2017,7,GOA,HYDERABAD,22565,20555,GOA-HYDERABAD,43120,All
2017,8,GOA,HYDERABAD,17788,17013,GOA-HYDERABAD,34801,All
2017,9,GOA,HYDERABAD,16787,17112,GOA-HYDERABAD,33899,All
2017,10,GOA,HYDERABAD,20392,19387,GOA-HYDERABAD,39779,All
2017,11,GOA,HYDERABAD,21282,21227,GOA-HYDERABAD,42509,All
2017,12,GOA,HYDERABAD,22832,23555,GOA-HYDERABAD,46387,All
2018,1,GOA,HYDERABAD,23982,22947,GOA-HYDERABAD,46929,All
2018,2,GOA,HYDERABAD,21883,21386,GOA-HYDERABAD,43269,All
2018,3,GOA,HYDERABAD,23291,22480,GOA-HYDERABAD,45771,All
2018,4,GOA,HYDERABAD,25430,24779,GOA-HYDERABAD,50209,All
2018,5,GOA,HYDERABAD,26894,26957,GOA-HYDERABAD,53851,All
2018,6,GOA,HYDERABAD,27149,26250,GOA-HYDERABAD,53399,All
2018,7,GOA,HYDERABAD,26474,25495,GOA-HYDERABAD,51969,All
2018,8,GOA,HYDERABAD,25563,25404,GOA-HYDERABAD,50967,All
2018,9,GOA,HYDERABAD,28990,29588,GOA-HYDERABAD,58578,All
2018,10,GOA,HYDERABAD,34648,33290,GOA-HYDERABAD,67938,All
2018,11,GOA,HYDERABAD,32160,32154,GOA-HYDERABAD,64314,All
2018,12,GOA,HYDERABAD,33196,35124,GOA-HYDERABAD,68320,All
2018,2,GOA,IMPHAL,0,13,GOA-IMPHAL,13,All
2018,3,GOA,IMPHAL,0,42,GOA-IMPHAL,42,All
2018,4,GOA,IMPHAL,0,20,GOA-IMPHAL,20,All
2018,5,GOA,IMPHAL,0,28,GOA-IMPHAL,28,All
2018,6,GOA,IMPHAL,0,2,GOA-IMPHAL,2,All
2018,7,GOA,IMPHAL,0,5,GOA-IMPHAL,5,All
2018,8,GOA,IMPHAL,0,20,GOA-IMPHAL,20,All
2018,9,GOA,IMPHAL,0,20,GOA-IMPHAL,20,All
2018,10,GOA,IMPHAL,0,37,GOA-IMPHAL,37,All
2018,11,GOA,IMPHAL,0,12,GOA-IMPHAL,12,All
2018,12,GOA,IMPHAL,0,7,GOA-IMPHAL,7,All
2015,4,GOA,INDORE,727,278,GOA-INDORE,1005,All
2015,5,GOA,INDORE,468,0,GOA-INDORE,468,All
2015,6,GOA,INDORE,941,617,GOA-INDORE,1558,All
2015,7,GOA,INDORE,1148,1198,GOA-INDORE,2346,All
2015,8,GOA,INDORE,977,1047,GOA-INDORE,2024,All
2015,9,GOA,INDORE,991,875,GOA-INDORE,1866,All
2015,10,GOA,INDORE,1061,1010,GOA-INDORE,2071,All
2015,11,GOA,INDORE,579,517,GOA-INDORE,1096,All
2015,12,GOA,INDORE,932,648,GOA-INDORE,1580,All
2016,1,GOA,INDORE,768,604,GOA-INDORE,1372,All
2016,2,GOA,INDORE,525,545,GOA-INDORE,1070,All
2016,3,GOA,INDORE,809,729,GOA-INDORE,1538,All
2016,4,GOA,INDORE,1958,1796,GOA-INDORE,3754,All
2016,5,GOA,INDORE,3906,4048,GOA-INDORE,7954,All
2016,6,GOA,INDORE,3826,3615,GOA-INDORE,7441,All
2016,7,GOA,INDORE,3434,3404,GOA-INDORE,6838,All
2016,8,GOA,INDORE,3552,3494,GOA-INDORE,7046,All
2016,9,GOA,INDORE,2574,2022,GOA-INDORE,4596,All
2016,10,GOA,INDORE,3520,3134,GOA-INDORE,6654,All
2016,11,GOA,INDORE,3803,4156,GOA-INDORE,7959,All
2016,12,GOA,INDORE,3986,4175,GOA-INDORE,8161,All
2017,1,GOA,INDORE,4080,4169,GOA-INDORE,8249,All
2017,2,GOA,INDORE,3686,3908,GOA-INDORE,7594,All
2017,3,GOA,INDORE,3475,4161,GOA-INDORE,7636,All
2017,4,GOA,INDORE,3259,3694,GOA-INDORE,6953,All
2017,5,GOA,INDORE,3322,4002,GOA-INDORE,7324,All
2017,6,GOA,INDORE,3923,3989,GOA-INDORE,7912,All
2017,7,GOA,INDORE,4357,4360,GOA-INDORE,8717,All
2017,8,GOA,INDORE,4314,4216,GOA-INDORE,8530,All
2017,9,GOA,INDORE,3795,3898,GOA-INDORE,7693,All
2017,10,GOA,INDORE,4511,3914,GOA-INDORE,8425,All
2017,11,GOA,INDORE,4258,4263,GOA-INDORE,8521,All
2017,12,GOA,INDORE,4378,4232,GOA-INDORE,8610,All
2018,1,GOA,INDORE,4492,4355,GOA-INDORE,8847,All
2018,2,GOA,INDORE,4323,4204,GOA-INDORE,8527,All
2018,3,GOA,INDORE,6261,7036,GOA-INDORE,13297,All
2018,4,GOA,INDORE,8333,8277,GOA-INDORE,16610,All
2018,5,GOA,INDORE,8475,9536,GOA-INDORE,18011,All
2018,6,GOA,INDORE,19349,8207,GOA-INDORE,27556,All
2018,7,GOA,INDORE,19799,5694,GOA-INDORE,25493,All
2018,8,GOA,INDORE,8162,8407,GOA-INDORE,16569,All
2018,9,GOA,INDORE,8709,9301,GOA-INDORE,18010,All
2018,10,GOA,INDORE,8640,8841,GOA-INDORE,17481,All
2018,11,GOA,INDORE,8567,8928,GOA-INDORE,17495,All
2018,12,GOA,INDORE,8996,9393,GOA-INDORE,18389,All
2015,4,GOA,JAIPUR,0,208,GOA-JAIPUR,208,All
2015,5,GOA,JAIPUR,0,218,GOA-JAIPUR,218,All
2015,6,GOA,JAIPUR,0,159,GOA-JAIPUR,159,All
2016,11,GOA,JAIPUR,0,102,GOA-JAIPUR,102,All
2017,3,GOA,JAIPUR,0,85,GOA-JAIPUR,85,All
2017,4,GOA,JAIPUR,0,344,GOA-JAIPUR,344,All
2017,5,GOA,JAIPUR,0,285,GOA-JAIPUR,285,All
2017,6,GOA,JAIPUR,284,945,GOA-JAIPUR,1229,All
2017,7,GOA,JAIPUR,426,681,GOA-JAIPUR,1107,All
2017,8,GOA,JAIPUR,468,452,GOA-JAIPUR,920,All
2017,9,GOA,JAIPUR,270,327,GOA-JAIPUR,597,All
2017,10,GOA,JAIPUR,277,206,GOA-JAIPUR,483,All
2017,11,GOA,JAIPUR,268,366,GOA-JAIPUR,634,All
2017,12,GOA,JAIPUR,302,332,GOA-JAIPUR,634,All
2018,1,GOA,JAIPUR,321,347,GOA-JAIPUR,668,All
2018,2,GOA,JAIPUR,229,204,GOA-JAIPUR,433,All
2018,3,GOA,JAIPUR,329,0,GOA-JAIPUR,329,All
2018,4,GOA,JAIPUR,123,42,GOA-JAIPUR,165,All
2018,5,GOA,JAIPUR,294,67,GOA-JAIPUR,361,All
2018,6,GOA,JAIPUR,79,381,GOA-JAIPUR,460,All
2018,7,GOA,JAIPUR,65,489,GOA-JAIPUR,554,All
2018,8,GOA,JAIPUR,175,376,GOA-JAIPUR,551,All
2018,9,GOA,JAIPUR,296,390,GOA-JAIPUR,686,All
2018,10,GOA,JAIPUR,395,879,GOA-JAIPUR,1274,All
2018,11,GOA,JAIPUR,498,847,GOA-JAIPUR,1345,All
2018,12,GOA,JAIPUR,1096,304,GOA-JAIPUR,1400,All
2017,9,GOA,JAMMU,0,47,GOA-JAMMU,47,All
2017,10,GOA,JAMMU,0,33,GOA-JAMMU,33,All
2017,11,GOA,JAMMU,0,34,GOA-JAMMU,34,All
2017,12,GOA,JAMMU,0,35,GOA-JAMMU,35,All
2018,11,GOA,JAMMU,0,44,GOA-JAMMU,44,All
2017,12,GOA,JODHPUR,62,286,GOA-JODHPUR,348,All
2018,1,GOA,JODHPUR,16,188,GOA-JODHPUR,204,All
2018,2,GOA,JODHPUR,0,51,GOA-JODHPUR,51,All
2015,4,GOA,LUCKNOW,167,160,GOA-LUCKNOW,327,All
2015,6,GOA,LUCKNOW,40,94,GOA-LUCKNOW,134,All
2015,7,GOA,LUCKNOW,73,70,GOA-LUCKNOW,143,All
2015,8,GOA,LUCKNOW,80,107,GOA-LUCKNOW,187,All
2015,9,GOA,LUCKNOW,52,49,GOA-LUCKNOW,101,All
2015,10,GOA,LUCKNOW,59,26,GOA-LUCKNOW,85,All
2015,11,GOA,LUCKNOW,76,80,GOA-LUCKNOW,156,All
2015,12,GOA,LUCKNOW,229,275,GOA-LUCKNOW,504,All
2016,1,GOA,LUCKNOW,474,151,GOA-LUCKNOW,625,All
2016,2,GOA,LUCKNOW,119,60,GOA-LUCKNOW,179,All
2016,3,GOA,LUCKNOW,123,242,GOA-LUCKNOW,365,All
2016,4,GOA,LUCKNOW,220,132,GOA-LUCKNOW,352,All
2016,5,GOA,LUCKNOW,206,168,GOA-LUCKNOW,374,All
2016,6,GOA,LUCKNOW,83,39,GOA-LUCKNOW,122,All
2016,7,GOA,LUCKNOW,21,16,GOA-LUCKNOW,37,All
2016,8,GOA,LUCKNOW,49,54,GOA-LUCKNOW,103,All
2016,9,GOA,LUCKNOW,3,1,GOA-LUCKNOW,4,All
2016,10,GOA,LUCKNOW,1,2,GOA-LUCKNOW,3,All
2016,11,GOA,LUCKNOW,43,36,GOA-LUCKNOW,79,All
2016,12,GOA,LUCKNOW,417,1211,GOA-LUCKNOW,1628,All
2017,1,GOA,LUCKNOW,912,1061,GOA-LUCKNOW,1973,All
2017,2,GOA,LUCKNOW,530,530,GOA-LUCKNOW,1060,All
2017,3,GOA,LUCKNOW,229,216,GOA-LUCKNOW,445,All
2017,12,GOA,LUCKNOW,0,959,GOA-LUCKNOW,959,All
2018,1,GOA,LUCKNOW,0,386,GOA-LUCKNOW,386,All
2018,2,GOA,LUCKNOW,0,150,GOA-LUCKNOW,150,All
2018,3,GOA,LUCKNOW,3952,4243,GOA-LUCKNOW,8195,All
2018,4,GOA,LUCKNOW,2080,1782,GOA-LUCKNOW,3862,All
2018,7,GOA,LUCKNOW,1361,1172,GOA-LUCKNOW,2533,All
2018,8,GOA,LUCKNOW,3503,3105,GOA-LUCKNOW,6608,All
2018,9,GOA,LUCKNOW,3449,3265,GOA-LUCKNOW,6714,All
2018,10,GOA,LUCKNOW,4179,3334,GOA-LUCKNOW,7513,All
2018,11,GOA,LUCKNOW,3875,4062,GOA-LUCKNOW,7937,All
2018,12,GOA,LUCKNOW,5126,4906,GOA-LUCKNOW,10032,All
2016,4,GOA,MADURAI,20,4,GOA-MADURAI,24,All
2016,5,GOA,MADURAI,28,4,GOA-MADURAI,32,All
2016,6,GOA,MADURAI,34,21,GOA-MADURAI,55,All
2016,7,GOA,MADURAI,29,36,GOA-MADURAI,65,All
2016,8,GOA,MADURAI,18,19,GOA-MADURAI,37,All
2016,9,GOA,MADURAI,20,12,GOA-MADURAI,32,All
2016,10,GOA,MADURAI,5,9,GOA-MADURAI,14,All
2017,3,GOA,MADURAI,14,0,GOA-MADURAI,14,All
2017,4,GOA,MADURAI,266,0,GOA-MADURAI,266,All
2017,5,GOA,MADURAI,477,0,GOA-MADURAI,477,All
2017,6,GOA,MADURAI,146,0,GOA-MADURAI,146,All
2017,7,GOA,MADURAI,256,0,GOA-MADURAI,256,All
2017,10,GOA,MADURAI,7,0,GOA-MADURAI,7,All
2017,11,GOA,MADURAI,194,0,GOA-MADURAI,194,All
2017,12,GOA,MADURAI,267,0,GOA-MADURAI,267,All
2018,1,GOA,MADURAI,281,0,GOA-MADURAI,281,All
2018,2,GOA,MADURAI,268,0,GOA-MADURAI,268,All
2018,3,GOA,MADURAI,158,0,GOA-MADURAI,158,All
2018,4,GOA,MADURAI,94,0,GOA-MADURAI,94,All
2018,5,GOA,MADURAI,280,0,GOA-MADURAI,280,All
2018,6,GOA,MADURAI,126,0,GOA-MADURAI,126,All
2018,7,GOA,MADURAI,56,0,GOA-MADURAI,56,All
2018,8,GOA,MADURAI,139,0,GOA-MADURAI,139,All
2018,9,GOA,MADURAI,60,0,GOA-MADURAI,60,All
2017,12,GOA,NAGPUR,0,294,GOA-NAGPUR,294,All
2018,1,GOA,NAGPUR,0,526,GOA-NAGPUR,526,All
2018,2,GOA,NAGPUR,0,257,GOA-NAGPUR,257,All
2015,4,GOA,PATNA,202,283,GOA-PATNA,485,All
2015,6,GOA,PATNA,175,265,GOA-PATNA,440,All
2015,7,GOA,PATNA,473,791,GOA-PATNA,1264,All
2015,8,GOA,PATNA,575,673,GOA-PATNA,1248,All
2015,9,GOA,PATNA,475,659,GOA-PATNA,1134,All
2015,10,GOA,PATNA,491,493,GOA-PATNA,984,All
2015,11,GOA,PATNA,567,501,GOA-PATNA,1068,All
2015,12,GOA,PATNA,576,0,GOA-PATNA,576,All
2016,1,GOA,PATNA,569,0,GOA-PATNA,569,All
2016,2,GOA,PATNA,637,473,GOA-PATNA,1110,All
2016,3,GOA,PATNA,815,912,GOA-PATNA,1727,All
2016,4,GOA,PATNA,785,591,GOA-PATNA,1376,All
2016,5,GOA,PATNA,552,486,GOA-PATNA,1038,All
2016,6,GOA,PATNA,490,472,GOA-PATNA,962,All
2016,7,GOA,PATNA,494,503,GOA-PATNA,997,All
2016,8,GOA,PATNA,518,440,GOA-PATNA,958,All
2016,9,GOA,PATNA,380,378,GOA-PATNA,758,All
2016,10,GOA,PATNA,416,319,GOA-PATNA,735,All
2016,11,GOA,PATNA,774,852,GOA-PATNA,1626,All
2017,2,GOA,PATNA,585,466,GOA-PATNA,1051,All
2017,3,GOA,PATNA,1300,859,GOA-PATNA,2159,All
2017,4,GOA,PATNA,0,483,GOA-PATNA,483,All
2017,5,GOA,PATNA,0,432,GOA-PATNA,432,All
2017,6,GOA,PATNA,0,615,GOA-PATNA,615,All
2017,7,GOA,PATNA,657,713,GOA-PATNA,1370,All
2017,8,GOA,PATNA,477,491,GOA-PATNA,968,All
2017,9,GOA,PATNA,506,365,GOA-PATNA,871,All
2017,10,GOA,PATNA,0,429,GOA-PATNA,429,All
2017,11,GOA,PATNA,0,962,GOA-PATNA,962,All
2017,12,GOA,PATNA,839,1117,GOA-PATNA,1956,All
2018,1,GOA,PATNA,608,963,GOA-PATNA,1571,All
2018,2,GOA,PATNA,707,982,GOA-PATNA,1689,All
2018,3,GOA,PATNA,0,878,GOA-PATNA,878,All
2018,4,GOA,PATNA,0,674,GOA-PATNA,674,All
2018,5,GOA,PATNA,0,620,GOA-PATNA,620,All
2018,6,GOA,PATNA,0,361,GOA-PATNA,361,All
2018,7,GOA,PATNA,645,533,GOA-PATNA,1178,All
2018,8,GOA,PATNA,436,624,GOA-PATNA,1060,All
2018,9,GOA,PATNA,535,556,GOA-PATNA,1091,All
2018,10,GOA,PATNA,279,430,GOA-PATNA,709,All
2018,11,GOA,PATNA,521,682,GOA-PATNA,1203,All
2018,12,GOA,PATNA,642,617,GOA-PATNA,1259,All
2015,4,GOA,PUNE,3516,3297,GOA-PUNE,6813,All
2015,5,GOA,PUNE,3547,3487,GOA-PUNE,7034,All
2015,6,GOA,PUNE,3295,3150,GOA-PUNE,6445,All
2015,7,GOA,PUNE,3322,3279,GOA-PUNE,6601,All
2015,8,GOA,PUNE,3023,3266,GOA-PUNE,6289,All
2015,9,GOA,PUNE,2865,3037,GOA-PUNE,5902,All
2015,10,GOA,PUNE,1538,12366,GOA-PUNE,13904,All
2015,11,GOA,PUNE,3508,3657,GOA-PUNE,7165,All
2015,12,GOA,PUNE,3591,3521,GOA-PUNE,7112,All
2016,1,GOA,PUNE,3506,3583,GOA-PUNE,7089,All
2016,2,GOA,PUNE,3503,3509,GOA-PUNE,7012,All
2016,3,GOA,PUNE,3745,3841,GOA-PUNE,7586,All
2016,4,GOA,PUNE,4200,4345,GOA-PUNE,8545,All
2016,5,GOA,PUNE,6767,6897,GOA-PUNE,13664,All
2016,6,GOA,PUNE,6537,6401,GOA-PUNE,12938,All
2016,7,GOA,PUNE,6520,6679,GOA-PUNE,13199,All
2016,8,GOA,PUNE,6882,6901,GOA-PUNE,13783,All
2016,9,GOA,PUNE,6381,6357,GOA-PUNE,12738,All
2016,10,GOA,PUNE,5735,5917,GOA-PUNE,11652,All
2016,11,GOA,PUNE,7257,7126,GOA-PUNE,14383,All
2016,12,GOA,PUNE,6863,7032,GOA-PUNE,13895,All
2017,1,GOA,PUNE,7169,7475,GOA-PUNE,14644,All
2017,2,GOA,PUNE,6484,6638,GOA-PUNE,13122,All
2017,3,GOA,PUNE,6936,6786,GOA-PUNE,13722,All
2017,4,GOA,PUNE,6178,6456,GOA-PUNE,12634,All
2017,5,GOA,PUNE,7086,7241,GOA-PUNE,14327,All
2017,6,GOA,PUNE,6663,6470,GOA-PUNE,13133,All
2017,7,GOA,PUNE,6648,6802,GOA-PUNE,13450,All
2017,8,GOA,PUNE,7101,7093,GOA-PUNE,14194,All
2017,9,GOA,PUNE,6473,6474,GOA-PUNE,12947,All
2017,10,GOA,PUNE,6817,6876,GOA-PUNE,13693,All
2017,11,GOA,PUNE,5190,5287,GOA-PUNE,10477,All
2017,12,GOA,PUNE,5077,5050,GOA-PUNE,10127,All
2018,1,GOA,PUNE,7593,6758,GOA-PUNE,14351,All
2018,2,GOA,PUNE,5953,5978,GOA-PUNE,11931,All
2018,3,GOA,PUNE,4936,4890,GOA-PUNE,9826,All
2018,4,GOA,PUNE,6903,6230,GOA-PUNE,13133,All
2018,5,GOA,PUNE,6424,6500,GOA-PUNE,12924,All
2018,6,GOA,PUNE,5756,5758,GOA-PUNE,11514,All
2018,7,GOA,PUNE,6421,6132,GOA-PUNE,12553,All
2018,8,GOA,PUNE,6332,6512,GOA-PUNE,12844,All
2018,9,GOA,PUNE,8005,7561,GOA-PUNE,15566,All
2018,10,GOA,PUNE,9310,8326,GOA-PUNE,17636,All
2018,11,GOA,PUNE,11733,9305,GOA-PUNE,21038,All
2018,12,GOA,PUNE,11933,9174,GOA-PUNE,21107,All
2016,4,GOA,RAIPUR,242,257,GOA-RAIPUR,499,All
2016,5,GOA,RAIPUR,359,482,GOA-RAIPUR,841,All
2016,6,GOA,RAIPUR,869,978,GOA-RAIPUR,1847,All
2016,7,GOA,RAIPUR,1262,1295,GOA-RAIPUR,2557,All
2016,8,GOA,RAIPUR,1189,1117,GOA-RAIPUR,2306,All
2016,9,GOA,RAIPUR,581,635,GOA-RAIPUR,1216,All
2016,10,GOA,RAIPUR,977,887,GOA-RAIPUR,1864,All
2016,11,GOA,RAIPUR,798,958,GOA-RAIPUR,1756,All
2016,12,GOA,RAIPUR,1063,1097,GOA-RAIPUR,2160,All
2017,1,GOA,RAIPUR,923,884,GOA-RAIPUR,1807,All
2017,2,GOA,RAIPUR,664,553,GOA-RAIPUR,1217,All
2017,3,GOA,RAIPUR,840,665,GOA-RAIPUR,1505,All
2017,4,GOA,RAIPUR,622,811,GOA-RAIPUR,1433,All
2017,5,GOA,RAIPUR,615,1025,GOA-RAIPUR,1640,All
2017,6,GOA,RAIPUR,1026,1020,GOA-RAIPUR,2046,All
2017,7,GOA,RAIPUR,760,736,GOA-RAIPUR,1496,All
2017,8,GOA,RAIPUR,982,706,GOA-RAIPUR,1688,All
2017,9,GOA,RAIPUR,920,701,GOA-RAIPUR,1621,All
2017,10,GOA,RAIPUR,908,835,GOA-RAIPUR,1743,All
2017,11,GOA,RAIPUR,1023,850,GOA-RAIPUR,1873,All
2017,12,GOA,RAIPUR,1053,999,GOA-RAIPUR,2052,All
2018,1,GOA,RAIPUR,934,864,GOA-RAIPUR,1798,All
2018,2,GOA,RAIPUR,726,519,GOA-RAIPUR,1245,All
2018,3,GOA,RAIPUR,768,546,GOA-RAIPUR,1314,All
2018,4,GOA,RAIPUR,916,688,GOA-RAIPUR,1604,All
2018,5,GOA,RAIPUR,947,906,GOA-RAIPUR,1853,All
2018,6,GOA,RAIPUR,1115,746,GOA-RAIPUR,1861,All
2018,7,GOA,RAIPUR,461,461,GOA-RAIPUR,922,All
2018,8,GOA,RAIPUR,803,674,GOA-RAIPUR,1477,All
2018,9,GOA,RAIPUR,812,690,GOA-RAIPUR,1502,All
2018,10,GOA,RAIPUR,1127,923,GOA-RAIPUR,2050,All
2018,11,GOA,RAIPUR,792,848,GOA-RAIPUR,1640,All
2018,12,GOA,RAIPUR,1371,950,GOA-RAIPUR,2321,All
2018,4,GOA,RANCHI,11,0,GOA-RANCHI,11,All
2018,5,GOA,RANCHI,2,0,GOA-RANCHI,2,All
2018,7,GOA,RANCHI,5,0,GOA-RANCHI,5,All
2015,4,GOA,SRINAGAR,273,91,GOA-SRINAGAR,364,All
2015,5,GOA,SRINAGAR,134,0,GOA-SRINAGAR,134,All
2015,6,GOA,SRINAGAR,112,52,GOA-SRINAGAR,164,All
2015,7,GOA,SRINAGAR,273,210,GOA-SRINAGAR,483,All
2015,8,GOA,SRINAGAR,110,161,GOA-SRINAGAR,271,All
2015,9,GOA,SRINAGAR,155,181,GOA-SRINAGAR,336,All
2015,10,GOA,SRINAGAR,10316,0,GOA-SRINAGAR,10316,All
2017,3,GOA,SRINAGAR,0,3,GOA-SRINAGAR,3,All
2017,4,GOA,SRINAGAR,0,151,GOA-SRINAGAR,151,All
2017,5,GOA,SRINAGAR,0,271,GOA-SRINAGAR,271,All
2017,6,GOA,SRINAGAR,0,104,GOA-SRINAGAR,104,All
2017,7,GOA,SRINAGAR,0,11,GOA-SRINAGAR,11,All
2017,9,GOA,SRINAGAR,0,6,GOA-SRINAGAR,6,All
2017,10,GOA,SRINAGAR,0,11,GOA-SRINAGAR,11,All
2017,11,GOA,SRINAGAR,0,113,GOA-SRINAGAR,113,All
2017,12,GOA,SRINAGAR,0,138,GOA-SRINAGAR,138,All
2018,2,GOA,SRINAGAR,0,46,GOA-SRINAGAR,46,All
2017,6,GOA,SURAT,1968,2223,GOA-SURAT,4191,All
2017,7,GOA,SURAT,1988,2291,GOA-SURAT,4279,All
2017,8,GOA,SURAT,1936,2186,GOA-SURAT,4122,All
2017,9,GOA,SURAT,1981,2082,GOA-SURAT,4063,All
2017,10,GOA,SURAT,1912,2215,GOA-SURAT,4127,All
2017,11,GOA,SURAT,1840,2175,GOA-SURAT,4015,All
2017,12,GOA,SURAT,2683,3218,GOA-SURAT,5901,All
2018,1,GOA,SURAT,3273,3590,GOA-SURAT,6863,All
2018,2,GOA,SURAT,3201,3304,GOA-SURAT,6505,All
2018,3,GOA,SURAT,3034,3527,GOA-SURAT,6561,All
2018,4,GOA,SURAT,1993,2316,GOA-SURAT,4309,All
2018,5,GOA,SURAT,2085,2406,GOA-SURAT,4491,All
2018,6,GOA,SURAT,2088,2324,GOA-SURAT,4412,All
2018,7,GOA,SURAT,2141,2397,GOA-SURAT,4538,All
2018,8,GOA,SURAT,3050,3323,GOA-SURAT,6373,All
2018,9,GOA,SURAT,4669,4883,GOA-SURAT,9552,All
2018,10,GOA,SURAT,2148,2253,GOA-SURAT,4401,All
2018,11,GOA,SURAT,5827,6305,GOA-SURAT,12132,All
2018,12,GOA,SURAT,6384,7052,GOA-SURAT,13436,All
2015,8,GOA,TIRUPATI,5,0,GOA-TIRUPATI,5,All
2015,9,GOA,TIRUPATI,8,0,GOA-TIRUPATI,8,All
2015,10,GOA,TIRUPATI,27,0,GOA-TIRUPATI,27,All
2015,11,GOA,TIRUPATI,23,0,GOA-TIRUPATI,23,All
2015,12,GOA,TIRUPATI,9,0,GOA-TIRUPATI,9,All
2016,1,GOA,TIRUPATI,26,0,GOA-TIRUPATI,26,All
2016,2,GOA,TIRUPATI,14,0,GOA-TIRUPATI,14,All
2016,3,GOA,TIRUPATI,45,0,GOA-TIRUPATI,45,All
2016,4,GOA,TIRUPATI,11,0,GOA-TIRUPATI,11,All
2017,6,GOA,TIRUPATI,0,69,GOA-TIRUPATI,69,All
2017,7,GOA,TIRUPATI,0,99,GOA-TIRUPATI,99,All
2017,8,GOA,TIRUPATI,0,136,GOA-TIRUPATI,136,All
2017,9,GOA,TIRUPATI,0,111,GOA-TIRUPATI,111,All
2017,10,GOA,TIRUPATI,0,59,GOA-TIRUPATI,59,All
2017,11,GOA,TIRUPATI,0,22,GOA-TIRUPATI,22,All
2017,12,GOA,TIRUPATI,0,8,GOA-TIRUPATI,8,All
2018,1,GOA,TIRUPATI,0,7,GOA-TIRUPATI,7,All
2018,2,GOA,TIRUPATI,0,13,GOA-TIRUPATI,13,All
2018,3,GOA,TIRUPATI,0,32,GOA-TIRUPATI,32,All
2018,4,GOA,TIRUPATI,0,51,GOA-TIRUPATI,51,All
2018,5,GOA,TIRUPATI,0,73,GOA-TIRUPATI,73,All
2018,6,GOA,TIRUPATI,0,79,GOA-TIRUPATI,79,All
2018,8,GOA,TIRUPATI,0,53,GOA-TIRUPATI,53,All
2018,9,GOA,TIRUPATI,0,81,GOA-TIRUPATI,81,All
2018,10,GOA,TIRUPATI,0,90,GOA-TIRUPATI,90,All
2018,11,GOA,TIRUPATI,0,5,GOA-TIRUPATI,5,All
2017,12,GOA,TRIVANDRUM,0,95,GOA-TRIVANDRUM,95,All
2018,1,GOA,TRIVANDRUM,0,243,GOA-TRIVANDRUM,243,All
2018,2,GOA,TRIVANDRUM,0,263,GOA-TRIVANDRUM,263,All
2018,3,GOA,TRIVANDRUM,0,26,GOA-TRIVANDRUM,26,All
2018,4,GOA,TRIVANDRUM,0,192,GOA-TRIVANDRUM,192,All
2018,5,GOA,TRIVANDRUM,0,280,GOA-TRIVANDRUM,280,All
2018,6,GOA,TRIVANDRUM,0,154,GOA-TRIVANDRUM,154,All
2018,7,GOA,TRIVANDRUM,0,183,GOA-TRIVANDRUM,183,All
2018,8,GOA,TRIVANDRUM,0,298,GOA-TRIVANDRUM,298,All
2018,9,GOA,TRIVANDRUM,0,234,GOA-TRIVANDRUM,234,All
2018,10,GOA,TRIVANDRUM,0,151,GOA-TRIVANDRUM,151,All
2018,11,GOA,TRIVANDRUM,0,184,GOA-TRIVANDRUM,184,All
2018,12,GOA,TRIVANDRUM,0,105,GOA-TRIVANDRUM,105,All
2017,3,GOA,UDAIPUR,0,94,GOA-UDAIPUR,94,All
2015,9,GOA,VARANASI,719,849,GOA-VARANASI,1568,All
2015,10,GOA,VARANASI,723,675,GOA-VARANASI,1398,All
2015,11,GOA,VARANASI,221,329,GOA-VARANASI,550,All
2015,12,GOA,VARANASI,86,118,GOA-VARANASI,204,All
2016,3,GOA,VARANASI,974,908,GOA-VARANASI,1882,All
2016,4,GOA,VARANASI,530,573,GOA-VARANASI,1103,All
2016,5,GOA,VARANASI,392,575,GOA-VARANASI,967,All
2016,6,GOA,VARANASI,745,718,GOA-VARANASI,1463,All
2016,7,GOA,VARANASI,663,634,GOA-VARANASI,1297,All
2016,8,GOA,VARANASI,413,404,GOA-VARANASI,817,All
2016,9,GOA,VARANASI,353,338,GOA-VARANASI,691,All
2016,10,GOA,VARANASI,598,552,GOA-VARANASI,1150,All
2016,11,GOA,VARANASI,302,657,GOA-VARANASI,959,All
2016,12,GOA,VARANASI,0,415,GOA-VARANASI,415,All
2017,1,GOA,VARANASI,0,359,GOA-VARANASI,359,All
2017,2,GOA,VARANASI,190,755,GOA-VARANASI,945,All
2017,3,GOA,VARANASI,428,85,GOA-VARANASI,513,All
2017,4,GOA,VARANASI,277,14,GOA-VARANASI,291,All
2017,5,GOA,VARANASI,233,0,GOA-VARANASI,233,All
2017,6,GOA,VARANASI,332,440,GOA-VARANASI,772,All
2017,7,GOA,VARANASI,268,319,GOA-VARANASI,587,All
2017,8,GOA,VARANASI,185,432,GOA-VARANASI,617,All
2017,9,GOA,VARANASI,246,518,GOA-VARANASI,764,All
2017,10,GOA,VARANASI,209,445,GOA-VARANASI,654,All
2017,11,GOA,VARANASI,328,510,GOA-VARANASI,838,All
2017,12,GOA,VARANASI,0,538,GOA-VARANASI,538,All
2018,1,GOA,VARANASI,0,639,GOA-VARANASI,639,All
2018,2,GOA,VARANASI,194,720,GOA-VARANASI,914,All
2018,3,GOA,VARANASI,451,562,GOA-VARANASI,1013,All
2018,4,GOA,VARANASI,109,346,GOA-VARANASI,455,All
2018,5,GOA,VARANASI,146,391,GOA-VARANASI,537,All
2018,6,GOA,VARANASI,347,555,GOA-VARANASI,902,All
2018,7,GOA,VARANASI,185,451,GOA-VARANASI,636,All
2018,8,GOA,VARANASI,280,560,GOA-VARANASI,840,All
2018,9,GOA,VARANASI,472,732,GOA-VARANASI,1204,All
2018,10,GOA,VARANASI,784,1021,GOA-VARANASI,1805,All
2018,11,GOA,VARANASI,287,844,GOA-VARANASI,1131,All
2018,12,GOA,VARANASI,0,721,GOA-VARANASI,721,All
2019,4,GORAKHPUR,HYDERABAD,165,175,GORAKHPUR-HYDERABAD,340,All
2019,5,GORAKHPUR,HYDERABAD,4797,4889,GORAKHPUR-HYDERABAD,9686,All
2019,6,GORAKHPUR,HYDERABAD,5320,3991,GORAKHPUR-HYDERABAD,9311,All
2019,7,GORAKHPUR,HYDERABAD,3979,2740,GORAKHPUR-HYDERABAD,6719,All
2019,9,GORAKHPUR,HYDERABAD,2609,3491,GORAKHPUR-HYDERABAD,6100,All
2019,10,GORAKHPUR,HYDERABAD,3530,4845,GORAKHPUR-HYDERABAD,8375,All
2019,11,GORAKHPUR,HYDERABAD,5187,4401,GORAKHPUR-HYDERABAD,9588,All
2019,12,GORAKHPUR,HYDERABAD,4926,4002,GORAKHPUR-HYDERABAD,8928,All
2020,1,GORAKHPUR,HYDERABAD,4689,5157,GORAKHPUR-HYDERABAD,9846,All
2020,2,GORAKHPUR,HYDERABAD,4604,5086,GORAKHPUR-HYDERABAD,9690,All
2020,3,GORAKHPUR,HYDERABAD,2668,3403,GORAKHPUR-HYDERABAD,6071,All
2020,6,GORAKHPUR,HYDERABAD,1532,2012,GORAKHPUR-HYDERABAD,3544,All
2020,7,GORAKHPUR,HYDERABAD,4685,3998,GORAKHPUR-HYDERABAD,8683,All
2020,8,GORAKHPUR,HYDERABAD,7762,3493,GORAKHPUR-HYDERABAD,11255,All
2020,9,GORAKHPUR,HYDERABAD,7681,3729,GORAKHPUR-HYDERABAD,11410,All
2020,10,GORAKHPUR,HYDERABAD,6227,6098,GORAKHPUR-HYDERABAD,12325,All
2020,11,GORAKHPUR,HYDERABAD,5168,5856,GORAKHPUR-HYDERABAD,11024,All
2020,12,GORAKHPUR,HYDERABAD,5979,4505,GORAKHPUR-HYDERABAD,10484,All
2021,1,GORAKHPUR,HYDERABAD,5609,4693,GORAKHPUR-HYDERABAD,10302,All
2021,2,GORAKHPUR,HYDERABAD,4230,4327,GORAKHPUR-HYDERABAD,8557,All
2021,3,GORAKHPUR,HYDERABAD,3681,4797,GORAKHPUR-HYDERABAD,8478,All
2021,4,GORAKHPUR,HYDERABAD,3295,4566,GORAKHPUR-HYDERABAD,7861,All
2021,6,GORAKHPUR,HYDERABAD,4605,1765,GORAKHPUR-HYDERABAD,6370,All
2021,7,GORAKHPUR,HYDERABAD,2626,1723,GORAKHPUR-HYDERABAD,4349,All
2021,8,GORAKHPUR,HYDERABAD,2259,1809,GORAKHPUR-HYDERABAD,4068,All
2021,9,GORAKHPUR,HYDERABAD,1016,982,GORAKHPUR-HYDERABAD,1998,All
2021,10,GORAKHPUR,HYDERABAD,1277,2020,GORAKHPUR-HYDERABAD,3297,All
2021,11,GORAKHPUR,HYDERABAD,3707,4679,GORAKHPUR-HYDERABAD,8386,All
2021,12,GORAKHPUR,HYDERABAD,4693,2512,GORAKHPUR-HYDERABAD,7205,All
2022,1,GORAKHPUR,HYDERABAD,3491,2740,GORAKHPUR-HYDERABAD,6231,All
2022,2,GORAKHPUR,HYDERABAD,3666,3696,GORAKHPUR-HYDERABAD,7362,All
2022,3,GORAKHPUR,HYDERABAD,3487,3575,GORAKHPUR-HYDERABAD,7062,All
2022,4,GORAKHPUR,HYDERABAD,3225,4314,GORAKHPUR-HYDERABAD,7539,All
2022,5,GORAKHPUR,HYDERABAD,4011,4292,GORAKHPUR-HYDERABAD,8303,All
2022,6,GORAKHPUR,HYDERABAD,4206,3391,GORAKHPUR-HYDERABAD,7597,All
2022,7,GORAKHPUR,HYDERABAD,3848,3192,GORAKHPUR-HYDERABAD,7040,All
2022,8,GORAKHPUR,HYDERABAD,3313,3231,GORAKHPUR-HYDERABAD,6544,All
2022,9,GORAKHPUR,HYDERABAD,3283,3548,GORAKHPUR-HYDERABAD,6831,All
2022,10,GORAKHPUR,HYDERABAD,3942,4553,GORAKHPUR-HYDERABAD,8495,All
2022,11,GORAKHPUR,HYDERABAD,4602,5010,GORAKHPUR-HYDERABAD,9612,All
2022,12,GORAKHPUR,HYDERABAD,4113,2934,GORAKHPUR-HYDERABAD,7047,All
2023,1,GORAKHPUR,HYDERABAD,3702,3957,GORAKHPUR-HYDERABAD,7659,All
2023,2,GORAKHPUR,HYDERABAD,4956,5567,GORAKHPUR-HYDERABAD,10523,All
2023,3,GORAKHPUR,HYDERABAD,5428,5727,GORAKHPUR-HYDERABAD,11155,All
2023,4,GORAKHPUR,HYDERABAD,5225,5749,GORAKHPUR-HYDERABAD,10974,All
2023,5,GORAKHPUR,HYDERABAD,5746,5930,GORAKHPUR-HYDERABAD,11676,All
2023,6,GORAKHPUR,HYDERABAD,6236,5168,GORAKHPUR-HYDERABAD,11404,All
2023,7,GORAKHPUR,HYDERABAD,5871,5679,GORAKHPUR-HYDERABAD,11550,All
2023,8,GORAKHPUR,HYDERABAD,5265,5938,GORAKHPUR-HYDERABAD,11203,All
2023,9,GORAKHPUR,HYDERABAD,5452,6184,GORAKHPUR-HYDERABAD,11636,All
2023,10,GORAKHPUR,HYDERABAD,5037,6153,GORAKHPUR-HYDERABAD,11190,All
2023,11,GORAKHPUR,HYDERABAD,4769,5227,GORAKHPUR-HYDERABAD,9996,All
2023,12,GORAKHPUR,HYDERABAD,5258,4999,GORAKHPUR-HYDERABAD,10257,All
2024,1,GORAKHPUR,HYDERABAD,4739,4892,GORAKHPUR-HYDERABAD,9631,All
2024,2,GORAKHPUR,HYDERABAD,4592,4948,GORAKHPUR-HYDERABAD,9540,All
2024,3,GORAKHPUR,HYDERABAD,4941,5339,GORAKHPUR-HYDERABAD,10280,All
2024,4,GORAKHPUR,HYDERABAD,4549,5546,GORAKHPUR-HYDERABAD,10095,All
2024,6,GORAKHPUR,HYDERABAD,6040,6048,GORAKHPUR-HYDERABAD,12088,All
2024,7,GORAKHPUR,HYDERABAD,6143,5614,GORAKHPUR-HYDERABAD,11757,All
2024,8,GORAKHPUR,HYDERABAD,5362,6260,GORAKHPUR-HYDERABAD,11622,All
2024,9,GORAKHPUR,HYDERABAD,5258,6260,GORAKHPUR-HYDERABAD,11518,All
2024,10,GORAKHPUR,HYDERABAD,5351,6978,GORAKHPUR-HYDERABAD,12329,All
2024,11,GORAKHPUR,HYDERABAD,5928,6443,GORAKHPUR-HYDERABAD,12371,All
2024,12,GORAKHPUR,HYDERABAD,4947,4829,GORAKHPUR-HYDERABAD,9776,All
2025,1,GORAKHPUR,HYDERABAD,4948,6158,GORAKHPUR-HYDERABAD,11106,All
2025,2,GORAKHPUR,HYDERABAD,5062,5836,GORAKHPUR-HYDERABAD,10898,All
2025,3,GORAKHPUR,HYDERABAD,5690,6456,GORAKHPUR-HYDERABAD,12146,All
2018,9,GORAKHPUR,INDORE,0,52,GORAKHPUR-INDORE,52,All
2018,10,GORAKHPUR,INDORE,0,83,GORAKHPUR-INDORE,83,All
2018,11,GORAKHPUR,INDORE,0,60,GORAKHPUR-INDORE,60,All
2018,12,GORAKHPUR,INDORE,0,90,GORAKHPUR-INDORE,90,All
2022,3,GORAKHPUR,JAIPUR,1,0,GORAKHPUR-JAIPUR,1,All
2022,4,GORAKHPUR,JAIPUR,97,0,GORAKHPUR-JAIPUR,97,All
2023,11,GORAKHPUR,JAIPUR,13,0,GORAKHPUR-JAIPUR,13,All
2024,4,GORAKHPUR,JAIPUR,6,0,GORAKHPUR-JAIPUR,6,All
2022,3,GORAKHPUR,KANPUR,41,24,GORAKHPUR-KANPUR,65,All
2022,4,GORAKHPUR,KANPUR,481,459,GORAKHPUR-KANPUR,940,All
2022,5,GORAKHPUR,KANPUR,287,321,GORAKHPUR-KANPUR,608,All
2022,6,GORAKHPUR,KANPUR,548,424,GORAKHPUR-KANPUR,972,All
2022,7,GORAKHPUR,KANPUR,139,104,GORAKHPUR-KANPUR,243,All
2020,3,GORAKHPUR,KOCHI,1,0,GORAKHPUR-KOCHI,1,All
2019,5,GORAKHPUR,KOLKATA,4752,4723,GORAKHPUR-KOLKATA,9475,All
2019,6,GORAKHPUR,KOLKATA,5215,4210,GORAKHPUR-KOLKATA,9425,All
2019,7,GORAKHPUR,KOLKATA,3513,3219,GORAKHPUR-KOLKATA,6732,All
2019,9,GORAKHPUR,KOLKATA,3716,3899,GORAKHPUR-KOLKATA,7615,All
2019,10,GORAKHPUR,KOLKATA,3897,4429,GORAKHPUR-KOLKATA,8326,All
2019,11,GORAKHPUR,KOLKATA,4598,3991,GORAKHPUR-KOLKATA,8589,All
2019,12,GORAKHPUR,KOLKATA,4767,3798,GORAKHPUR-KOLKATA,8565,All
2020,1,GORAKHPUR,KOLKATA,2915,2634,GORAKHPUR-KOLKATA,5549,All
2020,2,GORAKHPUR,KOLKATA,2164,2135,GORAKHPUR-KOLKATA,4299,All
2020,3,GORAKHPUR,KOLKATA,1568,1682,GORAKHPUR-KOLKATA,3250,All
2020,6,GORAKHPUR,KOLKATA,125,135,GORAKHPUR-KOLKATA,260,All
2020,7,GORAKHPUR,KOLKATA,1194,1032,GORAKHPUR-KOLKATA,2226,All
2020,8,GORAKHPUR,KOLKATA,1521,1169,GORAKHPUR-KOLKATA,2690,All
2020,9,GORAKHPUR,KOLKATA,1981,1441,GORAKHPUR-KOLKATA,3422,All
2020,10,GORAKHPUR,KOLKATA,1994,1843,GORAKHPUR-KOLKATA,3837,All
2020,11,GORAKHPUR,KOLKATA,1882,1979,GORAKHPUR-KOLKATA,3861,All
2020,12,GORAKHPUR,KOLKATA,2278,1376,GORAKHPUR-KOLKATA,3654,All
2021,1,GORAKHPUR,KOLKATA,2049,1352,GORAKHPUR-KOLKATA,3401,All
2021,2,GORAKHPUR,KOLKATA,1664,1329,GORAKHPUR-KOLKATA,2993,All
2021,3,GORAKHPUR,KOLKATA,1745,1628,GORAKHPUR-KOLKATA,3373,All
2021,4,GORAKHPUR,KOLKATA,1305,1646,GORAKHPUR-KOLKATA,2951,All
2021,6,GORAKHPUR,KOLKATA,612,440,GORAKHPUR-KOLKATA,1052,All
2021,7,GORAKHPUR,KOLKATA,881,945,GORAKHPUR-KOLKATA,1826,All
2021,8,GORAKHPUR,KOLKATA,1077,1026,GORAKHPUR-KOLKATA,2103,All
2021,9,GORAKHPUR,KOLKATA,1056,1044,GORAKHPUR-KOLKATA,2100,All
2021,10,GORAKHPUR,KOLKATA,1607,1767,GORAKHPUR-KOLKATA,3374,All
2021,11,GORAKHPUR,KOLKATA,781,752,GORAKHPUR-KOLKATA,1533,All
2021,12,GORAKHPUR,KOLKATA,1036,829,GORAKHPUR-KOLKATA,1865,All
2022,1,GORAKHPUR,KOLKATA,575,602,GORAKHPUR-KOLKATA,1177,All
2022,2,GORAKHPUR,KOLKATA,784,775,GORAKHPUR-KOLKATA,1559,All
2022,3,GORAKHPUR,KOLKATA,1019,985,GORAKHPUR-KOLKATA,2004,All
2022,4,GORAKHPUR,KOLKATA,1832,1927,GORAKHPUR-KOLKATA,3759,All
2022,5,GORAKHPUR,KOLKATA,2142,2173,GORAKHPUR-KOLKATA,4315,All
2022,6,GORAKHPUR,KOLKATA,2095,1969,GORAKHPUR-KOLKATA,4064,All
2022,7,GORAKHPUR,KOLKATA,2134,1775,GORAKHPUR-KOLKATA,3909,All
2022,8,GORAKHPUR,KOLKATA,2152,1782,GORAKHPUR-KOLKATA,3934,All
2022,9,GORAKHPUR,KOLKATA,1859,1686,GORAKHPUR-KOLKATA,3545,All
2022,10,GORAKHPUR,KOLKATA,1980,2149,GORAKHPUR-KOLKATA,4129,All
2022,11,GORAKHPUR,KOLKATA,2212,2115,GORAKHPUR-KOLKATA,4327,All
2022,12,GORAKHPUR,KOLKATA,2141,1889,GORAKHPUR-KOLKATA,4030,All
2023,1,GORAKHPUR,KOLKATA,1774,1921,GORAKHPUR-KOLKATA,3695,All
2023,2,GORAKHPUR,KOLKATA,1915,1932,GORAKHPUR-KOLKATA,3847,All
2023,3,GORAKHPUR,KOLKATA,2152,1923,GORAKHPUR-KOLKATA,4075,All
2023,4,GORAKHPUR,KOLKATA,2209,2158,GORAKHPUR-KOLKATA,4367,All
2023,5,GORAKHPUR,KOLKATA,2439,2652,GORAKHPUR-KOLKATA,5091,All
2023,6,GORAKHPUR,KOLKATA,2595,2147,GORAKHPUR-KOLKATA,4742,All
2023,7,GORAKHPUR,KOLKATA,2395,1903,GORAKHPUR-KOLKATA,4298,All
2023,8,GORAKHPUR,KOLKATA,1902,1960,GORAKHPUR-KOLKATA,3862,All
2023,9,GORAKHPUR,KOLKATA,2034,2081,GORAKHPUR-KOLKATA,4115,All
2023,10,GORAKHPUR,KOLKATA,2020,2173,GORAKHPUR-KOLKATA,4193,All
2023,11,GORAKHPUR,KOLKATA,1920,2146,GORAKHPUR-KOLKATA,4066,All
2023,12,GORAKHPUR,KOLKATA,2231,1987,GORAKHPUR-KOLKATA,4218,All
2024,1,GORAKHPUR,KOLKATA,1814,1711,GORAKHPUR-KOLKATA,3525,All
2024,2,GORAKHPUR,KOLKATA,1961,2044,GORAKHPUR-KOLKATA,4005,All
2024,3,GORAKHPUR,KOLKATA,2098,2137,GORAKHPUR-KOLKATA,4235,All
2024,4,GORAKHPUR,KOLKATA,1956,2218,GORAKHPUR-KOLKATA,4174,All
2024,6,GORAKHPUR,KOLKATA,2125,1800,GORAKHPUR-KOLKATA,3925,All
2024,7,GORAKHPUR,KOLKATA,1976,1730,GORAKHPUR-KOLKATA,3706,All
2024,8,GORAKHPUR,KOLKATA,1813,1626,GORAKHPUR-KOLKATA,3439,All
2024,9,GORAKHPUR,KOLKATA,1838,1740,GORAKHPUR-KOLKATA,3578,All
2024,10,GORAKHPUR,KOLKATA,1974,2107,GORAKHPUR-KOLKATA,4081,All
2024,11,GORAKHPUR,KOLKATA,2113,2251,GORAKHPUR-KOLKATA,4364,All
2024,12,GORAKHPUR,KOLKATA,2362,2139,GORAKHPUR-KOLKATA,4501,All
2025,1,GORAKHPUR,KOLKATA,1980,1962,GORAKHPUR-KOLKATA,3942,All
2025,2,GORAKHPUR,KOLKATA,2035,2079,GORAKHPUR-KOLKATA,4114,All
2025,3,GORAKHPUR,KOLKATA,2196,2162,GORAKHPUR-KOLKATA,4358,All
2021,1,GORAKHPUR,LUCKNOW,176,0,GORAKHPUR-LUCKNOW,176,All
2021,3,GORAKHPUR,LUCKNOW,128,111,GORAKHPUR-LUCKNOW,239,All
2021,4,GORAKHPUR,LUCKNOW,335,645,GORAKHPUR-LUCKNOW,980,All
2021,6,GORAKHPUR,LUCKNOW,245,168,GORAKHPUR-LUCKNOW,413,All
2021,7,GORAKHPUR,LUCKNOW,226,222,GORAKHPUR-LUCKNOW,448,All
2021,8,GORAKHPUR,LUCKNOW,216,213,GORAKHPUR-LUCKNOW,429,All
2021,9,GORAKHPUR,LUCKNOW,314,264,GORAKHPUR-LUCKNOW,578,All
2021,10,GORAKHPUR,LUCKNOW,302,295,GORAKHPUR-LUCKNOW,597,All
2021,11,GORAKHPUR,LUCKNOW,541,0,GORAKHPUR-LUCKNOW,541,All
2021,12,GORAKHPUR,LUCKNOW,536,359,GORAKHPUR-LUCKNOW,895,All
2022,1,GORAKHPUR,LUCKNOW,330,284,GORAKHPUR-LUCKNOW,614,All
2022,2,GORAKHPUR,LUCKNOW,450,383,GORAKHPUR-LUCKNOW,833,All
2022,3,GORAKHPUR,LUCKNOW,419,388,GORAKHPUR-LUCKNOW,807,All
2022,4,GORAKHPUR,LUCKNOW,541,0,GORAKHPUR-LUCKNOW,541,All
2022,5,GORAKHPUR,LUCKNOW,536,359,GORAKHPUR-LUCKNOW,895,All
2022,6,GORAKHPUR,LUCKNOW,541,0,GORAKHPUR-LUCKNOW,541,All
2022,7,GORAKHPUR,LUCKNOW,450,383,GORAKHPUR-LUCKNOW,833,All
2022,8,GORAKHPUR,LUCKNOW,536,359,GORAKHPUR-LUCKNOW,895,All
2022,9,GORAKHPUR,LUCKNOW,541,0,GORAKHPUR-LUCKNOW,541,All
2022,10,GORAKHPUR,LUCKNOW,740,994,GORAKHPUR-LUCKNOW,1734,All
2022,11,GORAKHPUR,LUCKNOW,1035,808,GORAKHPUR-LUCKNOW,1843,All
2022,12,GORAKHPUR,LUCKNOW,1046,885,GORAKHPUR-LUCKNOW,1931,All
2023,1,GORAKHPUR,LUCKNOW,838,949,GORAKHPUR-LUCKNOW,1787,All
2023,2,GORAKHPUR,LUCKNOW,1000,998,GORAKHPUR-LUCKNOW,1998,All
2023,3,GORAKHPUR,LUCKNOW,788,863,GORAKHPUR-LUCKNOW,1651,All
2023,4,GORAKHPUR,LUCKNOW,571,661,GORAKHPUR-LUCKNOW,1232,All
2023,5,GORAKHPUR,LUCKNOW,752,858,GORAKHPUR-LUCKNOW,1610,All
2023,6,GORAKHPUR,LUCKNOW,600,774,GORAKHPUR-LUCKNOW,1374,All
2023,7,GORAKHPUR,LUCKNOW,426,365,GORAKHPUR-LUCKNOW,791,All
2023,8,GORAKHPUR,LUCKNOW,472,450,GORAKHPUR-LUCKNOW,922,All
2023,9,GORAKHPUR,LUCKNOW,543,443,GORAKHPUR-LUCKNOW,986,All
2023,10,GORAKHPUR,LUCKNOW,564,764,GORAKHPUR-LUCKNOW,1328,All
2023,11,GORAKHPUR,LUCKNOW,946,1052,GORAKHPUR-LUCKNOW,1998,All
2023,12,GORAKHPUR,LUCKNOW,900,895,GORAKHPUR-LUCKNOW,1795,All
2024,1,GORAKHPUR,LUCKNOW,1138,1097,GORAKHPUR-LUCKNOW,2235,All
2024,2,GORAKHPUR,LUCKNOW,793,1067,GORAKHPUR-LUCKNOW,1860,All
2024,3,GORAKHPUR,LUCKNOW,785,1064,GORAKHPUR-LUCKNOW,1849,All
2019,5,GORAKHPUR,MUMBAI,8065,8286,GORAKHPUR-MUMBAI,16351,All
2019,6,GORAKHPUR,MUMBAI,9048,8907,GORAKHPUR-MUMBAI,17955,All
2019,7,GORAKHPUR,MUMBAI,8214,7411,GORAKHPUR-MUMBAI,15625,All
2019,8,GORAKHPUR,MUMBAI,8548,8463,GORAKHPUR-MUMBAI,17011,All
2019,9,GORAKHPUR,MUMBAI,8251,8773,GORAKHPUR-MUMBAI,17024,All
2019,10,GORAKHPUR,MUMBAI,6988,9266,GORAKHPUR-MUMBAI,16254,All
2019,11,GORAKHPUR,MUMBAI,5331,5436,GORAKHPUR-MUMBAI,10767,All
2019,12,GORAKHPUR,MUMBAI,4975,5137,GORAKHPUR-MUMBAI,10112,All
2020,1,GORAKHPUR,MUMBAI,4996,5649,GORAKHPUR-MUMBAI,10645,All
2020,2,GORAKHPUR,MUMBAI,4524,5267,GORAKHPUR-MUMBAI,9791,All
2020,3,GORAKHPUR,MUMBAI,3273,4203,GORAKHPUR-MUMBAI,7476,All
2020,5,GORAKHPUR,MUMBAI,340,930,GORAKHPUR-MUMBAI,1270,All
2020,6,GORAKHPUR,MUMBAI,2345,5411,GORAKHPUR-MUMBAI,7756,All
2020,7,GORAKHPUR,MUMBAI,4551,6207,GORAKHPUR-MUMBAI,10758,All
2020,8,GORAKHPUR,MUMBAI,7919,3811,GORAKHPUR-MUMBAI,11730,All
2020,9,GORAKHPUR,MUMBAI,13366,4946,GORAKHPUR-MUMBAI,18312,All
2020,10,GORAKHPUR,MUMBAI,15396,7747,GORAKHPUR-MUMBAI,23143,All
2020,11,GORAKHPUR,MUMBAI,12789,15714,GORAKHPUR-MUMBAI,28503,All
2020,12,GORAKHPUR,MUMBAI,17014,9770,GORAKHPUR-MUMBAI,26784,All
2021,1,GORAKHPUR,MUMBAI,14466,7898,GORAKHPUR-MUMBAI,22364,All
2021,2,GORAKHPUR,MUMBAI,8224,7793,GORAKHPUR-MUMBAI,16017,All
2021,3,GORAKHPUR,MUMBAI,5731,8646,GORAKHPUR-MUMBAI,14377,All
2021,4,GORAKHPUR,MUMBAI,5399,13207,GORAKHPUR-MUMBAI,18606,All
2021,6,GORAKHPUR,MUMBAI,8029,4029,GORAKHPUR-MUMBAI,12058,All
2021,7,GORAKHPUR,MUMBAI,5371,4225,GORAKHPUR-MUMBAI,9596,All
2021,8,GORAKHPUR,MUMBAI,4973,4369,GORAKHPUR-MUMBAI,9342,All
2021,9,GORAKHPUR,MUMBAI,4681,4620,GORAKHPUR-MUMBAI,9301,All
2021,10,GORAKHPUR,MUMBAI,4222,5798,GORAKHPUR-MUMBAI,10020,All
2021,11,GORAKHPUR,MUMBAI,9302,10550,GORAKHPUR-MUMBAI,19852,All
2021,12,GORAKHPUR,MUMBAI,9728,7226,GORAKHPUR-MUMBAI,16954,All
2022,1,GORAKHPUR,MUMBAI,5670,6789,GORAKHPUR-MUMBAI,12459,All
2022,2,GORAKHPUR,MUMBAI,7177,7871,GORAKHPUR-MUMBAI,15048,All
2022,3,GORAKHPUR,MUMBAI,7948,8684,GORAKHPUR-MUMBAI,16632,All
2022,4,GORAKHPUR,MUMBAI,7564,10211,GORAKHPUR-MUMBAI,17775,All
2022,5,GORAKHPUR,MUMBAI,10471,10903,GORAKHPUR-MUMBAI,21374,All
2022,6,GORAKHPUR,MUMBAI,10834,9449,GORAKHPUR-MUMBAI,20283,All
2022,7,GORAKHPUR,MUMBAI,6433,6137,GORAKHPUR-MUMBAI,12570,All
2022,8,GORAKHPUR,MUMBAI,7039,6422,GORAKHPUR-MUMBAI,13461,All
2022,9,GORAKHPUR,MUMBAI,6233,6540,GORAKHPUR-MUMBAI,12773,All
2022,10,GORAKHPUR,MUMBAI,8322,10339,GORAKHPUR-MUMBAI,18661,All
2022,11,GORAKHPUR,MUMBAI,9738,9830,GORAKHPUR-MUMBAI,19568,All
2022,12,GORAKHPUR,MUMBAI,8445,7941,GORAKHPUR-MUMBAI,16386,All
2023,11,GORAKHPUR,MUMBAI,9995,10961,GORAKHPUR-MUMBAI,20956,All
2023,12,GORAKHPUR,MUMBAI,11469,11145,GORAKHPUR-MUMBAI,22614,All
2024,1,GORAKHPUR,MUMBAI,9840,9938,GORAKHPUR-MUMBAI,19778,All
2024,2,GORAKHPUR,MUMBAI,5057,5420,GORAKHPUR-MUMBAI,10477,All
2024,3,GORAKHPUR,MUMBAI,5510,5719,GORAKHPUR-MUMBAI,11229,All
2024,4,GORAKHPUR,MUMBAI,4903,5207,GORAKHPUR-MUMBAI,10110,All
2024,6,GORAKHPUR,MUMBAI,5345,5189,GORAKHPUR-MUMBAI,10534,All
2024,7,GORAKHPUR,MUMBAI,5508,5541,GORAKHPUR-MUMBAI,11049,All
2024,8,GORAKHPUR,MUMBAI,5940,6197,GORAKHPUR-MUMBAI,12137,All
2024,9,GORAKHPUR,MUMBAI,6228,6464,GORAKHPUR-MUMBAI,12692,All
2024,10,GORAKHPUR,MUMBAI,6176,6927,GORAKHPUR-MUMBAI,13103,All
2024,11,GORAKHPUR,MUMBAI,6539,6759,GORAKHPUR-MUMBAI,13298,All
2024,12,GORAKHPUR,MUMBAI,10142,9297,GORAKHPUR-MUMBAI,19439,All
2025,1,GORAKHPUR,MUMBAI,11502,10757,GORAKHPUR-MUMBAI,22259,All
2025,2,GORAKHPUR,MUMBAI,9778,10304,GORAKHPUR-MUMBAI,20082,All
2025,3,GORAKHPUR,MUMBAI,11731,12642,GORAKHPUR-MUMBAI,24373,All
2020,12,GORAKHPUR,SRINAGAR,120,0,GORAKHPUR-SRINAGAR,120,All
2021,1,GORAKHPUR,SRINAGAR,200,0,GORAKHPUR-SRINAGAR,200,All
2021,2,GORAKHPUR,SRINAGAR,287,0,GORAKHPUR-SRINAGAR,287,All
2021,3,GORAKHPUR,SRINAGAR,226,0,GORAKHPUR-SRINAGAR,226,All
2023,3,GORAKHPUR,SRINAGAR,4,0,GORAKHPUR-SRINAGAR,4,All
2023,4,GORAKHPUR,SRINAGAR,76,0,GORAKHPUR-SRINAGAR,76,All
2023,5,GORAKHPUR,SRINAGAR,65,0,GORAKHPUR-SRINAGAR,65,All
2018,4,GORAKHPUR,SURAT,6,20,GORAKHPUR-SURAT,26,All
2018,5,GORAKHPUR,SURAT,145,161,GORAKHPUR-SURAT,306,All
2018,6,GORAKHPUR,SURAT,113,187,GORAKHPUR-SURAT,300,All
2018,7,GORAKHPUR,SURAT,0,187,GORAKHPUR-SURAT,187,All
2018,8,GORAKHPUR,SURAT,0,332,GORAKHPUR-SURAT,332,All
2018,9,GORAKHPUR,SURAT,0,337,GORAKHPUR-SURAT,337,All
2018,10,GORAKHPUR,SURAT,0,463,GORAKHPUR-SURAT,463,All
2018,11,GORAKHPUR,SURAT,0,411,GORAKHPUR-SURAT,411,All
2018,12,GORAKHPUR,SURAT,0,464,GORAKHPUR-SURAT,464,All
2019,1,GORAKHPUR,SURAT,0,334,GORAKHPUR-SURAT,334,All
2019,2,GORAKHPUR,SURAT,0,525,GORAKHPUR-SURAT,525,All
2019,3,GORAKHPUR,SURAT,0,247,GORAKHPUR-SURAT,247,All
2019,4,GORAKHPUR,SURAT,0,63,GORAKHPUR-SURAT,63,All
2019,5,GORAKHPUR,SURAT,0,21,GORAKHPUR-SURAT,21,All
2019,6,GORAKHPUR,SURAT,0,309,GORAKHPUR-SURAT,309,All
2019,7,GORAKHPUR,SURAT,0,251,GORAKHPUR-SURAT,251,All
2019,8,GORAKHPUR,SURAT,0,224,GORAKHPUR-SURAT,224,All
2019,9,GORAKHPUR,SURAT,0,366,GORAKHPUR-SURAT,366,All
2019,10,GORAKHPUR,SURAT,0,348,GORAKHPUR-SURAT,348,All
2019,11,GORAKHPUR,SURAT,0,478,GORAKHPUR-SURAT,478,All
2019,12,GORAKHPUR,SURAT,0,331,GORAKHPUR-SURAT,331,All
2020,1,GORAKHPUR,SURAT,0,203,GORAKHPUR-SURAT,203,All
2020,2,GORAKHPUR,SURAT,0,217,GORAKHPUR-SURAT,217,All
2021,3,GORAKHPUR,SURAT,0,116,GORAKHPUR-SURAT,116,All
2021,4,GORAKHPUR,SURAT,0,565,GORAKHPUR-SURAT,565,All
2022,3,GORAKHPUR,VARANASI,95,61,GORAKHPUR-VARANASI,156,All
2022,4,GORAKHPUR,VARANASI,921,627,GORAKHPUR-VARANASI,1548,All
2022,5,GORAKHPUR,VARANASI,1002,646,GORAKHPUR-VARANASI,1648,All
2022,6,GORAKHPUR,VARANASI,1406,630,GORAKHPUR-VARANASI,2036,All
2022,7,GORAKHPUR,VARANASI,115,61,GORAKHPUR-VARANASI,176,All
2022,8,GORAKHPUR,VARANASI,235,81,GORAKHPUR-VARANASI,316,All
2024,4,GORAKHPUR,VARANASI,0,77,GORAKHPUR-VARANASI,77,All
2024,7,GORAKHPUR,VARANASI,0,153,GORAKHPUR-VARANASI,153,All
2025,3,GORAKHPUR,VARANASI,0,225,GORAKHPUR-VARANASI,225,All
2015,4,GUWAHATI,AGARTALA,6965,7339,AGARTALA-GUWAHATI,14304,All
2015,5,GUWAHATI,AGARTALA,7684,8189,AGARTALA-GUWAHATI,15873,All
2015,6,GUWAHATI,AGARTALA,7630,7660,AGARTALA-GUWAHATI,15290,All
2015,7,GUWAHATI,AGARTALA,8273,8246,AGARTALA-GUWAHATI,16519,All
2015,8,GUWAHATI,AGARTALA,7000,8349,AGARTALA-GUWAHATI,15349,All
2015,9,GUWAHATI,AGARTALA,7328,7541,AGARTALA-GUWAHATI,14869,All
2015,10,GUWAHATI,AGARTALA,7193,7376,AGARTALA-GUWAHATI,14569,All
2015,11,GUWAHATI,AGARTALA,6872,6866,AGARTALA-GUWAHATI,13738,All
2015,12,GUWAHATI,AGARTALA,7989,7239,AGARTALA-GUWAHATI,15228,All
2016,1,GUWAHATI,AGARTALA,6965,7337,AGARTALA-GUWAHATI,14302,All
2016,2,GUWAHATI,AGARTALA,6817,7205,AGARTALA-GUWAHATI,14022,All
2016,3,GUWAHATI,AGARTALA,6571,7296,AGARTALA-GUWAHATI,13867,All
2016,4,GUWAHATI,AGARTALA,7013,7191,AGARTALA-GUWAHATI,14204,All
2016,5,GUWAHATI,AGARTALA,7903,7977,AGARTALA-GUWAHATI,15880,All
2016,6,GUWAHATI,AGARTALA,7935,7973,AGARTALA-GUWAHATI,15908,All
2016,7,GUWAHATI,AGARTALA,8510,8994,AGARTALA-GUWAHATI,17504,All
2016,8,GUWAHATI,AGARTALA,6887,7495,AGARTALA-GUWAHATI,14382,All
2016,9,GUWAHATI,AGARTALA,7147,7955,AGARTALA-GUWAHATI,15102,All
2016,10,GUWAHATI,AGARTALA,7094,7914,AGARTALA-GUWAHATI,15008,All
2016,11,GUWAHATI,AGARTALA,8020,8703,AGARTALA-GUWAHATI,16723,All
2016,12,GUWAHATI,AGARTALA,9165,9455,AGARTALA-GUWAHATI,18620,All
2017,1,GUWAHATI,AGARTALA,8708,9450,AGARTALA-GUWAHATI,18158,All
2017,2,GUWAHATI,AGARTALA,7851,8627,AGARTALA-GUWAHATI,16478,All
2017,3,GUWAHATI,AGARTALA,9064,9525,AGARTALA-GUWAHATI,18589,All
2017,4,GUWAHATI,AGARTALA,8789,9171,AGARTALA-GUWAHATI,17960,All
2017,5,GUWAHATI,AGARTALA,9555,9629,AGARTALA-GUWAHATI,19184,All
2017,6,GUWAHATI,AGARTALA,9249,9125,AGARTALA-GUWAHATI,18374,All
2017,7,GUWAHATI,AGARTALA,8878,9755,AGARTALA-GUWAHATI,18633,All
2017,8,GUWAHATI,AGARTALA,8688,9348,AGARTALA-GUWAHATI,18036,All
2017,9,GUWAHATI,AGARTALA,9011,9119,AGARTALA-GUWAHATI,18130,All
2017,10,GUWAHATI,AGARTALA,8997,9763,AGARTALA-GUWAHATI,18760,All
2017,11,GUWAHATI,AGARTALA,9202,9663,AGARTALA-GUWAHATI,18865,All
2017,12,GUWAHATI,AGARTALA,9357,9772,AGARTALA-GUWAHATI,19129,All
2018,1,GUWAHATI,AGARTALA,10003,9852,AGARTALA-GUWAHATI,19855,All
2018,2,GUWAHATI,AGARTALA,8231,8998,AGARTALA-GUWAHATI,17229,All
2018,3,GUWAHATI,AGARTALA,9345,9718,AGARTALA-GUWAHATI,19063,All
2018,4,GUWAHATI,AGARTALA,9566,10064,AGARTALA-GUWAHATI,19630,All
2018,5,GUWAHATI,AGARTALA,9281,8922,AGARTALA-GUWAHATI,18203,All
2018,6,GUWAHATI,AGARTALA,10263,8788,AGARTALA-GUWAHATI,19051,All
2018,7,GUWAHATI,AGARTALA,8968,8966,AGARTALA-GUWAHATI,17934,All
2018,8,GUWAHATI,AGARTALA,8249,8265,AGARTALA-GUWAHATI,16514,All
2018,9,GUWAHATI,AGARTALA,7008,6549,AGARTALA-GUWAHATI,13557,All
2018,10,GUWAHATI,AGARTALA,5954,6058,AGARTALA-GUWAHATI,12012,All
2018,11,GUWAHATI,AGARTALA,5759,8140,AGARTALA-GUWAHATI,13899,All
2018,12,GUWAHATI,AGARTALA,9092,10611,AGARTALA-GUWAHATI,19703,All
2019,1,GUWAHATI,AGARTALA,8788,8330,AGARTALA-GUWAHATI,17118,All
2019,2,GUWAHATI,AGARTALA,6355,7678,AGARTALA-GUWAHATI,14033,All
2019,3,GUWAHATI,AGARTALA,7000,8446,AGARTALA-GUWAHATI,15446,All
2019,4,GUWAHATI,AGARTALA,6411,8587,AGARTALA-GUWAHATI,14998,All
2015,4,GUWAHATI,BAGDOGRA,3735,1592,BAGDOGRA-GUWAHATI,5327,All
2015,5,GUWAHATI,BAGDOGRA,3396,1042,BAGDOGRA-GUWAHATI,4438,All
2015,6,GUWAHATI,BAGDOGRA,3732,1438,BAGDOGRA-GUWAHATI,5170,All
2015,7,GUWAHATI,BAGDOGRA,4294,1597,BAGDOGRA-GUWAHATI,5891,All
2015,8,GUWAHATI,BAGDOGRA,2780,1347,BAGDOGRA-GUWAHATI,4127,All
2015,9,GUWAHATI,BAGDOGRA,2745,1452,BAGDOGRA-GUWAHATI,4197,All
2015,10,GUWAHATI,BAGDOGRA,4576,2636,BAGDOGRA-GUWAHATI,7212,All
2015,11,GUWAHATI,BAGDOGRA,4424,1966,BAGDOGRA-GUWAHATI,6390,All
2015,12,GUWAHATI,BAGDOGRA,3288,3876,BAGDOGRA-GUWAHATI,7164,All
2016,1,GUWAHATI,BAGDOGRA,2112,4617,BAGDOGRA-GUWAHATI,6729,All
2016,2,GUWAHATI,BAGDOGRA,3848,3924,BAGDOGRA-GUWAHATI,7772,All
2016,3,GUWAHATI,BAGDOGRA,5142,2448,BAGDOGRA-GUWAHATI,7590,All
2016,4,GUWAHATI,BAGDOGRA,5365,2493,BAGDOGRA-GUWAHATI,7858,All
2016,5,GUWAHATI,BAGDOGRA,5747,2296,BAGDOGRA-GUWAHATI,8043,All
2016,6,GUWAHATI,BAGDOGRA,5459,2023,BAGDOGRA-GUWAHATI,7482,All
2016,7,GUWAHATI,BAGDOGRA,5558,2858,BAGDOGRA-GUWAHATI,8416,All
2016,8,GUWAHATI,BAGDOGRA,3901,2178,BAGDOGRA-GUWAHATI,6079,All
2016,9,GUWAHATI,BAGDOGRA,4816,2309,BAGDOGRA-GUWAHATI,7125,All
2016,10,GUWAHATI,BAGDOGRA,2816,5592,BAGDOGRA-GUWAHATI,8408,All
2016,11,GUWAHATI,BAGDOGRA,2607,5159,BAGDOGRA-GUWAHATI,7766,All
2016,12,GUWAHATI,BAGDOGRA,2535,10157,BAGDOGRA-GUWAHATI,12692,All
2017,1,GUWAHATI,BAGDOGRA,2952,9910,BAGDOGRA-GUWAHATI,12862,All
2017,2,GUWAHATI,BAGDOGRA,2140,9120,BAGDOGRA-GUWAHATI,11260,All
2017,3,GUWAHATI,BAGDOGRA,3841,10207,BAGDOGRA-GUWAHATI,14048,All
2017,4,GUWAHATI,BAGDOGRA,8656,6717,BAGDOGRA-GUWAHATI,15373,All
2017,5,GUWAHATI,BAGDOGRA,8763,6113,BAGDOGRA-GUWAHATI,14876,All
2017,6,GUWAHATI,BAGDOGRA,8926,6587,BAGDOGRA-GUWAHATI,15513,All
2017,7,GUWAHATI,BAGDOGRA,10560,6857,BAGDOGRA-GUWAHATI,17417,All
2017,8,GUWAHATI,BAGDOGRA,8283,5752,BAGDOGRA-GUWAHATI,14035,All
2017,9,GUWAHATI,BAGDOGRA,5763,6126,BAGDOGRA-GUWAHATI,11889,All
2017,10,GUWAHATI,BAGDOGRA,5810,6647,BAGDOGRA-GUWAHATI,12457,All
2017,11,GUWAHATI,BAGDOGRA,4810,6751,BAGDOGRA-GUWAHATI,11561,All
2017,12,GUWAHATI,BAGDOGRA,7304,9210,BAGDOGRA-GUWAHATI,16514,All
2018,1,GUWAHATI,BAGDOGRA,7870,10140,BAGDOGRA-GUWAHATI,18010,All
2018,2,GUWAHATI,BAGDOGRA,8745,9901,BAGDOGRA-GUWAHATI,18646,All
2018,3,GUWAHATI,BAGDOGRA,11126,12538,BAGDOGRA-GUWAHATI,23664,All
2018,4,GUWAHATI,BAGDOGRA,12166,14492,BAGDOGRA-GUWAHATI,26658,All
2018,5,GUWAHATI,BAGDOGRA,11492,13822,BAGDOGRA-GUWAHATI,25314,All
2018,6,GUWAHATI,BAGDOGRA,11860,13471,BAGDOGRA-GUWAHATI,25331,All
2018,7,GUWAHATI,BAGDOGRA,14287,16136,BAGDOGRA-GUWAHATI,30423,All
2018,8,GUWAHATI,BAGDOGRA,6344,7993,BAGDOGRA-GUWAHATI,14337,All
2018,9,GUWAHATI,BAGDOGRA,9273,11172,BAGDOGRA-GUWAHATI,20445,All
2018,10,GUWAHATI,BAGDOGRA,11687,13724,BAGDOGRA-GUWAHATI,25411,All
2018,11,GUWAHATI,BAGDOGRA,8506,10556,BAGDOGRA-GUWAHATI,19062,All
2018,12,GUWAHATI,BAGDOGRA,10497,14464,BAGDOGRA-GUWAHATI,24961,All
2019,1,GUWAHATI,BAGDOGRA,10824,13111,BAGDOGRA-GUWAHATI,23935,All
2019,2,GUWAHATI,BAGDOGRA,8935,8451,BAGDOGRA-GUWAHATI,17386,All
2019,3,GUWAHATI,BAGDOGRA,9863,9497,BAGDOGRA-GUWAHATI,19360,All
2019,4,GUWAHATI,BAGDOGRA,7898,7878,BAGDOGRA-GUWAHATI,15776,All
2015,4,GUWAHATI,CHENNAI,3230,4099,CHENNAI-GUWAHATI,7329,All
2015,5,GUWAHATI,CHENNAI,4620,5448,CHENNAI-GUWAHATI,10068,All
2015,6,GUWAHATI,CHENNAI,3689,3755,CHENNAI-GUWAHATI,7444,All
2015,7,GUWAHATI,CHENNAI,3061,3144,CHENNAI-GUWAHATI,6205,All
2015,8,GUWAHATI,CHENNAI,1730,2171,CHENNAI-GUWAHATI,3901,All
2015,9,GUWAHATI,CHENNAI,1775,2645,CHENNAI-GUWAHATI,4420,All
2015,10,GUWAHATI,CHENNAI,2623,2553,CHENNAI-GUWAHATI,5176,All
2015,11,GUWAHATI,CHENNAI,2619,3145,CHENNAI-GUWAHATI,5764,All
2015,12,GUWAHATI,CHENNAI,2065,2182,CHENNAI-GUWAHATI,4247,All
2016,1,GUWAHATI,CHENNAI,3354,2940,CHENNAI-GUWAHATI,6294,All
2016,2,GUWAHATI,CHENNAI,2516,2257,CHENNAI-GUWAHATI,4773,All
2016,3,GUWAHATI,CHENNAI,2147,2021,CHENNAI-GUWAHATI,4168,All
2016,4,GUWAHATI,CHENNAI,5155,5985,CHENNAI-GUWAHATI,11140,All
2016,5,GUWAHATI,CHENNAI,5815,5577,CHENNAI-GUWAHATI,11392,All
2016,6,GUWAHATI,CHENNAI,5774,5587,CHENNAI-GUWAHATI,11361,All
2016,7,GUWAHATI,CHENNAI,8100,7537,CHENNAI-GUWAHATI,15637,All
2016,8,GUWAHATI,CHENNAI,6029,6035,CHENNAI-GUWAHATI,12064,All
2016,9,GUWAHATI,CHENNAI,5167,6284,CHENNAI-GUWAHATI,11451,All
2016,10,GUWAHATI,CHENNAI,6772,6506,CHENNAI-GUWAHATI,13278,All
2016,11,GUWAHATI,CHENNAI,7313,8667,CHENNAI-GUWAHATI,15980,All
2016,12,GUWAHATI,CHENNAI,10398,11411,CHENNAI-GUWAHATI,21809,All
2017,1,GUWAHATI,CHENNAI,10835,12052,CHENNAI-GUWAHATI,22887,All
2017,2,GUWAHATI,CHENNAI,8585,10526,CHENNAI-GUWAHATI,19111,All
2017,3,GUWAHATI,CHENNAI,9313,10540,CHENNAI-GUWAHATI,19853,All
2017,4,GUWAHATI,CHENNAI,11609,13804,CHENNAI-GUWAHATI,25413,All
2017,5,GUWAHATI,CHENNAI,12269,12877,CHENNAI-GUWAHATI,25146,All
2017,6,GUWAHATI,CHENNAI,11800,11943,CHENNAI-GUWAHATI,23743,All
2017,7,GUWAHATI,CHENNAI,8633,7418,CHENNAI-GUWAHATI,16051,All
2017,8,GUWAHATI,CHENNAI,6805,7093,CHENNAI-GUWAHATI,13898,All
2017,9,GUWAHATI,CHENNAI,7407,7401,CHENNAI-GUWAHATI,14808,All
2017,10,GUWAHATI,CHENNAI,7403,7128,CHENNAI-GUWAHATI,14531,All
2017,11,GUWAHATI,CHENNAI,7230,6721,CHENNAI-GUWAHATI,13951,All
2017,12,GUWAHATI,CHENNAI,9788,9740,CHENNAI-GUWAHATI,19528,All
2018,1,GUWAHATI,CHENNAI,11831,10644,CHENNAI-GUWAHATI,22475,All
2018,2,GUWAHATI,CHENNAI,8019,8554,CHENNAI-GUWAHATI,16573,All
2018,3,GUWAHATI,CHENNAI,14917,14546,CHENNAI-GUWAHATI,29463,All
2018,4,GUWAHATI,CHENNAI,14176,13881,CHENNAI-GUWAHATI,28057,All
2018,5,GUWAHATI,CHENNAI,15366,14783,CHENNAI-GUWAHATI,30149,All
2018,6,GUWAHATI,CHENNAI,14278,13092,CHENNAI-GUWAHATI,27370,All
2018,7,GUWAHATI,CHENNAI,16649,15640,CHENNAI-GUWAHATI,32289,All
2018,8,GUWAHATI,CHENNAI,11485,14398,CHENNAI-GUWAHATI,25883,All
2018,9,GUWAHATI,CHENNAI,11706,13744,CHENNAI-GUWAHATI,25450,All
2018,10,GUWAHATI,CHENNAI,14113,15614,CHENNAI-GUWAHATI,29727,All
2018,11,GUWAHATI,CHENNAI,12382,13638,CHENNAI-GUWAHATI,26020,All
2018,12,GUWAHATI,CHENNAI,15394,15116,CHENNAI-GUWAHATI,30510,All
2019,1,GUWAHATI,CHENNAI,13921,12966,CHENNAI-GUWAHATI,26887,All
2019,2,GUWAHATI,CHENNAI,8318,10173,CHENNAI-GUWAHATI,18491,All
2019,3,GUWAHATI,CHENNAI,11233,13648,CHENNAI-GUWAHATI,24881,All
2019,4,GUWAHATI,CHENNAI,14689,14434,CHENNAI-GUWAHATI,29123,All
2019,1,GUWAHATI,DABOLIM,1181,1395,DABOLIM-GUWAHATI,2576,All
2019,2,GUWAHATI,DABOLIM,491,470,DABOLIM-GUWAHATI,961,All
2019,3,GUWAHATI,DABOLIM,441,262,DABOLIM-GUWAHATI,703,All
2019,4,GUWAHATI,DABOLIM,860,538,DABOLIM-GUWAHATI,1398,All
2018,10,GUWAHATI,GANGTOK,250,191,GANGTOK-GUWAHATI,441,All
2018,11,GUWAHATI,GANGTOK,757,654,GANGTOK-GUWAHATI,1411,All
2018,12,GUWAHATI,GANGTOK,1047,953,GANGTOK-GUWAHATI,2000,All
2015,4,GUWAHATI,GOA,408,385,GOA-GUWAHATI,793,All
2015,6,GUWAHATI,GOA,227,282,GOA-GUWAHATI,509,All
2015,7,GUWAHATI,GOA,957,704,GOA-GUWAHATI,1661,All
2015,8,GUWAHATI,GOA,476,528,GOA-GUWAHATI,1004,All
2015,9,GUWAHATI,GOA,666,598,GOA-GUWAHATI,1264,All
2015,10,GUWAHATI,GOA,1169,1186,GOA-GUWAHATI,2355,All
2015,11,GUWAHATI,GOA,1082,975,GOA-GUWAHATI,2057,All
2015,12,GUWAHATI,GOA,957,1051,GOA-GUWAHATI,2008,All
2016,1,GUWAHATI,GOA,1453,1467,GOA-GUWAHATI,2920,All
2016,2,GUWAHATI,GOA,1036,1095,GOA-GUWAHATI,2131,All
2016,3,GUWAHATI,GOA,1111,997,GOA-GUWAHATI,2108,All
2016,4,GUWAHATI,GOA,752,853,GOA-GUWAHATI,1605,All
2016,5,GUWAHATI,GOA,460,432,GOA-GUWAHATI,892,All
2016,6,GUWAHATI,GOA,346,466,GOA-GUWAHATI,812,All
2016,7,GUWAHATI,GOA,570,558,GOA-GUWAHATI,1128,All
2016,8,GUWAHATI,GOA,175,275,GOA-GUWAHATI,450,All
2016,9,GUWAHATI,GOA,110,204,GOA-GUWAHATI,314,All
2016,10,GUWAHATI,GOA,404,532,GOA-GUWAHATI,936,All
2016,11,GUWAHATI,GOA,258,211,GOA-GUWAHATI,469,All
2016,12,GUWAHATI,GOA,479,734,GOA-GUWAHATI,1213,All
2017,1,GUWAHATI,GOA,870,806,GOA-GUWAHATI,1676,All
2017,2,GUWAHATI,GOA,437,564,GOA-GUWAHATI,1001,All
2017,3,GUWAHATI,GOA,496,569,GOA-GUWAHATI,1065,All
2017,4,GUWAHATI,GOA,513,695,GOA-GUWAHATI,1208,All
2017,5,GUWAHATI,GOA,323,401,GOA-GUWAHATI,724,All
2017,6,GUWAHATI,GOA,367,510,GOA-GUWAHATI,877,All
2017,7,GUWAHATI,GOA,701,650,GOA-GUWAHATI,1351,All
2017,8,GUWAHATI,GOA,211,398,GOA-GUWAHATI,609,All
2017,9,GUWAHATI,GOA,450,462,GOA-GUWAHATI,912,All
2017,10,GUWAHATI,GOA,374,500,GOA-GUWAHATI,874,All
2017,11,GUWAHATI,GOA,190,585,GOA-GUWAHATI,775,All
2017,12,GUWAHATI,GOA,197,503,GOA-GUWAHATI,700,All
2018,1,GUWAHATI,GOA,85,540,GOA-GUWAHATI,625,All
2018,2,GUWAHATI,GOA,239,385,GOA-GUWAHATI,624,All
2018,3,GUWAHATI,GOA,318,534,GOA-GUWAHATI,852,All
2018,4,GUWAHATI,GOA,798,667,GOA-GUWAHATI,1465,All
2018,5,GUWAHATI,GOA,623,542,GOA-GUWAHATI,1165,All
2018,6,GUWAHATI,GOA,352,440,GOA-GUWAHATI,792,All
2018,7,GUWAHATI,GOA,712,530,GOA-GUWAHATI,1242,All
2018,8,GUWAHATI,GOA,368,394,GOA-GUWAHATI,762,All
2018,9,GUWAHATI,GOA,603,637,GOA-GUWAHATI,1240,All
2018,10,GUWAHATI,GOA,1283,1261,GOA-GUWAHATI,2544,All
2018,11,GUWAHATI,GOA,531,578,GOA-GUWAHATI,1109,All
2018,12,GUWAHATI,GOA,991,1024,GOA-GUWAHATI,2015,All
2017,3,GUWAHATI,GORAKHPUR,0,22,GORAKHPUR-GUWAHATI,22,All
2017,4,GUWAHATI,GORAKHPUR,0,31,GORAKHPUR-GUWAHATI,31,All
2017,5,GUWAHATI,GORAKHPUR,0,67,GORAKHPUR-GUWAHATI,67,All
2017,6,GUWAHATI,GORAKHPUR,0,128,GORAKHPUR-GUWAHATI,128,All
2017,7,GUWAHATI,GORAKHPUR,0,122,GORAKHPUR-GUWAHATI,122,All
2017,8,GUWAHATI,GORAKHPUR,0,130,GORAKHPUR-GUWAHATI,130,All
2017,9,GUWAHATI,GORAKHPUR,0,95,GORAKHPUR-GUWAHATI,95,All
2017,10,GUWAHATI,GORAKHPUR,0,2,GORAKHPUR-GUWAHATI,2,All
2015,4,GUWAHATI,HYDERABAD,776,860,GUWAHATI-HYDERABAD,1636,All
2015,5,GUWAHATI,HYDERABAD,796,1142,GUWAHATI-HYDERABAD,1938,All
2015,6,GUWAHATI,HYDERABAD,994,1059,GUWAHATI-HYDERABAD,2053,All
2015,7,GUWAHATI,HYDERABAD,920,1013,GUWAHATI-HYDERABAD,1933,All
2015,8,GUWAHATI,HYDERABAD,659,793,GUWAHATI-HYDERABAD,1452,All
2015,9,GUWAHATI,HYDERABAD,504,536,GUWAHATI-HYDERABAD,1040,All
2015,10,GUWAHATI,HYDERABAD,638,591,GUWAHATI-HYDERABAD,1229,All
2015,11,GUWAHATI,HYDERABAD,584,792,GUWAHATI-HYDERABAD,1376,All
2015,12,GUWAHATI,HYDERABAD,591,527,GUWAHATI-HYDERABAD,1118,All
2016,1,GUWAHATI,HYDERABAD,894,1059,GUWAHATI-HYDERABAD,1953,All
2016,2,GUWAHATI,HYDERABAD,802,972,GUWAHATI-HYDERABAD,1774,All
2016,3,GUWAHATI,HYDERABAD,746,829,GUWAHATI-HYDERABAD,1575,All
2016,4,GUWAHATI,HYDERABAD,576,704,GUWAHATI-HYDERABAD,1280,All
2016,5,GUWAHATI,HYDERABAD,790,1173,GUWAHATI-HYDERABAD,1963,All
2016,6,GUWAHATI,HYDERABAD,771,614,GUWAHATI-HYDERABAD,1385,All
2016,7,GUWAHATI,HYDERABAD,521,472,GUWAHATI-HYDERABAD,993,All
2016,8,GUWAHATI,HYDERABAD,294,265,GUWAHATI-HYDERABAD,559,All
2016,9,GUWAHATI,HYDERABAD,204,284,GUWAHATI-HYDERABAD,488,All
2016,10,GUWAHATI,HYDERABAD,350,509,GUWAHATI-HYDERABAD,859,All
2016,11,GUWAHATI,HYDERABAD,716,1334,GUWAHATI-HYDERABAD,2050,All
2016,12,GUWAHATI,HYDERABAD,1254,1277,GUWAHATI-HYDERABAD,2531,All
2017,1,GUWAHATI,HYDERABAD,1189,1219,GUWAHATI-HYDERABAD,2408,All
2017,2,GUWAHATI,HYDERABAD,4304,1710,GUWAHATI-HYDERABAD,6014,All
2017,3,GUWAHATI,HYDERABAD,5754,4326,GUWAHATI-HYDERABAD,10080,All
2017,4,GUWAHATI,HYDERABAD,3473,3115,GUWAHATI-HYDERABAD,6588,All
2017,5,GUWAHATI,HYDERABAD,1218,1878,GUWAHATI-HYDERABAD,3096,All
2017,6,GUWAHATI,HYDERABAD,2924,2549,GUWAHATI-HYDERABAD,5473,All
2017,7,GUWAHATI,HYDERABAD,3420,2824,GUWAHATI-HYDERABAD,6244,All
2017,8,GUWAHATI,HYDERABAD,2939,2620,GUWAHATI-HYDERABAD,5559,All
2017,9,GUWAHATI,HYDERABAD,3349,2484,GUWAHATI-HYDERABAD,5833,All
2017,10,GUWAHATI,HYDERABAD,3533,3013,GUWAHATI-HYDERABAD,6546,All
2017,11,GUWAHATI,HYDERABAD,4085,3428,GUWAHATI-HYDERABAD,7513,All
2017,12,GUWAHATI,HYDERABAD,4697,3646,GUWAHATI-HYDERABAD,8343,All
2018,1,GUWAHATI,HYDERABAD,4822,3493,GUWAHATI-HYDERABAD,8315,All
2018,2,GUWAHATI,HYDERABAD,3454,2710,GUWAHATI-HYDERABAD,6164,All
2018,3,GUWAHATI,HYDERABAD,4589,3702,GUWAHATI-HYDERABAD,8291,All
2018,4,GUWAHATI,HYDERABAD,4407,4202,GUWAHATI-HYDERABAD,8609,All
2018,5,GUWAHATI,HYDERABAD,5662,4855,GUWAHATI-HYDERABAD,10517,All
2018,6,GUWAHATI,HYDERABAD,5238,4141,GUWAHATI-HYDERABAD,9379,All
2018,7,GUWAHATI,HYDERABAD,4983,3803,GUWAHATI-HYDERABAD,8786,All
2018,8,GUWAHATI,HYDERABAD,4082,4033,GUWAHATI-HYDERABAD,8115,All
2018,9,GUWAHATI,HYDERABAD,6031,6940,GUWAHATI-HYDERABAD,12971,All
2018,10,GUWAHATI,HYDERABAD,11781,12466,GUWAHATI-HYDERABAD,24247,All
2018,11,GUWAHATI,HYDERABAD,12143,12820,GUWAHATI-HYDERABAD,24963,All
2018,12,GUWAHATI,HYDERABAD,14363,14140,GUWAHATI-HYDERABAD,28503,All
2019,1,GUWAHATI,HYDERABAD,12572,13132,GUWAHATI-HYDERABAD,25704,All
2019,2,GUWAHATI,HYDERABAD,9929,11584,GUWAHATI-HYDERABAD,21513,All
2019,3,GUWAHATI,HYDERABAD,10019,12831,GUWAHATI-HYDERABAD,22850,All
2019,4,GUWAHATI,HYDERABAD,7693,11531,GUWAHATI-HYDERABAD,19224,All
2019,5,GUWAHATI,HYDERABAD,10635,11179,GUWAHATI-HYDERABAD,21814,All
2019,6,GUWAHATI,HYDERABAD,10454,9159,GUWAHATI-HYDERABAD,19613,All
2019,7,GUWAHATI,HYDERABAD,6952,6750,GUWAHATI-HYDERABAD,13702,All
2019,8,GUWAHATI,HYDERABAD,6444,5928,GUWAHATI-HYDERABAD,12372,All
2019,9,GUWAHATI,HYDERABAD,5335,5942,GUWAHATI-HYDERABAD,11277,All
2019,10,GUWAHATI,HYDERABAD,5899,5736,GUWAHATI-HYDERABAD,11635,All
2019,11,GUWAHATI,HYDERABAD,7936,7679,GUWAHATI-HYDERABAD,15615,All
2019,12,GUWAHATI,HYDERABAD,6823,6313,GUWAHATI-HYDERABAD,13136,All
2020,1,GUWAHATI,HYDERABAD,6522,6181,GUWAHATI-HYDERABAD,12703,All
2020,2,GUWAHATI,HYDERABAD,6050,5988,GUWAHATI-HYDERABAD,12038,All
2020,3,GUWAHATI,HYDERABAD,3976,4066,GUWAHATI-HYDERABAD,8042,All
2020,6,GUWAHATI,HYDERABAD,1167,2959,GUWAHATI-HYDERABAD,4126,All
2020,7,GUWAHATI,HYDERABAD,2243,3762,GUWAHATI-HYDERABAD,6005,All
2020,8,GUWAHATI,HYDERABAD,3320,3314,GUWAHATI-HYDERABAD,6634,All
2020,9,GUWAHATI,HYDERABAD,5644,3756,GUWAHATI-HYDERABAD,9400,All
2020,10,GUWAHATI,HYDERABAD,7133,3986,GUWAHATI-HYDERABAD,11119,All
2020,11,GUWAHATI,HYDERABAD,5664,4625,GUWAHATI-HYDERABAD,10289,All
2020,12,GUWAHATI,HYDERABAD,5683,5401,GUWAHATI-HYDERABAD,11084,All
2021,1,GUWAHATI,HYDERABAD,5335,4589,GUWAHATI-HYDERABAD,9924,All
2021,2,GUWAHATI,HYDERABAD,5647,4912,GUWAHATI-HYDERABAD,10559,All
2021,3,GUWAHATI,HYDERABAD,4809,5565,GUWAHATI-HYDERABAD,10374,All
2021,4,GUWAHATI,HYDERABAD,4502,5000,GUWAHATI-HYDERABAD,9502,All
2021,6,GUWAHATI,HYDERABAD,2042,1568,GUWAHATI-HYDERABAD,3610,All
2021,7,GUWAHATI,HYDERABAD,3159,2539,GUWAHATI-HYDERABAD,5698,All
2021,8,GUWAHATI,HYDERABAD,5901,3773,GUWAHATI-HYDERABAD,9674,All
2021,9,GUWAHATI,HYDERABAD,3970,3639,GUWAHATI-HYDERABAD,7609,All
2021,10,GUWAHATI,HYDERABAD,4421,4451,GUWAHATI-HYDERABAD,8872,All
2021,11,GUWAHATI,HYDERABAD,6215,7283,GUWAHATI-HYDERABAD,13498,All
2021,12,GUWAHATI,HYDERABAD,4751,5654,GUWAHATI-HYDERABAD,10405,All
2022,1,GUWAHATI,HYDERABAD,4018,4029,GUWAHATI-HYDERABAD,8047,All
2022,2,GUWAHATI,HYDERABAD,4293,4217,GUWAHATI-HYDERABAD,8510,All
2022,3,GUWAHATI,HYDERABAD,4719,4795,GUWAHATI-HYDERABAD,9514,All
2022,4,GUWAHATI,HYDERABAD,4830,4875,GUWAHATI-HYDERABAD,9705,All
2022,5,GUWAHATI,HYDERABAD,5117,4910,GUWAHATI-HYDERABAD,10027,All
2022,6,GUWAHATI,HYDERABAD,4631,4401,GUWAHATI-HYDERABAD,9032,All
2022,7,GUWAHATI,HYDERABAD,5059,4841,GUWAHATI-HYDERABAD,9900,All
2022,8,GUWAHATI,HYDERABAD,5795,5275,GUWAHATI-HYDERABAD,11070,All
2022,9,GUWAHATI,HYDERABAD,5365,5267,GUWAHATI-HYDERABAD,10632,All
2022,10,GUWAHATI,HYDERABAD,6099,6234,GUWAHATI-HYDERABAD,12333,All
2022,11,GUWAHATI,HYDERABAD,5096,4928,GUWAHATI-HYDERABAD,10024,All
2022,12,GUWAHATI,HYDERABAD,5052,5088,GUWAHATI-HYDERABAD,10140,All
2023,1,GUWAHATI,HYDERABAD,5183,5211,GUWAHATI-HYDERABAD,10394,All
2023,2,GUWAHATI,HYDERABAD,4127,4378,GUWAHATI-HYDERABAD,8505,All
2023,3,GUWAHATI,HYDERABAD,4867,4979,GUWAHATI-HYDERABAD,9846,All
2023,4,GUWAHATI,HYDERABAD,4807,4909,GUWAHATI-HYDERABAD,9716,All
2023,5,GUWAHATI,HYDERABAD,5298,5003,GUWAHATI-HYDERABAD,10301,All
2023,6,GUWAHATI,HYDERABAD,4687,4367,GUWAHATI-HYDERABAD,9054,All
2023,7,GUWAHATI,HYDERABAD,4833,4559,GUWAHATI-HYDERABAD,9392,All
2023,8,GUWAHATI,HYDERABAD,4250,4292,GUWAHATI-HYDERABAD,8542,All
2023,9,GUWAHATI,HYDERABAD,4445,4486,GUWAHATI-HYDERABAD,8931,All
2023,10,GUWAHATI,HYDERABAD,4958,5108,GUWAHATI-HYDERABAD,10066,All
2023,11,GUWAHATI,HYDERABAD,4872,4919,GUWAHATI-HYDERABAD,9791,All
2023,12,GUWAHATI,HYDERABAD,6414,6031,GUWAHATI-HYDERABAD,12445,All
2024,1,GUWAHATI,HYDERABAD,6376,6277,GUWAHATI-HYDERABAD,12653,All
2024,2,GUWAHATI,HYDERABAD,5744,5723,GUWAHATI-HYDERABAD,11467,All
2024,3,GUWAHATI,HYDERABAD,5924,6209,GUWAHATI-HYDERABAD,12133,All
2024,4,GUWAHATI,HYDERABAD,5970,6960,GUWAHATI-HYDERABAD,12930,All
2024,6,GUWAHATI,HYDERABAD,6297,5594,GUWAHATI-HYDERABAD,11891,All
2024,7,GUWAHATI,HYDERABAD,7471,6521,GUWAHATI-HYDERABAD,13992,All
2024,8,GUWAHATI,HYDERABAD,7721,7111,GUWAHATI-HYDERABAD,14832,All
2024,9,GUWAHATI,HYDERABAD,13063,13269,GUWAHATI-HYDERABAD,26332,All
2024,10,GUWAHATI,HYDERABAD,14687,15428,GUWAHATI-HYDERABAD,30115,All
2024,11,GUWAHATI,HYDERABAD,14096,13823,GUWAHATI-HYDERABAD,27919,All
2024,12,GUWAHATI,HYDERABAD,15125,15237,GUWAHATI-HYDERABAD,30362,All
2025,1,GUWAHATI,HYDERABAD,15138,14733,GUWAHATI-HYDERABAD,29871,All
2025,2,GUWAHATI,HYDERABAD,13218,13694,GUWAHATI-HYDERABAD,26912,All
2025,3,GUWAHATI,HYDERABAD,14280,14917,GUWAHATI-HYDERABAD,29197,All
2023,2,GUWAHATI,"Hollongi Airport, Itanagar",868,1190,"GUWAHATI-Hollongi Airport, Itanagar",2058,All
2023,3,GUWAHATI,"Hollongi Airport, Itanagar",805,1303,"GUWAHATI-Hollongi Airport, Itanagar",2108,All
2023,4,GUWAHATI,"Hollongi Airport, Itanagar",1031,1518,"GUWAHATI-Hollongi Airport, Itanagar",2549,All
2023,5,GUWAHATI,"Hollongi Airport, Itanagar",1048,1313,"GUWAHATI-Hollongi Airport, Itanagar",2361,All
2015,4,GUWAHATI,IMPHAL,6953,8583,GUWAHATI-IMPHAL,15536,All
2015,5,GUWAHATI,IMPHAL,7575,8428,GUWAHATI-IMPHAL,16003,All
2015,6,GUWAHATI,IMPHAL,8853,10733,GUWAHATI-IMPHAL,19586,All
2015,7,GUWAHATI,IMPHAL,10227,12767,GUWAHATI-IMPHAL,22994,All
2015,8,GUWAHATI,IMPHAL,10090,13445,GUWAHATI-IMPHAL,23535,All
2015,9,GUWAHATI,IMPHAL,13036,14827,GUWAHATI-IMPHAL,27863,All
2015,10,GUWAHATI,IMPHAL,23061,35269,GUWAHATI-IMPHAL,58330,All
2015,11,GUWAHATI,IMPHAL,12504,14016,GUWAHATI-IMPHAL,26520,All
2015,12,GUWAHATI,IMPHAL,15008,16455,GUWAHATI-IMPHAL,31463,All
2016,1,GUWAHATI,IMPHAL,13154,15629,GUWAHATI-IMPHAL,28783,All
2016,2,GUWAHATI,IMPHAL,14716,16256,GUWAHATI-IMPHAL,30972,All
2016,3,GUWAHATI,IMPHAL,19020,26703,GUWAHATI-IMPHAL,45723,All
2016,4,GUWAHATI,IMPHAL,14486,17157,GUWAHATI-IMPHAL,31643,All
2016,5,GUWAHATI,IMPHAL,20166,23295,GUWAHATI-IMPHAL,43461,All
2016,6,GUWAHATI,IMPHAL,14877,16239,GUWAHATI-IMPHAL,31116,All
2016,7,GUWAHATI,IMPHAL,15265,17164,GUWAHATI-IMPHAL,32429,All
2016,8,GUWAHATI,IMPHAL,15529,16950,GUWAHATI-IMPHAL,32479,All
2016,9,GUWAHATI,IMPHAL,16833,18599,GUWAHATI-IMPHAL,35432,All
2016,10,GUWAHATI,IMPHAL,18006,17529,GUWAHATI-IMPHAL,35535,All
2016,11,GUWAHATI,IMPHAL,13651,16070,GUWAHATI-IMPHAL,29721,All
2016,12,GUWAHATI,IMPHAL,13491,15821,GUWAHATI-IMPHAL,29312,All
2017,1,GUWAHATI,IMPHAL,14659,15358,GUWAHATI-IMPHAL,30017,All
2017,2,GUWAHATI,IMPHAL,13232,13907,GUWAHATI-IMPHAL,27139,All
2017,3,GUWAHATI,IMPHAL,13810,15115,GUWAHATI-IMPHAL,28925,All
2017,4,GUWAHATI,IMPHAL,13783,14657,GUWAHATI-IMPHAL,28440,All
2017,5,GUWAHATI,IMPHAL,14689,15484,GUWAHATI-IMPHAL,30173,All
2017,6,GUWAHATI,IMPHAL,14857,15797,GUWAHATI-IMPHAL,30654,All
2017,7,GUWAHATI,IMPHAL,16814,19943,GUWAHATI-IMPHAL,36757,All
2017,8,GUWAHATI,IMPHAL,15679,19246,GUWAHATI-IMPHAL,34925,All
2017,9,GUWAHATI,IMPHAL,16177,17922,GUWAHATI-IMPHAL,34099,All
2017,10,GUWAHATI,IMPHAL,18237,19643,GUWAHATI-IMPHAL,37880,All
2017,11,GUWAHATI,IMPHAL,18831,20149,GUWAHATI-IMPHAL,38980,All
2017,12,GUWAHATI,IMPHAL,18510,18662,GUWAHATI-IMPHAL,37172,All
2018,1,GUWAHATI,IMPHAL,17413,20849,GUWAHATI-IMPHAL,38262,All
2018,2,GUWAHATI,IMPHAL,16027,18110,GUWAHATI-IMPHAL,34137,All
2018,3,GUWAHATI,IMPHAL,18657,19713,GUWAHATI-IMPHAL,38370,All
2018,4,GUWAHATI,IMPHAL,17664,20096,GUWAHATI-IMPHAL,37760,All
2018,5,GUWAHATI,IMPHAL,18154,19241,GUWAHATI-IMPHAL,37395,All
2018,6,GUWAHATI,IMPHAL,22500,20244,GUWAHATI-IMPHAL,42744,All
2018,7,GUWAHATI,IMPHAL,25429,24481,GUWAHATI-IMPHAL,49910,All
2018,8,GUWAHATI,IMPHAL,20176,22860,GUWAHATI-IMPHAL,43036,All
2018,9,GUWAHATI,IMPHAL,20559,21540,GUWAHATI-IMPHAL,42099,All
2018,10,GUWAHATI,IMPHAL,22068,23294,GUWAHATI-IMPHAL,45362,All
2018,11,GUWAHATI,IMPHAL,21705,22157,GUWAHATI-IMPHAL,43862,All
2018,12,GUWAHATI,IMPHAL,24366,25250,GUWAHATI-IMPHAL,49616,All
2019,1,GUWAHATI,IMPHAL,22026,24478,GUWAHATI-IMPHAL,46504,All
2019,2,GUWAHATI,IMPHAL,18579,20555,GUWAHATI-IMPHAL,39134,All
2019,3,GUWAHATI,IMPHAL,20230,21198,GUWAHATI-IMPHAL,41428,All
2019,4,GUWAHATI,IMPHAL,18793,21846,GUWAHATI-IMPHAL,40639,All
2019,5,GUWAHATI,IMPHAL,21922,22558,GUWAHATI-IMPHAL,44480,All
2019,6,GUWAHATI,IMPHAL,23574,22608,GUWAHATI-IMPHAL,46182,All
2019,7,GUWAHATI,IMPHAL,24855,23924,GUWAHATI-IMPHAL,48779,All
2019,8,GUWAHATI,IMPHAL,24530,23244,GUWAHATI-IMPHAL,47774,All
2019,9,GUWAHATI,IMPHAL,24414,23295,GUWAHATI-IMPHAL,47709,All
2019,10,GUWAHATI,IMPHAL,22748,22232,GUWAHATI-IMPHAL,44980,All
2019,11,GUWAHATI,IMPHAL,19994,17629,GUWAHATI-IMPHAL,37623,All
2019,12,GUWAHATI,IMPHAL,20617,15070,GUWAHATI-IMPHAL,35687,All
2020,1,GUWAHATI,IMPHAL,19177,17126,GUWAHATI-IMPHAL,36303,All
2020,2,GUWAHATI,IMPHAL,17213,16053,GUWAHATI-IMPHAL,33266,All
2020,3,GUWAHATI,IMPHAL,15684,11007,GUWAHATI-IMPHAL,26691,All
2020,5,GUWAHATI,IMPHAL,1302,432,GUWAHATI-IMPHAL,1734,All
2020,6,GUWAHATI,IMPHAL,4622,2147,GUWAHATI-IMPHAL,6769,All
2020,7,GUWAHATI,IMPHAL,4655,2526,GUWAHATI-IMPHAL,7181,All
2020,8,GUWAHATI,IMPHAL,2844,3114,GUWAHATI-IMPHAL,5958,All
2020,9,GUWAHATI,IMPHAL,4816,5100,GUWAHATI-IMPHAL,9916,All
2020,10,GUWAHATI,IMPHAL,6303,6998,GUWAHATI-IMPHAL,13301,All
2020,11,GUWAHATI,IMPHAL,7530,9369,GUWAHATI-IMPHAL,16899,All
2020,12,GUWAHATI,IMPHAL,10398,10278,GUWAHATI-IMPHAL,20676,All
2021,1,GUWAHATI,IMPHAL,10518,14072,GUWAHATI-IMPHAL,24590,All
2021,2,GUWAHATI,IMPHAL,12191,13985,GUWAHATI-IMPHAL,26176,All
2021,3,GUWAHATI,IMPHAL,13422,14427,GUWAHATI-IMPHAL,27849,All
2021,4,GUWAHATI,IMPHAL,11543,10223,GUWAHATI-IMPHAL,21766,All
2021,6,GUWAHATI,IMPHAL,4151,4367,GUWAHATI-IMPHAL,8518,All
2021,7,GUWAHATI,IMPHAL,5411,7823,GUWAHATI-IMPHAL,13234,All
2021,8,GUWAHATI,IMPHAL,8606,10050,GUWAHATI-IMPHAL,18656,All
2021,9,GUWAHATI,IMPHAL,12539,13023,GUWAHATI-IMPHAL,25562,All
2021,10,GUWAHATI,IMPHAL,15360,16411,GUWAHATI-IMPHAL,31771,All
2021,11,GUWAHATI,IMPHAL,16675,17150,GUWAHATI-IMPHAL,33825,All
2021,12,GUWAHATI,IMPHAL,18413,15270,GUWAHATI-IMPHAL,33683,All
2022,1,GUWAHATI,IMPHAL,10843,13068,GUWAHATI-IMPHAL,23911,All
2022,2,GUWAHATI,IMPHAL,12160,11819,GUWAHATI-IMPHAL,23979,All
2022,3,GUWAHATI,IMPHAL,15250,19940,GUWAHATI-IMPHAL,35190,All
2022,4,GUWAHATI,IMPHAL,14278,16837,GUWAHATI-IMPHAL,31115,All
2022,5,GUWAHATI,IMPHAL,14812,15114,GUWAHATI-IMPHAL,29926,All
2022,6,GUWAHATI,IMPHAL,14096,14331,GUWAHATI-IMPHAL,28427,All
2022,7,GUWAHATI,IMPHAL,16537,17966,GUWAHATI-IMPHAL,34503,All
2022,8,GUWAHATI,IMPHAL,15361,17775,GUWAHATI-IMPHAL,33136,All
2022,9,GUWAHATI,IMPHAL,17338,19028,GUWAHATI-IMPHAL,36366,All
2022,10,GUWAHATI,IMPHAL,19634,19933,GUWAHATI-IMPHAL,39567,All
2022,11,GUWAHATI,IMPHAL,17257,19220,GUWAHATI-IMPHAL,36477,All
2022,12,GUWAHATI,IMPHAL,18205,17717,GUWAHATI-IMPHAL,35922,All
2023,1,GUWAHATI,IMPHAL,16444,19586,GUWAHATI-IMPHAL,36030,All
2023,2,GUWAHATI,IMPHAL,15626,19392,GUWAHATI-IMPHAL,35018,All
2023,3,GUWAHATI,IMPHAL,19692,21506,GUWAHATI-IMPHAL,41198,All
2023,4,GUWAHATI,IMPHAL,18173,20833,GUWAHATI-IMPHAL,39006,All
2023,5,GUWAHATI,IMPHAL,15126,24760,GUWAHATI-IMPHAL,39886,All
2023,6,GUWAHATI,IMPHAL,17546,21264,GUWAHATI-IMPHAL,38810,All
2023,7,GUWAHATI,IMPHAL,20987,20986,GUWAHATI-IMPHAL,41973,All
2023,8,GUWAHATI,IMPHAL,20203,21310,GUWAHATI-IMPHAL,41513,All
2023,9,GUWAHATI,IMPHAL,18424,19093,GUWAHATI-IMPHAL,37517,All
2023,10,GUWAHATI,IMPHAL,21253,21616,GUWAHATI-IMPHAL,42869,All
2023,11,GUWAHATI,IMPHAL,21053,20691,GUWAHATI-IMPHAL,41744,All
2023,12,GUWAHATI,IMPHAL,20829,19732,GUWAHATI-IMPHAL,40561,All
2024,1,GUWAHATI,IMPHAL,19417,20635,GUWAHATI-IMPHAL,40052,All
2024,2,GUWAHATI,IMPHAL,20549,20394,GUWAHATI-IMPHAL,40943,All
2024,3,GUWAHATI,IMPHAL,21734,23010,GUWAHATI-IMPHAL,44744,All
2024,4,GUWAHATI,IMPHAL,20537,21972,GUWAHATI-IMPHAL,42509,All
2024,6,GUWAHATI,IMPHAL,22574,20010,GUWAHATI-IMPHAL,42584,All
2024,7,GUWAHATI,IMPHAL,21104,21856,GUWAHATI-IMPHAL,42960,All
2024,8,GUWAHATI,IMPHAL,21162,22730,GUWAHATI-IMPHAL,43892,All
2024,9,GUWAHATI,IMPHAL,18935,21339,GUWAHATI-IMPHAL,40274,All
2024,10,GUWAHATI,IMPHAL,24342,23418,GUWAHATI-IMPHAL,47760,All
2024,11,GUWAHATI,IMPHAL,20268,22333,GUWAHATI-IMPHAL,42601,All
2024,12,GUWAHATI,IMPHAL,21362,20159,GUWAHATI-IMPHAL,41521,All
2025,1,GUWAHATI,IMPHAL,20610,20718,GUWAHATI-IMPHAL,41328,All
2025,2,GUWAHATI,IMPHAL,20192,22320,GUWAHATI-IMPHAL,42512,All
2025,3,GUWAHATI,IMPHAL,25184,23504,GUWAHATI-IMPHAL,48688,All
2019,2,GUWAHATI,INDORE,28,0,GUWAHATI-INDORE,28,All
2019,3,GUWAHATI,INDORE,114,0,GUWAHATI-INDORE,114,All
2023,6,GUWAHATI,Itanagar,1012,1250,GUWAHATI-Itanagar,2262,All
2023,7,GUWAHATI,Itanagar,1024,1462,GUWAHATI-Itanagar,2486,All
2023,8,GUWAHATI,Itanagar,1018,1417,GUWAHATI-Itanagar,2435,All
2023,9,GUWAHATI,Itanagar,1338,1519,GUWAHATI-Itanagar,2857,All
2023,10,GUWAHATI,Itanagar,926,1134,GUWAHATI-Itanagar,2060,All
2023,11,GUWAHATI,Itanagar,107,123,GUWAHATI-Itanagar,230,All
2024,8,GUWAHATI,Itanagar,30,26,GUWAHATI-Itanagar,56,All
2024,9,GUWAHATI,Itanagar,148,109,GUWAHATI-Itanagar,257,All
2024,10,GUWAHATI,Itanagar,100,86,GUWAHATI-Itanagar,186,All
2024,11,GUWAHATI,Itanagar,62,49,GUWAHATI-Itanagar,111,All
2024,12,GUWAHATI,Itanagar,138,131,GUWAHATI-Itanagar,269,All
2025,1,GUWAHATI,Itanagar,121,106,GUWAHATI-Itanagar,227,All
2025,2,GUWAHATI,Itanagar,121,110,GUWAHATI-Itanagar,231,All
2025,3,GUWAHATI,Itanagar,102,73,GUWAHATI-Itanagar,175,All
2015,4,GUWAHATI,JAIPUR,1571,1376,GUWAHATI-JAIPUR,2947,All
2015,5,GUWAHATI,JAIPUR,1408,1718,GUWAHATI-JAIPUR,3126,All
2015,6,GUWAHATI,JAIPUR,1648,1426,GUWAHATI-JAIPUR,3074,All
2015,7,GUWAHATI,JAIPUR,1432,1138,GUWAHATI-JAIPUR,2570,All
2015,8,GUWAHATI,JAIPUR,813,832,GUWAHATI-JAIPUR,1645,All
2015,9,GUWAHATI,JAIPUR,931,902,GUWAHATI-JAIPUR,1833,All
2015,10,GUWAHATI,JAIPUR,725,749,GUWAHATI-JAIPUR,1474,All
2015,11,GUWAHATI,JAIPUR,1590,1455,GUWAHATI-JAIPUR,3045,All
2015,12,GUWAHATI,JAIPUR,1242,1543,GUWAHATI-JAIPUR,2785,All
2016,1,GUWAHATI,JAIPUR,1613,1459,GUWAHATI-JAIPUR,3072,All
2016,2,GUWAHATI,JAIPUR,1257,1166,GUWAHATI-JAIPUR,2423,All
2016,3,GUWAHATI,JAIPUR,1293,1226,GUWAHATI-JAIPUR,2519,All
2016,4,GUWAHATI,JAIPUR,1350,1177,GUWAHATI-JAIPUR,2527,All
2016,5,GUWAHATI,JAIPUR,977,1079,GUWAHATI-JAIPUR,2056,All
2016,6,GUWAHATI,JAIPUR,1075,1032,GUWAHATI-JAIPUR,2107,All
2016,7,GUWAHATI,JAIPUR,1369,1174,GUWAHATI-JAIPUR,2543,All
2016,8,GUWAHATI,JAIPUR,802,938,GUWAHATI-JAIPUR,1740,All
2016,9,GUWAHATI,JAIPUR,584,711,GUWAHATI-JAIPUR,1295,All
2016,10,GUWAHATI,JAIPUR,662,713,GUWAHATI-JAIPUR,1375,All
2016,11,GUWAHATI,JAIPUR,1393,1295,GUWAHATI-JAIPUR,2688,All
2016,12,GUWAHATI,JAIPUR,1046,1319,GUWAHATI-JAIPUR,2365,All
2017,1,GUWAHATI,JAIPUR,1208,1210,GUWAHATI-JAIPUR,2418,All
2017,2,GUWAHATI,JAIPUR,1101,1187,GUWAHATI-JAIPUR,2288,All
2017,3,GUWAHATI,JAIPUR,1082,1146,GUWAHATI-JAIPUR,2228,All
2017,4,GUWAHATI,JAIPUR,1357,1249,GUWAHATI-JAIPUR,2606,All
2017,5,GUWAHATI,JAIPUR,1143,1357,GUWAHATI-JAIPUR,2500,All
2017,6,GUWAHATI,JAIPUR,1861,1688,GUWAHATI-JAIPUR,3549,All
2017,7,GUWAHATI,JAIPUR,6091,5463,GUWAHATI-JAIPUR,11554,All
2017,8,GUWAHATI,JAIPUR,5486,5469,GUWAHATI-JAIPUR,10955,All
2017,9,GUWAHATI,JAIPUR,5380,5374,GUWAHATI-JAIPUR,10754,All
2017,10,GUWAHATI,JAIPUR,5764,5421,GUWAHATI-JAIPUR,11185,All
2017,11,GUWAHATI,JAIPUR,6286,5422,GUWAHATI-JAIPUR,11708,All
2017,12,GUWAHATI,JAIPUR,5685,5924,GUWAHATI-JAIPUR,11609,All
2018,1,GUWAHATI,JAIPUR,5506,5304,GUWAHATI-JAIPUR,10810,All
2018,2,GUWAHATI,JAIPUR,5372,4912,GUWAHATI-JAIPUR,10284,All
2018,3,GUWAHATI,JAIPUR,4696,5017,GUWAHATI-JAIPUR,9713,All
2018,4,GUWAHATI,JAIPUR,5778,4919,GUWAHATI-JAIPUR,10697,All
2018,5,GUWAHATI,JAIPUR,5383,5572,GUWAHATI-JAIPUR,10955,All
2018,6,GUWAHATI,JAIPUR,5769,5561,GUWAHATI-JAIPUR,11330,All
2018,7,GUWAHATI,JAIPUR,5946,5629,GUWAHATI-JAIPUR,11575,All
2018,8,GUWAHATI,JAIPUR,4944,4898,GUWAHATI-JAIPUR,9842,All
2018,9,GUWAHATI,JAIPUR,5839,5896,GUWAHATI-JAIPUR,11735,All
2018,10,GUWAHATI,JAIPUR,7808,7478,GUWAHATI-JAIPUR,15286,All
2018,11,GUWAHATI,JAIPUR,5941,5706,GUWAHATI-JAIPUR,11647,All
2018,12,GUWAHATI,JAIPUR,5797,5884,GUWAHATI-JAIPUR,11681,All
2019,1,GUWAHATI,JAIPUR,6009,5663,GUWAHATI-JAIPUR,11672,All
2019,2,GUWAHATI,JAIPUR,5190,5161,GUWAHATI-JAIPUR,10351,All
2019,3,GUWAHATI,JAIPUR,5383,5192,GUWAHATI-JAIPUR,10575,All
2019,4,GUWAHATI,JAIPUR,5155,4585,GUWAHATI-JAIPUR,9740,All
2019,5,GUWAHATI,JAIPUR,4799,5391,GUWAHATI-JAIPUR,10190,All
2019,6,GUWAHATI,JAIPUR,4951,5222,GUWAHATI-JAIPUR,10173,All
2019,7,GUWAHATI,JAIPUR,4851,4596,GUWAHATI-JAIPUR,9447,All
2019,8,GUWAHATI,JAIPUR,4298,4338,GUWAHATI-JAIPUR,8636,All
2019,9,GUWAHATI,JAIPUR,4037,3895,GUWAHATI-JAIPUR,7932,All
2019,10,GUWAHATI,JAIPUR,5109,4697,GUWAHATI-JAIPUR,9806,All
2019,11,GUWAHATI,JAIPUR,5726,5196,GUWAHATI-JAIPUR,10922,All
2019,12,GUWAHATI,JAIPUR,5398,5406,GUWAHATI-JAIPUR,10804,All
2020,1,GUWAHATI,JAIPUR,5988,5235,GUWAHATI-JAIPUR,11223,All
2020,2,GUWAHATI,JAIPUR,5161,4967,GUWAHATI-JAIPUR,10128,All
2020,3,GUWAHATI,JAIPUR,3095,3668,GUWAHATI-JAIPUR,6763,All
2020,6,GUWAHATI,JAIPUR,4078,4299,GUWAHATI-JAIPUR,8377,All
2020,7,GUWAHATI,JAIPUR,3069,2558,GUWAHATI-JAIPUR,5627,All
2020,8,GUWAHATI,JAIPUR,3610,4046,GUWAHATI-JAIPUR,7656,All
2020,9,GUWAHATI,JAIPUR,4133,4113,GUWAHATI-JAIPUR,8246,All
2020,10,GUWAHATI,JAIPUR,4365,3987,GUWAHATI-JAIPUR,8352,All
2020,11,GUWAHATI,JAIPUR,5354,4382,GUWAHATI-JAIPUR,9736,All
2020,12,GUWAHATI,JAIPUR,5019,7055,GUWAHATI-JAIPUR,12074,All
2021,1,GUWAHATI,JAIPUR,6380,6991,GUWAHATI-JAIPUR,13371,All
2021,2,GUWAHATI,JAIPUR,6769,7104,GUWAHATI-JAIPUR,13873,All
2021,3,GUWAHATI,JAIPUR,6929,6831,GUWAHATI-JAIPUR,13760,All
2021,4,GUWAHATI,JAIPUR,5040,4711,GUWAHATI-JAIPUR,9751,All
2021,6,GUWAHATI,JAIPUR,1927,1878,GUWAHATI-JAIPUR,3805,All
2021,7,GUWAHATI,JAIPUR,3308,2986,GUWAHATI-JAIPUR,6294,All
2021,8,GUWAHATI,JAIPUR,3796,3476,GUWAHATI-JAIPUR,7272,All
2021,9,GUWAHATI,JAIPUR,4184,4409,GUWAHATI-JAIPUR,8593,All
2021,10,GUWAHATI,JAIPUR,6312,6284,GUWAHATI-JAIPUR,12596,All
2021,11,GUWAHATI,JAIPUR,5491,5158,GUWAHATI-JAIPUR,10649,All
2021,12,GUWAHATI,JAIPUR,4804,5773,GUWAHATI-JAIPUR,10577,All
2022,1,GUWAHATI,JAIPUR,3094,3607,GUWAHATI-JAIPUR,6701,All
2022,2,GUWAHATI,JAIPUR,4083,4160,GUWAHATI-JAIPUR,8243,All
2022,3,GUWAHATI,JAIPUR,4418,4423,GUWAHATI-JAIPUR,8841,All
2022,4,GUWAHATI,JAIPUR,6001,6065,GUWAHATI-JAIPUR,12066,All
2022,5,GUWAHATI,JAIPUR,5216,5895,GUWAHATI-JAIPUR,11111,All
2022,6,GUWAHATI,JAIPUR,6631,5859,GUWAHATI-JAIPUR,12490,All
2022,7,GUWAHATI,JAIPUR,7371,7033,GUWAHATI-JAIPUR,14404,All
2022,8,GUWAHATI,JAIPUR,4441,4492,GUWAHATI-JAIPUR,8933,All
2022,9,GUWAHATI,JAIPUR,3936,4086,GUWAHATI-JAIPUR,8022,All
2022,10,GUWAHATI,JAIPUR,4636,5124,GUWAHATI-JAIPUR,9760,All
2022,11,GUWAHATI,JAIPUR,5332,5515,GUWAHATI-JAIPUR,10847,All
2022,12,GUWAHATI,JAIPUR,4758,5946,GUWAHATI-JAIPUR,10704,All
2023,1,GUWAHATI,JAIPUR,5060,5295,GUWAHATI-JAIPUR,10355,All
2023,2,GUWAHATI,JAIPUR,4818,4920,GUWAHATI-JAIPUR,9738,All
2023,3,GUWAHATI,JAIPUR,5263,5529,GUWAHATI-JAIPUR,10792,All
2023,4,GUWAHATI,JAIPUR,4794,5352,GUWAHATI-JAIPUR,10146,All
2023,5,GUWAHATI,JAIPUR,2163,2547,GUWAHATI-JAIPUR,4710,All
2023,6,GUWAHATI,JAIPUR,856,642,GUWAHATI-JAIPUR,1498,All
2023,7,GUWAHATI,JAIPUR,775,870,GUWAHATI-JAIPUR,1645,All
2023,8,GUWAHATI,JAIPUR,690,561,GUWAHATI-JAIPUR,1251,All
2023,9,GUWAHATI,JAIPUR,339,373,GUWAHATI-JAIPUR,712,All
2023,10,GUWAHATI,JAIPUR,695,736,GUWAHATI-JAIPUR,1431,All
2023,11,GUWAHATI,JAIPUR,4430,4966,GUWAHATI-JAIPUR,9396,All
2023,12,GUWAHATI,JAIPUR,4639,5481,GUWAHATI-JAIPUR,10120,All
2024,1,GUWAHATI,JAIPUR,5158,5005,GUWAHATI-JAIPUR,10163,All
2024,2,GUWAHATI,JAIPUR,4749,5088,GUWAHATI-JAIPUR,9837,All
2024,3,GUWAHATI,JAIPUR,4821,5388,GUWAHATI-JAIPUR,10209,All
2024,4,GUWAHATI,JAIPUR,852,913,GUWAHATI-JAIPUR,1765,All
2024,6,GUWAHATI,JAIPUR,1670,1514,GUWAHATI-JAIPUR,3184,All
2024,7,GUWAHATI,JAIPUR,1951,1675,GUWAHATI-JAIPUR,3626,All
2024,8,GUWAHATI,JAIPUR,3076,2850,GUWAHATI-JAIPUR,5926,All
2024,9,GUWAHATI,JAIPUR,3538,3570,GUWAHATI-JAIPUR,7108,All
2024,10,GUWAHATI,JAIPUR,4822,5307,GUWAHATI-JAIPUR,10129,All
2024,11,GUWAHATI,JAIPUR,4964,5123,GUWAHATI-JAIPUR,10087,All
2024,12,GUWAHATI,JAIPUR,5046,5529,GUWAHATI-JAIPUR,10575,All
2025,1,GUWAHATI,JAIPUR,4964,4498,GUWAHATI-JAIPUR,9462,All
2025,2,GUWAHATI,JAIPUR,4374,4334,GUWAHATI-JAIPUR,8708,All
2025,3,GUWAHATI,JAIPUR,4755,5387,GUWAHATI-JAIPUR,10142,All
2020,12,GUWAHATI,JAMMU,57,0,GUWAHATI-JAMMU,57,All
2021,1,GUWAHATI,JAMMU,78,0,GUWAHATI-JAMMU,78,All
2021,2,GUWAHATI,JAMMU,7,0,GUWAHATI-JAMMU,7,All
2021,6,GUWAHATI,JHARSUGUDA,0,10,GUWAHATI-JHARSUGUDA,10,All
2021,7,GUWAHATI,JHARSUGUDA,0,22,GUWAHATI-JHARSUGUDA,22,All
2021,8,GUWAHATI,JHARSUGUDA,0,5,GUWAHATI-JHARSUGUDA,5,All
2021,11,GUWAHATI,JODHPUR,168,135,GUWAHATI-JODHPUR,303,All
2021,12,GUWAHATI,JODHPUR,236,143,GUWAHATI-JODHPUR,379,All
2022,1,GUWAHATI,JODHPUR,47,77,GUWAHATI-JODHPUR,124,All
2022,2,GUWAHATI,JODHPUR,0,30,GUWAHATI-JODHPUR,30,All
2022,3,GUWAHATI,JODHPUR,142,95,GUWAHATI-JODHPUR,237,All
2022,4,GUWAHATI,JODHPUR,185,286,GUWAHATI-JODHPUR,471,All
2022,5,GUWAHATI,JODHPUR,41,168,GUWAHATI-JODHPUR,209,All
2022,6,GUWAHATI,JODHPUR,69,150,GUWAHATI-JODHPUR,219,All
2022,7,GUWAHATI,JODHPUR,131,131,GUWAHATI-JODHPUR,262,All
2022,8,GUWAHATI,JODHPUR,105,129,GUWAHATI-JODHPUR,234,All
2022,9,GUWAHATI,JODHPUR,8,62,GUWAHATI-JODHPUR,70,All
2022,10,GUWAHATI,JODHPUR,152,71,GUWAHATI-JODHPUR,223,All
2022,11,GUWAHATI,JODHPUR,206,208,GUWAHATI-JODHPUR,414,All
2022,12,GUWAHATI,JODHPUR,138,106,GUWAHATI-JODHPUR,244,All
2023,1,GUWAHATI,JODHPUR,23,176,GUWAHATI-JODHPUR,199,All
2023,2,GUWAHATI,JODHPUR,238,218,GUWAHATI-JODHPUR,456,All
2023,8,GUWAHATI,JODHPUR,46,8,GUWAHATI-JODHPUR,54,All
2023,10,GUWAHATI,JODHPUR,33,28,GUWAHATI-JODHPUR,61,All
2015,4,GUWAHATI,JORHAT,262,337,GUWAHATI-JORHAT,599,All
2015,5,GUWAHATI,JORHAT,305,387,GUWAHATI-JORHAT,692,All
2015,6,GUWAHATI,JORHAT,270,300,GUWAHATI-JORHAT,570,All
2015,7,GUWAHATI,JORHAT,373,393,GUWAHATI-JORHAT,766,All
2015,8,GUWAHATI,JORHAT,401,445,GUWAHATI-JORHAT,846,All
2015,9,GUWAHATI,JORHAT,312,319,GUWAHATI-JORHAT,631,All
2015,10,GUWAHATI,JORHAT,318,383,GUWAHATI-JORHAT,701,All
2015,11,GUWAHATI,JORHAT,337,346,GUWAHATI-JORHAT,683,All
2015,12,GUWAHATI,JORHAT,350,349,GUWAHATI-JORHAT,699,All
2016,1,GUWAHATI,JORHAT,242,351,GUWAHATI-JORHAT,593,All
2016,2,GUWAHATI,JORHAT,261,268,GUWAHATI-JORHAT,529,All
2016,3,GUWAHATI,JORHAT,307,356,GUWAHATI-JORHAT,663,All
2016,4,GUWAHATI,JORHAT,231,581,GUWAHATI-JORHAT,812,All
2016,5,GUWAHATI,JORHAT,364,600,GUWAHATI-JORHAT,964,All
2016,6,GUWAHATI,JORHAT,329,741,GUWAHATI-JORHAT,1070,All
2016,7,GUWAHATI,JORHAT,364,619,GUWAHATI-JORHAT,983,All
2016,8,GUWAHATI,JORHAT,296,696,GUWAHATI-JORHAT,992,All
2016,9,GUWAHATI,JORHAT,334,787,GUWAHATI-JORHAT,1121,All
2016,10,GUWAHATI,JORHAT,322,759,GUWAHATI-JORHAT,1081,All
2016,11,GUWAHATI,JORHAT,983,941,GUWAHATI-JORHAT,1924,All
2016,12,GUWAHATI,JORHAT,1234,1071,GUWAHATI-JORHAT,2305,All
2017,1,GUWAHATI,JORHAT,1331,1230,GUWAHATI-JORHAT,2561,All
2017,2,GUWAHATI,JORHAT,1204,1111,GUWAHATI-JORHAT,2315,All
2017,3,GUWAHATI,JORHAT,1337,1237,GUWAHATI-JORHAT,2574,All
2017,4,GUWAHATI,JORHAT,1142,1266,GUWAHATI-JORHAT,2408,All
2017,5,GUWAHATI,JORHAT,1243,918,GUWAHATI-JORHAT,2161,All
2017,6,GUWAHATI,JORHAT,1239,1258,GUWAHATI-JORHAT,2497,All
2017,7,GUWAHATI,JORHAT,1340,1300,GUWAHATI-JORHAT,2640,All
2017,8,GUWAHATI,JORHAT,1585,1459,GUWAHATI-JORHAT,3044,All
2017,9,GUWAHATI,JORHAT,1437,1204,GUWAHATI-JORHAT,2641,All
2017,10,GUWAHATI,JORHAT,954,1116,GUWAHATI-JORHAT,2070,All
2017,11,GUWAHATI,JORHAT,1399,1200,GUWAHATI-JORHAT,2599,All
2017,12,GUWAHATI,JORHAT,1366,1149,GUWAHATI-JORHAT,2515,All
2018,1,GUWAHATI,JORHAT,1174,1251,GUWAHATI-JORHAT,2425,All
2018,2,GUWAHATI,JORHAT,1422,1514,GUWAHATI-JORHAT,2936,All
2018,3,GUWAHATI,JORHAT,1548,1634,GUWAHATI-JORHAT,3182,All
2018,4,GUWAHATI,JORHAT,1588,1865,GUWAHATI-JORHAT,3453,All
2018,5,GUWAHATI,JORHAT,1570,1829,GUWAHATI-JORHAT,3399,All
2018,6,GUWAHATI,JORHAT,1644,2197,GUWAHATI-JORHAT,3841,All
2018,7,GUWAHATI,JORHAT,1956,2416,GUWAHATI-JORHAT,4372,All
2018,8,GUWAHATI,JORHAT,908,1175,GUWAHATI-JORHAT,2083,All
2018,9,GUWAHATI,JORHAT,1831,1591,GUWAHATI-JORHAT,3422,All
2018,10,GUWAHATI,JORHAT,1783,1490,GUWAHATI-JORHAT,3273,All
2018,11,GUWAHATI,JORHAT,2030,1767,GUWAHATI-JORHAT,3797,All
2018,12,GUWAHATI,JORHAT,2704,2690,GUWAHATI-JORHAT,5394,All
2019,1,GUWAHATI,JORHAT,3082,3390,GUWAHATI-JORHAT,6472,All
2019,2,GUWAHATI,JORHAT,991,978,GUWAHATI-JORHAT,1969,All
2019,10,GUWAHATI,JORHAT,114,159,GUWAHATI-JORHAT,273,All
2019,11,GUWAHATI,JORHAT,1167,948,GUWAHATI-JORHAT,2115,All
2019,12,GUWAHATI,JORHAT,1307,1639,GUWAHATI-JORHAT,2946,All
2020,1,GUWAHATI,JORHAT,1430,1437,GUWAHATI-JORHAT,2867,All
2020,2,GUWAHATI,JORHAT,1517,1633,GUWAHATI-JORHAT,3150,All
2020,3,GUWAHATI,JORHAT,1112,972,GUWAHATI-JORHAT,2084,All
2020,7,GUWAHATI,JORHAT,17,81,GUWAHATI-JORHAT,98,All
2020,8,GUWAHATI,JORHAT,79,318,GUWAHATI-JORHAT,397,All
2020,9,GUWAHATI,JORHAT,433,554,GUWAHATI-JORHAT,987,All
2020,10,GUWAHATI,JORHAT,630,851,GUWAHATI-JORHAT,1481,All
2020,11,GUWAHATI,JORHAT,960,972,GUWAHATI-JORHAT,1932,All
2020,12,GUWAHATI,JORHAT,685,891,GUWAHATI-JORHAT,1576,All
2021,1,GUWAHATI,JORHAT,657,904,GUWAHATI-JORHAT,1561,All
2021,2,GUWAHATI,JORHAT,592,1035,GUWAHATI-JORHAT,1627,All
2021,3,GUWAHATI,JORHAT,506,754,GUWAHATI-JORHAT,1260,All
2021,4,GUWAHATI,JORHAT,449,478,GUWAHATI-JORHAT,927,All
2021,6,GUWAHATI,JORHAT,185,425,GUWAHATI-JORHAT,610,All
2021,7,GUWAHATI,JORHAT,322,572,GUWAHATI-JORHAT,894,All
2021,8,GUWAHATI,JORHAT,642,1322,GUWAHATI-JORHAT,1964,All
2021,9,GUWAHATI,JORHAT,773,1404,GUWAHATI-JORHAT,2177,All
2021,10,GUWAHATI,JORHAT,768,1233,GUWAHATI-JORHAT,2001,All
2021,11,GUWAHATI,JORHAT,381,701,GUWAHATI-JORHAT,1082,All
2021,12,GUWAHATI,JORHAT,425,723,GUWAHATI-JORHAT,1148,All
2022,1,GUWAHATI,JORHAT,286,528,GUWAHATI-JORHAT,814,All
2022,2,GUWAHATI,JORHAT,292,702,GUWAHATI-JORHAT,994,All
2022,3,GUWAHATI,JORHAT,911,1165,GUWAHATI-JORHAT,2076,All
2022,4,GUWAHATI,JORHAT,666,799,GUWAHATI-JORHAT,1465,All
2022,5,GUWAHATI,JORHAT,421,632,GUWAHATI-JORHAT,1053,All
2022,6,GUWAHATI,JORHAT,927,1094,GUWAHATI-JORHAT,2021,All
2022,7,GUWAHATI,JORHAT,1455,1671,GUWAHATI-JORHAT,3126,All
2022,8,GUWAHATI,JORHAT,1424,1804,GUWAHATI-JORHAT,3228,All
2022,9,GUWAHATI,JORHAT,1188,1367,GUWAHATI-JORHAT,2555,All
2022,10,GUWAHATI,JORHAT,1195,1018,GUWAHATI-JORHAT,2213,All
2022,11,GUWAHATI,JORHAT,754,757,GUWAHATI-JORHAT,1511,All
2022,12,GUWAHATI,JORHAT,679,878,GUWAHATI-JORHAT,1557,All
2023,1,GUWAHATI,JORHAT,770,1032,GUWAHATI-JORHAT,1802,All
2023,2,GUWAHATI,JORHAT,982,1120,GUWAHATI-JORHAT,2102,All
2023,3,GUWAHATI,JORHAT,1098,1129,GUWAHATI-JORHAT,2227,All
2023,4,GUWAHATI,JORHAT,1352,1418,GUWAHATI-JORHAT,2770,All
2023,5,GUWAHATI,JORHAT,1349,1217,GUWAHATI-JORHAT,2566,All
2023,6,GUWAHATI,JORHAT,1241,1170,GUWAHATI-JORHAT,2411,All
2023,7,GUWAHATI,JORHAT,1635,1137,GUWAHATI-JORHAT,2772,All
2023,8,GUWAHATI,JORHAT,1722,1214,GUWAHATI-JORHAT,2936,All
2023,9,GUWAHATI,JORHAT,1773,1239,GUWAHATI-JORHAT,3012,All
2023,10,GUWAHATI,JORHAT,1853,1266,GUWAHATI-JORHAT,3119,All
2023,11,GUWAHATI,JORHAT,2036,1378,GUWAHATI-JORHAT,3414,All
2023,12,GUWAHATI,JORHAT,1793,1639,GUWAHATI-JORHAT,3432,All
2024,1,GUWAHATI,JORHAT,1408,1536,GUWAHATI-JORHAT,2944,All
2024,2,GUWAHATI,JORHAT,1394,1399,GUWAHATI-JORHAT,2793,All
2024,3,GUWAHATI,JORHAT,1658,1313,GUWAHATI-JORHAT,2971,All
2025,2,GUWAHATI,JORHAT,8,0,GUWAHATI-JORHAT,8,All
2019,5,GUWAHATI,KOCHI,5543,6390,GUWAHATI-KOCHI,11933,All
2019,6,GUWAHATI,KOCHI,5827,6195,GUWAHATI-KOCHI,12022,All
2019,7,GUWAHATI,KOCHI,1447,0,GUWAHATI-KOCHI,1447,All
2019,8,GUWAHATI,KOCHI,1502,0,GUWAHATI-KOCHI,1502,All
2019,9,GUWAHATI,KOCHI,1475,0,GUWAHATI-KOCHI,1475,All
2019,10,GUWAHATI,KOCHI,1016,0,GUWAHATI-KOCHI,1016,All
2019,11,GUWAHATI,KOCHI,1255,162,GUWAHATI-KOCHI,1417,All
2019,12,GUWAHATI,KOCHI,2567,0,GUWAHATI-KOCHI,2567,All
2020,1,GUWAHATI,KOCHI,1584,0,GUWAHATI-KOCHI,1584,All
2020,2,GUWAHATI,KOCHI,1849,0,GUWAHATI-KOCHI,1849,All
2020,3,GUWAHATI,KOCHI,1301,0,GUWAHATI-KOCHI,1301,All
2020,9,GUWAHATI,KOCHI,801,303,GUWAHATI-KOCHI,1104,All
2020,10,GUWAHATI,KOCHI,2080,1005,GUWAHATI-KOCHI,3085,All
2020,11,GUWAHATI,KOCHI,427,793,GUWAHATI-KOCHI,1220,All
2020,12,GUWAHATI,KOCHI,964,1340,GUWAHATI-KOCHI,2304,All
2021,1,GUWAHATI,KOCHI,1380,1735,GUWAHATI-KOCHI,3115,All
2021,2,GUWAHATI,KOCHI,1039,1370,GUWAHATI-KOCHI,2409,All
2021,3,GUWAHATI,KOCHI,489,1970,GUWAHATI-KOCHI,2459,All
2021,4,GUWAHATI,KOCHI,2992,0,GUWAHATI-KOCHI,2992,All
2021,7,GUWAHATI,KOCHI,1341,427,GUWAHATI-KOCHI,1768,All
2021,8,GUWAHATI,KOCHI,1136,350,GUWAHATI-KOCHI,1486,All
2021,9,GUWAHATI,KOCHI,704,210,GUWAHATI-KOCHI,914,All
2021,10,GUWAHATI,KOCHI,779,633,GUWAHATI-KOCHI,1412,All
2023,11,GUWAHATI,KOCHI,331,377,GUWAHATI-KOCHI,708,All
2023,12,GUWAHATI,KOCHI,174,294,GUWAHATI-KOCHI,468,All
2024,11,GUWAHATI,KOCHI,15,13,GUWAHATI-KOCHI,28,All
2024,12,GUWAHATI,KOCHI,501,816,GUWAHATI-KOCHI,1317,All
2019,5,GUWAHATI,KOLKATA,64184,67806,GUWAHATI-KOLKATA,131990,All
2019,6,GUWAHATI,KOLKATA,63908,60714,GUWAHATI-KOLKATA,124622,All
2019,7,GUWAHATI,KOLKATA,65728,65476,GUWAHATI-KOLKATA,131204,All
2019,8,GUWAHATI,KOLKATA,60879,59561,GUWAHATI-KOLKATA,120440,All
2019,9,GUWAHATI,KOLKATA,52526,56462,GUWAHATI-KOLKATA,108988,All
2019,10,GUWAHATI,KOLKATA,65405,65228,GUWAHATI-KOLKATA,130633,All
2019,11,GUWAHATI,KOLKATA,61115,63117,GUWAHATI-KOLKATA,124232,All
2019,12,GUWAHATI,KOLKATA,56216,60200,GUWAHATI-KOLKATA,116416,All
2020,1,GUWAHATI,KOLKATA,58809,60051,GUWAHATI-KOLKATA,118860,All
2020,2,GUWAHATI,KOLKATA,53254,57444,GUWAHATI-KOLKATA,110698,All
2020,3,GUWAHATI,KOLKATA,38760,46439,GUWAHATI-KOLKATA,85199,All
2020,5,GUWAHATI,KOLKATA,355,363,GUWAHATI-KOLKATA,718,All
2020,6,GUWAHATI,KOLKATA,7761,16859,GUWAHATI-KOLKATA,24620,All
2020,7,GUWAHATI,KOLKATA,7155,9690,GUWAHATI-KOLKATA,16845,All
2020,8,GUWAHATI,KOLKATA,8274,12655,GUWAHATI-KOLKATA,20929,All
2020,9,GUWAHATI,KOLKATA,9803,12143,GUWAHATI-KOLKATA,21946,All
2020,10,GUWAHATI,KOLKATA,13567,12750,GUWAHATI-KOLKATA,26317,All
2020,11,GUWAHATI,KOLKATA,17134,16058,GUWAHATI-KOLKATA,33192,All
2020,12,GUWAHATI,KOLKATA,24671,25042,GUWAHATI-KOLKATA,49713,All
2021,1,GUWAHATI,KOLKATA,24759,26888,GUWAHATI-KOLKATA,51647,All
2021,2,GUWAHATI,KOLKATA,25721,27699,GUWAHATI-KOLKATA,53420,All
2021,3,GUWAHATI,KOLKATA,25748,34399,GUWAHATI-KOLKATA,60147,All
2021,4,GUWAHATI,KOLKATA,21513,21690,GUWAHATI-KOLKATA,43203,All
2021,6,GUWAHATI,KOLKATA,6836,6991,GUWAHATI-KOLKATA,13827,All
2021,7,GUWAHATI,KOLKATA,10568,12214,GUWAHATI-KOLKATA,22782,All
2021,8,GUWAHATI,KOLKATA,20389,17270,GUWAHATI-KOLKATA,37659,All
2021,9,GUWAHATI,KOLKATA,23129,23766,GUWAHATI-KOLKATA,46895,All
2021,10,GUWAHATI,KOLKATA,37726,38064,GUWAHATI-KOLKATA,75790,All
2021,11,GUWAHATI,KOLKATA,38409,40909,GUWAHATI-KOLKATA,79318,All
2021,12,GUWAHATI,KOLKATA,42789,50311,GUWAHATI-KOLKATA,93100,All
2022,1,GUWAHATI,KOLKATA,24722,28343,GUWAHATI-KOLKATA,53065,All
2022,2,GUWAHATI,KOLKATA,25903,25392,GUWAHATI-KOLKATA,51295,All
2022,3,GUWAHATI,KOLKATA,40231,41522,GUWAHATI-KOLKATA,81753,All
2022,4,GUWAHATI,KOLKATA,36723,41815,GUWAHATI-KOLKATA,78538,All
2022,5,GUWAHATI,KOLKATA,39569,42528,GUWAHATI-KOLKATA,82097,All
2022,6,GUWAHATI,KOLKATA,34588,33400,GUWAHATI-KOLKATA,67988,All
2022,7,GUWAHATI,KOLKATA,35680,36892,GUWAHATI-KOLKATA,72572,All
2022,8,GUWAHATI,KOLKATA,30058,31486,GUWAHATI-KOLKATA,61544,All
2022,9,GUWAHATI,KOLKATA,32173,34562,GUWAHATI-KOLKATA,66735,All
2022,10,GUWAHATI,KOLKATA,43385,45718,GUWAHATI-KOLKATA,89103,All
2022,11,GUWAHATI,KOLKATA,36767,36659,GUWAHATI-KOLKATA,73426,All
2022,12,GUWAHATI,KOLKATA,44425,46096,GUWAHATI-KOLKATA,90521,All
2023,1,GUWAHATI,KOLKATA,41648,44780,GUWAHATI-KOLKATA,86428,All
2023,2,GUWAHATI,KOLKATA,39416,43447,GUWAHATI-KOLKATA,82863,All
2023,3,GUWAHATI,KOLKATA,48599,51730,GUWAHATI-KOLKATA,100329,All
2023,4,GUWAHATI,KOLKATA,44898,46521,GUWAHATI-KOLKATA,91419,All
2023,5,GUWAHATI,KOLKATA,45439,46122,GUWAHATI-KOLKATA,91561,All
2023,6,GUWAHATI,KOLKATA,46580,45342,GUWAHATI-KOLKATA,91922,All
2023,7,GUWAHATI,KOLKATA,47696,45473,GUWAHATI-KOLKATA,93169,All
2023,8,GUWAHATI,KOLKATA,45091,43126,GUWAHATI-KOLKATA,88217,All
2023,9,GUWAHATI,KOLKATA,42489,44492,GUWAHATI-KOLKATA,86981,All
2023,10,GUWAHATI,KOLKATA,52088,54096,GUWAHATI-KOLKATA,106184,All
2023,11,GUWAHATI,KOLKATA,50433,49794,GUWAHATI-KOLKATA,100227,All
2023,12,GUWAHATI,KOLKATA,47420,49574,GUWAHATI-KOLKATA,96994,All
2024,1,GUWAHATI,KOLKATA,43634,43608,GUWAHATI-KOLKATA,87242,All
2024,2,GUWAHATI,KOLKATA,39288,38638,GUWAHATI-KOLKATA,77926,All
2024,3,GUWAHATI,KOLKATA,41811,42777,GUWAHATI-KOLKATA,84588,All
2024,4,GUWAHATI,KOLKATA,45102,47422,GUWAHATI-KOLKATA,92524,All
2024,6,GUWAHATI,KOLKATA,47752,45046,GUWAHATI-KOLKATA,92798,All
2024,7,GUWAHATI,KOLKATA,49755,48090,GUWAHATI-KOLKATA,97845,All
2024,8,GUWAHATI,KOLKATA,44117,43673,GUWAHATI-KOLKATA,87790,All
2024,9,GUWAHATI,KOLKATA,46589,47563,GUWAHATI-KOLKATA,94152,All
2024,10,GUWAHATI,KOLKATA,50785,49189,GUWAHATI-KOLKATA,99974,All
2024,11,GUWAHATI,KOLKATA,43168,44061,GUWAHATI-KOLKATA,87229,All
2024,12,GUWAHATI,KOLKATA,45628,46546,GUWAHATI-KOLKATA,92174,All
2025,1,GUWAHATI,KOLKATA,43396,42815,GUWAHATI-KOLKATA,86211,All
2025,2,GUWAHATI,KOLKATA,39011,40989,GUWAHATI-KOLKATA,80000,All
2025,3,GUWAHATI,KOLKATA,49043,51001,GUWAHATI-KOLKATA,100044,All
2015,4,GUWAHATI,LILABARI,121,150,GUWAHATI-LILABARI,271,All
2015,5,GUWAHATI,LILABARI,135,105,GUWAHATI-LILABARI,240,All
2015,6,GUWAHATI,LILABARI,136,344,GUWAHATI-LILABARI,480,All
2015,7,GUWAHATI,LILABARI,95,290,GUWAHATI-LILABARI,385,All
2015,8,GUWAHATI,LILABARI,75,159,GUWAHATI-LILABARI,234,All
2015,9,GUWAHATI,LILABARI,99,94,GUWAHATI-LILABARI,193,All
2015,10,GUWAHATI,LILABARI,135,147,GUWAHATI-LILABARI,282,All
2015,11,GUWAHATI,LILABARI,152,171,GUWAHATI-LILABARI,323,All
2015,12,GUWAHATI,LILABARI,90,96,GUWAHATI-LILABARI,186,All
2016,1,GUWAHATI,LILABARI,29,23,GUWAHATI-LILABARI,52,All
2016,2,GUWAHATI,LILABARI,123,125,GUWAHATI-LILABARI,248,All
2016,3,GUWAHATI,LILABARI,130,172,GUWAHATI-LILABARI,302,All
2016,4,GUWAHATI,LILABARI,0,716,GUWAHATI-LILABARI,716,All
2016,5,GUWAHATI,LILABARI,0,826,GUWAHATI-LILABARI,826,All
2016,6,GUWAHATI,LILABARI,0,744,GUWAHATI-LILABARI,744,All
2016,7,GUWAHATI,LILABARI,0,842,GUWAHATI-LILABARI,842,All
2016,8,GUWAHATI,LILABARI,162,215,GUWAHATI-LILABARI,377,All
2016,9,GUWAHATI,LILABARI,188,191,GUWAHATI-LILABARI,379,All
2016,10,GUWAHATI,LILABARI,0,904,GUWAHATI-LILABARI,904,All
2016,11,GUWAHATI,LILABARI,230,419,GUWAHATI-LILABARI,649,All
2016,12,GUWAHATI,LILABARI,248,283,GUWAHATI-LILABARI,531,All
2017,1,GUWAHATI,LILABARI,202,282,GUWAHATI-LILABARI,484,All
2017,2,GUWAHATI,LILABARI,176,468,GUWAHATI-LILABARI,644,All
2017,3,GUWAHATI,LILABARI,205,223,GUWAHATI-LILABARI,428,All
2017,4,GUWAHATI,LILABARI,248,526,GUWAHATI-LILABARI,774,All
2017,5,GUWAHATI,LILABARI,250,273,GUWAHATI-LILABARI,523,All
2017,6,GUWAHATI,LILABARI,199,224,GUWAHATI-LILABARI,423,All
2017,7,GUWAHATI,LILABARI,217,264,GUWAHATI-LILABARI,481,All
2017,8,GUWAHATI,LILABARI,193,210,GUWAHATI-LILABARI,403,All
2017,9,GUWAHATI,LILABARI,244,266,GUWAHATI-LILABARI,510,All
2017,10,GUWAHATI,LILABARI,243,305,GUWAHATI-LILABARI,548,All
2017,11,GUWAHATI,LILABARI,226,260,GUWAHATI-LILABARI,486,All
2017,12,GUWAHATI,LILABARI,242,264,GUWAHATI-LILABARI,506,All
2018,1,GUWAHATI,LILABARI,206,275,GUWAHATI-LILABARI,481,All
2018,2,GUWAHATI,LILABARI,214,230,GUWAHATI-LILABARI,444,All
2018,3,GUWAHATI,LILABARI,236,319,GUWAHATI-LILABARI,555,All
2018,4,GUWAHATI,LILABARI,204,243,GUWAHATI-LILABARI,447,All
2018,5,GUWAHATI,LILABARI,193,191,GUWAHATI-LILABARI,384,All
2018,6,GUWAHATI,LILABARI,139,195,GUWAHATI-LILABARI,334,All
2018,7,GUWAHATI,LILABARI,23,228,GUWAHATI-LILABARI,251,All
2018,8,GUWAHATI,LILABARI,167,242,GUWAHATI-LILABARI,409,All
2018,9,GUWAHATI,LILABARI,175,236,GUWAHATI-LILABARI,411,All
2018,11,GUWAHATI,LILABARI,0,460,GUWAHATI-LILABARI,460,All
2018,12,GUWAHATI,LILABARI,0,498,GUWAHATI-LILABARI,498,All
2019,1,GUWAHATI,LILABARI,125,273,GUWAHATI-LILABARI,398,All
2019,2,GUWAHATI,LILABARI,0,542,GUWAHATI-LILABARI,542,All
2019,3,GUWAHATI,LILABARI,190,214,GUWAHATI-LILABARI,404,All
2019,4,GUWAHATI,LILABARI,799,870,GUWAHATI-LILABARI,1669,All
2019,5,GUWAHATI,LILABARI,877,779,GUWAHATI-LILABARI,1656,All
2019,6,GUWAHATI,LILABARI,873,953,GUWAHATI-LILABARI,1826,All
2019,7,GUWAHATI,LILABARI,212,453,GUWAHATI-LILABARI,665,All
2019,8,GUWAHATI,LILABARI,39,128,GUWAHATI-LILABARI,167,All
2020,1,GUWAHATI,LILABARI,0,9,GUWAHATI-LILABARI,9,All
2021,6,GUWAHATI,LILABARI,4,0,GUWAHATI-LILABARI,4,All
2021,11,GUWAHATI,LILABARI,803,797,GUWAHATI-LILABARI,1600,All
2021,12,GUWAHATI,LILABARI,727,819,GUWAHATI-LILABARI,1546,All
2022,1,GUWAHATI,LILABARI,629,682,GUWAHATI-LILABARI,1311,All
2022,2,GUWAHATI,LILABARI,637,681,GUWAHATI-LILABARI,1318,All
2022,3,GUWAHATI,LILABARI,633,703,GUWAHATI-LILABARI,1336,All
2022,4,GUWAHATI,LILABARI,371,396,GUWAHATI-LILABARI,767,All
2022,5,GUWAHATI,LILABARI,107,101,GUWAHATI-LILABARI,208,All
2022,10,GUWAHATI,LILABARI,4,6,GUWAHATI-LILABARI,10,All
2022,11,GUWAHATI,LILABARI,162,221,GUWAHATI-LILABARI,383,All
2022,12,GUWAHATI,LILABARI,252,269,GUWAHATI-LILABARI,521,All
2023,2,GUWAHATI,LILABARI,182,144,GUWAHATI-LILABARI,326,All
2023,3,GUWAHATI,LILABARI,169,185,GUWAHATI-LILABARI,354,All
2023,5,GUWAHATI,LILABARI,8,97,GUWAHATI-LILABARI,105,All
2023,6,GUWAHATI,LILABARI,0,11,GUWAHATI-LILABARI,11,All
2023,10,GUWAHATI,LILABARI,16,0,GUWAHATI-LILABARI,16,All
2024,1,GUWAHATI,LILABARI,162,227,GUWAHATI-LILABARI,389,All
2024,2,GUWAHATI,LILABARI,107,182,GUWAHATI-LILABARI,289,All
2024,3,GUWAHATI,LILABARI,165,198,GUWAHATI-LILABARI,363,All
2024,4,GUWAHATI,LILABARI,0,41,GUWAHATI-LILABARI,41,All
2024,10,GUWAHATI,LILABARI,0,51,GUWAHATI-LILABARI,51,All
2016,11,GUWAHATI,LUCKNOW,543,558,GUWAHATI-LUCKNOW,1101,All
2016,12,GUWAHATI,LUCKNOW,709,1116,GUWAHATI-LUCKNOW,1825,All
2017,1,GUWAHATI,LUCKNOW,1097,1161,GUWAHATI-LUCKNOW,2258,All
2017,2,GUWAHATI,LUCKNOW,1140,1342,GUWAHATI-LUCKNOW,2482,All
2017,3,GUWAHATI,LUCKNOW,1019,1074,GUWAHATI-LUCKNOW,2093,All
2017,4,GUWAHATI,LUCKNOW,730,1221,GUWAHATI-LUCKNOW,1951,All
2017,5,GUWAHATI,LUCKNOW,777,1304,GUWAHATI-LUCKNOW,2081,All
2017,6,GUWAHATI,LUCKNOW,997,1501,GUWAHATI-LUCKNOW,2498,All
2017,7,GUWAHATI,LUCKNOW,667,831,GUWAHATI-LUCKNOW,1498,All
2017,8,GUWAHATI,LUCKNOW,742,993,GUWAHATI-LUCKNOW,1735,All
2017,9,GUWAHATI,LUCKNOW,717,824,GUWAHATI-LUCKNOW,1541,All
2017,10,GUWAHATI,LUCKNOW,469,836,GUWAHATI-LUCKNOW,1305,All
2017,11,GUWAHATI,LUCKNOW,690,906,GUWAHATI-LUCKNOW,1596,All
2017,12,GUWAHATI,LUCKNOW,817,987,GUWAHATI-LUCKNOW,1804,All
2018,1,GUWAHATI,LUCKNOW,700,620,GUWAHATI-LUCKNOW,1320,All
2018,2,GUWAHATI,LUCKNOW,1023,853,GUWAHATI-LUCKNOW,1876,All
2018,3,GUWAHATI,LUCKNOW,829,996,GUWAHATI-LUCKNOW,1825,All
2018,4,GUWAHATI,LUCKNOW,431,630,GUWAHATI-LUCKNOW,1061,All
2018,5,GUWAHATI,LUCKNOW,666,1355,GUWAHATI-LUCKNOW,2021,All
2018,6,GUWAHATI,LUCKNOW,1057,1310,GUWAHATI-LUCKNOW,2367,All
2018,7,GUWAHATI,LUCKNOW,759,1040,GUWAHATI-LUCKNOW,1799,All
2018,8,GUWAHATI,LUCKNOW,635,666,GUWAHATI-LUCKNOW,1301,All
2018,9,GUWAHATI,LUCKNOW,483,618,GUWAHATI-LUCKNOW,1101,All
2018,10,GUWAHATI,LUCKNOW,708,743,GUWAHATI-LUCKNOW,1451,All
2018,11,GUWAHATI,LUCKNOW,818,758,GUWAHATI-LUCKNOW,1576,All
2018,12,GUWAHATI,LUCKNOW,917,698,GUWAHATI-LUCKNOW,1615,All
2019,1,GUWAHATI,LUCKNOW,788,666,GUWAHATI-LUCKNOW,1454,All
2019,2,GUWAHATI,LUCKNOW,596,600,GUWAHATI-LUCKNOW,1196,All
2019,3,GUWAHATI,LUCKNOW,648,762,GUWAHATI-LUCKNOW,1410,All
2019,4,GUWAHATI,LUCKNOW,761,742,GUWAHATI-LUCKNOW,1503,All
2019,5,GUWAHATI,LUCKNOW,814,1009,GUWAHATI-LUCKNOW,1823,All
2019,6,GUWAHATI,LUCKNOW,771,869,GUWAHATI-LUCKNOW,1640,All
2019,7,GUWAHATI,LUCKNOW,899,996,GUWAHATI-LUCKNOW,1895,All
2019,8,GUWAHATI,LUCKNOW,747,742,GUWAHATI-LUCKNOW,1489,All
2019,9,GUWAHATI,LUCKNOW,413,410,GUWAHATI-LUCKNOW,823,All
2019,10,GUWAHATI,LUCKNOW,725,528,GUWAHATI-LUCKNOW,1253,All
2019,11,GUWAHATI,LUCKNOW,396,0,GUWAHATI-LUCKNOW,396,All
2019,12,GUWAHATI,LUCKNOW,649,0,GUWAHATI-LUCKNOW,649,All
2020,1,GUWAHATI,LUCKNOW,653,0,GUWAHATI-LUCKNOW,653,All
2020,2,GUWAHATI,LUCKNOW,794,0,GUWAHATI-LUCKNOW,794,All
2020,3,GUWAHATI,LUCKNOW,1794,1902,GUWAHATI-LUCKNOW,3696,All
2021,3,GUWAHATI,LUCKNOW,264,372,GUWAHATI-LUCKNOW,636,All
2021,4,GUWAHATI,LUCKNOW,3457,2226,GUWAHATI-LUCKNOW,5683,All
2021,6,GUWAHATI,LUCKNOW,295,161,GUWAHATI-LUCKNOW,456,All
2021,7,GUWAHATI,LUCKNOW,1571,947,GUWAHATI-LUCKNOW,2518,All
2021,8,GUWAHATI,LUCKNOW,1712,1020,GUWAHATI-LUCKNOW,2732,All
2021,9,GUWAHATI,LUCKNOW,696,625,GUWAHATI-LUCKNOW,1321,All
2021,10,GUWAHATI,LUCKNOW,809,920,GUWAHATI-LUCKNOW,1729,All
2021,11,GUWAHATI,LUCKNOW,3073,2983,GUWAHATI-LUCKNOW,6056,All
2021,12,GUWAHATI,LUCKNOW,3600,3987,GUWAHATI-LUCKNOW,7587,All
2022,1,GUWAHATI,LUCKNOW,2573,2707,GUWAHATI-LUCKNOW,5280,All
2022,2,GUWAHATI,LUCKNOW,2209,2190,GUWAHATI-LUCKNOW,4399,All
2022,3,GUWAHATI,LUCKNOW,4191,3694,GUWAHATI-LUCKNOW,7885,All
2022,4,GUWAHATI,LUCKNOW,4379,4062,GUWAHATI-LUCKNOW,8441,All
2022,5,GUWAHATI,LUCKNOW,3978,3809,GUWAHATI-LUCKNOW,7787,All
2022,6,GUWAHATI,LUCKNOW,3890,3704,GUWAHATI-LUCKNOW,7594,All
2022,7,GUWAHATI,LUCKNOW,3705,3136,GUWAHATI-LUCKNOW,6841,All
2022,8,GUWAHATI,LUCKNOW,3353,2443,GUWAHATI-LUCKNOW,5796,All
2022,9,GUWAHATI,LUCKNOW,3275,2539,GUWAHATI-LUCKNOW,5814,All
2022,10,GUWAHATI,LUCKNOW,3728,3982,GUWAHATI-LUCKNOW,7710,All
2022,11,GUWAHATI,LUCKNOW,3848,3738,GUWAHATI-LUCKNOW,7586,All
2022,12,GUWAHATI,LUCKNOW,2702,3442,GUWAHATI-LUCKNOW,6144,All
2023,1,GUWAHATI,LUCKNOW,3195,2998,GUWAHATI-LUCKNOW,6193,All
2023,2,GUWAHATI,LUCKNOW,3216,2917,GUWAHATI-LUCKNOW,6133,All
2023,3,GUWAHATI,LUCKNOW,3817,3833,GUWAHATI-LUCKNOW,7650,All
2023,4,GUWAHATI,LUCKNOW,4421,4560,GUWAHATI-LUCKNOW,8981,All
2023,5,GUWAHATI,LUCKNOW,4578,4460,GUWAHATI-LUCKNOW,9038,All
2023,6,GUWAHATI,LUCKNOW,2776,2753,GUWAHATI-LUCKNOW,5529,All
2023,7,GUWAHATI,LUCKNOW,2858,2642,GUWAHATI-LUCKNOW,5500,All
2023,8,GUWAHATI,LUCKNOW,2764,2785,GUWAHATI-LUCKNOW,5549,All
2023,9,GUWAHATI,LUCKNOW,2902,2782,GUWAHATI-LUCKNOW,5684,All
2023,10,GUWAHATI,LUCKNOW,4878,4805,GUWAHATI-LUCKNOW,9683,All
2023,11,GUWAHATI,LUCKNOW,3010,3261,GUWAHATI-LUCKNOW,6271,All
2023,12,GUWAHATI,LUCKNOW,3796,3912,GUWAHATI-LUCKNOW,7708,All
2024,1,GUWAHATI,LUCKNOW,1883,2193,GUWAHATI-LUCKNOW,4076,All
2024,2,GUWAHATI,LUCKNOW,2034,2122,GUWAHATI-LUCKNOW,4156,All
2024,3,GUWAHATI,LUCKNOW,3999,4230,GUWAHATI-LUCKNOW,8229,All
2024,4,GUWAHATI,LUCKNOW,4113,4288,GUWAHATI-LUCKNOW,8401,All
2024,6,GUWAHATI,LUCKNOW,4250,4420,GUWAHATI-LUCKNOW,8670,All
2024,7,GUWAHATI,LUCKNOW,3954,3749,GUWAHATI-LUCKNOW,7703,All
2024,8,GUWAHATI,LUCKNOW,3809,3318,GUWAHATI-LUCKNOW,7127,All
2024,9,GUWAHATI,LUCKNOW,3355,3307,GUWAHATI-LUCKNOW,6662,All
2024,10,GUWAHATI,LUCKNOW,4531,4314,GUWAHATI-LUCKNOW,8845,All
2024,11,GUWAHATI,LUCKNOW,4291,4605,GUWAHATI-LUCKNOW,8896,All
2024,12,GUWAHATI,LUCKNOW,3933,4603,GUWAHATI-LUCKNOW,8536,All
2025,1,GUWAHATI,LUCKNOW,4447,4463,GUWAHATI-LUCKNOW,8910,All
2025,2,GUWAHATI,LUCKNOW,4411,4753,GUWAHATI-LUCKNOW,9164,All
2025,3,GUWAHATI,LUCKNOW,5197,4247,GUWAHATI-LUCKNOW,9444,All
2018,6,GUWAHATI,MANGALORE,0,79,GUWAHATI-MANGALORE,79,All
2018,7,GUWAHATI,MANGALORE,0,110,GUWAHATI-MANGALORE,110,All
2018,8,GUWAHATI,MANGALORE,0,55,GUWAHATI-MANGALORE,55,All
2019,5,GUWAHATI,MUMBAI,12560,13082,GUWAHATI-MUMBAI,25642,All
2019,6,GUWAHATI,MUMBAI,16415,16057,GUWAHATI-MUMBAI,32472,All
2019,7,GUWAHATI,MUMBAI,18462,18943,GUWAHATI-MUMBAI,37405,All
2019,8,GUWAHATI,MUMBAI,13855,15053,GUWAHATI-MUMBAI,28908,All
2019,9,GUWAHATI,MUMBAI,14410,15036,GUWAHATI-MUMBAI,29446,All
2019,10,GUWAHATI,MUMBAI,16018,18157,GUWAHATI-MUMBAI,34175,All
2019,11,GUWAHATI,MUMBAI,17301,16286,GUWAHATI-MUMBAI,33587,All
2019,12,GUWAHATI,MUMBAI,16042,16355,GUWAHATI-MUMBAI,32397,All
2020,1,GUWAHATI,MUMBAI,17392,18089,GUWAHATI-MUMBAI,35481,All
2020,2,GUWAHATI,MUMBAI,15440,15769,GUWAHATI-MUMBAI,31209,All
2020,3,GUWAHATI,MUMBAI,9926,13037,GUWAHATI-MUMBAI,22963,All
2020,5,GUWAHATI,MUMBAI,76,631,GUWAHATI-MUMBAI,707,All
2020,6,GUWAHATI,MUMBAI,888,3699,GUWAHATI-MUMBAI,4587,All
2020,7,GUWAHATI,MUMBAI,1392,2659,GUWAHATI-MUMBAI,4051,All
2020,8,GUWAHATI,MUMBAI,3513,1981,GUWAHATI-MUMBAI,5494,All
2020,9,GUWAHATI,MUMBAI,8619,3216,GUWAHATI-MUMBAI,11835,All
2020,10,GUWAHATI,MUMBAI,12421,4848,GUWAHATI-MUMBAI,17269,All
2020,11,GUWAHATI,MUMBAI,12701,7848,GUWAHATI-MUMBAI,20549,All
2020,12,GUWAHATI,MUMBAI,10780,9049,GUWAHATI-MUMBAI,19829,All
2021,1,GUWAHATI,MUMBAI,11429,10983,GUWAHATI-MUMBAI,22412,All
2021,2,GUWAHATI,MUMBAI,10744,9942,GUWAHATI-MUMBAI,20686,All
2021,3,GUWAHATI,MUMBAI,9581,13729,GUWAHATI-MUMBAI,23310,All
2021,4,GUWAHATI,MUMBAI,11783,10282,GUWAHATI-MUMBAI,22065,All
2021,6,GUWAHATI,MUMBAI,3107,1655,GUWAHATI-MUMBAI,4762,All
2021,7,GUWAHATI,MUMBAI,4303,3625,GUWAHATI-MUMBAI,7928,All
2021,8,GUWAHATI,MUMBAI,5801,4150,GUWAHATI-MUMBAI,9951,All
2021,9,GUWAHATI,MUMBAI,6356,5541,GUWAHATI-MUMBAI,11897,All
2021,10,GUWAHATI,MUMBAI,8338,8201,GUWAHATI-MUMBAI,16539,All
2021,11,GUWAHATI,MUMBAI,9810,8353,GUWAHATI-MUMBAI,18163,All
2021,12,GUWAHATI,MUMBAI,9164,8630,GUWAHATI-MUMBAI,17794,All
2022,1,GUWAHATI,MUMBAI,6155,6696,GUWAHATI-MUMBAI,12851,All
2022,2,GUWAHATI,MUMBAI,5009,5073,GUWAHATI-MUMBAI,10082,All
2022,3,GUWAHATI,MUMBAI,7244,6452,GUWAHATI-MUMBAI,13696,All
2022,4,GUWAHATI,MUMBAI,13809,14158,GUWAHATI-MUMBAI,27967,All
2022,5,GUWAHATI,MUMBAI,19363,17166,GUWAHATI-MUMBAI,36529,All
2022,6,GUWAHATI,MUMBAI,12966,10429,GUWAHATI-MUMBAI,23395,All
2022,7,GUWAHATI,MUMBAI,10343,9926,GUWAHATI-MUMBAI,20269,All
2022,8,GUWAHATI,MUMBAI,13451,10591,GUWAHATI-MUMBAI,24042,All
2022,9,GUWAHATI,MUMBAI,13520,13898,GUWAHATI-MUMBAI,27418,All
2022,10,GUWAHATI,MUMBAI,16065,18749,GUWAHATI-MUMBAI,34814,All
2022,11,GUWAHATI,MUMBAI,16107,14615,GUWAHATI-MUMBAI,30722,All
2022,12,GUWAHATI,MUMBAI,15620,15850,GUWAHATI-MUMBAI,31470,All
2023,11,GUWAHATI,MUMBAI,18163,19991,GUWAHATI-MUMBAI,38154,All
2023,12,GUWAHATI,MUMBAI,21132,20451,GUWAHATI-MUMBAI,41583,All
2024,1,GUWAHATI,MUMBAI,21860,21670,GUWAHATI-MUMBAI,43530,All
2024,2,GUWAHATI,MUMBAI,19804,19924,GUWAHATI-MUMBAI,39728,All
2024,3,GUWAHATI,MUMBAI,20123,21328,GUWAHATI-MUMBAI,41451,All
2024,4,GUWAHATI,MUMBAI,14193,15401,GUWAHATI-MUMBAI,29594,All
2024,6,GUWAHATI,MUMBAI,14746,14093,GUWAHATI-MUMBAI,28839,All
2024,7,GUWAHATI,MUMBAI,16351,15669,GUWAHATI-MUMBAI,32020,All
2024,8,GUWAHATI,MUMBAI,14537,13549,GUWAHATI-MUMBAI,28086,All
2024,9,GUWAHATI,MUMBAI,14289,15366,GUWAHATI-MUMBAI,29655,All
2024,10,GUWAHATI,MUMBAI,16400,17545,GUWAHATI-MUMBAI,33945,All
2024,11,GUWAHATI,MUMBAI,16503,16764,GUWAHATI-MUMBAI,33267,All
2024,12,GUWAHATI,MUMBAI,18069,18783,GUWAHATI-MUMBAI,36852,All
2025,1,GUWAHATI,MUMBAI,17383,17536,GUWAHATI-MUMBAI,34919,All
2025,2,GUWAHATI,MUMBAI,16178,16944,GUWAHATI-MUMBAI,33122,All
2025,3,GUWAHATI,MUMBAI,16936,17047,GUWAHATI-MUMBAI,33983,All
2019,1,GUWAHATI,PAKYONG,1538,1466,GUWAHATI-PAKYONG,3004,All
2019,2,GUWAHATI,PAKYONG,470,411,GUWAHATI-PAKYONG,881,All
2019,3,GUWAHATI,PAKYONG,320,207,GUWAHATI-PAKYONG,527,All
2018,5,GUWAHATI,PASIGHAT,53,45,GUWAHATI-PASIGHAT,98,All
2018,6,GUWAHATI,PASIGHAT,59,84,GUWAHATI-PASIGHAT,143,All
2018,7,GUWAHATI,PASIGHAT,9,51,GUWAHATI-PASIGHAT,60,All
2018,8,GUWAHATI,PASIGHAT,66,94,GUWAHATI-PASIGHAT,160,All
2018,9,GUWAHATI,PASIGHAT,55,76,GUWAHATI-PASIGHAT,131,All
2019,1,GUWAHATI,PASIGHAT,76,0,GUWAHATI-PASIGHAT,76,All
2019,4,GUWAHATI,PASIGHAT,32,0,GUWAHATI-PASIGHAT,32,All
2019,5,GUWAHATI,PASIGHAT,20,0,GUWAHATI-PASIGHAT,20,All
2019,6,GUWAHATI,PASIGHAT,4,0,GUWAHATI-PASIGHAT,4,All
2019,7,GUWAHATI,PASIGHAT,13,0,GUWAHATI-PASIGHAT,13,All
2019,8,GUWAHATI,PASIGHAT,15,10,GUWAHATI-PASIGHAT,25,All
2019,9,GUWAHATI,PASIGHAT,25,30,GUWAHATI-PASIGHAT,55,All
2019,10,GUWAHATI,PASIGHAT,37,40,GUWAHATI-PASIGHAT,77,All
2019,11,GUWAHATI,PASIGHAT,57,61,GUWAHATI-PASIGHAT,118,All
2019,12,GUWAHATI,PASIGHAT,125,114,GUWAHATI-PASIGHAT,239,All
2020,1,GUWAHATI,PASIGHAT,42,43,GUWAHATI-PASIGHAT,85,All
2020,2,GUWAHATI,PASIGHAT,40,44,GUWAHATI-PASIGHAT,84,All
2020,3,GUWAHATI,PASIGHAT,139,39,GUWAHATI-PASIGHAT,178,All
2020,5,GUWAHATI,PASIGHAT,1,0,GUWAHATI-PASIGHAT,1,All
2020,6,GUWAHATI,PASIGHAT,7,0,GUWAHATI-PASIGHAT,7,All
2020,8,GUWAHATI,PASIGHAT,4,0,GUWAHATI-PASIGHAT,4,All
2020,10,GUWAHATI,PASIGHAT,13,0,GUWAHATI-PASIGHAT,13,All
2020,11,GUWAHATI,PASIGHAT,23,0,GUWAHATI-PASIGHAT,23,All
2020,12,GUWAHATI,PASIGHAT,21,0,GUWAHATI-PASIGHAT,21,All
2021,1,GUWAHATI,PASIGHAT,15,0,GUWAHATI-PASIGHAT,15,All
2021,2,GUWAHATI,PASIGHAT,38,0,GUWAHATI-PASIGHAT,38,All
2021,3,GUWAHATI,PASIGHAT,28,0,GUWAHATI-PASIGHAT,28,All
2021,4,GUWAHATI,PASIGHAT,48,0,GUWAHATI-PASIGHAT,48,All
2021,6,GUWAHATI,PASIGHAT,115,95,GUWAHATI-PASIGHAT,210,All
2021,7,GUWAHATI,PASIGHAT,216,217,GUWAHATI-PASIGHAT,433,All
2021,8,GUWAHATI,PASIGHAT,158,125,GUWAHATI-PASIGHAT,283,All
2021,9,GUWAHATI,PASIGHAT,276,231,GUWAHATI-PASIGHAT,507,All
2021,10,GUWAHATI,PASIGHAT,291,178,GUWAHATI-PASIGHAT,469,All
2021,11,GUWAHATI,PASIGHAT,468,439,GUWAHATI-PASIGHAT,907,All
2021,12,GUWAHATI,PASIGHAT,537,533,GUWAHATI-PASIGHAT,1070,All
2022,1,GUWAHATI,PASIGHAT,364,372,GUWAHATI-PASIGHAT,736,All
2022,2,GUWAHATI,PASIGHAT,327,330,GUWAHATI-PASIGHAT,657,All
2022,3,GUWAHATI,PASIGHAT,318,336,GUWAHATI-PASIGHAT,654,All
2022,4,GUWAHATI,PASIGHAT,369,320,GUWAHATI-PASIGHAT,689,All
2022,5,GUWAHATI,PASIGHAT,290,252,GUWAHATI-PASIGHAT,542,All
2022,6,GUWAHATI,PASIGHAT,291,196,GUWAHATI-PASIGHAT,487,All
2022,7,GUWAHATI,PASIGHAT,338,330,GUWAHATI-PASIGHAT,668,All
2022,8,GUWAHATI,PASIGHAT,411,416,GUWAHATI-PASIGHAT,827,All
2022,9,GUWAHATI,PASIGHAT,532,455,GUWAHATI-PASIGHAT,987,All
2022,10,GUWAHATI,PASIGHAT,533,520,GUWAHATI-PASIGHAT,1053,All
2022,11,GUWAHATI,PASIGHAT,746,730,GUWAHATI-PASIGHAT,1476,All
2022,12,GUWAHATI,PASIGHAT,1070,1002,GUWAHATI-PASIGHAT,2072,All
2023,1,GUWAHATI,PASIGHAT,443,700,GUWAHATI-PASIGHAT,1143,All
2023,2,GUWAHATI,PASIGHAT,273,311,GUWAHATI-PASIGHAT,584,All
2023,3,GUWAHATI,PASIGHAT,168,88,GUWAHATI-PASIGHAT,256,All
2023,5,GUWAHATI,PASIGHAT,224,142,GUWAHATI-PASIGHAT,366,All
2023,6,GUWAHATI,PASIGHAT,258,236,GUWAHATI-PASIGHAT,494,All
2023,7,GUWAHATI,PASIGHAT,211,217,GUWAHATI-PASIGHAT,428,All
2023,8,GUWAHATI,PASIGHAT,230,191,GUWAHATI-PASIGHAT,421,All
2023,9,GUWAHATI,PASIGHAT,309,283,GUWAHATI-PASIGHAT,592,All
2023,10,GUWAHATI,PASIGHAT,402,405,GUWAHATI-PASIGHAT,807,All
2023,11,GUWAHATI,PASIGHAT,442,496,GUWAHATI-PASIGHAT,938,All
2023,12,GUWAHATI,PASIGHAT,574,586,GUWAHATI-PASIGHAT,1160,All
2024,1,GUWAHATI,PASIGHAT,460,555,GUWAHATI-PASIGHAT,1015,All
2024,2,GUWAHATI,PASIGHAT,140,181,GUWAHATI-PASIGHAT,321,All
2024,3,GUWAHATI,PASIGHAT,247,333,GUWAHATI-PASIGHAT,580,All
2024,4,GUWAHATI,PASIGHAT,251,318,GUWAHATI-PASIGHAT,569,All
2024,6,GUWAHATI,PASIGHAT,77,159,GUWAHATI-PASIGHAT,236,All
2024,7,GUWAHATI,PASIGHAT,193,183,GUWAHATI-PASIGHAT,376,All
2024,8,GUWAHATI,PASIGHAT,225,294,GUWAHATI-PASIGHAT,519,All
2024,9,GUWAHATI,PASIGHAT,403,518,GUWAHATI-PASIGHAT,921,All
2024,10,GUWAHATI,PASIGHAT,271,296,GUWAHATI-PASIGHAT,567,All
2024,11,GUWAHATI,PASIGHAT,380,462,GUWAHATI-PASIGHAT,842,All
2024,12,GUWAHATI,PASIGHAT,542,619,GUWAHATI-PASIGHAT,1161,All
2025,1,GUWAHATI,PASIGHAT,451,605,GUWAHATI-PASIGHAT,1056,All
2025,2,GUWAHATI,PASIGHAT,271,307,GUWAHATI-PASIGHAT,578,All
2025,3,GUWAHATI,PASIGHAT,30,39,GUWAHATI-PASIGHAT,69,All
2018,10,GUWAHATI,PATNA,3458,3655,GUWAHATI-PATNA,7113,All
2018,11,GUWAHATI,PATNA,4570,4741,GUWAHATI-PATNA,9311,All
2018,12,GUWAHATI,PATNA,4426,5538,GUWAHATI-PATNA,9964,All
2019,1,GUWAHATI,PATNA,3831,4501,GUWAHATI-PATNA,8332,All
2019,2,GUWAHATI,PATNA,2816,3551,GUWAHATI-PATNA,6367,All
2019,3,GUWAHATI,PATNA,938,1072,GUWAHATI-PATNA,2010,All
2020,8,GUWAHATI,PATNA,185,198,GUWAHATI-PATNA,383,All
2020,9,GUWAHATI,PATNA,1628,1709,GUWAHATI-PATNA,3337,All
2020,10,GUWAHATI,PATNA,1876,1867,GUWAHATI-PATNA,3743,All
2020,11,GUWAHATI,PATNA,1901,1862,GUWAHATI-PATNA,3763,All
2020,12,GUWAHATI,PATNA,1746,1988,GUWAHATI-PATNA,3734,All
2021,1,GUWAHATI,PATNA,2985,3527,GUWAHATI-PATNA,6512,All
2021,2,GUWAHATI,PATNA,4316,4595,GUWAHATI-PATNA,8911,All
2021,3,GUWAHATI,PATNA,4201,4289,GUWAHATI-PATNA,8490,All
2021,4,GUWAHATI,PATNA,3092,3490,GUWAHATI-PATNA,6582,All
2021,6,GUWAHATI,PATNA,1772,2374,GUWAHATI-PATNA,4146,All
2021,7,GUWAHATI,PATNA,1816,2158,GUWAHATI-PATNA,3974,All
2021,8,GUWAHATI,PATNA,2075,1908,GUWAHATI-PATNA,3983,All
2021,9,GUWAHATI,PATNA,1547,1646,GUWAHATI-PATNA,3193,All
2021,10,GUWAHATI,PATNA,2438,2740,GUWAHATI-PATNA,5178,All
2021,11,GUWAHATI,PATNA,3154,4386,GUWAHATI-PATNA,7540,All
2021,12,GUWAHATI,PATNA,3288,5981,GUWAHATI-PATNA,9269,All
2022,1,GUWAHATI,PATNA,1645,1863,GUWAHATI-PATNA,3508,All
2022,2,GUWAHATI,PATNA,1682,1586,GUWAHATI-PATNA,3268,All
2022,3,GUWAHATI,PATNA,1943,1871,GUWAHATI-PATNA,3814,All
2022,4,GUWAHATI,PATNA,3207,3761,GUWAHATI-PATNA,6968,All
2022,5,GUWAHATI,PATNA,4490,5109,GUWAHATI-PATNA,9599,All
2022,6,GUWAHATI,PATNA,4907,5572,GUWAHATI-PATNA,10479,All
2022,7,GUWAHATI,PATNA,4083,4455,GUWAHATI-PATNA,8538,All
2022,8,GUWAHATI,PATNA,3905,4447,GUWAHATI-PATNA,8352,All
2022,9,GUWAHATI,PATNA,3596,4050,GUWAHATI-PATNA,7646,All
2022,10,GUWAHATI,PATNA,4813,4027,GUWAHATI-PATNA,8840,All
2022,11,GUWAHATI,PATNA,2547,2912,GUWAHATI-PATNA,5459,All
2022,12,GUWAHATI,PATNA,1642,1884,GUWAHATI-PATNA,3526,All
2023,1,GUWAHATI,PATNA,1829,2236,GUWAHATI-PATNA,4065,All
2023,2,GUWAHATI,PATNA,1669,1704,GUWAHATI-PATNA,3373,All
2023,3,GUWAHATI,PATNA,1602,1763,GUWAHATI-PATNA,3365,All
2023,4,GUWAHATI,PATNA,1203,1285,GUWAHATI-PATNA,2488,All
2023,5,GUWAHATI,PATNA,860,951,GUWAHATI-PATNA,1811,All
2023,6,GUWAHATI,PATNA,977,1171,GUWAHATI-PATNA,2148,All
2023,7,GUWAHATI,PATNA,1506,1706,GUWAHATI-PATNA,3212,All
2023,8,GUWAHATI,PATNA,2112,2132,GUWAHATI-PATNA,4244,All
2023,9,GUWAHATI,PATNA,1111,1104,GUWAHATI-PATNA,2215,All
2023,10,GUWAHATI,PATNA,1495,1622,GUWAHATI-PATNA,3117,All
2023,11,GUWAHATI,PATNA,332,303,GUWAHATI-PATNA,635,All
2024,2,GUWAHATI,PATNA,1484,1679,GUWAHATI-PATNA,3163,All
2024,3,GUWAHATI,PATNA,2745,2997,GUWAHATI-PATNA,5742,All
2024,10,GUWAHATI,PATNA,333,134,GUWAHATI-PATNA,467,All
2024,11,GUWAHATI,PATNA,1958,1884,GUWAHATI-PATNA,3842,All
2024,12,GUWAHATI,PATNA,291,354,GUWAHATI-PATNA,645,All
2025,2,GUWAHATI,PATNA,1816,1983,GUWAHATI-PATNA,3799,All
2025,3,GUWAHATI,PATNA,1643,1700,GUWAHATI-PATNA,3343,All
2018,3,GUWAHATI,PORT BLAIR,1288,1059,GUWAHATI-PORT BLAIR,2347,All
2017,9,GUWAHATI,PUNE,759,815,GUWAHATI-PUNE,1574,All
2017,10,GUWAHATI,PUNE,561,775,GUWAHATI-PUNE,1336,All
2017,11,GUWAHATI,PUNE,657,422,GUWAHATI-PUNE,1079,All
2017,12,GUWAHATI,PUNE,765,1015,GUWAHATI-PUNE,1780,All
2018,1,GUWAHATI,PUNE,1042,932,GUWAHATI-PUNE,1974,All
2018,2,GUWAHATI,PUNE,782,870,GUWAHATI-PUNE,1652,All
2018,3,GUWAHATI,PUNE,1038,1088,GUWAHATI-PUNE,2126,All
2018,4,GUWAHATI,PUNE,926,1850,GUWAHATI-PUNE,2776,All
2018,5,GUWAHATI,PUNE,1205,1573,GUWAHATI-PUNE,2778,All
2018,6,GUWAHATI,PUNE,1780,1024,GUWAHATI-PUNE,2804,All
2018,7,GUWAHATI,PUNE,1969,1267,GUWAHATI-PUNE,3236,All
2018,8,GUWAHATI,PUNE,2281,1640,GUWAHATI-PUNE,3921,All
2018,9,GUWAHATI,PUNE,1990,1492,GUWAHATI-PUNE,3482,All
2018,10,GUWAHATI,PUNE,1918,998,GUWAHATI-PUNE,2916,All
2018,11,GUWAHATI,PUNE,1978,1097,GUWAHATI-PUNE,3075,All
2018,12,GUWAHATI,PUNE,1880,655,GUWAHATI-PUNE,2535,All
2019,1,GUWAHATI,PUNE,550,772,GUWAHATI-PUNE,1322,All
2019,2,GUWAHATI,PUNE,188,260,GUWAHATI-PUNE,448,All
2019,10,GUWAHATI,PUNE,0,41,GUWAHATI-PUNE,41,All
2019,11,GUWAHATI,PUNE,0,492,GUWAHATI-PUNE,492,All
2019,12,GUWAHATI,PUNE,0,1264,GUWAHATI-PUNE,1264,All
2020,1,GUWAHATI,PUNE,0,930,GUWAHATI-PUNE,930,All
2020,2,GUWAHATI,PUNE,0,688,GUWAHATI-PUNE,688,All
2020,3,GUWAHATI,PUNE,0,332,GUWAHATI-PUNE,332,All
2021,8,GUWAHATI,PUNE,66,70,GUWAHATI-PUNE,136,All
2021,9,GUWAHATI,PUNE,632,447,GUWAHATI-PUNE,1079,All
2021,10,GUWAHATI,PUNE,298,200,GUWAHATI-PUNE,498,All
2021,12,GUWAHATI,PUNE,2537,2550,GUWAHATI-PUNE,5087,All
2022,1,GUWAHATI,PUNE,1868,2158,GUWAHATI-PUNE,4026,All
2022,2,GUWAHATI,PUNE,169,0,GUWAHATI-PUNE,169,All
2022,3,GUWAHATI,PUNE,4907,4617,GUWAHATI-PUNE,9524,All
2022,4,GUWAHATI,PUNE,4856,5202,GUWAHATI-PUNE,10058,All
2022,5,GUWAHATI,PUNE,5164,4941,GUWAHATI-PUNE,10105,All
2022,6,GUWAHATI,PUNE,4153,4064,GUWAHATI-PUNE,8217,All
2022,7,GUWAHATI,PUNE,4377,4680,GUWAHATI-PUNE,9057,All
2022,8,GUWAHATI,PUNE,0,156,GUWAHATI-PUNE,156,All
2022,9,GUWAHATI,PUNE,162,0,GUWAHATI-PUNE,162,All
2022,10,GUWAHATI,PUNE,4108,4946,GUWAHATI-PUNE,9054,All
2022,11,GUWAHATI,PUNE,4858,4345,GUWAHATI-PUNE,9203,All
2022,12,GUWAHATI,PUNE,4074,4310,GUWAHATI-PUNE,8384,All
2023,1,GUWAHATI,PUNE,3696,3862,GUWAHATI-PUNE,7558,All
2023,2,GUWAHATI,PUNE,3387,3524,GUWAHATI-PUNE,6911,All
2023,3,GUWAHATI,PUNE,4651,4662,GUWAHATI-PUNE,9313,All
2023,4,GUWAHATI,PUNE,4357,4685,GUWAHATI-PUNE,9042,All
2023,5,GUWAHATI,PUNE,4950,4679,GUWAHATI-PUNE,9629,All
2023,6,GUWAHATI,PUNE,4832,4385,GUWAHATI-PUNE,9217,All
2023,7,GUWAHATI,PUNE,4716,4359,GUWAHATI-PUNE,9075,All
2023,8,GUWAHATI,PUNE,4327,3984,GUWAHATI-PUNE,8311,All
2023,9,GUWAHATI,PUNE,3744,3918,GUWAHATI-PUNE,7662,All
2023,10,GUWAHATI,PUNE,4817,5069,GUWAHATI-PUNE,9886,All
2023,11,GUWAHATI,PUNE,5006,5089,GUWAHATI-PUNE,10095,All
2023,12,GUWAHATI,PUNE,5359,5156,GUWAHATI-PUNE,10515,All
2024,3,GUWAHATI,PUNE,182,176,GUWAHATI-PUNE,358,All
2024,4,GUWAHATI,PUNE,4867,5227,GUWAHATI-PUNE,10094,All
2024,6,GUWAHATI,PUNE,5276,4963,GUWAHATI-PUNE,10239,All
2024,7,GUWAHATI,PUNE,5367,5174,GUWAHATI-PUNE,10541,All
2024,8,GUWAHATI,PUNE,5245,5016,GUWAHATI-PUNE,10261,All
2024,9,GUWAHATI,PUNE,4520,4774,GUWAHATI-PUNE,9294,All
2024,10,GUWAHATI,PUNE,4846,5288,GUWAHATI-PUNE,10134,All
2024,11,GUWAHATI,PUNE,5281,5126,GUWAHATI-PUNE,10407,All
2024,12,GUWAHATI,PUNE,5030,5235,GUWAHATI-PUNE,10265,All
2025,1,GUWAHATI,PUNE,4157,4318,GUWAHATI-PUNE,8475,All
2025,2,GUWAHATI,PUNE,4552,4458,GUWAHATI-PUNE,9010,All
2025,3,GUWAHATI,PUNE,4931,5166,GUWAHATI-PUNE,10097,All
2017,2,GUWAHATI,RAIPUR,5,9,GUWAHATI-RAIPUR,14,All
2017,3,GUWAHATI,RAIPUR,150,102,GUWAHATI-RAIPUR,252,All
2020,3,GUWAHATI,RANCHI,15,0,GUWAHATI-RANCHI,15,All
2023,5,GUWAHATI,RANCHI,15,0,GUWAHATI-RANCHI,15,All
2023,11,GUWAHATI,RANCHI,7,0,GUWAHATI-RANCHI,7,All
2021,6,GUWAHATI,RUPSI,890,920,GUWAHATI-RUPSI,1810,All
2021,7,GUWAHATI,RUPSI,909,773,GUWAHATI-RUPSI,1682,All
2021,8,GUWAHATI,RUPSI,735,640,GUWAHATI-RUPSI,1375,All
2021,9,GUWAHATI,RUPSI,510,561,GUWAHATI-RUPSI,1071,All
2021,10,GUWAHATI,RUPSI,900,777,GUWAHATI-RUPSI,1677,All
2021,11,GUWAHATI,RUPSI,832,782,GUWAHATI-RUPSI,1614,All
2021,12,GUWAHATI,RUPSI,717,612,GUWAHATI-RUPSI,1329,All
2022,1,GUWAHATI,RUPSI,578,387,GUWAHATI-RUPSI,965,All
2022,2,GUWAHATI,RUPSI,840,806,GUWAHATI-RUPSI,1646,All
2022,3,GUWAHATI,RUPSI,794,657,GUWAHATI-RUPSI,1451,All
2022,4,GUWAHATI,RUPSI,666,433,GUWAHATI-RUPSI,1099,All
2022,5,GUWAHATI,RUPSI,765,686,GUWAHATI-RUPSI,1451,All
2022,6,GUWAHATI,RUPSI,530,361,GUWAHATI-RUPSI,891,All
2022,7,GUWAHATI,RUPSI,808,703,GUWAHATI-RUPSI,1511,All
2022,8,GUWAHATI,RUPSI,736,611,GUWAHATI-RUPSI,1347,All
2022,9,GUWAHATI,RUPSI,927,713,GUWAHATI-RUPSI,1640,All
2022,10,GUWAHATI,RUPSI,786,773,GUWAHATI-RUPSI,1559,All
2022,11,GUWAHATI,RUPSI,929,1174,GUWAHATI-RUPSI,2103,All
2022,12,GUWAHATI,RUPSI,933,1043,GUWAHATI-RUPSI,1976,All
2023,1,GUWAHATI,RUPSI,578,571,GUWAHATI-RUPSI,1149,All
2023,2,GUWAHATI,RUPSI,492,527,GUWAHATI-RUPSI,1019,All
2023,3,GUWAHATI,RUPSI,775,898,GUWAHATI-RUPSI,1673,All
2023,4,GUWAHATI,RUPSI,969,1040,GUWAHATI-RUPSI,2009,All
2023,5,GUWAHATI,RUPSI,747,902,GUWAHATI-RUPSI,1649,All
2023,6,GUWAHATI,RUPSI,815,713,GUWAHATI-RUPSI,1528,All
2023,7,GUWAHATI,RUPSI,1086,1192,GUWAHATI-RUPSI,2278,All
2023,8,GUWAHATI,RUPSI,759,755,GUWAHATI-RUPSI,1514,All
2023,9,GUWAHATI,RUPSI,1530,1493,GUWAHATI-RUPSI,3023,All
2023,10,GUWAHATI,RUPSI,1214,1056,GUWAHATI-RUPSI,2270,All
2023,11,GUWAHATI,RUPSI,254,307,GUWAHATI-RUPSI,561,All
2024,10,GUWAHATI,RUPSI,218,112,GUWAHATI-RUPSI,330,All
2024,11,GUWAHATI,RUPSI,386,516,GUWAHATI-RUPSI,902,All
2024,12,GUWAHATI,RUPSI,351,343,GUWAHATI-RUPSI,694,All
2025,1,GUWAHATI,RUPSI,53,100,GUWAHATI-RUPSI,153,All
2019,12,GUWAHATI,SHILLONG,0,147,GUWAHATI-SHILLONG,147,All
2021,10,GUWAHATI,SHILLONG,0,1,GUWAHATI-SHILLONG,1,All
2021,11,GUWAHATI,SHILLONG,13,21,GUWAHATI-SHILLONG,34,All
2021,12,GUWAHATI,SHILLONG,127,55,GUWAHATI-SHILLONG,182,All
2022,1,GUWAHATI,SHILLONG,38,27,GUWAHATI-SHILLONG,65,All
2022,2,GUWAHATI,SHILLONG,38,29,GUWAHATI-SHILLONG,67,All
2022,3,GUWAHATI,SHILLONG,112,41,GUWAHATI-SHILLONG,153,All
2022,4,GUWAHATI,SHILLONG,13,21,GUWAHATI-SHILLONG,34,All
2022,5,GUWAHATI,SHILLONG,146,105,GUWAHATI-SHILLONG,251,All
2022,6,GUWAHATI,SHILLONG,61,103,GUWAHATI-SHILLONG,164,All
2022,7,GUWAHATI,SHILLONG,38,29,GUWAHATI-SHILLONG,67,All
2022,8,GUWAHATI,SHILLONG,127,55,GUWAHATI-SHILLONG,182,All
2022,9,GUWAHATI,SHILLONG,13,21,GUWAHATI-SHILLONG,34,All
2022,10,GUWAHATI,SHILLONG,104,77,GUWAHATI-SHILLONG,181,All
2022,11,GUWAHATI,SHILLONG,223,176,GUWAHATI-SHILLONG,399,All
2022,12,GUWAHATI,SHILLONG,151,166,GUWAHATI-SHILLONG,317,All
2023,1,GUWAHATI,SHILLONG,340,246,GUWAHATI-SHILLONG,586,All
2023,2,GUWAHATI,SHILLONG,103,46,GUWAHATI-SHILLONG,149,All
2023,3,GUWAHATI,SHILLONG,95,69,GUWAHATI-SHILLONG,164,All
2023,4,GUWAHATI,SHILLONG,440,476,GUWAHATI-SHILLONG,916,All
2023,5,GUWAHATI,SHILLONG,381,421,GUWAHATI-SHILLONG,802,All
2023,6,GUWAHATI,SHILLONG,511,491,GUWAHATI-SHILLONG,1002,All
2023,7,GUWAHATI,SHILLONG,495,477,GUWAHATI-SHILLONG,972,All
2023,8,GUWAHATI,SHILLONG,394,412,GUWAHATI-SHILLONG,806,All
2023,9,GUWAHATI,SHILLONG,494,377,GUWAHATI-SHILLONG,871,All
2023,10,GUWAHATI,SHILLONG,252,298,GUWAHATI-SHILLONG,550,All
2023,11,GUWAHATI,SHILLONG,442,445,GUWAHATI-SHILLONG,887,All
2023,12,GUWAHATI,SHILLONG,353,475,GUWAHATI-SHILLONG,828,All
2024,1,GUWAHATI,SHILLONG,404,711,GUWAHATI-SHILLONG,1115,All
2024,2,GUWAHATI,SHILLONG,407,584,GUWAHATI-SHILLONG,991,All
2024,3,GUWAHATI,SHILLONG,514,700,GUWAHATI-SHILLONG,1214,All
2024,4,GUWAHATI,SHILLONG,1136,1111,GUWAHATI-SHILLONG,2247,All
2024,6,GUWAHATI,SHILLONG,1170,860,GUWAHATI-SHILLONG,2030,All
2024,7,GUWAHATI,SHILLONG,1050,841,GUWAHATI-SHILLONG,1891,All
2024,8,GUWAHATI,SHILLONG,437,267,GUWAHATI-SHILLONG,704,All
2024,9,GUWAHATI,SHILLONG,449,406,GUWAHATI-SHILLONG,855,All
2024,10,GUWAHATI,SHILLONG,223,61,GUWAHATI-SHILLONG,284,All
2025,1,GUWAHATI,SHILLONG,0,37,GUWAHATI-SHILLONG,37,All
2021,10,GUWAHATI,SHIRDI,34,0,GUWAHATI-SHIRDI,34,All
2015,4,GUWAHATI,SILCHAR,2632,2767,GUWAHATI-SILCHAR,5399,All
2015,5,GUWAHATI,SILCHAR,2571,2749,GUWAHATI-SILCHAR,5320,All
2015,6,GUWAHATI,SILCHAR,2525,2504,GUWAHATI-SILCHAR,5029,All
2015,7,GUWAHATI,SILCHAR,3146,2794,GUWAHATI-SILCHAR,5940,All
2015,8,GUWAHATI,SILCHAR,2931,3214,GUWAHATI-SILCHAR,6145,All
2015,9,GUWAHATI,SILCHAR,2939,3007,GUWAHATI-SILCHAR,5946,All
2015,10,GUWAHATI,SILCHAR,2571,2639,GUWAHATI-SILCHAR,5210,All
2015,11,GUWAHATI,SILCHAR,2452,2508,GUWAHATI-SILCHAR,4960,All
2015,12,GUWAHATI,SILCHAR,1976,1886,GUWAHATI-SILCHAR,3862,All
2016,1,GUWAHATI,SILCHAR,1779,1807,GUWAHATI-SILCHAR,3586,All
2016,2,GUWAHATI,SILCHAR,2402,2494,GUWAHATI-SILCHAR,4896,All
2016,3,GUWAHATI,SILCHAR,2432,2350,GUWAHATI-SILCHAR,4782,All
2016,4,GUWAHATI,SILCHAR,1665,1713,GUWAHATI-SILCHAR,3378,All
2016,5,GUWAHATI,SILCHAR,1830,1900,GUWAHATI-SILCHAR,3730,All
2016,6,GUWAHATI,SILCHAR,1744,1771,GUWAHATI-SILCHAR,3515,All
2016,7,GUWAHATI,SILCHAR,1874,1828,GUWAHATI-SILCHAR,3702,All
2016,8,GUWAHATI,SILCHAR,1750,1731,GUWAHATI-SILCHAR,3481,All
2016,9,GUWAHATI,SILCHAR,1787,1710,GUWAHATI-SILCHAR,3497,All
2016,10,GUWAHATI,SILCHAR,3319,3279,GUWAHATI-SILCHAR,6598,All
2016,11,GUWAHATI,SILCHAR,3546,3636,GUWAHATI-SILCHAR,7182,All
2016,12,GUWAHATI,SILCHAR,3725,4024,GUWAHATI-SILCHAR,7749,All
2017,1,GUWAHATI,SILCHAR,3758,3819,GUWAHATI-SILCHAR,7577,All
2017,2,GUWAHATI,SILCHAR,3371,3645,GUWAHATI-SILCHAR,7016,All
2017,3,GUWAHATI,SILCHAR,3547,3793,GUWAHATI-SILCHAR,7340,All
2017,4,GUWAHATI,SILCHAR,3622,3862,GUWAHATI-SILCHAR,7484,All
2017,5,GUWAHATI,SILCHAR,3877,4003,GUWAHATI-SILCHAR,7880,All
2017,6,GUWAHATI,SILCHAR,3643,3521,GUWAHATI-SILCHAR,7164,All
2017,7,GUWAHATI,SILCHAR,4503,4351,GUWAHATI-SILCHAR,8854,All
2017,8,GUWAHATI,SILCHAR,4365,3978,GUWAHATI-SILCHAR,8343,All
2017,9,GUWAHATI,SILCHAR,4481,4313,GUWAHATI-SILCHAR,8794,All
2017,10,GUWAHATI,SILCHAR,4300,4658,GUWAHATI-SILCHAR,8958,All
2017,11,GUWAHATI,SILCHAR,4518,4424,GUWAHATI-SILCHAR,8942,All
2017,12,GUWAHATI,SILCHAR,4508,4726,GUWAHATI-SILCHAR,9234,All
2018,1,GUWAHATI,SILCHAR,5819,5243,GUWAHATI-SILCHAR,11062,All
2018,2,GUWAHATI,SILCHAR,5274,5057,GUWAHATI-SILCHAR,10331,All
2018,3,GUWAHATI,SILCHAR,5060,5283,GUWAHATI-SILCHAR,10343,All
2018,4,GUWAHATI,SILCHAR,5112,5469,GUWAHATI-SILCHAR,10581,All
2018,5,GUWAHATI,SILCHAR,3788,4300,GUWAHATI-SILCHAR,8088,All
2018,6,GUWAHATI,SILCHAR,3960,4102,GUWAHATI-SILCHAR,8062,All
2018,7,GUWAHATI,SILCHAR,4778,4722,GUWAHATI-SILCHAR,9500,All
2018,8,GUWAHATI,SILCHAR,4519,5096,GUWAHATI-SILCHAR,9615,All
2018,9,GUWAHATI,SILCHAR,7382,7253,GUWAHATI-SILCHAR,14635,All
2018,10,GUWAHATI,SILCHAR,7089,6867,GUWAHATI-SILCHAR,13956,All
2018,11,GUWAHATI,SILCHAR,5877,5293,GUWAHATI-SILCHAR,11170,All
2018,12,GUWAHATI,SILCHAR,6903,6629,GUWAHATI-SILCHAR,13532,All
2019,1,GUWAHATI,SILCHAR,7621,6410,GUWAHATI-SILCHAR,14031,All
2019,2,GUWAHATI,SILCHAR,4658,4548,GUWAHATI-SILCHAR,9206,All
2019,3,GUWAHATI,SILCHAR,3834,3920,GUWAHATI-SILCHAR,7754,All
2019,4,GUWAHATI,SILCHAR,4288,3960,GUWAHATI-SILCHAR,8248,All
2019,5,GUWAHATI,SILCHAR,4156,3582,GUWAHATI-SILCHAR,7738,All
2019,6,GUWAHATI,SILCHAR,3402,3226,GUWAHATI-SILCHAR,6628,All
2019,7,GUWAHATI,SILCHAR,3642,3229,GUWAHATI-SILCHAR,6871,All
2019,8,GUWAHATI,SILCHAR,3148,2907,GUWAHATI-SILCHAR,6055,All
2019,9,GUWAHATI,SILCHAR,2948,2857,GUWAHATI-SILCHAR,5805,All
2019,10,GUWAHATI,SILCHAR,5526,5760,GUWAHATI-SILCHAR,11286,All
2019,11,GUWAHATI,SILCHAR,5440,4705,GUWAHATI-SILCHAR,10145,All
2019,12,GUWAHATI,SILCHAR,5670,4286,GUWAHATI-SILCHAR,9956,All
2020,1,GUWAHATI,SILCHAR,5977,4567,GUWAHATI-SILCHAR,10544,All
2020,2,GUWAHATI,SILCHAR,5023,4635,GUWAHATI-SILCHAR,9658,All
2020,3,GUWAHATI,SILCHAR,4013,3528,GUWAHATI-SILCHAR,7541,All
2020,5,GUWAHATI,SILCHAR,37,21,GUWAHATI-SILCHAR,58,All
2020,6,GUWAHATI,SILCHAR,878,367,GUWAHATI-SILCHAR,1245,All
2020,7,GUWAHATI,SILCHAR,1077,736,GUWAHATI-SILCHAR,1813,All
2020,8,GUWAHATI,SILCHAR,1188,1500,GUWAHATI-SILCHAR,2688,All
2020,9,GUWAHATI,SILCHAR,1400,2720,GUWAHATI-SILCHAR,4120,All
2020,10,GUWAHATI,SILCHAR,2560,4123,GUWAHATI-SILCHAR,6683,All
2020,11,GUWAHATI,SILCHAR,2828,3550,GUWAHATI-SILCHAR,6378,All
2020,12,GUWAHATI,SILCHAR,3471,3627,GUWAHATI-SILCHAR,7098,All
2021,1,GUWAHATI,SILCHAR,4131,3716,GUWAHATI-SILCHAR,7847,All
2021,2,GUWAHATI,SILCHAR,3320,3698,GUWAHATI-SILCHAR,7018,All
2021,3,GUWAHATI,SILCHAR,2840,3003,GUWAHATI-SILCHAR,5843,All
2021,4,GUWAHATI,SILCHAR,3203,3409,GUWAHATI-SILCHAR,6612,All
2021,7,GUWAHATI,SILCHAR,1156,1244,GUWAHATI-SILCHAR,2400,All
2021,8,GUWAHATI,SILCHAR,1355,1484,GUWAHATI-SILCHAR,2839,All
2021,9,GUWAHATI,SILCHAR,2057,2545,GUWAHATI-SILCHAR,4602,All
2021,10,GUWAHATI,SILCHAR,2300,2701,GUWAHATI-SILCHAR,5001,All
2021,11,GUWAHATI,SILCHAR,2359,2596,GUWAHATI-SILCHAR,4955,All
2021,12,GUWAHATI,SILCHAR,2594,2658,GUWAHATI-SILCHAR,5252,All
2022,1,GUWAHATI,SILCHAR,1762,1464,GUWAHATI-SILCHAR,3226,All
2022,2,GUWAHATI,SILCHAR,1645,2245,GUWAHATI-SILCHAR,3890,All
2022,3,GUWAHATI,SILCHAR,3171,3136,GUWAHATI-SILCHAR,6307,All
2022,4,GUWAHATI,SILCHAR,2906,2895,GUWAHATI-SILCHAR,5801,All
2022,5,GUWAHATI,SILCHAR,4462,4803,GUWAHATI-SILCHAR,9265,All
2022,6,GUWAHATI,SILCHAR,4441,5448,GUWAHATI-SILCHAR,9889,All
2022,7,GUWAHATI,SILCHAR,5296,5602,GUWAHATI-SILCHAR,10898,All
2022,8,GUWAHATI,SILCHAR,2953,3291,GUWAHATI-SILCHAR,6244,All
2022,9,GUWAHATI,SILCHAR,3922,4136,GUWAHATI-SILCHAR,8058,All
2022,10,GUWAHATI,SILCHAR,3380,3674,GUWAHATI-SILCHAR,7054,All
2022,11,GUWAHATI,SILCHAR,4727,4322,GUWAHATI-SILCHAR,9049,All
2022,12,GUWAHATI,SILCHAR,4376,4193,GUWAHATI-SILCHAR,8569,All
2023,1,GUWAHATI,SILCHAR,4233,3702,GUWAHATI-SILCHAR,7935,All
2023,2,GUWAHATI,SILCHAR,2433,2363,GUWAHATI-SILCHAR,4796,All
2023,3,GUWAHATI,SILCHAR,1893,1794,GUWAHATI-SILCHAR,3687,All
2023,4,GUWAHATI,SILCHAR,1815,1640,GUWAHATI-SILCHAR,3455,All
2023,5,GUWAHATI,SILCHAR,2140,2144,GUWAHATI-SILCHAR,4284,All
2023,6,GUWAHATI,SILCHAR,3748,3817,GUWAHATI-SILCHAR,7565,All
2023,7,GUWAHATI,SILCHAR,4289,4198,GUWAHATI-SILCHAR,8487,All
2023,8,GUWAHATI,SILCHAR,4113,3844,GUWAHATI-SILCHAR,7957,All
2023,9,GUWAHATI,SILCHAR,3710,3415,GUWAHATI-SILCHAR,7125,All
2023,10,GUWAHATI,SILCHAR,3938,3573,GUWAHATI-SILCHAR,7511,All
2023,11,GUWAHATI,SILCHAR,2855,2454,GUWAHATI-SILCHAR,5309,All
2023,12,GUWAHATI,SILCHAR,2101,2323,GUWAHATI-SILCHAR,4424,All
2024,1,GUWAHATI,SILCHAR,2268,2270,GUWAHATI-SILCHAR,4538,All
2024,2,GUWAHATI,SILCHAR,2111,1964,GUWAHATI-SILCHAR,4075,All
2024,3,GUWAHATI,SILCHAR,2293,2070,GUWAHATI-SILCHAR,4363,All
2024,4,GUWAHATI,SILCHAR,4496,3654,GUWAHATI-SILCHAR,8150,All
2024,6,GUWAHATI,SILCHAR,4400,4371,GUWAHATI-SILCHAR,8771,All
2024,7,GUWAHATI,SILCHAR,4650,4327,GUWAHATI-SILCHAR,8977,All
2024,8,GUWAHATI,SILCHAR,4235,3461,GUWAHATI-SILCHAR,7696,All
2024,9,GUWAHATI,SILCHAR,4094,3159,GUWAHATI-SILCHAR,7253,All
2024,10,GUWAHATI,SILCHAR,4555,3667,GUWAHATI-SILCHAR,8222,All
2024,11,GUWAHATI,SILCHAR,4977,4472,GUWAHATI-SILCHAR,9449,All
2024,12,GUWAHATI,SILCHAR,5293,4527,GUWAHATI-SILCHAR,9820,All
2025,1,GUWAHATI,SILCHAR,4544,3857,GUWAHATI-SILCHAR,8401,All
2025,2,GUWAHATI,SILCHAR,4731,4180,GUWAHATI-SILCHAR,8911,All
2025,3,GUWAHATI,SILCHAR,4818,3638,GUWAHATI-SILCHAR,8456,All
2017,2,GUWAHATI,SRINAGAR,0,20,GUWAHATI-SRINAGAR,20,All
2017,6,GUWAHATI,SRINAGAR,0,100,GUWAHATI-SRINAGAR,100,All
2017,7,GUWAHATI,SRINAGAR,0,110,GUWAHATI-SRINAGAR,110,All
2017,8,GUWAHATI,SRINAGAR,0,279,GUWAHATI-SRINAGAR,279,All
2017,9,GUWAHATI,SRINAGAR,0,481,GUWAHATI-SRINAGAR,481,All
2017,10,GUWAHATI,SRINAGAR,0,247,GUWAHATI-SRINAGAR,247,All
2017,11,GUWAHATI,SRINAGAR,0,260,GUWAHATI-SRINAGAR,260,All
2017,12,GUWAHATI,SRINAGAR,0,256,GUWAHATI-SRINAGAR,256,All
2018,1,GUWAHATI,SRINAGAR,0,156,GUWAHATI-SRINAGAR,156,All
2018,2,GUWAHATI,SRINAGAR,0,191,GUWAHATI-SRINAGAR,191,All
2018,3,GUWAHATI,SRINAGAR,0,92,GUWAHATI-SRINAGAR,92,All
2023,6,GUWAHATI,SRINAGAR,184,186,GUWAHATI-SRINAGAR,370,All
2016,11,GUWAHATI,TEZPUR,9,259,GUWAHATI-TEZPUR,268,All
2016,12,GUWAHATI,TEZPUR,33,52,GUWAHATI-TEZPUR,85,All
2017,1,GUWAHATI,TEZPUR,16,25,GUWAHATI-TEZPUR,41,All
2017,2,GUWAHATI,TEZPUR,26,304,GUWAHATI-TEZPUR,330,All
2017,3,GUWAHATI,TEZPUR,22,41,GUWAHATI-TEZPUR,63,All
2017,4,GUWAHATI,TEZPUR,19,364,GUWAHATI-TEZPUR,383,All
2017,5,GUWAHATI,TEZPUR,38,59,GUWAHATI-TEZPUR,97,All
2017,6,GUWAHATI,TEZPUR,16,57,GUWAHATI-TEZPUR,73,All
2017,7,GUWAHATI,TEZPUR,135,54,GUWAHATI-TEZPUR,189,All
2017,8,GUWAHATI,TEZPUR,34,30,GUWAHATI-TEZPUR,64,All
2017,9,GUWAHATI,TEZPUR,29,51,GUWAHATI-TEZPUR,80,All
2017,10,GUWAHATI,TEZPUR,30,79,GUWAHATI-TEZPUR,109,All
2017,11,GUWAHATI,TEZPUR,44,92,GUWAHATI-TEZPUR,136,All
2017,12,GUWAHATI,TEZPUR,46,82,GUWAHATI-TEZPUR,128,All
2018,1,GUWAHATI,TEZPUR,49,61,GUWAHATI-TEZPUR,110,All
2018,2,GUWAHATI,TEZPUR,46,75,GUWAHATI-TEZPUR,121,All
2018,3,GUWAHATI,TEZPUR,42,113,GUWAHATI-TEZPUR,155,All
2018,4,GUWAHATI,TEZPUR,58,65,GUWAHATI-TEZPUR,123,All
2018,5,GUWAHATI,TEZPUR,41,52,GUWAHATI-TEZPUR,93,All
2018,6,GUWAHATI,TEZPUR,31,0,GUWAHATI-TEZPUR,31,All
2018,7,GUWAHATI,TEZPUR,180,0,GUWAHATI-TEZPUR,180,All
2018,8,GUWAHATI,TEZPUR,19,0,GUWAHATI-TEZPUR,19,All
2018,9,GUWAHATI,TEZPUR,29,0,GUWAHATI-TEZPUR,29,All
2018,11,GUWAHATI,TEZPUR,0,266,GUWAHATI-TEZPUR,266,All
2018,12,GUWAHATI,TEZPUR,0,377,GUWAHATI-TEZPUR,377,All
2019,1,GUWAHATI,TEZPUR,28,63,GUWAHATI-TEZPUR,91,All
2019,2,GUWAHATI,TEZPUR,0,517,GUWAHATI-TEZPUR,517,All
2019,3,GUWAHATI,TEZPUR,22,84,GUWAHATI-TEZPUR,106,All
2019,4,GUWAHATI,TEZPUR,18,37,GUWAHATI-TEZPUR,55,All
2019,5,GUWAHATI,TEZPUR,49,64,GUWAHATI-TEZPUR,113,All
2019,6,GUWAHATI,TEZPUR,32,95,GUWAHATI-TEZPUR,127,All
2019,7,GUWAHATI,TEZPUR,33,39,GUWAHATI-TEZPUR,72,All
2019,8,GUWAHATI,TEZPUR,14,62,GUWAHATI-TEZPUR,76,All
2019,9,GUWAHATI,TEZPUR,24,63,GUWAHATI-TEZPUR,87,All
2019,10,GUWAHATI,TEZPUR,22,68,GUWAHATI-TEZPUR,90,All
2019,11,GUWAHATI,TEZPUR,17,55,GUWAHATI-TEZPUR,72,All
2019,12,GUWAHATI,TEZPUR,92,195,GUWAHATI-TEZPUR,287,All
2020,1,GUWAHATI,TEZPUR,46,48,GUWAHATI-TEZPUR,94,All
2020,2,GUWAHATI,TEZPUR,37,56,GUWAHATI-TEZPUR,93,All
2020,3,GUWAHATI,TEZPUR,57,42,GUWAHATI-TEZPUR,99,All
2020,6,GUWAHATI,TEZPUR,5,21,GUWAHATI-TEZPUR,26,All
2020,7,GUWAHATI,TEZPUR,1,25,GUWAHATI-TEZPUR,26,All
2020,8,GUWAHATI,TEZPUR,3,29,GUWAHATI-TEZPUR,32,All
2020,9,GUWAHATI,TEZPUR,1,24,GUWAHATI-TEZPUR,25,All
2020,10,GUWAHATI,TEZPUR,4,17,GUWAHATI-TEZPUR,21,All
2020,11,GUWAHATI,TEZPUR,0,21,GUWAHATI-TEZPUR,21,All
2020,12,GUWAHATI,TEZPUR,5,14,GUWAHATI-TEZPUR,19,All
2021,1,GUWAHATI,TEZPUR,7,17,GUWAHATI-TEZPUR,24,All
2021,2,GUWAHATI,TEZPUR,0,44,GUWAHATI-TEZPUR,44,All
2021,3,GUWAHATI,TEZPUR,8,36,GUWAHATI-TEZPUR,44,All
2021,4,GUWAHATI,TEZPUR,3,23,GUWAHATI-TEZPUR,26,All
2021,6,GUWAHATI,TEZPUR,5,13,GUWAHATI-TEZPUR,18,All
2021,7,GUWAHATI,TEZPUR,8,24,GUWAHATI-TEZPUR,32,All
2021,8,GUWAHATI,TEZPUR,11,22,GUWAHATI-TEZPUR,33,All
2021,9,GUWAHATI,TEZPUR,10,18,GUWAHATI-TEZPUR,28,All
2021,10,GUWAHATI,TEZPUR,93,66,GUWAHATI-TEZPUR,159,All
2021,11,GUWAHATI,TEZPUR,150,43,GUWAHATI-TEZPUR,193,All
2021,12,GUWAHATI,TEZPUR,160,30,GUWAHATI-TEZPUR,190,All
2022,1,GUWAHATI,TEZPUR,112,10,GUWAHATI-TEZPUR,122,All
2022,2,GUWAHATI,TEZPUR,100,33,GUWAHATI-TEZPUR,133,All
2022,3,GUWAHATI,TEZPUR,175,44,GUWAHATI-TEZPUR,219,All
2022,4,GUWAHATI,TEZPUR,150,43,GUWAHATI-TEZPUR,193,All
2022,5,GUWAHATI,TEZPUR,160,30,GUWAHATI-TEZPUR,190,All
2022,6,GUWAHATI,TEZPUR,150,43,GUWAHATI-TEZPUR,193,All
2022,7,GUWAHATI,TEZPUR,100,33,GUWAHATI-TEZPUR,133,All
2022,8,GUWAHATI,TEZPUR,160,30,GUWAHATI-TEZPUR,190,All
2022,9,GUWAHATI,TEZPUR,150,43,GUWAHATI-TEZPUR,193,All
2022,10,GUWAHATI,TEZPUR,83,36,GUWAHATI-TEZPUR,119,All
2022,11,GUWAHATI,TEZPUR,27,60,GUWAHATI-TEZPUR,87,All
2022,12,GUWAHATI,TEZPUR,60,80,GUWAHATI-TEZPUR,140,All
2023,1,GUWAHATI,TEZPUR,190,414,GUWAHATI-TEZPUR,604,All
2023,2,GUWAHATI,TEZPUR,15,46,GUWAHATI-TEZPUR,61,All
2023,3,GUWAHATI,TEZPUR,67,106,GUWAHATI-TEZPUR,173,All
2023,4,GUWAHATI,TEZPUR,459,604,GUWAHATI-TEZPUR,1063,All
2023,5,GUWAHATI,TEZPUR,367,427,GUWAHATI-TEZPUR,794,All
2023,6,GUWAHATI,TEZPUR,297,409,GUWAHATI-TEZPUR,706,All
2023,7,GUWAHATI,TEZPUR,259,382,GUWAHATI-TEZPUR,641,All
2023,8,GUWAHATI,TEZPUR,228,373,GUWAHATI-TEZPUR,601,All
2023,9,GUWAHATI,TEZPUR,268,332,GUWAHATI-TEZPUR,600,All
2023,10,GUWAHATI,TEZPUR,273,199,GUWAHATI-TEZPUR,472,All
2023,11,GUWAHATI,TEZPUR,202,202,GUWAHATI-TEZPUR,404,All
2023,12,GUWAHATI,TEZPUR,120,223,GUWAHATI-TEZPUR,343,All
2024,1,GUWAHATI,TEZPUR,118,250,GUWAHATI-TEZPUR,368,All
2024,2,GUWAHATI,TEZPUR,89,209,GUWAHATI-TEZPUR,298,All
2024,3,GUWAHATI,TEZPUR,198,263,GUWAHATI-TEZPUR,461,All
2024,4,GUWAHATI,TEZPUR,155,277,GUWAHATI-TEZPUR,432,All
2024,6,GUWAHATI,TEZPUR,279,494,GUWAHATI-TEZPUR,773,All
2024,7,GUWAHATI,TEZPUR,384,455,GUWAHATI-TEZPUR,839,All
2024,8,GUWAHATI,TEZPUR,401,489,GUWAHATI-TEZPUR,890,All
2024,9,GUWAHATI,TEZPUR,317,477,GUWAHATI-TEZPUR,794,All
2021,8,GUWAHATI,TEZU,110,136,GUWAHATI-TEZU,246,All
2021,9,GUWAHATI,TEZU,308,423,GUWAHATI-TEZU,731,All
2021,10,GUWAHATI,TEZU,376,553,GUWAHATI-TEZU,929,All
2021,11,GUWAHATI,TEZU,430,655,GUWAHATI-TEZU,1085,All
2021,12,GUWAHATI,TEZU,565,629,GUWAHATI-TEZU,1194,All
2022,1,GUWAHATI,TEZU,392,441,GUWAHATI-TEZU,833,All
2022,2,GUWAHATI,TEZU,259,471,GUWAHATI-TEZU,730,All
2022,3,GUWAHATI,TEZU,421,581,GUWAHATI-TEZU,1002,All
2022,4,GUWAHATI,TEZU,311,453,GUWAHATI-TEZU,764,All
2022,5,GUWAHATI,TEZU,285,432,GUWAHATI-TEZU,717,All
2022,6,GUWAHATI,TEZU,194,215,GUWAHATI-TEZU,409,All
2022,7,GUWAHATI,TEZU,349,418,GUWAHATI-TEZU,767,All
2022,8,GUWAHATI,TEZU,439,546,GUWAHATI-TEZU,985,All
2022,9,GUWAHATI,TEZU,763,832,GUWAHATI-TEZU,1595,All
2022,10,GUWAHATI,TEZU,1357,1317,GUWAHATI-TEZU,2674,All
2022,11,GUWAHATI,TEZU,737,1003,GUWAHATI-TEZU,1740,All
2022,12,GUWAHATI,TEZU,1507,1252,GUWAHATI-TEZU,2759,All
2023,1,GUWAHATI,TEZU,751,1141,GUWAHATI-TEZU,1892,All
2023,2,GUWAHATI,TEZU,594,926,GUWAHATI-TEZU,1520,All
2023,3,GUWAHATI,TEZU,511,551,GUWAHATI-TEZU,1062,All
2023,4,GUWAHATI,TEZU,691,751,GUWAHATI-TEZU,1442,All
2023,5,GUWAHATI,TEZU,768,1156,GUWAHATI-TEZU,1924,All
2023,6,GUWAHATI,TEZU,778,966,GUWAHATI-TEZU,1744,All
2023,7,GUWAHATI,TEZU,1162,1335,GUWAHATI-TEZU,2497,All
2023,8,GUWAHATI,TEZU,1030,1262,GUWAHATI-TEZU,2292,All
2023,9,GUWAHATI,TEZU,1538,1414,GUWAHATI-TEZU,2952,All
2023,10,GUWAHATI,TEZU,1376,1079,GUWAHATI-TEZU,2455,All
2023,11,GUWAHATI,TEZU,269,222,GUWAHATI-TEZU,491,All
2024,10,GUWAHATI,TEZU,180,183,GUWAHATI-TEZU,363,All
2024,11,GUWAHATI,TEZU,480,548,GUWAHATI-TEZU,1028,All
2024,12,GUWAHATI,TEZU,887,719,GUWAHATI-TEZU,1606,All
2025,1,GUWAHATI,TEZU,509,364,GUWAHATI-TEZU,873,All
2025,2,GUWAHATI,TEZU,21,19,GUWAHATI-TEZU,40,All
2025,3,GUWAHATI,TEZU,36,28,GUWAHATI-TEZU,64,All
2021,11,GUWAHATI,UDAIPUR,115,90,GUWAHATI-UDAIPUR,205,All
2021,12,GUWAHATI,UDAIPUR,186,138,GUWAHATI-UDAIPUR,324,All
2022,1,GUWAHATI,UDAIPUR,54,52,GUWAHATI-UDAIPUR,106,All
2022,3,GUWAHATI,UDAIPUR,170,81,GUWAHATI-UDAIPUR,251,All
2022,11,GUWAHATI,UDAIPUR,16,15,GUWAHATI-UDAIPUR,31,All
2022,12,GUWAHATI,UDAIPUR,30,126,GUWAHATI-UDAIPUR,156,All
2023,1,GUWAHATI,UDAIPUR,0,56,GUWAHATI-UDAIPUR,56,All
2023,2,GUWAHATI,UDAIPUR,120,119,GUWAHATI-UDAIPUR,239,All
2018,10,GUWAHATI,VARANASI,173,300,GUWAHATI-VARANASI,473,All
2018,11,GUWAHATI,VARANASI,2191,3030,GUWAHATI-VARANASI,5221,All
2018,12,GUWAHATI,VARANASI,2691,4198,GUWAHATI-VARANASI,6889,All
2019,1,GUWAHATI,VARANASI,3090,3941,GUWAHATI-VARANASI,7031,All
2019,2,GUWAHATI,VARANASI,3208,4184,GUWAHATI-VARANASI,7392,All
2019,3,GUWAHATI,VARANASI,2667,4220,GUWAHATI-VARANASI,6887,All
2019,4,GUWAHATI,VARANASI,3031,4603,GUWAHATI-VARANASI,7634,All
2019,5,GUWAHATI,VARANASI,3547,4625,GUWAHATI-VARANASI,8172,All
2019,6,GUWAHATI,VARANASI,4404,4878,GUWAHATI-VARANASI,9282,All
2019,7,GUWAHATI,VARANASI,3925,3775,GUWAHATI-VARANASI,7700,All
2019,8,GUWAHATI,VARANASI,2498,3541,GUWAHATI-VARANASI,6039,All
2020,2,GUWAHATI,VARANASI,62,0,GUWAHATI-VARANASI,62,All
2020,3,GUWAHATI,VARANASI,1179,1331,GUWAHATI-VARANASI,2510,All
2020,8,GUWAHATI,VARANASI,167,96,GUWAHATI-VARANASI,263,All
2020,9,GUWAHATI,VARANASI,1149,444,GUWAHATI-VARANASI,1593,All
2020,10,GUWAHATI,VARANASI,1126,0,GUWAHATI-VARANASI,1126,All
2020,11,GUWAHATI,VARANASI,1113,0,GUWAHATI-VARANASI,1113,All
2020,12,GUWAHATI,VARANASI,682,0,GUWAHATI-VARANASI,682,All
2021,1,GUWAHATI,VARANASI,982,0,GUWAHATI-VARANASI,982,All
2021,2,GUWAHATI,VARANASI,827,0,GUWAHATI-VARANASI,827,All
2021,3,GUWAHATI,VARANASI,850,0,GUWAHATI-VARANASI,850,All
2021,4,GUWAHATI,VARANASI,1,0,GUWAHATI-VARANASI,1,All
2021,6,GUWAHATI,VARANASI,81,69,GUWAHATI-VARANASI,150,All
2021,7,GUWAHATI,VARANASI,200,134,GUWAHATI-VARANASI,334,All
2021,8,GUWAHATI,VARANASI,212,163,GUWAHATI-VARANASI,375,All
2021,9,GUWAHATI,VARANASI,705,605,GUWAHATI-VARANASI,1310,All
2021,10,GUWAHATI,VARANASI,1091,1057,GUWAHATI-VARANASI,2148,All
2022,3,GUWAHATI,VARANASI,178,152,GUWAHATI-VARANASI,330,All
2022,4,GUWAHATI,VARANASI,1500,1322,GUWAHATI-VARANASI,2822,All
2022,5,GUWAHATI,VARANASI,1231,1322,GUWAHATI-VARANASI,2553,All
2022,6,GUWAHATI,VARANASI,897,1025,GUWAHATI-VARANASI,1922,All
2022,7,GUWAHATI,VARANASI,195,180,GUWAHATI-VARANASI,375,All
2022,8,GUWAHATI,VARANASI,210,259,GUWAHATI-VARANASI,469,All
2022,9,GUWAHATI,VARANASI,379,420,GUWAHATI-VARANASI,799,All
2022,10,GUWAHATI,VARANASI,489,475,GUWAHATI-VARANASI,964,All
2023,7,GUWAHATI,VARANASI,600,537,GUWAHATI-VARANASI,1137,All
2023,8,GUWAHATI,VARANASI,300,305,GUWAHATI-VARANASI,605,All
2018,10,GUWAHATI,VISAKHAPATNAM,0,24,GUWAHATI-VISAKHAPATNAM,24,All
2018,11,GUWAHATI,VISAKHAPATNAM,0,295,GUWAHATI-VISAKHAPATNAM,295,All
2018,12,GUWAHATI,VISAKHAPATNAM,0,163,GUWAHATI-VISAKHAPATNAM,163,All
2019,1,GUWAHATI,VISAKHAPATNAM,0,400,GUWAHATI-VISAKHAPATNAM,400,All
2019,2,GUWAHATI,VISAKHAPATNAM,0,1,GUWAHATI-VISAKHAPATNAM,1,All
2022,8,GUWAHATI,VISAKHAPATNAM,0,17,GUWAHATI-VISAKHAPATNAM,17,All
2024,12,GUWAHATI,Ziro,62,43,GUWAHATI-Ziro,105,All
2025,1,GUWAHATI,Ziro,43,60,GUWAHATI-Ziro,103,All
2025,2,GUWAHATI,Ziro,36,35,GUWAHATI-Ziro,71,All
2025,3,GUWAHATI,Ziro,13,19,GUWAHATI-Ziro,32,All
2019,5,GWALIOR,HYDERABAD,1723,1336,GWALIOR-HYDERABAD,3059,All
2019,6,GWALIOR,HYDERABAD,1922,1528,GWALIOR-HYDERABAD,3450,All
2019,7,GWALIOR,HYDERABAD,1350,1351,GWALIOR-HYDERABAD,2701,All
2019,8,GWALIOR,HYDERABAD,1515,1569,GWALIOR-HYDERABAD,3084,All
2019,9,GWALIOR,HYDERABAD,1148,1273,GWALIOR-HYDERABAD,2421,All
2019,10,GWALIOR,HYDERABAD,1509,1823,GWALIOR-HYDERABAD,3332,All
2019,11,GWALIOR,HYDERABAD,1763,1569,GWALIOR-HYDERABAD,3332,All
2019,12,GWALIOR,HYDERABAD,1989,1925,GWALIOR-HYDERABAD,3914,All
2020,1,GWALIOR,HYDERABAD,1700,1850,GWALIOR-HYDERABAD,3550,All
2020,2,GWALIOR,HYDERABAD,1764,2075,GWALIOR-HYDERABAD,3839,All
2020,3,GWALIOR,HYDERABAD,1312,1411,GWALIOR-HYDERABAD,2723,All
2020,6,GWALIOR,HYDERABAD,430,692,GWALIOR-HYDERABAD,1122,All
2020,7,GWALIOR,HYDERABAD,508,876,GWALIOR-HYDERABAD,1384,All
2020,8,GWALIOR,HYDERABAD,1012,911,GWALIOR-HYDERABAD,1923,All
2020,9,GWALIOR,HYDERABAD,1011,784,GWALIOR-HYDERABAD,1795,All
2020,10,GWALIOR,HYDERABAD,984,982,GWALIOR-HYDERABAD,1966,All
2020,11,GWALIOR,HYDERABAD,1048,1302,GWALIOR-HYDERABAD,2350,All
2020,12,GWALIOR,HYDERABAD,1581,1051,GWALIOR-HYDERABAD,2632,All
2021,1,GWALIOR,HYDERABAD,1068,893,GWALIOR-HYDERABAD,1961,All
2021,2,GWALIOR,HYDERABAD,801,1120,GWALIOR-HYDERABAD,1921,All
2021,3,GWALIOR,HYDERABAD,958,1273,GWALIOR-HYDERABAD,2231,All
2021,4,GWALIOR,HYDERABAD,925,1059,GWALIOR-HYDERABAD,1984,All
2021,6,GWALIOR,HYDERABAD,833,1036,GWALIOR-HYDERABAD,1869,All
2021,7,GWALIOR,HYDERABAD,1031,1128,GWALIOR-HYDERABAD,2159,All
2021,8,GWALIOR,HYDERABAD,1129,1413,GWALIOR-HYDERABAD,2542,All
2021,9,GWALIOR,HYDERABAD,988,1101,GWALIOR-HYDERABAD,2089,All
2021,10,GWALIOR,HYDERABAD,1181,1857,GWALIOR-HYDERABAD,3038,All
2021,11,GWALIOR,HYDERABAD,1859,1911,GWALIOR-HYDERABAD,3770,All
2021,12,GWALIOR,HYDERABAD,1415,1305,GWALIOR-HYDERABAD,2720,All
2022,1,GWALIOR,HYDERABAD,483,595,GWALIOR-HYDERABAD,1078,All
2022,2,GWALIOR,HYDERABAD,1006,1258,GWALIOR-HYDERABAD,2264,All
2022,3,GWALIOR,HYDERABAD,1408,1732,GWALIOR-HYDERABAD,3140,All
2022,4,GWALIOR,HYDERABAD,1592,1897,GWALIOR-HYDERABAD,3489,All
2022,5,GWALIOR,HYDERABAD,1898,1737,GWALIOR-HYDERABAD,3635,All
2022,6,GWALIOR,HYDERABAD,1871,1635,GWALIOR-HYDERABAD,3506,All
2022,7,GWALIOR,HYDERABAD,435,482,GWALIOR-HYDERABAD,917,All
2022,8,GWALIOR,HYDERABAD,295,305,GWALIOR-HYDERABAD,600,All
2022,9,GWALIOR,HYDERABAD,119,121,GWALIOR-HYDERABAD,240,All
2023,1,GWALIOR,HYDERABAD,589,574,GWALIOR-HYDERABAD,1163,All
2023,2,GWALIOR,HYDERABAD,1294,1531,GWALIOR-HYDERABAD,2825,All
2023,3,GWALIOR,HYDERABAD,1615,1662,GWALIOR-HYDERABAD,3277,All
2023,4,GWALIOR,HYDERABAD,1503,1980,GWALIOR-HYDERABAD,3483,All
2023,5,GWALIOR,HYDERABAD,2389,2343,GWALIOR-HYDERABAD,4732,All
2023,6,GWALIOR,HYDERABAD,2011,1736,GWALIOR-HYDERABAD,3747,All
2023,7,GWALIOR,HYDERABAD,1161,1101,GWALIOR-HYDERABAD,2262,All
2023,8,GWALIOR,HYDERABAD,834,1071,GWALIOR-HYDERABAD,1905,All
2023,9,GWALIOR,HYDERABAD,1044,1105,GWALIOR-HYDERABAD,2149,All
2023,10,GWALIOR,HYDERABAD,254,361,GWALIOR-HYDERABAD,615,All
2023,11,GWALIOR,HYDERABAD,318,116,GWALIOR-HYDERABAD,434,All
2023,12,GWALIOR,HYDERABAD,1965,1053,GWALIOR-HYDERABAD,3018,All
2024,1,GWALIOR,HYDERABAD,1386,1360,GWALIOR-HYDERABAD,2746,All
2024,2,GWALIOR,HYDERABAD,960,1261,GWALIOR-HYDERABAD,2221,All
2024,3,GWALIOR,HYDERABAD,1044,1301,GWALIOR-HYDERABAD,2345,All
2024,4,GWALIOR,HYDERABAD,1401,1983,GWALIOR-HYDERABAD,3384,All
2024,6,GWALIOR,HYDERABAD,2026,1841,GWALIOR-HYDERABAD,3867,All
2024,7,GWALIOR,HYDERABAD,253,424,GWALIOR-HYDERABAD,677,All
2024,10,GWALIOR,HYDERABAD,47,320,GWALIOR-HYDERABAD,367,All
2024,11,GWALIOR,HYDERABAD,1112,542,GWALIOR-HYDERABAD,1654,All
2024,12,GWALIOR,HYDERABAD,932,614,GWALIOR-HYDERABAD,1546,All
2025,1,GWALIOR,HYDERABAD,872,702,GWALIOR-HYDERABAD,1574,All
2017,6,GWALIOR,INDORE,0,503,GWALIOR-INDORE,503,All
2017,7,GWALIOR,INDORE,0,493,GWALIOR-INDORE,493,All
2017,8,GWALIOR,INDORE,0,610,GWALIOR-INDORE,610,All
2017,9,GWALIOR,INDORE,185,489,GWALIOR-INDORE,674,All
2017,10,GWALIOR,INDORE,383,406,GWALIOR-INDORE,789,All
2017,11,GWALIOR,INDORE,361,287,GWALIOR-INDORE,648,All
2017,12,GWALIOR,INDORE,400,425,GWALIOR-INDORE,825,All
2018,1,GWALIOR,INDORE,324,349,GWALIOR-INDORE,673,All
2018,2,GWALIOR,INDORE,253,258,GWALIOR-INDORE,511,All
2018,3,GWALIOR,INDORE,212,327,GWALIOR-INDORE,539,All
2018,4,GWALIOR,INDORE,352,324,GWALIOR-INDORE,676,All
2018,5,GWALIOR,INDORE,316,370,GWALIOR-INDORE,686,All
2018,6,GWALIOR,INDORE,352,344,GWALIOR-INDORE,696,All
2018,7,GWALIOR,INDORE,202,314,GWALIOR-INDORE,516,All
2018,8,GWALIOR,INDORE,272,351,GWALIOR-INDORE,623,All
2018,9,GWALIOR,INDORE,270,325,GWALIOR-INDORE,595,All
2019,1,GWALIOR,INDORE,363,368,GWALIOR-INDORE,731,All
2019,3,GWALIOR,INDORE,430,431,GWALIOR-INDORE,861,All
2019,4,GWALIOR,INDORE,357,375,GWALIOR-INDORE,732,All
2019,5,GWALIOR,INDORE,448,456,GWALIOR-INDORE,904,All
2019,6,GWALIOR,INDORE,409,399,GWALIOR-INDORE,808,All
2019,7,GWALIOR,INDORE,295,268,GWALIOR-INDORE,563,All
2019,8,GWALIOR,INDORE,415,431,GWALIOR-INDORE,846,All
2019,9,GWALIOR,INDORE,337,394,GWALIOR-INDORE,731,All
2019,10,GWALIOR,INDORE,389,465,GWALIOR-INDORE,854,All
2019,11,GWALIOR,INDORE,480,527,GWALIOR-INDORE,1007,All
2019,12,GWALIOR,INDORE,463,493,GWALIOR-INDORE,956,All
2020,1,GWALIOR,INDORE,480,518,GWALIOR-INDORE,998,All
2020,2,GWALIOR,INDORE,412,466,GWALIOR-INDORE,878,All
2020,3,GWALIOR,INDORE,271,334,GWALIOR-INDORE,605,All
2021,9,GWALIOR,INDORE,1152,844,GWALIOR-INDORE,1996,All
2021,10,GWALIOR,INDORE,1127,962,GWALIOR-INDORE,2089,All
2021,11,GWALIOR,INDORE,1180,1353,GWALIOR-INDORE,2533,All
2021,12,GWALIOR,INDORE,1390,1516,GWALIOR-INDORE,2906,All
2022,1,GWALIOR,INDORE,541,673,GWALIOR-INDORE,1214,All
2022,2,GWALIOR,INDORE,572,660,GWALIOR-INDORE,1232,All
2022,3,GWALIOR,INDORE,1088,1386,GWALIOR-INDORE,2474,All
2022,4,GWALIOR,INDORE,1021,1377,GWALIOR-INDORE,2398,All
2022,5,GWALIOR,INDORE,1370,1366,GWALIOR-INDORE,2736,All
2022,6,GWALIOR,INDORE,1755,1385,GWALIOR-INDORE,3140,All
2022,7,GWALIOR,INDORE,1370,1432,GWALIOR-INDORE,2802,All
2022,8,GWALIOR,INDORE,1718,1832,GWALIOR-INDORE,3550,All
2022,9,GWALIOR,INDORE,331,400,GWALIOR-INDORE,731,All
2022,10,GWALIOR,INDORE,271,275,GWALIOR-INDORE,546,All
2022,11,GWALIOR,INDORE,318,332,GWALIOR-INDORE,650,All
2022,12,GWALIOR,INDORE,358,383,GWALIOR-INDORE,741,All
2023,1,GWALIOR,INDORE,206,355,GWALIOR-INDORE,561,All
2023,2,GWALIOR,INDORE,291,313,GWALIOR-INDORE,604,All
2023,3,GWALIOR,INDORE,192,193,GWALIOR-INDORE,385,All
2023,4,GWALIOR,INDORE,257,274,GWALIOR-INDORE,531,All
2023,5,GWALIOR,INDORE,285,306,GWALIOR-INDORE,591,All
2023,6,GWALIOR,INDORE,352,308,GWALIOR-INDORE,660,All
2023,7,GWALIOR,INDORE,257,309,GWALIOR-INDORE,566,All
2023,8,GWALIOR,INDORE,299,349,GWALIOR-INDORE,648,All
2023,9,GWALIOR,INDORE,274,310,GWALIOR-INDORE,584,All
2023,10,GWALIOR,INDORE,295,340,GWALIOR-INDORE,635,All
2023,11,GWALIOR,INDORE,275,255,GWALIOR-INDORE,530,All
2023,12,GWALIOR,INDORE,310,307,GWALIOR-INDORE,617,All
2024,1,GWALIOR,INDORE,389,353,GWALIOR-INDORE,742,All
2024,2,GWALIOR,INDORE,441,472,GWALIOR-INDORE,913,All
2024,3,GWALIOR,INDORE,534,501,GWALIOR-INDORE,1035,All
2024,4,GWALIOR,INDORE,549,525,GWALIOR-INDORE,1074,All
2024,6,GWALIOR,INDORE,700,698,GWALIOR-INDORE,1398,All
2024,7,GWALIOR,INDORE,282,275,GWALIOR-INDORE,557,All
2022,10,GWALIOR,JABALPUR,35,39,GWALIOR-JABALPUR,74,All
2022,11,GWALIOR,JABALPUR,33,40,GWALIOR-JABALPUR,73,All
2022,12,GWALIOR,JABALPUR,56,23,GWALIOR-JABALPUR,79,All
2023,1,GWALIOR,JABALPUR,22,0,GWALIOR-JABALPUR,22,All
2023,2,GWALIOR,JABALPUR,29,18,GWALIOR-JABALPUR,47,All
2023,3,GWALIOR,JABALPUR,34,9,GWALIOR-JABALPUR,43,All
2021,8,GWALIOR,JAIPUR,170,130,GWALIOR-JAIPUR,300,All
2021,9,GWALIOR,JAIPUR,171,199,GWALIOR-JAIPUR,370,All
2021,10,GWALIOR,JAIPUR,40,8,GWALIOR-JAIPUR,48,All
2021,11,GWALIOR,JAIPUR,52,47,GWALIOR-JAIPUR,99,All
2021,12,GWALIOR,JAIPUR,18,21,GWALIOR-JAIPUR,39,All
2022,1,GWALIOR,JAIPUR,3,7,GWALIOR-JAIPUR,10,All
2022,2,GWALIOR,JAIPUR,2,6,GWALIOR-JAIPUR,8,All
2022,3,GWALIOR,JAIPUR,12,15,GWALIOR-JAIPUR,27,All
2019,5,GWALIOR,JAMMU,1575,997,GWALIOR-JAMMU,2572,All
2019,6,GWALIOR,JAMMU,2218,1774,GWALIOR-JAMMU,3992,All
2019,7,GWALIOR,JAMMU,2173,1870,GWALIOR-JAMMU,4043,All
2019,8,GWALIOR,JAMMU,1481,1158,GWALIOR-JAMMU,2639,All
2019,9,GWALIOR,JAMMU,1159,939,GWALIOR-JAMMU,2098,All
2019,10,GWALIOR,JAMMU,1384,1255,GWALIOR-JAMMU,2639,All
2019,11,GWALIOR,JAMMU,1116,1041,GWALIOR-JAMMU,2157,All
2019,12,GWALIOR,JAMMU,1036,1006,GWALIOR-JAMMU,2042,All
2020,1,GWALIOR,JAMMU,521,342,GWALIOR-JAMMU,863,All
2020,2,GWALIOR,JAMMU,856,762,GWALIOR-JAMMU,1618,All
2020,3,GWALIOR,JAMMU,1003,831,GWALIOR-JAMMU,1834,All
2020,6,GWALIOR,JAMMU,185,148,GWALIOR-JAMMU,333,All
2021,1,GWALIOR,JAMMU,217,101,GWALIOR-JAMMU,318,All
2021,2,GWALIOR,JAMMU,917,561,GWALIOR-JAMMU,1478,All
2021,3,GWALIOR,JAMMU,593,335,GWALIOR-JAMMU,928,All
2021,4,GWALIOR,JAMMU,74,77,GWALIOR-JAMMU,151,All
2021,6,GWALIOR,JAMMU,715,418,GWALIOR-JAMMU,1133,All
2021,7,GWALIOR,JAMMU,1008,715,GWALIOR-JAMMU,1723,All
2021,8,GWALIOR,JAMMU,832,540,GWALIOR-JAMMU,1372,All
2021,9,GWALIOR,JAMMU,671,375,GWALIOR-JAMMU,1046,All
2021,10,GWALIOR,JAMMU,1092,685,GWALIOR-JAMMU,1777,All
2021,11,GWALIOR,JAMMU,877,638,GWALIOR-JAMMU,1515,All
2021,12,GWALIOR,JAMMU,1191,1014,GWALIOR-JAMMU,2205,All
2022,1,GWALIOR,JAMMU,598,676,GWALIOR-JAMMU,1274,All
2022,2,GWALIOR,JAMMU,708,447,GWALIOR-JAMMU,1155,All
2022,3,GWALIOR,JAMMU,1286,1027,GWALIOR-JAMMU,2313,All
2022,4,GWALIOR,JAMMU,1049,1105,GWALIOR-JAMMU,2154,All
2022,5,GWALIOR,JAMMU,935,716,GWALIOR-JAMMU,1651,All
2022,6,GWALIOR,JAMMU,1074,966,GWALIOR-JAMMU,2040,All
2022,7,GWALIOR,JAMMU,296,204,GWALIOR-JAMMU,500,All
2023,6,GWALIOR,JAMMU,255,179,GWALIOR-JAMMU,434,All
2023,7,GWALIOR,JAMMU,910,986,GWALIOR-JAMMU,1896,All
2023,8,GWALIOR,JAMMU,256,194,GWALIOR-JAMMU,450,All
2023,9,GWALIOR,JAMMU,618,445,GWALIOR-JAMMU,1063,All
2023,10,GWALIOR,JAMMU,165,91,GWALIOR-JAMMU,256,All
2019,6,GWALIOR,KOLKATA,397,389,GWALIOR-KOLKATA,786,All
2019,7,GWALIOR,KOLKATA,1545,1275,GWALIOR-KOLKATA,2820,All
2019,8,GWALIOR,KOLKATA,1727,1416,GWALIOR-KOLKATA,3143,All
2019,9,GWALIOR,KOLKATA,1500,1156,GWALIOR-KOLKATA,2656,All
2019,10,GWALIOR,KOLKATA,2132,1901,GWALIOR-KOLKATA,4033,All
2019,11,GWALIOR,KOLKATA,1587,1480,GWALIOR-KOLKATA,3067,All
2019,12,GWALIOR,KOLKATA,2150,1867,GWALIOR-KOLKATA,4017,All
2020,1,GWALIOR,KOLKATA,1749,1619,GWALIOR-KOLKATA,3368,All
2020,2,GWALIOR,KOLKATA,1979,1967,GWALIOR-KOLKATA,3946,All
2020,3,GWALIOR,KOLKATA,1552,1452,GWALIOR-KOLKATA,3004,All
2020,6,GWALIOR,KOLKATA,422,316,GWALIOR-KOLKATA,738,All
2020,7,GWALIOR,KOLKATA,374,202,GWALIOR-KOLKATA,576,All
2020,8,GWALIOR,KOLKATA,676,785,GWALIOR-KOLKATA,1461,All
2020,9,GWALIOR,KOLKATA,725,993,GWALIOR-KOLKATA,1718,All
2020,10,GWALIOR,KOLKATA,969,1089,GWALIOR-KOLKATA,2058,All
2020,11,GWALIOR,KOLKATA,1117,1206,GWALIOR-KOLKATA,2323,All
2020,12,GWALIOR,KOLKATA,1253,1228,GWALIOR-KOLKATA,2481,All
2021,1,GWALIOR,KOLKATA,1233,1176,GWALIOR-KOLKATA,2409,All
2021,2,GWALIOR,KOLKATA,1159,1194,GWALIOR-KOLKATA,2353,All
2021,3,GWALIOR,KOLKATA,1257,1369,GWALIOR-KOLKATA,2626,All
2021,4,GWALIOR,KOLKATA,1212,1155,GWALIOR-KOLKATA,2367,All
2021,6,GWALIOR,KOLKATA,578,614,GWALIOR-KOLKATA,1192,All
2021,7,GWALIOR,KOLKATA,1254,1136,GWALIOR-KOLKATA,2390,All
2021,8,GWALIOR,KOLKATA,995,969,GWALIOR-KOLKATA,1964,All
2021,9,GWALIOR,KOLKATA,935,935,GWALIOR-KOLKATA,1870,All
2021,10,GWALIOR,KOLKATA,1655,1418,GWALIOR-KOLKATA,3073,All
2021,11,GWALIOR,KOLKATA,1745,1646,GWALIOR-KOLKATA,3391,All
2021,12,GWALIOR,KOLKATA,1970,1877,GWALIOR-KOLKATA,3847,All
2022,1,GWALIOR,KOLKATA,1062,851,GWALIOR-KOLKATA,1913,All
2022,2,GWALIOR,KOLKATA,1336,1244,GWALIOR-KOLKATA,2580,All
2022,3,GWALIOR,KOLKATA,1354,1426,GWALIOR-KOLKATA,2780,All
2022,4,GWALIOR,KOLKATA,1813,1585,GWALIOR-KOLKATA,3398,All
2022,5,GWALIOR,KOLKATA,1639,1511,GWALIOR-KOLKATA,3150,All
2022,6,GWALIOR,KOLKATA,1740,1530,GWALIOR-KOLKATA,3270,All
2022,7,GWALIOR,KOLKATA,1357,1339,GWALIOR-KOLKATA,2696,All
2022,8,GWALIOR,KOLKATA,1193,1183,GWALIOR-KOLKATA,2376,All
2022,9,GWALIOR,KOLKATA,633,453,GWALIOR-KOLKATA,1086,All
2023,6,GWALIOR,KOLKATA,325,271,GWALIOR-KOLKATA,596,All
2023,7,GWALIOR,KOLKATA,1143,1229,GWALIOR-KOLKATA,2372,All
2023,8,GWALIOR,KOLKATA,297,470,GWALIOR-KOLKATA,767,All
2023,9,GWALIOR,KOLKATA,993,919,GWALIOR-KOLKATA,1912,All
2023,10,GWALIOR,KOLKATA,363,353,GWALIOR-KOLKATA,716,All
2019,5,GWALIOR,MUMBAI,214,188,GWALIOR-MUMBAI,402,All
2019,6,GWALIOR,MUMBAI,145,120,GWALIOR-MUMBAI,265,All
2019,7,GWALIOR,MUMBAI,146,99,GWALIOR-MUMBAI,245,All
2019,8,GWALIOR,MUMBAI,144,130,GWALIOR-MUMBAI,274,All
2019,9,GWALIOR,MUMBAI,114,130,GWALIOR-MUMBAI,244,All
2019,10,GWALIOR,MUMBAI,99,126,GWALIOR-MUMBAI,225,All
2021,7,GWALIOR,MUMBAI,333,386,GWALIOR-MUMBAI,719,All
2021,8,GWALIOR,MUMBAI,882,1099,GWALIOR-MUMBAI,1981,All
2021,9,GWALIOR,MUMBAI,917,947,GWALIOR-MUMBAI,1864,All
2021,10,GWALIOR,MUMBAI,1054,1352,GWALIOR-MUMBAI,2406,All
2021,11,GWALIOR,MUMBAI,2002,1964,GWALIOR-MUMBAI,3966,All
2021,12,GWALIOR,MUMBAI,2149,1627,GWALIOR-MUMBAI,3776,All
2022,1,GWALIOR,MUMBAI,629,642,GWALIOR-MUMBAI,1271,All
2022,2,GWALIOR,MUMBAI,1543,1618,GWALIOR-MUMBAI,3161,All
2022,3,GWALIOR,MUMBAI,1626,1433,GWALIOR-MUMBAI,3059,All
2022,4,GWALIOR,MUMBAI,1792,1719,GWALIOR-MUMBAI,3511,All
2022,5,GWALIOR,MUMBAI,1342,1327,GWALIOR-MUMBAI,2669,All
2022,6,GWALIOR,MUMBAI,1172,961,GWALIOR-MUMBAI,2133,All
2022,7,GWALIOR,MUMBAI,375,336,GWALIOR-MUMBAI,711,All
2022,8,GWALIOR,MUMBAI,368,340,GWALIOR-MUMBAI,708,All
2022,9,GWALIOR,MUMBAI,110,119,GWALIOR-MUMBAI,229,All
2022,10,GWALIOR,MUMBAI,552,823,GWALIOR-MUMBAI,1375,All
2022,11,GWALIOR,MUMBAI,1420,1506,GWALIOR-MUMBAI,2926,All
2022,12,GWALIOR,MUMBAI,4001,3577,GWALIOR-MUMBAI,7578,All
2023,11,GWALIOR,MUMBAI,3945,4588,GWALIOR-MUMBAI,8533,All
2023,12,GWALIOR,MUMBAI,4024,3898,GWALIOR-MUMBAI,7922,All
2024,1,GWALIOR,MUMBAI,4673,4594,GWALIOR-MUMBAI,9267,All
2024,2,GWALIOR,MUMBAI,4301,4664,GWALIOR-MUMBAI,8965,All
2024,3,GWALIOR,MUMBAI,4876,5029,GWALIOR-MUMBAI,9905,All
2024,4,GWALIOR,MUMBAI,4592,5735,GWALIOR-MUMBAI,10327,All
2024,6,GWALIOR,MUMBAI,5523,4425,GWALIOR-MUMBAI,9948,All
2024,7,GWALIOR,MUMBAI,5073,5094,GWALIOR-MUMBAI,10167,All
2024,8,GWALIOR,MUMBAI,4205,4140,GWALIOR-MUMBAI,8345,All
2024,9,GWALIOR,MUMBAI,3576,3846,GWALIOR-MUMBAI,7422,All
2024,10,GWALIOR,MUMBAI,3400,4918,GWALIOR-MUMBAI,8318,All
2024,11,GWALIOR,MUMBAI,5403,5156,GWALIOR-MUMBAI,10559,All
2024,12,GWALIOR,MUMBAI,5554,5024,GWALIOR-MUMBAI,10578,All
2025,1,GWALIOR,MUMBAI,5108,5381,GWALIOR-MUMBAI,10489,All
2025,2,GWALIOR,MUMBAI,4719,4976,GWALIOR-MUMBAI,9695,All
2025,3,GWALIOR,MUMBAI,4979,5029,GWALIOR-MUMBAI,10008,All
2021,3,GWALIOR,PUNE,20,44,GWALIOR-PUNE,64,All
2021,4,GWALIOR,PUNE,140,259,GWALIOR-PUNE,399,All
2021,7,GWALIOR,PUNE,300,268,GWALIOR-PUNE,568,All
2021,8,GWALIOR,PUNE,768,731,GWALIOR-PUNE,1499,All
2021,9,GWALIOR,PUNE,698,711,GWALIOR-PUNE,1409,All
2021,10,GWALIOR,PUNE,412,462,GWALIOR-PUNE,874,All
2021,10,GWALIOR,SILCHAR,0,11,GWALIOR-SILCHAR,11,All
2023,1,Goa,AHMEDABAD,3132,3623,AHMEDABAD-Goa,6755,All
2023,6,Goa,AHMEDABAD,13830,13403,AHMEDABAD-Goa,27233,All
2023,7,Goa,AHMEDABAD,12982,12658,AHMEDABAD-Goa,25640,All
2023,8,Goa,AHMEDABAD,11113,11006,AHMEDABAD-Goa,22119,All
2023,9,Goa,AHMEDABAD,14067,13709,AHMEDABAD-Goa,27776,All
2023,10,Goa,AHMEDABAD,12179,11644,AHMEDABAD-Goa,23823,All
2023,6,Goa,AMRITSAR,3792,4863,AMRITSAR-Goa,8655,All
2023,8,Goa,AMRITSAR,1448,1452,AMRITSAR-Goa,2900,All
2023,9,Goa,AMRITSAR,3751,3983,AMRITSAR-Goa,7734,All
2023,10,Goa,AMRITSAR,4349,4258,AMRITSAR-Goa,8607,All
2023,1,Goa,BENGALURU,20344,18661,BENGALURU-Goa,39005,All
2023,6,Goa,BENGALURU,21323,19732,BENGALURU-Goa,41055,All
2023,7,Goa,BENGALURU,14941,14482,BENGALURU-Goa,29423,All
2023,8,Goa,BENGALURU,11319,12358,BENGALURU-Goa,23677,All
2023,9,Goa,BENGALURU,13356,14758,BENGALURU-Goa,28114,All
2023,10,Goa,BENGALURU,19604,19777,BENGALURU-Goa,39381,All
2023,6,Goa,BHOPAL,1917,1920,BHOPAL-Goa,3837,All
2023,7,Goa,BHOPAL,1546,1688,BHOPAL-Goa,3234,All
2023,8,Goa,BHOPAL,1888,1888,BHOPAL-Goa,3776,All
2023,9,Goa,BHOPAL,1960,2045,BHOPAL-Goa,4005,All
2023,10,Goa,BHOPAL,2121,2085,BHOPAL-Goa,4206,All
2023,6,Goa,BHUBANESWAR,2634,2210,BHUBANESWAR-Goa,4844,All
2023,7,Goa,BHUBANESWAR,1135,1199,BHUBANESWAR-Goa,2334,All
2023,8,Goa,BHUBANESWAR,1775,1612,BHUBANESWAR-Goa,3387,All
2023,9,Goa,BHUBANESWAR,2099,2664,BHUBANESWAR-Goa,4763,All
2023,10,Goa,BHUBANESWAR,2994,3013,BHUBANESWAR-Goa,6007,All
2023,1,Goa,CHANDIGARH,1248,1228,CHANDIGARH-Goa,2476,All
2023,10,Goa,CHANDIGARH,329,130,CHANDIGARH-Goa,459,All
2023,1,Goa,CHENNAI,3435,3530,CHENNAI-Goa,6965,All
2023,6,Goa,CHENNAI,1481,1822,CHENNAI-Goa,3303,All
2023,7,Goa,CHENNAI,5091,5449,CHENNAI-Goa,10540,All
2023,8,Goa,CHENNAI,5630,6743,CHENNAI-Goa,12373,All
2023,9,Goa,CHENNAI,5594,6630,CHENNAI-Goa,12224,All
2023,10,Goa,CHENNAI,6286,6160,CHENNAI-Goa,12446,All
2023,6,Goa,COIMBATORE,2168,2065,COIMBATORE-Goa,4233,All
2023,7,Goa,COIMBATORE,2392,2175,COIMBATORE-Goa,4567,All
2023,8,Goa,COIMBATORE,2205,2261,COIMBATORE-Goa,4466,All
2023,9,Goa,COIMBATORE,2461,2627,COIMBATORE-Goa,5088,All
2023,10,Goa,COIMBATORE,2830,2649,COIMBATORE-Goa,5479,All
2023,1,Goa,DELHI,15946,16170,DELHI-Goa,32116,All
2023,6,Goa,DELHI,18313,19833,DELHI-Goa,38146,All
2023,7,Goa,DELHI,16940,17341,DELHI-Goa,34281,All
2023,8,Goa,DELHI,25838,25130,DELHI-Goa,50968,All
2023,9,Goa,DELHI,22575,24481,DELHI-Goa,47056,All
2023,10,Goa,DELHI,25515,24417,DELHI-Goa,49932,All
2023,6,Goa,DehraDun,1860,1800,DehraDun-Goa,3660,All
2023,7,Goa,DehraDun,1359,1166,DehraDun-Goa,2525,All
2023,8,Goa,DehraDun,1535,1321,DehraDun-Goa,2856,All
2023,9,Goa,DehraDun,1860,1804,DehraDun-Goa,3664,All
2023,10,Goa,DehraDun,1933,1903,DehraDun-Goa,3836,All
2023,6,Goa,GUWAHATI,128,95,Goa-GUWAHATI,223,All
2023,7,Goa,GUWAHATI,181,252,Goa-GUWAHATI,433,All
2023,8,Goa,GUWAHATI,24,18,Goa-GUWAHATI,42,All
2023,9,Goa,GUWAHATI,57,50,Goa-GUWAHATI,107,All
2023,10,Goa,GUWAHATI,124,75,Goa-GUWAHATI,199,All
2023,1,Goa,HYDERABAD,10143,9794,Goa-HYDERABAD,19937,All
2023,6,Goa,HYDERABAD,10426,10521,Goa-HYDERABAD,20947,All
2023,7,Goa,HYDERABAD,10850,10263,Goa-HYDERABAD,21113,All
2023,8,Goa,HYDERABAD,6020,5813,Goa-HYDERABAD,11833,All
2023,9,Goa,HYDERABAD,5231,5244,Goa-HYDERABAD,10475,All
2023,10,Goa,HYDERABAD,6696,6466,Goa-HYDERABAD,13162,All
2023,11,Goa,HYDERABAD,12945,14148,Goa-HYDERABAD,27093,All
2023,12,Goa,HYDERABAD,19709,20216,Goa-HYDERABAD,39925,All
2024,1,Goa,HYDERABAD,23206,22977,Goa-HYDERABAD,46183,All
2024,2,Goa,HYDERABAD,18590,18686,Goa-HYDERABAD,37276,All
2024,3,Goa,HYDERABAD,18662,19174,Goa-HYDERABAD,37836,All
2024,4,Goa,HYDERABAD,21200,20074,Goa-HYDERABAD,41274,All
2024,6,Goa,HYDERABAD,15433,15022,Goa-HYDERABAD,30455,All
2024,7,Goa,HYDERABAD,15476,14325,Goa-HYDERABAD,29801,All
2024,8,Goa,HYDERABAD,18769,19764,Goa-HYDERABAD,38533,All
2024,9,Goa,HYDERABAD,15333,15848,Goa-HYDERABAD,31181,All
2024,10,Goa,HYDERABAD,18570,17567,Goa-HYDERABAD,36137,All
2024,11,Goa,HYDERABAD,20296,21807,Goa-HYDERABAD,42103,All
2024,12,Goa,HYDERABAD,25835,26229,Goa-HYDERABAD,52064,All
2025,1,Goa,HYDERABAD,28282,26826,Goa-HYDERABAD,55108,All
2025,2,Goa,HYDERABAD,20807,19509,Goa-HYDERABAD,40316,All
2025,3,Goa,HYDERABAD,21553,19863,Goa-HYDERABAD,41416,All
2023,1,Goa,JAIPUR,4735,4304,Goa-JAIPUR,9039,All
2023,6,Goa,JAIPUR,4985,5103,Goa-JAIPUR,10088,All
2023,7,Goa,JAIPUR,4309,4129,Goa-JAIPUR,8438,All
2023,8,Goa,JAIPUR,4363,4110,Goa-JAIPUR,8473,All
2023,9,Goa,JAIPUR,4685,4987,Goa-JAIPUR,9672,All
2023,10,Goa,JAIPUR,5404,5034,Goa-JAIPUR,10438,All
2023,11,Goa,JAIPUR,6376,6136,Goa-JAIPUR,12512,All
2023,12,Goa,JAIPUR,5961,6984,Goa-JAIPUR,12945,All
2024,1,Goa,JAIPUR,6530,6355,Goa-JAIPUR,12885,All
2024,2,Goa,JAIPUR,6135,6068,Goa-JAIPUR,12203,All
2024,3,Goa,JAIPUR,6216,6292,Goa-JAIPUR,12508,All
2024,4,Goa,JAIPUR,4848,4385,Goa-JAIPUR,9233,All
2024,6,Goa,JAIPUR,5095,5296,Goa-JAIPUR,10391,All
2024,7,Goa,JAIPUR,5184,5343,Goa-JAIPUR,10527,All
2024,8,Goa,JAIPUR,5796,5899,Goa-JAIPUR,11695,All
2024,9,Goa,JAIPUR,4970,5034,Goa-JAIPUR,10004,All
2024,10,Goa,JAIPUR,5126,4910,Goa-JAIPUR,10036,All
2024,11,Goa,JAIPUR,5340,6340,Goa-JAIPUR,11680,All
2024,12,Goa,JAIPUR,5513,6374,Goa-JAIPUR,11887,All
2025,1,Goa,JAIPUR,6583,6279,Goa-JAIPUR,12862,All
2025,2,Goa,JAIPUR,6030,5901,Goa-JAIPUR,11931,All
2025,3,Goa,JAIPUR,5747,6202,Goa-JAIPUR,11949,All
2024,4,Goa,JALGAON,286,283,Goa-JALGAON,569,All
2024,6,Goa,JALGAON,1612,1371,Goa-JALGAON,2983,All
2024,7,Goa,JALGAON,1419,1389,Goa-JALGAON,2808,All
2024,8,Goa,JALGAON,1311,1285,Goa-JALGAON,2596,All
2024,9,Goa,JALGAON,1402,1258,Goa-JALGAON,2660,All
2024,10,Goa,JALGAON,1625,1264,Goa-JALGAON,2889,All
2024,11,Goa,JALGAON,1791,1759,Goa-JALGAON,3550,All
2024,12,Goa,JALGAON,1833,1896,Goa-JALGAON,3729,All
2025,1,Goa,JALGAON,1868,1822,Goa-JALGAON,3690,All
2025,2,Goa,JALGAON,1691,1566,Goa-JALGAON,3257,All
2025,3,Goa,JALGAON,1650,1406,Goa-JALGAON,3056,All
2023,6,Goa,KOLKATA,2666,2306,Goa-KOLKATA,4972,All
2023,7,Goa,KOLKATA,2132,2195,Goa-KOLKATA,4327,All
2023,8,Goa,KOLKATA,1452,1342,Goa-KOLKATA,2794,All
2023,9,Goa,KOLKATA,4280,4317,Goa-KOLKATA,8597,All
2023,10,Goa,KOLKATA,6895,4964,Goa-KOLKATA,11859,All
2023,11,Goa,KOLKATA,4609,3886,Goa-KOLKATA,8495,All
2023,12,Goa,KOLKATA,8220,9224,Goa-KOLKATA,17444,All
2024,1,Goa,KOLKATA,6127,5646,Goa-KOLKATA,11773,All
2024,2,Goa,KOLKATA,4666,4232,Goa-KOLKATA,8898,All
2024,3,Goa,KOLKATA,4815,4072,Goa-KOLKATA,8887,All
2024,4,Goa,KOLKATA,4694,3493,Goa-KOLKATA,8187,All
2024,6,Goa,KOLKATA,4427,4397,Goa-KOLKATA,8824,All
2024,7,Goa,KOLKATA,4240,5176,Goa-KOLKATA,9416,All
2024,8,Goa,KOLKATA,4223,4646,Goa-KOLKATA,8869,All
2024,9,Goa,KOLKATA,4421,4255,Goa-KOLKATA,8676,All
2024,10,Goa,KOLKATA,5113,3889,Goa-KOLKATA,9002,All
2024,11,Goa,KOLKATA,4921,4920,Goa-KOLKATA,9841,All
2024,12,Goa,KOLKATA,5307,5119,Goa-KOLKATA,10426,All
2025,1,Goa,KOLKATA,5403,4964,Goa-KOLKATA,10367,All
2025,2,Goa,KOLKATA,4821,4468,Goa-KOLKATA,9289,All
2025,3,Goa,KOLKATA,4756,4406,Goa-KOLKATA,9162,All
2023,6,Goa,LUCKNOW,871,1366,Goa-LUCKNOW,2237,All
2024,9,Goa,LUCKNOW,1,0,Goa-LUCKNOW,1,All
2025,3,Goa,LUCKNOW,283,3913,Goa-LUCKNOW,4196,All
2023,8,Goa,MADURAI,36,15,Goa-MADURAI,51,All
2023,9,Goa,MADURAI,138,71,Goa-MADURAI,209,All
2023,10,Goa,MADURAI,149,119,Goa-MADURAI,268,All
2023,1,Goa,MUMBAI,14642,14699,Goa-MUMBAI,29341,All
2023,6,Goa,MUMBAI,43418,44368,Goa-MUMBAI,87786,All
2023,7,Goa,MUMBAI,42594,40380,Goa-MUMBAI,82974,All
2023,8,Goa,MUMBAI,51195,49750,Goa-MUMBAI,100945,All
2023,9,Goa,MUMBAI,48888,52202,Goa-MUMBAI,101090,All
2023,10,Goa,MUMBAI,43751,43667,Goa-MUMBAI,87418,All
2023,11,Goa,MUMBAI,45514,50937,Goa-MUMBAI,96451,All
2023,12,Goa,MUMBAI,56046,58504,Goa-MUMBAI,114550,All
2024,1,Goa,MUMBAI,62493,59017,Goa-MUMBAI,121510,All
2024,2,Goa,MUMBAI,52559,51355,Goa-MUMBAI,103914,All
2024,3,Goa,MUMBAI,50491,49421,Goa-MUMBAI,99912,All
2024,4,Goa,MUMBAI,49555,50082,Goa-MUMBAI,99637,All
2024,6,Goa,MUMBAI,41602,40445,Goa-MUMBAI,82047,All
2024,7,Goa,MUMBAI,33438,32971,Goa-MUMBAI,66409,All
2024,8,Goa,MUMBAI,37783,39329,Goa-MUMBAI,77112,All
2024,9,Goa,MUMBAI,35365,36238,Goa-MUMBAI,71603,All
2024,10,Goa,MUMBAI,35900,36933,Goa-MUMBAI,72833,All
2024,11,Goa,MUMBAI,43416,43900,Goa-MUMBAI,87316,All
2024,12,Goa,MUMBAI,42021,44067,Goa-MUMBAI,86088,All
2025,1,Goa,MUMBAI,41178,40867,Goa-MUMBAI,82045,All
2025,2,Goa,MUMBAI,37298,38064,Goa-MUMBAI,75362,All
2025,3,Goa,MUMBAI,41243,40888,Goa-MUMBAI,82131,All
2023,1,Goa,NAGPUR,1029,1060,Goa-NAGPUR,2089,All
2023,6,Goa,NAGPUR,5037,5160,Goa-NAGPUR,10197,All
2023,7,Goa,NAGPUR,3300,4502,Goa-NAGPUR,7802,All
2023,8,Goa,NAGPUR,4092,4580,Goa-NAGPUR,8672,All
2023,9,Goa,NAGPUR,4136,4641,Goa-NAGPUR,8777,All
2023,10,Goa,NAGPUR,4391,4408,Goa-NAGPUR,8799,All
2023,11,Goa,NAGPUR,4349,4258,Goa-NAGPUR,8607,All
2023,12,Goa,NAGPUR,5018,5143,Goa-NAGPUR,10161,All
2024,1,Goa,NAGPUR,4899,5092,Goa-NAGPUR,9991,All
2024,2,Goa,NAGPUR,4637,4638,Goa-NAGPUR,9275,All
2024,3,Goa,NAGPUR,4907,4841,Goa-NAGPUR,9748,All
2024,4,Goa,NAGPUR,5163,4405,Goa-NAGPUR,9568,All
2024,6,Goa,NAGPUR,5183,4925,Goa-NAGPUR,10108,All
2024,7,Goa,NAGPUR,5038,4339,Goa-NAGPUR,9377,All
2024,8,Goa,NAGPUR,4705,4677,Goa-NAGPUR,9382,All
2024,9,Goa,NAGPUR,4766,4301,Goa-NAGPUR,9067,All
2024,10,Goa,NAGPUR,6123,4627,Goa-NAGPUR,10750,All
2024,11,Goa,NAGPUR,7877,8874,Goa-NAGPUR,16751,All
2024,12,Goa,NAGPUR,4873,5067,Goa-NAGPUR,9940,All
2025,1,Goa,NAGPUR,5113,4981,Goa-NAGPUR,10094,All
2025,2,Goa,NAGPUR,4786,4609,Goa-NAGPUR,9395,All
2025,3,Goa,NAGPUR,4669,4287,Goa-NAGPUR,8956,All
2023,6,Goa,NASIK,1578,1574,Goa-NASIK,3152,All
2023,7,Goa,NASIK,1470,1433,Goa-NASIK,2903,All
2023,8,Goa,NASIK,1500,1409,Goa-NASIK,2909,All
2023,9,Goa,NASIK,1497,1606,Goa-NASIK,3103,All
2023,10,Goa,NASIK,1692,1631,Goa-NASIK,3323,All
2023,11,Goa,NASIK,1445,1442,Goa-NASIK,2887,All
2023,12,Goa,NASIK,1784,1926,Goa-NASIK,3710,All
2024,1,Goa,NASIK,1799,1851,Goa-NASIK,3650,All
2024,2,Goa,NASIK,1541,1559,Goa-NASIK,3100,All
2024,3,Goa,NASIK,1693,1695,Goa-NASIK,3388,All
2024,4,Goa,NASIK,1656,1687,Goa-NASIK,3343,All
2024,6,Goa,NASIK,1711,1503,Goa-NASIK,3214,All
2024,7,Goa,NASIK,988,785,Goa-NASIK,1773,All
2024,8,Goa,NASIK,833,722,Goa-NASIK,1555,All
2024,9,Goa,NASIK,869,671,Goa-NASIK,1540,All
2024,10,Goa,NASIK,563,488,Goa-NASIK,1051,All
2023,6,Goa,PATNA,2599,2409,Goa-PATNA,5008,All
2023,7,Goa,PATNA,2261,2197,Goa-PATNA,4458,All
2023,8,Goa,PATNA,2293,2023,Goa-PATNA,4316,All
2023,9,Goa,PATNA,2412,2452,Goa-PATNA,4864,All
2023,10,Goa,PATNA,2885,2640,Goa-PATNA,5525,All
2023,11,Goa,PATNA,2867,2318,Goa-PATNA,5185,All
2023,12,Goa,PATNA,2841,3198,Goa-PATNA,6039,All
2024,1,Goa,PATNA,1634,1757,Goa-PATNA,3391,All
2024,2,Goa,PATNA,2159,1960,Goa-PATNA,4119,All
2024,3,Goa,PATNA,2055,2036,Goa-PATNA,4091,All
2023,10,Goa,PORT BLAIR,0,2,Goa-PORT BLAIR,2,All
2023,11,Goa,PORT BLAIR,0,12,Goa-PORT BLAIR,12,All
2023,12,Goa,PORT BLAIR,0,4,Goa-PORT BLAIR,4,All
2024,1,Goa,PORT BLAIR,0,5,Goa-PORT BLAIR,5,All
2024,2,Goa,PORT BLAIR,0,12,Goa-PORT BLAIR,12,All
2024,3,Goa,PORT BLAIR,0,8,Goa-PORT BLAIR,8,All
2023,1,Goa,PUNE,4571,4052,Goa-PUNE,8623,All
2023,6,Goa,PUNE,4683,4479,Goa-PUNE,9162,All
2023,7,Goa,PUNE,8251,7177,Goa-PUNE,15428,All
2023,8,Goa,PUNE,8380,8074,Goa-PUNE,16454,All
2023,9,Goa,PUNE,9044,8887,Goa-PUNE,17931,All
2023,10,Goa,PUNE,10078,9748,Goa-PUNE,19826,All
2023,11,Goa,PUNE,9894,9836,Goa-PUNE,19730,All
2023,12,Goa,PUNE,9968,9741,Goa-PUNE,19709,All
2024,1,Goa,PUNE,10434,10072,Goa-PUNE,20506,All
2024,2,Goa,PUNE,13615,12477,Goa-PUNE,26092,All
2024,3,Goa,PUNE,14167,13371,Goa-PUNE,27538,All
2024,4,Goa,PUNE,13351,12613,Goa-PUNE,25964,All
2024,6,Goa,PUNE,13416,11724,Goa-PUNE,25140,All
2024,7,Goa,PUNE,12298,11482,Goa-PUNE,23780,All
2024,8,Goa,PUNE,12568,12359,Goa-PUNE,24927,All
2024,9,Goa,PUNE,13056,12929,Goa-PUNE,25985,All
2024,10,Goa,PUNE,13121,12849,Goa-PUNE,25970,All
2024,11,Goa,PUNE,12511,12475,Goa-PUNE,24986,All
2024,12,Goa,PUNE,11466,11469,Goa-PUNE,22935,All
2025,1,Goa,PUNE,9825,10075,Goa-PUNE,19900,All
2025,2,Goa,PUNE,6036,6141,Goa-PUNE,12177,All
2025,3,Goa,PUNE,10244,10263,Goa-PUNE,20507,All
2023,6,Goa,RAJKOT,1847,1742,Goa-RAJKOT,3589,All
2023,7,Goa,RAJKOT,1659,1761,Goa-RAJKOT,3420,All
2023,8,Goa,RAJKOT,1911,1973,Goa-RAJKOT,3884,All
2023,9,Goa,RAJKOT,370,508,Goa-RAJKOT,878,All
2023,6,Goa,RANCHI,2070,1699,Goa-RANCHI,3769,All
2023,7,Goa,RANCHI,1222,1163,Goa-RANCHI,2385,All
2023,8,Goa,RANCHI,1365,1088,Goa-RANCHI,2453,All
2023,9,Goa,RANCHI,2115,2233,Goa-RANCHI,4348,All
2023,10,Goa,RANCHI,2698,2366,Goa-RANCHI,5064,All
2023,11,Goa,RANCHI,2144,1814,Goa-RANCHI,3958,All
2023,12,Goa,RANCHI,2345,2506,Goa-RANCHI,4851,All
2024,1,Goa,RANCHI,1173,1146,Goa-RANCHI,2319,All
2024,2,Goa,RANCHI,2590,2567,Goa-RANCHI,5157,All
2024,3,Goa,RANCHI,2709,2475,Goa-RANCHI,5184,All
2023,9,Goa,Rajkot International Airport,1445,1428,Goa-Rajkot International Airport,2873,All
2023,10,Goa,Rajkot International Airport,1956,1984,Goa-Rajkot International Airport,3940,All
2023,11,Goa,Rajkot International Airport,1856,2165,Goa-Rajkot International Airport,4021,All
2023,12,Goa,Rajkot International Airport,1832,2164,Goa-Rajkot International Airport,3996,All
2024,1,Goa,Rajkot International Airport,2015,2248,Goa-Rajkot International Airport,4263,All
2024,2,Goa,Rajkot International Airport,2154,2297,Goa-Rajkot International Airport,4451,All
2024,3,Goa,Rajkot International Airport,1945,2254,Goa-Rajkot International Airport,4199,All
2024,4,Goa,Rajkot International Airport,1799,2115,Goa-Rajkot International Airport,3914,All
2024,6,Goa,Rajkot International Airport,1938,2224,Goa-Rajkot International Airport,4162,All
2024,7,Goa,Rajkot International Airport,1691,1842,Goa-Rajkot International Airport,3533,All
2024,8,Goa,Rajkot International Airport,2066,2205,Goa-Rajkot International Airport,4271,All
2024,9,Goa,Rajkot International Airport,1978,2063,Goa-Rajkot International Airport,4041,All
2024,10,Goa,Rajkot International Airport,2218,2559,Goa-Rajkot International Airport,4777,All
2024,11,Goa,Rajkot International Airport,4688,4424,Goa-Rajkot International Airport,9112,All
2024,12,Goa,Rajkot International Airport,4317,4172,Goa-Rajkot International Airport,8489,All
2025,1,Goa,Rajkot International Airport,4827,3953,Goa-Rajkot International Airport,8780,All
2025,2,Goa,Rajkot International Airport,3877,3513,Goa-Rajkot International Airport,7390,All
2025,3,Goa,Rajkot International Airport,4313,3873,Goa-Rajkot International Airport,8186,All
2023,10,Goa,SURAT,480,169,Goa-SURAT,649,All
2023,11,Goa,SURAT,1223,1209,Goa-SURAT,2432,All
2023,12,Goa,SURAT,1429,1560,Goa-SURAT,2989,All
2024,1,Goa,SURAT,1900,1253,Goa-SURAT,3153,All
2024,10,Goa,SURAT,4,0,Goa-SURAT,4,All
2023,11,Goa,Shivamogga Airport,256,410,Goa-Shivamogga Airport,666,All
2023,12,Goa,Shivamogga Airport,423,670,Goa-Shivamogga Airport,1093,All
2024,1,Goa,Shivamogga Airport,518,706,Goa-Shivamogga Airport,1224,All
2024,2,Goa,Shivamogga Airport,535,731,Goa-Shivamogga Airport,1266,All
2024,3,Goa,Shivamogga Airport,417,558,Goa-Shivamogga Airport,975,All
2024,4,Goa,Shivamogga Airport,382,728,Goa-Shivamogga Airport,1110,All
2024,6,Goa,Shivamogga Airport,450,724,Goa-Shivamogga Airport,1174,All
2024,7,Goa,Shivamogga Airport,244,477,Goa-Shivamogga Airport,721,All
2024,9,Goa,Shivamogga Airport,412,465,Goa-Shivamogga Airport,877,All
2024,10,Goa,Shivamogga Airport,720,885,Goa-Shivamogga Airport,1605,All
2024,11,Goa,Shivamogga Airport,641,904,Goa-Shivamogga Airport,1545,All
2024,12,Goa,Shivamogga Airport,820,845,Goa-Shivamogga Airport,1665,All
2025,1,Goa,Shivamogga Airport,1321,1124,Goa-Shivamogga Airport,2445,All
2025,2,Goa,Shivamogga Airport,398,564,Goa-Shivamogga Airport,962,All
2025,3,Goa,Shivamogga Airport,534,495,Goa-Shivamogga Airport,1029,All
2023,6,Goa,VADODARA,1879,1839,Goa-VADODARA,3718,All
2023,7,Goa,VADODARA,1950,1560,Goa-VADODARA,3510,All
2023,8,Goa,VADODARA,1740,1512,Goa-VADODARA,3252,All
2023,9,Goa,VADODARA,1831,1964,Goa-VADODARA,3795,All
2023,10,Goa,VADODARA,1801,1890,Goa-VADODARA,3691,All
2023,11,Goa,VADODARA,2448,2740,Goa-VADODARA,5188,All
2023,12,Goa,VADODARA,2331,2846,Goa-VADODARA,5177,All
2024,1,Goa,VADODARA,2608,2312,Goa-VADODARA,4920,All
2024,2,Goa,VADODARA,1980,1712,Goa-VADODARA,3692,All
2024,3,Goa,VADODARA,2288,1728,Goa-VADODARA,4016,All
2024,4,Goa,VADODARA,1783,1458,Goa-VADODARA,3241,All
2024,6,Goa,VADODARA,2116,1733,Goa-VADODARA,3849,All
2024,7,Goa,VADODARA,1702,1308,Goa-VADODARA,3010,All
2024,8,Goa,VADODARA,1560,1413,Goa-VADODARA,2973,All
2024,9,Goa,VADODARA,1826,1308,Goa-VADODARA,3134,All
2024,10,Goa,VADODARA,1439,1449,Goa-VADODARA,2888,All
2024,11,Goa,VADODARA,4277,3626,Goa-VADODARA,7903,All
2024,12,Goa,VADODARA,4439,3675,Goa-VADODARA,8114,All
2025,1,Goa,VADODARA,4652,3415,Goa-VADODARA,8067,All
2025,2,Goa,VADODARA,3825,2737,Goa-VADODARA,6562,All
2025,3,Goa,VADODARA,3851,2394,Goa-VADODARA,6245,All
2023,6,Goa,VARANASI,1799,1922,Goa-VARANASI,3721,All
2023,7,Goa,VARANASI,1518,1424,Goa-VARANASI,2942,All
2023,8,Goa,VARANASI,1651,1558,Goa-VARANASI,3209,All
2023,9,Goa,VARANASI,1905,2029,Goa-VARANASI,3934,All
2023,10,Goa,VARANASI,2234,1940,Goa-VARANASI,4174,All
2023,11,Goa,VARANASI,2232,1946,Goa-VARANASI,4178,All
2023,12,Goa,VARANASI,2102,2167,Goa-VARANASI,4269,All
2024,1,Goa,VARANASI,1213,1281,Goa-VARANASI,2494,All
2023,6,Goa,VISAKHAPATNAM,1936,1919,Goa-VISAKHAPATNAM,3855,All
2023,8,Goa,VISAKHAPATNAM,892,885,Goa-VISAKHAPATNAM,1777,All
2023,9,Goa,VISAKHAPATNAM,1591,1962,Goa-VISAKHAPATNAM,3553,All
2023,10,Goa,VISAKHAPATNAM,2217,2206,Goa-VISAKHAPATNAM,4423,All
2023,11,Goa,VISAKHAPATNAM,1835,1872,Goa-VISAKHAPATNAM,3707,All
2023,12,Goa,VISAKHAPATNAM,1768,2127,Goa-VISAKHAPATNAM,3895,All
2024,1,Goa,VISAKHAPATNAM,1145,1152,Goa-VISAKHAPATNAM,2297,All
2023,12,Gondia ,HYDERABAD,856,731,Gondia -HYDERABAD,1587,All
2024,1,Gondia ,HYDERABAD,624,658,Gondia -HYDERABAD,1282,All
2024,2,Gondia ,HYDERABAD,1121,1024,Gondia -HYDERABAD,2145,All
2024,3,Gondia ,HYDERABAD,1269,1290,Gondia -HYDERABAD,2559,All
2024,4,Gondia ,HYDERABAD,1522,1497,Gondia -HYDERABAD,3019,All
2024,6,Gondia ,HYDERABAD,1732,1593,Gondia -HYDERABAD,3325,All
2024,7,Gondia ,HYDERABAD,1260,1157,Gondia -HYDERABAD,2417,All
2024,8,Gondia ,HYDERABAD,1209,1110,Gondia -HYDERABAD,2319,All
2024,9,Gondia ,HYDERABAD,694,844,Gondia -HYDERABAD,1538,All
2024,10,Gondia ,HYDERABAD,661,1223,Gondia -HYDERABAD,1884,All
2024,11,Gondia ,HYDERABAD,1795,1442,Gondia -HYDERABAD,3237,All
2024,12,Gondia ,HYDERABAD,1466,1210,Gondia -HYDERABAD,2676,All
2025,1,Gondia ,HYDERABAD,1102,902,Gondia -HYDERABAD,2004,All
2025,2,Gondia ,HYDERABAD,1203,1061,Gondia -HYDERABAD,2264,All
2025,3,Gondia ,HYDERABAD,1415,1217,Gondia -HYDERABAD,2632,All
2023,12,Gondia ,TIRUPATI,8,8,Gondia -TIRUPATI,16,All
2022,4,Gondia Airport,HYDERABAD,883,932,Gondia Airport-HYDERABAD,1815,All
2022,5,Gondia Airport,HYDERABAD,1153,932,Gondia Airport-HYDERABAD,2085,All
2022,6,Gondia Airport,HYDERABAD,895,845,Gondia Airport-HYDERABAD,1740,All
2022,7,Gondia Airport,HYDERABAD,505,603,Gondia Airport-HYDERABAD,1108,All
2022,8,Gondia Airport,HYDERABAD,152,232,Gondia Airport-HYDERABAD,384,All
2022,3,Gondia Airport,INDORE,753,863,Gondia Airport-INDORE,1616,All
2022,4,Gondia Airport,INDORE,1200,1056,Gondia Airport-INDORE,2256,All
2022,5,Gondia Airport,INDORE,1254,1249,Gondia Airport-INDORE,2503,All
2022,6,Gondia Airport,INDORE,1072,1037,Gondia Airport-INDORE,2109,All
2022,7,Gondia Airport,INDORE,813,758,Gondia Airport-INDORE,1571,All
2022,8,Gondia Airport,INDORE,297,315,Gondia Airport-INDORE,612,All
2018,5,HUBLI,CHENNAI,1090,1072,CHENNAI-HUBLI,2162,All
2018,6,HUBLI,CHENNAI,1701,1899,CHENNAI-HUBLI,3600,All
2018,7,HUBLI,CHENNAI,3002,3127,CHENNAI-HUBLI,6129,All
2018,8,HUBLI,CHENNAI,2877,2884,CHENNAI-HUBLI,5761,All
2018,9,HUBLI,CHENNAI,2982,3198,CHENNAI-HUBLI,6180,All
2018,10,HUBLI,CHENNAI,3632,3300,CHENNAI-HUBLI,6932,All
2018,11,HUBLI,CHENNAI,3619,3638,CHENNAI-HUBLI,7257,All
2018,12,HUBLI,CHENNAI,4314,4455,CHENNAI-HUBLI,8769,All
2019,1,HUBLI,CHENNAI,3881,3279,CHENNAI-HUBLI,7160,All
2019,2,HUBLI,CHENNAI,3454,3150,CHENNAI-HUBLI,6604,All
2019,3,HUBLI,CHENNAI,3221,2891,CHENNAI-HUBLI,6112,All
2019,4,HUBLI,CHENNAI,3706,3546,CHENNAI-HUBLI,7252,All
2019,11,HUBLI,GHAZIABAD,536,553,GHAZIABAD-HUBLI,1089,All
2019,12,HUBLI,GHAZIABAD,544,558,GHAZIABAD-HUBLI,1102,All
2020,3,HUBLI,GHAZIABAD,732,737,GHAZIABAD-HUBLI,1469,All
2020,5,HUBLI,GHAZIABAD,29,13,GHAZIABAD-HUBLI,42,All
2018,5,HUBLI,HYDERABAD,1055,866,HUBLI-HYDERABAD,1921,All
2018,6,HUBLI,HYDERABAD,1919,1590,HUBLI-HYDERABAD,3509,All
2018,7,HUBLI,HYDERABAD,1704,1651,HUBLI-HYDERABAD,3355,All
2018,8,HUBLI,HYDERABAD,1418,1298,HUBLI-HYDERABAD,2716,All
2018,9,HUBLI,HYDERABAD,1502,1602,HUBLI-HYDERABAD,3104,All
2018,10,HUBLI,HYDERABAD,2066,2027,HUBLI-HYDERABAD,4093,All
2018,11,HUBLI,HYDERABAD,2059,1997,HUBLI-HYDERABAD,4056,All
2019,6,HUBLI,HYDERABAD,0,1,HUBLI-HYDERABAD,1,All
2019,11,HUBLI,HYDERABAD,235,228,HUBLI-HYDERABAD,463,All
2019,12,HUBLI,HYDERABAD,1665,1592,HUBLI-HYDERABAD,3257,All
2020,1,HUBLI,HYDERABAD,1292,1334,HUBLI-HYDERABAD,2626,All
2020,2,HUBLI,HYDERABAD,1177,1245,HUBLI-HYDERABAD,2422,All
2020,3,HUBLI,HYDERABAD,437,460,HUBLI-HYDERABAD,897,All
2020,10,HUBLI,HYDERABAD,0,48,HUBLI-HYDERABAD,48,All
2021,3,HUBLI,HYDERABAD,27,26,HUBLI-HYDERABAD,53,All
2021,4,HUBLI,HYDERABAD,327,284,HUBLI-HYDERABAD,611,All
2021,6,HUBLI,HYDERABAD,177,142,HUBLI-HYDERABAD,319,All
2021,7,HUBLI,HYDERABAD,304,341,HUBLI-HYDERABAD,645,All
2021,8,HUBLI,HYDERABAD,276,263,HUBLI-HYDERABAD,539,All
2021,9,HUBLI,HYDERABAD,249,227,HUBLI-HYDERABAD,476,All
2021,10,HUBLI,HYDERABAD,368,342,HUBLI-HYDERABAD,710,All
2021,11,HUBLI,HYDERABAD,106,92,HUBLI-HYDERABAD,198,All
2022,4,HUBLI,HYDERABAD,286,289,HUBLI-HYDERABAD,575,All
2022,5,HUBLI,HYDERABAD,1783,1724,HUBLI-HYDERABAD,3507,All
2022,6,HUBLI,HYDERABAD,2000,1482,HUBLI-HYDERABAD,3482,All
2022,7,HUBLI,HYDERABAD,1957,1564,HUBLI-HYDERABAD,3521,All
2022,8,HUBLI,HYDERABAD,1896,1833,HUBLI-HYDERABAD,3729,All
2022,9,HUBLI,HYDERABAD,1983,1902,HUBLI-HYDERABAD,3885,All
2022,10,HUBLI,HYDERABAD,2037,1915,HUBLI-HYDERABAD,3952,All
2022,11,HUBLI,HYDERABAD,1695,2053,HUBLI-HYDERABAD,3748,All
2022,12,HUBLI,HYDERABAD,1668,1859,HUBLI-HYDERABAD,3527,All
2023,1,HUBLI,HYDERABAD,1776,1774,HUBLI-HYDERABAD,3550,All
2023,2,HUBLI,HYDERABAD,1819,1612,HUBLI-HYDERABAD,3431,All
2023,3,HUBLI,HYDERABAD,1814,1709,HUBLI-HYDERABAD,3523,All
2023,4,HUBLI,HYDERABAD,1850,1784,HUBLI-HYDERABAD,3634,All
2023,5,HUBLI,HYDERABAD,2039,1994,HUBLI-HYDERABAD,4033,All
2023,6,HUBLI,HYDERABAD,1879,1771,HUBLI-HYDERABAD,3650,All
2023,7,HUBLI,HYDERABAD,1935,1822,HUBLI-HYDERABAD,3757,All
2023,8,HUBLI,HYDERABAD,1998,1885,HUBLI-HYDERABAD,3883,All
2023,9,HUBLI,HYDERABAD,1987,1885,HUBLI-HYDERABAD,3872,All
2023,10,HUBLI,HYDERABAD,2123,2104,HUBLI-HYDERABAD,4227,All
2023,11,HUBLI,HYDERABAD,1943,2005,HUBLI-HYDERABAD,3948,All
2023,12,HUBLI,HYDERABAD,1759,1860,HUBLI-HYDERABAD,3619,All
2024,1,HUBLI,HYDERABAD,2025,1893,HUBLI-HYDERABAD,3918,All
2024,2,HUBLI,HYDERABAD,1858,1970,HUBLI-HYDERABAD,3828,All
2024,3,HUBLI,HYDERABAD,1837,2028,HUBLI-HYDERABAD,3865,All
2024,4,HUBLI,HYDERABAD,1849,1930,HUBLI-HYDERABAD,3779,All
2024,6,HUBLI,HYDERABAD,1869,1789,HUBLI-HYDERABAD,3658,All
2024,7,HUBLI,HYDERABAD,1543,1749,HUBLI-HYDERABAD,3292,All
2024,8,HUBLI,HYDERABAD,1495,1733,HUBLI-HYDERABAD,3228,All
2024,9,HUBLI,HYDERABAD,1775,1787,HUBLI-HYDERABAD,3562,All
2024,10,HUBLI,HYDERABAD,1805,1776,HUBLI-HYDERABAD,3581,All
2024,11,HUBLI,HYDERABAD,1926,1915,HUBLI-HYDERABAD,3841,All
2024,12,HUBLI,HYDERABAD,2030,1933,HUBLI-HYDERABAD,3963,All
2025,1,HUBLI,HYDERABAD,2044,1893,HUBLI-HYDERABAD,3937,All
2025,2,HUBLI,HYDERABAD,2062,2009,HUBLI-HYDERABAD,4071,All
2025,3,HUBLI,HYDERABAD,2095,1881,HUBLI-HYDERABAD,3976,All
2018,5,HUBLI,JABALPUR,3,5,HUBLI-JABALPUR,8,All
2018,6,HUBLI,JABALPUR,8,10,HUBLI-JABALPUR,18,All
2018,7,HUBLI,JABALPUR,8,14,HUBLI-JABALPUR,22,All
2018,8,HUBLI,JABALPUR,35,25,HUBLI-JABALPUR,60,All
2018,9,HUBLI,JABALPUR,28,22,HUBLI-JABALPUR,50,All
2018,10,HUBLI,JABALPUR,18,8,HUBLI-JABALPUR,26,All
2018,11,HUBLI,JABALPUR,14,14,HUBLI-JABALPUR,28,All
2018,12,HUBLI,JABALPUR,28,24,HUBLI-JABALPUR,52,All
2019,1,HUBLI,JABALPUR,24,37,HUBLI-JABALPUR,61,All
2019,2,HUBLI,JABALPUR,23,19,HUBLI-JABALPUR,42,All
2019,3,HUBLI,JABALPUR,10,2,HUBLI-JABALPUR,12,All
2019,4,HUBLI,JABALPUR,46,22,HUBLI-JABALPUR,68,All
2019,5,HUBLI,JABALPUR,31,30,HUBLI-JABALPUR,61,All
2019,6,HUBLI,JABALPUR,35,29,HUBLI-JABALPUR,64,All
2019,5,HUBLI,KANNUR,1110,1046,HUBLI-KANNUR,2156,All
2019,6,HUBLI,KANNUR,653,743,HUBLI-KANNUR,1396,All
2019,7,HUBLI,KANNUR,659,679,HUBLI-KANNUR,1338,All
2019,8,HUBLI,KANNUR,988,1043,HUBLI-KANNUR,2031,All
2019,9,HUBLI,KANNUR,815,867,HUBLI-KANNUR,1682,All
2019,10,HUBLI,KANNUR,1111,964,HUBLI-KANNUR,2075,All
2019,11,HUBLI,KANNUR,1010,1267,HUBLI-KANNUR,2277,All
2019,12,HUBLI,KANNUR,1454,1340,HUBLI-KANNUR,2794,All
2020,1,HUBLI,KANNUR,1371,1453,HUBLI-KANNUR,2824,All
2020,2,HUBLI,KANNUR,1131,1034,HUBLI-KANNUR,2165,All
2020,3,HUBLI,KANNUR,702,568,HUBLI-KANNUR,1270,All
2020,6,HUBLI,KANNUR,9,25,HUBLI-KANNUR,34,All
2020,7,HUBLI,KANNUR,48,152,HUBLI-KANNUR,200,All
2020,8,HUBLI,KANNUR,49,105,HUBLI-KANNUR,154,All
2020,9,HUBLI,KANNUR,84,126,HUBLI-KANNUR,210,All
2020,10,HUBLI,KANNUR,82,79,HUBLI-KANNUR,161,All
2020,11,HUBLI,KANNUR,50,111,HUBLI-KANNUR,161,All
2020,12,HUBLI,KANNUR,140,195,HUBLI-KANNUR,335,All
2021,1,HUBLI,KANNUR,190,228,HUBLI-KANNUR,418,All
2021,2,HUBLI,KANNUR,126,178,HUBLI-KANNUR,304,All
2021,3,HUBLI,KANNUR,142,111,HUBLI-KANNUR,253,All
2021,4,HUBLI,KANNUR,246,220,HUBLI-KANNUR,466,All
2021,6,HUBLI,KANNUR,172,203,HUBLI-KANNUR,375,All
2021,7,HUBLI,KANNUR,253,305,HUBLI-KANNUR,558,All
2021,8,HUBLI,KANNUR,286,262,HUBLI-KANNUR,548,All
2021,9,HUBLI,KANNUR,193,230,HUBLI-KANNUR,423,All
2021,10,HUBLI,KANNUR,339,294,HUBLI-KANNUR,633,All
2021,11,HUBLI,KANNUR,280,412,HUBLI-KANNUR,692,All
2021,12,HUBLI,KANNUR,358,418,HUBLI-KANNUR,776,All
2022,1,HUBLI,KANNUR,224,358,HUBLI-KANNUR,582,All
2022,2,HUBLI,KANNUR,269,372,HUBLI-KANNUR,641,All
2022,3,HUBLI,KANNUR,494,557,HUBLI-KANNUR,1051,All
2022,4,HUBLI,KANNUR,377,359,HUBLI-KANNUR,736,All
2019,5,HUBLI,KOCHI,2076,1944,HUBLI-KOCHI,4020,All
2019,6,HUBLI,KOCHI,1520,1660,HUBLI-KOCHI,3180,All
2019,7,HUBLI,KOCHI,1633,1572,HUBLI-KOCHI,3205,All
2019,8,HUBLI,KOCHI,1463,1425,HUBLI-KOCHI,2888,All
2019,9,HUBLI,KOCHI,1559,1621,HUBLI-KOCHI,3180,All
2019,10,HUBLI,KOCHI,1786,1621,HUBLI-KOCHI,3407,All
2019,11,HUBLI,KOCHI,1845,1769,HUBLI-KOCHI,3614,All
2019,12,HUBLI,KOCHI,2080,1938,HUBLI-KOCHI,4018,All
2020,1,HUBLI,KOCHI,1960,2029,HUBLI-KOCHI,3989,All
2020,2,HUBLI,KOCHI,1563,1711,HUBLI-KOCHI,3274,All
2020,3,HUBLI,KOCHI,1047,856,HUBLI-KOCHI,1903,All
2021,1,HUBLI,KOCHI,341,372,HUBLI-KOCHI,713,All
2021,2,HUBLI,KOCHI,866,914,HUBLI-KOCHI,1780,All
2021,3,HUBLI,KOCHI,529,513,HUBLI-KOCHI,1042,All
2021,4,HUBLI,KOCHI,558,484,HUBLI-KOCHI,1042,All
2021,7,HUBLI,KOCHI,330,360,HUBLI-KOCHI,690,All
2021,8,HUBLI,KOCHI,550,533,HUBLI-KOCHI,1083,All
2021,9,HUBLI,KOCHI,385,388,HUBLI-KOCHI,773,All
2021,10,HUBLI,KOCHI,823,773,HUBLI-KOCHI,1596,All
2021,11,HUBLI,KOCHI,1048,901,HUBLI-KOCHI,1949,All
2021,12,HUBLI,KOCHI,1166,1020,HUBLI-KOCHI,2186,All
2022,1,HUBLI,KOCHI,815,785,HUBLI-KOCHI,1600,All
2021,7,HUBLI,KOZHIKODE,4,0,HUBLI-KOZHIKODE,4,All
2018,5,HUBLI,MANGALORE,13,17,HUBLI-MANGALORE,30,All
2018,6,HUBLI,MANGALORE,32,26,HUBLI-MANGALORE,58,All
2018,7,HUBLI,MANGALORE,58,66,HUBLI-MANGALORE,124,All
2018,8,HUBLI,MANGALORE,74,55,HUBLI-MANGALORE,129,All
2018,9,HUBLI,MANGALORE,55,42,HUBLI-MANGALORE,97,All
2018,10,HUBLI,MANGALORE,28,58,HUBLI-MANGALORE,86,All
2018,11,HUBLI,MANGALORE,120,80,HUBLI-MANGALORE,200,All
2018,12,HUBLI,MANGALORE,86,69,HUBLI-MANGALORE,155,All
2019,1,HUBLI,MANGALORE,58,61,HUBLI-MANGALORE,119,All
2019,2,HUBLI,MANGALORE,52,50,HUBLI-MANGALORE,102,All
2019,3,HUBLI,MANGALORE,44,50,HUBLI-MANGALORE,94,All
2019,4,HUBLI,MANGALORE,0,73,HUBLI-MANGALORE,73,All
2019,5,HUBLI,MANGALORE,0,90,HUBLI-MANGALORE,90,All
2019,6,HUBLI,MANGALORE,0,44,HUBLI-MANGALORE,44,All
2022,5,HUBLI,MANGALORE,772,720,HUBLI-MANGALORE,1492,All
2022,6,HUBLI,MANGALORE,547,444,HUBLI-MANGALORE,991,All
2022,7,HUBLI,MANGALORE,198,232,HUBLI-MANGALORE,430,All
2022,8,HUBLI,MANGALORE,409,393,HUBLI-MANGALORE,802,All
2022,9,HUBLI,MANGALORE,518,454,HUBLI-MANGALORE,972,All
2022,10,HUBLI,MANGALORE,655,682,HUBLI-MANGALORE,1337,All
2022,11,HUBLI,MANGALORE,897,544,HUBLI-MANGALORE,1441,All
2022,12,HUBLI,MANGALORE,1075,685,HUBLI-MANGALORE,1760,All
2023,1,HUBLI,MANGALORE,801,705,HUBLI-MANGALORE,1506,All
2023,2,HUBLI,MANGALORE,385,255,HUBLI-MANGALORE,640,All
2023,3,HUBLI,MANGALORE,168,135,HUBLI-MANGALORE,303,All
2019,5,HUBLI,MUMBAI,2829,3269,HUBLI-MUMBAI,6098,All
2019,6,HUBLI,MUMBAI,2535,1980,HUBLI-MUMBAI,4515,All
2019,7,HUBLI,MUMBAI,1428,558,HUBLI-MUMBAI,1986,All
2019,8,HUBLI,MUMBAI,1418,1003,HUBLI-MUMBAI,2421,All
2019,9,HUBLI,MUMBAI,1294,1010,HUBLI-MUMBAI,2304,All
2019,10,HUBLI,MUMBAI,1184,1466,HUBLI-MUMBAI,2650,All
2019,11,HUBLI,MUMBAI,936,1720,HUBLI-MUMBAI,2656,All
2019,12,HUBLI,MUMBAI,897,1945,HUBLI-MUMBAI,2842,All
2020,1,HUBLI,MUMBAI,1481,2316,HUBLI-MUMBAI,3797,All
2020,2,HUBLI,MUMBAI,2537,2504,HUBLI-MUMBAI,5041,All
2020,3,HUBLI,MUMBAI,989,974,HUBLI-MUMBAI,1963,All
2020,9,HUBLI,MUMBAI,166,120,HUBLI-MUMBAI,286,All
2020,10,HUBLI,MUMBAI,959,613,HUBLI-MUMBAI,1572,All
2020,11,HUBLI,MUMBAI,1396,982,HUBLI-MUMBAI,2378,All
2020,12,HUBLI,MUMBAI,2080,1782,HUBLI-MUMBAI,3862,All
2021,1,HUBLI,MUMBAI,2178,1951,HUBLI-MUMBAI,4129,All
2021,2,HUBLI,MUMBAI,2129,1932,HUBLI-MUMBAI,4061,All
2021,3,HUBLI,MUMBAI,1870,1280,HUBLI-MUMBAI,3150,All
2021,4,HUBLI,MUMBAI,1121,881,HUBLI-MUMBAI,2002,All
2021,7,HUBLI,MUMBAI,660,785,HUBLI-MUMBAI,1445,All
2021,8,HUBLI,MUMBAI,1354,1260,HUBLI-MUMBAI,2614,All
2021,9,HUBLI,MUMBAI,1238,1185,HUBLI-MUMBAI,2423,All
2021,10,HUBLI,MUMBAI,1848,1884,HUBLI-MUMBAI,3732,All
2021,11,HUBLI,MUMBAI,1955,2035,HUBLI-MUMBAI,3990,All
2021,12,HUBLI,MUMBAI,1888,1989,HUBLI-MUMBAI,3877,All
2022,1,HUBLI,MUMBAI,1041,866,HUBLI-MUMBAI,1907,All
2022,2,HUBLI,MUMBAI,1061,1081,HUBLI-MUMBAI,2142,All
2022,3,HUBLI,MUMBAI,1994,1873,HUBLI-MUMBAI,3867,All
2022,4,HUBLI,MUMBAI,1926,1986,HUBLI-MUMBAI,3912,All
2022,5,HUBLI,MUMBAI,1897,2079,HUBLI-MUMBAI,3976,All
2022,6,HUBLI,MUMBAI,1677,1832,HUBLI-MUMBAI,3509,All
2022,7,HUBLI,MUMBAI,1930,2170,HUBLI-MUMBAI,4100,All
2022,8,HUBLI,MUMBAI,1999,2080,HUBLI-MUMBAI,4079,All
2022,9,HUBLI,MUMBAI,1913,1987,HUBLI-MUMBAI,3900,All
2022,10,HUBLI,MUMBAI,1905,2024,HUBLI-MUMBAI,3929,All
2022,11,HUBLI,MUMBAI,2164,2238,HUBLI-MUMBAI,4402,All
2022,12,HUBLI,MUMBAI,2066,2241,HUBLI-MUMBAI,4307,All
2023,11,HUBLI,MUMBAI,4007,4492,HUBLI-MUMBAI,8499,All
2023,12,HUBLI,MUMBAI,5065,5354,HUBLI-MUMBAI,10419,All
2024,1,HUBLI,MUMBAI,4014,4113,HUBLI-MUMBAI,8127,All
2024,2,HUBLI,MUMBAI,2089,2183,HUBLI-MUMBAI,4272,All
2024,7,HUBLI,MUMBAI,2121,2255,HUBLI-MUMBAI,4376,All
2024,8,HUBLI,MUMBAI,4350,3875,HUBLI-MUMBAI,8225,All
2024,9,HUBLI,MUMBAI,4078,3789,HUBLI-MUMBAI,7867,All
2024,10,HUBLI,MUMBAI,3662,3862,HUBLI-MUMBAI,7524,All
2024,11,HUBLI,MUMBAI,4030,4005,HUBLI-MUMBAI,8035,All
2024,12,HUBLI,MUMBAI,4229,4670,HUBLI-MUMBAI,8899,All
2025,1,HUBLI,MUMBAI,4184,4320,HUBLI-MUMBAI,8504,All
2025,2,HUBLI,MUMBAI,4415,4578,HUBLI-MUMBAI,8993,All
2025,3,HUBLI,MUMBAI,3883,3946,HUBLI-MUMBAI,7829,All
2022,5,HUBLI,MYSORE,395,389,HUBLI-MYSORE,784,All
2022,6,HUBLI,MYSORE,433,342,HUBLI-MYSORE,775,All
2022,7,HUBLI,MYSORE,345,219,HUBLI-MYSORE,564,All
2022,8,HUBLI,MYSORE,395,272,HUBLI-MYSORE,667,All
2022,9,HUBLI,MYSORE,283,194,HUBLI-MYSORE,477,All
2022,10,HUBLI,MYSORE,386,293,HUBLI-MYSORE,679,All
2022,11,HUBLI,MYSORE,245,170,HUBLI-MYSORE,415,All
2022,12,HUBLI,MYSORE,336,233,HUBLI-MYSORE,569,All
2023,1,HUBLI,MYSORE,215,181,HUBLI-MYSORE,396,All
2023,2,HUBLI,MYSORE,210,126,HUBLI-MYSORE,336,All
2023,3,HUBLI,MYSORE,84,64,HUBLI-MYSORE,148,All
2019,7,HUBLI,PUNE,27,21,HUBLI-PUNE,48,All
2023,2,HUBLI,PUNE,411,216,HUBLI-PUNE,627,All
2023,3,HUBLI,PUNE,895,594,HUBLI-PUNE,1489,All
2023,4,HUBLI,PUNE,592,345,HUBLI-PUNE,937,All
2023,5,HUBLI,PUNE,485,431,HUBLI-PUNE,916,All
2023,6,HUBLI,PUNE,430,399,HUBLI-PUNE,829,All
2023,7,HUBLI,PUNE,568,449,HUBLI-PUNE,1017,All
2023,8,HUBLI,PUNE,421,414,HUBLI-PUNE,835,All
2023,9,HUBLI,PUNE,491,448,HUBLI-PUNE,939,All
2023,10,HUBLI,PUNE,463,342,HUBLI-PUNE,805,All
2024,2,HUBLI,PUNE,802,868,HUBLI-PUNE,1670,All
2024,3,HUBLI,PUNE,789,814,HUBLI-PUNE,1603,All
2024,4,HUBLI,PUNE,830,876,HUBLI-PUNE,1706,All
2024,6,HUBLI,PUNE,801,927,HUBLI-PUNE,1728,All
2024,7,HUBLI,PUNE,811,1024,HUBLI-PUNE,1835,All
2024,8,HUBLI,PUNE,805,867,HUBLI-PUNE,1672,All
2024,9,HUBLI,PUNE,818,899,HUBLI-PUNE,1717,All
2024,10,HUBLI,PUNE,701,914,HUBLI-PUNE,1615,All
2024,11,HUBLI,PUNE,1038,975,HUBLI-PUNE,2013,All
2024,12,HUBLI,PUNE,1171,1190,HUBLI-PUNE,2361,All
2025,1,HUBLI,PUNE,1112,1175,HUBLI-PUNE,2287,All
2025,2,HUBLI,PUNE,761,796,HUBLI-PUNE,1557,All
2025,3,HUBLI,PUNE,1007,1079,HUBLI-PUNE,2086,All
2019,1,HUBLI,TIRUPATI,201,157,HUBLI-TIRUPATI,358,All
2019,2,HUBLI,TIRUPATI,695,605,HUBLI-TIRUPATI,1300,All
2019,3,HUBLI,TIRUPATI,913,721,HUBLI-TIRUPATI,1634,All
2019,4,HUBLI,TIRUPATI,721,673,HUBLI-TIRUPATI,1394,All
2019,5,HUBLI,TIRUPATI,845,726,HUBLI-TIRUPATI,1571,All
2019,6,HUBLI,TIRUPATI,647,641,HUBLI-TIRUPATI,1288,All
2019,7,HUBLI,TIRUPATI,719,643,HUBLI-TIRUPATI,1362,All
2019,8,HUBLI,TIRUPATI,586,561,HUBLI-TIRUPATI,1147,All
2019,9,HUBLI,TIRUPATI,480,335,HUBLI-TIRUPATI,815,All
2019,10,HUBLI,TIRUPATI,613,549,HUBLI-TIRUPATI,1162,All
2019,11,HUBLI,TIRUPATI,515,581,HUBLI-TIRUPATI,1096,All
2019,12,HUBLI,TIRUPATI,697,708,HUBLI-TIRUPATI,1405,All
2020,1,HUBLI,TIRUPATI,595,544,HUBLI-TIRUPATI,1139,All
2020,2,HUBLI,TIRUPATI,563,537,HUBLI-TIRUPATI,1100,All
2020,3,HUBLI,TIRUPATI,367,292,HUBLI-TIRUPATI,659,All
2021,1,HUBLI,TIRUPATI,440,404,HUBLI-TIRUPATI,844,All
2021,2,HUBLI,TIRUPATI,538,515,HUBLI-TIRUPATI,1053,All
2021,3,HUBLI,TIRUPATI,568,494,HUBLI-TIRUPATI,1062,All
2021,4,HUBLI,TIRUPATI,331,262,HUBLI-TIRUPATI,593,All
2021,6,HUBLI,TIRUPATI,186,162,HUBLI-TIRUPATI,348,All
2021,7,HUBLI,TIRUPATI,269,227,HUBLI-TIRUPATI,496,All
2021,8,HUBLI,TIRUPATI,247,261,HUBLI-TIRUPATI,508,All
2021,9,HUBLI,TIRUPATI,273,217,HUBLI-TIRUPATI,490,All
2021,10,HUBLI,TIRUPATI,239,182,HUBLI-TIRUPATI,421,All
2021,11,HUBLI,TIRUPATI,184,123,HUBLI-TIRUPATI,307,All
2021,12,HUBLI,TIRUPATI,26,18,HUBLI-TIRUPATI,44,All
2022,1,HUBLI,TIRUPATI,64,55,HUBLI-TIRUPATI,119,All
2022,2,HUBLI,TIRUPATI,215,124,HUBLI-TIRUPATI,339,All
2022,3,HUBLI,TIRUPATI,296,261,HUBLI-TIRUPATI,557,All
2022,4,HUBLI,TIRUPATI,296,244,HUBLI-TIRUPATI,540,All
2015,4,HYDERABAD,AGARTALA,254,184,AGARTALA-HYDERABAD,438,All
2015,5,HYDERABAD,AGARTALA,196,182,AGARTALA-HYDERABAD,378,All
2015,6,HYDERABAD,AGARTALA,319,251,AGARTALA-HYDERABAD,570,All
2015,7,HYDERABAD,AGARTALA,275,170,AGARTALA-HYDERABAD,445,All
2015,8,HYDERABAD,AGARTALA,278,244,AGARTALA-HYDERABAD,522,All
2015,9,HYDERABAD,AGARTALA,281,241,AGARTALA-HYDERABAD,522,All
2015,10,HYDERABAD,AGARTALA,237,202,AGARTALA-HYDERABAD,439,All
2015,11,HYDERABAD,AGARTALA,180,165,AGARTALA-HYDERABAD,345,All
2015,12,HYDERABAD,AGARTALA,75,123,AGARTALA-HYDERABAD,198,All
2016,1,HYDERABAD,AGARTALA,98,132,AGARTALA-HYDERABAD,230,All
2016,2,HYDERABAD,AGARTALA,86,105,AGARTALA-HYDERABAD,191,All
2016,3,HYDERABAD,AGARTALA,173,126,AGARTALA-HYDERABAD,299,All
2016,4,HYDERABAD,AGARTALA,194,207,AGARTALA-HYDERABAD,401,All
2016,5,HYDERABAD,AGARTALA,216,120,AGARTALA-HYDERABAD,336,All
2016,6,HYDERABAD,AGARTALA,172,204,AGARTALA-HYDERABAD,376,All
2016,7,HYDERABAD,AGARTALA,153,192,AGARTALA-HYDERABAD,345,All
2016,8,HYDERABAD,AGARTALA,131,166,AGARTALA-HYDERABAD,297,All
2016,9,HYDERABAD,AGARTALA,89,61,AGARTALA-HYDERABAD,150,All
2016,10,HYDERABAD,AGARTALA,150,124,AGARTALA-HYDERABAD,274,All
2016,11,HYDERABAD,AGARTALA,94,113,AGARTALA-HYDERABAD,207,All
2016,12,HYDERABAD,AGARTALA,145,144,AGARTALA-HYDERABAD,289,All
2017,1,HYDERABAD,AGARTALA,109,54,AGARTALA-HYDERABAD,163,All
2017,2,HYDERABAD,AGARTALA,75,57,AGARTALA-HYDERABAD,132,All
2017,3,HYDERABAD,AGARTALA,131,32,AGARTALA-HYDERABAD,163,All
2017,4,HYDERABAD,AGARTALA,49,55,AGARTALA-HYDERABAD,104,All
2017,5,HYDERABAD,AGARTALA,135,122,AGARTALA-HYDERABAD,257,All
2017,6,HYDERABAD,AGARTALA,81,231,AGARTALA-HYDERABAD,312,All
2017,7,HYDERABAD,AGARTALA,0,122,AGARTALA-HYDERABAD,122,All
2017,8,HYDERABAD,AGARTALA,0,293,AGARTALA-HYDERABAD,293,All
2017,9,HYDERABAD,AGARTALA,0,230,AGARTALA-HYDERABAD,230,All
2017,10,HYDERABAD,AGARTALA,0,127,AGARTALA-HYDERABAD,127,All
2017,11,HYDERABAD,AGARTALA,0,151,AGARTALA-HYDERABAD,151,All
2017,12,HYDERABAD,AGARTALA,0,496,AGARTALA-HYDERABAD,496,All
2018,1,HYDERABAD,AGARTALA,0,241,AGARTALA-HYDERABAD,241,All
2018,2,HYDERABAD,AGARTALA,0,146,AGARTALA-HYDERABAD,146,All
2018,3,HYDERABAD,AGARTALA,0,226,AGARTALA-HYDERABAD,226,All
2018,4,HYDERABAD,AGARTALA,0,203,AGARTALA-HYDERABAD,203,All
2018,5,HYDERABAD,AGARTALA,0,265,AGARTALA-HYDERABAD,265,All
2018,6,HYDERABAD,AGARTALA,0,385,AGARTALA-HYDERABAD,385,All
2018,7,HYDERABAD,AGARTALA,0,240,AGARTALA-HYDERABAD,240,All
2018,8,HYDERABAD,AGARTALA,0,462,AGARTALA-HYDERABAD,462,All
2018,9,HYDERABAD,AGARTALA,92,538,AGARTALA-HYDERABAD,630,All
2018,10,HYDERABAD,AGARTALA,667,730,AGARTALA-HYDERABAD,1397,All
2018,11,HYDERABAD,AGARTALA,565,1138,AGARTALA-HYDERABAD,1703,All
2018,12,HYDERABAD,AGARTALA,730,1457,AGARTALA-HYDERABAD,2187,All
2019,1,HYDERABAD,AGARTALA,800,1443,AGARTALA-HYDERABAD,2243,All
2019,2,HYDERABAD,AGARTALA,387,890,AGARTALA-HYDERABAD,1277,All
2019,3,HYDERABAD,AGARTALA,499,727,AGARTALA-HYDERABAD,1226,All
2019,4,HYDERABAD,AGARTALA,280,538,AGARTALA-HYDERABAD,818,All
2019,4,HYDERABAD,AJMER,468,468,AJMER-HYDERABAD,936,All
2015,7,HYDERABAD,AURANGABAD,274,265,AURANGABAD-HYDERABAD,539,All
2015,8,HYDERABAD,AURANGABAD,1964,1806,AURANGABAD-HYDERABAD,3770,All
2015,9,HYDERABAD,AURANGABAD,1805,1751,AURANGABAD-HYDERABAD,3556,All
2015,10,HYDERABAD,AURANGABAD,1356,1525,AURANGABAD-HYDERABAD,2881,All
2015,11,HYDERABAD,AURANGABAD,1557,1633,AURANGABAD-HYDERABAD,3190,All
2015,12,HYDERABAD,AURANGABAD,1798,1909,AURANGABAD-HYDERABAD,3707,All
2016,1,HYDERABAD,AURANGABAD,1723,1876,AURANGABAD-HYDERABAD,3599,All
2016,2,HYDERABAD,AURANGABAD,1616,1683,AURANGABAD-HYDERABAD,3299,All
2016,3,HYDERABAD,AURANGABAD,1758,1821,AURANGABAD-HYDERABAD,3579,All
2016,4,HYDERABAD,AURANGABAD,1554,1612,AURANGABAD-HYDERABAD,3166,All
2016,5,HYDERABAD,AURANGABAD,1805,1912,AURANGABAD-HYDERABAD,3717,All
2016,6,HYDERABAD,AURANGABAD,1906,1874,AURANGABAD-HYDERABAD,3780,All
2016,7,HYDERABAD,AURANGABAD,1749,1762,AURANGABAD-HYDERABAD,3511,All
2016,8,HYDERABAD,AURANGABAD,1679,1706,AURANGABAD-HYDERABAD,3385,All
2016,9,HYDERABAD,AURANGABAD,1578,1585,AURANGABAD-HYDERABAD,3163,All
2016,10,HYDERABAD,AURANGABAD,1550,1664,AURANGABAD-HYDERABAD,3214,All
2016,11,HYDERABAD,AURANGABAD,1688,1715,AURANGABAD-HYDERABAD,3403,All
2016,12,HYDERABAD,AURANGABAD,1662,1728,AURANGABAD-HYDERABAD,3390,All
2017,1,HYDERABAD,AURANGABAD,1594,1482,AURANGABAD-HYDERABAD,3076,All
2017,2,HYDERABAD,AURANGABAD,1610,1606,AURANGABAD-HYDERABAD,3216,All
2017,3,HYDERABAD,AURANGABAD,1607,1493,AURANGABAD-HYDERABAD,3100,All
2017,4,HYDERABAD,AURANGABAD,1461,1791,AURANGABAD-HYDERABAD,3252,All
2017,5,HYDERABAD,AURANGABAD,1880,1896,AURANGABAD-HYDERABAD,3776,All
2017,6,HYDERABAD,AURANGABAD,1668,1838,AURANGABAD-HYDERABAD,3506,All
2017,7,HYDERABAD,AURANGABAD,1836,1925,AURANGABAD-HYDERABAD,3761,All
2017,8,HYDERABAD,AURANGABAD,1716,1847,AURANGABAD-HYDERABAD,3563,All
2017,9,HYDERABAD,AURANGABAD,1551,1597,AURANGABAD-HYDERABAD,3148,All
2017,10,HYDERABAD,AURANGABAD,1502,1687,AURANGABAD-HYDERABAD,3189,All
2017,11,HYDERABAD,AURANGABAD,1477,1542,AURANGABAD-HYDERABAD,3019,All
2017,12,HYDERABAD,AURANGABAD,733,760,AURANGABAD-HYDERABAD,1493,All
2018,1,HYDERABAD,AURANGABAD,814,783,AURANGABAD-HYDERABAD,1597,All
2018,2,HYDERABAD,AURANGABAD,773,728,AURANGABAD-HYDERABAD,1501,All
2018,3,HYDERABAD,AURANGABAD,882,928,AURANGABAD-HYDERABAD,1810,All
2018,4,HYDERABAD,AURANGABAD,1598,1502,AURANGABAD-HYDERABAD,3100,All
2018,5,HYDERABAD,AURANGABAD,1837,1833,AURANGABAD-HYDERABAD,3670,All
2018,6,HYDERABAD,AURANGABAD,1863,1789,AURANGABAD-HYDERABAD,3652,All
2018,7,HYDERABAD,AURANGABAD,1762,1635,AURANGABAD-HYDERABAD,3397,All
2018,8,HYDERABAD,AURANGABAD,1439,1421,AURANGABAD-HYDERABAD,2860,All
2018,9,HYDERABAD,AURANGABAD,1360,1303,AURANGABAD-HYDERABAD,2663,All
2018,10,HYDERABAD,AURANGABAD,1793,1775,AURANGABAD-HYDERABAD,3568,All
2018,11,HYDERABAD,AURANGABAD,1731,1780,AURANGABAD-HYDERABAD,3511,All
2018,12,HYDERABAD,AURANGABAD,1745,1694,AURANGABAD-HYDERABAD,3439,All
2019,1,HYDERABAD,AURANGABAD,1704,1737,AURANGABAD-HYDERABAD,3441,All
2019,2,HYDERABAD,AURANGABAD,1425,1501,AURANGABAD-HYDERABAD,2926,All
2019,3,HYDERABAD,AURANGABAD,1620,1508,AURANGABAD-HYDERABAD,3128,All
2019,4,HYDERABAD,AURANGABAD,1394,1402,AURANGABAD-HYDERABAD,2796,All
2024,3,HYDERABAD,Ayodhya International Airport ,10,12,Ayodhya International Airport -HYDERABAD,22,All
2024,4,HYDERABAD,Ayodhya International Airport ,1988,1189,Ayodhya International Airport -HYDERABAD,3177,All
2024,9,HYDERABAD,Ayodhya International Airport ,462,428,Ayodhya International Airport -HYDERABAD,890,All
2024,10,HYDERABAD,Ayodhya International Airport ,2728,2431,Ayodhya International Airport -HYDERABAD,5159,All
2024,11,HYDERABAD,Ayodhya International Airport ,2830,2798,Ayodhya International Airport -HYDERABAD,5628,All
2024,12,HYDERABAD,Ayodhya International Airport ,2912,3099,Ayodhya International Airport -HYDERABAD,6011,All
2025,1,HYDERABAD,Ayodhya International Airport ,3015,3001,Ayodhya International Airport -HYDERABAD,6016,All
2025,2,HYDERABAD,Ayodhya International Airport ,2815,2846,Ayodhya International Airport -HYDERABAD,5661,All
2025,3,HYDERABAD,Ayodhya International Airport ,2922,2917,Ayodhya International Airport -HYDERABAD,5839,All
2015,7,HYDERABAD,BAGDOGRA,0,195,BAGDOGRA-HYDERABAD,195,All
2015,8,HYDERABAD,BAGDOGRA,0,40,BAGDOGRA-HYDERABAD,40,All
2016,10,HYDERABAD,BAGDOGRA,0,14,BAGDOGRA-HYDERABAD,14,All
2016,11,HYDERABAD,BAGDOGRA,0,384,BAGDOGRA-HYDERABAD,384,All
2016,12,HYDERABAD,BAGDOGRA,0,575,BAGDOGRA-HYDERABAD,575,All
2017,1,HYDERABAD,BAGDOGRA,0,476,BAGDOGRA-HYDERABAD,476,All
2017,2,HYDERABAD,BAGDOGRA,3838,252,BAGDOGRA-HYDERABAD,4090,All
2017,3,HYDERABAD,BAGDOGRA,3798,1017,BAGDOGRA-HYDERABAD,4815,All
2017,4,HYDERABAD,BAGDOGRA,0,422,BAGDOGRA-HYDERABAD,422,All
2017,5,HYDERABAD,BAGDOGRA,0,419,BAGDOGRA-HYDERABAD,419,All
2017,6,HYDERABAD,BAGDOGRA,0,145,BAGDOGRA-HYDERABAD,145,All
2017,7,HYDERABAD,BAGDOGRA,0,259,BAGDOGRA-HYDERABAD,259,All
2017,8,HYDERABAD,BAGDOGRA,0,341,BAGDOGRA-HYDERABAD,341,All
2017,9,HYDERABAD,BAGDOGRA,0,166,BAGDOGRA-HYDERABAD,166,All
2017,10,HYDERABAD,BAGDOGRA,0,70,BAGDOGRA-HYDERABAD,70,All
2017,11,HYDERABAD,BAGDOGRA,0,277,BAGDOGRA-HYDERABAD,277,All
2017,12,HYDERABAD,BAGDOGRA,0,651,BAGDOGRA-HYDERABAD,651,All
2018,1,HYDERABAD,BAGDOGRA,0,534,BAGDOGRA-HYDERABAD,534,All
2018,2,HYDERABAD,BAGDOGRA,0,210,BAGDOGRA-HYDERABAD,210,All
2018,3,HYDERABAD,BAGDOGRA,0,273,BAGDOGRA-HYDERABAD,273,All
2018,4,HYDERABAD,BAGDOGRA,0,179,BAGDOGRA-HYDERABAD,179,All
2018,5,HYDERABAD,BAGDOGRA,0,687,BAGDOGRA-HYDERABAD,687,All
2018,6,HYDERABAD,BAGDOGRA,0,256,BAGDOGRA-HYDERABAD,256,All
2018,7,HYDERABAD,BAGDOGRA,0,118,BAGDOGRA-HYDERABAD,118,All
2018,8,HYDERABAD,BAGDOGRA,0,255,BAGDOGRA-HYDERABAD,255,All
2018,9,HYDERABAD,BAGDOGRA,0,61,BAGDOGRA-HYDERABAD,61,All
2018,10,HYDERABAD,BAGDOGRA,0,754,BAGDOGRA-HYDERABAD,754,All
2018,11,HYDERABAD,BAGDOGRA,0,874,BAGDOGRA-HYDERABAD,874,All
2018,12,HYDERABAD,BAGDOGRA,2922,3105,BAGDOGRA-HYDERABAD,6027,All
2019,1,HYDERABAD,BAGDOGRA,4848,5385,BAGDOGRA-HYDERABAD,10233,All
2019,2,HYDERABAD,BAGDOGRA,4447,3948,BAGDOGRA-HYDERABAD,8395,All
2019,3,HYDERABAD,BAGDOGRA,4825,4658,BAGDOGRA-HYDERABAD,9483,All
2019,4,HYDERABAD,BAGDOGRA,5213,4707,BAGDOGRA-HYDERABAD,9920,All
2017,11,HYDERABAD,BELGAUM,0,23,BELGAUM-HYDERABAD,23,All
2017,12,HYDERABAD,BELGAUM,0,27,BELGAUM-HYDERABAD,27,All
2018,1,HYDERABAD,BELGAUM,0,28,BELGAUM-HYDERABAD,28,All
2018,2,HYDERABAD,BELGAUM,0,29,BELGAUM-HYDERABAD,29,All
2018,3,HYDERABAD,BELGAUM,252,285,BELGAUM-HYDERABAD,537,All
2018,4,HYDERABAD,BELGAUM,1567,1570,BELGAUM-HYDERABAD,3137,All
2018,5,HYDERABAD,BELGAUM,736,786,BELGAUM-HYDERABAD,1522,All
2015,4,HYDERABAD,CHANDIGARH,1045,1044,CHANDIGARH-HYDERABAD,2089,All
2015,5,HYDERABAD,CHANDIGARH,1327,1351,CHANDIGARH-HYDERABAD,2678,All
2015,6,HYDERABAD,CHANDIGARH,1000,1073,CHANDIGARH-HYDERABAD,2073,All
2015,7,HYDERABAD,CHANDIGARH,770,839,CHANDIGARH-HYDERABAD,1609,All
2015,8,HYDERABAD,CHANDIGARH,580,550,CHANDIGARH-HYDERABAD,1130,All
2015,9,HYDERABAD,CHANDIGARH,446,567,CHANDIGARH-HYDERABAD,1013,All
2015,10,HYDERABAD,CHANDIGARH,928,990,CHANDIGARH-HYDERABAD,1918,All
2015,11,HYDERABAD,CHANDIGARH,737,708,CHANDIGARH-HYDERABAD,1445,All
2015,12,HYDERABAD,CHANDIGARH,15,26,CHANDIGARH-HYDERABAD,41,All
2016,1,HYDERABAD,CHANDIGARH,16,0,CHANDIGARH-HYDERABAD,16,All
2016,2,HYDERABAD,CHANDIGARH,613,605,CHANDIGARH-HYDERABAD,1218,All
2016,3,HYDERABAD,CHANDIGARH,1261,1197,CHANDIGARH-HYDERABAD,2458,All
2016,4,HYDERABAD,CHANDIGARH,1014,1006,CHANDIGARH-HYDERABAD,2020,All
2016,5,HYDERABAD,CHANDIGARH,475,488,CHANDIGARH-HYDERABAD,963,All
2016,6,HYDERABAD,CHANDIGARH,780,869,CHANDIGARH-HYDERABAD,1649,All
2016,7,HYDERABAD,CHANDIGARH,739,999,CHANDIGARH-HYDERABAD,1738,All
2016,8,HYDERABAD,CHANDIGARH,565,826,CHANDIGARH-HYDERABAD,1391,All
2016,9,HYDERABAD,CHANDIGARH,676,621,CHANDIGARH-HYDERABAD,1297,All
2016,10,HYDERABAD,CHANDIGARH,528,785,CHANDIGARH-HYDERABAD,1313,All
2016,11,HYDERABAD,CHANDIGARH,550,500,CHANDIGARH-HYDERABAD,1050,All
2017,2,HYDERABAD,CHANDIGARH,1309,1322,CHANDIGARH-HYDERABAD,2631,All
2017,3,HYDERABAD,CHANDIGARH,3946,3360,CHANDIGARH-HYDERABAD,7306,All
2017,4,HYDERABAD,CHANDIGARH,4195,3661,CHANDIGARH-HYDERABAD,7856,All
2017,5,HYDERABAD,CHANDIGARH,3872,4368,CHANDIGARH-HYDERABAD,8240,All
2017,6,HYDERABAD,CHANDIGARH,3705,4108,CHANDIGARH-HYDERABAD,7813,All
2017,7,HYDERABAD,CHANDIGARH,7073,7027,CHANDIGARH-HYDERABAD,14100,All
2017,8,HYDERABAD,CHANDIGARH,6983,6821,CHANDIGARH-HYDERABAD,13804,All
2017,9,HYDERABAD,CHANDIGARH,7267,6340,CHANDIGARH-HYDERABAD,13607,All
2017,10,HYDERABAD,CHANDIGARH,4121,4084,CHANDIGARH-HYDERABAD,8205,All
2017,11,HYDERABAD,CHANDIGARH,3517,3584,CHANDIGARH-HYDERABAD,7101,All
2017,12,HYDERABAD,CHANDIGARH,3464,3767,CHANDIGARH-HYDERABAD,7231,All
2018,1,HYDERABAD,CHANDIGARH,3677,3757,CHANDIGARH-HYDERABAD,7434,All
2018,2,HYDERABAD,CHANDIGARH,1654,1729,CHANDIGARH-HYDERABAD,3383,All
2018,3,HYDERABAD,CHANDIGARH,4241,4053,CHANDIGARH-HYDERABAD,8294,All
2018,4,HYDERABAD,CHANDIGARH,3773,3545,CHANDIGARH-HYDERABAD,7318,All
2018,5,HYDERABAD,CHANDIGARH,1519,1322,CHANDIGARH-HYDERABAD,2841,All
2018,6,HYDERABAD,CHANDIGARH,3657,3532,CHANDIGARH-HYDERABAD,7189,All
2018,7,HYDERABAD,CHANDIGARH,4195,4120,CHANDIGARH-HYDERABAD,8315,All
2018,8,HYDERABAD,CHANDIGARH,4463,4290,CHANDIGARH-HYDERABAD,8753,All
2018,9,HYDERABAD,CHANDIGARH,4648,4311,CHANDIGARH-HYDERABAD,8959,All
2018,10,HYDERABAD,CHANDIGARH,5776,5615,CHANDIGARH-HYDERABAD,11391,All
2018,11,HYDERABAD,CHANDIGARH,4076,4055,CHANDIGARH-HYDERABAD,8131,All
2018,12,HYDERABAD,CHANDIGARH,4465,4538,CHANDIGARH-HYDERABAD,9003,All
2019,1,HYDERABAD,CHANDIGARH,4489,4312,CHANDIGARH-HYDERABAD,8801,All
2019,2,HYDERABAD,CHANDIGARH,3987,3809,CHANDIGARH-HYDERABAD,7796,All
2019,3,HYDERABAD,CHANDIGARH,4373,4293,CHANDIGARH-HYDERABAD,8666,All
2019,4,HYDERABAD,CHANDIGARH,4265,3768,CHANDIGARH-HYDERABAD,8033,All
2015,4,HYDERABAD,CHENNAI,40592,38200,CHENNAI-HYDERABAD,78792,All
2015,5,HYDERABAD,CHENNAI,43794,41778,CHENNAI-HYDERABAD,85572,All
2015,6,HYDERABAD,CHENNAI,37059,36561,CHENNAI-HYDERABAD,73620,All
2015,7,HYDERABAD,CHENNAI,35651,35120,CHENNAI-HYDERABAD,70771,All
2015,8,HYDERABAD,CHENNAI,35271,35218,CHENNAI-HYDERABAD,70489,All
2015,9,HYDERABAD,CHENNAI,33437,33364,CHENNAI-HYDERABAD,66801,All
2015,10,HYDERABAD,CHENNAI,47015,29357,CHENNAI-HYDERABAD,76372,All
2015,11,HYDERABAD,CHENNAI,31479,30889,CHENNAI-HYDERABAD,62368,All
2015,12,HYDERABAD,CHENNAI,28682,28420,CHENNAI-HYDERABAD,57102,All
2016,1,HYDERABAD,CHENNAI,40084,38721,CHENNAI-HYDERABAD,78805,All
2016,2,HYDERABAD,CHENNAI,38625,39598,CHENNAI-HYDERABAD,78223,All
2016,3,HYDERABAD,CHENNAI,41903,43305,CHENNAI-HYDERABAD,85208,All
2016,4,HYDERABAD,CHENNAI,43053,44253,CHENNAI-HYDERABAD,87306,All
2016,5,HYDERABAD,CHENNAI,45632,44726,CHENNAI-HYDERABAD,90358,All
2016,6,HYDERABAD,CHENNAI,40416,42093,CHENNAI-HYDERABAD,82509,All
2016,7,HYDERABAD,CHENNAI,50117,49733,CHENNAI-HYDERABAD,99850,All
2016,8,HYDERABAD,CHENNAI,48336,49070,CHENNAI-HYDERABAD,97406,All
2016,9,HYDERABAD,CHENNAI,44805,45566,CHENNAI-HYDERABAD,90371,All
2016,10,HYDERABAD,CHENNAI,49907,48521,CHENNAI-HYDERABAD,98428,All
2016,11,HYDERABAD,CHENNAI,45020,47647,CHENNAI-HYDERABAD,92667,All
2016,12,HYDERABAD,CHENNAI,49167,50429,CHENNAI-HYDERABAD,99596,All
2017,1,HYDERABAD,CHENNAI,55581,52542,CHENNAI-HYDERABAD,108123,All
2017,2,HYDERABAD,CHENNAI,48656,49419,CHENNAI-HYDERABAD,98075,All
2017,3,HYDERABAD,CHENNAI,50733,52474,CHENNAI-HYDERABAD,103207,All
2017,4,HYDERABAD,CHENNAI,48886,49131,CHENNAI-HYDERABAD,98017,All
2017,5,HYDERABAD,CHENNAI,53866,52327,CHENNAI-HYDERABAD,106193,All
2017,6,HYDERABAD,CHENNAI,46080,49034,CHENNAI-HYDERABAD,95114,All
2017,7,HYDERABAD,CHENNAI,54971,52384,CHENNAI-HYDERABAD,107355,All
2017,8,HYDERABAD,CHENNAI,49715,47851,CHENNAI-HYDERABAD,97566,All
2017,9,HYDERABAD,CHENNAI,53236,51612,CHENNAI-HYDERABAD,104848,All
2017,10,HYDERABAD,CHENNAI,59309,56085,CHENNAI-HYDERABAD,115394,All
2017,11,HYDERABAD,CHENNAI,60854,59235,CHENNAI-HYDERABAD,120089,All
2017,12,HYDERABAD,CHENNAI,59909,56952,CHENNAI-HYDERABAD,116861,All
2018,1,HYDERABAD,CHENNAI,63085,59082,CHENNAI-HYDERABAD,122167,All
2018,2,HYDERABAD,CHENNAI,56653,55377,CHENNAI-HYDERABAD,112030,All
2018,3,HYDERABAD,CHENNAI,60281,58039,CHENNAI-HYDERABAD,118320,All
2018,4,HYDERABAD,CHENNAI,54502,50641,CHENNAI-HYDERABAD,105143,All
2018,5,HYDERABAD,CHENNAI,55969,53214,CHENNAI-HYDERABAD,109183,All
2018,6,HYDERABAD,CHENNAI,51881,51465,CHENNAI-HYDERABAD,103346,All
2018,7,HYDERABAD,CHENNAI,62032,60680,CHENNAI-HYDERABAD,122712,All
2018,8,HYDERABAD,CHENNAI,53893,56022,CHENNAI-HYDERABAD,109915,All
2018,9,HYDERABAD,CHENNAI,54479,54606,CHENNAI-HYDERABAD,109085,All
2018,10,HYDERABAD,CHENNAI,52192,52939,CHENNAI-HYDERABAD,105131,All
2018,11,HYDERABAD,CHENNAI,46246,46414,CHENNAI-HYDERABAD,92660,All
2018,12,HYDERABAD,CHENNAI,54402,55213,CHENNAI-HYDERABAD,109615,All
2019,1,HYDERABAD,CHENNAI,54140,54316,CHENNAI-HYDERABAD,108456,All
2019,2,HYDERABAD,CHENNAI,49198,51046,CHENNAI-HYDERABAD,100244,All
2019,3,HYDERABAD,CHENNAI,50249,50804,CHENNAI-HYDERABAD,101053,All
2019,4,HYDERABAD,CHENNAI,52604,52888,CHENNAI-HYDERABAD,105492,All
2023,1,HYDERABAD,Cuddapah,1597,1575,Cuddapah-HYDERABAD,3172,All
2023,6,HYDERABAD,Cuddapah,1810,1825,Cuddapah-HYDERABAD,3635,All
2023,7,HYDERABAD,Cuddapah,1979,1921,Cuddapah-HYDERABAD,3900,All
2023,8,HYDERABAD,Cuddapah,1972,1953,Cuddapah-HYDERABAD,3925,All
2023,9,HYDERABAD,Cuddapah,1772,1836,Cuddapah-HYDERABAD,3608,All
2023,10,HYDERABAD,Cuddapah,1621,1583,Cuddapah-HYDERABAD,3204,All
2024,10,HYDERABAD,Cuddapah,207,295,Cuddapah-HYDERABAD,502,All
2024,11,HYDERABAD,Cuddapah,1580,1918,Cuddapah-HYDERABAD,3498,All
2024,12,HYDERABAD,Cuddapah,1540,1556,Cuddapah-HYDERABAD,3096,All
2025,1,HYDERABAD,Cuddapah,2119,2038,Cuddapah-HYDERABAD,4157,All
2025,2,HYDERABAD,Cuddapah,1763,1771,Cuddapah-HYDERABAD,3534,All
2025,3,HYDERABAD,Cuddapah,1825,1903,Cuddapah-HYDERABAD,3728,All
2019,2,HYDERABAD,DURGAPUR,456,492,DURGAPUR-HYDERABAD,948,All
2019,3,HYDERABAD,DURGAPUR,1431,1540,DURGAPUR-HYDERABAD,2971,All
2019,4,HYDERABAD,DURGAPUR,1685,954,DURGAPUR-HYDERABAD,2639,All
2022,3,HYDERABAD,Gondia Airport,564,694,Gondia Airport-HYDERABAD,1258,All
2017,6,HYDERABAD,IMPHAL,168,184,HYDERABAD-IMPHAL,352,All
2017,7,HYDERABAD,IMPHAL,175,195,HYDERABAD-IMPHAL,370,All
2017,8,HYDERABAD,IMPHAL,212,218,HYDERABAD-IMPHAL,430,All
2017,9,HYDERABAD,IMPHAL,275,180,HYDERABAD-IMPHAL,455,All
2017,10,HYDERABAD,IMPHAL,190,292,HYDERABAD-IMPHAL,482,All
2017,11,HYDERABAD,IMPHAL,155,205,HYDERABAD-IMPHAL,360,All
2017,12,HYDERABAD,IMPHAL,187,102,HYDERABAD-IMPHAL,289,All
2018,1,HYDERABAD,IMPHAL,183,180,HYDERABAD-IMPHAL,363,All
2018,2,HYDERABAD,IMPHAL,97,146,HYDERABAD-IMPHAL,243,All
2018,3,HYDERABAD,IMPHAL,278,383,HYDERABAD-IMPHAL,661,All
2018,4,HYDERABAD,IMPHAL,152,162,HYDERABAD-IMPHAL,314,All
2018,5,HYDERABAD,IMPHAL,249,186,HYDERABAD-IMPHAL,435,All
2018,6,HYDERABAD,IMPHAL,282,600,HYDERABAD-IMPHAL,882,All
2018,7,HYDERABAD,IMPHAL,109,161,HYDERABAD-IMPHAL,270,All
2018,8,HYDERABAD,IMPHAL,133,80,HYDERABAD-IMPHAL,213,All
2018,9,HYDERABAD,IMPHAL,178,99,HYDERABAD-IMPHAL,277,All
2018,10,HYDERABAD,IMPHAL,583,656,HYDERABAD-IMPHAL,1239,All
2018,11,HYDERABAD,IMPHAL,1260,2309,HYDERABAD-IMPHAL,3569,All
2018,12,HYDERABAD,IMPHAL,3884,2990,HYDERABAD-IMPHAL,6874,All
2019,1,HYDERABAD,IMPHAL,2353,4334,HYDERABAD-IMPHAL,6687,All
2019,2,HYDERABAD,IMPHAL,1802,2184,HYDERABAD-IMPHAL,3986,All
2019,3,HYDERABAD,IMPHAL,3040,2510,HYDERABAD-IMPHAL,5550,All
2019,4,HYDERABAD,IMPHAL,4496,2443,HYDERABAD-IMPHAL,6939,All
2019,5,HYDERABAD,IMPHAL,4290,4207,HYDERABAD-IMPHAL,8497,All
2019,6,HYDERABAD,IMPHAL,1934,3461,HYDERABAD-IMPHAL,5395,All
2019,7,HYDERABAD,IMPHAL,2718,3776,HYDERABAD-IMPHAL,6494,All
2019,8,HYDERABAD,IMPHAL,2200,2231,HYDERABAD-IMPHAL,4431,All
2019,9,HYDERABAD,IMPHAL,503,782,HYDERABAD-IMPHAL,1285,All
2019,10,HYDERABAD,IMPHAL,586,695,HYDERABAD-IMPHAL,1281,All
2019,11,HYDERABAD,IMPHAL,397,393,HYDERABAD-IMPHAL,790,All
2019,12,HYDERABAD,IMPHAL,470,593,HYDERABAD-IMPHAL,1063,All
2020,1,HYDERABAD,IMPHAL,641,574,HYDERABAD-IMPHAL,1215,All
2020,2,HYDERABAD,IMPHAL,511,548,HYDERABAD-IMPHAL,1059,All
2020,3,HYDERABAD,IMPHAL,678,361,HYDERABAD-IMPHAL,1039,All
2020,7,HYDERABAD,IMPHAL,15,15,HYDERABAD-IMPHAL,30,All
2020,8,HYDERABAD,IMPHAL,163,99,HYDERABAD-IMPHAL,262,All
2020,9,HYDERABAD,IMPHAL,321,230,HYDERABAD-IMPHAL,551,All
2020,10,HYDERABAD,IMPHAL,412,318,HYDERABAD-IMPHAL,730,All
2020,11,HYDERABAD,IMPHAL,494,263,HYDERABAD-IMPHAL,757,All
2020,12,HYDERABAD,IMPHAL,586,442,HYDERABAD-IMPHAL,1028,All
2021,1,HYDERABAD,IMPHAL,368,795,HYDERABAD-IMPHAL,1163,All
2021,2,HYDERABAD,IMPHAL,549,671,HYDERABAD-IMPHAL,1220,All
2021,3,HYDERABAD,IMPHAL,652,543,HYDERABAD-IMPHAL,1195,All
2021,4,HYDERABAD,IMPHAL,530,347,HYDERABAD-IMPHAL,877,All
2021,6,HYDERABAD,IMPHAL,381,0,HYDERABAD-IMPHAL,381,All
2021,7,HYDERABAD,IMPHAL,368,0,HYDERABAD-IMPHAL,368,All
2021,8,HYDERABAD,IMPHAL,500,165,HYDERABAD-IMPHAL,665,All
2021,9,HYDERABAD,IMPHAL,540,375,HYDERABAD-IMPHAL,915,All
2021,10,HYDERABAD,IMPHAL,815,341,HYDERABAD-IMPHAL,1156,All
2021,11,HYDERABAD,IMPHAL,530,422,HYDERABAD-IMPHAL,952,All
2021,12,HYDERABAD,IMPHAL,395,362,HYDERABAD-IMPHAL,757,All
2022,1,HYDERABAD,IMPHAL,307,297,HYDERABAD-IMPHAL,604,All
2022,2,HYDERABAD,IMPHAL,370,309,HYDERABAD-IMPHAL,679,All
2022,3,HYDERABAD,IMPHAL,212,309,HYDERABAD-IMPHAL,521,All
2022,4,HYDERABAD,IMPHAL,111,77,HYDERABAD-IMPHAL,188,All
2022,5,HYDERABAD,IMPHAL,254,235,HYDERABAD-IMPHAL,489,All
2022,6,HYDERABAD,IMPHAL,345,484,HYDERABAD-IMPHAL,829,All
2022,7,HYDERABAD,IMPHAL,307,350,HYDERABAD-IMPHAL,657,All
2022,8,HYDERABAD,IMPHAL,298,390,HYDERABAD-IMPHAL,688,All
2022,9,HYDERABAD,IMPHAL,141,271,HYDERABAD-IMPHAL,412,All
2022,10,HYDERABAD,IMPHAL,391,364,HYDERABAD-IMPHAL,755,All
2022,11,HYDERABAD,IMPHAL,338,297,HYDERABAD-IMPHAL,635,All
2022,12,HYDERABAD,IMPHAL,416,362,HYDERABAD-IMPHAL,778,All
2023,1,HYDERABAD,IMPHAL,342,484,HYDERABAD-IMPHAL,826,All
2023,2,HYDERABAD,IMPHAL,312,312,HYDERABAD-IMPHAL,624,All
2023,3,HYDERABAD,IMPHAL,286,313,HYDERABAD-IMPHAL,599,All
2023,4,HYDERABAD,IMPHAL,377,271,HYDERABAD-IMPHAL,648,All
2023,5,HYDERABAD,IMPHAL,271,400,HYDERABAD-IMPHAL,671,All
2023,6,HYDERABAD,IMPHAL,706,720,HYDERABAD-IMPHAL,1426,All
2023,7,HYDERABAD,IMPHAL,625,686,HYDERABAD-IMPHAL,1311,All
2023,8,HYDERABAD,IMPHAL,419,957,HYDERABAD-IMPHAL,1376,All
2023,9,HYDERABAD,IMPHAL,464,690,HYDERABAD-IMPHAL,1154,All
2023,10,HYDERABAD,IMPHAL,452,414,HYDERABAD-IMPHAL,866,All
2023,11,HYDERABAD,IMPHAL,607,346,HYDERABAD-IMPHAL,953,All
2023,12,HYDERABAD,IMPHAL,763,446,HYDERABAD-IMPHAL,1209,All
2024,1,HYDERABAD,IMPHAL,485,472,HYDERABAD-IMPHAL,957,All
2024,2,HYDERABAD,IMPHAL,583,587,HYDERABAD-IMPHAL,1170,All
2024,3,HYDERABAD,IMPHAL,470,541,HYDERABAD-IMPHAL,1011,All
2024,4,HYDERABAD,IMPHAL,173,274,HYDERABAD-IMPHAL,447,All
2015,4,HYDERABAD,INDORE,4927,5052,HYDERABAD-INDORE,9979,All
2015,5,HYDERABAD,INDORE,4473,4651,HYDERABAD-INDORE,9124,All
2015,6,HYDERABAD,INDORE,4200,4445,HYDERABAD-INDORE,8645,All
2015,7,HYDERABAD,INDORE,4144,4157,HYDERABAD-INDORE,8301,All
2015,8,HYDERABAD,INDORE,4108,3828,HYDERABAD-INDORE,7936,All
2015,9,HYDERABAD,INDORE,3569,3611,HYDERABAD-INDORE,7180,All
2015,10,HYDERABAD,INDORE,4009,4076,HYDERABAD-INDORE,8085,All
2015,11,HYDERABAD,INDORE,4182,4036,HYDERABAD-INDORE,8218,All
2015,12,HYDERABAD,INDORE,4477,4507,HYDERABAD-INDORE,8984,All
2016,1,HYDERABAD,INDORE,4730,4528,HYDERABAD-INDORE,9258,All
2016,2,HYDERABAD,INDORE,4170,4276,HYDERABAD-INDORE,8446,All
2016,3,HYDERABAD,INDORE,4030,4162,HYDERABAD-INDORE,8192,All
2016,4,HYDERABAD,INDORE,4025,3966,HYDERABAD-INDORE,7991,All
2016,5,HYDERABAD,INDORE,4212,4834,HYDERABAD-INDORE,9046,All
2016,6,HYDERABAD,INDORE,3254,3563,HYDERABAD-INDORE,6817,All
2016,7,HYDERABAD,INDORE,3629,4136,HYDERABAD-INDORE,7765,All
2016,8,HYDERABAD,INDORE,3743,3908,HYDERABAD-INDORE,7651,All
2016,9,HYDERABAD,INDORE,3876,3850,HYDERABAD-INDORE,7726,All
2016,10,HYDERABAD,INDORE,4215,4204,HYDERABAD-INDORE,8419,All
2016,11,HYDERABAD,INDORE,4402,4678,HYDERABAD-INDORE,9080,All
2016,12,HYDERABAD,INDORE,7619,8410,HYDERABAD-INDORE,16029,All
2017,1,HYDERABAD,INDORE,7824,7976,HYDERABAD-INDORE,15800,All
2017,2,HYDERABAD,INDORE,6434,7089,HYDERABAD-INDORE,13523,All
2017,3,HYDERABAD,INDORE,5852,6967,HYDERABAD-INDORE,12819,All
2017,4,HYDERABAD,INDORE,5533,5943,HYDERABAD-INDORE,11476,All
2017,5,HYDERABAD,INDORE,6037,8520,HYDERABAD-INDORE,14557,All
2017,6,HYDERABAD,INDORE,7117,8089,HYDERABAD-INDORE,15206,All
2017,7,HYDERABAD,INDORE,5160,6053,HYDERABAD-INDORE,11213,All
2017,8,HYDERABAD,INDORE,6388,7064,HYDERABAD-INDORE,13452,All
2017,9,HYDERABAD,INDORE,7537,7378,HYDERABAD-INDORE,14915,All
2017,10,HYDERABAD,INDORE,8037,8481,HYDERABAD-INDORE,16518,All
2017,11,HYDERABAD,INDORE,8961,9464,HYDERABAD-INDORE,18425,All
2017,12,HYDERABAD,INDORE,9494,9608,HYDERABAD-INDORE,19102,All
2018,1,HYDERABAD,INDORE,9533,10148,HYDERABAD-INDORE,19681,All
2018,2,HYDERABAD,INDORE,8218,8535,HYDERABAD-INDORE,16753,All
2018,3,HYDERABAD,INDORE,7407,8528,HYDERABAD-INDORE,15935,All
2018,4,HYDERABAD,INDORE,8582,7938,HYDERABAD-INDORE,16520,All
2018,5,HYDERABAD,INDORE,8692,9580,HYDERABAD-INDORE,18272,All
2018,6,HYDERABAD,INDORE,8612,7570,HYDERABAD-INDORE,16182,All
2018,7,HYDERABAD,INDORE,6918,7590,HYDERABAD-INDORE,14508,All
2018,8,HYDERABAD,INDORE,9234,10081,HYDERABAD-INDORE,19315,All
2018,9,HYDERABAD,INDORE,11484,12194,HYDERABAD-INDORE,23678,All
2018,10,HYDERABAD,INDORE,19168,17130,HYDERABAD-INDORE,36298,All
2018,11,HYDERABAD,INDORE,16097,16650,HYDERABAD-INDORE,32747,All
2018,12,HYDERABAD,INDORE,18720,19708,HYDERABAD-INDORE,38428,All
2019,1,HYDERABAD,INDORE,19302,19756,HYDERABAD-INDORE,39058,All
2019,2,HYDERABAD,INDORE,21761,21344,HYDERABAD-INDORE,43105,All
2019,3,HYDERABAD,INDORE,23040,22819,HYDERABAD-INDORE,45859,All
2019,4,HYDERABAD,INDORE,17775,16766,HYDERABAD-INDORE,34541,All
2019,5,HYDERABAD,INDORE,13158,14910,HYDERABAD-INDORE,28068,All
2019,6,HYDERABAD,INDORE,4922,4973,HYDERABAD-INDORE,9895,All
2019,7,HYDERABAD,INDORE,6638,6932,HYDERABAD-INDORE,13570,All
2019,8,HYDERABAD,INDORE,6783,6907,HYDERABAD-INDORE,13690,All
2019,9,HYDERABAD,INDORE,5735,5655,HYDERABAD-INDORE,11390,All
2019,10,HYDERABAD,INDORE,5885,6022,HYDERABAD-INDORE,11907,All
2019,11,HYDERABAD,INDORE,7667,8062,HYDERABAD-INDORE,15729,All
2019,12,HYDERABAD,INDORE,10349,11210,HYDERABAD-INDORE,21559,All
2020,1,HYDERABAD,INDORE,11870,12377,HYDERABAD-INDORE,24247,All
2020,2,HYDERABAD,INDORE,8928,9240,HYDERABAD-INDORE,18168,All
2020,3,HYDERABAD,INDORE,5756,4491,HYDERABAD-INDORE,10247,All
2020,5,HYDERABAD,INDORE,35,37,HYDERABAD-INDORE,72,All
2020,6,HYDERABAD,INDORE,2278,1435,HYDERABAD-INDORE,3713,All
2020,7,HYDERABAD,INDORE,2877,2218,HYDERABAD-INDORE,5095,All
2020,8,HYDERABAD,INDORE,2524,2198,HYDERABAD-INDORE,4722,All
2020,9,HYDERABAD,INDORE,2365,2255,HYDERABAD-INDORE,4620,All
2020,10,HYDERABAD,INDORE,2531,2566,HYDERABAD-INDORE,5097,All
2020,11,HYDERABAD,INDORE,6801,5522,HYDERABAD-INDORE,12323,All
2020,12,HYDERABAD,INDORE,6968,6749,HYDERABAD-INDORE,13717,All
2021,1,HYDERABAD,INDORE,7184,6988,HYDERABAD-INDORE,14172,All
2021,2,HYDERABAD,INDORE,7315,6810,HYDERABAD-INDORE,14125,All
2021,3,HYDERABAD,INDORE,6877,7320,HYDERABAD-INDORE,14197,All
2021,4,HYDERABAD,INDORE,4079,3616,HYDERABAD-INDORE,7695,All
2021,6,HYDERABAD,INDORE,1990,2047,HYDERABAD-INDORE,4037,All
2021,7,HYDERABAD,INDORE,6726,5628,HYDERABAD-INDORE,12354,All
2021,8,HYDERABAD,INDORE,8449,7389,HYDERABAD-INDORE,15838,All
2021,9,HYDERABAD,INDORE,6675,6780,HYDERABAD-INDORE,13455,All
2021,10,HYDERABAD,INDORE,8890,8018,HYDERABAD-INDORE,16908,All
2021,11,HYDERABAD,INDORE,7129,7350,HYDERABAD-INDORE,14479,All
2021,12,HYDERABAD,INDORE,7395,7454,HYDERABAD-INDORE,14849,All
2022,1,HYDERABAD,INDORE,5095,5004,HYDERABAD-INDORE,10099,All
2022,2,HYDERABAD,INDORE,5854,6315,HYDERABAD-INDORE,12169,All
2022,3,HYDERABAD,INDORE,7994,8138,HYDERABAD-INDORE,16132,All
2022,4,HYDERABAD,INDORE,11977,13005,HYDERABAD-INDORE,24982,All
2022,5,HYDERABAD,INDORE,9829,11817,HYDERABAD-INDORE,21646,All
2022,6,HYDERABAD,INDORE,8806,10109,HYDERABAD-INDORE,18915,All
2022,7,HYDERABAD,INDORE,9553,11079,HYDERABAD-INDORE,20632,All
2022,8,HYDERABAD,INDORE,10681,11561,HYDERABAD-INDORE,22242,All
2022,9,HYDERABAD,INDORE,10781,10434,HYDERABAD-INDORE,21215,All
2022,10,HYDERABAD,INDORE,13368,13275,HYDERABAD-INDORE,26643,All
2022,11,HYDERABAD,INDORE,12345,12770,HYDERABAD-INDORE,25115,All
2022,12,HYDERABAD,INDORE,11127,12100,HYDERABAD-INDORE,23227,All
2023,1,HYDERABAD,INDORE,12854,13304,HYDERABAD-INDORE,26158,All
2023,2,HYDERABAD,INDORE,11977,12334,HYDERABAD-INDORE,24311,All
2023,3,HYDERABAD,INDORE,12298,13068,HYDERABAD-INDORE,25366,All
2023,4,HYDERABAD,INDORE,12804,12496,HYDERABAD-INDORE,25300,All
2023,5,HYDERABAD,INDORE,12693,14657,HYDERABAD-INDORE,27350,All
2023,6,HYDERABAD,INDORE,13048,13979,HYDERABAD-INDORE,27027,All
2023,7,HYDERABAD,INDORE,12385,12405,HYDERABAD-INDORE,24790,All
2023,8,HYDERABAD,INDORE,12228,11407,HYDERABAD-INDORE,23635,All
2023,9,HYDERABAD,INDORE,12673,13188,HYDERABAD-INDORE,25861,All
2023,10,HYDERABAD,INDORE,12755,11857,HYDERABAD-INDORE,24612,All
2023,11,HYDERABAD,INDORE,14249,13860,HYDERABAD-INDORE,28109,All
2023,12,HYDERABAD,INDORE,15322,17356,HYDERABAD-INDORE,32678,All
2024,1,HYDERABAD,INDORE,14512,15101,HYDERABAD-INDORE,29613,All
2024,2,HYDERABAD,INDORE,13720,14162,HYDERABAD-INDORE,27882,All
2024,3,HYDERABAD,INDORE,14392,14932,HYDERABAD-INDORE,29324,All
2024,4,HYDERABAD,INDORE,15922,14902,HYDERABAD-INDORE,30824,All
2024,6,HYDERABAD,INDORE,15341,16194,HYDERABAD-INDORE,31535,All
2024,7,HYDERABAD,INDORE,15332,15898,HYDERABAD-INDORE,31230,All
2024,8,HYDERABAD,INDORE,15977,15929,HYDERABAD-INDORE,31906,All
2024,9,HYDERABAD,INDORE,13551,15630,HYDERABAD-INDORE,29181,All
2024,10,HYDERABAD,INDORE,16833,13805,HYDERABAD-INDORE,30638,All
2024,11,HYDERABAD,INDORE,14339,16453,HYDERABAD-INDORE,30792,All
2024,12,HYDERABAD,INDORE,16564,17813,HYDERABAD-INDORE,34377,All
2025,1,HYDERABAD,INDORE,18352,18149,HYDERABAD-INDORE,36501,All
2025,2,HYDERABAD,INDORE,17859,17021,HYDERABAD-INDORE,34880,All
2025,3,HYDERABAD,INDORE,18241,18578,HYDERABAD-INDORE,36819,All
2015,7,HYDERABAD,JABALPUR,1851,1820,HYDERABAD-JABALPUR,3671,All
2015,8,HYDERABAD,JABALPUR,1548,1385,HYDERABAD-JABALPUR,2933,All
2015,9,HYDERABAD,JABALPUR,1699,1666,HYDERABAD-JABALPUR,3365,All
2015,10,HYDERABAD,JABALPUR,1818,1576,HYDERABAD-JABALPUR,3394,All
2015,11,HYDERABAD,JABALPUR,1852,1698,HYDERABAD-JABALPUR,3550,All
2015,12,HYDERABAD,JABALPUR,192,243,HYDERABAD-JABALPUR,435,All
2016,5,HYDERABAD,JABALPUR,385,0,HYDERABAD-JABALPUR,385,All
2016,6,HYDERABAD,JABALPUR,1203,0,HYDERABAD-JABALPUR,1203,All
2016,7,HYDERABAD,JABALPUR,1177,0,HYDERABAD-JABALPUR,1177,All
2016,8,HYDERABAD,JABALPUR,413,474,HYDERABAD-JABALPUR,887,All
2016,9,HYDERABAD,JABALPUR,475,433,HYDERABAD-JABALPUR,908,All
2016,10,HYDERABAD,JABALPUR,1311,0,HYDERABAD-JABALPUR,1311,All
2016,11,HYDERABAD,JABALPUR,976,518,HYDERABAD-JABALPUR,1494,All
2016,12,HYDERABAD,JABALPUR,1132,1180,HYDERABAD-JABALPUR,2312,All
2017,1,HYDERABAD,JABALPUR,2409,2506,HYDERABAD-JABALPUR,4915,All
2017,2,HYDERABAD,JABALPUR,2829,2399,HYDERABAD-JABALPUR,5228,All
2017,3,HYDERABAD,JABALPUR,2556,2522,HYDERABAD-JABALPUR,5078,All
2017,4,HYDERABAD,JABALPUR,2237,2802,HYDERABAD-JABALPUR,5039,All
2017,5,HYDERABAD,JABALPUR,2501,2979,HYDERABAD-JABALPUR,5480,All
2017,6,HYDERABAD,JABALPUR,2478,2981,HYDERABAD-JABALPUR,5459,All
2017,7,HYDERABAD,JABALPUR,2597,3641,HYDERABAD-JABALPUR,6238,All
2017,8,HYDERABAD,JABALPUR,2651,2904,HYDERABAD-JABALPUR,5555,All
2017,9,HYDERABAD,JABALPUR,2858,2979,HYDERABAD-JABALPUR,5837,All
2017,10,HYDERABAD,JABALPUR,2823,2868,HYDERABAD-JABALPUR,5691,All
2017,11,HYDERABAD,JABALPUR,2183,2287,HYDERABAD-JABALPUR,4470,All
2017,12,HYDERABAD,JABALPUR,2293,2379,HYDERABAD-JABALPUR,4672,All
2018,1,HYDERABAD,JABALPUR,2335,2383,HYDERABAD-JABALPUR,4718,All
2018,2,HYDERABAD,JABALPUR,2131,2141,HYDERABAD-JABALPUR,4272,All
2018,3,HYDERABAD,JABALPUR,2265,2344,HYDERABAD-JABALPUR,4609,All
2018,4,HYDERABAD,JABALPUR,2237,2245,HYDERABAD-JABALPUR,4482,All
2018,5,HYDERABAD,JABALPUR,2329,2358,HYDERABAD-JABALPUR,4687,All
2018,6,HYDERABAD,JABALPUR,2154,2176,HYDERABAD-JABALPUR,4330,All
2018,7,HYDERABAD,JABALPUR,2371,2413,HYDERABAD-JABALPUR,4784,All
2018,8,HYDERABAD,JABALPUR,2127,2151,HYDERABAD-JABALPUR,4278,All
2018,9,HYDERABAD,JABALPUR,2202,2123,HYDERABAD-JABALPUR,4325,All
2018,10,HYDERABAD,JABALPUR,2275,2227,HYDERABAD-JABALPUR,4502,All
2018,11,HYDERABAD,JABALPUR,2192,2184,HYDERABAD-JABALPUR,4376,All
2018,12,HYDERABAD,JABALPUR,2282,2309,HYDERABAD-JABALPUR,4591,All
2019,1,HYDERABAD,JABALPUR,3554,3601,HYDERABAD-JABALPUR,7155,All
2019,2,HYDERABAD,JABALPUR,4150,4302,HYDERABAD-JABALPUR,8452,All
2019,3,HYDERABAD,JABALPUR,4874,5089,HYDERABAD-JABALPUR,9963,All
2019,4,HYDERABAD,JABALPUR,4359,4130,HYDERABAD-JABALPUR,8489,All
2019,5,HYDERABAD,JABALPUR,4110,4560,HYDERABAD-JABALPUR,8670,All
2019,6,HYDERABAD,JABALPUR,4443,4542,HYDERABAD-JABALPUR,8985,All
2019,7,HYDERABAD,JABALPUR,2497,2391,HYDERABAD-JABALPUR,4888,All
2019,8,HYDERABAD,JABALPUR,1992,1891,HYDERABAD-JABALPUR,3883,All
2019,9,HYDERABAD,JABALPUR,1880,1556,HYDERABAD-JABALPUR,3436,All
2019,10,HYDERABAD,JABALPUR,2995,2345,HYDERABAD-JABALPUR,5340,All
2019,11,HYDERABAD,JABALPUR,3397,3378,HYDERABAD-JABALPUR,6775,All
2019,12,HYDERABAD,JABALPUR,3502,3594,HYDERABAD-JABALPUR,7096,All
2020,1,HYDERABAD,JABALPUR,3510,3612,HYDERABAD-JABALPUR,7122,All
2020,2,HYDERABAD,JABALPUR,3582,3455,HYDERABAD-JABALPUR,7037,All
2020,3,HYDERABAD,JABALPUR,2918,2343,HYDERABAD-JABALPUR,5261,All
2020,9,HYDERABAD,JABALPUR,233,478,HYDERABAD-JABALPUR,711,All
2020,10,HYDERABAD,JABALPUR,629,944,HYDERABAD-JABALPUR,1573,All
2020,11,HYDERABAD,JABALPUR,954,980,HYDERABAD-JABALPUR,1934,All
2020,12,HYDERABAD,JABALPUR,507,939,HYDERABAD-JABALPUR,1446,All
2021,1,HYDERABAD,JABALPUR,569,1018,HYDERABAD-JABALPUR,1587,All
2021,2,HYDERABAD,JABALPUR,686,893,HYDERABAD-JABALPUR,1579,All
2021,3,HYDERABAD,JABALPUR,750,923,HYDERABAD-JABALPUR,1673,All
2021,4,HYDERABAD,JABALPUR,522,478,HYDERABAD-JABALPUR,1000,All
2021,6,HYDERABAD,JABALPUR,386,404,HYDERABAD-JABALPUR,790,All
2021,7,HYDERABAD,JABALPUR,820,957,HYDERABAD-JABALPUR,1777,All
2021,8,HYDERABAD,JABALPUR,1200,1236,HYDERABAD-JABALPUR,2436,All
2021,9,HYDERABAD,JABALPUR,2093,1982,HYDERABAD-JABALPUR,4075,All
2021,10,HYDERABAD,JABALPUR,3209,2821,HYDERABAD-JABALPUR,6030,All
2021,11,HYDERABAD,JABALPUR,1851,1980,HYDERABAD-JABALPUR,3831,All
2021,12,HYDERABAD,JABALPUR,1773,2140,HYDERABAD-JABALPUR,3913,All
2022,1,HYDERABAD,JABALPUR,1154,1211,HYDERABAD-JABALPUR,2365,All
2022,2,HYDERABAD,JABALPUR,830,889,HYDERABAD-JABALPUR,1719,All
2022,3,HYDERABAD,JABALPUR,1851,2139,HYDERABAD-JABALPUR,3990,All
2022,4,HYDERABAD,JABALPUR,2204,2741,HYDERABAD-JABALPUR,4945,All
2022,5,HYDERABAD,JABALPUR,2559,3313,HYDERABAD-JABALPUR,5872,All
2022,6,HYDERABAD,JABALPUR,1746,1988,HYDERABAD-JABALPUR,3734,All
2022,7,HYDERABAD,JABALPUR,1945,2110,HYDERABAD-JABALPUR,4055,All
2022,8,HYDERABAD,JABALPUR,1971,1982,HYDERABAD-JABALPUR,3953,All
2022,9,HYDERABAD,JABALPUR,2020,2058,HYDERABAD-JABALPUR,4078,All
2022,10,HYDERABAD,JABALPUR,2279,2275,HYDERABAD-JABALPUR,4554,All
2022,11,HYDERABAD,JABALPUR,2149,2176,HYDERABAD-JABALPUR,4325,All
2022,12,HYDERABAD,JABALPUR,2065,2160,HYDERABAD-JABALPUR,4225,All
2023,1,HYDERABAD,JABALPUR,2018,1977,HYDERABAD-JABALPUR,3995,All
2023,2,HYDERABAD,JABALPUR,1958,1876,HYDERABAD-JABALPUR,3834,All
2023,3,HYDERABAD,JABALPUR,2242,2259,HYDERABAD-JABALPUR,4501,All
2023,4,HYDERABAD,JABALPUR,2386,2525,HYDERABAD-JABALPUR,4911,All
2023,5,HYDERABAD,JABALPUR,2717,3088,HYDERABAD-JABALPUR,5805,All
2023,6,HYDERABAD,JABALPUR,2210,2687,HYDERABAD-JABALPUR,4897,All
2023,7,HYDERABAD,JABALPUR,2368,2484,HYDERABAD-JABALPUR,4852,All
2023,8,HYDERABAD,JABALPUR,2175,2131,HYDERABAD-JABALPUR,4306,All
2023,9,HYDERABAD,JABALPUR,2166,2142,HYDERABAD-JABALPUR,4308,All
2023,10,HYDERABAD,JABALPUR,2237,2184,HYDERABAD-JABALPUR,4421,All
2023,11,HYDERABAD,JABALPUR,2130,1941,HYDERABAD-JABALPUR,4071,All
2023,12,HYDERABAD,JABALPUR,2133,2273,HYDERABAD-JABALPUR,4406,All
2024,1,HYDERABAD,JABALPUR,1820,1906,HYDERABAD-JABALPUR,3726,All
2024,2,HYDERABAD,JABALPUR,2116,2089,HYDERABAD-JABALPUR,4205,All
2024,3,HYDERABAD,JABALPUR,2204,2195,HYDERABAD-JABALPUR,4399,All
2024,4,HYDERABAD,JABALPUR,2931,2979,HYDERABAD-JABALPUR,5910,All
2024,6,HYDERABAD,JABALPUR,2029,2121,HYDERABAD-JABALPUR,4150,All
2024,7,HYDERABAD,JABALPUR,2157,2104,HYDERABAD-JABALPUR,4261,All
2024,8,HYDERABAD,JABALPUR,2104,2104,HYDERABAD-JABALPUR,4208,All
2024,9,HYDERABAD,JABALPUR,2075,1944,HYDERABAD-JABALPUR,4019,All
2024,10,HYDERABAD,JABALPUR,2229,1926,HYDERABAD-JABALPUR,4155,All
2024,11,HYDERABAD,JABALPUR,2204,2187,HYDERABAD-JABALPUR,4391,All
2024,12,HYDERABAD,JABALPUR,2313,2271,HYDERABAD-JABALPUR,4584,All
2025,1,HYDERABAD,JABALPUR,2820,2757,HYDERABAD-JABALPUR,5577,All
2025,2,HYDERABAD,JABALPUR,3020,2935,HYDERABAD-JABALPUR,5955,All
2025,3,HYDERABAD,JABALPUR,3294,3077,HYDERABAD-JABALPUR,6371,All
2020,9,HYDERABAD,JAGDALPUR,126,166,HYDERABAD-JAGDALPUR,292,All
2020,10,HYDERABAD,JAGDALPUR,687,705,HYDERABAD-JAGDALPUR,1392,All
2020,11,HYDERABAD,JAGDALPUR,969,992,HYDERABAD-JAGDALPUR,1961,All
2020,12,HYDERABAD,JAGDALPUR,1149,1172,HYDERABAD-JAGDALPUR,2321,All
2021,1,HYDERABAD,JAGDALPUR,1164,1151,HYDERABAD-JAGDALPUR,2315,All
2021,2,HYDERABAD,JAGDALPUR,1050,1060,HYDERABAD-JAGDALPUR,2110,All
2021,3,HYDERABAD,JAGDALPUR,992,869,HYDERABAD-JAGDALPUR,1861,All
2021,4,HYDERABAD,JAGDALPUR,692,584,HYDERABAD-JAGDALPUR,1276,All
2021,6,HYDERABAD,JAGDALPUR,662,755,HYDERABAD-JAGDALPUR,1417,All
2021,7,HYDERABAD,JAGDALPUR,1049,1089,HYDERABAD-JAGDALPUR,2138,All
2021,8,HYDERABAD,JAGDALPUR,1130,1192,HYDERABAD-JAGDALPUR,2322,All
2021,9,HYDERABAD,JAGDALPUR,1013,1063,HYDERABAD-JAGDALPUR,2076,All
2021,10,HYDERABAD,JAGDALPUR,1294,1275,HYDERABAD-JAGDALPUR,2569,All
2021,11,HYDERABAD,JAGDALPUR,1160,1155,HYDERABAD-JAGDALPUR,2315,All
2021,12,HYDERABAD,JAGDALPUR,1216,1254,HYDERABAD-JAGDALPUR,2470,All
2022,1,HYDERABAD,JAGDALPUR,830,743,HYDERABAD-JAGDALPUR,1573,All
2022,2,HYDERABAD,JAGDALPUR,946,985,HYDERABAD-JAGDALPUR,1931,All
2022,3,HYDERABAD,JAGDALPUR,1316,1296,HYDERABAD-JAGDALPUR,2612,All
2022,4,HYDERABAD,JAGDALPUR,1160,1155,HYDERABAD-JAGDALPUR,2315,All
2022,5,HYDERABAD,JAGDALPUR,1216,1254,HYDERABAD-JAGDALPUR,2470,All
2022,6,HYDERABAD,JAGDALPUR,1160,1155,HYDERABAD-JAGDALPUR,2315,All
2022,7,HYDERABAD,JAGDALPUR,946,985,HYDERABAD-JAGDALPUR,1931,All
2022,8,HYDERABAD,JAGDALPUR,1216,1254,HYDERABAD-JAGDALPUR,2470,All
2022,9,HYDERABAD,JAGDALPUR,1160,1155,HYDERABAD-JAGDALPUR,2315,All
2022,10,HYDERABAD,JAGDALPUR,1367,1353,HYDERABAD-JAGDALPUR,2720,All
2022,11,HYDERABAD,JAGDALPUR,1302,1261,HYDERABAD-JAGDALPUR,2563,All
2022,12,HYDERABAD,JAGDALPUR,1430,1260,HYDERABAD-JAGDALPUR,2690,All
2023,1,HYDERABAD,JAGDALPUR,1588,1747,HYDERABAD-JAGDALPUR,3335,All
2023,2,HYDERABAD,JAGDALPUR,1187,1155,HYDERABAD-JAGDALPUR,2342,All
2023,3,HYDERABAD,JAGDALPUR,1286,1159,HYDERABAD-JAGDALPUR,2445,All
2023,4,HYDERABAD,JAGDALPUR,1611,1319,HYDERABAD-JAGDALPUR,2930,All
2023,5,HYDERABAD,JAGDALPUR,1623,1666,HYDERABAD-JAGDALPUR,3289,All
2023,6,HYDERABAD,JAGDALPUR,1541,1578,HYDERABAD-JAGDALPUR,3119,All
2023,7,HYDERABAD,JAGDALPUR,939,1009,HYDERABAD-JAGDALPUR,1948,All
2023,8,HYDERABAD,JAGDALPUR,1452,1286,HYDERABAD-JAGDALPUR,2738,All
2023,9,HYDERABAD,JAGDALPUR,1102,1200,HYDERABAD-JAGDALPUR,2302,All
2023,10,HYDERABAD,JAGDALPUR,1530,1268,HYDERABAD-JAGDALPUR,2798,All
2023,11,HYDERABAD,JAGDALPUR,1038,1040,HYDERABAD-JAGDALPUR,2078,All
2023,12,HYDERABAD,JAGDALPUR,1121,1220,HYDERABAD-JAGDALPUR,2341,All
2024,1,HYDERABAD,JAGDALPUR,1232,1259,HYDERABAD-JAGDALPUR,2491,All
2024,2,HYDERABAD,JAGDALPUR,1250,1261,HYDERABAD-JAGDALPUR,2511,All
2024,3,HYDERABAD,JAGDALPUR,1523,1365,HYDERABAD-JAGDALPUR,2888,All
2024,4,HYDERABAD,JAGDALPUR,2156,1909,HYDERABAD-JAGDALPUR,4065,All
2024,6,HYDERABAD,JAGDALPUR,1870,1760,HYDERABAD-JAGDALPUR,3630,All
2024,7,HYDERABAD,JAGDALPUR,1771,1740,HYDERABAD-JAGDALPUR,3511,All
2024,8,HYDERABAD,JAGDALPUR,1900,1826,HYDERABAD-JAGDALPUR,3726,All
2024,9,HYDERABAD,JAGDALPUR,1949,1680,HYDERABAD-JAGDALPUR,3629,All
2024,10,HYDERABAD,JAGDALPUR,2058,1717,HYDERABAD-JAGDALPUR,3775,All
2024,11,HYDERABAD,JAGDALPUR,1565,1648,HYDERABAD-JAGDALPUR,3213,All
2024,12,HYDERABAD,JAGDALPUR,1617,1595,HYDERABAD-JAGDALPUR,3212,All
2025,1,HYDERABAD,JAGDALPUR,1591,1518,HYDERABAD-JAGDALPUR,3109,All
2025,2,HYDERABAD,JAGDALPUR,1442,1493,HYDERABAD-JAGDALPUR,2935,All
2025,3,HYDERABAD,JAGDALPUR,1683,1513,HYDERABAD-JAGDALPUR,3196,All
2015,4,HYDERABAD,JAIPUR,3733,3583,HYDERABAD-JAIPUR,7316,All
2015,5,HYDERABAD,JAIPUR,3422,4307,HYDERABAD-JAIPUR,7729,All
2015,6,HYDERABAD,JAIPUR,3838,4851,HYDERABAD-JAIPUR,8689,All
2015,7,HYDERABAD,JAIPUR,4555,5019,HYDERABAD-JAIPUR,9574,All
2015,8,HYDERABAD,JAIPUR,4270,4414,HYDERABAD-JAIPUR,8684,All
2015,9,HYDERABAD,JAIPUR,4649,4768,HYDERABAD-JAIPUR,9417,All
2015,10,HYDERABAD,JAIPUR,4162,4745,HYDERABAD-JAIPUR,8907,All
2015,11,HYDERABAD,JAIPUR,3838,3643,HYDERABAD-JAIPUR,7481,All
2015,12,HYDERABAD,JAIPUR,4368,4972,HYDERABAD-JAIPUR,9340,All
2016,1,HYDERABAD,JAIPUR,4585,4638,HYDERABAD-JAIPUR,9223,All
2016,2,HYDERABAD,JAIPUR,4333,4562,HYDERABAD-JAIPUR,8895,All
2016,3,HYDERABAD,JAIPUR,6805,6901,HYDERABAD-JAIPUR,13706,All
2016,4,HYDERABAD,JAIPUR,10157,9757,HYDERABAD-JAIPUR,19914,All
2016,5,HYDERABAD,JAIPUR,9490,11437,HYDERABAD-JAIPUR,20927,All
2016,6,HYDERABAD,JAIPUR,8039,9412,HYDERABAD-JAIPUR,17451,All
2016,7,HYDERABAD,JAIPUR,9642,10234,HYDERABAD-JAIPUR,19876,All
2016,8,HYDERABAD,JAIPUR,8579,8708,HYDERABAD-JAIPUR,17287,All
2016,9,HYDERABAD,JAIPUR,7595,6785,HYDERABAD-JAIPUR,14380,All
2016,10,HYDERABAD,JAIPUR,10096,9174,HYDERABAD-JAIPUR,19270,All
2016,11,HYDERABAD,JAIPUR,11054,10605,HYDERABAD-JAIPUR,21659,All
2016,12,HYDERABAD,JAIPUR,6908,8199,HYDERABAD-JAIPUR,15107,All
2017,1,HYDERABAD,JAIPUR,7521,7576,HYDERABAD-JAIPUR,15097,All
2017,2,HYDERABAD,JAIPUR,12719,13089,HYDERABAD-JAIPUR,25808,All
2017,3,HYDERABAD,JAIPUR,11821,11944,HYDERABAD-JAIPUR,23765,All
2017,4,HYDERABAD,JAIPUR,9770,9775,HYDERABAD-JAIPUR,19545,All
2017,5,HYDERABAD,JAIPUR,5073,5347,HYDERABAD-JAIPUR,10420,All
2017,6,HYDERABAD,JAIPUR,4837,5716,HYDERABAD-JAIPUR,10553,All
2017,7,HYDERABAD,JAIPUR,10936,12720,HYDERABAD-JAIPUR,23656,All
2017,8,HYDERABAD,JAIPUR,11768,12462,HYDERABAD-JAIPUR,24230,All
2017,9,HYDERABAD,JAIPUR,15868,15675,HYDERABAD-JAIPUR,31543,All
2017,10,HYDERABAD,JAIPUR,15811,16749,HYDERABAD-JAIPUR,32560,All
2017,11,HYDERABAD,JAIPUR,15476,16226,HYDERABAD-JAIPUR,31702,All
2017,12,HYDERABAD,JAIPUR,15342,17307,HYDERABAD-JAIPUR,32649,All
2018,1,HYDERABAD,JAIPUR,19781,20178,HYDERABAD-JAIPUR,39959,All
2018,2,HYDERABAD,JAIPUR,18758,19537,HYDERABAD-JAIPUR,38295,All
2018,3,HYDERABAD,JAIPUR,19261,19875,HYDERABAD-JAIPUR,39136,All
2018,4,HYDERABAD,JAIPUR,20569,21638,HYDERABAD-JAIPUR,42207,All
2018,5,HYDERABAD,JAIPUR,16620,22050,HYDERABAD-JAIPUR,38670,All
2018,6,HYDERABAD,JAIPUR,16989,19263,HYDERABAD-JAIPUR,36252,All
2018,7,HYDERABAD,JAIPUR,17958,20703,HYDERABAD-JAIPUR,38661,All
2018,8,HYDERABAD,JAIPUR,18357,18593,HYDERABAD-JAIPUR,36950,All
2018,9,HYDERABAD,JAIPUR,21283,21575,HYDERABAD-JAIPUR,42858,All
2018,10,HYDERABAD,JAIPUR,22711,21871,HYDERABAD-JAIPUR,44582,All
2018,11,HYDERABAD,JAIPUR,23691,23224,HYDERABAD-JAIPUR,46915,All
2018,12,HYDERABAD,JAIPUR,23828,25256,HYDERABAD-JAIPUR,49084,All
2019,1,HYDERABAD,JAIPUR,24374,24584,HYDERABAD-JAIPUR,48958,All
2019,2,HYDERABAD,JAIPUR,20164,22260,HYDERABAD-JAIPUR,42424,All
2019,3,HYDERABAD,JAIPUR,23114,25014,HYDERABAD-JAIPUR,48128,All
2019,4,HYDERABAD,JAIPUR,23044,22684,HYDERABAD-JAIPUR,45728,All
2019,5,HYDERABAD,JAIPUR,21704,25698,HYDERABAD-JAIPUR,47402,All
2019,6,HYDERABAD,JAIPUR,23158,23843,HYDERABAD-JAIPUR,47001,All
2019,7,HYDERABAD,JAIPUR,23182,23490,HYDERABAD-JAIPUR,46672,All
2019,8,HYDERABAD,JAIPUR,23959,22404,HYDERABAD-JAIPUR,46363,All
2019,9,HYDERABAD,JAIPUR,28267,26089,HYDERABAD-JAIPUR,54356,All
2019,10,HYDERABAD,JAIPUR,28550,26053,HYDERABAD-JAIPUR,54603,All
2019,11,HYDERABAD,JAIPUR,28282,28536,HYDERABAD-JAIPUR,56818,All
2019,12,HYDERABAD,JAIPUR,26714,28798,HYDERABAD-JAIPUR,55512,All
2020,1,HYDERABAD,JAIPUR,26963,23763,HYDERABAD-JAIPUR,50726,All
2020,2,HYDERABAD,JAIPUR,28601,25739,HYDERABAD-JAIPUR,54340,All
2020,3,HYDERABAD,JAIPUR,17939,17402,HYDERABAD-JAIPUR,35341,All
2020,5,HYDERABAD,JAIPUR,1009,573,HYDERABAD-JAIPUR,1582,All
2020,6,HYDERABAD,JAIPUR,10305,8078,HYDERABAD-JAIPUR,18383,All
2020,7,HYDERABAD,JAIPUR,10630,8581,HYDERABAD-JAIPUR,19211,All
2020,8,HYDERABAD,JAIPUR,9792,12155,HYDERABAD-JAIPUR,21947,All
2020,9,HYDERABAD,JAIPUR,8483,10640,HYDERABAD-JAIPUR,19123,All
2020,10,HYDERABAD,JAIPUR,9543,10349,HYDERABAD-JAIPUR,19892,All
2020,11,HYDERABAD,JAIPUR,16351,10918,HYDERABAD-JAIPUR,27269,All
2020,12,HYDERABAD,JAIPUR,17366,17875,HYDERABAD-JAIPUR,35241,All
2021,1,HYDERABAD,JAIPUR,15113,13601,HYDERABAD-JAIPUR,28714,All
2021,2,HYDERABAD,JAIPUR,18784,16082,HYDERABAD-JAIPUR,34866,All
2021,3,HYDERABAD,JAIPUR,17086,14274,HYDERABAD-JAIPUR,31360,All
2021,4,HYDERABAD,JAIPUR,16073,9465,HYDERABAD-JAIPUR,25538,All
2021,6,HYDERABAD,JAIPUR,3691,4271,HYDERABAD-JAIPUR,7962,All
2021,7,HYDERABAD,JAIPUR,8118,7844,HYDERABAD-JAIPUR,15962,All
2021,8,HYDERABAD,JAIPUR,13020,11662,HYDERABAD-JAIPUR,24682,All
2021,9,HYDERABAD,JAIPUR,13527,12154,HYDERABAD-JAIPUR,25681,All
2021,10,HYDERABAD,JAIPUR,18050,14356,HYDERABAD-JAIPUR,32406,All
2021,11,HYDERABAD,JAIPUR,16322,14682,HYDERABAD-JAIPUR,31004,All
2021,12,HYDERABAD,JAIPUR,18420,19853,HYDERABAD-JAIPUR,38273,All
2022,1,HYDERABAD,JAIPUR,10036,9382,HYDERABAD-JAIPUR,19418,All
2022,2,HYDERABAD,JAIPUR,13557,12761,HYDERABAD-JAIPUR,26318,All
2022,3,HYDERABAD,JAIPUR,16912,15587,HYDERABAD-JAIPUR,32499,All
2022,4,HYDERABAD,JAIPUR,17908,14883,HYDERABAD-JAIPUR,32791,All
2022,5,HYDERABAD,JAIPUR,14730,15794,HYDERABAD-JAIPUR,30524,All
2022,6,HYDERABAD,JAIPUR,12680,14117,HYDERABAD-JAIPUR,26797,All
2022,7,HYDERABAD,JAIPUR,14725,13600,HYDERABAD-JAIPUR,28325,All
2022,8,HYDERABAD,JAIPUR,16949,15528,HYDERABAD-JAIPUR,32477,All
2022,9,HYDERABAD,JAIPUR,16078,13470,HYDERABAD-JAIPUR,29548,All
2022,10,HYDERABAD,JAIPUR,20434,18205,HYDERABAD-JAIPUR,38639,All
2022,11,HYDERABAD,JAIPUR,17298,17407,HYDERABAD-JAIPUR,34705,All
2022,12,HYDERABAD,JAIPUR,19682,20408,HYDERABAD-JAIPUR,40090,All
2023,1,HYDERABAD,JAIPUR,19801,18129,HYDERABAD-JAIPUR,37930,All
2023,2,HYDERABAD,JAIPUR,19464,18253,HYDERABAD-JAIPUR,37717,All
2023,3,HYDERABAD,JAIPUR,21046,20569,HYDERABAD-JAIPUR,41615,All
2023,4,HYDERABAD,JAIPUR,20695,17298,HYDERABAD-JAIPUR,37993,All
2023,5,HYDERABAD,JAIPUR,21176,21401,HYDERABAD-JAIPUR,42577,All
2023,6,HYDERABAD,JAIPUR,23385,24656,HYDERABAD-JAIPUR,48041,All
2023,7,HYDERABAD,JAIPUR,22513,22121,HYDERABAD-JAIPUR,44634,All
2023,8,HYDERABAD,JAIPUR,23974,21365,HYDERABAD-JAIPUR,45339,All
2023,9,HYDERABAD,JAIPUR,23990,22830,HYDERABAD-JAIPUR,46820,All
2023,10,HYDERABAD,JAIPUR,25227,22889,HYDERABAD-JAIPUR,48116,All
2023,11,HYDERABAD,JAIPUR,26126,22189,HYDERABAD-JAIPUR,48315,All
2023,12,HYDERABAD,JAIPUR,25394,26700,HYDERABAD-JAIPUR,52094,All
2024,1,HYDERABAD,JAIPUR,24655,23001,HYDERABAD-JAIPUR,47656,All
2024,2,HYDERABAD,JAIPUR,25429,23739,HYDERABAD-JAIPUR,49168,All
2024,3,HYDERABAD,JAIPUR,26521,24668,HYDERABAD-JAIPUR,51189,All
2024,4,HYDERABAD,JAIPUR,25434,23304,HYDERABAD-JAIPUR,48738,All
2024,6,HYDERABAD,JAIPUR,21439,21213,HYDERABAD-JAIPUR,42652,All
2024,7,HYDERABAD,JAIPUR,22672,22308,HYDERABAD-JAIPUR,44980,All
2024,8,HYDERABAD,JAIPUR,24372,22805,HYDERABAD-JAIPUR,47177,All
2024,9,HYDERABAD,JAIPUR,22938,21227,HYDERABAD-JAIPUR,44165,All
2024,10,HYDERABAD,JAIPUR,28438,23002,HYDERABAD-JAIPUR,51440,All
2024,11,HYDERABAD,JAIPUR,25156,25208,HYDERABAD-JAIPUR,50364,All
2024,12,HYDERABAD,JAIPUR,25646,26242,HYDERABAD-JAIPUR,51888,All
2025,1,HYDERABAD,JAIPUR,23573,21562,HYDERABAD-JAIPUR,45135,All
2025,2,HYDERABAD,JAIPUR,25570,23559,HYDERABAD-JAIPUR,49129,All
2025,3,HYDERABAD,JAIPUR,21664,20866,HYDERABAD-JAIPUR,42530,All
2018,10,HYDERABAD,JAISALMER,21,0,HYDERABAD-JAISALMER,21,All
2018,11,HYDERABAD,JAISALMER,53,0,HYDERABAD-JAISALMER,53,All
2018,12,HYDERABAD,JAISALMER,38,0,HYDERABAD-JAISALMER,38,All
2019,1,HYDERABAD,JAISALMER,119,0,HYDERABAD-JAISALMER,119,All
2019,2,HYDERABAD,JAISALMER,109,0,HYDERABAD-JAISALMER,109,All
2019,3,HYDERABAD,JAISALMER,41,0,HYDERABAD-JAISALMER,41,All
2024,4,HYDERABAD,JALGAON,232,245,HYDERABAD-JALGAON,477,All
2024,6,HYDERABAD,JALGAON,542,625,HYDERABAD-JALGAON,1167,All
2024,7,HYDERABAD,JALGAON,775,791,HYDERABAD-JALGAON,1566,All
2024,8,HYDERABAD,JALGAON,898,983,HYDERABAD-JALGAON,1881,All
2024,9,HYDERABAD,JALGAON,868,978,HYDERABAD-JALGAON,1846,All
2024,10,HYDERABAD,JALGAON,1206,1001,HYDERABAD-JALGAON,2207,All
2024,11,HYDERABAD,JALGAON,1313,1368,HYDERABAD-JALGAON,2681,All
2024,12,HYDERABAD,JALGAON,1302,1342,HYDERABAD-JALGAON,2644,All
2025,1,HYDERABAD,JALGAON,809,924,HYDERABAD-JALGAON,1733,All
2025,2,HYDERABAD,JALGAON,428,399,HYDERABAD-JALGAON,827,All
2025,3,HYDERABAD,JALGAON,570,669,HYDERABAD-JALGAON,1239,All
2018,1,HYDERABAD,JAMMU,633,744,HYDERABAD-JAMMU,1377,All
2018,2,HYDERABAD,JAMMU,820,765,HYDERABAD-JAMMU,1585,All
2018,4,HYDERABAD,JAMMU,1522,469,HYDERABAD-JAMMU,1991,All
2018,5,HYDERABAD,JAMMU,1867,787,HYDERABAD-JAMMU,2654,All
2018,6,HYDERABAD,JAMMU,1463,682,HYDERABAD-JAMMU,2145,All
2018,7,HYDERABAD,JAMMU,1235,661,HYDERABAD-JAMMU,1896,All
2018,8,HYDERABAD,JAMMU,489,170,HYDERABAD-JAMMU,659,All
2019,5,HYDERABAD,JAMMU,0,2,HYDERABAD-JAMMU,2,All
2021,8,HYDERABAD,JAMMU,150,0,HYDERABAD-JAMMU,150,All
2021,9,HYDERABAD,JAMMU,492,0,HYDERABAD-JAMMU,492,All
2021,10,HYDERABAD,JAMMU,778,3,HYDERABAD-JAMMU,781,All
2021,11,HYDERABAD,JAMMU,284,285,HYDERABAD-JAMMU,569,All
2021,12,HYDERABAD,JAMMU,260,207,HYDERABAD-JAMMU,467,All
2022,3,HYDERABAD,JAMMU,50,0,HYDERABAD-JAMMU,50,All
2022,4,HYDERABAD,JAMMU,972,0,HYDERABAD-JAMMU,972,All
2022,5,HYDERABAD,JAMMU,1143,0,HYDERABAD-JAMMU,1143,All
2022,6,HYDERABAD,JAMMU,965,0,HYDERABAD-JAMMU,965,All
2022,7,HYDERABAD,JAMMU,472,0,HYDERABAD-JAMMU,472,All
2022,8,HYDERABAD,JAMMU,162,0,HYDERABAD-JAMMU,162,All
2022,9,HYDERABAD,JAMMU,206,0,HYDERABAD-JAMMU,206,All
2022,10,HYDERABAD,JAMMU,484,5,HYDERABAD-JAMMU,489,All
2022,11,HYDERABAD,JAMMU,374,478,HYDERABAD-JAMMU,852,All
2022,12,HYDERABAD,JAMMU,375,342,HYDERABAD-JAMMU,717,All
2023,1,HYDERABAD,JAMMU,19,0,HYDERABAD-JAMMU,19,All
2023,3,HYDERABAD,JAMMU,140,0,HYDERABAD-JAMMU,140,All
2023,4,HYDERABAD,JAMMU,657,0,HYDERABAD-JAMMU,657,All
2023,5,HYDERABAD,JAMMU,552,0,HYDERABAD-JAMMU,552,All
2023,6,HYDERABAD,JAMMU,452,0,HYDERABAD-JAMMU,452,All
2023,7,HYDERABAD,JAMMU,143,0,HYDERABAD-JAMMU,143,All
2023,8,HYDERABAD,JAMMU,63,0,HYDERABAD-JAMMU,63,All
2023,9,HYDERABAD,JAMMU,66,0,HYDERABAD-JAMMU,66,All
2023,10,HYDERABAD,JAMMU,406,42,HYDERABAD-JAMMU,448,All
2023,11,HYDERABAD,JAMMU,481,211,HYDERABAD-JAMMU,692,All
2023,12,HYDERABAD,JAMMU,313,95,HYDERABAD-JAMMU,408,All
2024,1,HYDERABAD,JAMMU,380,0,HYDERABAD-JAMMU,380,All
2024,2,HYDERABAD,JAMMU,338,0,HYDERABAD-JAMMU,338,All
2024,3,HYDERABAD,JAMMU,319,1,HYDERABAD-JAMMU,320,All
2024,4,HYDERABAD,JAMMU,879,109,HYDERABAD-JAMMU,988,All
2024,6,HYDERABAD,JAMMU,433,0,HYDERABAD-JAMMU,433,All
2024,7,HYDERABAD,JAMMU,192,0,HYDERABAD-JAMMU,192,All
2024,8,HYDERABAD,JAMMU,88,0,HYDERABAD-JAMMU,88,All
2024,9,HYDERABAD,JAMMU,387,346,HYDERABAD-JAMMU,733,All
2024,10,HYDERABAD,JAMMU,2119,1810,HYDERABAD-JAMMU,3929,All
2024,11,HYDERABAD,JAMMU,2356,2422,HYDERABAD-JAMMU,4778,All
2024,12,HYDERABAD,JAMMU,2599,2716,HYDERABAD-JAMMU,5315,All
2025,1,HYDERABAD,JAMMU,2416,2328,HYDERABAD-JAMMU,4744,All
2025,2,HYDERABAD,JAMMU,2379,2011,HYDERABAD-JAMMU,4390,All
2025,3,HYDERABAD,JAMMU,2341,2058,HYDERABAD-JAMMU,4399,All
2021,8,HYDERABAD,JAMNAGAR,78,121,HYDERABAD-JAMNAGAR,199,All
2021,9,HYDERABAD,JAMNAGAR,456,369,HYDERABAD-JAMNAGAR,825,All
2021,10,HYDERABAD,JAMNAGAR,489,371,HYDERABAD-JAMNAGAR,860,All
2021,11,HYDERABAD,JAMNAGAR,559,454,HYDERABAD-JAMNAGAR,1013,All
2021,12,HYDERABAD,JAMNAGAR,552,540,HYDERABAD-JAMNAGAR,1092,All
2022,1,HYDERABAD,JAMNAGAR,404,391,HYDERABAD-JAMNAGAR,795,All
2022,2,HYDERABAD,JAMNAGAR,446,376,HYDERABAD-JAMNAGAR,822,All
2022,3,HYDERABAD,JAMNAGAR,587,512,HYDERABAD-JAMNAGAR,1099,All
2022,4,HYDERABAD,JAMNAGAR,595,569,HYDERABAD-JAMNAGAR,1164,All
2022,5,HYDERABAD,JAMNAGAR,592,489,HYDERABAD-JAMNAGAR,1081,All
2022,6,HYDERABAD,JAMNAGAR,569,555,HYDERABAD-JAMNAGAR,1124,All
2022,7,HYDERABAD,JAMNAGAR,457,436,HYDERABAD-JAMNAGAR,893,All
2022,8,HYDERABAD,JAMNAGAR,519,464,HYDERABAD-JAMNAGAR,983,All
2022,9,HYDERABAD,JAMNAGAR,367,421,HYDERABAD-JAMNAGAR,788,All
2022,10,HYDERABAD,JAMNAGAR,472,488,HYDERABAD-JAMNAGAR,960,All
2022,11,HYDERABAD,JAMNAGAR,474,417,HYDERABAD-JAMNAGAR,891,All
2022,12,HYDERABAD,JAMNAGAR,507,436,HYDERABAD-JAMNAGAR,943,All
2023,1,HYDERABAD,JAMNAGAR,493,298,HYDERABAD-JAMNAGAR,791,All
2023,2,HYDERABAD,JAMNAGAR,364,345,HYDERABAD-JAMNAGAR,709,All
2023,3,HYDERABAD,JAMNAGAR,554,549,HYDERABAD-JAMNAGAR,1103,All
2023,4,HYDERABAD,JAMNAGAR,542,509,HYDERABAD-JAMNAGAR,1051,All
2023,5,HYDERABAD,JAMNAGAR,725,850,HYDERABAD-JAMNAGAR,1575,All
2023,6,HYDERABAD,JAMNAGAR,805,718,HYDERABAD-JAMNAGAR,1523,All
2023,7,HYDERABAD,JAMNAGAR,1156,920,HYDERABAD-JAMNAGAR,2076,All
2023,8,HYDERABAD,JAMNAGAR,1230,1329,HYDERABAD-JAMNAGAR,2559,All
2023,9,HYDERABAD,JAMNAGAR,1120,1225,HYDERABAD-JAMNAGAR,2345,All
2023,10,HYDERABAD,JAMNAGAR,1345,1210,HYDERABAD-JAMNAGAR,2555,All
2023,11,HYDERABAD,JAMNAGAR,1310,1259,HYDERABAD-JAMNAGAR,2569,All
2023,12,HYDERABAD,JAMNAGAR,1256,1176,HYDERABAD-JAMNAGAR,2432,All
2024,1,HYDERABAD,JAMNAGAR,1135,1080,HYDERABAD-JAMNAGAR,2215,All
2024,2,HYDERABAD,JAMNAGAR,1222,1115,HYDERABAD-JAMNAGAR,2337,All
2024,3,HYDERABAD,JAMNAGAR,961,1016,HYDERABAD-JAMNAGAR,1977,All
2024,4,HYDERABAD,JAMNAGAR,1176,1010,HYDERABAD-JAMNAGAR,2186,All
2024,6,HYDERABAD,JAMNAGAR,1237,1257,HYDERABAD-JAMNAGAR,2494,All
2024,7,HYDERABAD,JAMNAGAR,1132,1126,HYDERABAD-JAMNAGAR,2258,All
2024,8,HYDERABAD,JAMNAGAR,1249,1264,HYDERABAD-JAMNAGAR,2513,All
2024,9,HYDERABAD,JAMNAGAR,950,862,HYDERABAD-JAMNAGAR,1812,All
2024,10,HYDERABAD,JAMNAGAR,1055,1115,HYDERABAD-JAMNAGAR,2170,All
2024,11,HYDERABAD,JAMNAGAR,552,446,HYDERABAD-JAMNAGAR,998,All
2019,5,HYDERABAD,JHARSUGUDA,2125,2145,HYDERABAD-JHARSUGUDA,4270,All
2019,6,HYDERABAD,JHARSUGUDA,2034,2078,HYDERABAD-JHARSUGUDA,4112,All
2019,7,HYDERABAD,JHARSUGUDA,1789,1911,HYDERABAD-JHARSUGUDA,3700,All
2019,8,HYDERABAD,JHARSUGUDA,2004,2050,HYDERABAD-JHARSUGUDA,4054,All
2019,9,HYDERABAD,JHARSUGUDA,1950,1877,HYDERABAD-JHARSUGUDA,3827,All
2019,10,HYDERABAD,JHARSUGUDA,2234,2136,HYDERABAD-JHARSUGUDA,4370,All
2019,11,HYDERABAD,JHARSUGUDA,2012,2153,HYDERABAD-JHARSUGUDA,4165,All
2019,12,HYDERABAD,JHARSUGUDA,2195,2369,HYDERABAD-JHARSUGUDA,4564,All
2020,1,HYDERABAD,JHARSUGUDA,2137,2175,HYDERABAD-JHARSUGUDA,4312,All
2020,2,HYDERABAD,JHARSUGUDA,1923,2045,HYDERABAD-JHARSUGUDA,3968,All
2020,3,HYDERABAD,JHARSUGUDA,1701,1358,HYDERABAD-JHARSUGUDA,3059,All
2020,5,HYDERABAD,JHARSUGUDA,135,67,HYDERABAD-JHARSUGUDA,202,All
2020,6,HYDERABAD,JHARSUGUDA,427,216,HYDERABAD-JHARSUGUDA,643,All
2020,7,HYDERABAD,JHARSUGUDA,941,422,HYDERABAD-JHARSUGUDA,1363,All
2020,8,HYDERABAD,JHARSUGUDA,847,778,HYDERABAD-JHARSUGUDA,1625,All
2020,9,HYDERABAD,JHARSUGUDA,994,1149,HYDERABAD-JHARSUGUDA,2143,All
2020,10,HYDERABAD,JHARSUGUDA,1343,1353,HYDERABAD-JHARSUGUDA,2696,All
2020,11,HYDERABAD,JHARSUGUDA,1707,1684,HYDERABAD-JHARSUGUDA,3391,All
2020,12,HYDERABAD,JHARSUGUDA,2327,2291,HYDERABAD-JHARSUGUDA,4618,All
2021,1,HYDERABAD,JHARSUGUDA,2129,2140,HYDERABAD-JHARSUGUDA,4269,All
2021,2,HYDERABAD,JHARSUGUDA,2010,2000,HYDERABAD-JHARSUGUDA,4010,All
2021,3,HYDERABAD,JHARSUGUDA,1958,1815,HYDERABAD-JHARSUGUDA,3773,All
2021,4,HYDERABAD,JHARSUGUDA,1580,1400,HYDERABAD-JHARSUGUDA,2980,All
2021,6,HYDERABAD,JHARSUGUDA,940,1006,HYDERABAD-JHARSUGUDA,1946,All
2021,7,HYDERABAD,JHARSUGUDA,1730,1801,HYDERABAD-JHARSUGUDA,3531,All
2021,8,HYDERABAD,JHARSUGUDA,1943,2143,HYDERABAD-JHARSUGUDA,4086,All
2021,9,HYDERABAD,JHARSUGUDA,1872,1794,HYDERABAD-JHARSUGUDA,3666,All
2021,10,HYDERABAD,JHARSUGUDA,2370,2166,HYDERABAD-JHARSUGUDA,4536,All
2021,11,HYDERABAD,JHARSUGUDA,2240,2012,HYDERABAD-JHARSUGUDA,4252,All
2021,12,HYDERABAD,JHARSUGUDA,2269,2297,HYDERABAD-JHARSUGUDA,4566,All
2022,1,HYDERABAD,JHARSUGUDA,1581,1264,HYDERABAD-JHARSUGUDA,2845,All
2022,2,HYDERABAD,JHARSUGUDA,1787,1817,HYDERABAD-JHARSUGUDA,3604,All
2022,3,HYDERABAD,JHARSUGUDA,2144,2120,HYDERABAD-JHARSUGUDA,4264,All
2022,4,HYDERABAD,JHARSUGUDA,2236,1850,HYDERABAD-JHARSUGUDA,4086,All
2022,5,HYDERABAD,JHARSUGUDA,2412,2237,HYDERABAD-JHARSUGUDA,4649,All
2022,6,HYDERABAD,JHARSUGUDA,1717,1751,HYDERABAD-JHARSUGUDA,3468,All
2022,7,HYDERABAD,JHARSUGUDA,507,494,HYDERABAD-JHARSUGUDA,1001,All
2022,8,HYDERABAD,JHARSUGUDA,235,234,HYDERABAD-JHARSUGUDA,469,All
2023,1,HYDERABAD,JHARSUGUDA,868,956,HYDERABAD-JHARSUGUDA,1824,All
2023,2,HYDERABAD,JHARSUGUDA,1992,2065,HYDERABAD-JHARSUGUDA,4057,All
2023,3,HYDERABAD,JHARSUGUDA,2223,2196,HYDERABAD-JHARSUGUDA,4419,All
2023,4,HYDERABAD,JHARSUGUDA,2568,2228,HYDERABAD-JHARSUGUDA,4796,All
2023,5,HYDERABAD,JHARSUGUDA,2621,2600,HYDERABAD-JHARSUGUDA,5221,All
2023,6,HYDERABAD,JHARSUGUDA,2492,2293,HYDERABAD-JHARSUGUDA,4785,All
2023,7,HYDERABAD,JHARSUGUDA,1954,2008,HYDERABAD-JHARSUGUDA,3962,All
2023,8,HYDERABAD,JHARSUGUDA,1537,1506,HYDERABAD-JHARSUGUDA,3043,All
2023,9,HYDERABAD,JHARSUGUDA,1784,1829,HYDERABAD-JHARSUGUDA,3613,All
2023,10,HYDERABAD,JHARSUGUDA,1854,1675,HYDERABAD-JHARSUGUDA,3529,All
2025,1,HYDERABAD,JHARSUGUDA,2108,2231,HYDERABAD-JHARSUGUDA,4339,All
2025,2,HYDERABAD,JHARSUGUDA,2004,1972,HYDERABAD-JHARSUGUDA,3976,All
2025,3,HYDERABAD,JHARSUGUDA,2121,2121,HYDERABAD-JHARSUGUDA,4242,All
2021,10,HYDERABAD,JODHPUR,4678,4384,HYDERABAD-JODHPUR,9062,All
2021,11,HYDERABAD,JODHPUR,5243,4652,HYDERABAD-JODHPUR,9895,All
2021,12,HYDERABAD,JODHPUR,4297,4596,HYDERABAD-JODHPUR,8893,All
2022,1,HYDERABAD,JODHPUR,3049,3260,HYDERABAD-JODHPUR,6309,All
2022,2,HYDERABAD,JODHPUR,2719,2588,HYDERABAD-JODHPUR,5307,All
2022,3,HYDERABAD,JODHPUR,4568,4418,HYDERABAD-JODHPUR,8986,All
2022,4,HYDERABAD,JODHPUR,1965,1900,HYDERABAD-JODHPUR,3865,All
2022,5,HYDERABAD,JODHPUR,1873,2024,HYDERABAD-JODHPUR,3897,All
2022,6,HYDERABAD,JODHPUR,1838,1837,HYDERABAD-JODHPUR,3675,All
2022,7,HYDERABAD,JODHPUR,1708,1606,HYDERABAD-JODHPUR,3314,All
2022,8,HYDERABAD,JODHPUR,1975,1763,HYDERABAD-JODHPUR,3738,All
2022,9,HYDERABAD,JODHPUR,1657,1537,HYDERABAD-JODHPUR,3194,All
2022,10,HYDERABAD,JODHPUR,2327,2407,HYDERABAD-JODHPUR,4734,All
2022,11,HYDERABAD,JODHPUR,4380,4475,HYDERABAD-JODHPUR,8855,All
2022,12,HYDERABAD,JODHPUR,3841,4266,HYDERABAD-JODHPUR,8107,All
2023,1,HYDERABAD,JODHPUR,4161,4240,HYDERABAD-JODHPUR,8401,All
2023,2,HYDERABAD,JODHPUR,4227,4243,HYDERABAD-JODHPUR,8470,All
2023,3,HYDERABAD,JODHPUR,4017,4290,HYDERABAD-JODHPUR,8307,All
2023,4,HYDERABAD,JODHPUR,5361,5220,HYDERABAD-JODHPUR,10581,All
2023,5,HYDERABAD,JODHPUR,3789,4010,HYDERABAD-JODHPUR,7799,All
2023,6,HYDERABAD,JODHPUR,3746,4003,HYDERABAD-JODHPUR,7749,All
2023,7,HYDERABAD,JODHPUR,3346,3309,HYDERABAD-JODHPUR,6655,All
2023,8,HYDERABAD,JODHPUR,3324,3181,HYDERABAD-JODHPUR,6505,All
2023,9,HYDERABAD,JODHPUR,5957,5703,HYDERABAD-JODHPUR,11660,All
2023,10,HYDERABAD,JODHPUR,6121,5891,HYDERABAD-JODHPUR,12012,All
2023,11,HYDERABAD,JODHPUR,4932,4682,HYDERABAD-JODHPUR,9614,All
2023,12,HYDERABAD,JODHPUR,5026,5095,HYDERABAD-JODHPUR,10121,All
2024,1,HYDERABAD,JODHPUR,5031,4989,HYDERABAD-JODHPUR,10020,All
2024,2,HYDERABAD,JODHPUR,4695,4716,HYDERABAD-JODHPUR,9411,All
2024,3,HYDERABAD,JODHPUR,4975,4970,HYDERABAD-JODHPUR,9945,All
2024,4,HYDERABAD,JODHPUR,3658,3251,HYDERABAD-JODHPUR,6909,All
2024,6,HYDERABAD,JODHPUR,3552,3367,HYDERABAD-JODHPUR,6919,All
2024,7,HYDERABAD,JODHPUR,3631,3372,HYDERABAD-JODHPUR,7003,All
2024,8,HYDERABAD,JODHPUR,3648,3238,HYDERABAD-JODHPUR,6886,All
2024,9,HYDERABAD,JODHPUR,5585,5061,HYDERABAD-JODHPUR,10646,All
2024,10,HYDERABAD,JODHPUR,6048,5096,HYDERABAD-JODHPUR,11144,All
2024,11,HYDERABAD,JODHPUR,4956,4738,HYDERABAD-JODHPUR,9694,All
2024,12,HYDERABAD,JODHPUR,5352,5334,HYDERABAD-JODHPUR,10686,All
2025,1,HYDERABAD,JODHPUR,5165,5076,HYDERABAD-JODHPUR,10241,All
2025,2,HYDERABAD,JODHPUR,4807,4713,HYDERABAD-JODHPUR,9520,All
2025,3,HYDERABAD,JODHPUR,4842,4633,HYDERABAD-JODHPUR,9475,All
2016,12,HYDERABAD,JORHAT,0,3,HYDERABAD-JORHAT,3,All
2019,4,HYDERABAD,JORHAT,0,3,HYDERABAD-JORHAT,3,All
2019,5,HYDERABAD,JORHAT,0,7,HYDERABAD-JORHAT,7,All
2019,9,HYDERABAD,JORHAT,0,4,HYDERABAD-JORHAT,4,All
2020,7,HYDERABAD,JORHAT,13,4,HYDERABAD-JORHAT,17,All
2020,8,HYDERABAD,JORHAT,75,50,HYDERABAD-JORHAT,125,All
2019,3,HYDERABAD,Jharsuguda,38,64,HYDERABAD-Jharsuguda,102,All
2019,4,HYDERABAD,Jharsuguda,2085,1750,HYDERABAD-Jharsuguda,3835,All
2019,5,HYDERABAD,KADAPA,1942,1821,HYDERABAD-KADAPA,3763,All
2019,6,HYDERABAD,KADAPA,1640,1655,HYDERABAD-KADAPA,3295,All
2019,7,HYDERABAD,KADAPA,1664,1560,HYDERABAD-KADAPA,3224,All
2019,8,HYDERABAD,KADAPA,1665,1524,HYDERABAD-KADAPA,3189,All
2019,9,HYDERABAD,KADAPA,1497,1438,HYDERABAD-KADAPA,2935,All
2019,10,HYDERABAD,KADAPA,1659,1674,HYDERABAD-KADAPA,3333,All
2019,11,HYDERABAD,KADAPA,1796,1740,HYDERABAD-KADAPA,3536,All
2019,12,HYDERABAD,KADAPA,1894,1845,HYDERABAD-KADAPA,3739,All
2020,1,HYDERABAD,KADAPA,1544,1486,HYDERABAD-KADAPA,3030,All
2020,2,HYDERABAD,KADAPA,1784,1719,HYDERABAD-KADAPA,3503,All
2020,3,HYDERABAD,KADAPA,1231,1146,HYDERABAD-KADAPA,2377,All
2020,5,HYDERABAD,KADAPA,77,99,HYDERABAD-KADAPA,176,All
2020,6,HYDERABAD,KADAPA,676,545,HYDERABAD-KADAPA,1221,All
2020,7,HYDERABAD,KADAPA,556,405,HYDERABAD-KADAPA,961,All
2020,8,HYDERABAD,KADAPA,593,504,HYDERABAD-KADAPA,1097,All
2020,9,HYDERABAD,KADAPA,394,335,HYDERABAD-KADAPA,729,All
2020,10,HYDERABAD,KADAPA,790,744,HYDERABAD-KADAPA,1534,All
2020,11,HYDERABAD,KADAPA,285,307,HYDERABAD-KADAPA,592,All
2020,12,HYDERABAD,KADAPA,404,386,HYDERABAD-KADAPA,790,All
2021,1,HYDERABAD,KADAPA,586,577,HYDERABAD-KADAPA,1163,All
2021,2,HYDERABAD,KADAPA,594,565,HYDERABAD-KADAPA,1159,All
2021,3,HYDERABAD,KADAPA,544,560,HYDERABAD-KADAPA,1104,All
2021,4,HYDERABAD,KADAPA,282,357,HYDERABAD-KADAPA,639,All
2021,7,HYDERABAD,KADAPA,535,526,HYDERABAD-KADAPA,1061,All
2021,8,HYDERABAD,KADAPA,495,527,HYDERABAD-KADAPA,1022,All
2021,9,HYDERABAD,KADAPA,108,163,HYDERABAD-KADAPA,271,All
2021,10,HYDERABAD,KADAPA,146,130,HYDERABAD-KADAPA,276,All
2021,11,HYDERABAD,KADAPA,88,79,HYDERABAD-KADAPA,167,All
2022,3,HYDERABAD,KADAPA,163,162,HYDERABAD-KADAPA,325,All
2022,4,HYDERABAD,KADAPA,1018,1048,HYDERABAD-KADAPA,2066,All
2022,5,HYDERABAD,KADAPA,1136,1137,HYDERABAD-KADAPA,2273,All
2022,6,HYDERABAD,KADAPA,1336,1324,HYDERABAD-KADAPA,2660,All
2022,7,HYDERABAD,KADAPA,1330,1272,HYDERABAD-KADAPA,2602,All
2022,8,HYDERABAD,KADAPA,1546,1525,HYDERABAD-KADAPA,3071,All
2022,9,HYDERABAD,KADAPA,1395,1351,HYDERABAD-KADAPA,2746,All
2022,10,HYDERABAD,KADAPA,1444,1575,HYDERABAD-KADAPA,3019,All
2022,11,HYDERABAD,KADAPA,1134,1229,HYDERABAD-KADAPA,2363,All
2022,12,HYDERABAD,KADAPA,1517,1406,HYDERABAD-KADAPA,2923,All
2023,2,HYDERABAD,KADAPA,1487,1686,HYDERABAD-KADAPA,3173,All
2023,3,HYDERABAD,KADAPA,1718,1766,HYDERABAD-KADAPA,3484,All
2023,4,HYDERABAD,KADAPA,1668,1712,HYDERABAD-KADAPA,3380,All
2023,5,HYDERABAD,KADAPA,1799,1889,HYDERABAD-KADAPA,3688,All
2021,12,HYDERABAD,KANDLA,0,1,HYDERABAD-KANDLA,1,All
2022,5,HYDERABAD,KANDLA,0,1,HYDERABAD-KANDLA,1,All
2022,8,HYDERABAD,KANDLA,0,1,HYDERABAD-KANDLA,1,All
2019,5,HYDERABAD,KANNUR,7626,6622,HYDERABAD-KANNUR,14248,All
2019,6,HYDERABAD,KANNUR,7403,7760,HYDERABAD-KANNUR,15163,All
2019,7,HYDERABAD,KANNUR,8234,8127,HYDERABAD-KANNUR,16361,All
2019,8,HYDERABAD,KANNUR,7801,7508,HYDERABAD-KANNUR,15309,All
2019,9,HYDERABAD,KANNUR,7024,7242,HYDERABAD-KANNUR,14266,All
2019,10,HYDERABAD,KANNUR,7338,8134,HYDERABAD-KANNUR,15472,All
2019,11,HYDERABAD,KANNUR,7691,7093,HYDERABAD-KANNUR,14784,All
2019,12,HYDERABAD,KANNUR,2620,2640,HYDERABAD-KANNUR,5260,All
2020,1,HYDERABAD,KANNUR,1928,2166,HYDERABAD-KANNUR,4094,All
2020,2,HYDERABAD,KANNUR,2177,2429,HYDERABAD-KANNUR,4606,All
2020,3,HYDERABAD,KANNUR,2062,1730,HYDERABAD-KANNUR,3792,All
2020,6,HYDERABAD,KANNUR,146,61,HYDERABAD-KANNUR,207,All
2020,7,HYDERABAD,KANNUR,1191,1258,HYDERABAD-KANNUR,2449,All
2020,8,HYDERABAD,KANNUR,1604,1274,HYDERABAD-KANNUR,2878,All
2020,9,HYDERABAD,KANNUR,2124,1687,HYDERABAD-KANNUR,3811,All
2020,10,HYDERABAD,KANNUR,2954,2076,HYDERABAD-KANNUR,5030,All
2020,11,HYDERABAD,KANNUR,2704,2300,HYDERABAD-KANNUR,5004,All
2020,12,HYDERABAD,KANNUR,2910,2660,HYDERABAD-KANNUR,5570,All
2021,1,HYDERABAD,KANNUR,2169,1933,HYDERABAD-KANNUR,4102,All
2021,2,HYDERABAD,KANNUR,1706,1830,HYDERABAD-KANNUR,3536,All
2021,3,HYDERABAD,KANNUR,1741,2038,HYDERABAD-KANNUR,3779,All
2021,4,HYDERABAD,KANNUR,1560,1902,HYDERABAD-KANNUR,3462,All
2021,6,HYDERABAD,KANNUR,942,1474,HYDERABAD-KANNUR,2416,All
2021,7,HYDERABAD,KANNUR,786,1480,HYDERABAD-KANNUR,2266,All
2021,8,HYDERABAD,KANNUR,1316,1758,HYDERABAD-KANNUR,3074,All
2021,9,HYDERABAD,KANNUR,960,1451,HYDERABAD-KANNUR,2411,All
2021,10,HYDERABAD,KANNUR,1704,2051,HYDERABAD-KANNUR,3755,All
2021,11,HYDERABAD,KANNUR,1816,2010,HYDERABAD-KANNUR,3826,All
2021,12,HYDERABAD,KANNUR,1935,1950,HYDERABAD-KANNUR,3885,All
2022,1,HYDERABAD,KANNUR,1475,1631,HYDERABAD-KANNUR,3106,All
2022,2,HYDERABAD,KANNUR,974,1108,HYDERABAD-KANNUR,2082,All
2022,3,HYDERABAD,KANNUR,1580,1783,HYDERABAD-KANNUR,3363,All
2022,4,HYDERABAD,KANNUR,1974,1976,HYDERABAD-KANNUR,3950,All
2022,5,HYDERABAD,KANNUR,2069,2168,HYDERABAD-KANNUR,4237,All
2022,6,HYDERABAD,KANNUR,1435,1651,HYDERABAD-KANNUR,3086,All
2022,7,HYDERABAD,KANNUR,1797,1697,HYDERABAD-KANNUR,3494,All
2022,8,HYDERABAD,KANNUR,1898,1788,HYDERABAD-KANNUR,3686,All
2022,9,HYDERABAD,KANNUR,1720,1795,HYDERABAD-KANNUR,3515,All
2022,10,HYDERABAD,KANNUR,1872,2145,HYDERABAD-KANNUR,4017,All
2022,11,HYDERABAD,KANNUR,1797,1849,HYDERABAD-KANNUR,3646,All
2022,12,HYDERABAD,KANNUR,1893,1902,HYDERABAD-KANNUR,3795,All
2023,1,HYDERABAD,KANNUR,1989,1993,HYDERABAD-KANNUR,3982,All
2023,2,HYDERABAD,KANNUR,1771,1898,HYDERABAD-KANNUR,3669,All
2023,3,HYDERABAD,KANNUR,1886,2078,HYDERABAD-KANNUR,3964,All
2023,4,HYDERABAD,KANNUR,1923,2085,HYDERABAD-KANNUR,4008,All
2023,5,HYDERABAD,KANNUR,2162,2293,HYDERABAD-KANNUR,4455,All
2023,6,HYDERABAD,KANNUR,1895,2093,HYDERABAD-KANNUR,3988,All
2023,7,HYDERABAD,KANNUR,2062,2094,HYDERABAD-KANNUR,4156,All
2023,8,HYDERABAD,KANNUR,2018,2169,HYDERABAD-KANNUR,4187,All
2023,9,HYDERABAD,KANNUR,1747,2186,HYDERABAD-KANNUR,3933,All
2023,10,HYDERABAD,KANNUR,1645,1973,HYDERABAD-KANNUR,3618,All
2023,11,HYDERABAD,KANNUR,1621,2088,HYDERABAD-KANNUR,3709,All
2023,12,HYDERABAD,KANNUR,1919,1896,HYDERABAD-KANNUR,3815,All
2024,1,HYDERABAD,KANNUR,1807,2055,HYDERABAD-KANNUR,3862,All
2024,2,HYDERABAD,KANNUR,1459,2010,HYDERABAD-KANNUR,3469,All
2024,3,HYDERABAD,KANNUR,1625,2103,HYDERABAD-KANNUR,3728,All
2024,4,HYDERABAD,KANNUR,2015,1808,HYDERABAD-KANNUR,3823,All
2024,6,HYDERABAD,KANNUR,1587,1784,HYDERABAD-KANNUR,3371,All
2024,7,HYDERABAD,KANNUR,1967,1604,HYDERABAD-KANNUR,3571,All
2024,8,HYDERABAD,KANNUR,1704,1821,HYDERABAD-KANNUR,3525,All
2024,9,HYDERABAD,KANNUR,1544,1604,HYDERABAD-KANNUR,3148,All
2024,10,HYDERABAD,KANNUR,1555,1704,HYDERABAD-KANNUR,3259,All
2024,11,HYDERABAD,KANNUR,1775,1713,HYDERABAD-KANNUR,3488,All
2024,12,HYDERABAD,KANNUR,2120,1893,HYDERABAD-KANNUR,4013,All
2025,1,HYDERABAD,KANNUR,1774,1932,HYDERABAD-KANNUR,3706,All
2025,2,HYDERABAD,KANNUR,2111,1989,HYDERABAD-KANNUR,4100,All
2025,3,HYDERABAD,KANNUR,1594,1553,HYDERABAD-KANNUR,3147,All
2021,11,HYDERABAD,KANPUR,2456,2602,HYDERABAD-KANPUR,5058,All
2022,10,HYDERABAD,KANPUR,3,10,HYDERABAD-KANPUR,13,All
2022,11,HYDERABAD,KANPUR,146,148,HYDERABAD-KANPUR,294,All
2022,12,HYDERABAD,KANPUR,117,167,HYDERABAD-KANPUR,284,All
2023,1,HYDERABAD,KANPUR,116,92,HYDERABAD-KANPUR,208,All
2023,2,HYDERABAD,KANPUR,165,115,HYDERABAD-KANPUR,280,All
2023,3,HYDERABAD,KANPUR,171,121,HYDERABAD-KANPUR,292,All
2023,4,HYDERABAD,KANPUR,86,87,HYDERABAD-KANPUR,173,All
2023,5,HYDERABAD,KANPUR,67,94,HYDERABAD-KANPUR,161,All
2023,6,HYDERABAD,KANPUR,84,97,HYDERABAD-KANPUR,181,All
2023,7,HYDERABAD,KANPUR,102,111,HYDERABAD-KANPUR,213,All
2023,8,HYDERABAD,KANPUR,79,82,HYDERABAD-KANPUR,161,All
2023,9,HYDERABAD,KANPUR,124,109,HYDERABAD-KANPUR,233,All
2023,10,HYDERABAD,KANPUR,319,212,HYDERABAD-KANPUR,531,All
2024,9,HYDERABAD,KANPUR,429,312,HYDERABAD-KANPUR,741,All
2024,10,HYDERABAD,KANPUR,2859,1769,HYDERABAD-KANPUR,4628,All
2024,11,HYDERABAD,KANPUR,2355,2856,HYDERABAD-KANPUR,5211,All
2024,12,HYDERABAD,KANPUR,2548,3175,HYDERABAD-KANPUR,5723,All
2025,1,HYDERABAD,KANPUR,2827,2679,HYDERABAD-KANPUR,5506,All
2025,2,HYDERABAD,KANPUR,3578,3443,HYDERABAD-KANPUR,7021,All
2025,3,HYDERABAD,KANPUR,3092,2981,HYDERABAD-KANPUR,6073,All
2019,5,HYDERABAD,KOCHI,13882,13717,HYDERABAD-KOCHI,27599,All
2019,6,HYDERABAD,KOCHI,12466,11876,HYDERABAD-KOCHI,24342,All
2019,7,HYDERABAD,KOCHI,12125,11146,HYDERABAD-KOCHI,23271,All
2019,8,HYDERABAD,KOCHI,15664,14924,HYDERABAD-KOCHI,30588,All
2019,9,HYDERABAD,KOCHI,24080,22175,HYDERABAD-KOCHI,46255,All
2019,10,HYDERABAD,KOCHI,21176,19758,HYDERABAD-KOCHI,40934,All
2019,11,HYDERABAD,KOCHI,26607,26651,HYDERABAD-KOCHI,53258,All
2019,12,HYDERABAD,KOCHI,33205,33002,HYDERABAD-KOCHI,66207,All
2020,1,HYDERABAD,KOCHI,28817,30063,HYDERABAD-KOCHI,58880,All
2020,2,HYDERABAD,KOCHI,24031,23693,HYDERABAD-KOCHI,47724,All
2020,3,HYDERABAD,KOCHI,10965,10261,HYDERABAD-KOCHI,21226,All
2020,5,HYDERABAD,KOCHI,565,347,HYDERABAD-KOCHI,912,All
2020,6,HYDERABAD,KOCHI,3732,5032,HYDERABAD-KOCHI,8764,All
2020,7,HYDERABAD,KOCHI,3822,6604,HYDERABAD-KOCHI,10426,All
2020,8,HYDERABAD,KOCHI,3291,4161,HYDERABAD-KOCHI,7452,All
2020,9,HYDERABAD,KOCHI,6897,4780,HYDERABAD-KOCHI,11677,All
2020,10,HYDERABAD,KOCHI,8349,6120,HYDERABAD-KOCHI,14469,All
2020,11,HYDERABAD,KOCHI,6210,6803,HYDERABAD-KOCHI,13013,All
2020,12,HYDERABAD,KOCHI,10894,9623,HYDERABAD-KOCHI,20517,All
2021,1,HYDERABAD,KOCHI,13349,11935,HYDERABAD-KOCHI,25284,All
2021,2,HYDERABAD,KOCHI,11939,11150,HYDERABAD-KOCHI,23089,All
2021,3,HYDERABAD,KOCHI,10369,10685,HYDERABAD-KOCHI,21054,All
2021,4,HYDERABAD,KOCHI,9301,10203,HYDERABAD-KOCHI,19504,All
2021,6,HYDERABAD,KOCHI,3853,4898,HYDERABAD-KOCHI,8751,All
2021,7,HYDERABAD,KOCHI,6470,6961,HYDERABAD-KOCHI,13431,All
2021,8,HYDERABAD,KOCHI,12162,8430,HYDERABAD-KOCHI,20592,All
2021,9,HYDERABAD,KOCHI,9901,8579,HYDERABAD-KOCHI,18480,All
2021,10,HYDERABAD,KOCHI,11375,10755,HYDERABAD-KOCHI,22130,All
2021,11,HYDERABAD,KOCHI,12138,12001,HYDERABAD-KOCHI,24139,All
2021,12,HYDERABAD,KOCHI,23991,22450,HYDERABAD-KOCHI,46441,All
2022,1,HYDERABAD,KOCHI,19743,20915,HYDERABAD-KOCHI,40658,All
2022,2,HYDERABAD,KOCHI,11599,11635,HYDERABAD-KOCHI,23234,All
2022,3,HYDERABAD,KOCHI,18632,17050,HYDERABAD-KOCHI,35682,All
2022,4,HYDERABAD,KOCHI,18862,17414,HYDERABAD-KOCHI,36276,All
2022,5,HYDERABAD,KOCHI,17839,17105,HYDERABAD-KOCHI,34944,All
2022,6,HYDERABAD,KOCHI,17724,17575,HYDERABAD-KOCHI,35299,All
2022,7,HYDERABAD,KOCHI,17293,15678,HYDERABAD-KOCHI,32971,All
2022,8,HYDERABAD,KOCHI,18232,15767,HYDERABAD-KOCHI,33999,All
2022,9,HYDERABAD,KOCHI,25361,22497,HYDERABAD-KOCHI,47858,All
2022,10,HYDERABAD,KOCHI,20731,21314,HYDERABAD-KOCHI,42045,All
2022,11,HYDERABAD,KOCHI,20960,21900,HYDERABAD-KOCHI,42860,All
2022,12,HYDERABAD,KOCHI,24554,24287,HYDERABAD-KOCHI,48841,All
2023,11,HYDERABAD,KOCHI,29124,29285,HYDERABAD-KOCHI,58409,All
2023,12,HYDERABAD,KOCHI,39357,38728,HYDERABAD-KOCHI,78085,All
2024,1,HYDERABAD,KOCHI,31830,33512,HYDERABAD-KOCHI,65342,All
2024,2,HYDERABAD,KOCHI,25372,27993,HYDERABAD-KOCHI,53365,All
2024,3,HYDERABAD,KOCHI,26287,28316,HYDERABAD-KOCHI,54603,All
2024,4,HYDERABAD,KOCHI,25898,25089,HYDERABAD-KOCHI,50987,All
2024,6,HYDERABAD,KOCHI,22735,25128,HYDERABAD-KOCHI,47863,All
2024,7,HYDERABAD,KOCHI,24648,21715,HYDERABAD-KOCHI,46363,All
2024,8,HYDERABAD,KOCHI,24703,23394,HYDERABAD-KOCHI,48097,All
2024,9,HYDERABAD,KOCHI,28530,28914,HYDERABAD-KOCHI,57444,All
2024,10,HYDERABAD,KOCHI,31645,30737,HYDERABAD-KOCHI,62382,All
2024,11,HYDERABAD,KOCHI,35706,34038,HYDERABAD-KOCHI,69744,All
2024,12,HYDERABAD,KOCHI,41883,38761,HYDERABAD-KOCHI,80644,All
2025,1,HYDERABAD,KOCHI,38618,40174,HYDERABAD-KOCHI,78792,All
2025,2,HYDERABAD,KOCHI,34359,34580,HYDERABAD-KOCHI,68939,All
2025,3,HYDERABAD,KOCHI,27044,29354,HYDERABAD-KOCHI,56398,All
2018,12,HYDERABAD,KOLHAPUR,620,635,HYDERABAD-KOLHAPUR,1255,All
2019,1,HYDERABAD,KOLHAPUR,1186,1184,HYDERABAD-KOLHAPUR,2370,All
2019,2,HYDERABAD,KOLHAPUR,1313,1281,HYDERABAD-KOLHAPUR,2594,All
2019,3,HYDERABAD,KOLHAPUR,1180,921,HYDERABAD-KOLHAPUR,2101,All
2019,4,HYDERABAD,KOLHAPUR,1258,1016,HYDERABAD-KOLHAPUR,2274,All
2019,5,HYDERABAD,KOLHAPUR,2216,2288,HYDERABAD-KOLHAPUR,4504,All
2019,6,HYDERABAD,KOLHAPUR,2780,2935,HYDERABAD-KOLHAPUR,5715,All
2019,7,HYDERABAD,KOLHAPUR,2276,2759,HYDERABAD-KOLHAPUR,5035,All
2019,8,HYDERABAD,KOLHAPUR,2308,2507,HYDERABAD-KOLHAPUR,4815,All
2019,9,HYDERABAD,KOLHAPUR,2424,2791,HYDERABAD-KOLHAPUR,5215,All
2019,10,HYDERABAD,KOLHAPUR,2722,2953,HYDERABAD-KOLHAPUR,5675,All
2019,11,HYDERABAD,KOLHAPUR,3185,2960,HYDERABAD-KOLHAPUR,6145,All
2019,12,HYDERABAD,KOLHAPUR,2983,2777,HYDERABAD-KOLHAPUR,5760,All
2020,1,HYDERABAD,KOLHAPUR,3068,2883,HYDERABAD-KOLHAPUR,5951,All
2020,2,HYDERABAD,KOLHAPUR,2977,2549,HYDERABAD-KOLHAPUR,5526,All
2020,3,HYDERABAD,KOLHAPUR,1991,1782,HYDERABAD-KOLHAPUR,3773,All
2020,5,HYDERABAD,KOLHAPUR,94,105,HYDERABAD-KOLHAPUR,199,All
2020,6,HYDERABAD,KOLHAPUR,1386,1787,HYDERABAD-KOLHAPUR,3173,All
2020,7,HYDERABAD,KOLHAPUR,1732,1827,HYDERABAD-KOLHAPUR,3559,All
2020,8,HYDERABAD,KOLHAPUR,2582,2481,HYDERABAD-KOLHAPUR,5063,All
2020,9,HYDERABAD,KOLHAPUR,2722,2415,HYDERABAD-KOLHAPUR,5137,All
2020,10,HYDERABAD,KOLHAPUR,3022,2413,HYDERABAD-KOLHAPUR,5435,All
2020,11,HYDERABAD,KOLHAPUR,2474,2291,HYDERABAD-KOLHAPUR,4765,All
2020,12,HYDERABAD,KOLHAPUR,2841,2581,HYDERABAD-KOLHAPUR,5422,All
2021,1,HYDERABAD,KOLHAPUR,2814,2714,HYDERABAD-KOLHAPUR,5528,All
2021,2,HYDERABAD,KOLHAPUR,2930,2616,HYDERABAD-KOLHAPUR,5546,All
2021,3,HYDERABAD,KOLHAPUR,2385,2362,HYDERABAD-KOLHAPUR,4747,All
2021,4,HYDERABAD,KOLHAPUR,1952,2087,HYDERABAD-KOLHAPUR,4039,All
2021,6,HYDERABAD,KOLHAPUR,2139,1814,HYDERABAD-KOLHAPUR,3953,All
2021,7,HYDERABAD,KOLHAPUR,2042,1952,HYDERABAD-KOLHAPUR,3994,All
2021,8,HYDERABAD,KOLHAPUR,2476,2223,HYDERABAD-KOLHAPUR,4699,All
2021,9,HYDERABAD,KOLHAPUR,2556,2273,HYDERABAD-KOLHAPUR,4829,All
2021,10,HYDERABAD,KOLHAPUR,2836,2476,HYDERABAD-KOLHAPUR,5312,All
2021,11,HYDERABAD,KOLHAPUR,3374,3030,HYDERABAD-KOLHAPUR,6404,All
2021,12,HYDERABAD,KOLHAPUR,3114,2898,HYDERABAD-KOLHAPUR,6012,All
2022,1,HYDERABAD,KOLHAPUR,2322,2293,HYDERABAD-KOLHAPUR,4615,All
2022,2,HYDERABAD,KOLHAPUR,2415,2189,HYDERABAD-KOLHAPUR,4604,All
2022,3,HYDERABAD,KOLHAPUR,3162,2963,HYDERABAD-KOLHAPUR,6125,All
2022,4,HYDERABAD,KOLHAPUR,3155,3031,HYDERABAD-KOLHAPUR,6186,All
2022,5,HYDERABAD,KOLHAPUR,3080,2913,HYDERABAD-KOLHAPUR,5993,All
2022,6,HYDERABAD,KOLHAPUR,3200,3014,HYDERABAD-KOLHAPUR,6214,All
2022,7,HYDERABAD,KOLHAPUR,2558,2335,HYDERABAD-KOLHAPUR,4893,All
2022,8,HYDERABAD,KOLHAPUR,3085,2910,HYDERABAD-KOLHAPUR,5995,All
2022,9,HYDERABAD,KOLHAPUR,3147,3009,HYDERABAD-KOLHAPUR,6156,All
2022,10,HYDERABAD,KOLHAPUR,2601,2400,HYDERABAD-KOLHAPUR,5001,All
2022,11,HYDERABAD,KOLHAPUR,2110,1918,HYDERABAD-KOLHAPUR,4028,All
2022,12,HYDERABAD,KOLHAPUR,2063,1975,HYDERABAD-KOLHAPUR,4038,All
2023,1,HYDERABAD,KOLHAPUR,1824,2118,HYDERABAD-KOLHAPUR,3942,All
2023,2,HYDERABAD,KOLHAPUR,1841,1955,HYDERABAD-KOLHAPUR,3796,All
2023,3,HYDERABAD,KOLHAPUR,1684,1803,HYDERABAD-KOLHAPUR,3487,All
2023,4,HYDERABAD,KOLHAPUR,1817,1916,HYDERABAD-KOLHAPUR,3733,All
2023,5,HYDERABAD,KOLHAPUR,2136,1890,HYDERABAD-KOLHAPUR,4026,All
2023,6,HYDERABAD,KOLHAPUR,2000,1819,HYDERABAD-KOLHAPUR,3819,All
2023,7,HYDERABAD,KOLHAPUR,2049,1612,HYDERABAD-KOLHAPUR,3661,All
2023,8,HYDERABAD,KOLHAPUR,2106,1752,HYDERABAD-KOLHAPUR,3858,All
2023,9,HYDERABAD,KOLHAPUR,2184,1971,HYDERABAD-KOLHAPUR,4155,All
2023,10,HYDERABAD,KOLHAPUR,2092,1941,HYDERABAD-KOLHAPUR,4033,All
2023,11,HYDERABAD,KOLHAPUR,1717,1962,HYDERABAD-KOLHAPUR,3679,All
2023,12,HYDERABAD,KOLHAPUR,1891,1815,HYDERABAD-KOLHAPUR,3706,All
2024,1,HYDERABAD,KOLHAPUR,1816,1807,HYDERABAD-KOLHAPUR,3623,All
2024,2,HYDERABAD,KOLHAPUR,1711,1722,HYDERABAD-KOLHAPUR,3433,All
2024,3,HYDERABAD,KOLHAPUR,1642,1610,HYDERABAD-KOLHAPUR,3252,All
2024,4,HYDERABAD,KOLHAPUR,1727,1688,HYDERABAD-KOLHAPUR,3415,All
2024,6,HYDERABAD,KOLHAPUR,1758,1793,HYDERABAD-KOLHAPUR,3551,All
2024,7,HYDERABAD,KOLHAPUR,1848,1919,HYDERABAD-KOLHAPUR,3767,All
2024,8,HYDERABAD,KOLHAPUR,1757,1817,HYDERABAD-KOLHAPUR,3574,All
2024,9,HYDERABAD,KOLHAPUR,1749,1928,HYDERABAD-KOLHAPUR,3677,All
2024,10,HYDERABAD,KOLHAPUR,1874,2000,HYDERABAD-KOLHAPUR,3874,All
2024,11,HYDERABAD,KOLHAPUR,1815,2041,HYDERABAD-KOLHAPUR,3856,All
2024,12,HYDERABAD,KOLHAPUR,1773,2069,HYDERABAD-KOLHAPUR,3842,All
2025,1,HYDERABAD,KOLHAPUR,1668,2026,HYDERABAD-KOLHAPUR,3694,All
2025,2,HYDERABAD,KOLHAPUR,1613,1952,HYDERABAD-KOLHAPUR,3565,All
2025,3,HYDERABAD,KOLHAPUR,1771,1876,HYDERABAD-KOLHAPUR,3647,All
2019,5,HYDERABAD,KOLKATA,47918,50169,HYDERABAD-KOLKATA,98087,All
2019,6,HYDERABAD,KOLKATA,41157,43712,HYDERABAD-KOLKATA,84869,All
2019,7,HYDERABAD,KOLKATA,42886,43750,HYDERABAD-KOLKATA,86636,All
2019,8,HYDERABAD,KOLKATA,43251,40319,HYDERABAD-KOLKATA,83570,All
2019,9,HYDERABAD,KOLKATA,41930,38719,HYDERABAD-KOLKATA,80649,All
2019,10,HYDERABAD,KOLKATA,44240,42455,HYDERABAD-KOLKATA,86695,All
2019,11,HYDERABAD,KOLKATA,42731,43947,HYDERABAD-KOLKATA,86678,All
2019,12,HYDERABAD,KOLKATA,47464,47834,HYDERABAD-KOLKATA,95298,All
2020,1,HYDERABAD,KOLKATA,44583,44342,HYDERABAD-KOLKATA,88925,All
2020,2,HYDERABAD,KOLKATA,37449,37135,HYDERABAD-KOLKATA,74584,All
2020,3,HYDERABAD,KOLKATA,33533,25331,HYDERABAD-KOLKATA,58864,All
2020,5,HYDERABAD,KOLKATA,824,393,HYDERABAD-KOLKATA,1217,All
2020,6,HYDERABAD,KOLKATA,17012,8767,HYDERABAD-KOLKATA,25779,All
2020,7,HYDERABAD,KOLKATA,21351,12561,HYDERABAD-KOLKATA,33912,All
2020,8,HYDERABAD,KOLKATA,21297,26669,HYDERABAD-KOLKATA,47966,All
2020,9,HYDERABAD,KOLKATA,18974,40524,HYDERABAD-KOLKATA,59498,All
2020,10,HYDERABAD,KOLKATA,32654,45089,HYDERABAD-KOLKATA,77743,All
2020,11,HYDERABAD,KOLKATA,42016,44733,HYDERABAD-KOLKATA,86749,All
2020,12,HYDERABAD,KOLKATA,41617,53748,HYDERABAD-KOLKATA,95365,All
2021,1,HYDERABAD,KOLKATA,45612,45936,HYDERABAD-KOLKATA,91548,All
2021,2,HYDERABAD,KOLKATA,40515,37654,HYDERABAD-KOLKATA,78169,All
2021,3,HYDERABAD,KOLKATA,41126,34955,HYDERABAD-KOLKATA,76081,All
2021,4,HYDERABAD,KOLKATA,32814,22242,HYDERABAD-KOLKATA,55056,All
2021,6,HYDERABAD,KOLKATA,12528,15316,HYDERABAD-KOLKATA,27844,All
2021,7,HYDERABAD,KOLKATA,24715,24826,HYDERABAD-KOLKATA,49541,All
2021,8,HYDERABAD,KOLKATA,30696,37056,HYDERABAD-KOLKATA,67752,All
2021,9,HYDERABAD,KOLKATA,36550,35915,HYDERABAD-KOLKATA,72465,All
2021,10,HYDERABAD,KOLKATA,51306,43132,HYDERABAD-KOLKATA,94438,All
2021,11,HYDERABAD,KOLKATA,47589,42449,HYDERABAD-KOLKATA,90038,All
2021,12,HYDERABAD,KOLKATA,44140,42192,HYDERABAD-KOLKATA,86332,All
2022,1,HYDERABAD,KOLKATA,36897,27232,HYDERABAD-KOLKATA,64129,All
2022,2,HYDERABAD,KOLKATA,33880,29945,HYDERABAD-KOLKATA,63825,All
2022,3,HYDERABAD,KOLKATA,46441,41789,HYDERABAD-KOLKATA,88230,All
2022,4,HYDERABAD,KOLKATA,44451,34778,HYDERABAD-KOLKATA,79229,All
2022,5,HYDERABAD,KOLKATA,40729,39985,HYDERABAD-KOLKATA,80714,All
2022,6,HYDERABAD,KOLKATA,35335,34958,HYDERABAD-KOLKATA,70293,All
2022,7,HYDERABAD,KOLKATA,34371,34224,HYDERABAD-KOLKATA,68595,All
2022,8,HYDERABAD,KOLKATA,32669,31728,HYDERABAD-KOLKATA,64397,All
2022,9,HYDERABAD,KOLKATA,37329,29876,HYDERABAD-KOLKATA,67205,All
2022,10,HYDERABAD,KOLKATA,45198,39433,HYDERABAD-KOLKATA,84631,All
2022,11,HYDERABAD,KOLKATA,37980,38285,HYDERABAD-KOLKATA,76265,All
2022,12,HYDERABAD,KOLKATA,43332,42329,HYDERABAD-KOLKATA,85661,All
2023,1,HYDERABAD,KOLKATA,41449,38871,HYDERABAD-KOLKATA,80320,All
2023,2,HYDERABAD,KOLKATA,37073,35141,HYDERABAD-KOLKATA,72214,All
2023,3,HYDERABAD,KOLKATA,41104,37871,HYDERABAD-KOLKATA,78975,All
2023,4,HYDERABAD,KOLKATA,41011,35652,HYDERABAD-KOLKATA,76663,All
2023,5,HYDERABAD,KOLKATA,37367,39121,HYDERABAD-KOLKATA,76488,All
2023,6,HYDERABAD,KOLKATA,44696,45171,HYDERABAD-KOLKATA,89867,All
2023,7,HYDERABAD,KOLKATA,39671,43998,HYDERABAD-KOLKATA,83669,All
2023,8,HYDERABAD,KOLKATA,43187,44622,HYDERABAD-KOLKATA,87809,All
2023,9,HYDERABAD,KOLKATA,44212,43371,HYDERABAD-KOLKATA,87583,All
2023,10,HYDERABAD,KOLKATA,52828,48628,HYDERABAD-KOLKATA,101456,All
2023,11,HYDERABAD,KOLKATA,49214,46769,HYDERABAD-KOLKATA,95983,All
2023,12,HYDERABAD,KOLKATA,44377,45558,HYDERABAD-KOLKATA,89935,All
2024,1,HYDERABAD,KOLKATA,43717,42238,HYDERABAD-KOLKATA,85955,All
2024,2,HYDERABAD,KOLKATA,42825,41671,HYDERABAD-KOLKATA,84496,All
2024,3,HYDERABAD,KOLKATA,53274,47328,HYDERABAD-KOLKATA,100602,All
2024,4,HYDERABAD,KOLKATA,57302,45422,HYDERABAD-KOLKATA,102724,All
2024,6,HYDERABAD,KOLKATA,45240,46990,HYDERABAD-KOLKATA,92230,All
2024,7,HYDERABAD,KOLKATA,45178,49262,HYDERABAD-KOLKATA,94440,All
2024,8,HYDERABAD,KOLKATA,46153,47662,HYDERABAD-KOLKATA,93815,All
2024,9,HYDERABAD,KOLKATA,46815,41801,HYDERABAD-KOLKATA,88616,All
2024,10,HYDERABAD,KOLKATA,60585,48172,HYDERABAD-KOLKATA,108757,All
2024,11,HYDERABAD,KOLKATA,47780,50897,HYDERABAD-KOLKATA,98677,All
2024,12,HYDERABAD,KOLKATA,53977,52923,HYDERABAD-KOLKATA,106900,All
2025,1,HYDERABAD,KOLKATA,49624,47048,HYDERABAD-KOLKATA,96672,All
2025,2,HYDERABAD,KOLKATA,47222,44115,HYDERABAD-KOLKATA,91337,All
2025,3,HYDERABAD,KOLKATA,53615,45909,HYDERABAD-KOLKATA,99524,All
2020,3,HYDERABAD,KOZHIKODE,0,154,HYDERABAD-KOZHIKODE,154,All
2020,9,HYDERABAD,KOZHIKODE,1194,1074,HYDERABAD-KOZHIKODE,2268,All
2020,10,HYDERABAD,KOZHIKODE,1826,1004,HYDERABAD-KOZHIKODE,2830,All
2020,11,HYDERABAD,KOZHIKODE,864,1653,HYDERABAD-KOZHIKODE,2517,All
2020,12,HYDERABAD,KOZHIKODE,1843,2101,HYDERABAD-KOZHIKODE,3944,All
2021,1,HYDERABAD,KOZHIKODE,1704,2089,HYDERABAD-KOZHIKODE,3793,All
2021,2,HYDERABAD,KOZHIKODE,1317,1787,HYDERABAD-KOZHIKODE,3104,All
2021,3,HYDERABAD,KOZHIKODE,1224,1837,HYDERABAD-KOZHIKODE,3061,All
2021,7,HYDERABAD,KOZHIKODE,1398,1085,HYDERABAD-KOZHIKODE,2483,All
2021,8,HYDERABAD,KOZHIKODE,2211,1637,HYDERABAD-KOZHIKODE,3848,All
2021,9,HYDERABAD,KOZHIKODE,2171,1832,HYDERABAD-KOZHIKODE,4003,All
2021,10,HYDERABAD,KOZHIKODE,1422,1414,HYDERABAD-KOZHIKODE,2836,All
2021,11,HYDERABAD,KOZHIKODE,1471,1946,HYDERABAD-KOZHIKODE,3417,All
2021,12,HYDERABAD,KOZHIKODE,1869,2007,HYDERABAD-KOZHIKODE,3876,All
2022,1,HYDERABAD,KOZHIKODE,1017,1393,HYDERABAD-KOZHIKODE,2410,All
2022,2,HYDERABAD,KOZHIKODE,807,801,HYDERABAD-KOZHIKODE,1608,All
2022,3,HYDERABAD,KOZHIKODE,1696,1884,HYDERABAD-KOZHIKODE,3580,All
2022,4,HYDERABAD,KOZHIKODE,1997,2021,HYDERABAD-KOZHIKODE,4018,All
2022,5,HYDERABAD,KOZHIKODE,2209,2240,HYDERABAD-KOZHIKODE,4449,All
2022,6,HYDERABAD,KOZHIKODE,1785,1933,HYDERABAD-KOZHIKODE,3718,All
2022,7,HYDERABAD,KOZHIKODE,2034,1997,HYDERABAD-KOZHIKODE,4031,All
2022,8,HYDERABAD,KOZHIKODE,2149,1887,HYDERABAD-KOZHIKODE,4036,All
2022,9,HYDERABAD,KOZHIKODE,1675,1815,HYDERABAD-KOZHIKODE,3490,All
2022,10,HYDERABAD,KOZHIKODE,2024,2040,HYDERABAD-KOZHIKODE,4064,All
2022,11,HYDERABAD,KOZHIKODE,2031,1999,HYDERABAD-KOZHIKODE,4030,All
2022,12,HYDERABAD,KOZHIKODE,1989,1921,HYDERABAD-KOZHIKODE,3910,All
2023,1,HYDERABAD,KOZHIKODE,1955,1849,HYDERABAD-KOZHIKODE,3804,All
2023,2,HYDERABAD,KOZHIKODE,1748,1826,HYDERABAD-KOZHIKODE,3574,All
2023,3,HYDERABAD,KOZHIKODE,1902,1989,HYDERABAD-KOZHIKODE,3891,All
2023,4,HYDERABAD,KOZHIKODE,1951,2097,HYDERABAD-KOZHIKODE,4048,All
2023,5,HYDERABAD,KOZHIKODE,2317,2187,HYDERABAD-KOZHIKODE,4504,All
2023,6,HYDERABAD,KOZHIKODE,2148,2147,HYDERABAD-KOZHIKODE,4295,All
2023,7,HYDERABAD,KOZHIKODE,2129,2179,HYDERABAD-KOZHIKODE,4308,All
2023,8,HYDERABAD,KOZHIKODE,2136,2305,HYDERABAD-KOZHIKODE,4441,All
2023,9,HYDERABAD,KOZHIKODE,1729,2089,HYDERABAD-KOZHIKODE,3818,All
2023,10,HYDERABAD,KOZHIKODE,1826,1958,HYDERABAD-KOZHIKODE,3784,All
2023,11,HYDERABAD,KOZHIKODE,1861,1925,HYDERABAD-KOZHIKODE,3786,All
2023,12,HYDERABAD,KOZHIKODE,2112,2025,HYDERABAD-KOZHIKODE,4137,All
2024,1,HYDERABAD,KOZHIKODE,2032,2184,HYDERABAD-KOZHIKODE,4216,All
2024,2,HYDERABAD,KOZHIKODE,1761,1841,HYDERABAD-KOZHIKODE,3602,All
2024,3,HYDERABAD,KOZHIKODE,1788,1958,HYDERABAD-KOZHIKODE,3746,All
2024,4,HYDERABAD,KOZHIKODE,1863,1941,HYDERABAD-KOZHIKODE,3804,All
2024,6,HYDERABAD,KOZHIKODE,1982,2055,HYDERABAD-KOZHIKODE,4037,All
2024,7,HYDERABAD,KOZHIKODE,2081,1865,HYDERABAD-KOZHIKODE,3946,All
2024,8,HYDERABAD,KOZHIKODE,1890,1947,HYDERABAD-KOZHIKODE,3837,All
2024,9,HYDERABAD,KOZHIKODE,1691,1837,HYDERABAD-KOZHIKODE,3528,All
2024,10,HYDERABAD,KOZHIKODE,2017,2135,HYDERABAD-KOZHIKODE,4152,All
2024,11,HYDERABAD,KOZHIKODE,3959,4270,HYDERABAD-KOZHIKODE,8229,All
2024,12,HYDERABAD,KOZHIKODE,4745,4462,HYDERABAD-KOZHIKODE,9207,All
2025,1,HYDERABAD,KOZHIKODE,4551,4625,HYDERABAD-KOZHIKODE,9176,All
2025,2,HYDERABAD,KOZHIKODE,4591,4667,HYDERABAD-KOZHIKODE,9258,All
2025,3,HYDERABAD,KOZHIKODE,3664,3947,HYDERABAD-KOZHIKODE,7611,All
2018,5,HYDERABAD,LEH,0,106,HYDERABAD-LEH,106,All
2018,6,HYDERABAD,LEH,0,65,HYDERABAD-LEH,65,All
2018,7,HYDERABAD,LEH,0,69,HYDERABAD-LEH,69,All
2018,8,HYDERABAD,LEH,0,212,HYDERABAD-LEH,212,All
2018,9,HYDERABAD,LEH,0,581,HYDERABAD-LEH,581,All
2018,10,HYDERABAD,LEH,0,377,HYDERABAD-LEH,377,All
2018,11,HYDERABAD,LEH,0,143,HYDERABAD-LEH,143,All
2018,12,HYDERABAD,LEH,0,159,HYDERABAD-LEH,159,All
2019,1,HYDERABAD,LEH,0,29,HYDERABAD-LEH,29,All
2015,4,HYDERABAD,LUCKNOW,2631,2141,HYDERABAD-LUCKNOW,4772,All
2015,5,HYDERABAD,LUCKNOW,4838,5390,HYDERABAD-LUCKNOW,10228,All
2015,6,HYDERABAD,LUCKNOW,4227,5343,HYDERABAD-LUCKNOW,9570,All
2015,7,HYDERABAD,LUCKNOW,3725,3790,HYDERABAD-LUCKNOW,7515,All
2015,8,HYDERABAD,LUCKNOW,3795,3692,HYDERABAD-LUCKNOW,7487,All
2015,9,HYDERABAD,LUCKNOW,4022,3710,HYDERABAD-LUCKNOW,7732,All
2015,10,HYDERABAD,LUCKNOW,5165,4459,HYDERABAD-LUCKNOW,9624,All
2015,11,HYDERABAD,LUCKNOW,5158,4639,HYDERABAD-LUCKNOW,9797,All
2015,12,HYDERABAD,LUCKNOW,4757,5310,HYDERABAD-LUCKNOW,10067,All
2016,1,HYDERABAD,LUCKNOW,3626,3306,HYDERABAD-LUCKNOW,6932,All
2016,2,HYDERABAD,LUCKNOW,4208,3693,HYDERABAD-LUCKNOW,7901,All
2016,3,HYDERABAD,LUCKNOW,4112,3914,HYDERABAD-LUCKNOW,8026,All
2016,4,HYDERABAD,LUCKNOW,4666,3907,HYDERABAD-LUCKNOW,8573,All
2016,5,HYDERABAD,LUCKNOW,4329,4584,HYDERABAD-LUCKNOW,8913,All
2016,6,HYDERABAD,LUCKNOW,4027,4489,HYDERABAD-LUCKNOW,8516,All
2016,7,HYDERABAD,LUCKNOW,4361,4298,HYDERABAD-LUCKNOW,8659,All
2016,8,HYDERABAD,LUCKNOW,3717,3582,HYDERABAD-LUCKNOW,7299,All
2016,9,HYDERABAD,LUCKNOW,3519,2934,HYDERABAD-LUCKNOW,6453,All
2016,10,HYDERABAD,LUCKNOW,5613,3980,HYDERABAD-LUCKNOW,9593,All
2016,11,HYDERABAD,LUCKNOW,5915,5232,HYDERABAD-LUCKNOW,11147,All
2016,12,HYDERABAD,LUCKNOW,5778,4659,HYDERABAD-LUCKNOW,10437,All
2017,1,HYDERABAD,LUCKNOW,5571,4998,HYDERABAD-LUCKNOW,10569,All
2017,2,HYDERABAD,LUCKNOW,4718,4602,HYDERABAD-LUCKNOW,9320,All
2017,3,HYDERABAD,LUCKNOW,4856,4850,HYDERABAD-LUCKNOW,9706,All
2017,4,HYDERABAD,LUCKNOW,5063,4455,HYDERABAD-LUCKNOW,9518,All
2017,5,HYDERABAD,LUCKNOW,5262,5302,HYDERABAD-LUCKNOW,10564,All
2017,6,HYDERABAD,LUCKNOW,5116,5126,HYDERABAD-LUCKNOW,10242,All
2017,7,HYDERABAD,LUCKNOW,5177,5087,HYDERABAD-LUCKNOW,10264,All
2017,8,HYDERABAD,LUCKNOW,4795,4442,HYDERABAD-LUCKNOW,9237,All
2017,9,HYDERABAD,LUCKNOW,4767,3685,HYDERABAD-LUCKNOW,8452,All
2017,10,HYDERABAD,LUCKNOW,5123,4726,HYDERABAD-LUCKNOW,9849,All
2017,11,HYDERABAD,LUCKNOW,5168,5099,HYDERABAD-LUCKNOW,10267,All
2017,12,HYDERABAD,LUCKNOW,10827,11595,HYDERABAD-LUCKNOW,22422,All
2018,1,HYDERABAD,LUCKNOW,13710,12912,HYDERABAD-LUCKNOW,26622,All
2018,2,HYDERABAD,LUCKNOW,13582,12536,HYDERABAD-LUCKNOW,26118,All
2018,3,HYDERABAD,LUCKNOW,13529,13626,HYDERABAD-LUCKNOW,27155,All
2018,4,HYDERABAD,LUCKNOW,12750,11109,HYDERABAD-LUCKNOW,23859,All
2018,5,HYDERABAD,LUCKNOW,13048,14394,HYDERABAD-LUCKNOW,27442,All
2018,6,HYDERABAD,LUCKNOW,14024,14555,HYDERABAD-LUCKNOW,28579,All
2018,7,HYDERABAD,LUCKNOW,13500,14003,HYDERABAD-LUCKNOW,27503,All
2018,8,HYDERABAD,LUCKNOW,14755,15045,HYDERABAD-LUCKNOW,29800,All
2018,9,HYDERABAD,LUCKNOW,15516,14824,HYDERABAD-LUCKNOW,30340,All
2018,10,HYDERABAD,LUCKNOW,17004,14303,HYDERABAD-LUCKNOW,31307,All
2018,11,HYDERABAD,LUCKNOW,12409,13091,HYDERABAD-LUCKNOW,25500,All
2018,12,HYDERABAD,LUCKNOW,13804,16486,HYDERABAD-LUCKNOW,30290,All
2019,1,HYDERABAD,LUCKNOW,15021,14451,HYDERABAD-LUCKNOW,29472,All
2019,2,HYDERABAD,LUCKNOW,17550,15562,HYDERABAD-LUCKNOW,33112,All
2019,3,HYDERABAD,LUCKNOW,14771,14127,HYDERABAD-LUCKNOW,28898,All
2019,4,HYDERABAD,LUCKNOW,13661,10766,HYDERABAD-LUCKNOW,24427,All
2019,5,HYDERABAD,LUCKNOW,14518,13262,HYDERABAD-LUCKNOW,27780,All
2019,6,HYDERABAD,LUCKNOW,8765,9658,HYDERABAD-LUCKNOW,18423,All
2019,7,HYDERABAD,LUCKNOW,14030,12911,HYDERABAD-LUCKNOW,26941,All
2019,8,HYDERABAD,LUCKNOW,13126,12537,HYDERABAD-LUCKNOW,25663,All
2019,9,HYDERABAD,LUCKNOW,13750,12801,HYDERABAD-LUCKNOW,26551,All
2019,10,HYDERABAD,LUCKNOW,14263,11640,HYDERABAD-LUCKNOW,25903,All
2019,11,HYDERABAD,LUCKNOW,14457,15751,HYDERABAD-LUCKNOW,30208,All
2019,12,HYDERABAD,LUCKNOW,12871,15197,HYDERABAD-LUCKNOW,28068,All
2020,1,HYDERABAD,LUCKNOW,14641,15664,HYDERABAD-LUCKNOW,30305,All
2020,2,HYDERABAD,LUCKNOW,10487,10909,HYDERABAD-LUCKNOW,21396,All
2020,3,HYDERABAD,LUCKNOW,8950,8665,HYDERABAD-LUCKNOW,17615,All
2020,5,HYDERABAD,LUCKNOW,280,199,HYDERABAD-LUCKNOW,479,All
2020,6,HYDERABAD,LUCKNOW,2771,2230,HYDERABAD-LUCKNOW,5001,All
2020,7,HYDERABAD,LUCKNOW,3732,2900,HYDERABAD-LUCKNOW,6632,All
2020,8,HYDERABAD,LUCKNOW,2595,3637,HYDERABAD-LUCKNOW,6232,All
2020,9,HYDERABAD,LUCKNOW,2881,4341,HYDERABAD-LUCKNOW,7222,All
2020,10,HYDERABAD,LUCKNOW,5367,5446,HYDERABAD-LUCKNOW,10813,All
2020,11,HYDERABAD,LUCKNOW,9277,7704,HYDERABAD-LUCKNOW,16981,All
2020,12,HYDERABAD,LUCKNOW,22774,12548,HYDERABAD-LUCKNOW,35322,All
2021,1,HYDERABAD,LUCKNOW,7142,9837,HYDERABAD-LUCKNOW,16979,All
2021,2,HYDERABAD,LUCKNOW,7880,8012,HYDERABAD-LUCKNOW,15892,All
2021,3,HYDERABAD,LUCKNOW,9924,7787,HYDERABAD-LUCKNOW,17711,All
2021,4,HYDERABAD,LUCKNOW,9448,5652,HYDERABAD-LUCKNOW,15100,All
2021,6,HYDERABAD,LUCKNOW,2938,4436,HYDERABAD-LUCKNOW,7374,All
2021,7,HYDERABAD,LUCKNOW,4703,6237,HYDERABAD-LUCKNOW,10940,All
2021,8,HYDERABAD,LUCKNOW,4716,5600,HYDERABAD-LUCKNOW,10316,All
2021,9,HYDERABAD,LUCKNOW,4888,5176,HYDERABAD-LUCKNOW,10064,All
2021,10,HYDERABAD,LUCKNOW,7887,6521,HYDERABAD-LUCKNOW,14408,All
2021,11,HYDERABAD,LUCKNOW,8023,8580,HYDERABAD-LUCKNOW,16603,All
2021,12,HYDERABAD,LUCKNOW,7539,10888,HYDERABAD-LUCKNOW,18427,All
2022,1,HYDERABAD,LUCKNOW,5298,4409,HYDERABAD-LUCKNOW,9707,All
2022,2,HYDERABAD,LUCKNOW,8606,7827,HYDERABAD-LUCKNOW,16433,All
2022,3,HYDERABAD,LUCKNOW,10098,10482,HYDERABAD-LUCKNOW,20580,All
2022,4,HYDERABAD,LUCKNOW,10574,9710,HYDERABAD-LUCKNOW,20284,All
2022,5,HYDERABAD,LUCKNOW,11138,12614,HYDERABAD-LUCKNOW,23752,All
2022,6,HYDERABAD,LUCKNOW,8246,11278,HYDERABAD-LUCKNOW,19524,All
2022,7,HYDERABAD,LUCKNOW,7303,9157,HYDERABAD-LUCKNOW,16460,All
2022,8,HYDERABAD,LUCKNOW,8044,8517,HYDERABAD-LUCKNOW,16561,All
2022,9,HYDERABAD,LUCKNOW,9346,8883,HYDERABAD-LUCKNOW,18229,All
2022,10,HYDERABAD,LUCKNOW,11441,10678,HYDERABAD-LUCKNOW,22119,All
2022,11,HYDERABAD,LUCKNOW,10324,10655,HYDERABAD-LUCKNOW,20979,All
2022,12,HYDERABAD,LUCKNOW,9327,10944,HYDERABAD-LUCKNOW,20271,All
2023,1,HYDERABAD,LUCKNOW,9396,9445,HYDERABAD-LUCKNOW,18841,All
2023,2,HYDERABAD,LUCKNOW,10469,9667,HYDERABAD-LUCKNOW,20136,All
2023,3,HYDERABAD,LUCKNOW,10011,10267,HYDERABAD-LUCKNOW,20278,All
2023,4,HYDERABAD,LUCKNOW,10394,10229,HYDERABAD-LUCKNOW,20623,All
2023,5,HYDERABAD,LUCKNOW,10554,12053,HYDERABAD-LUCKNOW,22607,All
2023,6,HYDERABAD,LUCKNOW,9713,11294,HYDERABAD-LUCKNOW,21007,All
2023,7,HYDERABAD,LUCKNOW,7938,8189,HYDERABAD-LUCKNOW,16127,All
2023,8,HYDERABAD,LUCKNOW,7687,6638,HYDERABAD-LUCKNOW,14325,All
2023,9,HYDERABAD,LUCKNOW,8201,7887,HYDERABAD-LUCKNOW,16088,All
2023,10,HYDERABAD,LUCKNOW,10582,9667,HYDERABAD-LUCKNOW,20249,All
2023,11,HYDERABAD,LUCKNOW,13999,12840,HYDERABAD-LUCKNOW,26839,All
2023,12,HYDERABAD,LUCKNOW,13362,14732,HYDERABAD-LUCKNOW,28094,All
2024,1,HYDERABAD,LUCKNOW,13523,13903,HYDERABAD-LUCKNOW,27426,All
2024,2,HYDERABAD,LUCKNOW,13248,12682,HYDERABAD-LUCKNOW,25930,All
2024,3,HYDERABAD,LUCKNOW,17296,15914,HYDERABAD-LUCKNOW,33210,All
2024,4,HYDERABAD,LUCKNOW,17138,14794,HYDERABAD-LUCKNOW,31932,All
2024,6,HYDERABAD,LUCKNOW,15233,16613,HYDERABAD-LUCKNOW,31846,All
2024,7,HYDERABAD,LUCKNOW,14995,16152,HYDERABAD-LUCKNOW,31147,All
2024,8,HYDERABAD,LUCKNOW,16796,16062,HYDERABAD-LUCKNOW,32858,All
2024,9,HYDERABAD,LUCKNOW,15509,13488,HYDERABAD-LUCKNOW,28997,All
2024,10,HYDERABAD,LUCKNOW,25006,14875,HYDERABAD-LUCKNOW,39881,All
2024,11,HYDERABAD,LUCKNOW,23597,23355,HYDERABAD-LUCKNOW,46952,All
2024,12,HYDERABAD,LUCKNOW,20997,27073,HYDERABAD-LUCKNOW,48070,All
2025,1,HYDERABAD,LUCKNOW,24334,22994,HYDERABAD-LUCKNOW,47328,All
2025,2,HYDERABAD,LUCKNOW,32440,30056,HYDERABAD-LUCKNOW,62496,All
2025,3,HYDERABAD,LUCKNOW,26244,22823,HYDERABAD-LUCKNOW,49067,All
2015,4,HYDERABAD,MADURAI,1957,2202,HYDERABAD-MADURAI,4159,All
2015,5,HYDERABAD,MADURAI,1898,2318,HYDERABAD-MADURAI,4216,All
2015,6,HYDERABAD,MADURAI,2090,2299,HYDERABAD-MADURAI,4389,All
2015,7,HYDERABAD,MADURAI,2243,2222,HYDERABAD-MADURAI,4465,All
2015,8,HYDERABAD,MADURAI,2336,2257,HYDERABAD-MADURAI,4593,All
2015,9,HYDERABAD,MADURAI,2100,2045,HYDERABAD-MADURAI,4145,All
2015,10,HYDERABAD,MADURAI,2058,2065,HYDERABAD-MADURAI,4123,All
2015,11,HYDERABAD,MADURAI,1914,1877,HYDERABAD-MADURAI,3791,All
2015,12,HYDERABAD,MADURAI,2219,2192,HYDERABAD-MADURAI,4411,All
2016,1,HYDERABAD,MADURAI,2226,2187,HYDERABAD-MADURAI,4413,All
2016,2,HYDERABAD,MADURAI,2068,2075,HYDERABAD-MADURAI,4143,All
2016,3,HYDERABAD,MADURAI,2233,2208,HYDERABAD-MADURAI,4441,All
2016,4,HYDERABAD,MADURAI,2134,2112,HYDERABAD-MADURAI,4246,All
2016,5,HYDERABAD,MADURAI,2313,2260,HYDERABAD-MADURAI,4573,All
2016,6,HYDERABAD,MADURAI,2256,2247,HYDERABAD-MADURAI,4503,All
2016,7,HYDERABAD,MADURAI,2178,2128,HYDERABAD-MADURAI,4306,All
2016,8,HYDERABAD,MADURAI,2221,2205,HYDERABAD-MADURAI,4426,All
2016,9,HYDERABAD,MADURAI,2183,2201,HYDERABAD-MADURAI,4384,All
2016,10,HYDERABAD,MADURAI,2340,2340,HYDERABAD-MADURAI,4680,All
2016,11,HYDERABAD,MADURAI,2237,2258,HYDERABAD-MADURAI,4495,All
2016,12,HYDERABAD,MADURAI,2270,2283,HYDERABAD-MADURAI,4553,All
2017,1,HYDERABAD,MADURAI,2279,2311,HYDERABAD-MADURAI,4590,All
2017,2,HYDERABAD,MADURAI,3389,3396,HYDERABAD-MADURAI,6785,All
2017,3,HYDERABAD,MADURAI,3752,3839,HYDERABAD-MADURAI,7591,All
2017,4,HYDERABAD,MADURAI,5704,5764,HYDERABAD-MADURAI,11468,All
2017,5,HYDERABAD,MADURAI,2281,2346,HYDERABAD-MADURAI,4627,All
2017,6,HYDERABAD,MADURAI,2432,2295,HYDERABAD-MADURAI,4727,All
2017,7,HYDERABAD,MADURAI,2714,2387,HYDERABAD-MADURAI,5101,All
2017,8,HYDERABAD,MADURAI,2788,2231,HYDERABAD-MADURAI,5019,All
2017,9,HYDERABAD,MADURAI,2519,2205,HYDERABAD-MADURAI,4724,All
2017,10,HYDERABAD,MADURAI,2495,2231,HYDERABAD-MADURAI,4726,All
2017,11,HYDERABAD,MADURAI,2525,2135,HYDERABAD-MADURAI,4660,All
2017,12,HYDERABAD,MADURAI,2678,2228,HYDERABAD-MADURAI,4906,All
2018,1,HYDERABAD,MADURAI,2637,2406,HYDERABAD-MADURAI,5043,All
2018,2,HYDERABAD,MADURAI,2706,2086,HYDERABAD-MADURAI,4792,All
2018,3,HYDERABAD,MADURAI,2497,2345,HYDERABAD-MADURAI,4842,All
2018,4,HYDERABAD,MADURAI,2635,2334,HYDERABAD-MADURAI,4969,All
2018,5,HYDERABAD,MADURAI,2812,2335,HYDERABAD-MADURAI,5147,All
2018,6,HYDERABAD,MADURAI,5057,4765,HYDERABAD-MADURAI,9822,All
2018,7,HYDERABAD,MADURAI,6066,5982,HYDERABAD-MADURAI,12048,All
2018,8,HYDERABAD,MADURAI,5979,5783,HYDERABAD-MADURAI,11762,All
2018,9,HYDERABAD,MADURAI,6100,6248,HYDERABAD-MADURAI,12348,All
2018,10,HYDERABAD,MADURAI,6028,6216,HYDERABAD-MADURAI,12244,All
2018,11,HYDERABAD,MADURAI,5873,6258,HYDERABAD-MADURAI,12131,All
2018,12,HYDERABAD,MADURAI,6519,6846,HYDERABAD-MADURAI,13365,All
2019,1,HYDERABAD,MADURAI,6441,6950,HYDERABAD-MADURAI,13391,All
2019,2,HYDERABAD,MADURAI,5485,6301,HYDERABAD-MADURAI,11786,All
2019,3,HYDERABAD,MADURAI,5731,6079,HYDERABAD-MADURAI,11810,All
2019,4,HYDERABAD,MADURAI,5785,6261,HYDERABAD-MADURAI,12046,All
2019,5,HYDERABAD,MADURAI,6321,5885,HYDERABAD-MADURAI,12206,All
2019,6,HYDERABAD,MADURAI,5622,6287,HYDERABAD-MADURAI,11909,All
2019,7,HYDERABAD,MADURAI,6094,6266,HYDERABAD-MADURAI,12360,All
2019,8,HYDERABAD,MADURAI,5963,6456,HYDERABAD-MADURAI,12419,All
2019,9,HYDERABAD,MADURAI,5398,6194,HYDERABAD-MADURAI,11592,All
2019,10,HYDERABAD,MADURAI,5590,5460,HYDERABAD-MADURAI,11050,All
2019,11,HYDERABAD,MADURAI,5737,6162,HYDERABAD-MADURAI,11899,All
2019,12,HYDERABAD,MADURAI,4663,4646,HYDERABAD-MADURAI,9309,All
2020,1,HYDERABAD,MADURAI,6199,6556,HYDERABAD-MADURAI,12755,All
2020,2,HYDERABAD,MADURAI,5532,5735,HYDERABAD-MADURAI,11267,All
2020,3,HYDERABAD,MADURAI,2832,3102,HYDERABAD-MADURAI,5934,All
2020,6,HYDERABAD,MADURAI,32,15,HYDERABAD-MADURAI,47,All
2020,7,HYDERABAD,MADURAI,1599,1358,HYDERABAD-MADURAI,2957,All
2020,8,HYDERABAD,MADURAI,3125,2640,HYDERABAD-MADURAI,5765,All
2020,9,HYDERABAD,MADURAI,4658,3687,HYDERABAD-MADURAI,8345,All
2020,10,HYDERABAD,MADURAI,4805,3636,HYDERABAD-MADURAI,8441,All
2020,11,HYDERABAD,MADURAI,3442,3996,HYDERABAD-MADURAI,7438,All
2020,12,HYDERABAD,MADURAI,3139,3427,HYDERABAD-MADURAI,6566,All
2021,1,HYDERABAD,MADURAI,3748,4368,HYDERABAD-MADURAI,8116,All
2021,2,HYDERABAD,MADURAI,4045,4146,HYDERABAD-MADURAI,8191,All
2021,3,HYDERABAD,MADURAI,3858,3854,HYDERABAD-MADURAI,7712,All
2021,4,HYDERABAD,MADURAI,2139,2159,HYDERABAD-MADURAI,4298,All
2021,7,HYDERABAD,MADURAI,1793,1950,HYDERABAD-MADURAI,3743,All
2021,8,HYDERABAD,MADURAI,1756,1963,HYDERABAD-MADURAI,3719,All
2021,9,HYDERABAD,MADURAI,1648,1888,HYDERABAD-MADURAI,3536,All
2021,10,HYDERABAD,MADURAI,1930,2032,HYDERABAD-MADURAI,3962,All
2021,11,HYDERABAD,MADURAI,3670,4086,HYDERABAD-MADURAI,7756,All
2021,12,HYDERABAD,MADURAI,4210,4194,HYDERABAD-MADURAI,8404,All
2022,1,HYDERABAD,MADURAI,2543,2498,HYDERABAD-MADURAI,5041,All
2022,2,HYDERABAD,MADURAI,2645,2575,HYDERABAD-MADURAI,5220,All
2022,3,HYDERABAD,MADURAI,5046,5068,HYDERABAD-MADURAI,10114,All
2022,4,HYDERABAD,MADURAI,4282,4089,HYDERABAD-MADURAI,8371,All
2022,5,HYDERABAD,MADURAI,4815,4367,HYDERABAD-MADURAI,9182,All
2022,6,HYDERABAD,MADURAI,4164,4450,HYDERABAD-MADURAI,8614,All
2022,7,HYDERABAD,MADURAI,4320,4265,HYDERABAD-MADURAI,8585,All
2022,8,HYDERABAD,MADURAI,5065,4948,HYDERABAD-MADURAI,10013,All
2022,9,HYDERABAD,MADURAI,4709,4807,HYDERABAD-MADURAI,9516,All
2022,10,HYDERABAD,MADURAI,5286,4996,HYDERABAD-MADURAI,10282,All
2022,11,HYDERABAD,MADURAI,5181,4757,HYDERABAD-MADURAI,9938,All
2022,12,HYDERABAD,MADURAI,4979,4596,HYDERABAD-MADURAI,9575,All
2023,1,HYDERABAD,MADURAI,5070,4924,HYDERABAD-MADURAI,9994,All
2023,2,HYDERABAD,MADURAI,5224,5093,HYDERABAD-MADURAI,10317,All
2023,3,HYDERABAD,MADURAI,6037,5417,HYDERABAD-MADURAI,11454,All
2023,4,HYDERABAD,MADURAI,5066,4984,HYDERABAD-MADURAI,10050,All
2023,5,HYDERABAD,MADURAI,6288,6275,HYDERABAD-MADURAI,12563,All
2023,6,HYDERABAD,MADURAI,5963,5906,HYDERABAD-MADURAI,11869,All
2023,7,HYDERABAD,MADURAI,6055,5961,HYDERABAD-MADURAI,12016,All
2023,8,HYDERABAD,MADURAI,7403,7289,HYDERABAD-MADURAI,14692,All
2023,9,HYDERABAD,MADURAI,6581,6571,HYDERABAD-MADURAI,13152,All
2023,10,HYDERABAD,MADURAI,6165,6311,HYDERABAD-MADURAI,12476,All
2023,11,HYDERABAD,MADURAI,4667,4659,HYDERABAD-MADURAI,9326,All
2023,12,HYDERABAD,MADURAI,5482,5508,HYDERABAD-MADURAI,10990,All
2024,1,HYDERABAD,MADURAI,4923,4966,HYDERABAD-MADURAI,9889,All
2024,2,HYDERABAD,MADURAI,4511,4481,HYDERABAD-MADURAI,8992,All
2024,3,HYDERABAD,MADURAI,4762,4799,HYDERABAD-MADURAI,9561,All
2024,4,HYDERABAD,MADURAI,6038,5834,HYDERABAD-MADURAI,11872,All
2024,6,HYDERABAD,MADURAI,4348,4774,HYDERABAD-MADURAI,9122,All
2024,7,HYDERABAD,MADURAI,4889,5022,HYDERABAD-MADURAI,9911,All
2024,8,HYDERABAD,MADURAI,4740,5038,HYDERABAD-MADURAI,9778,All
2024,9,HYDERABAD,MADURAI,5183,5888,HYDERABAD-MADURAI,11071,All
2024,10,HYDERABAD,MADURAI,4661,4632,HYDERABAD-MADURAI,9293,All
2024,11,HYDERABAD,MADURAI,6004,5908,HYDERABAD-MADURAI,11912,All
2024,12,HYDERABAD,MADURAI,9396,8638,HYDERABAD-MADURAI,18034,All
2025,1,HYDERABAD,MADURAI,9690,8874,HYDERABAD-MADURAI,18564,All
2025,2,HYDERABAD,MADURAI,8221,8126,HYDERABAD-MADURAI,16347,All
2025,3,HYDERABAD,MADURAI,8408,8132,HYDERABAD-MADURAI,16540,All
2015,4,HYDERABAD,MANGALORE,1233,648,HYDERABAD-MANGALORE,1881,All
2015,5,HYDERABAD,MANGALORE,859,249,HYDERABAD-MANGALORE,1108,All
2015,6,HYDERABAD,MANGALORE,795,208,HYDERABAD-MANGALORE,1003,All
2015,7,HYDERABAD,MANGALORE,1718,1784,HYDERABAD-MANGALORE,3502,All
2015,8,HYDERABAD,MANGALORE,1937,1618,HYDERABAD-MANGALORE,3555,All
2015,9,HYDERABAD,MANGALORE,1890,1649,HYDERABAD-MANGALORE,3539,All
2015,10,HYDERABAD,MANGALORE,1942,1951,HYDERABAD-MANGALORE,3893,All
2015,11,HYDERABAD,MANGALORE,1236,1205,HYDERABAD-MANGALORE,2441,All
2015,12,HYDERABAD,MANGALORE,1111,1220,HYDERABAD-MANGALORE,2331,All
2016,1,HYDERABAD,MANGALORE,1277,1231,HYDERABAD-MANGALORE,2508,All
2016,2,HYDERABAD,MANGALORE,1096,1058,HYDERABAD-MANGALORE,2154,All
2016,3,HYDERABAD,MANGALORE,1179,1111,HYDERABAD-MANGALORE,2290,All
2016,4,HYDERABAD,MANGALORE,1124,822,HYDERABAD-MANGALORE,1946,All
2016,5,HYDERABAD,MANGALORE,956,912,HYDERABAD-MANGALORE,1868,All
2016,6,HYDERABAD,MANGALORE,791,824,HYDERABAD-MANGALORE,1615,All
2016,7,HYDERABAD,MANGALORE,1205,946,HYDERABAD-MANGALORE,2151,All
2016,8,HYDERABAD,MANGALORE,845,886,HYDERABAD-MANGALORE,1731,All
2016,9,HYDERABAD,MANGALORE,905,846,HYDERABAD-MANGALORE,1751,All
2016,10,HYDERABAD,MANGALORE,805,757,HYDERABAD-MANGALORE,1562,All
2016,11,HYDERABAD,MANGALORE,1039,984,HYDERABAD-MANGALORE,2023,All
2016,12,HYDERABAD,MANGALORE,1497,1546,HYDERABAD-MANGALORE,3043,All
2017,1,HYDERABAD,MANGALORE,3008,2858,HYDERABAD-MANGALORE,5866,All
2017,2,HYDERABAD,MANGALORE,2561,2552,HYDERABAD-MANGALORE,5113,All
2017,3,HYDERABAD,MANGALORE,2551,2718,HYDERABAD-MANGALORE,5269,All
2017,4,HYDERABAD,MANGALORE,2746,2782,HYDERABAD-MANGALORE,5528,All
2017,5,HYDERABAD,MANGALORE,2086,1741,HYDERABAD-MANGALORE,3827,All
2017,6,HYDERABAD,MANGALORE,962,800,HYDERABAD-MANGALORE,1762,All
2017,7,HYDERABAD,MANGALORE,2974,2954,HYDERABAD-MANGALORE,5928,All
2017,8,HYDERABAD,MANGALORE,2151,1735,HYDERABAD-MANGALORE,3886,All
2017,9,HYDERABAD,MANGALORE,3017,2817,HYDERABAD-MANGALORE,5834,All
2017,10,HYDERABAD,MANGALORE,2775,2709,HYDERABAD-MANGALORE,5484,All
2017,11,HYDERABAD,MANGALORE,2619,2685,HYDERABAD-MANGALORE,5304,All
2017,12,HYDERABAD,MANGALORE,3592,3623,HYDERABAD-MANGALORE,7215,All
2018,1,HYDERABAD,MANGALORE,4406,4697,HYDERABAD-MANGALORE,9103,All
2018,2,HYDERABAD,MANGALORE,3491,4026,HYDERABAD-MANGALORE,7517,All
2018,3,HYDERABAD,MANGALORE,4755,5603,HYDERABAD-MANGALORE,10358,All
2018,4,HYDERABAD,MANGALORE,8457,8653,HYDERABAD-MANGALORE,17110,All
2018,5,HYDERABAD,MANGALORE,8070,7994,HYDERABAD-MANGALORE,16064,All
2018,6,HYDERABAD,MANGALORE,5493,5948,HYDERABAD-MANGALORE,11441,All
2018,7,HYDERABAD,MANGALORE,6016,5874,HYDERABAD-MANGALORE,11890,All
2018,8,HYDERABAD,MANGALORE,5928,6404,HYDERABAD-MANGALORE,12332,All
2018,9,HYDERABAD,MANGALORE,5054,5552,HYDERABAD-MANGALORE,10606,All
2018,10,HYDERABAD,MANGALORE,4412,4614,HYDERABAD-MANGALORE,9026,All
2018,11,HYDERABAD,MANGALORE,4099,4196,HYDERABAD-MANGALORE,8295,All
2018,12,HYDERABAD,MANGALORE,4537,4332,HYDERABAD-MANGALORE,8869,All
2019,1,HYDERABAD,MANGALORE,4355,4298,HYDERABAD-MANGALORE,8653,All
2019,2,HYDERABAD,MANGALORE,3907,4686,HYDERABAD-MANGALORE,8593,All
2019,3,HYDERABAD,MANGALORE,4019,4784,HYDERABAD-MANGALORE,8803,All
2019,4,HYDERABAD,MANGALORE,4299,4044,HYDERABAD-MANGALORE,8343,All
2019,5,HYDERABAD,MANGALORE,4445,4092,HYDERABAD-MANGALORE,8537,All
2019,6,HYDERABAD,MANGALORE,3869,4132,HYDERABAD-MANGALORE,8001,All
2019,7,HYDERABAD,MANGALORE,4650,4283,HYDERABAD-MANGALORE,8933,All
2019,8,HYDERABAD,MANGALORE,3001,2576,HYDERABAD-MANGALORE,5577,All
2019,9,HYDERABAD,MANGALORE,3682,3703,HYDERABAD-MANGALORE,7385,All
2019,10,HYDERABAD,MANGALORE,4369,4190,HYDERABAD-MANGALORE,8559,All
2019,11,HYDERABAD,MANGALORE,4359,4071,HYDERABAD-MANGALORE,8430,All
2019,12,HYDERABAD,MANGALORE,4995,4769,HYDERABAD-MANGALORE,9764,All
2020,1,HYDERABAD,MANGALORE,4444,4084,HYDERABAD-MANGALORE,8528,All
2020,2,HYDERABAD,MANGALORE,3779,3969,HYDERABAD-MANGALORE,7748,All
2020,3,HYDERABAD,MANGALORE,2230,2738,HYDERABAD-MANGALORE,4968,All
2020,8,HYDERABAD,MANGALORE,295,197,HYDERABAD-MANGALORE,492,All
2020,9,HYDERABAD,MANGALORE,1474,1090,HYDERABAD-MANGALORE,2564,All
2020,10,HYDERABAD,MANGALORE,2010,1744,HYDERABAD-MANGALORE,3754,All
2020,11,HYDERABAD,MANGALORE,3757,2927,HYDERABAD-MANGALORE,6684,All
2020,12,HYDERABAD,MANGALORE,4218,3393,HYDERABAD-MANGALORE,7611,All
2021,1,HYDERABAD,MANGALORE,3755,3736,HYDERABAD-MANGALORE,7491,All
2021,2,HYDERABAD,MANGALORE,3695,3195,HYDERABAD-MANGALORE,6890,All
2021,3,HYDERABAD,MANGALORE,3129,3292,HYDERABAD-MANGALORE,6421,All
2021,4,HYDERABAD,MANGALORE,2102,2661,HYDERABAD-MANGALORE,4763,All
2021,6,HYDERABAD,MANGALORE,1231,901,HYDERABAD-MANGALORE,2132,All
2021,7,HYDERABAD,MANGALORE,2084,1534,HYDERABAD-MANGALORE,3618,All
2021,8,HYDERABAD,MANGALORE,3308,2843,HYDERABAD-MANGALORE,6151,All
2021,9,HYDERABAD,MANGALORE,3235,3021,HYDERABAD-MANGALORE,6256,All
2021,10,HYDERABAD,MANGALORE,4570,4502,HYDERABAD-MANGALORE,9072,All
2021,11,HYDERABAD,MANGALORE,5528,5189,HYDERABAD-MANGALORE,10717,All
2021,12,HYDERABAD,MANGALORE,6232,6111,HYDERABAD-MANGALORE,12343,All
2022,1,HYDERABAD,MANGALORE,2991,3472,HYDERABAD-MANGALORE,6463,All
2022,2,HYDERABAD,MANGALORE,2889,3053,HYDERABAD-MANGALORE,5942,All
2022,3,HYDERABAD,MANGALORE,5573,5293,HYDERABAD-MANGALORE,10866,All
2022,4,HYDERABAD,MANGALORE,4152,4180,HYDERABAD-MANGALORE,8332,All
2022,5,HYDERABAD,MANGALORE,4316,4155,HYDERABAD-MANGALORE,8471,All
2022,6,HYDERABAD,MANGALORE,3697,4006,HYDERABAD-MANGALORE,7703,All
2022,7,HYDERABAD,MANGALORE,4055,3786,HYDERABAD-MANGALORE,7841,All
2022,8,HYDERABAD,MANGALORE,4163,4065,HYDERABAD-MANGALORE,8228,All
2022,9,HYDERABAD,MANGALORE,4157,3989,HYDERABAD-MANGALORE,8146,All
2022,10,HYDERABAD,MANGALORE,4322,4448,HYDERABAD-MANGALORE,8770,All
2022,11,HYDERABAD,MANGALORE,4457,4389,HYDERABAD-MANGALORE,8846,All
2022,12,HYDERABAD,MANGALORE,4382,4209,HYDERABAD-MANGALORE,8591,All
2023,1,HYDERABAD,MANGALORE,4248,3960,HYDERABAD-MANGALORE,8208,All
2023,2,HYDERABAD,MANGALORE,3856,3474,HYDERABAD-MANGALORE,7330,All
2023,3,HYDERABAD,MANGALORE,4101,3509,HYDERABAD-MANGALORE,7610,All
2023,4,HYDERABAD,MANGALORE,4068,4003,HYDERABAD-MANGALORE,8071,All
2023,5,HYDERABAD,MANGALORE,4282,4450,HYDERABAD-MANGALORE,8732,All
2023,6,HYDERABAD,MANGALORE,4044,4215,HYDERABAD-MANGALORE,8259,All
2023,7,HYDERABAD,MANGALORE,4339,4321,HYDERABAD-MANGALORE,8660,All
2023,8,HYDERABAD,MANGALORE,4203,4381,HYDERABAD-MANGALORE,8584,All
2023,9,HYDERABAD,MANGALORE,3798,4013,HYDERABAD-MANGALORE,7811,All
2023,10,HYDERABAD,MANGALORE,4382,4674,HYDERABAD-MANGALORE,9056,All
2023,11,HYDERABAD,MANGALORE,3843,3888,HYDERABAD-MANGALORE,7731,All
2023,12,HYDERABAD,MANGALORE,4072,4067,HYDERABAD-MANGALORE,8139,All
2024,1,HYDERABAD,MANGALORE,3798,3811,HYDERABAD-MANGALORE,7609,All
2024,2,HYDERABAD,MANGALORE,3420,3532,HYDERABAD-MANGALORE,6952,All
2024,3,HYDERABAD,MANGALORE,3978,4069,HYDERABAD-MANGALORE,8047,All
2024,4,HYDERABAD,MANGALORE,4020,3961,HYDERABAD-MANGALORE,7981,All
2024,6,HYDERABAD,MANGALORE,3918,4131,HYDERABAD-MANGALORE,8049,All
2024,7,HYDERABAD,MANGALORE,4188,3812,HYDERABAD-MANGALORE,8000,All
2024,8,HYDERABAD,MANGALORE,4068,4029,HYDERABAD-MANGALORE,8097,All
2024,9,HYDERABAD,MANGALORE,3339,3683,HYDERABAD-MANGALORE,7022,All
2024,10,HYDERABAD,MANGALORE,3747,4107,HYDERABAD-MANGALORE,7854,All
2024,11,HYDERABAD,MANGALORE,4415,4172,HYDERABAD-MANGALORE,8587,All
2024,12,HYDERABAD,MANGALORE,4572,4628,HYDERABAD-MANGALORE,9200,All
2025,1,HYDERABAD,MANGALORE,4908,5141,HYDERABAD-MANGALORE,10049,All
2025,2,HYDERABAD,MANGALORE,5303,5304,HYDERABAD-MANGALORE,10607,All
2025,3,HYDERABAD,MANGALORE,4864,5098,HYDERABAD-MANGALORE,9962,All
2019,5,HYDERABAD,MUMBAI,85677,96061,HYDERABAD-MUMBAI,181738,All
2019,6,HYDERABAD,MUMBAI,95005,102675,HYDERABAD-MUMBAI,197680,All
2019,7,HYDERABAD,MUMBAI,95649,107571,HYDERABAD-MUMBAI,203220,All
2019,8,HYDERABAD,MUMBAI,112915,113110,HYDERABAD-MUMBAI,226025,All
2019,9,HYDERABAD,MUMBAI,106199,100345,HYDERABAD-MUMBAI,206544,All
2019,10,HYDERABAD,MUMBAI,102325,123222,HYDERABAD-MUMBAI,225547,All
2019,11,HYDERABAD,MUMBAI,108973,108795,HYDERABAD-MUMBAI,217768,All
2019,12,HYDERABAD,MUMBAI,104801,110171,HYDERABAD-MUMBAI,214972,All
2020,1,HYDERABAD,MUMBAI,99552,103700,HYDERABAD-MUMBAI,203252,All
2020,2,HYDERABAD,MUMBAI,94183,97453,HYDERABAD-MUMBAI,191636,All
2020,3,HYDERABAD,MUMBAI,47770,49185,HYDERABAD-MUMBAI,96955,All
2020,5,HYDERABAD,MUMBAI,844,2113,HYDERABAD-MUMBAI,2957,All
2020,6,HYDERABAD,MUMBAI,6724,6989,HYDERABAD-MUMBAI,13713,All
2020,7,HYDERABAD,MUMBAI,7201,9484,HYDERABAD-MUMBAI,16685,All
2020,8,HYDERABAD,MUMBAI,13897,12027,HYDERABAD-MUMBAI,25924,All
2020,9,HYDERABAD,MUMBAI,19445,15748,HYDERABAD-MUMBAI,35193,All
2020,10,HYDERABAD,MUMBAI,24657,24163,HYDERABAD-MUMBAI,48820,All
2020,11,HYDERABAD,MUMBAI,33279,33463,HYDERABAD-MUMBAI,66742,All
2020,12,HYDERABAD,MUMBAI,49962,36468,HYDERABAD-MUMBAI,86430,All
2021,1,HYDERABAD,MUMBAI,38346,37983,HYDERABAD-MUMBAI,76329,All
2021,2,HYDERABAD,MUMBAI,35976,36985,HYDERABAD-MUMBAI,72961,All
2021,3,HYDERABAD,MUMBAI,32875,33309,HYDERABAD-MUMBAI,66184,All
2021,4,HYDERABAD,MUMBAI,19579,20158,HYDERABAD-MUMBAI,39737,All
2021,6,HYDERABAD,MUMBAI,19148,18800,HYDERABAD-MUMBAI,37948,All
2021,7,HYDERABAD,MUMBAI,31696,33489,HYDERABAD-MUMBAI,65185,All
2021,8,HYDERABAD,MUMBAI,43003,39821,HYDERABAD-MUMBAI,82824,All
2021,9,HYDERABAD,MUMBAI,41931,39039,HYDERABAD-MUMBAI,80970,All
2021,10,HYDERABAD,MUMBAI,48413,52673,HYDERABAD-MUMBAI,101086,All
2021,11,HYDERABAD,MUMBAI,55268,53319,HYDERABAD-MUMBAI,108587,All
2021,12,HYDERABAD,MUMBAI,59063,57209,HYDERABAD-MUMBAI,116272,All
2022,1,HYDERABAD,MUMBAI,32492,31738,HYDERABAD-MUMBAI,64230,All
2022,2,HYDERABAD,MUMBAI,46330,43048,HYDERABAD-MUMBAI,89378,All
2022,3,HYDERABAD,MUMBAI,57827,56700,HYDERABAD-MUMBAI,114527,All
2022,4,HYDERABAD,MUMBAI,60958,61988,HYDERABAD-MUMBAI,122946,All
2022,5,HYDERABAD,MUMBAI,65501,69304,HYDERABAD-MUMBAI,134805,All
2022,6,HYDERABAD,MUMBAI,63730,68971,HYDERABAD-MUMBAI,132701,All
2022,7,HYDERABAD,MUMBAI,63197,65099,HYDERABAD-MUMBAI,128296,All
2022,8,HYDERABAD,MUMBAI,75101,65508,HYDERABAD-MUMBAI,140609,All
2022,9,HYDERABAD,MUMBAI,77245,68529,HYDERABAD-MUMBAI,145774,All
2022,10,HYDERABAD,MUMBAI,66839,73174,HYDERABAD-MUMBAI,140013,All
2022,11,HYDERABAD,MUMBAI,69517,67363,HYDERABAD-MUMBAI,136880,All
2022,12,HYDERABAD,MUMBAI,76474,76308,HYDERABAD-MUMBAI,152782,All
2023,11,HYDERABAD,MUMBAI,91566,93828,HYDERABAD-MUMBAI,185394,All
2023,12,HYDERABAD,MUMBAI,109922,111104,HYDERABAD-MUMBAI,221026,All
2024,1,HYDERABAD,MUMBAI,108612,105344,HYDERABAD-MUMBAI,213956,All
2024,2,HYDERABAD,MUMBAI,97310,100044,HYDERABAD-MUMBAI,197354,All
2024,3,HYDERABAD,MUMBAI,95517,95348,HYDERABAD-MUMBAI,190865,All
2024,4,HYDERABAD,MUMBAI,99889,94837,HYDERABAD-MUMBAI,194726,All
2024,6,HYDERABAD,MUMBAI,94337,99030,HYDERABAD-MUMBAI,193367,All
2024,7,HYDERABAD,MUMBAI,95689,95245,HYDERABAD-MUMBAI,190934,All
2024,8,HYDERABAD,MUMBAI,109924,98516,HYDERABAD-MUMBAI,208440,All
2024,9,HYDERABAD,MUMBAI,102814,97960,HYDERABAD-MUMBAI,200774,All
2024,10,HYDERABAD,MUMBAI,95696,102069,HYDERABAD-MUMBAI,197765,All
2024,11,HYDERABAD,MUMBAI,98997,97302,HYDERABAD-MUMBAI,196299,All
2024,12,HYDERABAD,MUMBAI,99982,106152,HYDERABAD-MUMBAI,206134,All
2025,1,HYDERABAD,MUMBAI,96955,101542,HYDERABAD-MUMBAI,198497,All
2025,2,HYDERABAD,MUMBAI,88795,97707,HYDERABAD-MUMBAI,186502,All
2025,3,HYDERABAD,MUMBAI,81610,90547,HYDERABAD-MUMBAI,172157,All
2019,7,HYDERABAD,MYSORE,764,636,HYDERABAD-MYSORE,1400,All
2019,8,HYDERABAD,MYSORE,1670,1714,HYDERABAD-MYSORE,3384,All
2019,9,HYDERABAD,MYSORE,1579,1593,HYDERABAD-MYSORE,3172,All
2019,10,HYDERABAD,MYSORE,1937,2020,HYDERABAD-MYSORE,3957,All
2019,11,HYDERABAD,MYSORE,3444,2975,HYDERABAD-MYSORE,6419,All
2019,12,HYDERABAD,MYSORE,3817,3783,HYDERABAD-MYSORE,7600,All
2020,1,HYDERABAD,MYSORE,3412,3399,HYDERABAD-MYSORE,6811,All
2020,2,HYDERABAD,MYSORE,3302,2798,HYDERABAD-MYSORE,6100,All
2020,3,HYDERABAD,MYSORE,1886,2081,HYDERABAD-MYSORE,3967,All
2020,5,HYDERABAD,MYSORE,95,81,HYDERABAD-MYSORE,176,All
2020,6,HYDERABAD,MYSORE,493,442,HYDERABAD-MYSORE,935,All
2020,7,HYDERABAD,MYSORE,399,471,HYDERABAD-MYSORE,870,All
2020,8,HYDERABAD,MYSORE,746,643,HYDERABAD-MYSORE,1389,All
2020,9,HYDERABAD,MYSORE,882,829,HYDERABAD-MYSORE,1711,All
2020,10,HYDERABAD,MYSORE,962,985,HYDERABAD-MYSORE,1947,All
2020,11,HYDERABAD,MYSORE,1299,1279,HYDERABAD-MYSORE,2578,All
2020,12,HYDERABAD,MYSORE,1459,1391,HYDERABAD-MYSORE,2850,All
2021,1,HYDERABAD,MYSORE,2340,2234,HYDERABAD-MYSORE,4574,All
2021,2,HYDERABAD,MYSORE,2234,2221,HYDERABAD-MYSORE,4455,All
2021,3,HYDERABAD,MYSORE,2682,2600,HYDERABAD-MYSORE,5282,All
2021,4,HYDERABAD,MYSORE,1517,1781,HYDERABAD-MYSORE,3298,All
2021,6,HYDERABAD,MYSORE,951,902,HYDERABAD-MYSORE,1853,All
2021,7,HYDERABAD,MYSORE,2244,1922,HYDERABAD-MYSORE,4166,All
2021,8,HYDERABAD,MYSORE,2640,2411,HYDERABAD-MYSORE,5051,All
2021,9,HYDERABAD,MYSORE,2560,2391,HYDERABAD-MYSORE,4951,All
2021,10,HYDERABAD,MYSORE,2818,2494,HYDERABAD-MYSORE,5312,All
2021,11,HYDERABAD,MYSORE,2895,2661,HYDERABAD-MYSORE,5556,All
2021,12,HYDERABAD,MYSORE,3035,2732,HYDERABAD-MYSORE,5767,All
2022,1,HYDERABAD,MYSORE,1589,1689,HYDERABAD-MYSORE,3278,All
2022,2,HYDERABAD,MYSORE,1771,1617,HYDERABAD-MYSORE,3388,All
2022,3,HYDERABAD,MYSORE,2961,2770,HYDERABAD-MYSORE,5731,All
2022,4,HYDERABAD,MYSORE,2846,2770,HYDERABAD-MYSORE,5616,All
2022,5,HYDERABAD,MYSORE,2963,3072,HYDERABAD-MYSORE,6035,All
2022,6,HYDERABAD,MYSORE,2805,2738,HYDERABAD-MYSORE,5543,All
2022,7,HYDERABAD,MYSORE,2838,2570,HYDERABAD-MYSORE,5408,All
2022,8,HYDERABAD,MYSORE,3127,2741,HYDERABAD-MYSORE,5868,All
2022,9,HYDERABAD,MYSORE,2917,2475,HYDERABAD-MYSORE,5392,All
2022,10,HYDERABAD,MYSORE,3135,2770,HYDERABAD-MYSORE,5905,All
2022,11,HYDERABAD,MYSORE,3165,2807,HYDERABAD-MYSORE,5972,All
2022,12,HYDERABAD,MYSORE,3603,3415,HYDERABAD-MYSORE,7018,All
2023,1,HYDERABAD,MYSORE,3294,3293,HYDERABAD-MYSORE,6587,All
2023,2,HYDERABAD,MYSORE,3031,2862,HYDERABAD-MYSORE,5893,All
2023,3,HYDERABAD,MYSORE,2766,2805,HYDERABAD-MYSORE,5571,All
2023,4,HYDERABAD,MYSORE,3262,3020,HYDERABAD-MYSORE,6282,All
2023,5,HYDERABAD,MYSORE,3954,3599,HYDERABAD-MYSORE,7553,All
2023,6,HYDERABAD,MYSORE,3194,3167,HYDERABAD-MYSORE,6361,All
2023,7,HYDERABAD,MYSORE,2645,3136,HYDERABAD-MYSORE,5781,All
2023,8,HYDERABAD,MYSORE,2422,2830,HYDERABAD-MYSORE,5252,All
2023,9,HYDERABAD,MYSORE,2374,2141,HYDERABAD-MYSORE,4515,All
2023,10,HYDERABAD,MYSORE,2606,2481,HYDERABAD-MYSORE,5087,All
2023,11,HYDERABAD,MYSORE,2418,2169,HYDERABAD-MYSORE,4587,All
2023,12,HYDERABAD,MYSORE,2826,2415,HYDERABAD-MYSORE,5241,All
2024,1,HYDERABAD,MYSORE,2631,2488,HYDERABAD-MYSORE,5119,All
2024,2,HYDERABAD,MYSORE,2113,1891,HYDERABAD-MYSORE,4004,All
2024,3,HYDERABAD,MYSORE,2023,1942,HYDERABAD-MYSORE,3965,All
2024,4,HYDERABAD,MYSORE,1952,1651,HYDERABAD-MYSORE,3603,All
2024,6,HYDERABAD,MYSORE,2099,1686,HYDERABAD-MYSORE,3785,All
2024,7,HYDERABAD,MYSORE,2152,1771,HYDERABAD-MYSORE,3923,All
2024,8,HYDERABAD,MYSORE,1994,1640,HYDERABAD-MYSORE,3634,All
2024,9,HYDERABAD,MYSORE,1836,1534,HYDERABAD-MYSORE,3370,All
2024,10,HYDERABAD,MYSORE,1957,1725,HYDERABAD-MYSORE,3682,All
2024,11,HYDERABAD,MYSORE,2066,1820,HYDERABAD-MYSORE,3886,All
2024,12,HYDERABAD,MYSORE,1991,2077,HYDERABAD-MYSORE,4068,All
2025,1,HYDERABAD,MYSORE,2092,1992,HYDERABAD-MYSORE,4084,All
2025,2,HYDERABAD,MYSORE,1789,1804,HYDERABAD-MYSORE,3593,All
2025,3,HYDERABAD,MYSORE,1996,1724,HYDERABAD-MYSORE,3720,All
2024,3,HYDERABAD,Malvan,39,46,HYDERABAD-Malvan,85,All
2024,4,HYDERABAD,Malvan,59,99,HYDERABAD-Malvan,158,All
2024,6,HYDERABAD,Malvan,124,149,HYDERABAD-Malvan,273,All
2024,7,HYDERABAD,Malvan,29,60,HYDERABAD-Malvan,89,All
2024,8,HYDERABAD,Malvan,61,86,HYDERABAD-Malvan,147,All
2024,9,HYDERABAD,Malvan,34,106,HYDERABAD-Malvan,140,All
2024,10,HYDERABAD,Malvan,109,75,HYDERABAD-Malvan,184,All
2016,3,HYDERABAD,NAGPUR,250,321,HYDERABAD-NAGPUR,571,All
2016,4,HYDERABAD,NAGPUR,875,1054,HYDERABAD-NAGPUR,1929,All
2016,5,HYDERABAD,NAGPUR,1259,1955,HYDERABAD-NAGPUR,3214,All
2016,6,HYDERABAD,NAGPUR,1328,1819,HYDERABAD-NAGPUR,3147,All
2016,7,HYDERABAD,NAGPUR,2285,3290,HYDERABAD-NAGPUR,5575,All
2016,8,HYDERABAD,NAGPUR,2360,3000,HYDERABAD-NAGPUR,5360,All
2016,9,HYDERABAD,NAGPUR,2183,2379,HYDERABAD-NAGPUR,4562,All
2016,10,HYDERABAD,NAGPUR,3177,3258,HYDERABAD-NAGPUR,6435,All
2016,11,HYDERABAD,NAGPUR,3124,4298,HYDERABAD-NAGPUR,7422,All
2016,12,HYDERABAD,NAGPUR,1920,2521,HYDERABAD-NAGPUR,4441,All
2017,1,HYDERABAD,NAGPUR,568,505,HYDERABAD-NAGPUR,1073,All
2017,2,HYDERABAD,NAGPUR,89,0,HYDERABAD-NAGPUR,89,All
2017,3,HYDERABAD,NAGPUR,191,0,HYDERABAD-NAGPUR,191,All
2017,12,HYDERABAD,NAGPUR,695,703,HYDERABAD-NAGPUR,1398,All
2018,1,HYDERABAD,NAGPUR,1764,1753,HYDERABAD-NAGPUR,3517,All
2018,2,HYDERABAD,NAGPUR,1673,1761,HYDERABAD-NAGPUR,3434,All
2018,3,HYDERABAD,NAGPUR,1837,1937,HYDERABAD-NAGPUR,3774,All
2018,4,HYDERABAD,NAGPUR,1997,2086,HYDERABAD-NAGPUR,4083,All
2018,5,HYDERABAD,NAGPUR,3310,4183,HYDERABAD-NAGPUR,7493,All
2018,6,HYDERABAD,NAGPUR,2659,2347,HYDERABAD-NAGPUR,5006,All
2018,7,HYDERABAD,NAGPUR,2731,3056,HYDERABAD-NAGPUR,5787,All
2018,8,HYDERABAD,NAGPUR,2610,2571,HYDERABAD-NAGPUR,5181,All
2018,9,HYDERABAD,NAGPUR,2780,3033,HYDERABAD-NAGPUR,5813,All
2018,10,HYDERABAD,NAGPUR,3401,3305,HYDERABAD-NAGPUR,6706,All
2018,11,HYDERABAD,NAGPUR,3590,3752,HYDERABAD-NAGPUR,7342,All
2018,12,HYDERABAD,NAGPUR,3709,3923,HYDERABAD-NAGPUR,7632,All
2019,1,HYDERABAD,NAGPUR,3750,3901,HYDERABAD-NAGPUR,7651,All
2019,2,HYDERABAD,NAGPUR,3614,3577,HYDERABAD-NAGPUR,7191,All
2019,3,HYDERABAD,NAGPUR,3343,3316,HYDERABAD-NAGPUR,6659,All
2019,4,HYDERABAD,NAGPUR,3455,3429,HYDERABAD-NAGPUR,6884,All
2019,5,HYDERABAD,NAGPUR,3472,3895,HYDERABAD-NAGPUR,7367,All
2019,6,HYDERABAD,NAGPUR,2876,3227,HYDERABAD-NAGPUR,6103,All
2019,7,HYDERABAD,NAGPUR,2892,3117,HYDERABAD-NAGPUR,6009,All
2019,8,HYDERABAD,NAGPUR,2255,2327,HYDERABAD-NAGPUR,4582,All
2019,9,HYDERABAD,NAGPUR,1772,1863,HYDERABAD-NAGPUR,3635,All
2019,10,HYDERABAD,NAGPUR,2888,2961,HYDERABAD-NAGPUR,5849,All
2019,11,HYDERABAD,NAGPUR,1762,1810,HYDERABAD-NAGPUR,3572,All
2019,12,HYDERABAD,NAGPUR,2147,2179,HYDERABAD-NAGPUR,4326,All
2020,1,HYDERABAD,NAGPUR,2203,2288,HYDERABAD-NAGPUR,4491,All
2020,2,HYDERABAD,NAGPUR,1965,2037,HYDERABAD-NAGPUR,4002,All
2020,3,HYDERABAD,NAGPUR,942,889,HYDERABAD-NAGPUR,1831,All
2020,6,HYDERABAD,NAGPUR,47,0,HYDERABAD-NAGPUR,47,All
2020,7,HYDERABAD,NAGPUR,0,17,HYDERABAD-NAGPUR,17,All
2020,8,HYDERABAD,NAGPUR,159,224,HYDERABAD-NAGPUR,383,All
2020,9,HYDERABAD,NAGPUR,748,1334,HYDERABAD-NAGPUR,2082,All
2020,10,HYDERABAD,NAGPUR,1540,1843,HYDERABAD-NAGPUR,3383,All
2020,11,HYDERABAD,NAGPUR,2105,2094,HYDERABAD-NAGPUR,4199,All
2020,12,HYDERABAD,NAGPUR,1938,2052,HYDERABAD-NAGPUR,3990,All
2021,1,HYDERABAD,NAGPUR,1521,1768,HYDERABAD-NAGPUR,3289,All
2021,2,HYDERABAD,NAGPUR,1548,1786,HYDERABAD-NAGPUR,3334,All
2021,3,HYDERABAD,NAGPUR,1104,1370,HYDERABAD-NAGPUR,2474,All
2021,4,HYDERABAD,NAGPUR,964,956,HYDERABAD-NAGPUR,1920,All
2021,6,HYDERABAD,NAGPUR,851,727,HYDERABAD-NAGPUR,1578,All
2021,7,HYDERABAD,NAGPUR,1549,1482,HYDERABAD-NAGPUR,3031,All
2021,8,HYDERABAD,NAGPUR,1733,1809,HYDERABAD-NAGPUR,3542,All
2021,9,HYDERABAD,NAGPUR,1367,1758,HYDERABAD-NAGPUR,3125,All
2021,10,HYDERABAD,NAGPUR,1928,1896,HYDERABAD-NAGPUR,3824,All
2021,11,HYDERABAD,NAGPUR,1790,1877,HYDERABAD-NAGPUR,3667,All
2021,12,HYDERABAD,NAGPUR,1959,2074,HYDERABAD-NAGPUR,4033,All
2022,1,HYDERABAD,NAGPUR,1070,1300,HYDERABAD-NAGPUR,2370,All
2022,2,HYDERABAD,NAGPUR,814,860,HYDERABAD-NAGPUR,1674,All
2022,3,HYDERABAD,NAGPUR,2030,2188,HYDERABAD-NAGPUR,4218,All
2022,4,HYDERABAD,NAGPUR,1908,2074,HYDERABAD-NAGPUR,3982,All
2022,5,HYDERABAD,NAGPUR,1931,1965,HYDERABAD-NAGPUR,3896,All
2022,6,HYDERABAD,NAGPUR,1749,1828,HYDERABAD-NAGPUR,3577,All
2022,7,HYDERABAD,NAGPUR,1946,2082,HYDERABAD-NAGPUR,4028,All
2022,8,HYDERABAD,NAGPUR,2176,2274,HYDERABAD-NAGPUR,4450,All
2022,9,HYDERABAD,NAGPUR,2225,2351,HYDERABAD-NAGPUR,4576,All
2022,10,HYDERABAD,NAGPUR,2464,2457,HYDERABAD-NAGPUR,4921,All
2022,11,HYDERABAD,NAGPUR,2230,2276,HYDERABAD-NAGPUR,4506,All
2022,12,HYDERABAD,NAGPUR,2156,2288,HYDERABAD-NAGPUR,4444,All
2023,1,HYDERABAD,NAGPUR,2144,2184,HYDERABAD-NAGPUR,4328,All
2023,2,HYDERABAD,NAGPUR,1949,2004,HYDERABAD-NAGPUR,3953,All
2023,3,HYDERABAD,NAGPUR,2656,3040,HYDERABAD-NAGPUR,5696,All
2023,4,HYDERABAD,NAGPUR,3788,3816,HYDERABAD-NAGPUR,7604,All
2023,5,HYDERABAD,NAGPUR,3770,4202,HYDERABAD-NAGPUR,7972,All
2023,6,HYDERABAD,NAGPUR,2015,2185,HYDERABAD-NAGPUR,4200,All
2023,7,HYDERABAD,NAGPUR,2052,2235,HYDERABAD-NAGPUR,4287,All
2023,8,HYDERABAD,NAGPUR,2185,2350,HYDERABAD-NAGPUR,4535,All
2023,9,HYDERABAD,NAGPUR,1990,2186,HYDERABAD-NAGPUR,4176,All
2023,10,HYDERABAD,NAGPUR,3248,3173,HYDERABAD-NAGPUR,6421,All
2023,11,HYDERABAD,NAGPUR,4505,4350,HYDERABAD-NAGPUR,8855,All
2023,12,HYDERABAD,NAGPUR,5322,5777,HYDERABAD-NAGPUR,11099,All
2024,1,HYDERABAD,NAGPUR,5270,5541,HYDERABAD-NAGPUR,10811,All
2024,2,HYDERABAD,NAGPUR,5146,5217,HYDERABAD-NAGPUR,10363,All
2024,3,HYDERABAD,NAGPUR,4876,4864,HYDERABAD-NAGPUR,9740,All
2024,4,HYDERABAD,NAGPUR,4101,4087,HYDERABAD-NAGPUR,8188,All
2024,6,HYDERABAD,NAGPUR,4179,4246,HYDERABAD-NAGPUR,8425,All
2024,7,HYDERABAD,NAGPUR,3867,4304,HYDERABAD-NAGPUR,8171,All
2024,8,HYDERABAD,NAGPUR,4072,4239,HYDERABAD-NAGPUR,8311,All
2024,9,HYDERABAD,NAGPUR,3889,4123,HYDERABAD-NAGPUR,8012,All
2024,10,HYDERABAD,NAGPUR,3910,3947,HYDERABAD-NAGPUR,7857,All
2024,11,HYDERABAD,NAGPUR,4038,4381,HYDERABAD-NAGPUR,8419,All
2024,12,HYDERABAD,NAGPUR,4645,5115,HYDERABAD-NAGPUR,9760,All
2025,1,HYDERABAD,NAGPUR,5143,6153,HYDERABAD-NAGPUR,11296,All
2025,2,HYDERABAD,NAGPUR,4202,4107,HYDERABAD-NAGPUR,8309,All
2025,3,HYDERABAD,NAGPUR,4093,4306,HYDERABAD-NAGPUR,8399,All
2017,4,HYDERABAD,NANDED,121,149,HYDERABAD-NANDED,270,All
2017,5,HYDERABAD,NANDED,1043,1201,HYDERABAD-NANDED,2244,All
2017,6,HYDERABAD,NANDED,909,999,HYDERABAD-NANDED,1908,All
2017,7,HYDERABAD,NANDED,870,1020,HYDERABAD-NANDED,1890,All
2017,8,HYDERABAD,NANDED,1260,1238,HYDERABAD-NANDED,2498,All
2017,9,HYDERABAD,NANDED,1176,1103,HYDERABAD-NANDED,2279,All
2017,10,HYDERABAD,NANDED,1022,1072,HYDERABAD-NANDED,2094,All
2017,11,HYDERABAD,NANDED,497,635,HYDERABAD-NANDED,1132,All
2017,12,HYDERABAD,NANDED,1276,1497,HYDERABAD-NANDED,2773,All
2018,1,HYDERABAD,NANDED,1456,1646,HYDERABAD-NANDED,3102,All
2018,2,HYDERABAD,NANDED,1407,1563,HYDERABAD-NANDED,2970,All
2018,3,HYDERABAD,NANDED,1520,1584,HYDERABAD-NANDED,3104,All
2018,4,HYDERABAD,NANDED,1430,1543,HYDERABAD-NANDED,2973,All
2018,5,HYDERABAD,NANDED,1466,1803,HYDERABAD-NANDED,3269,All
2018,6,HYDERABAD,NANDED,1410,1594,HYDERABAD-NANDED,3004,All
2018,7,HYDERABAD,NANDED,1315,1610,HYDERABAD-NANDED,2925,All
2018,8,HYDERABAD,NANDED,1448,1703,HYDERABAD-NANDED,3151,All
2018,9,HYDERABAD,NANDED,1497,1540,HYDERABAD-NANDED,3037,All
2018,10,HYDERABAD,NANDED,1428,1542,HYDERABAD-NANDED,2970,All
2018,11,HYDERABAD,NANDED,1554,1567,HYDERABAD-NANDED,3121,All
2018,12,HYDERABAD,NANDED,1509,1693,HYDERABAD-NANDED,3202,All
2019,1,HYDERABAD,NANDED,1283,1639,HYDERABAD-NANDED,2922,All
2019,2,HYDERABAD,NANDED,1250,1520,HYDERABAD-NANDED,2770,All
2019,3,HYDERABAD,NANDED,1377,1386,HYDERABAD-NANDED,2763,All
2019,4,HYDERABAD,NANDED,1308,1445,HYDERABAD-NANDED,2753,All
2019,5,HYDERABAD,NANDED,1383,1686,HYDERABAD-NANDED,3069,All
2019,6,HYDERABAD,NANDED,1587,1712,HYDERABAD-NANDED,3299,All
2019,7,HYDERABAD,NANDED,1272,1403,HYDERABAD-NANDED,2675,All
2019,8,HYDERABAD,NANDED,1630,1290,HYDERABAD-NANDED,2920,All
2019,9,HYDERABAD,NANDED,979,825,HYDERABAD-NANDED,1804,All
2019,10,HYDERABAD,NANDED,1292,1272,HYDERABAD-NANDED,2564,All
2019,11,HYDERABAD,NANDED,1496,1427,HYDERABAD-NANDED,2923,All
2019,12,HYDERABAD,NANDED,1596,1830,HYDERABAD-NANDED,3426,All
2020,1,HYDERABAD,NANDED,1617,1610,HYDERABAD-NANDED,3227,All
2020,2,HYDERABAD,NANDED,1688,1541,HYDERABAD-NANDED,3229,All
2020,3,HYDERABAD,NANDED,1389,1173,HYDERABAD-NANDED,2562,All
2020,6,HYDERABAD,NANDED,110,114,HYDERABAD-NANDED,224,All
2020,7,HYDERABAD,NANDED,179,218,HYDERABAD-NANDED,397,All
2020,8,HYDERABAD,NANDED,243,238,HYDERABAD-NANDED,481,All
2020,9,HYDERABAD,NANDED,237,280,HYDERABAD-NANDED,517,All
2020,10,HYDERABAD,NANDED,265,330,HYDERABAD-NANDED,595,All
2020,11,HYDERABAD,NANDED,258,283,HYDERABAD-NANDED,541,All
2020,12,HYDERABAD,NANDED,332,348,HYDERABAD-NANDED,680,All
2021,1,HYDERABAD,NANDED,305,393,HYDERABAD-NANDED,698,All
2021,2,HYDERABAD,NANDED,444,524,HYDERABAD-NANDED,968,All
2021,3,HYDERABAD,NANDED,316,391,HYDERABAD-NANDED,707,All
2021,4,HYDERABAD,NANDED,114,123,HYDERABAD-NANDED,237,All
2021,6,HYDERABAD,NANDED,174,157,HYDERABAD-NANDED,331,All
2021,7,HYDERABAD,NANDED,158,136,HYDERABAD-NANDED,294,All
2021,8,HYDERABAD,NANDED,333,446,HYDERABAD-NANDED,779,All
2021,9,HYDERABAD,NANDED,102,163,HYDERABAD-NANDED,265,All
2021,10,HYDERABAD,NANDED,214,195,HYDERABAD-NANDED,409,All
2021,11,HYDERABAD,NANDED,87,37,HYDERABAD-NANDED,124,All
2022,2,HYDERABAD,NANDED,120,161,HYDERABAD-NANDED,281,All
2024,3,HYDERABAD,NANDED,33,45,HYDERABAD-NANDED,78,All
2024,4,HYDERABAD,NANDED,781,927,HYDERABAD-NANDED,1708,All
2024,6,HYDERABAD,NANDED,804,1151,HYDERABAD-NANDED,1955,All
2024,7,HYDERABAD,NANDED,623,638,HYDERABAD-NANDED,1261,All
2024,8,HYDERABAD,NANDED,803,912,HYDERABAD-NANDED,1715,All
2024,9,HYDERABAD,NANDED,797,703,HYDERABAD-NANDED,1500,All
2024,10,HYDERABAD,NANDED,897,986,HYDERABAD-NANDED,1883,All
2024,11,HYDERABAD,NANDED,910,956,HYDERABAD-NANDED,1866,All
2024,12,HYDERABAD,NANDED,1033,943,HYDERABAD-NANDED,1976,All
2025,1,HYDERABAD,NANDED,878,923,HYDERABAD-NANDED,1801,All
2025,2,HYDERABAD,NANDED,711,832,HYDERABAD-NANDED,1543,All
2025,3,HYDERABAD,NANDED,945,989,HYDERABAD-NANDED,1934,All
2019,2,HYDERABAD,NASIK,2252,207,HYDERABAD-NASIK,2459,All
2019,3,HYDERABAD,NASIK,1032,1010,HYDERABAD-NASIK,2042,All
2019,4,HYDERABAD,NASIK,1395,1381,HYDERABAD-NASIK,2776,All
2019,5,HYDERABAD,NASIK,1473,1477,HYDERABAD-NASIK,2950,All
2019,6,HYDERABAD,NASIK,1427,1346,HYDERABAD-NASIK,2773,All
2019,7,HYDERABAD,NASIK,1307,1306,HYDERABAD-NASIK,2613,All
2019,8,HYDERABAD,NASIK,1319,1248,HYDERABAD-NASIK,2567,All
2019,9,HYDERABAD,NASIK,1048,936,HYDERABAD-NASIK,1984,All
2019,10,HYDERABAD,NASIK,1154,1265,HYDERABAD-NASIK,2419,All
2019,11,HYDERABAD,NASIK,1693,1519,HYDERABAD-NASIK,3212,All
2019,12,HYDERABAD,NASIK,1643,1762,HYDERABAD-NASIK,3405,All
2020,1,HYDERABAD,NASIK,1465,1603,HYDERABAD-NASIK,3068,All
2020,2,HYDERABAD,NASIK,1501,1459,HYDERABAD-NASIK,2960,All
2020,3,HYDERABAD,NASIK,919,878,HYDERABAD-NASIK,1797,All
2020,6,HYDERABAD,NASIK,475,328,HYDERABAD-NASIK,803,All
2020,7,HYDERABAD,NASIK,801,612,HYDERABAD-NASIK,1413,All
2020,8,HYDERABAD,NASIK,805,808,HYDERABAD-NASIK,1613,All
2020,9,HYDERABAD,NASIK,861,755,HYDERABAD-NASIK,1616,All
2020,10,HYDERABAD,NASIK,1014,960,HYDERABAD-NASIK,1974,All
2020,11,HYDERABAD,NASIK,1505,1411,HYDERABAD-NASIK,2916,All
2020,12,HYDERABAD,NASIK,1769,1713,HYDERABAD-NASIK,3482,All
2021,1,HYDERABAD,NASIK,1734,1751,HYDERABAD-NASIK,3485,All
2021,2,HYDERABAD,NASIK,1324,1272,HYDERABAD-NASIK,2596,All
2021,3,HYDERABAD,NASIK,1058,1142,HYDERABAD-NASIK,2200,All
2021,4,HYDERABAD,NASIK,460,371,HYDERABAD-NASIK,831,All
2021,11,HYDERABAD,NASIK,0,51,HYDERABAD-NASIK,51,All
2022,7,HYDERABAD,NASIK,589,593,HYDERABAD-NASIK,1182,All
2022,8,HYDERABAD,NASIK,2025,1951,HYDERABAD-NASIK,3976,All
2022,9,HYDERABAD,NASIK,1840,1723,HYDERABAD-NASIK,3563,All
2022,10,HYDERABAD,NASIK,1899,2197,HYDERABAD-NASIK,4096,All
2022,11,HYDERABAD,NASIK,849,773,HYDERABAD-NASIK,1622,All
2022,12,HYDERABAD,NASIK,1742,1747,HYDERABAD-NASIK,3489,All
2023,1,HYDERABAD,NASIK,1745,1775,HYDERABAD-NASIK,3520,All
2023,2,HYDERABAD,NASIK,1414,1306,HYDERABAD-NASIK,2720,All
2023,3,HYDERABAD,NASIK,1501,1481,HYDERABAD-NASIK,2982,All
2023,5,HYDERABAD,NASIK,339,313,HYDERABAD-NASIK,652,All
2023,6,HYDERABAD,NASIK,1789,1969,HYDERABAD-NASIK,3758,All
2023,7,HYDERABAD,NASIK,1849,1935,HYDERABAD-NASIK,3784,All
2023,8,HYDERABAD,NASIK,1870,1935,HYDERABAD-NASIK,3805,All
2023,9,HYDERABAD,NASIK,1857,2050,HYDERABAD-NASIK,3907,All
2023,10,HYDERABAD,NASIK,2043,2072,HYDERABAD-NASIK,4115,All
2023,11,HYDERABAD,NASIK,2291,2445,HYDERABAD-NASIK,4736,All
2023,12,HYDERABAD,NASIK,2265,2393,HYDERABAD-NASIK,4658,All
2024,1,HYDERABAD,NASIK,2468,2464,HYDERABAD-NASIK,4932,All
2024,2,HYDERABAD,NASIK,2156,2183,HYDERABAD-NASIK,4339,All
2024,3,HYDERABAD,NASIK,2336,2461,HYDERABAD-NASIK,4797,All
2024,4,HYDERABAD,NASIK,2038,1891,HYDERABAD-NASIK,3929,All
2024,6,HYDERABAD,NASIK,2091,1950,HYDERABAD-NASIK,4041,All
2024,7,HYDERABAD,NASIK,2146,1848,HYDERABAD-NASIK,3994,All
2024,8,HYDERABAD,NASIK,2242,1858,HYDERABAD-NASIK,4100,All
2024,9,HYDERABAD,NASIK,1980,1823,HYDERABAD-NASIK,3803,All
2024,10,HYDERABAD,NASIK,1940,1845,HYDERABAD-NASIK,3785,All
2024,11,HYDERABAD,NASIK,2059,2079,HYDERABAD-NASIK,4138,All
2024,12,HYDERABAD,NASIK,1754,1879,HYDERABAD-NASIK,3633,All
2025,1,HYDERABAD,NASIK,2017,2036,HYDERABAD-NASIK,4053,All
2025,2,HYDERABAD,NASIK,1971,1950,HYDERABAD-NASIK,3921,All
2025,3,HYDERABAD,NASIK,2180,2202,HYDERABAD-NASIK,4382,All
2017,6,HYDERABAD,PATNA,114,0,HYDERABAD-PATNA,114,All
2017,7,HYDERABAD,PATNA,4307,5002,HYDERABAD-PATNA,9309,All
2017,8,HYDERABAD,PATNA,4652,4592,HYDERABAD-PATNA,9244,All
2017,9,HYDERABAD,PATNA,4460,3979,HYDERABAD-PATNA,8439,All
2017,10,HYDERABAD,PATNA,4136,3755,HYDERABAD-PATNA,7891,All
2017,11,HYDERABAD,PATNA,4177,4328,HYDERABAD-PATNA,8505,All
2017,12,HYDERABAD,PATNA,4091,4405,HYDERABAD-PATNA,8496,All
2018,1,HYDERABAD,PATNA,4467,3673,HYDERABAD-PATNA,8140,All
2018,2,HYDERABAD,PATNA,4599,3942,HYDERABAD-PATNA,8541,All
2018,3,HYDERABAD,PATNA,6836,6635,HYDERABAD-PATNA,13471,All
2018,4,HYDERABAD,PATNA,6559,5517,HYDERABAD-PATNA,12076,All
2018,5,HYDERABAD,PATNA,4738,4127,HYDERABAD-PATNA,8865,All
2018,6,HYDERABAD,PATNA,5057,4862,HYDERABAD-PATNA,9919,All
2018,7,HYDERABAD,PATNA,4190,4492,HYDERABAD-PATNA,8682,All
2018,8,HYDERABAD,PATNA,4712,4610,HYDERABAD-PATNA,9322,All
2018,9,HYDERABAD,PATNA,7125,7768,HYDERABAD-PATNA,14893,All
2018,10,HYDERABAD,PATNA,9000,8190,HYDERABAD-PATNA,17190,All
2018,11,HYDERABAD,PATNA,7491,7834,HYDERABAD-PATNA,15325,All
2018,12,HYDERABAD,PATNA,8080,8638,HYDERABAD-PATNA,16718,All
2019,1,HYDERABAD,PATNA,8206,7555,HYDERABAD-PATNA,15761,All
2019,2,HYDERABAD,PATNA,8563,8147,HYDERABAD-PATNA,16710,All
2019,3,HYDERABAD,PATNA,9011,8709,HYDERABAD-PATNA,17720,All
2019,4,HYDERABAD,PATNA,6574,5302,HYDERABAD-PATNA,11876,All
2019,5,HYDERABAD,PATNA,7399,7219,HYDERABAD-PATNA,14618,All
2019,6,HYDERABAD,PATNA,7733,8417,HYDERABAD-PATNA,16150,All
2019,7,HYDERABAD,PATNA,7785,7753,HYDERABAD-PATNA,15538,All
2019,8,HYDERABAD,PATNA,11867,11396,HYDERABAD-PATNA,23263,All
2019,9,HYDERABAD,PATNA,12981,11280,HYDERABAD-PATNA,24261,All
2019,10,HYDERABAD,PATNA,13480,10878,HYDERABAD-PATNA,24358,All
2019,11,HYDERABAD,PATNA,13246,14037,HYDERABAD-PATNA,27283,All
2019,12,HYDERABAD,PATNA,12614,13555,HYDERABAD-PATNA,26169,All
2020,1,HYDERABAD,PATNA,10040,9905,HYDERABAD-PATNA,19945,All
2020,2,HYDERABAD,PATNA,10038,9198,HYDERABAD-PATNA,19236,All
2020,3,HYDERABAD,PATNA,12599,10045,HYDERABAD-PATNA,22644,All
2020,5,HYDERABAD,PATNA,387,172,HYDERABAD-PATNA,559,All
2020,6,HYDERABAD,PATNA,4609,2641,HYDERABAD-PATNA,7250,All
2020,7,HYDERABAD,PATNA,10247,7017,HYDERABAD-PATNA,17264,All
2020,8,HYDERABAD,PATNA,7562,12013,HYDERABAD-PATNA,19575,All
2020,9,HYDERABAD,PATNA,7354,16483,HYDERABAD-PATNA,23837,All
2020,10,HYDERABAD,PATNA,11933,16545,HYDERABAD-PATNA,28478,All
2020,11,HYDERABAD,PATNA,18792,10520,HYDERABAD-PATNA,29312,All
2020,12,HYDERABAD,PATNA,26952,16140,HYDERABAD-PATNA,43092,All
2021,1,HYDERABAD,PATNA,9679,14153,HYDERABAD-PATNA,23832,All
2021,2,HYDERABAD,PATNA,9706,9024,HYDERABAD-PATNA,18730,All
2021,3,HYDERABAD,PATNA,9564,7283,HYDERABAD-PATNA,16847,All
2021,4,HYDERABAD,PATNA,13968,7865,HYDERABAD-PATNA,21833,All
2021,6,HYDERABAD,PATNA,5375,8559,HYDERABAD-PATNA,13934,All
2021,7,HYDERABAD,PATNA,6445,8007,HYDERABAD-PATNA,14452,All
2021,8,HYDERABAD,PATNA,6792,8719,HYDERABAD-PATNA,15511,All
2021,9,HYDERABAD,PATNA,5543,6022,HYDERABAD-PATNA,11565,All
2021,10,HYDERABAD,PATNA,10563,6929,HYDERABAD-PATNA,17492,All
2021,11,HYDERABAD,PATNA,16374,13469,HYDERABAD-PATNA,29843,All
2021,12,HYDERABAD,PATNA,9156,11305,HYDERABAD-PATNA,20461,All
2022,1,HYDERABAD,PATNA,6709,5050,HYDERABAD-PATNA,11759,All
2022,2,HYDERABAD,PATNA,6775,5897,HYDERABAD-PATNA,12672,All
2022,3,HYDERABAD,PATNA,10843,8355,HYDERABAD-PATNA,19198,All
2022,4,HYDERABAD,PATNA,12699,8605,HYDERABAD-PATNA,21304,All
2022,5,HYDERABAD,PATNA,11515,12149,HYDERABAD-PATNA,23664,All
2022,6,HYDERABAD,PATNA,9504,12003,HYDERABAD-PATNA,21507,All
2022,7,HYDERABAD,PATNA,8748,8524,HYDERABAD-PATNA,17272,All
2022,8,HYDERABAD,PATNA,6991,7830,HYDERABAD-PATNA,14821,All
2022,9,HYDERABAD,PATNA,9607,7057,HYDERABAD-PATNA,16664,All
2022,10,HYDERABAD,PATNA,14134,8099,HYDERABAD-PATNA,22233,All
2022,11,HYDERABAD,PATNA,9488,10433,HYDERABAD-PATNA,19921,All
2022,12,HYDERABAD,PATNA,9368,10128,HYDERABAD-PATNA,19496,All
2023,1,HYDERABAD,PATNA,9476,8070,HYDERABAD-PATNA,17546,All
2023,2,HYDERABAD,PATNA,10107,9090,HYDERABAD-PATNA,19197,All
2023,3,HYDERABAD,PATNA,9933,9891,HYDERABAD-PATNA,19824,All
2023,4,HYDERABAD,PATNA,10385,8003,HYDERABAD-PATNA,18388,All
2023,5,HYDERABAD,PATNA,10727,10701,HYDERABAD-PATNA,21428,All
2023,6,HYDERABAD,PATNA,9961,10053,HYDERABAD-PATNA,20014,All
2023,7,HYDERABAD,PATNA,7435,9745,HYDERABAD-PATNA,17180,All
2023,8,HYDERABAD,PATNA,8575,9218,HYDERABAD-PATNA,17793,All
2023,9,HYDERABAD,PATNA,8878,9649,HYDERABAD-PATNA,18527,All
2023,10,HYDERABAD,PATNA,12800,10295,HYDERABAD-PATNA,23095,All
2023,11,HYDERABAD,PATNA,12397,10324,HYDERABAD-PATNA,22721,All
2023,12,HYDERABAD,PATNA,12000,12481,HYDERABAD-PATNA,24481,All
2024,1,HYDERABAD,PATNA,9707,9134,HYDERABAD-PATNA,18841,All
2024,2,HYDERABAD,PATNA,10330,9492,HYDERABAD-PATNA,19822,All
2024,3,HYDERABAD,PATNA,10888,9525,HYDERABAD-PATNA,20413,All
2024,4,HYDERABAD,PATNA,10607,9381,HYDERABAD-PATNA,19988,All
2024,6,HYDERABAD,PATNA,9852,9985,HYDERABAD-PATNA,19837,All
2024,7,HYDERABAD,PATNA,9021,10603,HYDERABAD-PATNA,19624,All
2024,8,HYDERABAD,PATNA,9210,10103,HYDERABAD-PATNA,19313,All
2024,9,HYDERABAD,PATNA,13465,12656,HYDERABAD-PATNA,26121,All
2024,10,HYDERABAD,PATNA,17085,10491,HYDERABAD-PATNA,27576,All
2024,11,HYDERABAD,PATNA,18188,16406,HYDERABAD-PATNA,34594,All
2024,12,HYDERABAD,PATNA,15635,16406,HYDERABAD-PATNA,32041,All
2025,1,HYDERABAD,PATNA,18163,16938,HYDERABAD-PATNA,35101,All
2025,2,HYDERABAD,PATNA,23411,21744,HYDERABAD-PATNA,45155,All
2025,3,HYDERABAD,PATNA,22171,18921,HYDERABAD-PATNA,41092,All
2019,1,HYDERABAD,PONDICHERRY,2125,2247,HYDERABAD-PONDICHERRY,4372,All
2019,2,HYDERABAD,PONDICHERRY,1930,2013,HYDERABAD-PONDICHERRY,3943,All
2019,3,HYDERABAD,PONDICHERRY,2056,2216,HYDERABAD-PONDICHERRY,4272,All
2019,4,HYDERABAD,PONDICHERRY,1931,2115,HYDERABAD-PONDICHERRY,4046,All
2019,5,HYDERABAD,PONDICHERRY,2107,2194,HYDERABAD-PONDICHERRY,4301,All
2019,6,HYDERABAD,PONDICHERRY,2006,2035,HYDERABAD-PONDICHERRY,4041,All
2019,7,HYDERABAD,PONDICHERRY,1240,1200,HYDERABAD-PONDICHERRY,2440,All
2019,9,HYDERABAD,PONDICHERRY,423,367,HYDERABAD-PONDICHERRY,790,All
2019,10,HYDERABAD,PONDICHERRY,1795,1907,HYDERABAD-PONDICHERRY,3702,All
2019,11,HYDERABAD,PONDICHERRY,1573,1713,HYDERABAD-PONDICHERRY,3286,All
2019,12,HYDERABAD,PONDICHERRY,2191,2067,HYDERABAD-PONDICHERRY,4258,All
2020,1,HYDERABAD,PONDICHERRY,2257,2155,HYDERABAD-PONDICHERRY,4412,All
2020,2,HYDERABAD,PONDICHERRY,1998,2099,HYDERABAD-PONDICHERRY,4097,All
2020,3,HYDERABAD,PONDICHERRY,984,1178,HYDERABAD-PONDICHERRY,2162,All
2022,3,HYDERABAD,PONDICHERRY,225,264,HYDERABAD-PONDICHERRY,489,All
2022,4,HYDERABAD,PONDICHERRY,2159,2178,HYDERABAD-PONDICHERRY,4337,All
2022,5,HYDERABAD,PONDICHERRY,2266,2197,HYDERABAD-PONDICHERRY,4463,All
2022,6,HYDERABAD,PONDICHERRY,2526,2272,HYDERABAD-PONDICHERRY,4798,All
2022,7,HYDERABAD,PONDICHERRY,2415,2458,HYDERABAD-PONDICHERRY,4873,All
2022,8,HYDERABAD,PONDICHERRY,2447,2379,HYDERABAD-PONDICHERRY,4826,All
2022,9,HYDERABAD,PONDICHERRY,2256,2236,HYDERABAD-PONDICHERRY,4492,All
2022,10,HYDERABAD,PONDICHERRY,2107,2023,HYDERABAD-PONDICHERRY,4130,All
2022,11,HYDERABAD,PONDICHERRY,1554,1497,HYDERABAD-PONDICHERRY,3051,All
2022,12,HYDERABAD,PONDICHERRY,1924,1897,HYDERABAD-PONDICHERRY,3821,All
2023,1,HYDERABAD,PONDICHERRY,2463,2270,HYDERABAD-PONDICHERRY,4733,All
2023,2,HYDERABAD,PONDICHERRY,1847,1994,HYDERABAD-PONDICHERRY,3841,All
2023,3,HYDERABAD,PONDICHERRY,1913,1958,HYDERABAD-PONDICHERRY,3871,All
2023,4,HYDERABAD,PONDICHERRY,1635,1689,HYDERABAD-PONDICHERRY,3324,All
2023,5,HYDERABAD,PONDICHERRY,1832,1870,HYDERABAD-PONDICHERRY,3702,All
2023,6,HYDERABAD,PONDICHERRY,667,714,HYDERABAD-PONDICHERRY,1381,All
2023,10,HYDERABAD,PONDICHERRY,1869,1847,HYDERABAD-PONDICHERRY,3716,All
2023,11,HYDERABAD,PONDICHERRY,1335,1305,HYDERABAD-PONDICHERRY,2640,All
2023,12,HYDERABAD,PONDICHERRY,2323,2351,HYDERABAD-PONDICHERRY,4674,All
2024,1,HYDERABAD,PONDICHERRY,2433,2474,HYDERABAD-PONDICHERRY,4907,All
2024,2,HYDERABAD,PONDICHERRY,2090,2028,HYDERABAD-PONDICHERRY,4118,All
2024,3,HYDERABAD,PONDICHERRY,1981,2203,HYDERABAD-PONDICHERRY,4184,All
2024,12,HYDERABAD,PONDICHERRY,819,820,HYDERABAD-PONDICHERRY,1639,All
2025,1,HYDERABAD,PONDICHERRY,2208,2141,HYDERABAD-PONDICHERRY,4349,All
2025,2,HYDERABAD,PONDICHERRY,1984,1976,HYDERABAD-PONDICHERRY,3960,All
2025,3,HYDERABAD,PONDICHERRY,2078,2164,HYDERABAD-PONDICHERRY,4242,All
2015,12,HYDERABAD,PORT BLAIR,21,470,HYDERABAD-PORT BLAIR,491,All
2016,9,HYDERABAD,PORT BLAIR,14,4,HYDERABAD-PORT BLAIR,18,All
2016,10,HYDERABAD,PORT BLAIR,671,576,HYDERABAD-PORT BLAIR,1247,All
2016,11,HYDERABAD,PORT BLAIR,678,650,HYDERABAD-PORT BLAIR,1328,All
2016,12,HYDERABAD,PORT BLAIR,778,794,HYDERABAD-PORT BLAIR,1572,All
2017,1,HYDERABAD,PORT BLAIR,956,940,HYDERABAD-PORT BLAIR,1896,All
2017,2,HYDERABAD,PORT BLAIR,3342,3429,HYDERABAD-PORT BLAIR,6771,All
2017,3,HYDERABAD,PORT BLAIR,3178,3702,HYDERABAD-PORT BLAIR,6880,All
2017,4,HYDERABAD,PORT BLAIR,4401,4652,HYDERABAD-PORT BLAIR,9053,All
2017,5,HYDERABAD,PORT BLAIR,601,384,HYDERABAD-PORT BLAIR,985,All
2017,6,HYDERABAD,PORT BLAIR,599,743,HYDERABAD-PORT BLAIR,1342,All
2017,7,HYDERABAD,PORT BLAIR,342,441,HYDERABAD-PORT BLAIR,783,All
2017,8,HYDERABAD,PORT BLAIR,398,471,HYDERABAD-PORT BLAIR,869,All
2017,9,HYDERABAD,PORT BLAIR,281,407,HYDERABAD-PORT BLAIR,688,All
2017,10,HYDERABAD,PORT BLAIR,290,423,HYDERABAD-PORT BLAIR,713,All
2017,11,HYDERABAD,PORT BLAIR,471,438,HYDERABAD-PORT BLAIR,909,All
2017,12,HYDERABAD,PORT BLAIR,985,708,HYDERABAD-PORT BLAIR,1693,All
2018,1,HYDERABAD,PORT BLAIR,1080,736,HYDERABAD-PORT BLAIR,1816,All
2018,2,HYDERABAD,PORT BLAIR,831,742,HYDERABAD-PORT BLAIR,1573,All
2018,3,HYDERABAD,PORT BLAIR,627,658,HYDERABAD-PORT BLAIR,1285,All
2018,4,HYDERABAD,PORT BLAIR,486,470,HYDERABAD-PORT BLAIR,956,All
2018,5,HYDERABAD,PORT BLAIR,508,253,HYDERABAD-PORT BLAIR,761,All
2018,6,HYDERABAD,PORT BLAIR,429,566,HYDERABAD-PORT BLAIR,995,All
2018,7,HYDERABAD,PORT BLAIR,297,405,HYDERABAD-PORT BLAIR,702,All
2018,8,HYDERABAD,PORT BLAIR,383,464,HYDERABAD-PORT BLAIR,847,All
2018,9,HYDERABAD,PORT BLAIR,3118,2150,HYDERABAD-PORT BLAIR,5268,All
2018,10,HYDERABAD,PORT BLAIR,5364,5145,HYDERABAD-PORT BLAIR,10509,All
2018,11,HYDERABAD,PORT BLAIR,5751,4959,HYDERABAD-PORT BLAIR,10710,All
2018,12,HYDERABAD,PORT BLAIR,5820,5425,HYDERABAD-PORT BLAIR,11245,All
2019,1,HYDERABAD,PORT BLAIR,5607,5657,HYDERABAD-PORT BLAIR,11264,All
2019,2,HYDERABAD,PORT BLAIR,4886,4993,HYDERABAD-PORT BLAIR,9879,All
2019,3,HYDERABAD,PORT BLAIR,5155,5525,HYDERABAD-PORT BLAIR,10680,All
2019,4,HYDERABAD,PORT BLAIR,3940,4962,HYDERABAD-PORT BLAIR,8902,All
2019,5,HYDERABAD,PORT BLAIR,5052,5817,HYDERABAD-PORT BLAIR,10869,All
2019,6,HYDERABAD,PORT BLAIR,5090,4384,HYDERABAD-PORT BLAIR,9474,All
2019,7,HYDERABAD,PORT BLAIR,764,1142,HYDERABAD-PORT BLAIR,1906,All
2019,8,HYDERABAD,PORT BLAIR,4172,3437,HYDERABAD-PORT BLAIR,7609,All
2019,9,HYDERABAD,PORT BLAIR,4569,4217,HYDERABAD-PORT BLAIR,8786,All
2019,10,HYDERABAD,PORT BLAIR,4499,4176,HYDERABAD-PORT BLAIR,8675,All
2019,11,HYDERABAD,PORT BLAIR,4406,4465,HYDERABAD-PORT BLAIR,8871,All
2019,12,HYDERABAD,PORT BLAIR,5316,5460,HYDERABAD-PORT BLAIR,10776,All
2020,1,HYDERABAD,PORT BLAIR,4871,5467,HYDERABAD-PORT BLAIR,10338,All
2020,2,HYDERABAD,PORT BLAIR,4856,5266,HYDERABAD-PORT BLAIR,10122,All
2020,3,HYDERABAD,PORT BLAIR,2285,3144,HYDERABAD-PORT BLAIR,5429,All
2020,6,HYDERABAD,PORT BLAIR,328,320,HYDERABAD-PORT BLAIR,648,All
2020,7,HYDERABAD,PORT BLAIR,910,511,HYDERABAD-PORT BLAIR,1421,All
2020,8,HYDERABAD,PORT BLAIR,477,256,HYDERABAD-PORT BLAIR,733,All
2020,9,HYDERABAD,PORT BLAIR,500,213,HYDERABAD-PORT BLAIR,713,All
2020,10,HYDERABAD,PORT BLAIR,1108,917,HYDERABAD-PORT BLAIR,2025,All
2020,11,HYDERABAD,PORT BLAIR,1454,856,HYDERABAD-PORT BLAIR,2310,All
2020,12,HYDERABAD,PORT BLAIR,1797,1193,HYDERABAD-PORT BLAIR,2990,All
2021,1,HYDERABAD,PORT BLAIR,2664,1801,HYDERABAD-PORT BLAIR,4465,All
2021,2,HYDERABAD,PORT BLAIR,3216,2108,HYDERABAD-PORT BLAIR,5324,All
2021,3,HYDERABAD,PORT BLAIR,3192,2442,HYDERABAD-PORT BLAIR,5634,All
2021,4,HYDERABAD,PORT BLAIR,176,112,HYDERABAD-PORT BLAIR,288,All
2021,9,HYDERABAD,PORT BLAIR,151,73,HYDERABAD-PORT BLAIR,224,All
2021,10,HYDERABAD,PORT BLAIR,1441,1245,HYDERABAD-PORT BLAIR,2686,All
2021,11,HYDERABAD,PORT BLAIR,3180,2655,HYDERABAD-PORT BLAIR,5835,All
2021,12,HYDERABAD,PORT BLAIR,4919,3847,HYDERABAD-PORT BLAIR,8766,All
2022,1,HYDERABAD,PORT BLAIR,1804,2382,HYDERABAD-PORT BLAIR,4186,All
2022,2,HYDERABAD,PORT BLAIR,964,1037,HYDERABAD-PORT BLAIR,2001,All
2022,3,HYDERABAD,PORT BLAIR,1373,1646,HYDERABAD-PORT BLAIR,3019,All
2022,4,HYDERABAD,PORT BLAIR,1879,1852,HYDERABAD-PORT BLAIR,3731,All
2022,5,HYDERABAD,PORT BLAIR,2140,2193,HYDERABAD-PORT BLAIR,4333,All
2022,10,HYDERABAD,PORT BLAIR,309,370,HYDERABAD-PORT BLAIR,679,All
2022,11,HYDERABAD,PORT BLAIR,3031,3218,HYDERABAD-PORT BLAIR,6249,All
2022,12,HYDERABAD,PORT BLAIR,5229,4981,HYDERABAD-PORT BLAIR,10210,All
2023,1,HYDERABAD,PORT BLAIR,5494,6231,HYDERABAD-PORT BLAIR,11725,All
2023,2,HYDERABAD,PORT BLAIR,4425,4712,HYDERABAD-PORT BLAIR,9137,All
2023,3,HYDERABAD,PORT BLAIR,3984,4412,HYDERABAD-PORT BLAIR,8396,All
2023,4,HYDERABAD,PORT BLAIR,3375,3995,HYDERABAD-PORT BLAIR,7370,All
2023,5,HYDERABAD,PORT BLAIR,3898,4171,HYDERABAD-PORT BLAIR,8069,All
2023,6,HYDERABAD,PORT BLAIR,2011,2127,HYDERABAD-PORT BLAIR,4138,All
2023,8,HYDERABAD,PORT BLAIR,1445,1363,HYDERABAD-PORT BLAIR,2808,All
2023,9,HYDERABAD,PORT BLAIR,4670,4051,HYDERABAD-PORT BLAIR,8721,All
2023,10,HYDERABAD,PORT BLAIR,4920,4816,HYDERABAD-PORT BLAIR,9736,All
2023,11,HYDERABAD,PORT BLAIR,4052,4604,HYDERABAD-PORT BLAIR,8656,All
2023,12,HYDERABAD,PORT BLAIR,4980,5067,HYDERABAD-PORT BLAIR,10047,All
2024,1,HYDERABAD,PORT BLAIR,4692,4925,HYDERABAD-PORT BLAIR,9617,All
2024,2,HYDERABAD,PORT BLAIR,4661,4947,HYDERABAD-PORT BLAIR,9608,All
2024,3,HYDERABAD,PORT BLAIR,5123,5217,HYDERABAD-PORT BLAIR,10340,All
2024,4,HYDERABAD,PORT BLAIR,4134,4948,HYDERABAD-PORT BLAIR,9082,All
2024,6,HYDERABAD,PORT BLAIR,4137,4526,HYDERABAD-PORT BLAIR,8663,All
2024,7,HYDERABAD,PORT BLAIR,2177,2944,HYDERABAD-PORT BLAIR,5121,All
2024,8,HYDERABAD,PORT BLAIR,2637,2907,HYDERABAD-PORT BLAIR,5544,All
2024,9,HYDERABAD,PORT BLAIR,4355,4235,HYDERABAD-PORT BLAIR,8590,All
2024,10,HYDERABAD,PORT BLAIR,4950,5007,HYDERABAD-PORT BLAIR,9957,All
2024,11,HYDERABAD,PORT BLAIR,6125,5832,HYDERABAD-PORT BLAIR,11957,All
2024,12,HYDERABAD,PORT BLAIR,8494,8449,HYDERABAD-PORT BLAIR,16943,All
2025,1,HYDERABAD,PORT BLAIR,9645,11405,HYDERABAD-PORT BLAIR,21050,All
2025,2,HYDERABAD,PORT BLAIR,5457,6189,HYDERABAD-PORT BLAIR,11646,All
2025,3,HYDERABAD,PORT BLAIR,5708,6720,HYDERABAD-PORT BLAIR,12428,All
2017,8,HYDERABAD,PUDUCHERRY,1139,1069,HYDERABAD-PUDUCHERRY,2208,All
2017,9,HYDERABAD,PUDUCHERRY,2070,2030,HYDERABAD-PUDUCHERRY,4100,All
2017,10,HYDERABAD,PUDUCHERRY,1972,1815,HYDERABAD-PUDUCHERRY,3787,All
2017,11,HYDERABAD,PUDUCHERRY,1635,1568,HYDERABAD-PUDUCHERRY,3203,All
2017,12,HYDERABAD,PUDUCHERRY,2058,2122,HYDERABAD-PUDUCHERRY,4180,All
2018,1,HYDERABAD,PUDUCHERRY,2189,2323,HYDERABAD-PUDUCHERRY,4512,All
2018,2,HYDERABAD,PUDUCHERRY,1948,2075,HYDERABAD-PUDUCHERRY,4023,All
2018,3,HYDERABAD,PUDUCHERRY,2034,2139,HYDERABAD-PUDUCHERRY,4173,All
2018,4,HYDERABAD,PUDUCHERRY,1985,2149,HYDERABAD-PUDUCHERRY,4134,All
2018,5,HYDERABAD,PUDUCHERRY,2127,2217,HYDERABAD-PUDUCHERRY,4344,All
2018,6,HYDERABAD,PUDUCHERRY,1930,2152,HYDERABAD-PUDUCHERRY,4082,All
2018,7,HYDERABAD,PUDUCHERRY,1887,2199,HYDERABAD-PUDUCHERRY,4086,All
2018,8,HYDERABAD,PUDUCHERRY,2146,2027,HYDERABAD-PUDUCHERRY,4173,All
2018,9,HYDERABAD,PUDUCHERRY,1978,1874,HYDERABAD-PUDUCHERRY,3852,All
2018,10,HYDERABAD,PUDUCHERRY,2038,1949,HYDERABAD-PUDUCHERRY,3987,All
2018,11,HYDERABAD,PUDUCHERRY,1435,1618,HYDERABAD-PUDUCHERRY,3053,All
2018,12,HYDERABAD,PUDUCHERRY,1895,1960,HYDERABAD-PUDUCHERRY,3855,All
2015,4,HYDERABAD,PUNE,10013,8983,HYDERABAD-PUNE,18996,All
2015,5,HYDERABAD,PUNE,11062,10300,HYDERABAD-PUNE,21362,All
2015,6,HYDERABAD,PUNE,10232,9708,HYDERABAD-PUNE,19940,All
2015,7,HYDERABAD,PUNE,10385,10393,HYDERABAD-PUNE,20778,All
2015,8,HYDERABAD,PUNE,10564,9676,HYDERABAD-PUNE,20240,All
2015,9,HYDERABAD,PUNE,10022,9447,HYDERABAD-PUNE,19469,All
2015,10,HYDERABAD,PUNE,11888,10942,HYDERABAD-PUNE,22830,All
2015,11,HYDERABAD,PUNE,9904,9844,HYDERABAD-PUNE,19748,All
2015,12,HYDERABAD,PUNE,10328,10220,HYDERABAD-PUNE,20548,All
2016,1,HYDERABAD,PUNE,10031,10022,HYDERABAD-PUNE,20053,All
2016,2,HYDERABAD,PUNE,9670,9499,HYDERABAD-PUNE,19169,All
2016,3,HYDERABAD,PUNE,10048,9778,HYDERABAD-PUNE,19826,All
2016,4,HYDERABAD,PUNE,10609,11426,HYDERABAD-PUNE,22035,All
2016,5,HYDERABAD,PUNE,12654,13535,HYDERABAD-PUNE,26189,All
2016,6,HYDERABAD,PUNE,12132,13308,HYDERABAD-PUNE,25440,All
2016,7,HYDERABAD,PUNE,12726,13780,HYDERABAD-PUNE,26506,All
2016,8,HYDERABAD,PUNE,13496,13915,HYDERABAD-PUNE,27411,All
2016,9,HYDERABAD,PUNE,11274,12154,HYDERABAD-PUNE,23428,All
2016,10,HYDERABAD,PUNE,11932,13188,HYDERABAD-PUNE,25120,All
2016,11,HYDERABAD,PUNE,13148,13459,HYDERABAD-PUNE,26607,All
2016,12,HYDERABAD,PUNE,12549,13569,HYDERABAD-PUNE,26118,All
2017,1,HYDERABAD,PUNE,12821,13637,HYDERABAD-PUNE,26458,All
2017,2,HYDERABAD,PUNE,15531,15867,HYDERABAD-PUNE,31398,All
2017,3,HYDERABAD,PUNE,16354,17065,HYDERABAD-PUNE,33419,All
2017,4,HYDERABAD,PUNE,14430,15324,HYDERABAD-PUNE,29754,All
2017,5,HYDERABAD,PUNE,14993,15899,HYDERABAD-PUNE,30892,All
2017,6,HYDERABAD,PUNE,15854,16707,HYDERABAD-PUNE,32561,All
2017,7,HYDERABAD,PUNE,17837,20021,HYDERABAD-PUNE,37858,All
2017,8,HYDERABAD,PUNE,18188,20199,HYDERABAD-PUNE,38387,All
2017,9,HYDERABAD,PUNE,16452,18132,HYDERABAD-PUNE,34584,All
2017,10,HYDERABAD,PUNE,18043,21282,HYDERABAD-PUNE,39325,All
2017,11,HYDERABAD,PUNE,21713,22510,HYDERABAD-PUNE,44223,All
2017,12,HYDERABAD,PUNE,24578,25903,HYDERABAD-PUNE,50481,All
2018,1,HYDERABAD,PUNE,26518,27133,HYDERABAD-PUNE,53651,All
2018,2,HYDERABAD,PUNE,24982,25257,HYDERABAD-PUNE,50239,All
2018,3,HYDERABAD,PUNE,25913,24126,HYDERABAD-PUNE,50039,All
2018,4,HYDERABAD,PUNE,29732,28749,HYDERABAD-PUNE,58481,All
2018,5,HYDERABAD,PUNE,31745,30912,HYDERABAD-PUNE,62657,All
2018,6,HYDERABAD,PUNE,25584,24536,HYDERABAD-PUNE,50120,All
2018,7,HYDERABAD,PUNE,26355,25494,HYDERABAD-PUNE,51849,All
2018,8,HYDERABAD,PUNE,24376,24716,HYDERABAD-PUNE,49092,All
2018,9,HYDERABAD,PUNE,24450,23630,HYDERABAD-PUNE,48080,All
2018,10,HYDERABAD,PUNE,20960,21881,HYDERABAD-PUNE,42841,All
2018,11,HYDERABAD,PUNE,17402,15109,HYDERABAD-PUNE,32511,All
2018,12,HYDERABAD,PUNE,17042,14397,HYDERABAD-PUNE,31439,All
2019,1,HYDERABAD,PUNE,21162,21047,HYDERABAD-PUNE,42209,All
2019,2,HYDERABAD,PUNE,22371,19872,HYDERABAD-PUNE,42243,All
2019,3,HYDERABAD,PUNE,20405,20583,HYDERABAD-PUNE,40988,All
2019,4,HYDERABAD,PUNE,23367,24305,HYDERABAD-PUNE,47672,All
2019,5,HYDERABAD,PUNE,27102,27202,HYDERABAD-PUNE,54304,All
2019,6,HYDERABAD,PUNE,25660,24352,HYDERABAD-PUNE,50012,All
2019,7,HYDERABAD,PUNE,24194,24016,HYDERABAD-PUNE,48210,All
2019,8,HYDERABAD,PUNE,23902,24179,HYDERABAD-PUNE,48081,All
2019,9,HYDERABAD,PUNE,22363,22634,HYDERABAD-PUNE,44997,All
2019,10,HYDERABAD,PUNE,21213,24351,HYDERABAD-PUNE,45564,All
2019,11,HYDERABAD,PUNE,18270,16372,HYDERABAD-PUNE,34642,All
2019,12,HYDERABAD,PUNE,17328,16845,HYDERABAD-PUNE,34173,All
2020,1,HYDERABAD,PUNE,17234,16045,HYDERABAD-PUNE,33279,All
2020,2,HYDERABAD,PUNE,18862,17758,HYDERABAD-PUNE,36620,All
2020,3,HYDERABAD,PUNE,10704,10825,HYDERABAD-PUNE,21529,All
2020,5,HYDERABAD,PUNE,280,431,HYDERABAD-PUNE,711,All
2020,6,HYDERABAD,PUNE,2862,7059,HYDERABAD-PUNE,9921,All
2020,7,HYDERABAD,PUNE,5553,10417,HYDERABAD-PUNE,15970,All
2020,8,HYDERABAD,PUNE,8935,9974,HYDERABAD-PUNE,18909,All
2020,9,HYDERABAD,PUNE,8773,9247,HYDERABAD-PUNE,18020,All
2020,10,HYDERABAD,PUNE,9814,10284,HYDERABAD-PUNE,20098,All
2020,11,HYDERABAD,PUNE,9236,10687,HYDERABAD-PUNE,19923,All
2020,12,HYDERABAD,PUNE,10034,11209,HYDERABAD-PUNE,21243,All
2021,1,HYDERABAD,PUNE,10512,11574,HYDERABAD-PUNE,22086,All
2021,2,HYDERABAD,PUNE,9227,10829,HYDERABAD-PUNE,20056,All
2021,3,HYDERABAD,PUNE,6951,9156,HYDERABAD-PUNE,16107,All
2021,4,HYDERABAD,PUNE,4199,5634,HYDERABAD-PUNE,9833,All
2021,6,HYDERABAD,PUNE,4830,4240,HYDERABAD-PUNE,9070,All
2021,7,HYDERABAD,PUNE,6278,6234,HYDERABAD-PUNE,12512,All
2021,8,HYDERABAD,PUNE,7362,8371,HYDERABAD-PUNE,15733,All
2021,9,HYDERABAD,PUNE,8215,9268,HYDERABAD-PUNE,17483,All
2021,10,HYDERABAD,PUNE,5615,6483,HYDERABAD-PUNE,12098,All
2021,11,HYDERABAD,PUNE,14362,13268,HYDERABAD-PUNE,27630,All
2021,12,HYDERABAD,PUNE,13857,15524,HYDERABAD-PUNE,29381,All
2022,1,HYDERABAD,PUNE,8089,8335,HYDERABAD-PUNE,16424,All
2022,2,HYDERABAD,PUNE,9418,8615,HYDERABAD-PUNE,18033,All
2022,3,HYDERABAD,PUNE,13908,15584,HYDERABAD-PUNE,29492,All
2022,4,HYDERABAD,PUNE,11320,12591,HYDERABAD-PUNE,23911,All
2022,5,HYDERABAD,PUNE,12444,13996,HYDERABAD-PUNE,26440,All
2022,6,HYDERABAD,PUNE,14360,14706,HYDERABAD-PUNE,29066,All
2022,7,HYDERABAD,PUNE,17358,17195,HYDERABAD-PUNE,34553,All
2022,8,HYDERABAD,PUNE,20328,19763,HYDERABAD-PUNE,40091,All
2022,9,HYDERABAD,PUNE,19017,17676,HYDERABAD-PUNE,36693,All
2022,10,HYDERABAD,PUNE,18634,22409,HYDERABAD-PUNE,41043,All
2022,11,HYDERABAD,PUNE,19408,18123,HYDERABAD-PUNE,37531,All
2022,12,HYDERABAD,PUNE,19143,18768,HYDERABAD-PUNE,37911,All
2023,1,HYDERABAD,PUNE,17955,17903,HYDERABAD-PUNE,35858,All
2023,2,HYDERABAD,PUNE,18042,17358,HYDERABAD-PUNE,35400,All
2023,3,HYDERABAD,PUNE,19824,18837,HYDERABAD-PUNE,38661,All
2023,4,HYDERABAD,PUNE,22147,21979,HYDERABAD-PUNE,44126,All
2023,5,HYDERABAD,PUNE,22406,23981,HYDERABAD-PUNE,46387,All
2023,6,HYDERABAD,PUNE,21974,22716,HYDERABAD-PUNE,44690,All
2023,7,HYDERABAD,PUNE,21956,20543,HYDERABAD-PUNE,42499,All
2023,8,HYDERABAD,PUNE,28521,28147,HYDERABAD-PUNE,56668,All
2023,9,HYDERABAD,PUNE,26378,24598,HYDERABAD-PUNE,50976,All
2023,10,HYDERABAD,PUNE,27919,27966,HYDERABAD-PUNE,55885,All
2023,11,HYDERABAD,PUNE,24074,24285,HYDERABAD-PUNE,48359,All
2023,12,HYDERABAD,PUNE,24616,25165,HYDERABAD-PUNE,49781,All
2024,1,HYDERABAD,PUNE,22792,23880,HYDERABAD-PUNE,46672,All
2024,2,HYDERABAD,PUNE,21839,23192,HYDERABAD-PUNE,45031,All
2024,3,HYDERABAD,PUNE,22138,23807,HYDERABAD-PUNE,45945,All
2024,4,HYDERABAD,PUNE,24331,25805,HYDERABAD-PUNE,50136,All
2024,6,HYDERABAD,PUNE,25688,26024,HYDERABAD-PUNE,51712,All
2024,7,HYDERABAD,PUNE,27433,28177,HYDERABAD-PUNE,55610,All
2024,8,HYDERABAD,PUNE,28291,27900,HYDERABAD-PUNE,56191,All
2024,9,HYDERABAD,PUNE,26820,28376,HYDERABAD-PUNE,55196,All
2024,10,HYDERABAD,PUNE,24380,26630,HYDERABAD-PUNE,51010,All
2024,11,HYDERABAD,PUNE,24031,23560,HYDERABAD-PUNE,47591,All
2024,12,HYDERABAD,PUNE,24590,24973,HYDERABAD-PUNE,49563,All
2025,1,HYDERABAD,PUNE,25418,25397,HYDERABAD-PUNE,50815,All
2025,2,HYDERABAD,PUNE,22561,23043,HYDERABAD-PUNE,45604,All
2025,3,HYDERABAD,PUNE,25055,25858,HYDERABAD-PUNE,50913,All
2015,4,HYDERABAD,RAIPUR,5406,4872,HYDERABAD-RAIPUR,10278,All
2015,5,HYDERABAD,RAIPUR,5704,5462,HYDERABAD-RAIPUR,11166,All
2015,6,HYDERABAD,RAIPUR,5569,5445,HYDERABAD-RAIPUR,11014,All
2015,7,HYDERABAD,RAIPUR,4958,4890,HYDERABAD-RAIPUR,9848,All
2015,8,HYDERABAD,RAIPUR,5055,4494,HYDERABAD-RAIPUR,9549,All
2015,9,HYDERABAD,RAIPUR,4269,4003,HYDERABAD-RAIPUR,8272,All
2015,10,HYDERABAD,RAIPUR,4880,4658,HYDERABAD-RAIPUR,9538,All
2015,11,HYDERABAD,RAIPUR,5068,4527,HYDERABAD-RAIPUR,9595,All
2015,12,HYDERABAD,RAIPUR,5052,5393,HYDERABAD-RAIPUR,10445,All
2016,1,HYDERABAD,RAIPUR,5362,5241,HYDERABAD-RAIPUR,10603,All
2016,2,HYDERABAD,RAIPUR,5260,5226,HYDERABAD-RAIPUR,10486,All
2016,3,HYDERABAD,RAIPUR,5522,6282,HYDERABAD-RAIPUR,11804,All
2016,4,HYDERABAD,RAIPUR,5256,5709,HYDERABAD-RAIPUR,10965,All
2016,5,HYDERABAD,RAIPUR,5251,6221,HYDERABAD-RAIPUR,11472,All
2016,6,HYDERABAD,RAIPUR,5024,5639,HYDERABAD-RAIPUR,10663,All
2016,7,HYDERABAD,RAIPUR,4949,6051,HYDERABAD-RAIPUR,11000,All
2016,8,HYDERABAD,RAIPUR,5127,5917,HYDERABAD-RAIPUR,11044,All
2016,9,HYDERABAD,RAIPUR,5263,5649,HYDERABAD-RAIPUR,10912,All
2016,10,HYDERABAD,RAIPUR,6459,6543,HYDERABAD-RAIPUR,13002,All
2016,11,HYDERABAD,RAIPUR,6123,7338,HYDERABAD-RAIPUR,13461,All
2016,12,HYDERABAD,RAIPUR,6587,8500,HYDERABAD-RAIPUR,15087,All
2017,1,HYDERABAD,RAIPUR,6246,7918,HYDERABAD-RAIPUR,14164,All
2017,2,HYDERABAD,RAIPUR,7078,8811,HYDERABAD-RAIPUR,15889,All
2017,3,HYDERABAD,RAIPUR,9407,11750,HYDERABAD-RAIPUR,21157,All
2017,4,HYDERABAD,RAIPUR,8205,9941,HYDERABAD-RAIPUR,18146,All
2017,5,HYDERABAD,RAIPUR,7448,9423,HYDERABAD-RAIPUR,16871,All
2017,6,HYDERABAD,RAIPUR,7892,9227,HYDERABAD-RAIPUR,17119,All
2017,7,HYDERABAD,RAIPUR,8904,12382,HYDERABAD-RAIPUR,21286,All
2017,8,HYDERABAD,RAIPUR,8033,9164,HYDERABAD-RAIPUR,17197,All
2017,9,HYDERABAD,RAIPUR,7630,8637,HYDERABAD-RAIPUR,16267,All
2017,10,HYDERABAD,RAIPUR,10631,13139,HYDERABAD-RAIPUR,23770,All
2017,11,HYDERABAD,RAIPUR,12046,15119,HYDERABAD-RAIPUR,27165,All
2017,12,HYDERABAD,RAIPUR,11130,15504,HYDERABAD-RAIPUR,26634,All
2018,1,HYDERABAD,RAIPUR,10996,15076,HYDERABAD-RAIPUR,26072,All
2018,2,HYDERABAD,RAIPUR,11115,14109,HYDERABAD-RAIPUR,25224,All
2018,3,HYDERABAD,RAIPUR,13880,16442,HYDERABAD-RAIPUR,30322,All
2018,4,HYDERABAD,RAIPUR,11782,13850,HYDERABAD-RAIPUR,25632,All
2018,5,HYDERABAD,RAIPUR,10371,14572,HYDERABAD-RAIPUR,24943,All
2018,6,HYDERABAD,RAIPUR,10763,14252,HYDERABAD-RAIPUR,25015,All
2018,7,HYDERABAD,RAIPUR,11387,14425,HYDERABAD-RAIPUR,25812,All
2018,8,HYDERABAD,RAIPUR,9676,12619,HYDERABAD-RAIPUR,22295,All
2018,9,HYDERABAD,RAIPUR,12449,14874,HYDERABAD-RAIPUR,27323,All
2018,10,HYDERABAD,RAIPUR,11991,12945,HYDERABAD-RAIPUR,24936,All
2018,11,HYDERABAD,RAIPUR,14125,15787,HYDERABAD-RAIPUR,29912,All
2018,12,HYDERABAD,RAIPUR,16065,17576,HYDERABAD-RAIPUR,33641,All
2019,1,HYDERABAD,RAIPUR,17105,17294,HYDERABAD-RAIPUR,34399,All
2019,2,HYDERABAD,RAIPUR,15645,16080,HYDERABAD-RAIPUR,31725,All
2019,3,HYDERABAD,RAIPUR,17660,18555,HYDERABAD-RAIPUR,36215,All
2019,4,HYDERABAD,RAIPUR,12478,12118,HYDERABAD-RAIPUR,24596,All
2019,5,HYDERABAD,RAIPUR,12477,14242,HYDERABAD-RAIPUR,26719,All
2019,6,HYDERABAD,RAIPUR,12744,13312,HYDERABAD-RAIPUR,26056,All
2019,7,HYDERABAD,RAIPUR,11227,11542,HYDERABAD-RAIPUR,22769,All
2019,8,HYDERABAD,RAIPUR,8678,8898,HYDERABAD-RAIPUR,17576,All
2019,9,HYDERABAD,RAIPUR,11678,12517,HYDERABAD-RAIPUR,24195,All
2019,10,HYDERABAD,RAIPUR,12941,12880,HYDERABAD-RAIPUR,25821,All
2019,11,HYDERABAD,RAIPUR,12831,14069,HYDERABAD-RAIPUR,26900,All
2019,12,HYDERABAD,RAIPUR,16137,18552,HYDERABAD-RAIPUR,34689,All
2020,1,HYDERABAD,RAIPUR,14450,17220,HYDERABAD-RAIPUR,31670,All
2020,2,HYDERABAD,RAIPUR,14314,16801,HYDERABAD-RAIPUR,31115,All
2020,3,HYDERABAD,RAIPUR,11627,9764,HYDERABAD-RAIPUR,21391,All
2020,5,HYDERABAD,RAIPUR,493,348,HYDERABAD-RAIPUR,841,All
2020,6,HYDERABAD,RAIPUR,2548,1950,HYDERABAD-RAIPUR,4498,All
2020,7,HYDERABAD,RAIPUR,2496,1630,HYDERABAD-RAIPUR,4126,All
2020,8,HYDERABAD,RAIPUR,3173,2894,HYDERABAD-RAIPUR,6067,All
2020,9,HYDERABAD,RAIPUR,3561,3319,HYDERABAD-RAIPUR,6880,All
2020,10,HYDERABAD,RAIPUR,4073,3899,HYDERABAD-RAIPUR,7972,All
2020,11,HYDERABAD,RAIPUR,4737,4345,HYDERABAD-RAIPUR,9082,All
2020,12,HYDERABAD,RAIPUR,5639,5561,HYDERABAD-RAIPUR,11200,All
2021,1,HYDERABAD,RAIPUR,5604,7036,HYDERABAD-RAIPUR,12640,All
2021,2,HYDERABAD,RAIPUR,5548,6324,HYDERABAD-RAIPUR,11872,All
2021,3,HYDERABAD,RAIPUR,5343,5865,HYDERABAD-RAIPUR,11208,All
2021,4,HYDERABAD,RAIPUR,2738,3052,HYDERABAD-RAIPUR,5790,All
2021,6,HYDERABAD,RAIPUR,2379,1755,HYDERABAD-RAIPUR,4134,All
2021,7,HYDERABAD,RAIPUR,4904,6045,HYDERABAD-RAIPUR,10949,All
2021,8,HYDERABAD,RAIPUR,5226,4941,HYDERABAD-RAIPUR,10167,All
2021,9,HYDERABAD,RAIPUR,4621,4623,HYDERABAD-RAIPUR,9244,All
2021,10,HYDERABAD,RAIPUR,6769,5395,HYDERABAD-RAIPUR,12164,All
2021,11,HYDERABAD,RAIPUR,8833,11263,HYDERABAD-RAIPUR,20096,All
2021,12,HYDERABAD,RAIPUR,9148,12054,HYDERABAD-RAIPUR,21202,All
2022,1,HYDERABAD,RAIPUR,5669,5390,HYDERABAD-RAIPUR,11059,All
2022,2,HYDERABAD,RAIPUR,6926,7873,HYDERABAD-RAIPUR,14799,All
2022,3,HYDERABAD,RAIPUR,8038,8353,HYDERABAD-RAIPUR,16391,All
2022,4,HYDERABAD,RAIPUR,8697,8307,HYDERABAD-RAIPUR,17004,All
2022,5,HYDERABAD,RAIPUR,9047,9850,HYDERABAD-RAIPUR,18897,All
2022,6,HYDERABAD,RAIPUR,7870,8606,HYDERABAD-RAIPUR,16476,All
2022,7,HYDERABAD,RAIPUR,7128,8105,HYDERABAD-RAIPUR,15233,All
2022,8,HYDERABAD,RAIPUR,7792,8575,HYDERABAD-RAIPUR,16367,All
2022,9,HYDERABAD,RAIPUR,7867,7737,HYDERABAD-RAIPUR,15604,All
2022,10,HYDERABAD,RAIPUR,9907,9151,HYDERABAD-RAIPUR,19058,All
2022,11,HYDERABAD,RAIPUR,10990,11849,HYDERABAD-RAIPUR,22839,All
2022,12,HYDERABAD,RAIPUR,9281,9229,HYDERABAD-RAIPUR,18510,All
2023,1,HYDERABAD,RAIPUR,7814,7227,HYDERABAD-RAIPUR,15041,All
2023,2,HYDERABAD,RAIPUR,7939,7855,HYDERABAD-RAIPUR,15794,All
2023,3,HYDERABAD,RAIPUR,8752,8703,HYDERABAD-RAIPUR,17455,All
2023,4,HYDERABAD,RAIPUR,7907,7710,HYDERABAD-RAIPUR,15617,All
2023,5,HYDERABAD,RAIPUR,8067,8426,HYDERABAD-RAIPUR,16493,All
2023,6,HYDERABAD,RAIPUR,7884,8161,HYDERABAD-RAIPUR,16045,All
2023,7,HYDERABAD,RAIPUR,7494,8706,HYDERABAD-RAIPUR,16200,All
2023,8,HYDERABAD,RAIPUR,8038,8596,HYDERABAD-RAIPUR,16634,All
2023,9,HYDERABAD,RAIPUR,7713,8553,HYDERABAD-RAIPUR,16266,All
2023,10,HYDERABAD,RAIPUR,7945,7631,HYDERABAD-RAIPUR,15576,All
2023,11,HYDERABAD,RAIPUR,8664,8454,HYDERABAD-RAIPUR,17118,All
2023,12,HYDERABAD,RAIPUR,8221,8188,HYDERABAD-RAIPUR,16409,All
2024,1,HYDERABAD,RAIPUR,9095,9317,HYDERABAD-RAIPUR,18412,All
2024,2,HYDERABAD,RAIPUR,7320,7529,HYDERABAD-RAIPUR,14849,All
2024,3,HYDERABAD,RAIPUR,7689,7955,HYDERABAD-RAIPUR,15644,All
2024,4,HYDERABAD,RAIPUR,7502,7095,HYDERABAD-RAIPUR,14597,All
2024,6,HYDERABAD,RAIPUR,6983,7269,HYDERABAD-RAIPUR,14252,All
2024,7,HYDERABAD,RAIPUR,7030,7476,HYDERABAD-RAIPUR,14506,All
2024,8,HYDERABAD,RAIPUR,6989,7522,HYDERABAD-RAIPUR,14511,All
2024,9,HYDERABAD,RAIPUR,7430,7331,HYDERABAD-RAIPUR,14761,All
2024,10,HYDERABAD,RAIPUR,10540,9214,HYDERABAD-RAIPUR,19754,All
2024,11,HYDERABAD,RAIPUR,7284,7435,HYDERABAD-RAIPUR,14719,All
2024,12,HYDERABAD,RAIPUR,7822,7530,HYDERABAD-RAIPUR,15352,All
2025,1,HYDERABAD,RAIPUR,9929,9729,HYDERABAD-RAIPUR,19658,All
2025,2,HYDERABAD,RAIPUR,10269,9849,HYDERABAD-RAIPUR,20118,All
2025,3,HYDERABAD,RAIPUR,10210,10331,HYDERABAD-RAIPUR,20541,All
2015,4,HYDERABAD,RAJAHMUNDRY,4837,5042,HYDERABAD-RAJAHMUNDRY,9879,All
2015,5,HYDERABAD,RAJAHMUNDRY,5132,5191,HYDERABAD-RAJAHMUNDRY,10323,All
2015,6,HYDERABAD,RAJAHMUNDRY,4805,4695,HYDERABAD-RAJAHMUNDRY,9500,All
2015,7,HYDERABAD,RAJAHMUNDRY,10034,9616,HYDERABAD-RAJAHMUNDRY,19650,All
2015,8,HYDERABAD,RAJAHMUNDRY,8712,8866,HYDERABAD-RAJAHMUNDRY,17578,All
2015,9,HYDERABAD,RAJAHMUNDRY,8504,8656,HYDERABAD-RAJAHMUNDRY,17160,All
2015,10,HYDERABAD,RAJAHMUNDRY,10277,9831,HYDERABAD-RAJAHMUNDRY,20108,All
2015,11,HYDERABAD,RAJAHMUNDRY,9259,9326,HYDERABAD-RAJAHMUNDRY,18585,All
2015,12,HYDERABAD,RAJAHMUNDRY,10446,10615,HYDERABAD-RAJAHMUNDRY,21061,All
2016,1,HYDERABAD,RAJAHMUNDRY,8844,9416,HYDERABAD-RAJAHMUNDRY,18260,All
2016,2,HYDERABAD,RAJAHMUNDRY,8330,8794,HYDERABAD-RAJAHMUNDRY,17124,All
2016,3,HYDERABAD,RAJAHMUNDRY,8949,9562,HYDERABAD-RAJAHMUNDRY,18511,All
2016,4,HYDERABAD,RAJAHMUNDRY,9271,9109,HYDERABAD-RAJAHMUNDRY,18380,All
2016,5,HYDERABAD,RAJAHMUNDRY,8486,8608,HYDERABAD-RAJAHMUNDRY,17094,All
2016,6,HYDERABAD,RAJAHMUNDRY,7771,7537,HYDERABAD-RAJAHMUNDRY,15308,All
2016,7,HYDERABAD,RAJAHMUNDRY,6736,6681,HYDERABAD-RAJAHMUNDRY,13417,All
2016,8,HYDERABAD,RAJAHMUNDRY,8339,8423,HYDERABAD-RAJAHMUNDRY,16762,All
2016,9,HYDERABAD,RAJAHMUNDRY,7167,7480,HYDERABAD-RAJAHMUNDRY,14647,All
2016,10,HYDERABAD,RAJAHMUNDRY,9492,9119,HYDERABAD-RAJAHMUNDRY,18611,All
2016,11,HYDERABAD,RAJAHMUNDRY,8823,9199,HYDERABAD-RAJAHMUNDRY,18022,All
2016,12,HYDERABAD,RAJAHMUNDRY,8131,8395,HYDERABAD-RAJAHMUNDRY,16526,All
2017,1,HYDERABAD,RAJAHMUNDRY,8261,8430,HYDERABAD-RAJAHMUNDRY,16691,All
2017,2,HYDERABAD,RAJAHMUNDRY,8150,8540,HYDERABAD-RAJAHMUNDRY,16690,All
2017,3,HYDERABAD,RAJAHMUNDRY,8148,8185,HYDERABAD-RAJAHMUNDRY,16333,All
2017,4,HYDERABAD,RAJAHMUNDRY,8195,8312,HYDERABAD-RAJAHMUNDRY,16507,All
2017,5,HYDERABAD,RAJAHMUNDRY,8587,9075,HYDERABAD-RAJAHMUNDRY,17662,All
2017,6,HYDERABAD,RAJAHMUNDRY,8074,8016,HYDERABAD-RAJAHMUNDRY,16090,All
2017,7,HYDERABAD,RAJAHMUNDRY,7791,7689,HYDERABAD-RAJAHMUNDRY,15480,All
2017,8,HYDERABAD,RAJAHMUNDRY,7690,8167,HYDERABAD-RAJAHMUNDRY,15857,All
2017,9,HYDERABAD,RAJAHMUNDRY,7410,7148,HYDERABAD-RAJAHMUNDRY,14558,All
2017,10,HYDERABAD,RAJAHMUNDRY,7562,7707,HYDERABAD-RAJAHMUNDRY,15269,All
2017,11,HYDERABAD,RAJAHMUNDRY,7056,7219,HYDERABAD-RAJAHMUNDRY,14275,All
2017,12,HYDERABAD,RAJAHMUNDRY,7225,7089,HYDERABAD-RAJAHMUNDRY,14314,All
2018,1,HYDERABAD,RAJAHMUNDRY,9667,9990,HYDERABAD-RAJAHMUNDRY,19657,All
2018,2,HYDERABAD,RAJAHMUNDRY,9774,10013,HYDERABAD-RAJAHMUNDRY,19787,All
2018,3,HYDERABAD,RAJAHMUNDRY,11708,11743,HYDERABAD-RAJAHMUNDRY,23451,All
2018,4,HYDERABAD,RAJAHMUNDRY,11472,11134,HYDERABAD-RAJAHMUNDRY,22606,All
2018,5,HYDERABAD,RAJAHMUNDRY,11360,12010,HYDERABAD-RAJAHMUNDRY,23370,All
2018,6,HYDERABAD,RAJAHMUNDRY,12098,11681,HYDERABAD-RAJAHMUNDRY,23779,All
2018,7,HYDERABAD,RAJAHMUNDRY,13700,13757,HYDERABAD-RAJAHMUNDRY,27457,All
2018,8,HYDERABAD,RAJAHMUNDRY,12433,12623,HYDERABAD-RAJAHMUNDRY,25056,All
2018,9,HYDERABAD,RAJAHMUNDRY,12379,12782,HYDERABAD-RAJAHMUNDRY,25161,All
2018,10,HYDERABAD,RAJAHMUNDRY,13369,13572,HYDERABAD-RAJAHMUNDRY,26941,All
2018,11,HYDERABAD,RAJAHMUNDRY,11682,11917,HYDERABAD-RAJAHMUNDRY,23599,All
2018,12,HYDERABAD,RAJAHMUNDRY,12201,11567,HYDERABAD-RAJAHMUNDRY,23768,All
2019,1,HYDERABAD,RAJAHMUNDRY,8489,9018,HYDERABAD-RAJAHMUNDRY,17507,All
2019,2,HYDERABAD,RAJAHMUNDRY,9048,9010,HYDERABAD-RAJAHMUNDRY,18058,All
2019,3,HYDERABAD,RAJAHMUNDRY,9897,10011,HYDERABAD-RAJAHMUNDRY,19908,All
2019,4,HYDERABAD,RAJAHMUNDRY,9223,9450,HYDERABAD-RAJAHMUNDRY,18673,All
2019,5,HYDERABAD,RAJAHMUNDRY,10804,11181,HYDERABAD-RAJAHMUNDRY,21985,All
2019,6,HYDERABAD,RAJAHMUNDRY,11028,11442,HYDERABAD-RAJAHMUNDRY,22470,All
2019,7,HYDERABAD,RAJAHMUNDRY,11699,11885,HYDERABAD-RAJAHMUNDRY,23584,All
2019,8,HYDERABAD,RAJAHMUNDRY,10593,11293,HYDERABAD-RAJAHMUNDRY,21886,All
2019,9,HYDERABAD,RAJAHMUNDRY,9958,10216,HYDERABAD-RAJAHMUNDRY,20174,All
2019,10,HYDERABAD,RAJAHMUNDRY,11222,11207,HYDERABAD-RAJAHMUNDRY,22429,All
2019,11,HYDERABAD,RAJAHMUNDRY,12606,12873,HYDERABAD-RAJAHMUNDRY,25479,All
2019,12,HYDERABAD,RAJAHMUNDRY,13742,12247,HYDERABAD-RAJAHMUNDRY,25989,All
2020,1,HYDERABAD,RAJAHMUNDRY,14625,13689,HYDERABAD-RAJAHMUNDRY,28314,All
2020,2,HYDERABAD,RAJAHMUNDRY,13496,13363,HYDERABAD-RAJAHMUNDRY,26859,All
2020,3,HYDERABAD,RAJAHMUNDRY,7988,7662,HYDERABAD-RAJAHMUNDRY,15650,All
2020,5,HYDERABAD,RAJAHMUNDRY,174,148,HYDERABAD-RAJAHMUNDRY,322,All
2020,6,HYDERABAD,RAJAHMUNDRY,2698,2277,HYDERABAD-RAJAHMUNDRY,4975,All
2020,7,HYDERABAD,RAJAHMUNDRY,3121,2694,HYDERABAD-RAJAHMUNDRY,5815,All
2020,8,HYDERABAD,RAJAHMUNDRY,3236,3434,HYDERABAD-RAJAHMUNDRY,6670,All
2020,9,HYDERABAD,RAJAHMUNDRY,4830,5008,HYDERABAD-RAJAHMUNDRY,9838,All
2020,10,HYDERABAD,RAJAHMUNDRY,7511,7418,HYDERABAD-RAJAHMUNDRY,14929,All
2020,11,HYDERABAD,RAJAHMUNDRY,8144,8017,HYDERABAD-RAJAHMUNDRY,16161,All
2020,12,HYDERABAD,RAJAHMUNDRY,9976,9604,HYDERABAD-RAJAHMUNDRY,19580,All
2021,1,HYDERABAD,RAJAHMUNDRY,9638,10094,HYDERABAD-RAJAHMUNDRY,19732,All
2021,2,HYDERABAD,RAJAHMUNDRY,8804,8912,HYDERABAD-RAJAHMUNDRY,17716,All
2021,3,HYDERABAD,RAJAHMUNDRY,8783,8755,HYDERABAD-RAJAHMUNDRY,17538,All
2021,4,HYDERABAD,RAJAHMUNDRY,6865,6264,HYDERABAD-RAJAHMUNDRY,13129,All
2021,6,HYDERABAD,RAJAHMUNDRY,4509,4366,HYDERABAD-RAJAHMUNDRY,8875,All
2021,7,HYDERABAD,RAJAHMUNDRY,6850,6805,HYDERABAD-RAJAHMUNDRY,13655,All
2021,8,HYDERABAD,RAJAHMUNDRY,9237,8334,HYDERABAD-RAJAHMUNDRY,17571,All
2021,9,HYDERABAD,RAJAHMUNDRY,7357,7110,HYDERABAD-RAJAHMUNDRY,14467,All
2021,10,HYDERABAD,RAJAHMUNDRY,8006,7461,HYDERABAD-RAJAHMUNDRY,15467,All
2021,11,HYDERABAD,RAJAHMUNDRY,7106,7054,HYDERABAD-RAJAHMUNDRY,14160,All
2021,12,HYDERABAD,RAJAHMUNDRY,8853,8159,HYDERABAD-RAJAHMUNDRY,17012,All
2022,1,HYDERABAD,RAJAHMUNDRY,6852,6775,HYDERABAD-RAJAHMUNDRY,13627,All
2022,2,HYDERABAD,RAJAHMUNDRY,6535,6926,HYDERABAD-RAJAHMUNDRY,13461,All
2022,3,HYDERABAD,RAJAHMUNDRY,8445,8447,HYDERABAD-RAJAHMUNDRY,16892,All
2022,4,HYDERABAD,RAJAHMUNDRY,9449,9586,HYDERABAD-RAJAHMUNDRY,19035,All
2022,5,HYDERABAD,RAJAHMUNDRY,9447,9756,HYDERABAD-RAJAHMUNDRY,19203,All
2022,6,HYDERABAD,RAJAHMUNDRY,9580,9600,HYDERABAD-RAJAHMUNDRY,19180,All
2022,7,HYDERABAD,RAJAHMUNDRY,9561,9528,HYDERABAD-RAJAHMUNDRY,19089,All
2022,8,HYDERABAD,RAJAHMUNDRY,10618,10977,HYDERABAD-RAJAHMUNDRY,21595,All
2022,9,HYDERABAD,RAJAHMUNDRY,9829,9777,HYDERABAD-RAJAHMUNDRY,19606,All
2022,10,HYDERABAD,RAJAHMUNDRY,10729,10307,HYDERABAD-RAJAHMUNDRY,21036,All
2022,11,HYDERABAD,RAJAHMUNDRY,11517,10907,HYDERABAD-RAJAHMUNDRY,22424,All
2022,12,HYDERABAD,RAJAHMUNDRY,12486,11534,HYDERABAD-RAJAHMUNDRY,24020,All
2023,1,HYDERABAD,RAJAHMUNDRY,12172,11725,HYDERABAD-RAJAHMUNDRY,23897,All
2023,2,HYDERABAD,RAJAHMUNDRY,11278,10923,HYDERABAD-RAJAHMUNDRY,22201,All
2023,3,HYDERABAD,RAJAHMUNDRY,11703,11367,HYDERABAD-RAJAHMUNDRY,23070,All
2023,4,HYDERABAD,RAJAHMUNDRY,10090,10253,HYDERABAD-RAJAHMUNDRY,20343,All
2023,5,HYDERABAD,RAJAHMUNDRY,10828,10866,HYDERABAD-RAJAHMUNDRY,21694,All
2023,6,HYDERABAD,RAJAHMUNDRY,10348,10599,HYDERABAD-RAJAHMUNDRY,20947,All
2023,7,HYDERABAD,RAJAHMUNDRY,10757,10701,HYDERABAD-RAJAHMUNDRY,21458,All
2023,8,HYDERABAD,RAJAHMUNDRY,10881,10996,HYDERABAD-RAJAHMUNDRY,21877,All
2023,9,HYDERABAD,RAJAHMUNDRY,10284,10559,HYDERABAD-RAJAHMUNDRY,20843,All
2023,10,HYDERABAD,RAJAHMUNDRY,11004,10866,HYDERABAD-RAJAHMUNDRY,21870,All
2023,11,HYDERABAD,RAJAHMUNDRY,11483,11430,HYDERABAD-RAJAHMUNDRY,22913,All
2023,12,HYDERABAD,RAJAHMUNDRY,11384,10658,HYDERABAD-RAJAHMUNDRY,22042,All
2024,1,HYDERABAD,RAJAHMUNDRY,11767,11669,HYDERABAD-RAJAHMUNDRY,23436,All
2024,2,HYDERABAD,RAJAHMUNDRY,11447,10309,HYDERABAD-RAJAHMUNDRY,21756,All
2024,3,HYDERABAD,RAJAHMUNDRY,12228,11886,HYDERABAD-RAJAHMUNDRY,24114,All
2024,4,HYDERABAD,RAJAHMUNDRY,10892,10865,HYDERABAD-RAJAHMUNDRY,21757,All
2024,6,HYDERABAD,RAJAHMUNDRY,12529,12143,HYDERABAD-RAJAHMUNDRY,24672,All
2024,7,HYDERABAD,RAJAHMUNDRY,11998,11718,HYDERABAD-RAJAHMUNDRY,23716,All
2024,8,HYDERABAD,RAJAHMUNDRY,12385,12790,HYDERABAD-RAJAHMUNDRY,25175,All
2024,9,HYDERABAD,RAJAHMUNDRY,10902,11289,HYDERABAD-RAJAHMUNDRY,22191,All
2024,10,HYDERABAD,RAJAHMUNDRY,12992,12425,HYDERABAD-RAJAHMUNDRY,25417,All
2024,11,HYDERABAD,RAJAHMUNDRY,12495,12665,HYDERABAD-RAJAHMUNDRY,25160,All
2024,12,HYDERABAD,RAJAHMUNDRY,13371,11711,HYDERABAD-RAJAHMUNDRY,25082,All
2025,1,HYDERABAD,RAJAHMUNDRY,11581,11508,HYDERABAD-RAJAHMUNDRY,23089,All
2025,2,HYDERABAD,RAJAHMUNDRY,11677,11365,HYDERABAD-RAJAHMUNDRY,23042,All
2025,3,HYDERABAD,RAJAHMUNDRY,11669,11210,HYDERABAD-RAJAHMUNDRY,22879,All
2017,9,HYDERABAD,RAJKOT,0,85,HYDERABAD-RAJKOT,85,All
2021,3,HYDERABAD,RAJKOT,890,996,HYDERABAD-RAJKOT,1886,All
2021,4,HYDERABAD,RAJKOT,256,311,HYDERABAD-RAJKOT,567,All
2021,7,HYDERABAD,RAJKOT,707,716,HYDERABAD-RAJKOT,1423,All
2021,8,HYDERABAD,RAJKOT,1267,1336,HYDERABAD-RAJKOT,2603,All
2021,9,HYDERABAD,RAJKOT,802,862,HYDERABAD-RAJKOT,1664,All
2021,10,HYDERABAD,RAJKOT,1259,1258,HYDERABAD-RAJKOT,2517,All
2017,10,HYDERABAD,RANCHI,3936,3388,HYDERABAD-RANCHI,7324,All
2017,11,HYDERABAD,RANCHI,4565,4560,HYDERABAD-RANCHI,9125,All
2017,12,HYDERABAD,RANCHI,6439,6345,HYDERABAD-RANCHI,12784,All
2018,1,HYDERABAD,RANCHI,8898,8171,HYDERABAD-RANCHI,17069,All
2018,2,HYDERABAD,RANCHI,8636,6904,HYDERABAD-RANCHI,15540,All
2018,3,HYDERABAD,RANCHI,8992,8481,HYDERABAD-RANCHI,17473,All
2018,4,HYDERABAD,RANCHI,10103,7521,HYDERABAD-RANCHI,17624,All
2018,5,HYDERABAD,RANCHI,9643,10758,HYDERABAD-RANCHI,20401,All
2018,6,HYDERABAD,RANCHI,10156,15686,HYDERABAD-RANCHI,25842,All
2018,7,HYDERABAD,RANCHI,8311,14844,HYDERABAD-RANCHI,23155,All
2018,8,HYDERABAD,RANCHI,4531,4275,HYDERABAD-RANCHI,8806,All
2018,9,HYDERABAD,RANCHI,3755,3724,HYDERABAD-RANCHI,7479,All
2018,10,HYDERABAD,RANCHI,5046,4106,HYDERABAD-RANCHI,9152,All
2018,11,HYDERABAD,RANCHI,5398,6551,HYDERABAD-RANCHI,11949,All
2018,12,HYDERABAD,RANCHI,4676,4873,HYDERABAD-RANCHI,9549,All
2019,1,HYDERABAD,RANCHI,4229,4671,HYDERABAD-RANCHI,8900,All
2019,2,HYDERABAD,RANCHI,3706,4187,HYDERABAD-RANCHI,7893,All
2019,3,HYDERABAD,RANCHI,4103,4608,HYDERABAD-RANCHI,8711,All
2019,4,HYDERABAD,RANCHI,5069,4295,HYDERABAD-RANCHI,9364,All
2019,5,HYDERABAD,RANCHI,5332,5355,HYDERABAD-RANCHI,10687,All
2019,6,HYDERABAD,RANCHI,4954,5356,HYDERABAD-RANCHI,10310,All
2019,7,HYDERABAD,RANCHI,4144,4931,HYDERABAD-RANCHI,9075,All
2019,8,HYDERABAD,RANCHI,4716,4676,HYDERABAD-RANCHI,9392,All
2019,9,HYDERABAD,RANCHI,4154,4241,HYDERABAD-RANCHI,8395,All
2019,10,HYDERABAD,RANCHI,5226,4935,HYDERABAD-RANCHI,10161,All
2019,11,HYDERABAD,RANCHI,3714,5196,HYDERABAD-RANCHI,8910,All
2019,12,HYDERABAD,RANCHI,4277,5376,HYDERABAD-RANCHI,9653,All
2020,1,HYDERABAD,RANCHI,4102,5199,HYDERABAD-RANCHI,9301,All
2020,2,HYDERABAD,RANCHI,5594,6177,HYDERABAD-RANCHI,11771,All
2020,3,HYDERABAD,RANCHI,7154,5470,HYDERABAD-RANCHI,12624,All
2020,5,HYDERABAD,RANCHI,739,423,HYDERABAD-RANCHI,1162,All
2020,6,HYDERABAD,RANCHI,4651,2312,HYDERABAD-RANCHI,6963,All
2020,7,HYDERABAD,RANCHI,4780,2906,HYDERABAD-RANCHI,7686,All
2020,8,HYDERABAD,RANCHI,4275,4799,HYDERABAD-RANCHI,9074,All
2020,9,HYDERABAD,RANCHI,4839,6961,HYDERABAD-RANCHI,11800,All
2020,10,HYDERABAD,RANCHI,5540,5831,HYDERABAD-RANCHI,11371,All
2020,11,HYDERABAD,RANCHI,5947,5698,HYDERABAD-RANCHI,11645,All
2020,12,HYDERABAD,RANCHI,5708,6286,HYDERABAD-RANCHI,11994,All
2021,1,HYDERABAD,RANCHI,5611,6982,HYDERABAD-RANCHI,12593,All
2021,2,HYDERABAD,RANCHI,5595,6889,HYDERABAD-RANCHI,12484,All
2021,3,HYDERABAD,RANCHI,6324,5625,HYDERABAD-RANCHI,11949,All
2021,4,HYDERABAD,RANCHI,7830,4696,HYDERABAD-RANCHI,12526,All
2021,6,HYDERABAD,RANCHI,3010,5049,HYDERABAD-RANCHI,8059,All
2021,7,HYDERABAD,RANCHI,4919,7148,HYDERABAD-RANCHI,12067,All
2021,8,HYDERABAD,RANCHI,5136,6829,HYDERABAD-RANCHI,11965,All
2021,9,HYDERABAD,RANCHI,4038,5462,HYDERABAD-RANCHI,9500,All
2021,10,HYDERABAD,RANCHI,6746,5500,HYDERABAD-RANCHI,12246,All
2021,11,HYDERABAD,RANCHI,7484,8318,HYDERABAD-RANCHI,15802,All
2021,12,HYDERABAD,RANCHI,6507,9147,HYDERABAD-RANCHI,15654,All
2022,1,HYDERABAD,RANCHI,3637,4072,HYDERABAD-RANCHI,7709,All
2022,2,HYDERABAD,RANCHI,3809,4237,HYDERABAD-RANCHI,8046,All
2022,3,HYDERABAD,RANCHI,6714,7297,HYDERABAD-RANCHI,14011,All
2022,4,HYDERABAD,RANCHI,8623,7691,HYDERABAD-RANCHI,16314,All
2022,5,HYDERABAD,RANCHI,8356,9194,HYDERABAD-RANCHI,17550,All
2022,6,HYDERABAD,RANCHI,5713,6549,HYDERABAD-RANCHI,12262,All
2022,7,HYDERABAD,RANCHI,4806,5068,HYDERABAD-RANCHI,9874,All
2022,8,HYDERABAD,RANCHI,4462,4678,HYDERABAD-RANCHI,9140,All
2022,9,HYDERABAD,RANCHI,4995,5118,HYDERABAD-RANCHI,10113,All
2022,10,HYDERABAD,RANCHI,6771,6092,HYDERABAD-RANCHI,12863,All
2022,11,HYDERABAD,RANCHI,4588,4761,HYDERABAD-RANCHI,9349,All
2022,12,HYDERABAD,RANCHI,4726,5030,HYDERABAD-RANCHI,9756,All
2023,1,HYDERABAD,RANCHI,5266,5485,HYDERABAD-RANCHI,10751,All
2023,2,HYDERABAD,RANCHI,5304,5324,HYDERABAD-RANCHI,10628,All
2023,3,HYDERABAD,RANCHI,5756,5704,HYDERABAD-RANCHI,11460,All
2023,4,HYDERABAD,RANCHI,6158,5699,HYDERABAD-RANCHI,11857,All
2023,5,HYDERABAD,RANCHI,6643,6629,HYDERABAD-RANCHI,13272,All
2023,6,HYDERABAD,RANCHI,6233,5890,HYDERABAD-RANCHI,12123,All
2023,7,HYDERABAD,RANCHI,7419,7567,HYDERABAD-RANCHI,14986,All
2023,8,HYDERABAD,RANCHI,8319,8123,HYDERABAD-RANCHI,16442,All
2023,9,HYDERABAD,RANCHI,8049,7550,HYDERABAD-RANCHI,15599,All
2023,10,HYDERABAD,RANCHI,8186,7268,HYDERABAD-RANCHI,15454,All
2023,11,HYDERABAD,RANCHI,9897,8944,HYDERABAD-RANCHI,18841,All
2023,12,HYDERABAD,RANCHI,9981,10526,HYDERABAD-RANCHI,20507,All
2024,1,HYDERABAD,RANCHI,8322,8605,HYDERABAD-RANCHI,16927,All
2024,2,HYDERABAD,RANCHI,7502,7370,HYDERABAD-RANCHI,14872,All
2024,3,HYDERABAD,RANCHI,10761,9759,HYDERABAD-RANCHI,20520,All
2024,4,HYDERABAD,RANCHI,9140,8383,HYDERABAD-RANCHI,17523,All
2024,6,HYDERABAD,RANCHI,10268,10544,HYDERABAD-RANCHI,20812,All
2024,7,HYDERABAD,RANCHI,9051,11591,HYDERABAD-RANCHI,20642,All
2024,8,HYDERABAD,RANCHI,9699,11526,HYDERABAD-RANCHI,21225,All
2024,9,HYDERABAD,RANCHI,9756,9789,HYDERABAD-RANCHI,19545,All
2024,10,HYDERABAD,RANCHI,12664,9533,HYDERABAD-RANCHI,22197,All
2024,11,HYDERABAD,RANCHI,12517,12678,HYDERABAD-RANCHI,25195,All
2024,12,HYDERABAD,RANCHI,13136,13608,HYDERABAD-RANCHI,26744,All
2025,1,HYDERABAD,RANCHI,13702,12865,HYDERABAD-RANCHI,26567,All
2025,2,HYDERABAD,RANCHI,12659,11931,HYDERABAD-RANCHI,24590,All
2025,3,HYDERABAD,RANCHI,13301,11900,HYDERABAD-RANCHI,25201,All
2024,9,HYDERABAD,Rajkot International Airport,2128,1641,HYDERABAD-Rajkot International Airport,3769,All
2024,10,HYDERABAD,Rajkot International Airport,4146,4060,HYDERABAD-Rajkot International Airport,8206,All
2024,11,HYDERABAD,Rajkot International Airport,3036,2994,HYDERABAD-Rajkot International Airport,6030,All
2024,12,HYDERABAD,Rajkot International Airport,3366,3376,HYDERABAD-Rajkot International Airport,6742,All
2025,1,HYDERABAD,Rajkot International Airport,4550,4836,HYDERABAD-Rajkot International Airport,9386,All
2025,2,HYDERABAD,Rajkot International Airport,3767,4433,HYDERABAD-Rajkot International Airport,8200,All
2025,3,HYDERABAD,Rajkot International Airport,3389,4302,HYDERABAD-Rajkot International Airport,7691,All
2023,10,HYDERABAD,SALEM,23,42,HYDERABAD-SALEM,65,All
2023,11,HYDERABAD,SALEM,575,636,HYDERABAD-SALEM,1211,All
2023,12,HYDERABAD,SALEM,730,735,HYDERABAD-SALEM,1465,All
2024,1,HYDERABAD,SALEM,756,806,HYDERABAD-SALEM,1562,All
2024,2,HYDERABAD,SALEM,654,683,HYDERABAD-SALEM,1337,All
2024,3,HYDERABAD,SALEM,566,625,HYDERABAD-SALEM,1191,All
2024,4,HYDERABAD,SALEM,676,671,HYDERABAD-SALEM,1347,All
2024,6,HYDERABAD,SALEM,780,891,HYDERABAD-SALEM,1671,All
2024,7,HYDERABAD,SALEM,791,725,HYDERABAD-SALEM,1516,All
2024,8,HYDERABAD,SALEM,750,696,HYDERABAD-SALEM,1446,All
2024,9,HYDERABAD,SALEM,744,780,HYDERABAD-SALEM,1524,All
2024,10,HYDERABAD,SALEM,787,741,HYDERABAD-SALEM,1528,All
2024,11,HYDERABAD,SALEM,810,853,HYDERABAD-SALEM,1663,All
2024,12,HYDERABAD,SALEM,882,876,HYDERABAD-SALEM,1758,All
2025,1,HYDERABAD,SALEM,898,831,HYDERABAD-SALEM,1729,All
2025,2,HYDERABAD,SALEM,801,850,HYDERABAD-SALEM,1651,All
2025,3,HYDERABAD,SALEM,793,761,HYDERABAD-SALEM,1554,All
2017,10,HYDERABAD,SHIRDI,1036,1245,HYDERABAD-SHIRDI,2281,All
2017,11,HYDERABAD,SHIRDI,1460,1563,HYDERABAD-SHIRDI,3023,All
2017,12,HYDERABAD,SHIRDI,1569,1769,HYDERABAD-SHIRDI,3338,All
2018,1,HYDERABAD,SHIRDI,1683,1778,HYDERABAD-SHIRDI,3461,All
2018,2,HYDERABAD,SHIRDI,1378,1428,HYDERABAD-SHIRDI,2806,All
2018,3,HYDERABAD,SHIRDI,1302,1398,HYDERABAD-SHIRDI,2700,All
2018,4,HYDERABAD,SHIRDI,1534,1692,HYDERABAD-SHIRDI,3226,All
2018,5,HYDERABAD,SHIRDI,1451,1590,HYDERABAD-SHIRDI,3041,All
2018,6,HYDERABAD,SHIRDI,1471,1608,HYDERABAD-SHIRDI,3079,All
2018,7,HYDERABAD,SHIRDI,1532,1861,HYDERABAD-SHIRDI,3393,All
2018,8,HYDERABAD,SHIRDI,2054,2024,HYDERABAD-SHIRDI,4078,All
2018,9,HYDERABAD,SHIRDI,2842,2688,HYDERABAD-SHIRDI,5530,All
2018,10,HYDERABAD,SHIRDI,2303,2556,HYDERABAD-SHIRDI,4859,All
2018,11,HYDERABAD,SHIRDI,5243,5384,HYDERABAD-SHIRDI,10627,All
2018,12,HYDERABAD,SHIRDI,5588,5648,HYDERABAD-SHIRDI,11236,All
2019,1,HYDERABAD,SHIRDI,5837,6268,HYDERABAD-SHIRDI,12105,All
2019,2,HYDERABAD,SHIRDI,4825,5155,HYDERABAD-SHIRDI,9980,All
2019,3,HYDERABAD,SHIRDI,6078,6600,HYDERABAD-SHIRDI,12678,All
2019,4,HYDERABAD,SHIRDI,5277,5549,HYDERABAD-SHIRDI,10826,All
2019,5,HYDERABAD,SHIRDI,6341,6414,HYDERABAD-SHIRDI,12755,All
2019,6,HYDERABAD,SHIRDI,5935,5928,HYDERABAD-SHIRDI,11863,All
2019,7,HYDERABAD,SHIRDI,7093,7330,HYDERABAD-SHIRDI,14423,All
2019,8,HYDERABAD,SHIRDI,6058,6298,HYDERABAD-SHIRDI,12356,All
2019,9,HYDERABAD,SHIRDI,5912,6148,HYDERABAD-SHIRDI,12060,All
2019,10,HYDERABAD,SHIRDI,6417,7195,HYDERABAD-SHIRDI,13612,All
2019,11,HYDERABAD,SHIRDI,3698,3837,HYDERABAD-SHIRDI,7535,All
2019,12,HYDERABAD,SHIRDI,5074,5122,HYDERABAD-SHIRDI,10196,All
2020,1,HYDERABAD,SHIRDI,8106,8240,HYDERABAD-SHIRDI,16346,All
2020,2,HYDERABAD,SHIRDI,7809,8456,HYDERABAD-SHIRDI,16265,All
2020,3,HYDERABAD,SHIRDI,3945,4931,HYDERABAD-SHIRDI,8876,All
2020,6,HYDERABAD,SHIRDI,538,335,HYDERABAD-SHIRDI,873,All
2020,7,HYDERABAD,SHIRDI,262,119,HYDERABAD-SHIRDI,381,All
2020,8,HYDERABAD,SHIRDI,71,11,HYDERABAD-SHIRDI,82,All
2020,9,HYDERABAD,SHIRDI,93,48,HYDERABAD-SHIRDI,141,All
2020,12,HYDERABAD,SHIRDI,1507,1255,HYDERABAD-SHIRDI,2762,All
2021,1,HYDERABAD,SHIRDI,3495,3438,HYDERABAD-SHIRDI,6933,All
2021,2,HYDERABAD,SHIRDI,2948,3148,HYDERABAD-SHIRDI,6096,All
2021,3,HYDERABAD,SHIRDI,1557,1674,HYDERABAD-SHIRDI,3231,All
2021,4,HYDERABAD,SHIRDI,373,375,HYDERABAD-SHIRDI,748,All
2021,10,HYDERABAD,SHIRDI,926,699,HYDERABAD-SHIRDI,1625,All
2021,11,HYDERABAD,SHIRDI,5310,5262,HYDERABAD-SHIRDI,10572,All
2021,12,HYDERABAD,SHIRDI,5839,6047,HYDERABAD-SHIRDI,11886,All
2022,1,HYDERABAD,SHIRDI,2540,3152,HYDERABAD-SHIRDI,5692,All
2022,2,HYDERABAD,SHIRDI,3077,2673,HYDERABAD-SHIRDI,5750,All
2022,3,HYDERABAD,SHIRDI,7175,7302,HYDERABAD-SHIRDI,14477,All
2022,4,HYDERABAD,SHIRDI,6869,7210,HYDERABAD-SHIRDI,14079,All
2022,5,HYDERABAD,SHIRDI,7152,7245,HYDERABAD-SHIRDI,14397,All
2022,6,HYDERABAD,SHIRDI,7700,7782,HYDERABAD-SHIRDI,15482,All
2022,7,HYDERABAD,SHIRDI,7716,8044,HYDERABAD-SHIRDI,15760,All
2022,8,HYDERABAD,SHIRDI,6682,7201,HYDERABAD-SHIRDI,13883,All
2022,9,HYDERABAD,SHIRDI,6645,7006,HYDERABAD-SHIRDI,13651,All
2022,10,HYDERABAD,SHIRDI,6878,7992,HYDERABAD-SHIRDI,14870,All
2022,11,HYDERABAD,SHIRDI,7974,8141,HYDERABAD-SHIRDI,16115,All
2022,12,HYDERABAD,SHIRDI,8781,8982,HYDERABAD-SHIRDI,17763,All
2023,1,HYDERABAD,SHIRDI,8420,8876,HYDERABAD-SHIRDI,17296,All
2023,2,HYDERABAD,SHIRDI,6759,7087,HYDERABAD-SHIRDI,13846,All
2023,3,HYDERABAD,SHIRDI,7122,7441,HYDERABAD-SHIRDI,14563,All
2023,4,HYDERABAD,SHIRDI,4727,5056,HYDERABAD-SHIRDI,9783,All
2023,5,HYDERABAD,SHIRDI,4683,4974,HYDERABAD-SHIRDI,9657,All
2023,6,HYDERABAD,SHIRDI,4641,4999,HYDERABAD-SHIRDI,9640,All
2023,7,HYDERABAD,SHIRDI,5094,5281,HYDERABAD-SHIRDI,10375,All
2023,8,HYDERABAD,SHIRDI,4527,4713,HYDERABAD-SHIRDI,9240,All
2023,9,HYDERABAD,SHIRDI,4643,4815,HYDERABAD-SHIRDI,9458,All
2023,10,HYDERABAD,SHIRDI,6561,6861,HYDERABAD-SHIRDI,13422,All
2023,11,HYDERABAD,SHIRDI,8970,8810,HYDERABAD-SHIRDI,17780,All
2023,12,HYDERABAD,SHIRDI,7862,7961,HYDERABAD-SHIRDI,15823,All
2024,1,HYDERABAD,SHIRDI,8732,8616,HYDERABAD-SHIRDI,17348,All
2024,2,HYDERABAD,SHIRDI,8119,7845,HYDERABAD-SHIRDI,15964,All
2024,3,HYDERABAD,SHIRDI,8598,8541,HYDERABAD-SHIRDI,17139,All
2024,4,HYDERABAD,SHIRDI,6975,7085,HYDERABAD-SHIRDI,14060,All
2024,6,HYDERABAD,SHIRDI,7582,7554,HYDERABAD-SHIRDI,15136,All
2024,7,HYDERABAD,SHIRDI,7612,7734,HYDERABAD-SHIRDI,15346,All
2024,8,HYDERABAD,SHIRDI,6877,6902,HYDERABAD-SHIRDI,13779,All
2024,9,HYDERABAD,SHIRDI,5643,5990,HYDERABAD-SHIRDI,11633,All
2024,10,HYDERABAD,SHIRDI,5578,5877,HYDERABAD-SHIRDI,11455,All
2024,11,HYDERABAD,SHIRDI,6827,6995,HYDERABAD-SHIRDI,13822,All
2024,12,HYDERABAD,SHIRDI,8005,8151,HYDERABAD-SHIRDI,16156,All
2025,1,HYDERABAD,SHIRDI,7180,7365,HYDERABAD-SHIRDI,14545,All
2025,2,HYDERABAD,SHIRDI,5091,5340,HYDERABAD-SHIRDI,10431,All
2025,3,HYDERABAD,SHIRDI,6398,6661,HYDERABAD-SHIRDI,13059,All
2020,7,HYDERABAD,SILCHAR,307,47,HYDERABAD-SILCHAR,354,All
2020,8,HYDERABAD,SILCHAR,123,80,HYDERABAD-SILCHAR,203,All
2017,2,HYDERABAD,SRINAGAR,12,0,HYDERABAD-SRINAGAR,12,All
2017,3,HYDERABAD,SRINAGAR,21,0,HYDERABAD-SRINAGAR,21,All
2018,6,HYDERABAD,SRINAGAR,59,0,HYDERABAD-SRINAGAR,59,All
2021,7,HYDERABAD,SRINAGAR,164,240,HYDERABAD-SRINAGAR,404,All
2021,8,HYDERABAD,SRINAGAR,1642,2496,HYDERABAD-SRINAGAR,4138,All
2021,9,HYDERABAD,SRINAGAR,1654,2292,HYDERABAD-SRINAGAR,3946,All
2021,10,HYDERABAD,SRINAGAR,1339,1672,HYDERABAD-SRINAGAR,3011,All
2021,12,HYDERABAD,SRINAGAR,0,275,HYDERABAD-SRINAGAR,275,All
2022,1,HYDERABAD,SRINAGAR,0,190,HYDERABAD-SRINAGAR,190,All
2022,2,HYDERABAD,SRINAGAR,0,88,HYDERABAD-SRINAGAR,88,All
2022,3,HYDERABAD,SRINAGAR,554,562,HYDERABAD-SRINAGAR,1116,All
2022,4,HYDERABAD,SRINAGAR,3736,3663,HYDERABAD-SRINAGAR,7399,All
2022,5,HYDERABAD,SRINAGAR,4098,3992,HYDERABAD-SRINAGAR,8090,All
2022,6,HYDERABAD,SRINAGAR,3987,3972,HYDERABAD-SRINAGAR,7959,All
2022,7,HYDERABAD,SRINAGAR,3837,4097,HYDERABAD-SRINAGAR,7934,All
2022,8,HYDERABAD,SRINAGAR,3034,3348,HYDERABAD-SRINAGAR,6382,All
2022,9,HYDERABAD,SRINAGAR,3252,2950,HYDERABAD-SRINAGAR,6202,All
2022,10,HYDERABAD,SRINAGAR,4380,3814,HYDERABAD-SRINAGAR,8194,All
2023,2,HYDERABAD,SRINAGAR,1059,891,HYDERABAD-SRINAGAR,1950,All
2023,3,HYDERABAD,SRINAGAR,3046,2698,HYDERABAD-SRINAGAR,5744,All
2023,4,HYDERABAD,SRINAGAR,3616,2357,HYDERABAD-SRINAGAR,5973,All
2023,5,HYDERABAD,SRINAGAR,6119,4309,HYDERABAD-SRINAGAR,10428,All
2023,6,HYDERABAD,SRINAGAR,5224,4080,HYDERABAD-SRINAGAR,9304,All
2023,7,HYDERABAD,SRINAGAR,4976,4136,HYDERABAD-SRINAGAR,9112,All
2023,8,HYDERABAD,SRINAGAR,5202,4332,HYDERABAD-SRINAGAR,9534,All
2023,9,HYDERABAD,SRINAGAR,5342,4307,HYDERABAD-SRINAGAR,9649,All
2023,10,HYDERABAD,SRINAGAR,5500,4415,HYDERABAD-SRINAGAR,9915,All
2023,11,HYDERABAD,SRINAGAR,4787,4782,HYDERABAD-SRINAGAR,9569,All
2023,12,HYDERABAD,SRINAGAR,4852,5020,HYDERABAD-SRINAGAR,9872,All
2024,1,HYDERABAD,SRINAGAR,6150,6018,HYDERABAD-SRINAGAR,12168,All
2024,2,HYDERABAD,SRINAGAR,5750,5270,HYDERABAD-SRINAGAR,11020,All
2024,3,HYDERABAD,SRINAGAR,6095,5495,HYDERABAD-SRINAGAR,11590,All
2024,4,HYDERABAD,SRINAGAR,4670,4302,HYDERABAD-SRINAGAR,8972,All
2024,6,HYDERABAD,SRINAGAR,5301,5000,HYDERABAD-SRINAGAR,10301,All
2024,7,HYDERABAD,SRINAGAR,5020,5390,HYDERABAD-SRINAGAR,10410,All
2024,8,HYDERABAD,SRINAGAR,3178,3733,HYDERABAD-SRINAGAR,6911,All
2024,9,HYDERABAD,SRINAGAR,3010,2781,HYDERABAD-SRINAGAR,5791,All
2024,10,HYDERABAD,SRINAGAR,7156,7956,HYDERABAD-SRINAGAR,15112,All
2024,11,HYDERABAD,SRINAGAR,8824,10073,HYDERABAD-SRINAGAR,18897,All
2024,12,HYDERABAD,SRINAGAR,7067,7631,HYDERABAD-SRINAGAR,14698,All
2025,1,HYDERABAD,SRINAGAR,6433,6328,HYDERABAD-SRINAGAR,12761,All
2025,2,HYDERABAD,SRINAGAR,8394,7762,HYDERABAD-SRINAGAR,16156,All
2025,3,HYDERABAD,SRINAGAR,9368,9052,HYDERABAD-SRINAGAR,18420,All
2017,6,HYDERABAD,SURAT,2265,2057,HYDERABAD-SURAT,4322,All
2017,7,HYDERABAD,SURAT,3605,3046,HYDERABAD-SURAT,6651,All
2017,8,HYDERABAD,SURAT,4208,4215,HYDERABAD-SURAT,8423,All
2017,9,HYDERABAD,SURAT,2257,2198,HYDERABAD-SURAT,4455,All
2017,10,HYDERABAD,SURAT,2194,2307,HYDERABAD-SURAT,4501,All
2017,11,HYDERABAD,SURAT,2244,2220,HYDERABAD-SURAT,4464,All
2017,12,HYDERABAD,SURAT,2210,2224,HYDERABAD-SURAT,4434,All
2018,1,HYDERABAD,SURAT,2345,2389,HYDERABAD-SURAT,4734,All
2018,2,HYDERABAD,SURAT,2179,2176,HYDERABAD-SURAT,4355,All
2018,3,HYDERABAD,SURAT,2307,2286,HYDERABAD-SURAT,4593,All
2018,4,HYDERABAD,SURAT,2327,2318,HYDERABAD-SURAT,4645,All
2018,5,HYDERABAD,SURAT,2374,2411,HYDERABAD-SURAT,4785,All
2018,6,HYDERABAD,SURAT,2276,2288,HYDERABAD-SURAT,4564,All
2018,7,HYDERABAD,SURAT,2392,2390,HYDERABAD-SURAT,4782,All
2018,8,HYDERABAD,SURAT,3511,3420,HYDERABAD-SURAT,6931,All
2018,9,HYDERABAD,SURAT,6745,6182,HYDERABAD-SURAT,12927,All
2018,10,HYDERABAD,SURAT,6098,5970,HYDERABAD-SURAT,12068,All
2018,11,HYDERABAD,SURAT,7563,9009,HYDERABAD-SURAT,16572,All
2018,12,HYDERABAD,SURAT,8224,8716,HYDERABAD-SURAT,16940,All
2019,1,HYDERABAD,SURAT,7896,8480,HYDERABAD-SURAT,16376,All
2019,2,HYDERABAD,SURAT,8397,9119,HYDERABAD-SURAT,17516,All
2019,3,HYDERABAD,SURAT,9253,9860,HYDERABAD-SURAT,19113,All
2019,4,HYDERABAD,SURAT,7043,7267,HYDERABAD-SURAT,14310,All
2019,5,HYDERABAD,SURAT,6785,7859,HYDERABAD-SURAT,14644,All
2019,6,HYDERABAD,SURAT,7015,6816,HYDERABAD-SURAT,13831,All
2019,7,HYDERABAD,SURAT,6797,6617,HYDERABAD-SURAT,13414,All
2019,8,HYDERABAD,SURAT,2715,2690,HYDERABAD-SURAT,5405,All
2019,9,HYDERABAD,SURAT,2499,2598,HYDERABAD-SURAT,5097,All
2019,10,HYDERABAD,SURAT,3253,4122,HYDERABAD-SURAT,7375,All
2019,11,HYDERABAD,SURAT,7047,7235,HYDERABAD-SURAT,14282,All
2019,12,HYDERABAD,SURAT,6976,7390,HYDERABAD-SURAT,14366,All
2020,1,HYDERABAD,SURAT,5717,6081,HYDERABAD-SURAT,11798,All
2020,2,HYDERABAD,SURAT,4883,4772,HYDERABAD-SURAT,9655,All
2020,3,HYDERABAD,SURAT,3345,3362,HYDERABAD-SURAT,6707,All
2020,5,HYDERABAD,SURAT,104,123,HYDERABAD-SURAT,227,All
2020,6,HYDERABAD,SURAT,829,880,HYDERABAD-SURAT,1709,All
2020,7,HYDERABAD,SURAT,306,535,HYDERABAD-SURAT,841,All
2020,8,HYDERABAD,SURAT,1127,1351,HYDERABAD-SURAT,2478,All
2020,9,HYDERABAD,SURAT,2316,2335,HYDERABAD-SURAT,4651,All
2020,10,HYDERABAD,SURAT,2995,3214,HYDERABAD-SURAT,6209,All
2020,11,HYDERABAD,SURAT,3791,5521,HYDERABAD-SURAT,9312,All
2020,12,HYDERABAD,SURAT,3346,5156,HYDERABAD-SURAT,8502,All
2021,1,HYDERABAD,SURAT,2936,3837,HYDERABAD-SURAT,6773,All
2021,2,HYDERABAD,SURAT,3244,3570,HYDERABAD-SURAT,6814,All
2021,3,HYDERABAD,SURAT,2611,2880,HYDERABAD-SURAT,5491,All
2021,4,HYDERABAD,SURAT,233,284,HYDERABAD-SURAT,517,All
2021,6,HYDERABAD,SURAT,513,409,HYDERABAD-SURAT,922,All
2021,7,HYDERABAD,SURAT,1150,1120,HYDERABAD-SURAT,2270,All
2021,8,HYDERABAD,SURAT,3826,4320,HYDERABAD-SURAT,8146,All
2021,9,HYDERABAD,SURAT,3727,3804,HYDERABAD-SURAT,7531,All
2021,10,HYDERABAD,SURAT,2896,3532,HYDERABAD-SURAT,6428,All
2021,11,HYDERABAD,SURAT,4282,3797,HYDERABAD-SURAT,8079,All
2021,12,HYDERABAD,SURAT,3970,3372,HYDERABAD-SURAT,7342,All
2022,1,HYDERABAD,SURAT,2695,2003,HYDERABAD-SURAT,4698,All
2022,2,HYDERABAD,SURAT,3661,2933,HYDERABAD-SURAT,6594,All
2022,3,HYDERABAD,SURAT,5006,4828,HYDERABAD-SURAT,9834,All
2022,4,HYDERABAD,SURAT,3935,4448,HYDERABAD-SURAT,8383,All
2022,5,HYDERABAD,SURAT,4057,5052,HYDERABAD-SURAT,9109,All
2022,6,HYDERABAD,SURAT,4375,4797,HYDERABAD-SURAT,9172,All
2022,7,HYDERABAD,SURAT,3687,4852,HYDERABAD-SURAT,8539,All
2022,8,HYDERABAD,SURAT,3959,5004,HYDERABAD-SURAT,8963,All
2022,9,HYDERABAD,SURAT,2388,2582,HYDERABAD-SURAT,4970,All
2022,10,HYDERABAD,SURAT,4701,5360,HYDERABAD-SURAT,10061,All
2022,11,HYDERABAD,SURAT,4478,4059,HYDERABAD-SURAT,8537,All
2022,12,HYDERABAD,SURAT,4085,4049,HYDERABAD-SURAT,8134,All
2023,1,HYDERABAD,SURAT,4617,4265,HYDERABAD-SURAT,8882,All
2023,2,HYDERABAD,SURAT,4445,4705,HYDERABAD-SURAT,9150,All
2023,3,HYDERABAD,SURAT,4370,4727,HYDERABAD-SURAT,9097,All
2023,4,HYDERABAD,SURAT,4361,4421,HYDERABAD-SURAT,8782,All
2023,5,HYDERABAD,SURAT,4739,4868,HYDERABAD-SURAT,9607,All
2023,6,HYDERABAD,SURAT,4192,4353,HYDERABAD-SURAT,8545,All
2023,7,HYDERABAD,SURAT,4146,4054,HYDERABAD-SURAT,8200,All
2023,8,HYDERABAD,SURAT,4221,4048,HYDERABAD-SURAT,8269,All
2023,9,HYDERABAD,SURAT,4060,3958,HYDERABAD-SURAT,8018,All
2023,10,HYDERABAD,SURAT,3864,4073,HYDERABAD-SURAT,7937,All
2023,11,HYDERABAD,SURAT,4672,5351,HYDERABAD-SURAT,10023,All
2023,12,HYDERABAD,SURAT,6177,6331,HYDERABAD-SURAT,12508,All
2024,1,HYDERABAD,SURAT,6445,6238,HYDERABAD-SURAT,12683,All
2024,2,HYDERABAD,SURAT,6773,7172,HYDERABAD-SURAT,13945,All
2024,3,HYDERABAD,SURAT,7171,7205,HYDERABAD-SURAT,14376,All
2024,4,HYDERABAD,SURAT,6456,5508,HYDERABAD-SURAT,11964,All
2024,6,HYDERABAD,SURAT,6851,7569,HYDERABAD-SURAT,14420,All
2024,7,HYDERABAD,SURAT,6304,6879,HYDERABAD-SURAT,13183,All
2024,8,HYDERABAD,SURAT,7098,6825,HYDERABAD-SURAT,13923,All
2024,9,HYDERABAD,SURAT,7226,6988,HYDERABAD-SURAT,14214,All
2024,10,HYDERABAD,SURAT,7962,7968,HYDERABAD-SURAT,15930,All
2024,11,HYDERABAD,SURAT,8167,7780,HYDERABAD-SURAT,15947,All
2024,12,HYDERABAD,SURAT,8612,8365,HYDERABAD-SURAT,16977,All
2025,1,HYDERABAD,SURAT,8066,7951,HYDERABAD-SURAT,16017,All
2025,2,HYDERABAD,SURAT,6859,6969,HYDERABAD-SURAT,13828,All
2025,3,HYDERABAD,SURAT,6306,6917,HYDERABAD-SURAT,13223,All
2023,11,HYDERABAD,Shivamogga Airport,472,420,HYDERABAD-Shivamogga Airport,892,All
2023,12,HYDERABAD,Shivamogga Airport,964,932,HYDERABAD-Shivamogga Airport,1896,All
2024,1,HYDERABAD,Shivamogga Airport,743,728,HYDERABAD-Shivamogga Airport,1471,All
2024,2,HYDERABAD,Shivamogga Airport,943,921,HYDERABAD-Shivamogga Airport,1864,All
2024,3,HYDERABAD,Shivamogga Airport,971,908,HYDERABAD-Shivamogga Airport,1879,All
2024,4,HYDERABAD,Shivamogga Airport,1019,915,HYDERABAD-Shivamogga Airport,1934,All
2024,6,HYDERABAD,Shivamogga Airport,881,977,HYDERABAD-Shivamogga Airport,1858,All
2024,7,HYDERABAD,Shivamogga Airport,1010,810,HYDERABAD-Shivamogga Airport,1820,All
2024,8,HYDERABAD,Shivamogga Airport,223,191,HYDERABAD-Shivamogga Airport,414,All
2024,9,HYDERABAD,Shivamogga Airport,646,665,HYDERABAD-Shivamogga Airport,1311,All
2024,10,HYDERABAD,Shivamogga Airport,2063,2074,HYDERABAD-Shivamogga Airport,4137,All
2024,11,HYDERABAD,Shivamogga Airport,2361,2230,HYDERABAD-Shivamogga Airport,4591,All
2024,12,HYDERABAD,Shivamogga Airport,2972,2910,HYDERABAD-Shivamogga Airport,5882,All
2025,1,HYDERABAD,Shivamogga Airport,2504,2756,HYDERABAD-Shivamogga Airport,5260,All
2025,2,HYDERABAD,Shivamogga Airport,2708,2358,HYDERABAD-Shivamogga Airport,5066,All
2025,3,HYDERABAD,Shivamogga Airport,2494,2272,HYDERABAD-Shivamogga Airport,4766,All
2019,10,HYDERABAD,TIRUCHIRAPALLY,203,304,HYDERABAD-TIRUCHIRAPALLY,507,All
2019,11,HYDERABAD,TIRUCHIRAPALLY,1639,1756,HYDERABAD-TIRUCHIRAPALLY,3395,All
2019,12,HYDERABAD,TIRUCHIRAPALLY,2048,2011,HYDERABAD-TIRUCHIRAPALLY,4059,All
2020,1,HYDERABAD,TIRUCHIRAPALLY,2095,2029,HYDERABAD-TIRUCHIRAPALLY,4124,All
2020,2,HYDERABAD,TIRUCHIRAPALLY,1877,1782,HYDERABAD-TIRUCHIRAPALLY,3659,All
2020,3,HYDERABAD,TIRUCHIRAPALLY,1206,1267,HYDERABAD-TIRUCHIRAPALLY,2473,All
2020,6,HYDERABAD,TIRUCHIRAPALLY,205,145,HYDERABAD-TIRUCHIRAPALLY,350,All
2020,7,HYDERABAD,TIRUCHIRAPALLY,1753,1079,HYDERABAD-TIRUCHIRAPALLY,2832,All
2020,8,HYDERABAD,TIRUCHIRAPALLY,2221,1321,HYDERABAD-TIRUCHIRAPALLY,3542,All
2020,9,HYDERABAD,TIRUCHIRAPALLY,3242,2508,HYDERABAD-TIRUCHIRAPALLY,5750,All
2020,10,HYDERABAD,TIRUCHIRAPALLY,1934,2274,HYDERABAD-TIRUCHIRAPALLY,4208,All
2020,11,HYDERABAD,TIRUCHIRAPALLY,1928,3580,HYDERABAD-TIRUCHIRAPALLY,5508,All
2020,12,HYDERABAD,TIRUCHIRAPALLY,1482,2269,HYDERABAD-TIRUCHIRAPALLY,3751,All
2021,1,HYDERABAD,TIRUCHIRAPALLY,1780,1718,HYDERABAD-TIRUCHIRAPALLY,3498,All
2021,2,HYDERABAD,TIRUCHIRAPALLY,1888,1447,HYDERABAD-TIRUCHIRAPALLY,3335,All
2021,3,HYDERABAD,TIRUCHIRAPALLY,1663,1368,HYDERABAD-TIRUCHIRAPALLY,3031,All
2021,7,HYDERABAD,TIRUCHIRAPALLY,1000,729,HYDERABAD-TIRUCHIRAPALLY,1729,All
2021,8,HYDERABAD,TIRUCHIRAPALLY,1343,1108,HYDERABAD-TIRUCHIRAPALLY,2451,All
2021,9,HYDERABAD,TIRUCHIRAPALLY,1335,1321,HYDERABAD-TIRUCHIRAPALLY,2656,All
2021,10,HYDERABAD,TIRUCHIRAPALLY,1821,1824,HYDERABAD-TIRUCHIRAPALLY,3645,All
2021,11,HYDERABAD,TIRUCHIRAPALLY,1759,1760,HYDERABAD-TIRUCHIRAPALLY,3519,All
2021,12,HYDERABAD,TIRUCHIRAPALLY,2055,2110,HYDERABAD-TIRUCHIRAPALLY,4165,All
2022,1,HYDERABAD,TIRUCHIRAPALLY,1424,1318,HYDERABAD-TIRUCHIRAPALLY,2742,All
2022,2,HYDERABAD,TIRUCHIRAPALLY,1914,1695,HYDERABAD-TIRUCHIRAPALLY,3609,All
2022,3,HYDERABAD,TIRUCHIRAPALLY,2302,1808,HYDERABAD-TIRUCHIRAPALLY,4110,All
2022,4,HYDERABAD,TIRUCHIRAPALLY,2503,1921,HYDERABAD-TIRUCHIRAPALLY,4424,All
2022,5,HYDERABAD,TIRUCHIRAPALLY,3778,3186,HYDERABAD-TIRUCHIRAPALLY,6964,All
2022,6,HYDERABAD,TIRUCHIRAPALLY,3864,3504,HYDERABAD-TIRUCHIRAPALLY,7368,All
2022,7,HYDERABAD,TIRUCHIRAPALLY,3654,3196,HYDERABAD-TIRUCHIRAPALLY,6850,All
2022,8,HYDERABAD,TIRUCHIRAPALLY,3939,3359,HYDERABAD-TIRUCHIRAPALLY,7298,All
2022,9,HYDERABAD,TIRUCHIRAPALLY,3340,3296,HYDERABAD-TIRUCHIRAPALLY,6636,All
2022,10,HYDERABAD,TIRUCHIRAPALLY,3549,3869,HYDERABAD-TIRUCHIRAPALLY,7418,All
2022,11,HYDERABAD,TIRUCHIRAPALLY,3014,3640,HYDERABAD-TIRUCHIRAPALLY,6654,All
2022,12,HYDERABAD,TIRUCHIRAPALLY,3394,3685,HYDERABAD-TIRUCHIRAPALLY,7079,All
2023,1,HYDERABAD,TIRUCHIRAPALLY,3625,3621,HYDERABAD-TIRUCHIRAPALLY,7246,All
2023,2,HYDERABAD,TIRUCHIRAPALLY,3046,3228,HYDERABAD-TIRUCHIRAPALLY,6274,All
2023,3,HYDERABAD,TIRUCHIRAPALLY,3277,3069,HYDERABAD-TIRUCHIRAPALLY,6346,All
2023,4,HYDERABAD,TIRUCHIRAPALLY,3669,3245,HYDERABAD-TIRUCHIRAPALLY,6914,All
2023,5,HYDERABAD,TIRUCHIRAPALLY,4292,4005,HYDERABAD-TIRUCHIRAPALLY,8297,All
2023,6,HYDERABAD,TIRUCHIRAPALLY,4117,3812,HYDERABAD-TIRUCHIRAPALLY,7929,All
2023,7,HYDERABAD,TIRUCHIRAPALLY,4538,4294,HYDERABAD-TIRUCHIRAPALLY,8832,All
2023,8,HYDERABAD,TIRUCHIRAPALLY,4611,4513,HYDERABAD-TIRUCHIRAPALLY,9124,All
2023,9,HYDERABAD,TIRUCHIRAPALLY,4025,4148,HYDERABAD-TIRUCHIRAPALLY,8173,All
2023,10,HYDERABAD,TIRUCHIRAPALLY,3957,3675,HYDERABAD-TIRUCHIRAPALLY,7632,All
2023,11,HYDERABAD,TIRUCHIRAPALLY,5066,4970,HYDERABAD-TIRUCHIRAPALLY,10036,All
2023,12,HYDERABAD,TIRUCHIRAPALLY,6097,5972,HYDERABAD-TIRUCHIRAPALLY,12069,All
2024,1,HYDERABAD,TIRUCHIRAPALLY,6358,5990,HYDERABAD-TIRUCHIRAPALLY,12348,All
2024,2,HYDERABAD,TIRUCHIRAPALLY,5761,5838,HYDERABAD-TIRUCHIRAPALLY,11599,All
2024,3,HYDERABAD,TIRUCHIRAPALLY,6131,6021,HYDERABAD-TIRUCHIRAPALLY,12152,All
2024,4,HYDERABAD,TIRUCHIRAPALLY,4386,4357,HYDERABAD-TIRUCHIRAPALLY,8743,All
2024,6,HYDERABAD,TIRUCHIRAPALLY,4496,4459,HYDERABAD-TIRUCHIRAPALLY,8955,All
2024,7,HYDERABAD,TIRUCHIRAPALLY,4879,4450,HYDERABAD-TIRUCHIRAPALLY,9329,All
2024,8,HYDERABAD,TIRUCHIRAPALLY,4827,4952,HYDERABAD-TIRUCHIRAPALLY,9779,All
2024,9,HYDERABAD,TIRUCHIRAPALLY,4744,4978,HYDERABAD-TIRUCHIRAPALLY,9722,All
2024,10,HYDERABAD,TIRUCHIRAPALLY,5087,4679,HYDERABAD-TIRUCHIRAPALLY,9766,All
2024,11,HYDERABAD,TIRUCHIRAPALLY,4732,4468,HYDERABAD-TIRUCHIRAPALLY,9200,All
2024,12,HYDERABAD,TIRUCHIRAPALLY,5230,4638,HYDERABAD-TIRUCHIRAPALLY,9868,All
2025,1,HYDERABAD,TIRUCHIRAPALLY,5195,4479,HYDERABAD-TIRUCHIRAPALLY,9674,All
2025,2,HYDERABAD,TIRUCHIRAPALLY,4829,4750,HYDERABAD-TIRUCHIRAPALLY,9579,All
2025,3,HYDERABAD,TIRUCHIRAPALLY,4705,4168,HYDERABAD-TIRUCHIRAPALLY,8873,All
2015,4,HYDERABAD,TIRUPATI,10866,10165,HYDERABAD-TIRUPATI,21031,All
2015,5,HYDERABAD,TIRUPATI,10703,9735,HYDERABAD-TIRUPATI,20438,All
2015,6,HYDERABAD,TIRUPATI,10940,10355,HYDERABAD-TIRUPATI,21295,All
2015,7,HYDERABAD,TIRUPATI,13125,12922,HYDERABAD-TIRUPATI,26047,All
2015,8,HYDERABAD,TIRUPATI,15627,15182,HYDERABAD-TIRUPATI,30809,All
2015,9,HYDERABAD,TIRUPATI,14289,13407,HYDERABAD-TIRUPATI,27696,All
2015,10,HYDERABAD,TIRUPATI,14814,14018,HYDERABAD-TIRUPATI,28832,All
2015,11,HYDERABAD,TIRUPATI,15785,15529,HYDERABAD-TIRUPATI,31314,All
2015,12,HYDERABAD,TIRUPATI,16239,16383,HYDERABAD-TIRUPATI,32622,All
2016,1,HYDERABAD,TIRUPATI,15398,15893,HYDERABAD-TIRUPATI,31291,All
2016,2,HYDERABAD,TIRUPATI,15076,15527,HYDERABAD-TIRUPATI,30603,All
2016,3,HYDERABAD,TIRUPATI,15988,17148,HYDERABAD-TIRUPATI,33136,All
2016,4,HYDERABAD,TIRUPATI,16213,17094,HYDERABAD-TIRUPATI,33307,All
2016,5,HYDERABAD,TIRUPATI,18279,18553,HYDERABAD-TIRUPATI,36832,All
2016,6,HYDERABAD,TIRUPATI,18439,18821,HYDERABAD-TIRUPATI,37260,All
2016,7,HYDERABAD,TIRUPATI,18983,18973,HYDERABAD-TIRUPATI,37956,All
2016,8,HYDERABAD,TIRUPATI,18439,18294,HYDERABAD-TIRUPATI,36733,All
2016,9,HYDERABAD,TIRUPATI,17269,17415,HYDERABAD-TIRUPATI,34684,All
2016,10,HYDERABAD,TIRUPATI,16206,16481,HYDERABAD-TIRUPATI,32687,All
2016,11,HYDERABAD,TIRUPATI,17817,17968,HYDERABAD-TIRUPATI,35785,All
2016,12,HYDERABAD,TIRUPATI,18006,17839,HYDERABAD-TIRUPATI,35845,All
2017,1,HYDERABAD,TIRUPATI,18123,17997,HYDERABAD-TIRUPATI,36120,All
2017,2,HYDERABAD,TIRUPATI,17864,17793,HYDERABAD-TIRUPATI,35657,All
2017,3,HYDERABAD,TIRUPATI,17882,17858,HYDERABAD-TIRUPATI,35740,All
2017,4,HYDERABAD,TIRUPATI,18072,17933,HYDERABAD-TIRUPATI,36005,All
2017,5,HYDERABAD,TIRUPATI,18373,18022,HYDERABAD-TIRUPATI,36395,All
2017,6,HYDERABAD,TIRUPATI,18051,18320,HYDERABAD-TIRUPATI,36371,All
2017,7,HYDERABAD,TIRUPATI,21803,21929,HYDERABAD-TIRUPATI,43732,All
2017,8,HYDERABAD,TIRUPATI,22166,22152,HYDERABAD-TIRUPATI,44318,All
2017,9,HYDERABAD,TIRUPATI,18520,18597,HYDERABAD-TIRUPATI,37117,All
2017,10,HYDERABAD,TIRUPATI,18392,18431,HYDERABAD-TIRUPATI,36823,All
2017,11,HYDERABAD,TIRUPATI,17945,17749,HYDERABAD-TIRUPATI,35694,All
2017,12,HYDERABAD,TIRUPATI,16584,16910,HYDERABAD-TIRUPATI,33494,All
2018,1,HYDERABAD,TIRUPATI,19830,20426,HYDERABAD-TIRUPATI,40256,All
2018,2,HYDERABAD,TIRUPATI,20403,20669,HYDERABAD-TIRUPATI,41072,All
2018,3,HYDERABAD,TIRUPATI,25957,26419,HYDERABAD-TIRUPATI,52376,All
2018,4,HYDERABAD,TIRUPATI,27208,27655,HYDERABAD-TIRUPATI,54863,All
2018,5,HYDERABAD,TIRUPATI,26390,26359,HYDERABAD-TIRUPATI,52749,All
2018,6,HYDERABAD,TIRUPATI,26385,26537,HYDERABAD-TIRUPATI,52922,All
2018,7,HYDERABAD,TIRUPATI,28463,29056,HYDERABAD-TIRUPATI,57519,All
2018,8,HYDERABAD,TIRUPATI,27523,28653,HYDERABAD-TIRUPATI,56176,All
2018,9,HYDERABAD,TIRUPATI,26935,27846,HYDERABAD-TIRUPATI,54781,All
2018,10,HYDERABAD,TIRUPATI,23884,24992,HYDERABAD-TIRUPATI,48876,All
2018,11,HYDERABAD,TIRUPATI,25759,25350,HYDERABAD-TIRUPATI,51109,All
2018,12,HYDERABAD,TIRUPATI,27334,27526,HYDERABAD-TIRUPATI,54860,All
2019,1,HYDERABAD,TIRUPATI,26205,26272,HYDERABAD-TIRUPATI,52477,All
2019,2,HYDERABAD,TIRUPATI,27238,25352,HYDERABAD-TIRUPATI,52590,All
2019,3,HYDERABAD,TIRUPATI,29053,28524,HYDERABAD-TIRUPATI,57577,All
2019,4,HYDERABAD,TIRUPATI,27501,28283,HYDERABAD-TIRUPATI,55784,All
2019,5,HYDERABAD,TIRUPATI,29086,29429,HYDERABAD-TIRUPATI,58515,All
2019,6,HYDERABAD,TIRUPATI,28277,28504,HYDERABAD-TIRUPATI,56781,All
2019,7,HYDERABAD,TIRUPATI,23691,23921,HYDERABAD-TIRUPATI,47612,All
2019,8,HYDERABAD,TIRUPATI,23263,23314,HYDERABAD-TIRUPATI,46577,All
2019,9,HYDERABAD,TIRUPATI,21588,21888,HYDERABAD-TIRUPATI,43476,All
2019,10,HYDERABAD,TIRUPATI,22058,22312,HYDERABAD-TIRUPATI,44370,All
2019,11,HYDERABAD,TIRUPATI,26183,27199,HYDERABAD-TIRUPATI,53382,All
2019,12,HYDERABAD,TIRUPATI,27330,28753,HYDERABAD-TIRUPATI,56083,All
2020,1,HYDERABAD,TIRUPATI,25176,27438,HYDERABAD-TIRUPATI,52614,All
2020,2,HYDERABAD,TIRUPATI,25076,25726,HYDERABAD-TIRUPATI,50802,All
2020,3,HYDERABAD,TIRUPATI,14506,16276,HYDERABAD-TIRUPATI,30782,All
2020,5,HYDERABAD,TIRUPATI,349,266,HYDERABAD-TIRUPATI,615,All
2020,6,HYDERABAD,TIRUPATI,2608,2413,HYDERABAD-TIRUPATI,5021,All
2020,7,HYDERABAD,TIRUPATI,3190,3079,HYDERABAD-TIRUPATI,6269,All
2020,8,HYDERABAD,TIRUPATI,6000,5739,HYDERABAD-TIRUPATI,11739,All
2020,9,HYDERABAD,TIRUPATI,8244,7430,HYDERABAD-TIRUPATI,15674,All
2020,10,HYDERABAD,TIRUPATI,12406,11889,HYDERABAD-TIRUPATI,24295,All
2020,11,HYDERABAD,TIRUPATI,13404,13935,HYDERABAD-TIRUPATI,27339,All
2020,12,HYDERABAD,TIRUPATI,17894,17524,HYDERABAD-TIRUPATI,35418,All
2021,1,HYDERABAD,TIRUPATI,21507,21715,HYDERABAD-TIRUPATI,43222,All
2021,2,HYDERABAD,TIRUPATI,21178,20836,HYDERABAD-TIRUPATI,42014,All
2021,3,HYDERABAD,TIRUPATI,23301,22900,HYDERABAD-TIRUPATI,46201,All
2021,4,HYDERABAD,TIRUPATI,14118,14138,HYDERABAD-TIRUPATI,28256,All
2021,6,HYDERABAD,TIRUPATI,7058,7045,HYDERABAD-TIRUPATI,14103,All
2021,7,HYDERABAD,TIRUPATI,15661,15270,HYDERABAD-TIRUPATI,30931,All
2021,8,HYDERABAD,TIRUPATI,22196,22742,HYDERABAD-TIRUPATI,44938,All
2021,9,HYDERABAD,TIRUPATI,21186,20805,HYDERABAD-TIRUPATI,41991,All
2021,10,HYDERABAD,TIRUPATI,22244,21994,HYDERABAD-TIRUPATI,44238,All
2021,11,HYDERABAD,TIRUPATI,21603,22155,HYDERABAD-TIRUPATI,43758,All
2021,12,HYDERABAD,TIRUPATI,25722,25238,HYDERABAD-TIRUPATI,50960,All
2022,1,HYDERABAD,TIRUPATI,19375,19944,HYDERABAD-TIRUPATI,39319,All
2022,2,HYDERABAD,TIRUPATI,21337,21894,HYDERABAD-TIRUPATI,43231,All
2022,3,HYDERABAD,TIRUPATI,25769,26407,HYDERABAD-TIRUPATI,52176,All
2022,4,HYDERABAD,TIRUPATI,23262,22952,HYDERABAD-TIRUPATI,46214,All
2022,5,HYDERABAD,TIRUPATI,22907,23404,HYDERABAD-TIRUPATI,46311,All
2022,6,HYDERABAD,TIRUPATI,23093,23535,HYDERABAD-TIRUPATI,46628,All
2022,7,HYDERABAD,TIRUPATI,24541,24261,HYDERABAD-TIRUPATI,48802,All
2022,8,HYDERABAD,TIRUPATI,24097,24859,HYDERABAD-TIRUPATI,48956,All
2022,9,HYDERABAD,TIRUPATI,21203,21370,HYDERABAD-TIRUPATI,42573,All
2022,10,HYDERABAD,TIRUPATI,20652,20953,HYDERABAD-TIRUPATI,41605,All
2022,11,HYDERABAD,TIRUPATI,23637,23517,HYDERABAD-TIRUPATI,47154,All
2022,12,HYDERABAD,TIRUPATI,27104,26900,HYDERABAD-TIRUPATI,54004,All
2023,1,HYDERABAD,TIRUPATI,26648,26894,HYDERABAD-TIRUPATI,53542,All
2023,2,HYDERABAD,TIRUPATI,25514,25389,HYDERABAD-TIRUPATI,50903,All
2023,3,HYDERABAD,TIRUPATI,27013,26981,HYDERABAD-TIRUPATI,53994,All
2023,4,HYDERABAD,TIRUPATI,24683,24538,HYDERABAD-TIRUPATI,49221,All
2023,5,HYDERABAD,TIRUPATI,26521,25934,HYDERABAD-TIRUPATI,52455,All
2023,6,HYDERABAD,TIRUPATI,24473,24851,HYDERABAD-TIRUPATI,49324,All
2023,7,HYDERABAD,TIRUPATI,25158,24620,HYDERABAD-TIRUPATI,49778,All
2023,8,HYDERABAD,TIRUPATI,24577,24141,HYDERABAD-TIRUPATI,48718,All
2023,9,HYDERABAD,TIRUPATI,22539,21606,HYDERABAD-TIRUPATI,44145,All
2023,10,HYDERABAD,TIRUPATI,23586,22225,HYDERABAD-TIRUPATI,45811,All
2023,11,HYDERABAD,TIRUPATI,26341,25530,HYDERABAD-TIRUPATI,51871,All
2023,12,HYDERABAD,TIRUPATI,26557,26485,HYDERABAD-TIRUPATI,53042,All
2024,1,HYDERABAD,TIRUPATI,28907,28441,HYDERABAD-TIRUPATI,57348,All
2024,2,HYDERABAD,TIRUPATI,27874,27620,HYDERABAD-TIRUPATI,55494,All
2024,3,HYDERABAD,TIRUPATI,33261,32785,HYDERABAD-TIRUPATI,66046,All
2024,4,HYDERABAD,TIRUPATI,28178,27750,HYDERABAD-TIRUPATI,55928,All
2024,6,HYDERABAD,TIRUPATI,28497,27505,HYDERABAD-TIRUPATI,56002,All
2024,7,HYDERABAD,TIRUPATI,28740,28204,HYDERABAD-TIRUPATI,56944,All
2024,8,HYDERABAD,TIRUPATI,29302,28954,HYDERABAD-TIRUPATI,58256,All
2024,9,HYDERABAD,TIRUPATI,28796,28656,HYDERABAD-TIRUPATI,57452,All
2024,10,HYDERABAD,TIRUPATI,28049,27998,HYDERABAD-TIRUPATI,56047,All
2024,11,HYDERABAD,TIRUPATI,29992,29503,HYDERABAD-TIRUPATI,59495,All
2024,12,HYDERABAD,TIRUPATI,33356,32359,HYDERABAD-TIRUPATI,65715,All
2025,1,HYDERABAD,TIRUPATI,32780,32111,HYDERABAD-TIRUPATI,64891,All
2025,2,HYDERABAD,TIRUPATI,33593,32209,HYDERABAD-TIRUPATI,65802,All
2025,3,HYDERABAD,TIRUPATI,37991,37228,HYDERABAD-TIRUPATI,75219,All
2015,4,HYDERABAD,TRIVANDRUM,2090,2352,HYDERABAD-TRIVANDRUM,4442,All
2015,5,HYDERABAD,TRIVANDRUM,2539,2670,HYDERABAD-TRIVANDRUM,5209,All
2015,6,HYDERABAD,TRIVANDRUM,1632,2452,HYDERABAD-TRIVANDRUM,4084,All
2015,7,HYDERABAD,TRIVANDRUM,1726,2038,HYDERABAD-TRIVANDRUM,3764,All
2015,8,HYDERABAD,TRIVANDRUM,2398,2274,HYDERABAD-TRIVANDRUM,4672,All
2015,9,HYDERABAD,TRIVANDRUM,2383,2690,HYDERABAD-TRIVANDRUM,5073,All
2015,10,HYDERABAD,TRIVANDRUM,2432,2895,HYDERABAD-TRIVANDRUM,5327,All
2015,11,HYDERABAD,TRIVANDRUM,2338,2635,HYDERABAD-TRIVANDRUM,4973,All
2015,12,HYDERABAD,TRIVANDRUM,3056,3102,HYDERABAD-TRIVANDRUM,6158,All
2016,1,HYDERABAD,TRIVANDRUM,3065,3581,HYDERABAD-TRIVANDRUM,6646,All
2016,2,HYDERABAD,TRIVANDRUM,1903,2396,HYDERABAD-TRIVANDRUM,4299,All
2016,3,HYDERABAD,TRIVANDRUM,1683,2326,HYDERABAD-TRIVANDRUM,4009,All
2016,4,HYDERABAD,TRIVANDRUM,1722,2189,HYDERABAD-TRIVANDRUM,3911,All
2016,5,HYDERABAD,TRIVANDRUM,1837,2602,HYDERABAD-TRIVANDRUM,4439,All
2016,6,HYDERABAD,TRIVANDRUM,1156,2384,HYDERABAD-TRIVANDRUM,3540,All
2016,7,HYDERABAD,TRIVANDRUM,1169,1801,HYDERABAD-TRIVANDRUM,2970,All
2016,8,HYDERABAD,TRIVANDRUM,1178,1746,HYDERABAD-TRIVANDRUM,2924,All
2016,9,HYDERABAD,TRIVANDRUM,1230,1740,HYDERABAD-TRIVANDRUM,2970,All
2016,10,HYDERABAD,TRIVANDRUM,1170,1990,HYDERABAD-TRIVANDRUM,3160,All
2016,11,HYDERABAD,TRIVANDRUM,1000,1591,HYDERABAD-TRIVANDRUM,2591,All
2016,12,HYDERABAD,TRIVANDRUM,1142,1903,HYDERABAD-TRIVANDRUM,3045,All
2017,1,HYDERABAD,TRIVANDRUM,975,1303,HYDERABAD-TRIVANDRUM,2278,All
2017,2,HYDERABAD,TRIVANDRUM,896,774,HYDERABAD-TRIVANDRUM,1670,All
2017,3,HYDERABAD,TRIVANDRUM,857,532,HYDERABAD-TRIVANDRUM,1389,All
2017,4,HYDERABAD,TRIVANDRUM,2187,2344,HYDERABAD-TRIVANDRUM,4531,All
2017,5,HYDERABAD,TRIVANDRUM,3491,4126,HYDERABAD-TRIVANDRUM,7617,All
2017,6,HYDERABAD,TRIVANDRUM,2903,4660,HYDERABAD-TRIVANDRUM,7563,All
2017,7,HYDERABAD,TRIVANDRUM,2807,3523,HYDERABAD-TRIVANDRUM,6330,All
2017,8,HYDERABAD,TRIVANDRUM,3665,4326,HYDERABAD-TRIVANDRUM,7991,All
2017,9,HYDERABAD,TRIVANDRUM,4950,6326,HYDERABAD-TRIVANDRUM,11276,All
2017,10,HYDERABAD,TRIVANDRUM,4275,5591,HYDERABAD-TRIVANDRUM,9866,All
2017,11,HYDERABAD,TRIVANDRUM,5383,7293,HYDERABAD-TRIVANDRUM,12676,All
2017,12,HYDERABAD,TRIVANDRUM,7241,9076,HYDERABAD-TRIVANDRUM,16317,All
2018,1,HYDERABAD,TRIVANDRUM,6735,8594,HYDERABAD-TRIVANDRUM,15329,All
2018,2,HYDERABAD,TRIVANDRUM,4506,6041,HYDERABAD-TRIVANDRUM,10547,All
2018,3,HYDERABAD,TRIVANDRUM,4065,6042,HYDERABAD-TRIVANDRUM,10107,All
2018,4,HYDERABAD,TRIVANDRUM,2132,3813,HYDERABAD-TRIVANDRUM,5945,All
2018,5,HYDERABAD,TRIVANDRUM,2239,2975,HYDERABAD-TRIVANDRUM,5214,All
2018,6,HYDERABAD,TRIVANDRUM,2555,3588,HYDERABAD-TRIVANDRUM,6143,All
2018,7,HYDERABAD,TRIVANDRUM,3968,4424,HYDERABAD-TRIVANDRUM,8392,All
2018,8,HYDERABAD,TRIVANDRUM,6994,7486,HYDERABAD-TRIVANDRUM,14480,All
2018,9,HYDERABAD,TRIVANDRUM,4420,5185,HYDERABAD-TRIVANDRUM,9605,All
2018,10,HYDERABAD,TRIVANDRUM,5265,5460,HYDERABAD-TRIVANDRUM,10725,All
2018,11,HYDERABAD,TRIVANDRUM,6228,5473,HYDERABAD-TRIVANDRUM,11701,All
2018,12,HYDERABAD,TRIVANDRUM,7399,6858,HYDERABAD-TRIVANDRUM,14257,All
2019,1,HYDERABAD,TRIVANDRUM,6763,7476,HYDERABAD-TRIVANDRUM,14239,All
2019,2,HYDERABAD,TRIVANDRUM,5868,5278,HYDERABAD-TRIVANDRUM,11146,All
2019,3,HYDERABAD,TRIVANDRUM,6141,5779,HYDERABAD-TRIVANDRUM,11920,All
2019,4,HYDERABAD,TRIVANDRUM,5489,4627,HYDERABAD-TRIVANDRUM,10116,All
2019,5,HYDERABAD,TRIVANDRUM,5318,4473,HYDERABAD-TRIVANDRUM,9791,All
2019,6,HYDERABAD,TRIVANDRUM,4746,4347,HYDERABAD-TRIVANDRUM,9093,All
2019,7,HYDERABAD,TRIVANDRUM,5041,4783,HYDERABAD-TRIVANDRUM,9824,All
2019,8,HYDERABAD,TRIVANDRUM,5016,4541,HYDERABAD-TRIVANDRUM,9557,All
2019,9,HYDERABAD,TRIVANDRUM,4538,4449,HYDERABAD-TRIVANDRUM,8987,All
2019,10,HYDERABAD,TRIVANDRUM,4379,4304,HYDERABAD-TRIVANDRUM,8683,All
2019,11,HYDERABAD,TRIVANDRUM,4811,4327,HYDERABAD-TRIVANDRUM,9138,All
2019,12,HYDERABAD,TRIVANDRUM,5247,4649,HYDERABAD-TRIVANDRUM,9896,All
2020,1,HYDERABAD,TRIVANDRUM,7267,7903,HYDERABAD-TRIVANDRUM,15170,All
2020,2,HYDERABAD,TRIVANDRUM,7027,8056,HYDERABAD-TRIVANDRUM,15083,All
2020,3,HYDERABAD,TRIVANDRUM,4422,4360,HYDERABAD-TRIVANDRUM,8782,All
2020,6,HYDERABAD,TRIVANDRUM,2216,2037,HYDERABAD-TRIVANDRUM,4253,All
2020,7,HYDERABAD,TRIVANDRUM,2049,2224,HYDERABAD-TRIVANDRUM,4273,All
2020,8,HYDERABAD,TRIVANDRUM,2384,2691,HYDERABAD-TRIVANDRUM,5075,All
2020,9,HYDERABAD,TRIVANDRUM,6348,3651,HYDERABAD-TRIVANDRUM,9999,All
2020,10,HYDERABAD,TRIVANDRUM,6521,3563,HYDERABAD-TRIVANDRUM,10084,All
2020,11,HYDERABAD,TRIVANDRUM,5152,3687,HYDERABAD-TRIVANDRUM,8839,All
2020,12,HYDERABAD,TRIVANDRUM,7865,5804,HYDERABAD-TRIVANDRUM,13669,All
2021,1,HYDERABAD,TRIVANDRUM,7046,6579,HYDERABAD-TRIVANDRUM,13625,All
2021,2,HYDERABAD,TRIVANDRUM,5539,5637,HYDERABAD-TRIVANDRUM,11176,All
2021,3,HYDERABAD,TRIVANDRUM,4506,4480,HYDERABAD-TRIVANDRUM,8986,All
2021,4,HYDERABAD,TRIVANDRUM,2464,3545,HYDERABAD-TRIVANDRUM,6009,All
2021,6,HYDERABAD,TRIVANDRUM,531,1450,HYDERABAD-TRIVANDRUM,1981,All
2021,7,HYDERABAD,TRIVANDRUM,1306,2478,HYDERABAD-TRIVANDRUM,3784,All
2021,8,HYDERABAD,TRIVANDRUM,2303,1470,HYDERABAD-TRIVANDRUM,3773,All
2021,9,HYDERABAD,TRIVANDRUM,2449,2467,HYDERABAD-TRIVANDRUM,4916,All
2021,10,HYDERABAD,TRIVANDRUM,4104,4109,HYDERABAD-TRIVANDRUM,8213,All
2021,11,HYDERABAD,TRIVANDRUM,4415,4135,HYDERABAD-TRIVANDRUM,8550,All
2021,12,HYDERABAD,TRIVANDRUM,5109,5112,HYDERABAD-TRIVANDRUM,10221,All
2022,1,HYDERABAD,TRIVANDRUM,4036,3621,HYDERABAD-TRIVANDRUM,7657,All
2022,2,HYDERABAD,TRIVANDRUM,3797,2958,HYDERABAD-TRIVANDRUM,6755,All
2022,3,HYDERABAD,TRIVANDRUM,5140,4810,HYDERABAD-TRIVANDRUM,9950,All
2022,4,HYDERABAD,TRIVANDRUM,7489,7002,HYDERABAD-TRIVANDRUM,14491,All
2022,5,HYDERABAD,TRIVANDRUM,5087,4460,HYDERABAD-TRIVANDRUM,9547,All
2022,6,HYDERABAD,TRIVANDRUM,3611,4211,HYDERABAD-TRIVANDRUM,7822,All
2022,7,HYDERABAD,TRIVANDRUM,5223,5070,HYDERABAD-TRIVANDRUM,10293,All
2022,8,HYDERABAD,TRIVANDRUM,5799,5058,HYDERABAD-TRIVANDRUM,10857,All
2022,9,HYDERABAD,TRIVANDRUM,5784,5644,HYDERABAD-TRIVANDRUM,11428,All
2022,10,HYDERABAD,TRIVANDRUM,6242,6324,HYDERABAD-TRIVANDRUM,12566,All
2022,11,HYDERABAD,TRIVANDRUM,4774,4771,HYDERABAD-TRIVANDRUM,9545,All
2022,12,HYDERABAD,TRIVANDRUM,5073,4942,HYDERABAD-TRIVANDRUM,10015,All
2023,1,HYDERABAD,TRIVANDRUM,4697,4845,HYDERABAD-TRIVANDRUM,9542,All
2023,2,HYDERABAD,TRIVANDRUM,4199,4087,HYDERABAD-TRIVANDRUM,8286,All
2023,3,HYDERABAD,TRIVANDRUM,4813,4983,HYDERABAD-TRIVANDRUM,9796,All
2023,4,HYDERABAD,TRIVANDRUM,9580,10630,HYDERABAD-TRIVANDRUM,20210,All
2023,5,HYDERABAD,TRIVANDRUM,11553,11391,HYDERABAD-TRIVANDRUM,22944,All
2023,6,HYDERABAD,TRIVANDRUM,8218,8837,HYDERABAD-TRIVANDRUM,17055,All
2023,7,HYDERABAD,TRIVANDRUM,7200,6977,HYDERABAD-TRIVANDRUM,14177,All
2023,8,HYDERABAD,TRIVANDRUM,7606,7557,HYDERABAD-TRIVANDRUM,15163,All
2023,9,HYDERABAD,TRIVANDRUM,8887,9545,HYDERABAD-TRIVANDRUM,18432,All
2023,10,HYDERABAD,TRIVANDRUM,8880,10078,HYDERABAD-TRIVANDRUM,18958,All
2023,11,HYDERABAD,TRIVANDRUM,8649,9284,HYDERABAD-TRIVANDRUM,17933,All
2023,12,HYDERABAD,TRIVANDRUM,10150,10253,HYDERABAD-TRIVANDRUM,20403,All
2024,1,HYDERABAD,TRIVANDRUM,9077,9922,HYDERABAD-TRIVANDRUM,18999,All
2024,2,HYDERABAD,TRIVANDRUM,9660,11131,HYDERABAD-TRIVANDRUM,20791,All
2024,3,HYDERABAD,TRIVANDRUM,12381,13143,HYDERABAD-TRIVANDRUM,25524,All
2024,4,HYDERABAD,TRIVANDRUM,13018,13777,HYDERABAD-TRIVANDRUM,26795,All
2024,6,HYDERABAD,TRIVANDRUM,11168,13673,HYDERABAD-TRIVANDRUM,24841,All
2024,7,HYDERABAD,TRIVANDRUM,10861,11045,HYDERABAD-TRIVANDRUM,21906,All
2024,8,HYDERABAD,TRIVANDRUM,12822,14111,HYDERABAD-TRIVANDRUM,26933,All
2024,9,HYDERABAD,TRIVANDRUM,14224,15700,HYDERABAD-TRIVANDRUM,29924,All
2024,10,HYDERABAD,TRIVANDRUM,15015,15881,HYDERABAD-TRIVANDRUM,30896,All
2024,11,HYDERABAD,TRIVANDRUM,17096,18586,HYDERABAD-TRIVANDRUM,35682,All
2024,12,HYDERABAD,TRIVANDRUM,20645,20464,HYDERABAD-TRIVANDRUM,41109,All
2025,1,HYDERABAD,TRIVANDRUM,16719,17895,HYDERABAD-TRIVANDRUM,34614,All
2025,2,HYDERABAD,TRIVANDRUM,13459,13962,HYDERABAD-TRIVANDRUM,27421,All
2025,3,HYDERABAD,TRIVANDRUM,14127,14744,HYDERABAD-TRIVANDRUM,28871,All
2015,11,HYDERABAD,UDAIPUR,0,200,HYDERABAD-UDAIPUR,200,All
2015,12,HYDERABAD,UDAIPUR,0,319,HYDERABAD-UDAIPUR,319,All
2016,1,HYDERABAD,UDAIPUR,0,178,HYDERABAD-UDAIPUR,178,All
2016,2,HYDERABAD,UDAIPUR,0,156,HYDERABAD-UDAIPUR,156,All
2016,3,HYDERABAD,UDAIPUR,0,148,HYDERABAD-UDAIPUR,148,All
2016,4,HYDERABAD,UDAIPUR,291,263,HYDERABAD-UDAIPUR,554,All
2016,5,HYDERABAD,UDAIPUR,176,46,HYDERABAD-UDAIPUR,222,All
2016,6,HYDERABAD,UDAIPUR,79,42,HYDERABAD-UDAIPUR,121,All
2016,7,HYDERABAD,UDAIPUR,0,169,HYDERABAD-UDAIPUR,169,All
2016,8,HYDERABAD,UDAIPUR,0,116,HYDERABAD-UDAIPUR,116,All
2016,9,HYDERABAD,UDAIPUR,0,57,HYDERABAD-UDAIPUR,57,All
2016,10,HYDERABAD,UDAIPUR,155,77,HYDERABAD-UDAIPUR,232,All
2016,11,HYDERABAD,UDAIPUR,64,350,HYDERABAD-UDAIPUR,414,All
2016,12,HYDERABAD,UDAIPUR,102,517,HYDERABAD-UDAIPUR,619,All
2017,1,HYDERABAD,UDAIPUR,147,852,HYDERABAD-UDAIPUR,999,All
2017,2,HYDERABAD,UDAIPUR,0,685,HYDERABAD-UDAIPUR,685,All
2017,3,HYDERABAD,UDAIPUR,0,582,HYDERABAD-UDAIPUR,582,All
2017,4,HYDERABAD,UDAIPUR,0,532,HYDERABAD-UDAIPUR,532,All
2017,5,HYDERABAD,UDAIPUR,0,462,HYDERABAD-UDAIPUR,462,All
2017,6,HYDERABAD,UDAIPUR,0,326,HYDERABAD-UDAIPUR,326,All
2017,7,HYDERABAD,UDAIPUR,0,359,HYDERABAD-UDAIPUR,359,All
2017,8,HYDERABAD,UDAIPUR,0,558,HYDERABAD-UDAIPUR,558,All
2017,9,HYDERABAD,UDAIPUR,0,464,HYDERABAD-UDAIPUR,464,All
2017,10,HYDERABAD,UDAIPUR,20,302,HYDERABAD-UDAIPUR,322,All
2017,11,HYDERABAD,UDAIPUR,510,189,HYDERABAD-UDAIPUR,699,All
2017,12,HYDERABAD,UDAIPUR,223,259,HYDERABAD-UDAIPUR,482,All
2018,1,HYDERABAD,UDAIPUR,259,251,HYDERABAD-UDAIPUR,510,All
2018,2,HYDERABAD,UDAIPUR,171,234,HYDERABAD-UDAIPUR,405,All
2018,3,HYDERABAD,UDAIPUR,0,317,HYDERABAD-UDAIPUR,317,All
2018,9,HYDERABAD,UDAIPUR,1098,1061,HYDERABAD-UDAIPUR,2159,All
2018,10,HYDERABAD,UDAIPUR,2970,3288,HYDERABAD-UDAIPUR,6258,All
2018,11,HYDERABAD,UDAIPUR,3374,3568,HYDERABAD-UDAIPUR,6942,All
2018,12,HYDERABAD,UDAIPUR,3844,4257,HYDERABAD-UDAIPUR,8101,All
2019,1,HYDERABAD,UDAIPUR,4476,4349,HYDERABAD-UDAIPUR,8825,All
2019,2,HYDERABAD,UDAIPUR,3908,4226,HYDERABAD-UDAIPUR,8134,All
2019,3,HYDERABAD,UDAIPUR,3382,3446,HYDERABAD-UDAIPUR,6828,All
2019,4,HYDERABAD,UDAIPUR,4032,3043,HYDERABAD-UDAIPUR,7075,All
2019,5,HYDERABAD,UDAIPUR,3665,4270,HYDERABAD-UDAIPUR,7935,All
2019,6,HYDERABAD,UDAIPUR,3513,3254,HYDERABAD-UDAIPUR,6767,All
2019,7,HYDERABAD,UDAIPUR,3588,3245,HYDERABAD-UDAIPUR,6833,All
2019,10,HYDERABAD,UDAIPUR,429,602,HYDERABAD-UDAIPUR,1031,All
2019,11,HYDERABAD,UDAIPUR,4072,4059,HYDERABAD-UDAIPUR,8131,All
2019,12,HYDERABAD,UDAIPUR,3835,4064,HYDERABAD-UDAIPUR,7899,All
2020,1,HYDERABAD,UDAIPUR,4530,4540,HYDERABAD-UDAIPUR,9070,All
2020,2,HYDERABAD,UDAIPUR,4732,4817,HYDERABAD-UDAIPUR,9549,All
2020,3,HYDERABAD,UDAIPUR,1983,2061,HYDERABAD-UDAIPUR,4044,All
2020,11,HYDERABAD,UDAIPUR,2479,2091,HYDERABAD-UDAIPUR,4570,All
2020,12,HYDERABAD,UDAIPUR,3480,4522,HYDERABAD-UDAIPUR,8002,All
2021,1,HYDERABAD,UDAIPUR,2857,3263,HYDERABAD-UDAIPUR,6120,All
2021,2,HYDERABAD,UDAIPUR,3249,3407,HYDERABAD-UDAIPUR,6656,All
2021,3,HYDERABAD,UDAIPUR,2559,2710,HYDERABAD-UDAIPUR,5269,All
2021,8,HYDERABAD,UDAIPUR,177,172,HYDERABAD-UDAIPUR,349,All
2021,10,HYDERABAD,UDAIPUR,4236,4113,HYDERABAD-UDAIPUR,8349,All
2021,11,HYDERABAD,UDAIPUR,4023,3935,HYDERABAD-UDAIPUR,7958,All
2021,12,HYDERABAD,UDAIPUR,5054,5359,HYDERABAD-UDAIPUR,10413,All
2022,1,HYDERABAD,UDAIPUR,3074,3548,HYDERABAD-UDAIPUR,6622,All
2022,2,HYDERABAD,UDAIPUR,2722,2680,HYDERABAD-UDAIPUR,5402,All
2022,3,HYDERABAD,UDAIPUR,4064,4295,HYDERABAD-UDAIPUR,8359,All
2022,4,HYDERABAD,UDAIPUR,3301,3354,HYDERABAD-UDAIPUR,6655,All
2022,5,HYDERABAD,UDAIPUR,2894,3334,HYDERABAD-UDAIPUR,6228,All
2022,6,HYDERABAD,UDAIPUR,2765,2912,HYDERABAD-UDAIPUR,5677,All
2022,7,HYDERABAD,UDAIPUR,2492,2760,HYDERABAD-UDAIPUR,5252,All
2022,8,HYDERABAD,UDAIPUR,3002,3277,HYDERABAD-UDAIPUR,6279,All
2022,9,HYDERABAD,UDAIPUR,2834,3038,HYDERABAD-UDAIPUR,5872,All
2022,10,HYDERABAD,UDAIPUR,2805,2735,HYDERABAD-UDAIPUR,5540,All
2022,11,HYDERABAD,UDAIPUR,5209,5043,HYDERABAD-UDAIPUR,10252,All
2022,12,HYDERABAD,UDAIPUR,5650,5766,HYDERABAD-UDAIPUR,11416,All
2023,1,HYDERABAD,UDAIPUR,5443,5305,HYDERABAD-UDAIPUR,10748,All
2023,2,HYDERABAD,UDAIPUR,5473,5468,HYDERABAD-UDAIPUR,10941,All
2023,3,HYDERABAD,UDAIPUR,5135,5683,HYDERABAD-UDAIPUR,10818,All
2023,4,HYDERABAD,UDAIPUR,5063,4715,HYDERABAD-UDAIPUR,9778,All
2023,5,HYDERABAD,UDAIPUR,4113,4709,HYDERABAD-UDAIPUR,8822,All
2023,6,HYDERABAD,UDAIPUR,2358,2532,HYDERABAD-UDAIPUR,4890,All
2023,7,HYDERABAD,UDAIPUR,2140,1940,HYDERABAD-UDAIPUR,4080,All
2023,8,HYDERABAD,UDAIPUR,2146,2296,HYDERABAD-UDAIPUR,4442,All
2023,9,HYDERABAD,UDAIPUR,4702,4778,HYDERABAD-UDAIPUR,9480,All
2023,10,HYDERABAD,UDAIPUR,5304,5204,HYDERABAD-UDAIPUR,10508,All
2023,11,HYDERABAD,UDAIPUR,5328,5000,HYDERABAD-UDAIPUR,10328,All
2023,12,HYDERABAD,UDAIPUR,5428,5764,HYDERABAD-UDAIPUR,11192,All
2024,1,HYDERABAD,UDAIPUR,5991,5858,HYDERABAD-UDAIPUR,11849,All
2024,2,HYDERABAD,UDAIPUR,5718,5527,HYDERABAD-UDAIPUR,11245,All
2024,3,HYDERABAD,UDAIPUR,5115,5394,HYDERABAD-UDAIPUR,10509,All
2024,4,HYDERABAD,UDAIPUR,2513,2070,HYDERABAD-UDAIPUR,4583,All
2024,6,HYDERABAD,UDAIPUR,2295,1968,HYDERABAD-UDAIPUR,4263,All
2024,7,HYDERABAD,UDAIPUR,2711,2454,HYDERABAD-UDAIPUR,5165,All
2024,8,HYDERABAD,UDAIPUR,2917,2574,HYDERABAD-UDAIPUR,5491,All
2024,9,HYDERABAD,UDAIPUR,4540,5358,HYDERABAD-UDAIPUR,9898,All
2024,10,HYDERABAD,UDAIPUR,5685,5763,HYDERABAD-UDAIPUR,11448,All
2024,11,HYDERABAD,UDAIPUR,6128,6559,HYDERABAD-UDAIPUR,12687,All
2024,12,HYDERABAD,UDAIPUR,6672,7199,HYDERABAD-UDAIPUR,13871,All
2025,1,HYDERABAD,UDAIPUR,6758,6829,HYDERABAD-UDAIPUR,13587,All
2025,2,HYDERABAD,UDAIPUR,6379,6342,HYDERABAD-UDAIPUR,12721,All
2025,3,HYDERABAD,UDAIPUR,5848,6457,HYDERABAD-UDAIPUR,12305,All
2019,5,HYDERABAD,VADODARA,3145,4042,HYDERABAD-VADODARA,7187,All
2019,10,HYDERABAD,VADODARA,4155,4304,HYDERABAD-VADODARA,8459,All
2019,11,HYDERABAD,VADODARA,5131,4264,HYDERABAD-VADODARA,9395,All
2019,12,HYDERABAD,VADODARA,5011,4875,HYDERABAD-VADODARA,9886,All
2020,1,HYDERABAD,VADODARA,5208,4945,HYDERABAD-VADODARA,10153,All
2020,2,HYDERABAD,VADODARA,4897,4725,HYDERABAD-VADODARA,9622,All
2020,3,HYDERABAD,VADODARA,2823,2386,HYDERABAD-VADODARA,5209,All
2020,7,HYDERABAD,VADODARA,882,1092,HYDERABAD-VADODARA,1974,All
2020,8,HYDERABAD,VADODARA,724,989,HYDERABAD-VADODARA,1713,All
2020,9,HYDERABAD,VADODARA,986,996,HYDERABAD-VADODARA,1982,All
2020,10,HYDERABAD,VADODARA,1327,1622,HYDERABAD-VADODARA,2949,All
2020,11,HYDERABAD,VADODARA,3079,3443,HYDERABAD-VADODARA,6522,All
2020,12,HYDERABAD,VADODARA,2884,3489,HYDERABAD-VADODARA,6373,All
2021,1,HYDERABAD,VADODARA,3180,3589,HYDERABAD-VADODARA,6769,All
2021,2,HYDERABAD,VADODARA,3513,3927,HYDERABAD-VADODARA,7440,All
2021,3,HYDERABAD,VADODARA,3335,3739,HYDERABAD-VADODARA,7074,All
2021,4,HYDERABAD,VADODARA,1112,1241,HYDERABAD-VADODARA,2353,All
2021,7,HYDERABAD,VADODARA,1781,1889,HYDERABAD-VADODARA,3670,All
2021,8,HYDERABAD,VADODARA,2761,3344,HYDERABAD-VADODARA,6105,All
2021,9,HYDERABAD,VADODARA,2858,2969,HYDERABAD-VADODARA,5827,All
2021,10,HYDERABAD,VADODARA,3289,3814,HYDERABAD-VADODARA,7103,All
2021,11,HYDERABAD,VADODARA,4869,4857,HYDERABAD-VADODARA,9726,All
2021,12,HYDERABAD,VADODARA,4645,4909,HYDERABAD-VADODARA,9554,All
2022,1,HYDERABAD,VADODARA,2672,2737,HYDERABAD-VADODARA,5409,All
2022,2,HYDERABAD,VADODARA,2669,2640,HYDERABAD-VADODARA,5309,All
2022,3,HYDERABAD,VADODARA,4959,5429,HYDERABAD-VADODARA,10388,All
2022,4,HYDERABAD,VADODARA,5451,5378,HYDERABAD-VADODARA,10829,All
2022,5,HYDERABAD,VADODARA,5619,6373,HYDERABAD-VADODARA,11992,All
2022,6,HYDERABAD,VADODARA,5438,5208,HYDERABAD-VADODARA,10646,All
2022,7,HYDERABAD,VADODARA,4964,5215,HYDERABAD-VADODARA,10179,All
2022,8,HYDERABAD,VADODARA,5502,5472,HYDERABAD-VADODARA,10974,All
2022,9,HYDERABAD,VADODARA,5467,5097,HYDERABAD-VADODARA,10564,All
2022,10,HYDERABAD,VADODARA,5880,6308,HYDERABAD-VADODARA,12188,All
2022,11,HYDERABAD,VADODARA,5023,4964,HYDERABAD-VADODARA,9987,All
2022,12,HYDERABAD,VADODARA,5439,5555,HYDERABAD-VADODARA,10994,All
2023,1,HYDERABAD,VADODARA,5673,5747,HYDERABAD-VADODARA,11420,All
2023,2,HYDERABAD,VADODARA,5277,5440,HYDERABAD-VADODARA,10717,All
2023,3,HYDERABAD,VADODARA,5359,5661,HYDERABAD-VADODARA,11020,All
2023,4,HYDERABAD,VADODARA,5419,5376,HYDERABAD-VADODARA,10795,All
2023,5,HYDERABAD,VADODARA,4332,5414,HYDERABAD-VADODARA,9746,All
2023,6,HYDERABAD,VADODARA,4247,4362,HYDERABAD-VADODARA,8609,All
2023,7,HYDERABAD,VADODARA,4154,4228,HYDERABAD-VADODARA,8382,All
2023,8,HYDERABAD,VADODARA,4418,4444,HYDERABAD-VADODARA,8862,All
2023,9,HYDERABAD,VADODARA,4404,4500,HYDERABAD-VADODARA,8904,All
2023,10,HYDERABAD,VADODARA,3484,3775,HYDERABAD-VADODARA,7259,All
2023,11,HYDERABAD,VADODARA,4757,4737,HYDERABAD-VADODARA,9494,All
2023,12,HYDERABAD,VADODARA,4906,5090,HYDERABAD-VADODARA,9996,All
2024,1,HYDERABAD,VADODARA,4773,4611,HYDERABAD-VADODARA,9384,All
2024,2,HYDERABAD,VADODARA,4618,4685,HYDERABAD-VADODARA,9303,All
2024,3,HYDERABAD,VADODARA,4955,4928,HYDERABAD-VADODARA,9883,All
2024,4,HYDERABAD,VADODARA,4672,4517,HYDERABAD-VADODARA,9189,All
2024,6,HYDERABAD,VADODARA,4685,4584,HYDERABAD-VADODARA,9269,All
2024,7,HYDERABAD,VADODARA,4722,4788,HYDERABAD-VADODARA,9510,All
2024,8,HYDERABAD,VADODARA,4734,4879,HYDERABAD-VADODARA,9613,All
2024,9,HYDERABAD,VADODARA,4784,4702,HYDERABAD-VADODARA,9486,All
2024,10,HYDERABAD,VADODARA,4693,5038,HYDERABAD-VADODARA,9731,All
2024,11,HYDERABAD,VADODARA,5106,5150,HYDERABAD-VADODARA,10256,All
2024,12,HYDERABAD,VADODARA,5252,5238,HYDERABAD-VADODARA,10490,All
2025,1,HYDERABAD,VADODARA,5241,5074,HYDERABAD-VADODARA,10315,All
2025,2,HYDERABAD,VADODARA,4581,4610,HYDERABAD-VADODARA,9191,All
2025,3,HYDERABAD,VADODARA,4894,4985,HYDERABAD-VADODARA,9879,All
2015,4,HYDERABAD,VARANASI,1798,1468,HYDERABAD-VARANASI,3266,All
2015,5,HYDERABAD,VARANASI,1956,1700,HYDERABAD-VARANASI,3656,All
2015,6,HYDERABAD,VARANASI,1691,1693,HYDERABAD-VARANASI,3384,All
2015,7,HYDERABAD,VARANASI,1858,1282,HYDERABAD-VARANASI,3140,All
2015,8,HYDERABAD,VARANASI,1569,1166,HYDERABAD-VARANASI,2735,All
2015,9,HYDERABAD,VARANASI,1756,1175,HYDERABAD-VARANASI,2931,All
2015,10,HYDERABAD,VARANASI,17095,3463,HYDERABAD-VARANASI,20558,All
2015,11,HYDERABAD,VARANASI,4704,4614,HYDERABAD-VARANASI,9318,All
2015,12,HYDERABAD,VARANASI,5089,6195,HYDERABAD-VARANASI,11284,All
2016,1,HYDERABAD,VARANASI,7093,6961,HYDERABAD-VARANASI,14054,All
2016,2,HYDERABAD,VARANASI,5477,5156,HYDERABAD-VARANASI,10633,All
2016,3,HYDERABAD,VARANASI,6043,6129,HYDERABAD-VARANASI,12172,All
2016,4,HYDERABAD,VARANASI,5594,5508,HYDERABAD-VARANASI,11102,All
2016,5,HYDERABAD,VARANASI,5136,5528,HYDERABAD-VARANASI,10664,All
2016,6,HYDERABAD,VARANASI,5424,5935,HYDERABAD-VARANASI,11359,All
2016,7,HYDERABAD,VARANASI,5909,6108,HYDERABAD-VARANASI,12017,All
2016,8,HYDERABAD,VARANASI,5472,5751,HYDERABAD-VARANASI,11223,All
2016,9,HYDERABAD,VARANASI,5614,5674,HYDERABAD-VARANASI,11288,All
2016,10,HYDERABAD,VARANASI,8965,8128,HYDERABAD-VARANASI,17093,All
2016,11,HYDERABAD,VARANASI,10245,10496,HYDERABAD-VARANASI,20741,All
2016,12,HYDERABAD,VARANASI,9033,10144,HYDERABAD-VARANASI,19177,All
2017,1,HYDERABAD,VARANASI,10565,10118,HYDERABAD-VARANASI,20683,All
2017,2,HYDERABAD,VARANASI,9778,9688,HYDERABAD-VARANASI,19466,All
2017,3,HYDERABAD,VARANASI,10347,9754,HYDERABAD-VARANASI,20101,All
2017,4,HYDERABAD,VARANASI,9802,9071,HYDERABAD-VARANASI,18873,All
2017,5,HYDERABAD,VARANASI,11152,10305,HYDERABAD-VARANASI,21457,All
2017,6,HYDERABAD,VARANASI,9999,10428,HYDERABAD-VARANASI,20427,All
2017,7,HYDERABAD,VARANASI,10028,10495,HYDERABAD-VARANASI,20523,All
2017,8,HYDERABAD,VARANASI,9649,9517,HYDERABAD-VARANASI,19166,All
2017,9,HYDERABAD,VARANASI,10360,9287,HYDERABAD-VARANASI,19647,All
2017,10,HYDERABAD,VARANASI,10501,9530,HYDERABAD-VARANASI,20031,All
2017,11,HYDERABAD,VARANASI,10655,10550,HYDERABAD-VARANASI,21205,All
2017,12,HYDERABAD,VARANASI,10292,11055,HYDERABAD-VARANASI,21347,All
2018,1,HYDERABAD,VARANASI,14631,14445,HYDERABAD-VARANASI,29076,All
2018,2,HYDERABAD,VARANASI,13225,12290,HYDERABAD-VARANASI,25515,All
2018,3,HYDERABAD,VARANASI,16188,17196,HYDERABAD-VARANASI,33384,All
2018,4,HYDERABAD,VARANASI,16853,16240,HYDERABAD-VARANASI,33093,All
2018,5,HYDERABAD,VARANASI,16034,18046,HYDERABAD-VARANASI,34080,All
2018,6,HYDERABAD,VARANASI,13838,15277,HYDERABAD-VARANASI,29115,All
2018,7,HYDERABAD,VARANASI,14045,15472,HYDERABAD-VARANASI,29517,All
2018,8,HYDERABAD,VARANASI,10374,10257,HYDERABAD-VARANASI,20631,All
2018,9,HYDERABAD,VARANASI,13057,11997,HYDERABAD-VARANASI,25054,All
2018,10,HYDERABAD,VARANASI,13290,13616,HYDERABAD-VARANASI,26906,All
2018,11,HYDERABAD,VARANASI,13741,13948,HYDERABAD-VARANASI,27689,All
2018,12,HYDERABAD,VARANASI,9671,11581,HYDERABAD-VARANASI,21252,All
2019,1,HYDERABAD,VARANASI,10110,10018,HYDERABAD-VARANASI,20128,All
2019,2,HYDERABAD,VARANASI,14053,12564,HYDERABAD-VARANASI,26617,All
2019,3,HYDERABAD,VARANASI,16604,16778,HYDERABAD-VARANASI,33382,All
2019,4,HYDERABAD,VARANASI,14488,14031,HYDERABAD-VARANASI,28519,All
2019,5,HYDERABAD,VARANASI,15105,15373,HYDERABAD-VARANASI,30478,All
2019,6,HYDERABAD,VARANASI,13904,14867,HYDERABAD-VARANASI,28771,All
2019,7,HYDERABAD,VARANASI,13608,14635,HYDERABAD-VARANASI,28243,All
2019,8,HYDERABAD,VARANASI,12948,13367,HYDERABAD-VARANASI,26315,All
2019,9,HYDERABAD,VARANASI,13835,13712,HYDERABAD-VARANASI,27547,All
2019,10,HYDERABAD,VARANASI,14799,13728,HYDERABAD-VARANASI,28527,All
2019,11,HYDERABAD,VARANASI,17629,19793,HYDERABAD-VARANASI,37422,All
2019,12,HYDERABAD,VARANASI,14598,19145,HYDERABAD-VARANASI,33743,All
2020,1,HYDERABAD,VARANASI,13322,13952,HYDERABAD-VARANASI,27274,All
2020,2,HYDERABAD,VARANASI,15595,14400,HYDERABAD-VARANASI,29995,All
2020,3,HYDERABAD,VARANASI,9690,10890,HYDERABAD-VARANASI,20580,All
2020,5,HYDERABAD,VARANASI,600,221,HYDERABAD-VARANASI,821,All
2020,6,HYDERABAD,VARANASI,4041,2506,HYDERABAD-VARANASI,6547,All
2020,7,HYDERABAD,VARANASI,2471,2358,HYDERABAD-VARANASI,4829,All
2020,8,HYDERABAD,VARANASI,2213,5567,HYDERABAD-VARANASI,7780,All
2020,9,HYDERABAD,VARANASI,3636,12701,HYDERABAD-VARANASI,16337,All
2020,10,HYDERABAD,VARANASI,4351,6898,HYDERABAD-VARANASI,11249,All
2020,11,HYDERABAD,VARANASI,8729,6402,HYDERABAD-VARANASI,15131,All
2020,12,HYDERABAD,VARANASI,6900,10561,HYDERABAD-VARANASI,17461,All
2021,1,HYDERABAD,VARANASI,5218,7484,HYDERABAD-VARANASI,12702,All
2021,2,HYDERABAD,VARANASI,6844,7438,HYDERABAD-VARANASI,14282,All
2021,3,HYDERABAD,VARANASI,8671,8741,HYDERABAD-VARANASI,17412,All
2021,4,HYDERABAD,VARANASI,6934,5484,HYDERABAD-VARANASI,12418,All
2021,6,HYDERABAD,VARANASI,1404,2387,HYDERABAD-VARANASI,3791,All
2021,7,HYDERABAD,VARANASI,3781,4313,HYDERABAD-VARANASI,8094,All
2021,8,HYDERABAD,VARANASI,6200,7371,HYDERABAD-VARANASI,13571,All
2021,9,HYDERABAD,VARANASI,6094,7029,HYDERABAD-VARANASI,13123,All
2021,10,HYDERABAD,VARANASI,8233,8009,HYDERABAD-VARANASI,16242,All
2021,11,HYDERABAD,VARANASI,9457,9333,HYDERABAD-VARANASI,18790,All
2021,12,HYDERABAD,VARANASI,8101,10147,HYDERABAD-VARANASI,18248,All
2022,1,HYDERABAD,VARANASI,6089,6326,HYDERABAD-VARANASI,12415,All
2022,2,HYDERABAD,VARANASI,7542,7032,HYDERABAD-VARANASI,14574,All
2022,3,HYDERABAD,VARANASI,10773,10978,HYDERABAD-VARANASI,21751,All
2022,4,HYDERABAD,VARANASI,10079,10260,HYDERABAD-VARANASI,20339,All
2022,5,HYDERABAD,VARANASI,10164,10742,HYDERABAD-VARANASI,20906,All
2022,6,HYDERABAD,VARANASI,9120,10293,HYDERABAD-VARANASI,19413,All
2022,7,HYDERABAD,VARANASI,9960,10572,HYDERABAD-VARANASI,20532,All
2022,8,HYDERABAD,VARANASI,9101,10153,HYDERABAD-VARANASI,19254,All
2022,9,HYDERABAD,VARANASI,9945,9499,HYDERABAD-VARANASI,19444,All
2022,10,HYDERABAD,VARANASI,11096,10534,HYDERABAD-VARANASI,21630,All
2022,11,HYDERABAD,VARANASI,11189,11408,HYDERABAD-VARANASI,22597,All
2022,12,HYDERABAD,VARANASI,10070,10885,HYDERABAD-VARANASI,20955,All
2023,1,HYDERABAD,VARANASI,8910,9036,HYDERABAD-VARANASI,17946,All
2023,2,HYDERABAD,VARANASI,9637,9179,HYDERABAD-VARANASI,18816,All
2023,3,HYDERABAD,VARANASI,10150,10217,HYDERABAD-VARANASI,20367,All
2023,4,HYDERABAD,VARANASI,10342,9862,HYDERABAD-VARANASI,20204,All
2023,5,HYDERABAD,VARANASI,10821,11004,HYDERABAD-VARANASI,21825,All
2023,6,HYDERABAD,VARANASI,9717,10323,HYDERABAD-VARANASI,20040,All
2023,7,HYDERABAD,VARANASI,9726,9981,HYDERABAD-VARANASI,19707,All
2023,8,HYDERABAD,VARANASI,9440,9806,HYDERABAD-VARANASI,19246,All
2023,9,HYDERABAD,VARANASI,10992,10896,HYDERABAD-VARANASI,21888,All
2023,10,HYDERABAD,VARANASI,11636,11096,HYDERABAD-VARANASI,22732,All
2023,11,HYDERABAD,VARANASI,11496,9896,HYDERABAD-VARANASI,21392,All
2023,12,HYDERABAD,VARANASI,9897,10588,HYDERABAD-VARANASI,20485,All
2024,1,HYDERABAD,VARANASI,8437,8089,HYDERABAD-VARANASI,16526,All
2024,2,HYDERABAD,VARANASI,10319,9560,HYDERABAD-VARANASI,19879,All
2024,3,HYDERABAD,VARANASI,14751,14083,HYDERABAD-VARANASI,28834,All
2024,4,HYDERABAD,VARANASI,18808,15674,HYDERABAD-VARANASI,34482,All
2024,6,HYDERABAD,VARANASI,15548,16442,HYDERABAD-VARANASI,31990,All
2024,7,HYDERABAD,VARANASI,17489,19572,HYDERABAD-VARANASI,37061,All
2024,8,HYDERABAD,VARANASI,18603,20133,HYDERABAD-VARANASI,38736,All
2024,9,HYDERABAD,VARANASI,24653,24164,HYDERABAD-VARANASI,48817,All
2024,10,HYDERABAD,VARANASI,28597,22141,HYDERABAD-VARANASI,50738,All
2024,11,HYDERABAD,VARANASI,25966,25857,HYDERABAD-VARANASI,51823,All
2024,12,HYDERABAD,VARANASI,22587,26591,HYDERABAD-VARANASI,49178,All
2025,1,HYDERABAD,VARANASI,26391,25420,HYDERABAD-VARANASI,51811,All
2025,2,HYDERABAD,VARANASI,26791,26551,HYDERABAD-VARANASI,53342,All
2025,3,HYDERABAD,VARANASI,29584,29027,HYDERABAD-VARANASI,58611,All
2017,10,HYDERABAD,VIDYANAGAR,939,1329,HYDERABAD-VIDYANAGAR,2268,All
2017,11,HYDERABAD,VIDYANAGAR,751,836,HYDERABAD-VIDYANAGAR,1587,All
2017,12,HYDERABAD,VIDYANAGAR,1283,1378,HYDERABAD-VIDYANAGAR,2661,All
2018,1,HYDERABAD,VIDYANAGAR,1401,1491,HYDERABAD-VIDYANAGAR,2892,All
2018,2,HYDERABAD,VIDYANAGAR,1325,1360,HYDERABAD-VIDYANAGAR,2685,All
2018,3,HYDERABAD,VIDYANAGAR,1257,1349,HYDERABAD-VIDYANAGAR,2606,All
2018,4,HYDERABAD,VIDYANAGAR,1576,1572,HYDERABAD-VIDYANAGAR,3148,All
2018,5,HYDERABAD,VIDYANAGAR,1753,1666,HYDERABAD-VIDYANAGAR,3419,All
2018,6,HYDERABAD,VIDYANAGAR,1580,1656,HYDERABAD-VIDYANAGAR,3236,All
2018,7,HYDERABAD,VIDYANAGAR,1523,1618,HYDERABAD-VIDYANAGAR,3141,All
2018,8,HYDERABAD,VIDYANAGAR,1614,1482,HYDERABAD-VIDYANAGAR,3096,All
2018,9,HYDERABAD,VIDYANAGAR,1608,1613,HYDERABAD-VIDYANAGAR,3221,All
2018,10,HYDERABAD,VIDYANAGAR,1739,1733,HYDERABAD-VIDYANAGAR,3472,All
2018,11,HYDERABAD,VIDYANAGAR,1626,1564,HYDERABAD-VIDYANAGAR,3190,All
2018,12,HYDERABAD,VIDYANAGAR,1735,1596,HYDERABAD-VIDYANAGAR,3331,All
2019,1,HYDERABAD,VIDYANAGAR,1634,1562,HYDERABAD-VIDYANAGAR,3196,All
2019,2,HYDERABAD,VIDYANAGAR,1517,1465,HYDERABAD-VIDYANAGAR,2982,All
2019,3,HYDERABAD,VIDYANAGAR,1494,1412,HYDERABAD-VIDYANAGAR,2906,All
2019,4,HYDERABAD,VIDYANAGAR,1432,1493,HYDERABAD-VIDYANAGAR,2925,All
2019,5,HYDERABAD,VIDYANAGAR,1673,1463,HYDERABAD-VIDYANAGAR,3136,All
2019,6,HYDERABAD,VIDYANAGAR,1672,1515,HYDERABAD-VIDYANAGAR,3187,All
2019,7,HYDERABAD,VIDYANAGAR,1600,1539,HYDERABAD-VIDYANAGAR,3139,All
2019,8,HYDERABAD,VIDYANAGAR,1547,1571,HYDERABAD-VIDYANAGAR,3118,All
2019,9,HYDERABAD,VIDYANAGAR,1218,1143,HYDERABAD-VIDYANAGAR,2361,All
2019,10,HYDERABAD,VIDYANAGAR,1450,1415,HYDERABAD-VIDYANAGAR,2865,All
2019,11,HYDERABAD,VIDYANAGAR,1719,1568,HYDERABAD-VIDYANAGAR,3287,All
2019,12,HYDERABAD,VIDYANAGAR,1828,1771,HYDERABAD-VIDYANAGAR,3599,All
2020,1,HYDERABAD,VIDYANAGAR,1668,1660,HYDERABAD-VIDYANAGAR,3328,All
2020,2,HYDERABAD,VIDYANAGAR,1435,1546,HYDERABAD-VIDYANAGAR,2981,All
2020,3,HYDERABAD,VIDYANAGAR,931,1106,HYDERABAD-VIDYANAGAR,2037,All
2020,5,HYDERABAD,VIDYANAGAR,74,69,HYDERABAD-VIDYANAGAR,143,All
2020,6,HYDERABAD,VIDYANAGAR,669,773,HYDERABAD-VIDYANAGAR,1442,All
2020,7,HYDERABAD,VIDYANAGAR,581,677,HYDERABAD-VIDYANAGAR,1258,All
2020,8,HYDERABAD,VIDYANAGAR,311,254,HYDERABAD-VIDYANAGAR,565,All
2020,9,HYDERABAD,VIDYANAGAR,150,188,HYDERABAD-VIDYANAGAR,338,All
2020,10,HYDERABAD,VIDYANAGAR,492,463,HYDERABAD-VIDYANAGAR,955,All
2020,11,HYDERABAD,VIDYANAGAR,501,395,HYDERABAD-VIDYANAGAR,896,All
2020,12,HYDERABAD,VIDYANAGAR,573,652,HYDERABAD-VIDYANAGAR,1225,All
2021,1,HYDERABAD,VIDYANAGAR,591,663,HYDERABAD-VIDYANAGAR,1254,All
2021,2,HYDERABAD,VIDYANAGAR,703,684,HYDERABAD-VIDYANAGAR,1387,All
2021,3,HYDERABAD,VIDYANAGAR,722,774,HYDERABAD-VIDYANAGAR,1496,All
2021,4,HYDERABAD,VIDYANAGAR,264,395,HYDERABAD-VIDYANAGAR,659,All
2021,6,HYDERABAD,VIDYANAGAR,130,140,HYDERABAD-VIDYANAGAR,270,All
2021,7,HYDERABAD,VIDYANAGAR,68,39,HYDERABAD-VIDYANAGAR,107,All
2021,8,HYDERABAD,VIDYANAGAR,684,779,HYDERABAD-VIDYANAGAR,1463,All
2021,9,HYDERABAD,VIDYANAGAR,106,158,HYDERABAD-VIDYANAGAR,264,All
2021,10,HYDERABAD,VIDYANAGAR,172,247,HYDERABAD-VIDYANAGAR,419,All
2021,11,HYDERABAD,VIDYANAGAR,94,58,HYDERABAD-VIDYANAGAR,152,All
2022,2,HYDERABAD,VIDYANAGAR,52,61,HYDERABAD-VIDYANAGAR,113,All
2022,10,HYDERABAD,VIDYANAGAR,22,17,HYDERABAD-VIDYANAGAR,39,All
2022,11,HYDERABAD,VIDYANAGAR,874,878,HYDERABAD-VIDYANAGAR,1752,All
2022,12,HYDERABAD,VIDYANAGAR,1273,1225,HYDERABAD-VIDYANAGAR,2498,All
2023,1,HYDERABAD,VIDYANAGAR,1205,1284,HYDERABAD-VIDYANAGAR,2489,All
2023,2,HYDERABAD,VIDYANAGAR,1124,1095,HYDERABAD-VIDYANAGAR,2219,All
2023,3,HYDERABAD,VIDYANAGAR,792,827,HYDERABAD-VIDYANAGAR,1619,All
2023,4,HYDERABAD,VIDYANAGAR,404,470,HYDERABAD-VIDYANAGAR,874,All
2023,5,HYDERABAD,VIDYANAGAR,354,419,HYDERABAD-VIDYANAGAR,773,All
2023,6,HYDERABAD,VIDYANAGAR,94,75,HYDERABAD-VIDYANAGAR,169,All
2023,10,HYDERABAD,VIDYANAGAR,133,317,HYDERABAD-VIDYANAGAR,450,All
2023,12,HYDERABAD,VIDYANAGAR,246,328,HYDERABAD-VIDYANAGAR,574,All
2024,1,HYDERABAD,VIDYANAGAR,610,790,HYDERABAD-VIDYANAGAR,1400,All
2024,2,HYDERABAD,VIDYANAGAR,746,821,HYDERABAD-VIDYANAGAR,1567,All
2024,3,HYDERABAD,VIDYANAGAR,602,789,HYDERABAD-VIDYANAGAR,1391,All
2024,4,HYDERABAD,VIDYANAGAR,933,1316,HYDERABAD-VIDYANAGAR,2249,All
2024,6,HYDERABAD,VIDYANAGAR,846,1133,HYDERABAD-VIDYANAGAR,1979,All
2024,7,HYDERABAD,VIDYANAGAR,797,1052,HYDERABAD-VIDYANAGAR,1849,All
2024,8,HYDERABAD,VIDYANAGAR,1120,1339,HYDERABAD-VIDYANAGAR,2459,All
2024,9,HYDERABAD,VIDYANAGAR,1070,1345,HYDERABAD-VIDYANAGAR,2415,All
2024,10,HYDERABAD,VIDYANAGAR,878,948,HYDERABAD-VIDYANAGAR,1826,All
2024,11,HYDERABAD,VIDYANAGAR,704,774,HYDERABAD-VIDYANAGAR,1478,All
2024,12,HYDERABAD,VIDYANAGAR,983,1198,HYDERABAD-VIDYANAGAR,2181,All
2025,1,HYDERABAD,VIDYANAGAR,852,995,HYDERABAD-VIDYANAGAR,1847,All
2025,3,HYDERABAD,VIDYANAGAR,330,397,HYDERABAD-VIDYANAGAR,727,All
2015,4,HYDERABAD,VIJAYAWADA,5008,5272,HYDERABAD-VIJAYAWADA,10280,All
2015,5,HYDERABAD,VIJAYAWADA,4210,4748,HYDERABAD-VIJAYAWADA,8958,All
2015,6,HYDERABAD,VIJAYAWADA,5209,5532,HYDERABAD-VIJAYAWADA,10741,All
2015,7,HYDERABAD,VIJAYAWADA,5828,6046,HYDERABAD-VIJAYAWADA,11874,All
2015,8,HYDERABAD,VIJAYAWADA,5423,6200,HYDERABAD-VIJAYAWADA,11623,All
2015,9,HYDERABAD,VIJAYAWADA,5176,5923,HYDERABAD-VIJAYAWADA,11099,All
2015,10,HYDERABAD,VIJAYAWADA,25991,4953,HYDERABAD-VIJAYAWADA,30944,All
2015,11,HYDERABAD,VIJAYAWADA,7150,7828,HYDERABAD-VIJAYAWADA,14978,All
2015,12,HYDERABAD,VIJAYAWADA,7482,7594,HYDERABAD-VIJAYAWADA,15076,All
2016,1,HYDERABAD,VIJAYAWADA,7620,8469,HYDERABAD-VIJAYAWADA,16089,All
2016,2,HYDERABAD,VIJAYAWADA,7812,8000,HYDERABAD-VIJAYAWADA,15812,All
2016,3,HYDERABAD,VIJAYAWADA,7062,7777,HYDERABAD-VIJAYAWADA,14839,All
2016,4,HYDERABAD,VIJAYAWADA,7877,7364,HYDERABAD-VIJAYAWADA,15241,All
2016,5,HYDERABAD,VIJAYAWADA,8030,7692,HYDERABAD-VIJAYAWADA,15722,All
2016,6,HYDERABAD,VIJAYAWADA,8007,7139,HYDERABAD-VIJAYAWADA,15146,All
2016,7,HYDERABAD,VIJAYAWADA,8158,7478,HYDERABAD-VIJAYAWADA,15636,All
2016,8,HYDERABAD,VIJAYAWADA,10444,11269,HYDERABAD-VIJAYAWADA,21713,All
2016,9,HYDERABAD,VIJAYAWADA,8693,9552,HYDERABAD-VIJAYAWADA,18245,All
2016,10,HYDERABAD,VIJAYAWADA,9546,8500,HYDERABAD-VIJAYAWADA,18046,All
2016,11,HYDERABAD,VIJAYAWADA,8374,9196,HYDERABAD-VIJAYAWADA,17570,All
2016,12,HYDERABAD,VIJAYAWADA,9116,8753,HYDERABAD-VIJAYAWADA,17869,All
2017,1,HYDERABAD,VIJAYAWADA,8628,9397,HYDERABAD-VIJAYAWADA,18025,All
2017,2,HYDERABAD,VIJAYAWADA,8607,9166,HYDERABAD-VIJAYAWADA,17773,All
2017,3,HYDERABAD,VIJAYAWADA,10111,11184,HYDERABAD-VIJAYAWADA,21295,All
2017,4,HYDERABAD,VIJAYAWADA,9624,11751,HYDERABAD-VIJAYAWADA,21375,All
2017,5,HYDERABAD,VIJAYAWADA,7799,8633,HYDERABAD-VIJAYAWADA,16432,All
2017,6,HYDERABAD,VIJAYAWADA,7109,7689,HYDERABAD-VIJAYAWADA,14798,All
2017,7,HYDERABAD,VIJAYAWADA,10114,10882,HYDERABAD-VIJAYAWADA,20996,All
2017,8,HYDERABAD,VIJAYAWADA,10280,11506,HYDERABAD-VIJAYAWADA,21786,All
2017,9,HYDERABAD,VIJAYAWADA,10093,11051,HYDERABAD-VIJAYAWADA,21144,All
2017,10,HYDERABAD,VIJAYAWADA,9922,11176,HYDERABAD-VIJAYAWADA,21098,All
2017,11,HYDERABAD,VIJAYAWADA,10300,10623,HYDERABAD-VIJAYAWADA,20923,All
2017,12,HYDERABAD,VIJAYAWADA,9886,10492,HYDERABAD-VIJAYAWADA,20378,All
2018,1,HYDERABAD,VIJAYAWADA,10764,11583,HYDERABAD-VIJAYAWADA,22347,All
2018,2,HYDERABAD,VIJAYAWADA,9719,10334,HYDERABAD-VIJAYAWADA,20053,All
2018,3,HYDERABAD,VIJAYAWADA,15929,16829,HYDERABAD-VIJAYAWADA,32758,All
2018,4,HYDERABAD,VIJAYAWADA,15774,16739,HYDERABAD-VIJAYAWADA,32513,All
2018,5,HYDERABAD,VIJAYAWADA,14863,17262,HYDERABAD-VIJAYAWADA,32125,All
2018,6,HYDERABAD,VIJAYAWADA,15417,16275,HYDERABAD-VIJAYAWADA,31692,All
2018,7,HYDERABAD,VIJAYAWADA,16923,17688,HYDERABAD-VIJAYAWADA,34611,All
2018,8,HYDERABAD,VIJAYAWADA,16144,17555,HYDERABAD-VIJAYAWADA,33699,All
2018,9,HYDERABAD,VIJAYAWADA,14574,16970,HYDERABAD-VIJAYAWADA,31544,All
2018,10,HYDERABAD,VIJAYAWADA,14542,16608,HYDERABAD-VIJAYAWADA,31150,All
2018,11,HYDERABAD,VIJAYAWADA,11641,13349,HYDERABAD-VIJAYAWADA,24990,All
2018,12,HYDERABAD,VIJAYAWADA,13486,14585,HYDERABAD-VIJAYAWADA,28071,All
2019,1,HYDERABAD,VIJAYAWADA,12875,14448,HYDERABAD-VIJAYAWADA,27323,All
2019,2,HYDERABAD,VIJAYAWADA,14061,15094,HYDERABAD-VIJAYAWADA,29155,All
2019,3,HYDERABAD,VIJAYAWADA,14026,16095,HYDERABAD-VIJAYAWADA,30121,All
2019,4,HYDERABAD,VIJAYAWADA,14376,15749,HYDERABAD-VIJAYAWADA,30125,All
2019,5,HYDERABAD,VIJAYAWADA,15867,17739,HYDERABAD-VIJAYAWADA,33606,All
2019,6,HYDERABAD,VIJAYAWADA,14890,15462,HYDERABAD-VIJAYAWADA,30352,All
2019,7,HYDERABAD,VIJAYAWADA,12661,12757,HYDERABAD-VIJAYAWADA,25418,All
2019,8,HYDERABAD,VIJAYAWADA,10300,9975,HYDERABAD-VIJAYAWADA,20275,All
2019,9,HYDERABAD,VIJAYAWADA,10569,10015,HYDERABAD-VIJAYAWADA,20584,All
2019,10,HYDERABAD,VIJAYAWADA,15842,15423,HYDERABAD-VIJAYAWADA,31265,All
2019,11,HYDERABAD,VIJAYAWADA,16519,17061,HYDERABAD-VIJAYAWADA,33580,All
2019,12,HYDERABAD,VIJAYAWADA,17312,17170,HYDERABAD-VIJAYAWADA,34482,All
2020,1,HYDERABAD,VIJAYAWADA,16682,18043,HYDERABAD-VIJAYAWADA,34725,All
2020,2,HYDERABAD,VIJAYAWADA,15167,16688,HYDERABAD-VIJAYAWADA,31855,All
2020,3,HYDERABAD,VIJAYAWADA,9214,9584,HYDERABAD-VIJAYAWADA,18798,All
2020,5,HYDERABAD,VIJAYAWADA,67,220,HYDERABAD-VIJAYAWADA,287,All
2020,6,HYDERABAD,VIJAYAWADA,1338,1489,HYDERABAD-VIJAYAWADA,2827,All
2020,7,HYDERABAD,VIJAYAWADA,1848,1836,HYDERABAD-VIJAYAWADA,3684,All
2020,8,HYDERABAD,VIJAYAWADA,2924,4009,HYDERABAD-VIJAYAWADA,6933,All
2020,9,HYDERABAD,VIJAYAWADA,4527,5341,HYDERABAD-VIJAYAWADA,9868,All
2020,10,HYDERABAD,VIJAYAWADA,5384,5962,HYDERABAD-VIJAYAWADA,11346,All
2020,11,HYDERABAD,VIJAYAWADA,6254,6970,HYDERABAD-VIJAYAWADA,13224,All
2020,12,HYDERABAD,VIJAYAWADA,8533,8616,HYDERABAD-VIJAYAWADA,17149,All
2021,1,HYDERABAD,VIJAYAWADA,8739,9872,HYDERABAD-VIJAYAWADA,18611,All
2021,2,HYDERABAD,VIJAYAWADA,7043,7923,HYDERABAD-VIJAYAWADA,14966,All
2021,3,HYDERABAD,VIJAYAWADA,7094,8224,HYDERABAD-VIJAYAWADA,15318,All
2021,4,HYDERABAD,VIJAYAWADA,5532,4613,HYDERABAD-VIJAYAWADA,10145,All
2021,6,HYDERABAD,VIJAYAWADA,4071,4033,HYDERABAD-VIJAYAWADA,8104,All
2021,7,HYDERABAD,VIJAYAWADA,5296,5652,HYDERABAD-VIJAYAWADA,10948,All
2021,8,HYDERABAD,VIJAYAWADA,6737,7192,HYDERABAD-VIJAYAWADA,13929,All
2021,9,HYDERABAD,VIJAYAWADA,6942,6819,HYDERABAD-VIJAYAWADA,13761,All
2021,10,HYDERABAD,VIJAYAWADA,8011,7910,HYDERABAD-VIJAYAWADA,15921,All
2021,11,HYDERABAD,VIJAYAWADA,8996,8283,HYDERABAD-VIJAYAWADA,17279,All
2021,12,HYDERABAD,VIJAYAWADA,10885,9703,HYDERABAD-VIJAYAWADA,20588,All
2022,1,HYDERABAD,VIJAYAWADA,7150,6570,HYDERABAD-VIJAYAWADA,13720,All
2022,2,HYDERABAD,VIJAYAWADA,7727,8136,HYDERABAD-VIJAYAWADA,15863,All
2022,3,HYDERABAD,VIJAYAWADA,10847,10173,HYDERABAD-VIJAYAWADA,21020,All
2022,4,HYDERABAD,VIJAYAWADA,10249,10575,HYDERABAD-VIJAYAWADA,20824,All
2022,5,HYDERABAD,VIJAYAWADA,11084,10412,HYDERABAD-VIJAYAWADA,21496,All
2022,6,HYDERABAD,VIJAYAWADA,9067,8837,HYDERABAD-VIJAYAWADA,17904,All
2022,7,HYDERABAD,VIJAYAWADA,10321,10528,HYDERABAD-VIJAYAWADA,20849,All
2022,8,HYDERABAD,VIJAYAWADA,12063,11973,HYDERABAD-VIJAYAWADA,24036,All
2022,9,HYDERABAD,VIJAYAWADA,10031,10154,HYDERABAD-VIJAYAWADA,20185,All
2022,10,HYDERABAD,VIJAYAWADA,11377,10231,HYDERABAD-VIJAYAWADA,21608,All
2022,11,HYDERABAD,VIJAYAWADA,10808,10939,HYDERABAD-VIJAYAWADA,21747,All
2022,12,HYDERABAD,VIJAYAWADA,12240,12320,HYDERABAD-VIJAYAWADA,24560,All
2023,1,HYDERABAD,VIJAYAWADA,11404,11744,HYDERABAD-VIJAYAWADA,23148,All
2023,2,HYDERABAD,VIJAYAWADA,11265,11418,HYDERABAD-VIJAYAWADA,22683,All
2023,3,HYDERABAD,VIJAYAWADA,11751,11949,HYDERABAD-VIJAYAWADA,23700,All
2023,4,HYDERABAD,VIJAYAWADA,11145,11728,HYDERABAD-VIJAYAWADA,22873,All
2023,5,HYDERABAD,VIJAYAWADA,12590,12838,HYDERABAD-VIJAYAWADA,25428,All
2023,6,HYDERABAD,VIJAYAWADA,12120,12242,HYDERABAD-VIJAYAWADA,24362,All
2023,7,HYDERABAD,VIJAYAWADA,12854,13069,HYDERABAD-VIJAYAWADA,25923,All
2023,8,HYDERABAD,VIJAYAWADA,12495,12521,HYDERABAD-VIJAYAWADA,25016,All
2023,9,HYDERABAD,VIJAYAWADA,10892,11330,HYDERABAD-VIJAYAWADA,22222,All
2023,10,HYDERABAD,VIJAYAWADA,11416,10958,HYDERABAD-VIJAYAWADA,22374,All
2023,11,HYDERABAD,VIJAYAWADA,10755,10944,HYDERABAD-VIJAYAWADA,21699,All
2023,12,HYDERABAD,VIJAYAWADA,11534,11113,HYDERABAD-VIJAYAWADA,22647,All
2024,1,HYDERABAD,VIJAYAWADA,12539,12665,HYDERABAD-VIJAYAWADA,25204,All
2024,2,HYDERABAD,VIJAYAWADA,11631,11575,HYDERABAD-VIJAYAWADA,23206,All
2024,3,HYDERABAD,VIJAYAWADA,12078,11938,HYDERABAD-VIJAYAWADA,24016,All
2024,4,HYDERABAD,VIJAYAWADA,13561,14448,HYDERABAD-VIJAYAWADA,28009,All
2024,6,HYDERABAD,VIJAYAWADA,15600,15404,HYDERABAD-VIJAYAWADA,31004,All
2024,7,HYDERABAD,VIJAYAWADA,16304,16209,HYDERABAD-VIJAYAWADA,32513,All
2024,8,HYDERABAD,VIJAYAWADA,16061,16084,HYDERABAD-VIJAYAWADA,32145,All
2024,9,HYDERABAD,VIJAYAWADA,15183,15738,HYDERABAD-VIJAYAWADA,30921,All
2024,10,HYDERABAD,VIJAYAWADA,16794,16612,HYDERABAD-VIJAYAWADA,33406,All
2024,11,HYDERABAD,VIJAYAWADA,14472,15150,HYDERABAD-VIJAYAWADA,29622,All
2024,12,HYDERABAD,VIJAYAWADA,16766,17092,HYDERABAD-VIJAYAWADA,33858,All
2025,1,HYDERABAD,VIJAYAWADA,14337,14584,HYDERABAD-VIJAYAWADA,28921,All
2025,2,HYDERABAD,VIJAYAWADA,14814,15299,HYDERABAD-VIJAYAWADA,30113,All
2025,3,HYDERABAD,VIJAYAWADA,16249,16446,HYDERABAD-VIJAYAWADA,32695,All
2015,4,HYDERABAD,VISAKHAPATNAM,25110,22636,HYDERABAD-VISAKHAPATNAM,47746,All
2015,5,HYDERABAD,VISAKHAPATNAM,28926,29145,HYDERABAD-VISAKHAPATNAM,58071,All
2015,6,HYDERABAD,VISAKHAPATNAM,23864,23359,HYDERABAD-VISAKHAPATNAM,47223,All
2015,7,HYDERABAD,VISAKHAPATNAM,26993,26058,HYDERABAD-VISAKHAPATNAM,53051,All
2015,8,HYDERABAD,VISAKHAPATNAM,26817,26497,HYDERABAD-VISAKHAPATNAM,53314,All
2015,9,HYDERABAD,VISAKHAPATNAM,25642,24965,HYDERABAD-VISAKHAPATNAM,50607,All
2015,10,HYDERABAD,VISAKHAPATNAM,28224,27432,HYDERABAD-VISAKHAPATNAM,55656,All
2015,11,HYDERABAD,VISAKHAPATNAM,26555,26351,HYDERABAD-VISAKHAPATNAM,52906,All
2015,12,HYDERABAD,VISAKHAPATNAM,29290,29534,HYDERABAD-VISAKHAPATNAM,58824,All
2016,1,HYDERABAD,VISAKHAPATNAM,28462,30343,HYDERABAD-VISAKHAPATNAM,58805,All
2016,2,HYDERABAD,VISAKHAPATNAM,28960,30249,HYDERABAD-VISAKHAPATNAM,59209,All
2016,3,HYDERABAD,VISAKHAPATNAM,30703,31195,HYDERABAD-VISAKHAPATNAM,61898,All
2016,4,HYDERABAD,VISAKHAPATNAM,32069,31293,HYDERABAD-VISAKHAPATNAM,63362,All
2016,5,HYDERABAD,VISAKHAPATNAM,29520,31086,HYDERABAD-VISAKHAPATNAM,60606,All
2016,6,HYDERABAD,VISAKHAPATNAM,26297,26848,HYDERABAD-VISAKHAPATNAM,53145,All
2016,7,HYDERABAD,VISAKHAPATNAM,29414,29874,HYDERABAD-VISAKHAPATNAM,59288,All
2016,8,HYDERABAD,VISAKHAPATNAM,35995,37356,HYDERABAD-VISAKHAPATNAM,73351,All
2016,9,HYDERABAD,VISAKHAPATNAM,28494,29259,HYDERABAD-VISAKHAPATNAM,57753,All
2016,10,HYDERABAD,VISAKHAPATNAM,31691,31301,HYDERABAD-VISAKHAPATNAM,62992,All
2016,11,HYDERABAD,VISAKHAPATNAM,30191,34500,HYDERABAD-VISAKHAPATNAM,64691,All
2016,12,HYDERABAD,VISAKHAPATNAM,35535,36677,HYDERABAD-VISAKHAPATNAM,72212,All
2017,1,HYDERABAD,VISAKHAPATNAM,34376,36455,HYDERABAD-VISAKHAPATNAM,70831,All
2017,2,HYDERABAD,VISAKHAPATNAM,31830,34943,HYDERABAD-VISAKHAPATNAM,66773,All
2017,3,HYDERABAD,VISAKHAPATNAM,31979,34959,HYDERABAD-VISAKHAPATNAM,66938,All
2017,4,HYDERABAD,VISAKHAPATNAM,32179,32548,HYDERABAD-VISAKHAPATNAM,64727,All
2017,5,HYDERABAD,VISAKHAPATNAM,38235,41838,HYDERABAD-VISAKHAPATNAM,80073,All
2017,6,HYDERABAD,VISAKHAPATNAM,35354,36256,HYDERABAD-VISAKHAPATNAM,71610,All
2017,7,HYDERABAD,VISAKHAPATNAM,31204,31407,HYDERABAD-VISAKHAPATNAM,62611,All
2017,8,HYDERABAD,VISAKHAPATNAM,26393,27305,HYDERABAD-VISAKHAPATNAM,53698,All
2017,9,HYDERABAD,VISAKHAPATNAM,26048,26718,HYDERABAD-VISAKHAPATNAM,52766,All
2017,10,HYDERABAD,VISAKHAPATNAM,32767,32714,HYDERABAD-VISAKHAPATNAM,65481,All
2017,11,HYDERABAD,VISAKHAPATNAM,34753,33505,HYDERABAD-VISAKHAPATNAM,68258,All
2017,12,HYDERABAD,VISAKHAPATNAM,35528,34854,HYDERABAD-VISAKHAPATNAM,70382,All
2018,1,HYDERABAD,VISAKHAPATNAM,33048,35475,HYDERABAD-VISAKHAPATNAM,68523,All
2018,2,HYDERABAD,VISAKHAPATNAM,30561,30514,HYDERABAD-VISAKHAPATNAM,61075,All
2018,3,HYDERABAD,VISAKHAPATNAM,37268,36669,HYDERABAD-VISAKHAPATNAM,73937,All
2018,4,HYDERABAD,VISAKHAPATNAM,35766,35537,HYDERABAD-VISAKHAPATNAM,71303,All
2018,5,HYDERABAD,VISAKHAPATNAM,35385,37843,HYDERABAD-VISAKHAPATNAM,73228,All
2018,6,HYDERABAD,VISAKHAPATNAM,34226,33480,HYDERABAD-VISAKHAPATNAM,67706,All
2018,7,HYDERABAD,VISAKHAPATNAM,37796,39093,HYDERABAD-VISAKHAPATNAM,76889,All
2018,8,HYDERABAD,VISAKHAPATNAM,36069,37875,HYDERABAD-VISAKHAPATNAM,73944,All
2018,9,HYDERABAD,VISAKHAPATNAM,31957,35447,HYDERABAD-VISAKHAPATNAM,67404,All
2018,10,HYDERABAD,VISAKHAPATNAM,33266,33994,HYDERABAD-VISAKHAPATNAM,67260,All
2018,11,HYDERABAD,VISAKHAPATNAM,26559,28243,HYDERABAD-VISAKHAPATNAM,54802,All
2018,12,HYDERABAD,VISAKHAPATNAM,35911,34310,HYDERABAD-VISAKHAPATNAM,70221,All
2019,1,HYDERABAD,VISAKHAPATNAM,32209,34761,HYDERABAD-VISAKHAPATNAM,66970,All
2019,2,HYDERABAD,VISAKHAPATNAM,34273,35112,HYDERABAD-VISAKHAPATNAM,69385,All
2019,3,HYDERABAD,VISAKHAPATNAM,35745,37337,HYDERABAD-VISAKHAPATNAM,73082,All
2019,4,HYDERABAD,VISAKHAPATNAM,36843,36486,HYDERABAD-VISAKHAPATNAM,73329,All
2019,5,HYDERABAD,VISAKHAPATNAM,40518,42399,HYDERABAD-VISAKHAPATNAM,82917,All
2019,6,HYDERABAD,VISAKHAPATNAM,39591,42042,HYDERABAD-VISAKHAPATNAM,81633,All
2019,7,HYDERABAD,VISAKHAPATNAM,38651,40293,HYDERABAD-VISAKHAPATNAM,78944,All
2019,8,HYDERABAD,VISAKHAPATNAM,37465,37633,HYDERABAD-VISAKHAPATNAM,75098,All
2019,9,HYDERABAD,VISAKHAPATNAM,37474,38089,HYDERABAD-VISAKHAPATNAM,75563,All
2019,10,HYDERABAD,VISAKHAPATNAM,43305,41898,HYDERABAD-VISAKHAPATNAM,85203,All
2019,11,HYDERABAD,VISAKHAPATNAM,39824,39677,HYDERABAD-VISAKHAPATNAM,79501,All
2019,12,HYDERABAD,VISAKHAPATNAM,41975,39645,HYDERABAD-VISAKHAPATNAM,81620,All
2020,1,HYDERABAD,VISAKHAPATNAM,38517,39681,HYDERABAD-VISAKHAPATNAM,78198,All
2020,2,HYDERABAD,VISAKHAPATNAM,36513,37528,HYDERABAD-VISAKHAPATNAM,74041,All
2020,3,HYDERABAD,VISAKHAPATNAM,21896,20705,HYDERABAD-VISAKHAPATNAM,42601,All
2020,5,HYDERABAD,VISAKHAPATNAM,895,1028,HYDERABAD-VISAKHAPATNAM,1923,All
2020,6,HYDERABAD,VISAKHAPATNAM,5898,5315,HYDERABAD-VISAKHAPATNAM,11213,All
2020,7,HYDERABAD,VISAKHAPATNAM,7073,5573,HYDERABAD-VISAKHAPATNAM,12646,All
2020,8,HYDERABAD,VISAKHAPATNAM,10425,11197,HYDERABAD-VISAKHAPATNAM,21622,All
2020,9,HYDERABAD,VISAKHAPATNAM,14447,17612,HYDERABAD-VISAKHAPATNAM,32059,All
2020,10,HYDERABAD,VISAKHAPATNAM,22860,22261,HYDERABAD-VISAKHAPATNAM,45121,All
2020,11,HYDERABAD,VISAKHAPATNAM,26720,27634,HYDERABAD-VISAKHAPATNAM,54354,All
2020,12,HYDERABAD,VISAKHAPATNAM,32852,29926,HYDERABAD-VISAKHAPATNAM,62778,All
2021,1,HYDERABAD,VISAKHAPATNAM,31840,33287,HYDERABAD-VISAKHAPATNAM,65127,All
2021,2,HYDERABAD,VISAKHAPATNAM,25518,26900,HYDERABAD-VISAKHAPATNAM,52418,All
2021,3,HYDERABAD,VISAKHAPATNAM,25140,25550,HYDERABAD-VISAKHAPATNAM,50690,All
2021,4,HYDERABAD,VISAKHAPATNAM,19838,17981,HYDERABAD-VISAKHAPATNAM,37819,All
2021,6,HYDERABAD,VISAKHAPATNAM,14127,13502,HYDERABAD-VISAKHAPATNAM,27629,All
2021,7,HYDERABAD,VISAKHAPATNAM,22681,21331,HYDERABAD-VISAKHAPATNAM,44012,All
2021,8,HYDERABAD,VISAKHAPATNAM,31527,30408,HYDERABAD-VISAKHAPATNAM,61935,All
2021,9,HYDERABAD,VISAKHAPATNAM,25187,25270,HYDERABAD-VISAKHAPATNAM,50457,All
2021,10,HYDERABAD,VISAKHAPATNAM,35589,32359,HYDERABAD-VISAKHAPATNAM,67948,All
2021,11,HYDERABAD,VISAKHAPATNAM,32390,31582,HYDERABAD-VISAKHAPATNAM,63972,All
2021,12,HYDERABAD,VISAKHAPATNAM,36286,33224,HYDERABAD-VISAKHAPATNAM,69510,All
2022,1,HYDERABAD,VISAKHAPATNAM,24362,22622,HYDERABAD-VISAKHAPATNAM,46984,All
2022,2,HYDERABAD,VISAKHAPATNAM,25324,24641,HYDERABAD-VISAKHAPATNAM,49965,All
2022,3,HYDERABAD,VISAKHAPATNAM,31979,30509,HYDERABAD-VISAKHAPATNAM,62488,All
2022,4,HYDERABAD,VISAKHAPATNAM,33011,30725,HYDERABAD-VISAKHAPATNAM,63736,All
2022,5,HYDERABAD,VISAKHAPATNAM,30057,29763,HYDERABAD-VISAKHAPATNAM,59820,All
2022,6,HYDERABAD,VISAKHAPATNAM,32151,31256,HYDERABAD-VISAKHAPATNAM,63407,All
2022,7,HYDERABAD,VISAKHAPATNAM,28212,26586,HYDERABAD-VISAKHAPATNAM,54798,All
2022,8,HYDERABAD,VISAKHAPATNAM,31470,31488,HYDERABAD-VISAKHAPATNAM,62958,All
2022,9,HYDERABAD,VISAKHAPATNAM,24759,26073,HYDERABAD-VISAKHAPATNAM,50832,All
2022,10,HYDERABAD,VISAKHAPATNAM,27605,27081,HYDERABAD-VISAKHAPATNAM,54686,All
2022,11,HYDERABAD,VISAKHAPATNAM,24083,22618,HYDERABAD-VISAKHAPATNAM,46701,All
2022,12,HYDERABAD,VISAKHAPATNAM,31333,30660,HYDERABAD-VISAKHAPATNAM,61993,All
2023,1,HYDERABAD,VISAKHAPATNAM,29219,28041,HYDERABAD-VISAKHAPATNAM,57260,All
2023,2,HYDERABAD,VISAKHAPATNAM,32075,29955,HYDERABAD-VISAKHAPATNAM,62030,All
2023,3,HYDERABAD,VISAKHAPATNAM,40196,37999,HYDERABAD-VISAKHAPATNAM,78195,All
2023,4,HYDERABAD,VISAKHAPATNAM,37851,35750,HYDERABAD-VISAKHAPATNAM,73601,All
2023,5,HYDERABAD,VISAKHAPATNAM,40951,42873,HYDERABAD-VISAKHAPATNAM,83824,All
2023,6,HYDERABAD,VISAKHAPATNAM,37403,39233,HYDERABAD-VISAKHAPATNAM,76636,All
2023,7,HYDERABAD,VISAKHAPATNAM,33527,36308,HYDERABAD-VISAKHAPATNAM,69835,All
2023,8,HYDERABAD,VISAKHAPATNAM,39534,42219,HYDERABAD-VISAKHAPATNAM,81753,All
2023,9,HYDERABAD,VISAKHAPATNAM,33409,36610,HYDERABAD-VISAKHAPATNAM,70019,All
2023,10,HYDERABAD,VISAKHAPATNAM,33261,34743,HYDERABAD-VISAKHAPATNAM,68004,All
2023,11,HYDERABAD,VISAKHAPATNAM,28974,29914,HYDERABAD-VISAKHAPATNAM,58888,All
2023,12,HYDERABAD,VISAKHAPATNAM,30476,29795,HYDERABAD-VISAKHAPATNAM,60271,All
2024,1,HYDERABAD,VISAKHAPATNAM,28579,29641,HYDERABAD-VISAKHAPATNAM,58220,All
2024,2,HYDERABAD,VISAKHAPATNAM,29992,29359,HYDERABAD-VISAKHAPATNAM,59351,All
2024,3,HYDERABAD,VISAKHAPATNAM,32869,32744,HYDERABAD-VISAKHAPATNAM,65613,All
2024,4,HYDERABAD,VISAKHAPATNAM,30617,29538,HYDERABAD-VISAKHAPATNAM,60155,All
2024,6,HYDERABAD,VISAKHAPATNAM,35257,32857,HYDERABAD-VISAKHAPATNAM,68114,All
2024,7,HYDERABAD,VISAKHAPATNAM,32703,30831,HYDERABAD-VISAKHAPATNAM,63534,All
2024,8,HYDERABAD,VISAKHAPATNAM,35978,35581,HYDERABAD-VISAKHAPATNAM,71559,All
2024,9,HYDERABAD,VISAKHAPATNAM,33777,33258,HYDERABAD-VISAKHAPATNAM,67035,All
2024,10,HYDERABAD,VISAKHAPATNAM,44927,39766,HYDERABAD-VISAKHAPATNAM,84693,All
2024,11,HYDERABAD,VISAKHAPATNAM,40491,43074,HYDERABAD-VISAKHAPATNAM,83565,All
2024,12,HYDERABAD,VISAKHAPATNAM,46339,44677,HYDERABAD-VISAKHAPATNAM,91016,All
2025,1,HYDERABAD,VISAKHAPATNAM,47150,46798,HYDERABAD-VISAKHAPATNAM,93948,All
2025,2,HYDERABAD,VISAKHAPATNAM,43377,41827,HYDERABAD-VISAKHAPATNAM,85204,All
2025,3,HYDERABAD,VISAKHAPATNAM,45010,42888,HYDERABAD-VISAKHAPATNAM,87898,All
2022,12,"Hollongi Airport, Itanagar",DIBRUGARH,64,98,"DIBRUGARH-Hollongi Airport, Itanagar",162,All
2022,12,"Hollongi Airport, Itanagar",KOLKATA,2594,3634,"Hollongi Airport, Itanagar-KOLKATA",6228,All
2023,2,"Hollongi Airport, Itanagar",KOLKATA,2848,3199,"Hollongi Airport, Itanagar-KOLKATA",6047,All
2023,3,"Hollongi Airport, Itanagar",KOLKATA,3506,3854,"Hollongi Airport, Itanagar-KOLKATA",7360,All
2023,4,"Hollongi Airport, Itanagar",KOLKATA,3957,4004,"Hollongi Airport, Itanagar-KOLKATA",7961,All
2023,5,"Hollongi Airport, Itanagar",KOLKATA,3575,4024,"Hollongi Airport, Itanagar-KOLKATA",7599,All
2022,12,"Hollongi Airport, Itanagar",MUMBAI,174,164,"Hollongi Airport, Itanagar-MUMBAI",338,All
2022,12,"Hollongi Airport, Itanagar",PASIGHAT,42,49,"Hollongi Airport, Itanagar-PASIGHAT",91,All
2023,3,"Hollongi Airport, Itanagar",PASIGHAT,0,3,"Hollongi Airport, Itanagar-PASIGHAT",3,All
2023,4,"Hollongi Airport, Itanagar",PASIGHAT,24,17,"Hollongi Airport, Itanagar-PASIGHAT",41,All
2023,5,"Hollongi Airport, Itanagar",PASIGHAT,16,7,"Hollongi Airport, Itanagar-PASIGHAT",23,All
2022,12,"Hollongi Airport, Itanagar",ZIRO,32,46,"Hollongi Airport, Itanagar-ZIRO",78,All
2023,4,"Hollongi Airport, Itanagar",Zero Airport,12,3,"Hollongi Airport, Itanagar-Zero Airport",15,All
2023,5,"Hollongi Airport, Itanagar",Zero Airport,12,9,"Hollongi Airport, Itanagar-Zero Airport",21,All
2025,1,Hyderabad,HYDERABAD,0,2,HYDERABAD-Hyderabad,2,All
2015,4,IMPHAL,AGARTALA,1030,870,AGARTALA-IMPHAL,1900,All
2015,5,IMPHAL,AGARTALA,1247,1039,AGARTALA-IMPHAL,2286,All
2015,6,IMPHAL,AGARTALA,1134,1018,AGARTALA-IMPHAL,2152,All
2015,7,IMPHAL,AGARTALA,1069,897,AGARTALA-IMPHAL,1966,All
2015,8,IMPHAL,AGARTALA,866,795,AGARTALA-IMPHAL,1661,All
2015,9,IMPHAL,AGARTALA,825,672,AGARTALA-IMPHAL,1497,All
2015,10,IMPHAL,AGARTALA,976,960,AGARTALA-IMPHAL,1936,All
2015,11,IMPHAL,AGARTALA,1036,1070,AGARTALA-IMPHAL,2106,All
2015,12,IMPHAL,AGARTALA,1166,983,AGARTALA-IMPHAL,2149,All
2016,1,IMPHAL,AGARTALA,964,874,AGARTALA-IMPHAL,1838,All
2016,2,IMPHAL,AGARTALA,990,1000,AGARTALA-IMPHAL,1990,All
2016,3,IMPHAL,AGARTALA,976,908,AGARTALA-IMPHAL,1884,All
2016,4,IMPHAL,AGARTALA,991,822,AGARTALA-IMPHAL,1813,All
2016,5,IMPHAL,AGARTALA,933,869,AGARTALA-IMPHAL,1802,All
2016,6,IMPHAL,AGARTALA,951,942,AGARTALA-IMPHAL,1893,All
2016,7,IMPHAL,AGARTALA,1035,883,AGARTALA-IMPHAL,1918,All
2016,8,IMPHAL,AGARTALA,873,665,AGARTALA-IMPHAL,1538,All
2016,9,IMPHAL,AGARTALA,895,831,AGARTALA-IMPHAL,1726,All
2016,10,IMPHAL,AGARTALA,1128,1097,AGARTALA-IMPHAL,2225,All
2016,11,IMPHAL,AGARTALA,1321,1044,AGARTALA-IMPHAL,2365,All
2016,12,IMPHAL,AGARTALA,1460,1177,AGARTALA-IMPHAL,2637,All
2017,1,IMPHAL,AGARTALA,1422,1253,AGARTALA-IMPHAL,2675,All
2017,2,IMPHAL,AGARTALA,1170,1076,AGARTALA-IMPHAL,2246,All
2017,3,IMPHAL,AGARTALA,1292,1044,AGARTALA-IMPHAL,2336,All
2017,4,IMPHAL,AGARTALA,1185,1023,AGARTALA-IMPHAL,2208,All
2017,5,IMPHAL,AGARTALA,1319,1042,AGARTALA-IMPHAL,2361,All
2017,6,IMPHAL,AGARTALA,1105,1147,AGARTALA-IMPHAL,2252,All
2017,7,IMPHAL,AGARTALA,1230,1101,AGARTALA-IMPHAL,2331,All
2017,8,IMPHAL,AGARTALA,1034,882,AGARTALA-IMPHAL,1916,All
2017,9,IMPHAL,AGARTALA,1149,921,AGARTALA-IMPHAL,2070,All
2017,10,IMPHAL,AGARTALA,1250,1135,AGARTALA-IMPHAL,2385,All
2017,11,IMPHAL,AGARTALA,1179,931,AGARTALA-IMPHAL,2110,All
2017,12,IMPHAL,AGARTALA,1367,931,AGARTALA-IMPHAL,2298,All
2018,1,IMPHAL,AGARTALA,1291,1201,AGARTALA-IMPHAL,2492,All
2018,2,IMPHAL,AGARTALA,1314,893,AGARTALA-IMPHAL,2207,All
2018,3,IMPHAL,AGARTALA,1324,1114,AGARTALA-IMPHAL,2438,All
2018,4,IMPHAL,AGARTALA,1093,1194,AGARTALA-IMPHAL,2287,All
2018,5,IMPHAL,AGARTALA,963,1174,AGARTALA-IMPHAL,2137,All
2018,6,IMPHAL,AGARTALA,1193,1335,AGARTALA-IMPHAL,2528,All
2018,7,IMPHAL,AGARTALA,1092,950,AGARTALA-IMPHAL,2042,All
2018,8,IMPHAL,AGARTALA,861,817,AGARTALA-IMPHAL,1678,All
2018,9,IMPHAL,AGARTALA,1183,706,AGARTALA-IMPHAL,1889,All
2018,10,IMPHAL,AGARTALA,1461,970,AGARTALA-IMPHAL,2431,All
2018,11,IMPHAL,AGARTALA,1537,834,AGARTALA-IMPHAL,2371,All
2018,12,IMPHAL,AGARTALA,1304,1045,AGARTALA-IMPHAL,2349,All
2019,1,IMPHAL,AGARTALA,1523,850,AGARTALA-IMPHAL,2373,All
2019,2,IMPHAL,AGARTALA,1192,759,AGARTALA-IMPHAL,1951,All
2019,3,IMPHAL,AGARTALA,1194,694,AGARTALA-IMPHAL,1888,All
2019,4,IMPHAL,AGARTALA,1315,863,AGARTALA-IMPHAL,2178,All
2018,5,IMPHAL,JAIPUR,67,0,IMPHAL-JAIPUR,67,All
2023,12,IMPHAL,JAIPUR,68,0,IMPHAL-JAIPUR,68,All
2019,5,IMPHAL,KOLKATA,10190,11301,IMPHAL-KOLKATA,21491,All
2019,6,IMPHAL,KOLKATA,12440,9899,IMPHAL-KOLKATA,22339,All
2019,7,IMPHAL,KOLKATA,13281,11782,IMPHAL-KOLKATA,25063,All
2019,8,IMPHAL,KOLKATA,11451,9950,IMPHAL-KOLKATA,21401,All
2019,9,IMPHAL,KOLKATA,11264,11002,IMPHAL-KOLKATA,22266,All
2019,10,IMPHAL,KOLKATA,13317,12941,IMPHAL-KOLKATA,26258,All
2019,11,IMPHAL,KOLKATA,13994,13237,IMPHAL-KOLKATA,27231,All
2019,12,IMPHAL,KOLKATA,12944,14367,IMPHAL-KOLKATA,27311,All
2020,1,IMPHAL,KOLKATA,14412,12873,IMPHAL-KOLKATA,27285,All
2020,2,IMPHAL,KOLKATA,13355,10962,IMPHAL-KOLKATA,24317,All
2020,3,IMPHAL,KOLKATA,8678,10812,IMPHAL-KOLKATA,19490,All
2020,5,IMPHAL,KOLKATA,64,103,IMPHAL-KOLKATA,167,All
2020,6,IMPHAL,KOLKATA,1996,2147,IMPHAL-KOLKATA,4143,All
2020,7,IMPHAL,KOLKATA,2830,3564,IMPHAL-KOLKATA,6394,All
2020,8,IMPHAL,KOLKATA,2011,1987,IMPHAL-KOLKATA,3998,All
2020,9,IMPHAL,KOLKATA,3284,4151,IMPHAL-KOLKATA,7435,All
2020,10,IMPHAL,KOLKATA,4805,4193,IMPHAL-KOLKATA,8998,All
2020,11,IMPHAL,KOLKATA,6211,4869,IMPHAL-KOLKATA,11080,All
2020,12,IMPHAL,KOLKATA,7184,9073,IMPHAL-KOLKATA,16257,All
2021,1,IMPHAL,KOLKATA,10531,7986,IMPHAL-KOLKATA,18517,All
2021,2,IMPHAL,KOLKATA,9289,8101,IMPHAL-KOLKATA,17390,All
2021,3,IMPHAL,KOLKATA,11335,10876,IMPHAL-KOLKATA,22211,All
2021,4,IMPHAL,KOLKATA,9479,9227,IMPHAL-KOLKATA,18706,All
2021,6,IMPHAL,KOLKATA,4546,5923,IMPHAL-KOLKATA,10469,All
2021,7,IMPHAL,KOLKATA,6659,6256,IMPHAL-KOLKATA,12915,All
2021,8,IMPHAL,KOLKATA,9333,8480,IMPHAL-KOLKATA,17813,All
2021,9,IMPHAL,KOLKATA,11291,9183,IMPHAL-KOLKATA,20474,All
2021,10,IMPHAL,KOLKATA,12828,11099,IMPHAL-KOLKATA,23927,All
2021,11,IMPHAL,KOLKATA,15746,12447,IMPHAL-KOLKATA,28193,All
2021,12,IMPHAL,KOLKATA,13679,18332,IMPHAL-KOLKATA,32011,All
2022,1,IMPHAL,KOLKATA,12357,9433,IMPHAL-KOLKATA,21790,All
2022,2,IMPHAL,KOLKATA,11904,10363,IMPHAL-KOLKATA,22267,All
2022,3,IMPHAL,KOLKATA,17498,12953,IMPHAL-KOLKATA,30451,All
2022,4,IMPHAL,KOLKATA,15708,13174,IMPHAL-KOLKATA,28882,All
2022,5,IMPHAL,KOLKATA,14556,14380,IMPHAL-KOLKATA,28936,All
2022,6,IMPHAL,KOLKATA,15788,12749,IMPHAL-KOLKATA,28537,All
2022,7,IMPHAL,KOLKATA,13138,11909,IMPHAL-KOLKATA,25047,All
2022,8,IMPHAL,KOLKATA,13431,12027,IMPHAL-KOLKATA,25458,All
2022,9,IMPHAL,KOLKATA,13966,11687,IMPHAL-KOLKATA,25653,All
2022,10,IMPHAL,KOLKATA,15145,15186,IMPHAL-KOLKATA,30331,All
2022,11,IMPHAL,KOLKATA,16141,15609,IMPHAL-KOLKATA,31750,All
2022,12,IMPHAL,KOLKATA,16348,19709,IMPHAL-KOLKATA,36057,All
2023,1,IMPHAL,KOLKATA,18997,14810,IMPHAL-KOLKATA,33807,All
2023,2,IMPHAL,KOLKATA,16460,14050,IMPHAL-KOLKATA,30510,All
2023,3,IMPHAL,KOLKATA,18630,18619,IMPHAL-KOLKATA,37249,All
2023,4,IMPHAL,KOLKATA,14658,15377,IMPHAL-KOLKATA,30035,All
2023,5,IMPHAL,KOLKATA,15534,9569,IMPHAL-KOLKATA,25103,All
2023,6,IMPHAL,KOLKATA,11990,8223,IMPHAL-KOLKATA,20213,All
2023,7,IMPHAL,KOLKATA,11722,11470,IMPHAL-KOLKATA,23192,All
2023,8,IMPHAL,KOLKATA,10909,10471,IMPHAL-KOLKATA,21380,All
2023,9,IMPHAL,KOLKATA,10611,10612,IMPHAL-KOLKATA,21223,All
2023,10,IMPHAL,KOLKATA,12013,11911,IMPHAL-KOLKATA,23924,All
2023,11,IMPHAL,KOLKATA,13731,13037,IMPHAL-KOLKATA,26768,All
2023,12,IMPHAL,KOLKATA,13075,14459,IMPHAL-KOLKATA,27534,All
2024,1,IMPHAL,KOLKATA,14847,13914,IMPHAL-KOLKATA,28761,All
2024,2,IMPHAL,KOLKATA,12354,12707,IMPHAL-KOLKATA,25061,All
2024,3,IMPHAL,KOLKATA,14636,14527,IMPHAL-KOLKATA,29163,All
2024,4,IMPHAL,KOLKATA,15315,15350,IMPHAL-KOLKATA,30665,All
2024,6,IMPHAL,KOLKATA,16984,14601,IMPHAL-KOLKATA,31585,All
2024,7,IMPHAL,KOLKATA,17003,14396,IMPHAL-KOLKATA,31399,All
2024,8,IMPHAL,KOLKATA,16323,11955,IMPHAL-KOLKATA,28278,All
2024,9,IMPHAL,KOLKATA,15599,11954,IMPHAL-KOLKATA,27553,All
2024,10,IMPHAL,KOLKATA,16905,16218,IMPHAL-KOLKATA,33123,All
2024,11,IMPHAL,KOLKATA,17750,17292,IMPHAL-KOLKATA,35042,All
2024,12,IMPHAL,KOLKATA,18387,19210,IMPHAL-KOLKATA,37597,All
2025,1,IMPHAL,KOLKATA,18792,19010,IMPHAL-KOLKATA,37802,All
2025,2,IMPHAL,KOLKATA,16634,16238,IMPHAL-KOLKATA,32872,All
2025,3,IMPHAL,KOLKATA,18647,18661,IMPHAL-KOLKATA,37308,All
2019,10,IMPHAL,LUCKNOW,10,0,IMPHAL-LUCKNOW,10,All
2021,6,IMPHAL,LUCKNOW,79,0,IMPHAL-LUCKNOW,79,All
2021,11,IMPHAL,LUCKNOW,0,134,IMPHAL-LUCKNOW,134,All
2023,2,IMPHAL,LUCKNOW,0,154,IMPHAL-LUCKNOW,154,All
2023,3,IMPHAL,LUCKNOW,1,0,IMPHAL-LUCKNOW,1,All
2023,9,IMPHAL,LUCKNOW,10,0,IMPHAL-LUCKNOW,10,All
2017,12,IMPHAL,MANGALORE,2,0,IMPHAL-MANGALORE,2,All
2018,1,IMPHAL,MANGALORE,5,0,IMPHAL-MANGALORE,5,All
2018,2,IMPHAL,MANGALORE,13,0,IMPHAL-MANGALORE,13,All
2018,4,IMPHAL,MANGALORE,23,0,IMPHAL-MANGALORE,23,All
2018,5,IMPHAL,MANGALORE,62,0,IMPHAL-MANGALORE,62,All
2018,6,IMPHAL,MANGALORE,1,0,IMPHAL-MANGALORE,1,All
2018,7,IMPHAL,MANGALORE,6,0,IMPHAL-MANGALORE,6,All
2018,8,IMPHAL,MANGALORE,23,0,IMPHAL-MANGALORE,23,All
2018,9,IMPHAL,MANGALORE,24,0,IMPHAL-MANGALORE,24,All
2018,10,IMPHAL,MANGALORE,7,0,IMPHAL-MANGALORE,7,All
2018,11,IMPHAL,MANGALORE,42,0,IMPHAL-MANGALORE,42,All
2018,12,IMPHAL,MANGALORE,16,0,IMPHAL-MANGALORE,16,All
2019,1,IMPHAL,MANGALORE,16,0,IMPHAL-MANGALORE,16,All
2019,2,IMPHAL,MANGALORE,2,0,IMPHAL-MANGALORE,2,All
2019,4,IMPHAL,MANGALORE,5,0,IMPHAL-MANGALORE,5,All
2019,5,IMPHAL,MANGALORE,13,0,IMPHAL-MANGALORE,13,All
2019,6,IMPHAL,MANGALORE,32,0,IMPHAL-MANGALORE,32,All
2019,7,IMPHAL,MANGALORE,5,0,IMPHAL-MANGALORE,5,All
2019,8,IMPHAL,MANGALORE,9,0,IMPHAL-MANGALORE,9,All
2019,9,IMPHAL,MANGALORE,11,0,IMPHAL-MANGALORE,11,All
2019,10,IMPHAL,MANGALORE,2,0,IMPHAL-MANGALORE,2,All
2021,4,IMPHAL,MANGALORE,0,159,IMPHAL-MANGALORE,159,All
2020,11,IMPHAL,MUMBAI,57,82,IMPHAL-MUMBAI,139,All
2020,12,IMPHAL,MUMBAI,491,655,IMPHAL-MUMBAI,1146,All
2021,1,IMPHAL,MUMBAI,859,537,IMPHAL-MUMBAI,1396,All
2021,2,IMPHAL,MUMBAI,681,578,IMPHAL-MUMBAI,1259,All
2021,3,IMPHAL,MUMBAI,649,497,IMPHAL-MUMBAI,1146,All
2021,4,IMPHAL,MUMBAI,128,0,IMPHAL-MUMBAI,128,All
2021,6,IMPHAL,MUMBAI,168,0,IMPHAL-MUMBAI,168,All
2021,7,IMPHAL,MUMBAI,70,0,IMPHAL-MUMBAI,70,All
2021,8,IMPHAL,MUMBAI,188,0,IMPHAL-MUMBAI,188,All
2021,9,IMPHAL,MUMBAI,192,0,IMPHAL-MUMBAI,192,All
2021,10,IMPHAL,MUMBAI,239,0,IMPHAL-MUMBAI,239,All
2021,11,IMPHAL,MUMBAI,555,568,IMPHAL-MUMBAI,1123,All
2021,12,IMPHAL,MUMBAI,481,745,IMPHAL-MUMBAI,1226,All
2022,1,IMPHAL,MUMBAI,240,183,IMPHAL-MUMBAI,423,All
2022,2,IMPHAL,MUMBAI,285,411,IMPHAL-MUMBAI,696,All
2022,3,IMPHAL,MUMBAI,291,386,IMPHAL-MUMBAI,677,All
2022,4,IMPHAL,MUMBAI,301,287,IMPHAL-MUMBAI,588,All
2022,5,IMPHAL,MUMBAI,800,929,IMPHAL-MUMBAI,1729,All
2022,6,IMPHAL,MUMBAI,921,636,IMPHAL-MUMBAI,1557,All
2022,7,IMPHAL,MUMBAI,619,395,IMPHAL-MUMBAI,1014,All
2022,8,IMPHAL,MUMBAI,452,236,IMPHAL-MUMBAI,688,All
2022,9,IMPHAL,MUMBAI,284,173,IMPHAL-MUMBAI,457,All
2022,10,IMPHAL,MUMBAI,487,500,IMPHAL-MUMBAI,987,All
2022,11,IMPHAL,MUMBAI,378,844,IMPHAL-MUMBAI,1222,All
2022,12,IMPHAL,MUMBAI,882,1257,IMPHAL-MUMBAI,2139,All
2024,6,IMPHAL,MUMBAI,150,197,IMPHAL-MUMBAI,347,All
2024,7,IMPHAL,MUMBAI,87,77,IMPHAL-MUMBAI,164,All
2024,8,IMPHAL,MUMBAI,101,107,IMPHAL-MUMBAI,208,All
2024,9,IMPHAL,MUMBAI,65,84,IMPHAL-MUMBAI,149,All
2024,10,IMPHAL,MUMBAI,116,139,IMPHAL-MUMBAI,255,All
2024,11,IMPHAL,MUMBAI,303,105,IMPHAL-MUMBAI,408,All
2024,12,IMPHAL,MUMBAI,196,181,IMPHAL-MUMBAI,377,All
2025,3,IMPHAL,MUMBAI,231,116,IMPHAL-MUMBAI,347,All
2018,3,IMPHAL,NAGPUR,69,0,IMPHAL-NAGPUR,69,All
2018,4,IMPHAL,NAGPUR,14,0,IMPHAL-NAGPUR,14,All
2023,5,IMPHAL,PATNA,167,0,IMPHAL-PATNA,167,All
2023,10,IMPHAL,PATNA,5,0,IMPHAL-PATNA,5,All
2023,11,IMPHAL,PATNA,313,0,IMPHAL-PATNA,313,All
2023,12,IMPHAL,PATNA,383,0,IMPHAL-PATNA,383,All
2015,4,IMPHAL,PUNE,0,24,IMPHAL-PUNE,24,All
2015,5,IMPHAL,PUNE,0,143,IMPHAL-PUNE,143,All
2015,6,IMPHAL,PUNE,0,178,IMPHAL-PUNE,178,All
2015,7,IMPHAL,PUNE,0,187,IMPHAL-PUNE,187,All
2015,8,IMPHAL,PUNE,0,188,IMPHAL-PUNE,188,All
2015,9,IMPHAL,PUNE,0,143,IMPHAL-PUNE,143,All
2015,10,IMPHAL,PUNE,0,164,IMPHAL-PUNE,164,All
2015,11,IMPHAL,PUNE,0,154,IMPHAL-PUNE,154,All
2015,12,IMPHAL,PUNE,0,511,IMPHAL-PUNE,511,All
2016,1,IMPHAL,PUNE,0,254,IMPHAL-PUNE,254,All
2016,2,IMPHAL,PUNE,0,245,IMPHAL-PUNE,245,All
2016,3,IMPHAL,PUNE,0,358,IMPHAL-PUNE,358,All
2016,4,IMPHAL,PUNE,0,258,IMPHAL-PUNE,258,All
2016,5,IMPHAL,PUNE,0,292,IMPHAL-PUNE,292,All
2016,6,IMPHAL,PUNE,0,280,IMPHAL-PUNE,280,All
2016,7,IMPHAL,PUNE,0,293,IMPHAL-PUNE,293,All
2016,8,IMPHAL,PUNE,0,249,IMPHAL-PUNE,249,All
2016,9,IMPHAL,PUNE,0,247,IMPHAL-PUNE,247,All
2016,10,IMPHAL,PUNE,0,287,IMPHAL-PUNE,287,All
2016,11,IMPHAL,PUNE,0,290,IMPHAL-PUNE,290,All
2016,12,IMPHAL,PUNE,0,434,IMPHAL-PUNE,434,All
2017,1,IMPHAL,PUNE,0,221,IMPHAL-PUNE,221,All
2017,2,IMPHAL,PUNE,5,202,IMPHAL-PUNE,207,All
2017,3,IMPHAL,PUNE,15,299,IMPHAL-PUNE,314,All
2017,4,IMPHAL,PUNE,0,336,IMPHAL-PUNE,336,All
2017,5,IMPHAL,PUNE,0,370,IMPHAL-PUNE,370,All
2017,6,IMPHAL,PUNE,0,298,IMPHAL-PUNE,298,All
2017,12,IMPHAL,PUNE,11,0,IMPHAL-PUNE,11,All
2018,1,IMPHAL,PUNE,79,0,IMPHAL-PUNE,79,All
2018,2,IMPHAL,PUNE,94,0,IMPHAL-PUNE,94,All
2018,3,IMPHAL,PUNE,17,0,IMPHAL-PUNE,17,All
2018,4,IMPHAL,PUNE,13,0,IMPHAL-PUNE,13,All
2018,5,IMPHAL,PUNE,8,0,IMPHAL-PUNE,8,All
2018,6,IMPHAL,PUNE,3,0,IMPHAL-PUNE,3,All
2018,7,IMPHAL,PUNE,1,0,IMPHAL-PUNE,1,All
2018,8,IMPHAL,PUNE,1,0,IMPHAL-PUNE,1,All
2023,4,IMPHAL,RANCHI,21,0,IMPHAL-RANCHI,21,All
2023,8,IMPHAL,RANCHI,1,0,IMPHAL-RANCHI,1,All
2021,8,IMPHAL,SHILLONG,534,467,IMPHAL-SHILLONG,1001,All
2021,9,IMPHAL,SHILLONG,942,722,IMPHAL-SHILLONG,1664,All
2021,10,IMPHAL,SHILLONG,889,790,IMPHAL-SHILLONG,1679,All
2021,11,IMPHAL,SHILLONG,935,849,IMPHAL-SHILLONG,1784,All
2021,12,IMPHAL,SHILLONG,974,904,IMPHAL-SHILLONG,1878,All
2022,1,IMPHAL,SHILLONG,798,615,IMPHAL-SHILLONG,1413,All
2022,2,IMPHAL,SHILLONG,802,644,IMPHAL-SHILLONG,1446,All
2022,3,IMPHAL,SHILLONG,930,774,IMPHAL-SHILLONG,1704,All
2022,4,IMPHAL,SHILLONG,854,677,IMPHAL-SHILLONG,1531,All
2022,5,IMPHAL,SHILLONG,737,691,IMPHAL-SHILLONG,1428,All
2022,6,IMPHAL,SHILLONG,691,620,IMPHAL-SHILLONG,1311,All
2022,7,IMPHAL,SHILLONG,722,667,IMPHAL-SHILLONG,1389,All
2022,8,IMPHAL,SHILLONG,791,773,IMPHAL-SHILLONG,1564,All
2022,9,IMPHAL,SHILLONG,696,629,IMPHAL-SHILLONG,1325,All
2022,10,IMPHAL,SHILLONG,682,664,IMPHAL-SHILLONG,1346,All
2022,11,IMPHAL,SHILLONG,670,696,IMPHAL-SHILLONG,1366,All
2022,12,IMPHAL,SHILLONG,714,797,IMPHAL-SHILLONG,1511,All
2023,1,IMPHAL,SHILLONG,856,682,IMPHAL-SHILLONG,1538,All
2023,2,IMPHAL,SHILLONG,661,637,IMPHAL-SHILLONG,1298,All
2023,3,IMPHAL,SHILLONG,716,806,IMPHAL-SHILLONG,1522,All
2023,4,IMPHAL,SHILLONG,650,632,IMPHAL-SHILLONG,1282,All
2023,5,IMPHAL,SHILLONG,883,527,IMPHAL-SHILLONG,1410,All
2023,6,IMPHAL,SHILLONG,755,535,IMPHAL-SHILLONG,1290,All
2023,7,IMPHAL,SHILLONG,778,657,IMPHAL-SHILLONG,1435,All
2023,8,IMPHAL,SHILLONG,649,577,IMPHAL-SHILLONG,1226,All
2023,9,IMPHAL,SHILLONG,709,551,IMPHAL-SHILLONG,1260,All
2023,10,IMPHAL,SHILLONG,746,611,IMPHAL-SHILLONG,1357,All
2023,11,IMPHAL,SHILLONG,856,728,IMPHAL-SHILLONG,1584,All
2023,12,IMPHAL,SHILLONG,810,804,IMPHAL-SHILLONG,1614,All
2024,1,IMPHAL,SHILLONG,976,774,IMPHAL-SHILLONG,1750,All
2024,2,IMPHAL,SHILLONG,837,650,IMPHAL-SHILLONG,1487,All
2024,3,IMPHAL,SHILLONG,795,715,IMPHAL-SHILLONG,1510,All
2024,4,IMPHAL,SHILLONG,465,401,IMPHAL-SHILLONG,866,All
2024,6,IMPHAL,SHILLONG,608,575,IMPHAL-SHILLONG,1183,All
2024,7,IMPHAL,SHILLONG,838,707,IMPHAL-SHILLONG,1545,All
2024,8,IMPHAL,SHILLONG,776,566,IMPHAL-SHILLONG,1342,All
2024,9,IMPHAL,SHILLONG,695,565,IMPHAL-SHILLONG,1260,All
2024,10,IMPHAL,SHILLONG,739,626,IMPHAL-SHILLONG,1365,All
2024,11,IMPHAL,SHILLONG,749,603,IMPHAL-SHILLONG,1352,All
2024,12,IMPHAL,SHILLONG,792,697,IMPHAL-SHILLONG,1489,All
2025,1,IMPHAL,SHILLONG,952,772,IMPHAL-SHILLONG,1724,All
2025,2,IMPHAL,SHILLONG,752,523,IMPHAL-SHILLONG,1275,All
2025,3,IMPHAL,SHILLONG,619,483,IMPHAL-SHILLONG,1102,All
2022,11,IMPHAL,SILCHAR,222,210,IMPHAL-SILCHAR,432,All
2022,12,IMPHAL,SILCHAR,1468,1445,IMPHAL-SILCHAR,2913,All
2023,1,IMPHAL,SILCHAR,1559,1375,IMPHAL-SILCHAR,2934,All
2023,2,IMPHAL,SILCHAR,1354,1325,IMPHAL-SILCHAR,2679,All
2023,3,IMPHAL,SILCHAR,1517,1458,IMPHAL-SILCHAR,2975,All
2023,4,IMPHAL,SILCHAR,1621,1677,IMPHAL-SILCHAR,3298,All
2023,5,IMPHAL,SILCHAR,1718,1677,IMPHAL-SILCHAR,3395,All
2023,6,IMPHAL,SILCHAR,1715,1512,IMPHAL-SILCHAR,3227,All
2023,7,IMPHAL,SILCHAR,1723,1847,IMPHAL-SILCHAR,3570,All
2023,8,IMPHAL,SILCHAR,1804,1857,IMPHAL-SILCHAR,3661,All
2023,9,IMPHAL,SILCHAR,1715,1744,IMPHAL-SILCHAR,3459,All
2023,10,IMPHAL,SILCHAR,1891,1723,IMPHAL-SILCHAR,3614,All
2023,11,IMPHAL,SILCHAR,1857,1815,IMPHAL-SILCHAR,3672,All
2023,12,IMPHAL,SILCHAR,1678,1792,IMPHAL-SILCHAR,3470,All
2024,1,IMPHAL,SILCHAR,1974,1921,IMPHAL-SILCHAR,3895,All
2024,2,IMPHAL,SILCHAR,1804,1845,IMPHAL-SILCHAR,3649,All
2024,3,IMPHAL,SILCHAR,1941,1949,IMPHAL-SILCHAR,3890,All
2024,4,IMPHAL,SILCHAR,1888,1918,IMPHAL-SILCHAR,3806,All
2024,6,IMPHAL,SILCHAR,1907,1910,IMPHAL-SILCHAR,3817,All
2024,7,IMPHAL,SILCHAR,1889,1877,IMPHAL-SILCHAR,3766,All
2024,8,IMPHAL,SILCHAR,1195,1167,IMPHAL-SILCHAR,2362,All
2024,9,IMPHAL,SILCHAR,1242,1176,IMPHAL-SILCHAR,2418,All
2024,10,IMPHAL,SILCHAR,1707,1723,IMPHAL-SILCHAR,3430,All
2024,11,IMPHAL,SILCHAR,1120,1094,IMPHAL-SILCHAR,2214,All
2024,12,IMPHAL,SILCHAR,1138,1132,IMPHAL-SILCHAR,2270,All
2025,1,IMPHAL,SILCHAR,899,1015,IMPHAL-SILCHAR,1914,All
2025,2,IMPHAL,SILCHAR,1018,1014,IMPHAL-SILCHAR,2032,All
2025,3,IMPHAL,SILCHAR,958,965,IMPHAL-SILCHAR,1923,All
2021,6,IMPHAL,SURAT,16,0,IMPHAL-SURAT,16,All
2021,7,IMPHAL,SURAT,46,0,IMPHAL-SURAT,46,All
2022,9,IMPHAL,TEZU,179,131,IMPHAL-TEZU,310,All
2022,10,IMPHAL,TEZU,1038,1003,IMPHAL-TEZU,2041,All
2022,11,IMPHAL,TEZU,604,407,IMPHAL-TEZU,1011,All
2022,12,IMPHAL,TEZU,934,1194,IMPHAL-TEZU,2128,All
2023,1,IMPHAL,TEZU,912,471,IMPHAL-TEZU,1383,All
2023,2,IMPHAL,TEZU,478,207,IMPHAL-TEZU,685,All
2023,3,IMPHAL,TEZU,9,9,IMPHAL-TEZU,18,All
2023,4,IMPHAL,TEZU,74,41,IMPHAL-TEZU,115,All
2023,5,IMPHAL,TEZU,765,114,IMPHAL-TEZU,879,All
2023,6,IMPHAL,TEZU,691,274,IMPHAL-TEZU,965,All
2023,7,IMPHAL,TEZU,1021,618,IMPHAL-TEZU,1639,All
2023,8,IMPHAL,TEZU,1044,645,IMPHAL-TEZU,1689,All
2023,9,IMPHAL,TEZU,1258,1166,IMPHAL-TEZU,2424,All
2023,10,IMPHAL,TEZU,679,570,IMPHAL-TEZU,1249,All
2023,11,IMPHAL,TEZU,0,60,IMPHAL-TEZU,60,All
2024,10,IMPHAL,TEZU,23,22,IMPHAL-TEZU,45,All
2024,11,IMPHAL,TEZU,207,155,IMPHAL-TEZU,362,All
2024,12,IMPHAL,TEZU,664,794,IMPHAL-TEZU,1458,All
2025,1,IMPHAL,TEZU,390,404,IMPHAL-TEZU,794,All
2017,12,IMPHAL,TRIVANDRUM,0,2,IMPHAL-TRIVANDRUM,2,All
2018,1,IMPHAL,TRIVANDRUM,0,7,IMPHAL-TRIVANDRUM,7,All
2018,2,IMPHAL,TRIVANDRUM,0,37,IMPHAL-TRIVANDRUM,37,All
2018,4,IMPHAL,TRIVANDRUM,0,60,IMPHAL-TRIVANDRUM,60,All
2018,5,IMPHAL,TRIVANDRUM,0,37,IMPHAL-TRIVANDRUM,37,All
2018,6,IMPHAL,TRIVANDRUM,0,24,IMPHAL-TRIVANDRUM,24,All
2018,7,IMPHAL,TRIVANDRUM,0,4,IMPHAL-TRIVANDRUM,4,All
2018,9,IMPHAL,TRIVANDRUM,0,8,IMPHAL-TRIVANDRUM,8,All
2018,6,INDORE,ALLAHABAD,444,457,ALLAHABAD-INDORE,901,All
2018,7,INDORE,ALLAHABAD,692,718,ALLAHABAD-INDORE,1410,All
2018,8,INDORE,ALLAHABAD,715,677,ALLAHABAD-INDORE,1392,All
2018,9,INDORE,ALLAHABAD,619,581,ALLAHABAD-INDORE,1200,All
2018,10,INDORE,ALLAHABAD,727,644,ALLAHABAD-INDORE,1371,All
2018,11,INDORE,ALLAHABAD,672,630,ALLAHABAD-INDORE,1302,All
2018,12,INDORE,ALLAHABAD,761,824,ALLAHABAD-INDORE,1585,All
2019,1,INDORE,ALLAHABAD,769,732,ALLAHABAD-INDORE,1501,All
2019,2,INDORE,ALLAHABAD,800,739,ALLAHABAD-INDORE,1539,All
2019,3,INDORE,ALLAHABAD,745,691,ALLAHABAD-INDORE,1436,All
2019,4,INDORE,ALLAHABAD,239,201,ALLAHABAD-INDORE,440,All
2018,8,INDORE,CHANDIGARH,1289,1281,CHANDIGARH-INDORE,2570,All
2018,9,INDORE,CHANDIGARH,1988,1804,CHANDIGARH-INDORE,3792,All
2018,10,INDORE,CHANDIGARH,2391,1840,CHANDIGARH-INDORE,4231,All
2015,4,INDORE,CHENNAI,66,113,CHENNAI-INDORE,179,All
2015,5,INDORE,CHENNAI,697,682,CHENNAI-INDORE,1379,All
2015,6,INDORE,CHENNAI,724,759,CHENNAI-INDORE,1483,All
2015,7,INDORE,CHENNAI,915,1083,CHENNAI-INDORE,1998,All
2015,8,INDORE,CHENNAI,728,918,CHENNAI-INDORE,1646,All
2015,9,INDORE,CHENNAI,686,940,CHENNAI-INDORE,1626,All
2015,10,INDORE,CHENNAI,549,666,CHENNAI-INDORE,1215,All
2015,11,INDORE,CHENNAI,560,692,CHENNAI-INDORE,1252,All
2015,12,INDORE,CHENNAI,478,448,CHENNAI-INDORE,926,All
2016,1,INDORE,CHENNAI,456,375,CHENNAI-INDORE,831,All
2016,2,INDORE,CHENNAI,536,560,CHENNAI-INDORE,1096,All
2016,3,INDORE,CHENNAI,268,300,CHENNAI-INDORE,568,All
2016,4,INDORE,CHENNAI,333,404,CHENNAI-INDORE,737,All
2016,5,INDORE,CHENNAI,920,734,CHENNAI-INDORE,1654,All
2016,6,INDORE,CHENNAI,373,462,CHENNAI-INDORE,835,All
2016,7,INDORE,CHENNAI,503,521,CHENNAI-INDORE,1024,All
2016,8,INDORE,CHENNAI,622,669,CHENNAI-INDORE,1291,All
2016,9,INDORE,CHENNAI,510,638,CHENNAI-INDORE,1148,All
2016,10,INDORE,CHENNAI,608,671,CHENNAI-INDORE,1279,All
2016,11,INDORE,CHENNAI,631,560,CHENNAI-INDORE,1191,All
2016,12,INDORE,CHENNAI,508,448,CHENNAI-INDORE,956,All
2017,1,INDORE,CHENNAI,610,565,CHENNAI-INDORE,1175,All
2017,2,INDORE,CHENNAI,663,596,CHENNAI-INDORE,1259,All
2017,3,INDORE,CHENNAI,448,467,CHENNAI-INDORE,915,All
2017,4,INDORE,CHENNAI,3148,3656,CHENNAI-INDORE,6804,All
2017,5,INDORE,CHENNAI,4978,4444,CHENNAI-INDORE,9422,All
2017,6,INDORE,CHENNAI,2446,2715,CHENNAI-INDORE,5161,All
2017,7,INDORE,CHENNAI,3227,2925,CHENNAI-INDORE,6152,All
2017,8,INDORE,CHENNAI,560,554,CHENNAI-INDORE,1114,All
2017,9,INDORE,CHENNAI,613,743,CHENNAI-INDORE,1356,All
2017,10,INDORE,CHENNAI,761,827,CHENNAI-INDORE,1588,All
2017,11,INDORE,CHENNAI,1435,1499,CHENNAI-INDORE,2934,All
2017,12,INDORE,CHENNAI,5732,5819,CHENNAI-INDORE,11551,All
2018,1,INDORE,CHENNAI,5686,5229,CHENNAI-INDORE,10915,All
2018,2,INDORE,CHENNAI,4445,4799,CHENNAI-INDORE,9244,All
2018,3,INDORE,CHENNAI,4442,5002,CHENNAI-INDORE,9444,All
2018,4,INDORE,CHENNAI,3467,3838,CHENNAI-INDORE,7305,All
2018,5,INDORE,CHENNAI,5575,4990,CHENNAI-INDORE,10565,All
2018,6,INDORE,CHENNAI,4945,4302,CHENNAI-INDORE,9247,All
2018,7,INDORE,CHENNAI,5201,3990,CHENNAI-INDORE,9191,All
2018,8,INDORE,CHENNAI,4262,4200,CHENNAI-INDORE,8462,All
2018,9,INDORE,CHENNAI,4587,4646,CHENNAI-INDORE,9233,All
2018,10,INDORE,CHENNAI,3806,3790,CHENNAI-INDORE,7596,All
2018,11,INDORE,CHENNAI,4218,4205,CHENNAI-INDORE,8423,All
2018,12,INDORE,CHENNAI,4783,4828,CHENNAI-INDORE,9611,All
2019,1,INDORE,CHENNAI,5059,5387,CHENNAI-INDORE,10446,All
2019,2,INDORE,CHENNAI,4299,5080,CHENNAI-INDORE,9379,All
2019,3,INDORE,CHENNAI,3937,4309,CHENNAI-INDORE,8246,All
2019,4,INDORE,CHENNAI,3623,4931,CHENNAI-INDORE,8554,All
2021,8,INDORE,JABALPUR,180,200,INDORE-JABALPUR,380,All
2021,9,INDORE,JABALPUR,1161,1182,INDORE-JABALPUR,2343,All
2021,10,INDORE,JABALPUR,1119,1193,INDORE-JABALPUR,2312,All
2021,11,INDORE,JABALPUR,1564,1624,INDORE-JABALPUR,3188,All
2021,12,INDORE,JABALPUR,1679,1795,INDORE-JABALPUR,3474,All
2022,1,INDORE,JABALPUR,736,702,INDORE-JABALPUR,1438,All
2022,2,INDORE,JABALPUR,604,631,INDORE-JABALPUR,1235,All
2022,3,INDORE,JABALPUR,1246,1524,INDORE-JABALPUR,2770,All
2022,4,INDORE,JABALPUR,1188,1319,INDORE-JABALPUR,2507,All
2022,5,INDORE,JABALPUR,1202,1244,INDORE-JABALPUR,2446,All
2022,6,INDORE,JABALPUR,1189,1295,INDORE-JABALPUR,2484,All
2022,7,INDORE,JABALPUR,848,894,INDORE-JABALPUR,1742,All
2022,8,INDORE,JABALPUR,1065,1119,INDORE-JABALPUR,2184,All
2022,9,INDORE,JABALPUR,1208,1243,INDORE-JABALPUR,2451,All
2022,10,INDORE,JABALPUR,1933,1855,INDORE-JABALPUR,3788,All
2022,11,INDORE,JABALPUR,1905,2391,INDORE-JABALPUR,4296,All
2022,12,INDORE,JABALPUR,2118,2265,INDORE-JABALPUR,4383,All
2023,1,INDORE,JABALPUR,1693,1799,INDORE-JABALPUR,3492,All
2023,2,INDORE,JABALPUR,2195,1931,INDORE-JABALPUR,4126,All
2023,3,INDORE,JABALPUR,2351,2331,INDORE-JABALPUR,4682,All
2023,4,INDORE,JABALPUR,1903,2040,INDORE-JABALPUR,3943,All
2023,5,INDORE,JABALPUR,2160,2234,INDORE-JABALPUR,4394,All
2023,6,INDORE,JABALPUR,1932,1915,INDORE-JABALPUR,3847,All
2023,7,INDORE,JABALPUR,1610,2227,INDORE-JABALPUR,3837,All
2023,8,INDORE,JABALPUR,1677,2050,INDORE-JABALPUR,3727,All
2023,9,INDORE,JABALPUR,1681,2188,INDORE-JABALPUR,3869,All
2023,10,INDORE,JABALPUR,1914,2197,INDORE-JABALPUR,4111,All
2023,11,INDORE,JABALPUR,1945,1883,INDORE-JABALPUR,3828,All
2023,12,INDORE,JABALPUR,2051,2275,INDORE-JABALPUR,4326,All
2024,1,INDORE,JABALPUR,1677,1794,INDORE-JABALPUR,3471,All
2024,2,INDORE,JABALPUR,2035,2137,INDORE-JABALPUR,4172,All
2024,3,INDORE,JABALPUR,2105,2276,INDORE-JABALPUR,4381,All
2024,4,INDORE,JABALPUR,2119,2127,INDORE-JABALPUR,4246,All
2024,6,INDORE,JABALPUR,1895,2173,INDORE-JABALPUR,4068,All
2024,7,INDORE,JABALPUR,1622,1812,INDORE-JABALPUR,3434,All
2024,8,INDORE,JABALPUR,1900,1994,INDORE-JABALPUR,3894,All
2024,9,INDORE,JABALPUR,1593,1869,INDORE-JABALPUR,3462,All
2024,10,INDORE,JABALPUR,2069,1844,INDORE-JABALPUR,3913,All
2024,11,INDORE,JABALPUR,1729,2145,INDORE-JABALPUR,3874,All
2024,12,INDORE,JABALPUR,1946,2225,INDORE-JABALPUR,4171,All
2025,1,INDORE,JABALPUR,1834,2267,INDORE-JABALPUR,4101,All
2025,2,INDORE,JABALPUR,1800,2025,INDORE-JABALPUR,3825,All
2025,3,INDORE,JABALPUR,1386,2029,INDORE-JABALPUR,3415,All
2015,4,INDORE,JAIPUR,0,265,INDORE-JAIPUR,265,All
2015,5,INDORE,JAIPUR,0,349,INDORE-JAIPUR,349,All
2015,6,INDORE,JAIPUR,0,233,INDORE-JAIPUR,233,All
2015,7,INDORE,JAIPUR,0,270,INDORE-JAIPUR,270,All
2015,8,INDORE,JAIPUR,0,241,INDORE-JAIPUR,241,All
2015,9,INDORE,JAIPUR,0,187,INDORE-JAIPUR,187,All
2015,10,INDORE,JAIPUR,0,251,INDORE-JAIPUR,251,All
2015,11,INDORE,JAIPUR,0,157,INDORE-JAIPUR,157,All
2015,12,INDORE,JAIPUR,0,53,INDORE-JAIPUR,53,All
2016,2,INDORE,JAIPUR,0,108,INDORE-JAIPUR,108,All
2016,3,INDORE,JAIPUR,0,132,INDORE-JAIPUR,132,All
2017,7,INDORE,JAIPUR,724,762,INDORE-JAIPUR,1486,All
2017,8,INDORE,JAIPUR,1492,1494,INDORE-JAIPUR,2986,All
2017,9,INDORE,JAIPUR,1268,1210,INDORE-JAIPUR,2478,All
2017,10,INDORE,JAIPUR,1344,1348,INDORE-JAIPUR,2692,All
2017,11,INDORE,JAIPUR,1428,1474,INDORE-JAIPUR,2902,All
2017,12,INDORE,JAIPUR,1506,1587,INDORE-JAIPUR,3093,All
2018,1,INDORE,JAIPUR,1415,1437,INDORE-JAIPUR,2852,All
2018,2,INDORE,JAIPUR,1426,1445,INDORE-JAIPUR,2871,All
2018,3,INDORE,JAIPUR,310,311,INDORE-JAIPUR,621,All
2018,4,INDORE,JAIPUR,1492,1357,INDORE-JAIPUR,2849,All
2018,5,INDORE,JAIPUR,1256,1349,INDORE-JAIPUR,2605,All
2018,6,INDORE,JAIPUR,1140,1218,INDORE-JAIPUR,2358,All
2018,7,INDORE,JAIPUR,1318,1234,INDORE-JAIPUR,2552,All
2018,8,INDORE,JAIPUR,1338,1342,INDORE-JAIPUR,2680,All
2018,9,INDORE,JAIPUR,1228,1193,INDORE-JAIPUR,2421,All
2018,10,INDORE,JAIPUR,1165,1175,INDORE-JAIPUR,2340,All
2018,11,INDORE,JAIPUR,1177,1084,INDORE-JAIPUR,2261,All
2018,12,INDORE,JAIPUR,1036,1067,INDORE-JAIPUR,2103,All
2019,1,INDORE,JAIPUR,1092,1063,INDORE-JAIPUR,2155,All
2019,2,INDORE,JAIPUR,983,951,INDORE-JAIPUR,1934,All
2019,3,INDORE,JAIPUR,920,933,INDORE-JAIPUR,1853,All
2019,4,INDORE,JAIPUR,282,218,INDORE-JAIPUR,500,All
2019,5,INDORE,JAIPUR,11,0,INDORE-JAIPUR,11,All
2019,12,INDORE,JAIPUR,7,0,INDORE-JAIPUR,7,All
2020,8,INDORE,JAIPUR,0,15,INDORE-JAIPUR,15,All
2020,9,INDORE,JAIPUR,726,734,INDORE-JAIPUR,1460,All
2020,10,INDORE,JAIPUR,830,868,INDORE-JAIPUR,1698,All
2020,12,INDORE,JAIPUR,833,972,INDORE-JAIPUR,1805,All
2021,1,INDORE,JAIPUR,1663,1663,INDORE-JAIPUR,3326,All
2021,2,INDORE,JAIPUR,1554,1555,INDORE-JAIPUR,3109,All
2021,3,INDORE,JAIPUR,1475,1516,INDORE-JAIPUR,2991,All
2021,7,INDORE,JAIPUR,3,0,INDORE-JAIPUR,3,All
2021,8,INDORE,JAIPUR,249,176,INDORE-JAIPUR,425,All
2021,9,INDORE,JAIPUR,1696,1464,INDORE-JAIPUR,3160,All
2021,10,INDORE,JAIPUR,1753,1591,INDORE-JAIPUR,3344,All
2021,11,INDORE,JAIPUR,2165,2154,INDORE-JAIPUR,4319,All
2021,12,INDORE,JAIPUR,2230,2211,INDORE-JAIPUR,4441,All
2022,1,INDORE,JAIPUR,1136,949,INDORE-JAIPUR,2085,All
2022,2,INDORE,JAIPUR,860,834,INDORE-JAIPUR,1694,All
2022,3,INDORE,JAIPUR,2150,2209,INDORE-JAIPUR,4359,All
2022,4,INDORE,JAIPUR,3268,3096,INDORE-JAIPUR,6364,All
2022,5,INDORE,JAIPUR,3317,3381,INDORE-JAIPUR,6698,All
2022,6,INDORE,JAIPUR,1988,1973,INDORE-JAIPUR,3961,All
2022,7,INDORE,JAIPUR,2174,2065,INDORE-JAIPUR,4239,All
2022,8,INDORE,JAIPUR,2279,2191,INDORE-JAIPUR,4470,All
2022,9,INDORE,JAIPUR,2159,2094,INDORE-JAIPUR,4253,All
2022,10,INDORE,JAIPUR,2130,2166,INDORE-JAIPUR,4296,All
2022,11,INDORE,JAIPUR,2133,2011,INDORE-JAIPUR,4144,All
2022,12,INDORE,JAIPUR,2306,2216,INDORE-JAIPUR,4522,All
2023,1,INDORE,JAIPUR,2126,1952,INDORE-JAIPUR,4078,All
2023,2,INDORE,JAIPUR,2032,1939,INDORE-JAIPUR,3971,All
2023,3,INDORE,JAIPUR,1979,1815,INDORE-JAIPUR,3794,All
2023,4,INDORE,JAIPUR,2011,1965,INDORE-JAIPUR,3976,All
2023,5,INDORE,JAIPUR,2139,2190,INDORE-JAIPUR,4329,All
2023,6,INDORE,JAIPUR,2232,2260,INDORE-JAIPUR,4492,All
2023,7,INDORE,JAIPUR,2463,2141,INDORE-JAIPUR,4604,All
2023,8,INDORE,JAIPUR,2341,2194,INDORE-JAIPUR,4535,All
2023,9,INDORE,JAIPUR,2503,2306,INDORE-JAIPUR,4809,All
2023,10,INDORE,JAIPUR,2561,2369,INDORE-JAIPUR,4930,All
2023,11,INDORE,JAIPUR,3703,3533,INDORE-JAIPUR,7236,All
2023,12,INDORE,JAIPUR,4637,4671,INDORE-JAIPUR,9308,All
2024,1,INDORE,JAIPUR,4533,4148,INDORE-JAIPUR,8681,All
2024,2,INDORE,JAIPUR,4147,3929,INDORE-JAIPUR,8076,All
2024,3,INDORE,JAIPUR,5100,4685,INDORE-JAIPUR,9785,All
2024,4,INDORE,JAIPUR,3947,3431,INDORE-JAIPUR,7378,All
2024,6,INDORE,JAIPUR,3387,3750,INDORE-JAIPUR,7137,All
2024,7,INDORE,JAIPUR,4039,3794,INDORE-JAIPUR,7833,All
2024,8,INDORE,JAIPUR,4357,3969,INDORE-JAIPUR,8326,All
2024,9,INDORE,JAIPUR,4245,3925,INDORE-JAIPUR,8170,All
2024,10,INDORE,JAIPUR,3900,3683,INDORE-JAIPUR,7583,All
2024,11,INDORE,JAIPUR,4568,4579,INDORE-JAIPUR,9147,All
2024,12,INDORE,JAIPUR,4780,4731,INDORE-JAIPUR,9511,All
2025,1,INDORE,JAIPUR,4870,4880,INDORE-JAIPUR,9750,All
2025,2,INDORE,JAIPUR,4555,4487,INDORE-JAIPUR,9042,All
2025,3,INDORE,JAIPUR,4458,4622,INDORE-JAIPUR,9080,All
2018,6,INDORE,JAMMU,73,0,INDORE-JAMMU,73,All
2018,7,INDORE,JAMMU,99,0,INDORE-JAMMU,99,All
2018,8,INDORE,JAMMU,156,0,INDORE-JAMMU,156,All
2022,3,INDORE,JAMMU,281,279,INDORE-JAMMU,560,All
2022,4,INDORE,JAMMU,2382,1944,INDORE-JAMMU,4326,All
2022,5,INDORE,JAMMU,2254,1825,INDORE-JAMMU,4079,All
2022,6,INDORE,JAMMU,1650,1632,INDORE-JAMMU,3282,All
2022,7,INDORE,JAMMU,1486,1463,INDORE-JAMMU,2949,All
2022,8,INDORE,JAMMU,1129,1060,INDORE-JAMMU,2189,All
2022,9,INDORE,JAMMU,746,596,INDORE-JAMMU,1342,All
2022,10,INDORE,JAMMU,1852,2043,INDORE-JAMMU,3895,All
2022,11,INDORE,JAMMU,1711,1852,INDORE-JAMMU,3563,All
2022,12,INDORE,JAMMU,1536,1484,INDORE-JAMMU,3020,All
2023,1,INDORE,JAMMU,1318,1583,INDORE-JAMMU,2901,All
2023,2,INDORE,JAMMU,1495,1192,INDORE-JAMMU,2687,All
2023,3,INDORE,JAMMU,1771,1740,INDORE-JAMMU,3511,All
2023,4,INDORE,JAMMU,1871,1934,INDORE-JAMMU,3805,All
2023,5,INDORE,JAMMU,2695,2339,INDORE-JAMMU,5034,All
2023,6,INDORE,JAMMU,2247,2069,INDORE-JAMMU,4316,All
2023,7,INDORE,JAMMU,2011,2152,INDORE-JAMMU,4163,All
2023,8,INDORE,JAMMU,2075,1848,INDORE-JAMMU,3923,All
2023,9,INDORE,JAMMU,2086,1711,INDORE-JAMMU,3797,All
2023,10,INDORE,JAMMU,1910,1889,INDORE-JAMMU,3799,All
2023,11,INDORE,JAMMU,1778,1663,INDORE-JAMMU,3441,All
2023,12,INDORE,JAMMU,1743,1445,INDORE-JAMMU,3188,All
2024,1,INDORE,JAMMU,2102,1852,INDORE-JAMMU,3954,All
2024,2,INDORE,JAMMU,1777,1596,INDORE-JAMMU,3373,All
2024,3,INDORE,JAMMU,2184,2179,INDORE-JAMMU,4363,All
2024,4,INDORE,JAMMU,2089,1730,INDORE-JAMMU,3819,All
2024,6,INDORE,JAMMU,2110,1848,INDORE-JAMMU,3958,All
2024,7,INDORE,JAMMU,2102,1885,INDORE-JAMMU,3987,All
2024,8,INDORE,JAMMU,2025,1340,INDORE-JAMMU,3365,All
2024,9,INDORE,JAMMU,1956,1509,INDORE-JAMMU,3465,All
2024,10,INDORE,JAMMU,1261,1393,INDORE-JAMMU,2654,All
2024,11,INDORE,JAMMU,865,718,INDORE-JAMMU,1583,All
2024,12,INDORE,JAMMU,828,746,INDORE-JAMMU,1574,All
2025,1,INDORE,JAMMU,856,896,INDORE-JAMMU,1752,All
2025,2,INDORE,JAMMU,2353,1921,INDORE-JAMMU,4274,All
2025,3,INDORE,JAMMU,1927,1988,INDORE-JAMMU,3915,All
2018,9,INDORE,JODHPUR,1300,1322,INDORE-JODHPUR,2622,All
2018,10,INDORE,JODHPUR,1792,1798,INDORE-JODHPUR,3590,All
2018,11,INDORE,JODHPUR,1707,1520,INDORE-JODHPUR,3227,All
2018,12,INDORE,JODHPUR,1760,1879,INDORE-JODHPUR,3639,All
2019,1,INDORE,JODHPUR,1737,1907,INDORE-JODHPUR,3644,All
2019,2,INDORE,JODHPUR,1340,1484,INDORE-JODHPUR,2824,All
2019,3,INDORE,JODHPUR,1293,1405,INDORE-JODHPUR,2698,All
2020,12,INDORE,JODHPUR,27,0,INDORE-JODHPUR,27,All
2021,10,INDORE,JODHPUR,28,28,INDORE-JODHPUR,56,All
2021,11,INDORE,JODHPUR,1713,1607,INDORE-JODHPUR,3320,All
2021,12,INDORE,JODHPUR,2151,2177,INDORE-JODHPUR,4328,All
2022,1,INDORE,JODHPUR,1178,1082,INDORE-JODHPUR,2260,All
2022,2,INDORE,JODHPUR,1083,953,INDORE-JODHPUR,2036,All
2022,3,INDORE,JODHPUR,828,779,INDORE-JODHPUR,1607,All
2022,9,INDORE,JODHPUR,1004,823,INDORE-JODHPUR,1827,All
2022,10,INDORE,JODHPUR,1638,1875,INDORE-JODHPUR,3513,All
2022,11,INDORE,JODHPUR,1708,1625,INDORE-JODHPUR,3333,All
2022,12,INDORE,JODHPUR,1855,1668,INDORE-JODHPUR,3523,All
2023,1,INDORE,JODHPUR,1667,1458,INDORE-JODHPUR,3125,All
2023,2,INDORE,JODHPUR,1707,1666,INDORE-JODHPUR,3373,All
2023,3,INDORE,JODHPUR,1712,1591,INDORE-JODHPUR,3303,All
2023,4,INDORE,JODHPUR,1846,1621,INDORE-JODHPUR,3467,All
2023,5,INDORE,JODHPUR,2138,2066,INDORE-JODHPUR,4204,All
2023,6,INDORE,JODHPUR,2044,1903,INDORE-JODHPUR,3947,All
2023,7,INDORE,JODHPUR,1762,1366,INDORE-JODHPUR,3128,All
2023,8,INDORE,JODHPUR,1948,1654,INDORE-JODHPUR,3602,All
2023,9,INDORE,JODHPUR,2096,1606,INDORE-JODHPUR,3702,All
2023,10,INDORE,JODHPUR,1808,1810,INDORE-JODHPUR,3618,All
2023,11,INDORE,JODHPUR,1741,1826,INDORE-JODHPUR,3567,All
2023,12,INDORE,JODHPUR,1990,2156,INDORE-JODHPUR,4146,All
2024,1,INDORE,JODHPUR,1953,1794,INDORE-JODHPUR,3747,All
2024,2,INDORE,JODHPUR,1861,1890,INDORE-JODHPUR,3751,All
2024,3,INDORE,JODHPUR,1849,1901,INDORE-JODHPUR,3750,All
2024,4,INDORE,JODHPUR,1760,1646,INDORE-JODHPUR,3406,All
2024,6,INDORE,JODHPUR,1735,1855,INDORE-JODHPUR,3590,All
2024,7,INDORE,JODHPUR,1878,1804,INDORE-JODHPUR,3682,All
2024,8,INDORE,JODHPUR,1961,1859,INDORE-JODHPUR,3820,All
2024,9,INDORE,JODHPUR,1746,1648,INDORE-JODHPUR,3394,All
2024,10,INDORE,JODHPUR,1956,1833,INDORE-JODHPUR,3789,All
2024,11,INDORE,JODHPUR,2055,2016,INDORE-JODHPUR,4071,All
2024,12,INDORE,JODHPUR,2024,2083,INDORE-JODHPUR,4107,All
2025,1,INDORE,JODHPUR,2201,2158,INDORE-JODHPUR,4359,All
2025,2,INDORE,JODHPUR,2006,1982,INDORE-JODHPUR,3988,All
2025,3,INDORE,JODHPUR,1803,1778,INDORE-JODHPUR,3581,All
2021,1,INDORE,KOCHI,384,261,INDORE-KOCHI,645,All
2021,2,INDORE,KOCHI,365,287,INDORE-KOCHI,652,All
2021,3,INDORE,KOCHI,252,184,INDORE-KOCHI,436,All
2021,4,INDORE,KOCHI,436,166,INDORE-KOCHI,602,All
2021,6,INDORE,KOCHI,107,224,INDORE-KOCHI,331,All
2021,7,INDORE,KOCHI,278,225,INDORE-KOCHI,503,All
2021,8,INDORE,KOCHI,256,192,INDORE-KOCHI,448,All
2021,9,INDORE,KOCHI,174,259,INDORE-KOCHI,433,All
2021,10,INDORE,KOCHI,283,156,INDORE-KOCHI,439,All
2019,5,INDORE,KOLKATA,7718,6673,INDORE-KOLKATA,14391,All
2019,6,INDORE,KOLKATA,7196,6483,INDORE-KOLKATA,13679,All
2019,7,INDORE,KOLKATA,7536,6787,INDORE-KOLKATA,14323,All
2019,8,INDORE,KOLKATA,6947,6093,INDORE-KOLKATA,13040,All
2019,9,INDORE,KOLKATA,6499,5633,INDORE-KOLKATA,12132,All
2019,10,INDORE,KOLKATA,6187,4916,INDORE-KOLKATA,11103,All
2019,11,INDORE,KOLKATA,5862,5368,INDORE-KOLKATA,11230,All
2019,12,INDORE,KOLKATA,8377,7115,INDORE-KOLKATA,15492,All
2020,1,INDORE,KOLKATA,10914,9468,INDORE-KOLKATA,20382,All
2020,2,INDORE,KOLKATA,6663,6352,INDORE-KOLKATA,13015,All
2020,3,INDORE,KOLKATA,4930,3841,INDORE-KOLKATA,8771,All
2020,7,INDORE,KOLKATA,371,174,INDORE-KOLKATA,545,All
2020,8,INDORE,KOLKATA,1513,2862,INDORE-KOLKATA,4375,All
2020,9,INDORE,KOLKATA,2074,4190,INDORE-KOLKATA,6264,All
2020,10,INDORE,KOLKATA,2848,4253,INDORE-KOLKATA,7101,All
2020,11,INDORE,KOLKATA,3920,3536,INDORE-KOLKATA,7456,All
2020,12,INDORE,KOLKATA,6657,3638,INDORE-KOLKATA,10295,All
2021,1,INDORE,KOLKATA,3572,3178,INDORE-KOLKATA,6750,All
2021,2,INDORE,KOLKATA,3723,3622,INDORE-KOLKATA,7345,All
2021,3,INDORE,KOLKATA,3047,3353,INDORE-KOLKATA,6400,All
2021,4,INDORE,KOLKATA,0,1251,INDORE-KOLKATA,1251,All
2021,7,INDORE,KOLKATA,1903,1957,INDORE-KOLKATA,3860,All
2021,8,INDORE,KOLKATA,1427,1166,INDORE-KOLKATA,2593,All
2021,9,INDORE,KOLKATA,1475,863,INDORE-KOLKATA,2338,All
2021,10,INDORE,KOLKATA,2269,1908,INDORE-KOLKATA,4177,All
2021,11,INDORE,KOLKATA,3395,3756,INDORE-KOLKATA,7151,All
2021,12,INDORE,KOLKATA,4010,3589,INDORE-KOLKATA,7599,All
2022,1,INDORE,KOLKATA,2990,2183,INDORE-KOLKATA,5173,All
2022,2,INDORE,KOLKATA,3472,2933,INDORE-KOLKATA,6405,All
2022,3,INDORE,KOLKATA,4336,3609,INDORE-KOLKATA,7945,All
2022,4,INDORE,KOLKATA,2946,2981,INDORE-KOLKATA,5927,All
2022,5,INDORE,KOLKATA,3512,3419,INDORE-KOLKATA,6931,All
2022,6,INDORE,KOLKATA,3405,3815,INDORE-KOLKATA,7220,All
2022,7,INDORE,KOLKATA,4013,3504,INDORE-KOLKATA,7517,All
2022,8,INDORE,KOLKATA,3756,3276,INDORE-KOLKATA,7032,All
2022,9,INDORE,KOLKATA,3481,3131,INDORE-KOLKATA,6612,All
2022,10,INDORE,KOLKATA,4579,3923,INDORE-KOLKATA,8502,All
2022,11,INDORE,KOLKATA,5032,4987,INDORE-KOLKATA,10019,All
2022,12,INDORE,KOLKATA,4794,4368,INDORE-KOLKATA,9162,All
2023,1,INDORE,KOLKATA,4507,4235,INDORE-KOLKATA,8742,All
2023,2,INDORE,KOLKATA,4221,4353,INDORE-KOLKATA,8574,All
2023,3,INDORE,KOLKATA,4565,4566,INDORE-KOLKATA,9131,All
2023,4,INDORE,KOLKATA,4763,4507,INDORE-KOLKATA,9270,All
2023,5,INDORE,KOLKATA,5132,5002,INDORE-KOLKATA,10134,All
2023,6,INDORE,KOLKATA,4110,3891,INDORE-KOLKATA,8001,All
2023,7,INDORE,KOLKATA,2134,2202,INDORE-KOLKATA,4336,All
2023,8,INDORE,KOLKATA,3345,3460,INDORE-KOLKATA,6805,All
2023,9,INDORE,KOLKATA,5051,4965,INDORE-KOLKATA,10016,All
2023,10,INDORE,KOLKATA,5266,4758,INDORE-KOLKATA,10024,All
2023,11,INDORE,KOLKATA,5229,4813,INDORE-KOLKATA,10042,All
2023,12,INDORE,KOLKATA,6006,5956,INDORE-KOLKATA,11962,All
2024,1,INDORE,KOLKATA,5945,5822,INDORE-KOLKATA,11767,All
2024,2,INDORE,KOLKATA,4974,4815,INDORE-KOLKATA,9789,All
2024,3,INDORE,KOLKATA,5421,5284,INDORE-KOLKATA,10705,All
2024,4,INDORE,KOLKATA,5297,5209,INDORE-KOLKATA,10506,All
2024,6,INDORE,KOLKATA,5143,5112,INDORE-KOLKATA,10255,All
2024,7,INDORE,KOLKATA,5044,5251,INDORE-KOLKATA,10295,All
2024,8,INDORE,KOLKATA,5905,6483,INDORE-KOLKATA,12388,All
2024,9,INDORE,KOLKATA,5872,6037,INDORE-KOLKATA,11909,All
2024,10,INDORE,KOLKATA,5098,4721,INDORE-KOLKATA,9819,All
2024,11,INDORE,KOLKATA,5068,5116,INDORE-KOLKATA,10184,All
2024,12,INDORE,KOLKATA,10390,10545,INDORE-KOLKATA,20935,All
2025,1,INDORE,KOLKATA,12121,13035,INDORE-KOLKATA,25156,All
2025,2,INDORE,KOLKATA,13059,13372,INDORE-KOLKATA,26431,All
2025,3,INDORE,KOLKATA,13400,13038,INDORE-KOLKATA,26438,All
2015,4,INDORE,LUCKNOW,418,298,INDORE-LUCKNOW,716,All
2015,5,INDORE,LUCKNOW,601,328,INDORE-LUCKNOW,929,All
2015,6,INDORE,LUCKNOW,247,165,INDORE-LUCKNOW,412,All
2015,7,INDORE,LUCKNOW,116,150,INDORE-LUCKNOW,266,All
2015,8,INDORE,LUCKNOW,132,192,INDORE-LUCKNOW,324,All
2015,9,INDORE,LUCKNOW,92,192,INDORE-LUCKNOW,284,All
2015,10,INDORE,LUCKNOW,103,321,INDORE-LUCKNOW,424,All
2015,11,INDORE,LUCKNOW,169,247,INDORE-LUCKNOW,416,All
2015,12,INDORE,LUCKNOW,99,215,INDORE-LUCKNOW,314,All
2016,1,INDORE,LUCKNOW,0,269,INDORE-LUCKNOW,269,All
2016,2,INDORE,LUCKNOW,186,425,INDORE-LUCKNOW,611,All
2016,3,INDORE,LUCKNOW,414,465,INDORE-LUCKNOW,879,All
2016,4,INDORE,LUCKNOW,196,145,INDORE-LUCKNOW,341,All
2017,7,INDORE,LUCKNOW,121,119,INDORE-LUCKNOW,240,All
2017,8,INDORE,LUCKNOW,358,362,INDORE-LUCKNOW,720,All
2017,9,INDORE,LUCKNOW,368,266,INDORE-LUCKNOW,634,All
2017,10,INDORE,LUCKNOW,173,168,INDORE-LUCKNOW,341,All
2017,11,INDORE,LUCKNOW,336,462,INDORE-LUCKNOW,798,All
2017,12,INDORE,LUCKNOW,283,581,INDORE-LUCKNOW,864,All
2018,1,INDORE,LUCKNOW,470,558,INDORE-LUCKNOW,1028,All
2018,2,INDORE,LUCKNOW,414,566,INDORE-LUCKNOW,980,All
2018,3,INDORE,LUCKNOW,41,289,INDORE-LUCKNOW,330,All
2018,4,INDORE,LUCKNOW,365,560,INDORE-LUCKNOW,925,All
2018,5,INDORE,LUCKNOW,288,748,INDORE-LUCKNOW,1036,All
2018,6,INDORE,LUCKNOW,380,1138,INDORE-LUCKNOW,1518,All
2018,7,INDORE,LUCKNOW,760,1199,INDORE-LUCKNOW,1959,All
2018,8,INDORE,LUCKNOW,928,1226,INDORE-LUCKNOW,2154,All
2018,9,INDORE,LUCKNOW,1830,1918,INDORE-LUCKNOW,3748,All
2018,10,INDORE,LUCKNOW,1918,1944,INDORE-LUCKNOW,3862,All
2018,11,INDORE,LUCKNOW,1985,2070,INDORE-LUCKNOW,4055,All
2018,12,INDORE,LUCKNOW,1900,2429,INDORE-LUCKNOW,4329,All
2019,1,INDORE,LUCKNOW,1941,2047,INDORE-LUCKNOW,3988,All
2019,2,INDORE,LUCKNOW,1873,2132,INDORE-LUCKNOW,4005,All
2019,3,INDORE,LUCKNOW,1959,2132,INDORE-LUCKNOW,4091,All
2019,4,INDORE,LUCKNOW,654,892,INDORE-LUCKNOW,1546,All
2019,5,INDORE,LUCKNOW,0,530,INDORE-LUCKNOW,530,All
2019,6,INDORE,LUCKNOW,0,535,INDORE-LUCKNOW,535,All
2019,7,INDORE,LUCKNOW,0,381,INDORE-LUCKNOW,381,All
2019,8,INDORE,LUCKNOW,0,501,INDORE-LUCKNOW,501,All
2019,9,INDORE,LUCKNOW,0,257,INDORE-LUCKNOW,257,All
2019,10,INDORE,LUCKNOW,0,356,INDORE-LUCKNOW,356,All
2020,9,INDORE,LUCKNOW,1112,1231,INDORE-LUCKNOW,2343,All
2020,10,INDORE,LUCKNOW,855,992,INDORE-LUCKNOW,1847,All
2021,2,INDORE,LUCKNOW,1074,1021,INDORE-LUCKNOW,2095,All
2021,3,INDORE,LUCKNOW,901,849,INDORE-LUCKNOW,1750,All
2021,9,INDORE,LUCKNOW,1073,933,INDORE-LUCKNOW,2006,All
2021,10,INDORE,LUCKNOW,1733,1781,INDORE-LUCKNOW,3514,All
2021,11,INDORE,LUCKNOW,2121,2047,INDORE-LUCKNOW,4168,All
2021,12,INDORE,LUCKNOW,2042,2305,INDORE-LUCKNOW,4347,All
2022,1,INDORE,LUCKNOW,1033,1024,INDORE-LUCKNOW,2057,All
2022,2,INDORE,LUCKNOW,1163,1161,INDORE-LUCKNOW,2324,All
2022,3,INDORE,LUCKNOW,2058,2105,INDORE-LUCKNOW,4163,All
2022,4,INDORE,LUCKNOW,2116,2225,INDORE-LUCKNOW,4341,All
2022,5,INDORE,LUCKNOW,2238,2321,INDORE-LUCKNOW,4559,All
2022,6,INDORE,LUCKNOW,2004,2203,INDORE-LUCKNOW,4207,All
2022,7,INDORE,LUCKNOW,1605,2206,INDORE-LUCKNOW,3811,All
2022,8,INDORE,LUCKNOW,1677,2087,INDORE-LUCKNOW,3764,All
2022,9,INDORE,LUCKNOW,1618,1971,INDORE-LUCKNOW,3589,All
2022,10,INDORE,LUCKNOW,2134,2024,INDORE-LUCKNOW,4158,All
2022,11,INDORE,LUCKNOW,2180,2146,INDORE-LUCKNOW,4326,All
2022,12,INDORE,LUCKNOW,1896,2095,INDORE-LUCKNOW,3991,All
2023,1,INDORE,LUCKNOW,1817,1861,INDORE-LUCKNOW,3678,All
2023,2,INDORE,LUCKNOW,1918,1855,INDORE-LUCKNOW,3773,All
2023,3,INDORE,LUCKNOW,2034,2169,INDORE-LUCKNOW,4203,All
2023,4,INDORE,LUCKNOW,3945,3529,INDORE-LUCKNOW,7474,All
2023,5,INDORE,LUCKNOW,4377,4132,INDORE-LUCKNOW,8509,All
2023,6,INDORE,LUCKNOW,3996,4198,INDORE-LUCKNOW,8194,All
2023,7,INDORE,LUCKNOW,3420,3351,INDORE-LUCKNOW,6771,All
2023,8,INDORE,LUCKNOW,3776,3452,INDORE-LUCKNOW,7228,All
2023,9,INDORE,LUCKNOW,4066,3902,INDORE-LUCKNOW,7968,All
2023,10,INDORE,LUCKNOW,4216,3770,INDORE-LUCKNOW,7986,All
2023,11,INDORE,LUCKNOW,3905,3439,INDORE-LUCKNOW,7344,All
2023,12,INDORE,LUCKNOW,3870,3947,INDORE-LUCKNOW,7817,All
2024,1,INDORE,LUCKNOW,3845,3421,INDORE-LUCKNOW,7266,All
2024,2,INDORE,LUCKNOW,4067,3922,INDORE-LUCKNOW,7989,All
2024,3,INDORE,LUCKNOW,4178,3848,INDORE-LUCKNOW,8026,All
2024,4,INDORE,LUCKNOW,4047,3787,INDORE-LUCKNOW,7834,All
2024,6,INDORE,LUCKNOW,3780,4063,INDORE-LUCKNOW,7843,All
2024,7,INDORE,LUCKNOW,3911,3951,INDORE-LUCKNOW,7862,All
2024,8,INDORE,LUCKNOW,3814,3787,INDORE-LUCKNOW,7601,All
2024,9,INDORE,LUCKNOW,3658,3416,INDORE-LUCKNOW,7074,All
2024,10,INDORE,LUCKNOW,3873,3195,INDORE-LUCKNOW,7068,All
2024,11,INDORE,LUCKNOW,4148,3832,INDORE-LUCKNOW,7980,All
2024,12,INDORE,LUCKNOW,3932,4302,INDORE-LUCKNOW,8234,All
2025,1,INDORE,LUCKNOW,4064,4193,INDORE-LUCKNOW,8257,All
2025,2,INDORE,LUCKNOW,3881,3683,INDORE-LUCKNOW,7564,All
2025,3,INDORE,LUCKNOW,3974,3749,INDORE-LUCKNOW,7723,All
2023,1,INDORE,MADURAI,0,2,INDORE-MADURAI,2,All
2019,5,INDORE,MUMBAI,28906,28323,INDORE-MUMBAI,57229,All
2019,6,INDORE,MUMBAI,31867,32097,INDORE-MUMBAI,63964,All
2019,7,INDORE,MUMBAI,31596,30172,INDORE-MUMBAI,61768,All
2019,8,INDORE,MUMBAI,32448,31157,INDORE-MUMBAI,63605,All
2019,9,INDORE,MUMBAI,32204,30724,INDORE-MUMBAI,62928,All
2019,10,INDORE,MUMBAI,28955,34045,INDORE-MUMBAI,63000,All
2019,11,INDORE,MUMBAI,26554,26356,INDORE-MUMBAI,52910,All
2019,12,INDORE,MUMBAI,27231,27479,INDORE-MUMBAI,54710,All
2020,1,INDORE,MUMBAI,26767,26915,INDORE-MUMBAI,53682,All
2020,2,INDORE,MUMBAI,25148,25491,INDORE-MUMBAI,50639,All
2020,3,INDORE,MUMBAI,13541,16218,INDORE-MUMBAI,29759,All
2020,5,INDORE,MUMBAI,0,93,INDORE-MUMBAI,93,All
2020,6,INDORE,MUMBAI,0,0,INDORE-MUMBAI,0,All
2020,7,INDORE,MUMBAI,556,661,INDORE-MUMBAI,1217,All
2020,8,INDORE,MUMBAI,1738,1519,INDORE-MUMBAI,3257,All
2020,9,INDORE,MUMBAI,4605,3141,INDORE-MUMBAI,7746,All
2020,10,INDORE,MUMBAI,7533,6594,INDORE-MUMBAI,14127,All
2020,11,INDORE,MUMBAI,9613,11365,INDORE-MUMBAI,20978,All
2020,12,INDORE,MUMBAI,12270,14919,INDORE-MUMBAI,27189,All
2021,1,INDORE,MUMBAI,13939,14241,INDORE-MUMBAI,28180,All
2021,2,INDORE,MUMBAI,14931,15242,INDORE-MUMBAI,30173,All
2021,3,INDORE,MUMBAI,11807,11581,INDORE-MUMBAI,23388,All
2021,4,INDORE,MUMBAI,4203,5020,INDORE-MUMBAI,9223,All
2021,6,INDORE,MUMBAI,5859,4321,INDORE-MUMBAI,10180,All
2021,7,INDORE,MUMBAI,11395,9016,INDORE-MUMBAI,20411,All
2021,8,INDORE,MUMBAI,15870,15654,INDORE-MUMBAI,31524,All
2021,9,INDORE,MUMBAI,15290,13465,INDORE-MUMBAI,28755,All
2021,10,INDORE,MUMBAI,16738,17642,INDORE-MUMBAI,34380,All
2021,11,INDORE,MUMBAI,20736,20408,INDORE-MUMBAI,41144,All
2021,12,INDORE,MUMBAI,21825,21413,INDORE-MUMBAI,43238,All
2022,1,INDORE,MUMBAI,11339,11170,INDORE-MUMBAI,22509,All
2022,2,INDORE,MUMBAI,14359,15087,INDORE-MUMBAI,29446,All
2022,3,INDORE,MUMBAI,22736,21822,INDORE-MUMBAI,44558,All
2022,4,INDORE,MUMBAI,21588,22677,INDORE-MUMBAI,44265,All
2022,5,INDORE,MUMBAI,22442,22832,INDORE-MUMBAI,45274,All
2022,6,INDORE,MUMBAI,22596,22399,INDORE-MUMBAI,44995,All
2022,7,INDORE,MUMBAI,23233,22736,INDORE-MUMBAI,45969,All
2022,8,INDORE,MUMBAI,24679,23355,INDORE-MUMBAI,48034,All
2022,9,INDORE,MUMBAI,24386,23458,INDORE-MUMBAI,47844,All
2022,10,INDORE,MUMBAI,20108,22965,INDORE-MUMBAI,43073,All
2022,11,INDORE,MUMBAI,25637,24513,INDORE-MUMBAI,50150,All
2022,12,INDORE,MUMBAI,25960,26173,INDORE-MUMBAI,52133,All
2023,11,INDORE,MUMBAI,25078,25231,INDORE-MUMBAI,50309,All
2023,12,INDORE,MUMBAI,32374,29184,INDORE-MUMBAI,61558,All
2024,1,INDORE,MUMBAI,30827,29056,INDORE-MUMBAI,59883,All
2024,2,INDORE,MUMBAI,29159,28332,INDORE-MUMBAI,57491,All
2024,3,INDORE,MUMBAI,29301,27992,INDORE-MUMBAI,57293,All
2024,4,INDORE,MUMBAI,27284,28843,INDORE-MUMBAI,56127,All
2024,6,INDORE,MUMBAI,27873,29174,INDORE-MUMBAI,57047,All
2024,7,INDORE,MUMBAI,28309,28081,INDORE-MUMBAI,56390,All
2024,8,INDORE,MUMBAI,29997,28606,INDORE-MUMBAI,58603,All
2024,9,INDORE,MUMBAI,28667,29537,INDORE-MUMBAI,58204,All
2024,10,INDORE,MUMBAI,26885,32870,INDORE-MUMBAI,59755,All
2024,11,INDORE,MUMBAI,34141,30831,INDORE-MUMBAI,64972,All
2024,12,INDORE,MUMBAI,33798,33488,INDORE-MUMBAI,67286,All
2025,1,INDORE,MUMBAI,31823,32660,INDORE-MUMBAI,64483,All
2025,2,INDORE,MUMBAI,29133,30415,INDORE-MUMBAI,59548,All
2025,3,INDORE,MUMBAI,30524,30862,INDORE-MUMBAI,61386,All
2015,4,INDORE,NAGPUR,1106,1049,INDORE-NAGPUR,2155,All
2015,5,INDORE,NAGPUR,1409,1368,INDORE-NAGPUR,2777,All
2015,6,INDORE,NAGPUR,1322,1355,INDORE-NAGPUR,2677,All
2015,7,INDORE,NAGPUR,1495,1478,INDORE-NAGPUR,2973,All
2015,8,INDORE,NAGPUR,1395,1379,INDORE-NAGPUR,2774,All
2015,9,INDORE,NAGPUR,1221,1179,INDORE-NAGPUR,2400,All
2015,10,INDORE,NAGPUR,1330,1278,INDORE-NAGPUR,2608,All
2015,11,INDORE,NAGPUR,1695,1738,INDORE-NAGPUR,3433,All
2015,12,INDORE,NAGPUR,1980,1991,INDORE-NAGPUR,3971,All
2016,1,INDORE,NAGPUR,1741,1742,INDORE-NAGPUR,3483,All
2016,2,INDORE,NAGPUR,1468,1427,INDORE-NAGPUR,2895,All
2016,3,INDORE,NAGPUR,1156,1230,INDORE-NAGPUR,2386,All
2016,4,INDORE,NAGPUR,1469,1289,INDORE-NAGPUR,2758,All
2016,5,INDORE,NAGPUR,1739,1439,INDORE-NAGPUR,3178,All
2016,6,INDORE,NAGPUR,1337,1017,INDORE-NAGPUR,2354,All
2016,7,INDORE,NAGPUR,1434,1376,INDORE-NAGPUR,2810,All
2016,8,INDORE,NAGPUR,1729,1436,INDORE-NAGPUR,3165,All
2016,9,INDORE,NAGPUR,1544,1363,INDORE-NAGPUR,2907,All
2016,10,INDORE,NAGPUR,1981,1604,INDORE-NAGPUR,3585,All
2016,11,INDORE,NAGPUR,2488,2187,INDORE-NAGPUR,4675,All
2016,12,INDORE,NAGPUR,2942,3024,INDORE-NAGPUR,5966,All
2017,1,INDORE,NAGPUR,2712,2352,INDORE-NAGPUR,5064,All
2017,2,INDORE,NAGPUR,2587,2074,INDORE-NAGPUR,4661,All
2017,3,INDORE,NAGPUR,2509,1720,INDORE-NAGPUR,4229,All
2017,4,INDORE,NAGPUR,2403,1934,INDORE-NAGPUR,4337,All
2017,5,INDORE,NAGPUR,2057,2164,INDORE-NAGPUR,4221,All
2017,6,INDORE,NAGPUR,2618,2217,INDORE-NAGPUR,4835,All
2017,7,INDORE,NAGPUR,2472,1708,INDORE-NAGPUR,4180,All
2017,8,INDORE,NAGPUR,2628,1983,INDORE-NAGPUR,4611,All
2017,9,INDORE,NAGPUR,2302,1841,INDORE-NAGPUR,4143,All
2017,10,INDORE,NAGPUR,2947,2505,INDORE-NAGPUR,5452,All
2017,11,INDORE,NAGPUR,2694,2948,INDORE-NAGPUR,5642,All
2017,12,INDORE,NAGPUR,2984,2639,INDORE-NAGPUR,5623,All
2018,1,INDORE,NAGPUR,2231,1740,INDORE-NAGPUR,3971,All
2018,2,INDORE,NAGPUR,2533,2282,INDORE-NAGPUR,4815,All
2018,3,INDORE,NAGPUR,2670,2176,INDORE-NAGPUR,4846,All
2018,4,INDORE,NAGPUR,2666,2489,INDORE-NAGPUR,5155,All
2018,5,INDORE,NAGPUR,2597,2325,INDORE-NAGPUR,4922,All
2018,6,INDORE,NAGPUR,2867,2158,INDORE-NAGPUR,5025,All
2018,7,INDORE,NAGPUR,3454,2974,INDORE-NAGPUR,6428,All
2018,8,INDORE,NAGPUR,3591,3323,INDORE-NAGPUR,6914,All
2018,9,INDORE,NAGPUR,5417,4690,INDORE-NAGPUR,10107,All
2018,10,INDORE,NAGPUR,4249,3751,INDORE-NAGPUR,8000,All
2018,11,INDORE,NAGPUR,5435,5042,INDORE-NAGPUR,10477,All
2018,12,INDORE,NAGPUR,4914,4328,INDORE-NAGPUR,9242,All
2019,1,INDORE,NAGPUR,4727,4528,INDORE-NAGPUR,9255,All
2019,2,INDORE,NAGPUR,6242,5500,INDORE-NAGPUR,11742,All
2019,3,INDORE,NAGPUR,7666,5756,INDORE-NAGPUR,13422,All
2019,4,INDORE,NAGPUR,3673,2753,INDORE-NAGPUR,6426,All
2019,5,INDORE,NAGPUR,3789,3613,INDORE-NAGPUR,7402,All
2019,6,INDORE,NAGPUR,3663,3403,INDORE-NAGPUR,7066,All
2019,7,INDORE,NAGPUR,3697,3283,INDORE-NAGPUR,6980,All
2019,8,INDORE,NAGPUR,3861,3482,INDORE-NAGPUR,7343,All
2019,9,INDORE,NAGPUR,3680,3288,INDORE-NAGPUR,6968,All
2019,10,INDORE,NAGPUR,2749,2376,INDORE-NAGPUR,5125,All
2019,11,INDORE,NAGPUR,4159,4514,INDORE-NAGPUR,8673,All
2019,12,INDORE,NAGPUR,4392,4776,INDORE-NAGPUR,9168,All
2020,1,INDORE,NAGPUR,4529,4603,INDORE-NAGPUR,9132,All
2020,2,INDORE,NAGPUR,4073,4060,INDORE-NAGPUR,8133,All
2020,3,INDORE,NAGPUR,2187,2302,INDORE-NAGPUR,4489,All
2020,8,INDORE,NAGPUR,0,140,INDORE-NAGPUR,140,All
2020,9,INDORE,NAGPUR,567,636,INDORE-NAGPUR,1203,All
2020,10,INDORE,NAGPUR,721,800,INDORE-NAGPUR,1521,All
2020,12,INDORE,NAGPUR,1008,789,INDORE-NAGPUR,1797,All
2021,1,INDORE,NAGPUR,1718,1671,INDORE-NAGPUR,3389,All
2021,2,INDORE,NAGPUR,1591,1613,INDORE-NAGPUR,3204,All
2021,3,INDORE,NAGPUR,1001,985,INDORE-NAGPUR,1986,All
2021,4,INDORE,NAGPUR,263,333,INDORE-NAGPUR,596,All
2021,8,INDORE,NAGPUR,340,302,INDORE-NAGPUR,642,All
2021,9,INDORE,NAGPUR,1416,1537,INDORE-NAGPUR,2953,All
2021,10,INDORE,NAGPUR,2068,2069,INDORE-NAGPUR,4137,All
2021,11,INDORE,NAGPUR,2042,2117,INDORE-NAGPUR,4159,All
2021,12,INDORE,NAGPUR,1982,1948,INDORE-NAGPUR,3930,All
2022,1,INDORE,NAGPUR,939,984,INDORE-NAGPUR,1923,All
2022,2,INDORE,NAGPUR,927,978,INDORE-NAGPUR,1905,All
2022,3,INDORE,NAGPUR,1779,1808,INDORE-NAGPUR,3587,All
2022,4,INDORE,NAGPUR,1735,1795,INDORE-NAGPUR,3530,All
2022,5,INDORE,NAGPUR,1975,1895,INDORE-NAGPUR,3870,All
2022,6,INDORE,NAGPUR,1742,1837,INDORE-NAGPUR,3579,All
2022,7,INDORE,NAGPUR,1691,1809,INDORE-NAGPUR,3500,All
2022,8,INDORE,NAGPUR,2060,2023,INDORE-NAGPUR,4083,All
2022,9,INDORE,NAGPUR,1768,2021,INDORE-NAGPUR,3789,All
2022,10,INDORE,NAGPUR,2093,2188,INDORE-NAGPUR,4281,All
2022,11,INDORE,NAGPUR,2353,2498,INDORE-NAGPUR,4851,All
2022,12,INDORE,NAGPUR,2305,2272,INDORE-NAGPUR,4577,All
2023,1,INDORE,NAGPUR,2246,2211,INDORE-NAGPUR,4457,All
2023,2,INDORE,NAGPUR,2160,1948,INDORE-NAGPUR,4108,All
2023,3,INDORE,NAGPUR,2330,2143,INDORE-NAGPUR,4473,All
2023,4,INDORE,NAGPUR,3130,3521,INDORE-NAGPUR,6651,All
2023,5,INDORE,NAGPUR,3892,4052,INDORE-NAGPUR,7944,All
2023,6,INDORE,NAGPUR,1919,2002,INDORE-NAGPUR,3921,All
2023,7,INDORE,NAGPUR,2032,1990,INDORE-NAGPUR,4022,All
2023,8,INDORE,NAGPUR,1937,2095,INDORE-NAGPUR,4032,All
2023,9,INDORE,NAGPUR,1863,2021,INDORE-NAGPUR,3884,All
2023,10,INDORE,NAGPUR,1891,2058,INDORE-NAGPUR,3949,All
2023,11,INDORE,NAGPUR,3633,3161,INDORE-NAGPUR,6794,All
2023,12,INDORE,NAGPUR,4188,4272,INDORE-NAGPUR,8460,All
2024,1,INDORE,NAGPUR,3601,4201,INDORE-NAGPUR,7802,All
2024,2,INDORE,NAGPUR,3757,3726,INDORE-NAGPUR,7483,All
2024,3,INDORE,NAGPUR,3629,3628,INDORE-NAGPUR,7257,All
2024,4,INDORE,NAGPUR,2985,3656,INDORE-NAGPUR,6641,All
2024,6,INDORE,NAGPUR,3942,3824,INDORE-NAGPUR,7766,All
2024,7,INDORE,NAGPUR,3755,3863,INDORE-NAGPUR,7618,All
2024,8,INDORE,NAGPUR,4080,3928,INDORE-NAGPUR,8008,All
2024,9,INDORE,NAGPUR,3662,3731,INDORE-NAGPUR,7393,All
2024,10,INDORE,NAGPUR,3953,3781,INDORE-NAGPUR,7734,All
2024,11,INDORE,NAGPUR,3359,3310,INDORE-NAGPUR,6669,All
2024,12,INDORE,NAGPUR,3563,3440,INDORE-NAGPUR,7003,All
2025,1,INDORE,NAGPUR,3370,3297,INDORE-NAGPUR,6667,All
2025,2,INDORE,NAGPUR,2973,2995,INDORE-NAGPUR,5968,All
2025,3,INDORE,NAGPUR,3113,2980,INDORE-NAGPUR,6093,All
2023,6,INDORE,NASIK,1558,1191,INDORE-NASIK,2749,All
2023,7,INDORE,NASIK,1188,1294,INDORE-NASIK,2482,All
2023,8,INDORE,NASIK,1466,1544,INDORE-NASIK,3010,All
2023,9,INDORE,NASIK,1489,1477,INDORE-NASIK,2966,All
2023,10,INDORE,NASIK,1407,1551,INDORE-NASIK,2958,All
2023,11,INDORE,NASIK,1164,1221,INDORE-NASIK,2385,All
2023,12,INDORE,NASIK,1975,1606,INDORE-NASIK,3581,All
2024,1,INDORE,NASIK,2069,1773,INDORE-NASIK,3842,All
2024,2,INDORE,NASIK,1835,1901,INDORE-NASIK,3736,All
2024,3,INDORE,NASIK,1803,1881,INDORE-NASIK,3684,All
2024,4,INDORE,NASIK,446,491,INDORE-NASIK,937,All
2024,6,INDORE,NASIK,723,547,INDORE-NASIK,1270,All
2024,7,INDORE,NASIK,666,642,INDORE-NASIK,1308,All
2024,8,INDORE,NASIK,905,726,INDORE-NASIK,1631,All
2024,9,INDORE,NASIK,579,466,INDORE-NASIK,1045,All
2024,10,INDORE,NASIK,426,678,INDORE-NASIK,1104,All
2024,11,INDORE,NASIK,766,705,INDORE-NASIK,1471,All
2024,12,INDORE,NASIK,567,583,INDORE-NASIK,1150,All
2025,1,INDORE,NASIK,446,594,INDORE-NASIK,1040,All
2025,2,INDORE,NASIK,632,634,INDORE-NASIK,1266,All
2025,3,INDORE,NASIK,627,624,INDORE-NASIK,1251,All
2018,1,INDORE,PATNA,7,0,INDORE-PATNA,7,All
2018,2,INDORE,PATNA,45,0,INDORE-PATNA,45,All
2018,3,INDORE,PATNA,97,0,INDORE-PATNA,97,All
2018,4,INDORE,PATNA,134,0,INDORE-PATNA,134,All
2018,5,INDORE,PATNA,62,0,INDORE-PATNA,62,All
2018,6,INDORE,PATNA,172,0,INDORE-PATNA,172,All
2018,7,INDORE,PATNA,50,0,INDORE-PATNA,50,All
2018,8,INDORE,PATNA,13,0,INDORE-PATNA,13,All
2018,9,INDORE,PATNA,5,0,INDORE-PATNA,5,All
2018,11,INDORE,PATNA,7,1,INDORE-PATNA,8,All
2018,12,INDORE,PATNA,1,0,INDORE-PATNA,1,All
2020,12,INDORE,PATNA,3891,0,INDORE-PATNA,3891,All
2024,3,INDORE,PATNA,0,2,INDORE-PATNA,2,All
2018,9,INDORE,PORT BLAIR,0,17,INDORE-PORT BLAIR,17,All
2018,10,INDORE,PORT BLAIR,0,76,INDORE-PORT BLAIR,76,All
2015,4,INDORE,PUNE,2653,3669,INDORE-PUNE,6322,All
2015,5,INDORE,PUNE,3644,3520,INDORE-PUNE,7164,All
2015,6,INDORE,PUNE,3239,3177,INDORE-PUNE,6416,All
2015,7,INDORE,PUNE,3335,3496,INDORE-PUNE,6831,All
2015,8,INDORE,PUNE,3670,3849,INDORE-PUNE,7519,All
2015,9,INDORE,PUNE,3471,3612,INDORE-PUNE,7083,All
2015,10,INDORE,PUNE,2856,3051,INDORE-PUNE,5907,All
2015,11,INDORE,PUNE,2997,3401,INDORE-PUNE,6398,All
2015,12,INDORE,PUNE,3488,3289,INDORE-PUNE,6777,All
2016,1,INDORE,PUNE,2927,2878,INDORE-PUNE,5805,All
2016,2,INDORE,PUNE,2775,2817,INDORE-PUNE,5592,All
2016,3,INDORE,PUNE,3064,3260,INDORE-PUNE,6324,All
2016,4,INDORE,PUNE,2474,2829,INDORE-PUNE,5303,All
2016,5,INDORE,PUNE,2834,2777,INDORE-PUNE,5611,All
2016,6,INDORE,PUNE,2602,2738,INDORE-PUNE,5340,All
2016,7,INDORE,PUNE,2848,3080,INDORE-PUNE,5928,All
2016,8,INDORE,PUNE,2845,3256,INDORE-PUNE,6101,All
2016,9,INDORE,PUNE,2347,2728,INDORE-PUNE,5075,All
2016,10,INDORE,PUNE,2246,3120,INDORE-PUNE,5366,All
2016,11,INDORE,PUNE,3517,3263,INDORE-PUNE,6780,All
2016,12,INDORE,PUNE,3824,3799,INDORE-PUNE,7623,All
2017,1,INDORE,PUNE,4190,4292,INDORE-PUNE,8482,All
2017,2,INDORE,PUNE,3719,4200,INDORE-PUNE,7919,All
2017,3,INDORE,PUNE,3793,4334,INDORE-PUNE,8127,All
2017,4,INDORE,PUNE,3578,4517,INDORE-PUNE,8095,All
2017,5,INDORE,PUNE,4315,4567,INDORE-PUNE,8882,All
2017,6,INDORE,PUNE,4131,4619,INDORE-PUNE,8750,All
2017,7,INDORE,PUNE,3794,4356,INDORE-PUNE,8150,All
2017,8,INDORE,PUNE,3734,4176,INDORE-PUNE,7910,All
2017,9,INDORE,PUNE,3083,3445,INDORE-PUNE,6528,All
2017,10,INDORE,PUNE,3384,3682,INDORE-PUNE,7066,All
2017,11,INDORE,PUNE,3426,3683,INDORE-PUNE,7109,All
2017,12,INDORE,PUNE,4105,4126,INDORE-PUNE,8231,All
2018,1,INDORE,PUNE,3856,3857,INDORE-PUNE,7713,All
2018,2,INDORE,PUNE,3040,3210,INDORE-PUNE,6250,All
2018,3,INDORE,PUNE,3293,3551,INDORE-PUNE,6844,All
2018,4,INDORE,PUNE,2933,3487,INDORE-PUNE,6420,All
2018,5,INDORE,PUNE,3607,3539,INDORE-PUNE,7146,All
2018,6,INDORE,PUNE,3146,3366,INDORE-PUNE,6512,All
2018,7,INDORE,PUNE,3188,3392,INDORE-PUNE,6580,All
2018,8,INDORE,PUNE,3280,3611,INDORE-PUNE,6891,All
2018,9,INDORE,PUNE,3083,3444,INDORE-PUNE,6527,All
2018,10,INDORE,PUNE,3082,3490,INDORE-PUNE,6572,All
2018,11,INDORE,PUNE,3457,3700,INDORE-PUNE,7157,All
2018,12,INDORE,PUNE,3447,3480,INDORE-PUNE,6927,All
2019,1,INDORE,PUNE,3581,3505,INDORE-PUNE,7086,All
2019,2,INDORE,PUNE,2859,3037,INDORE-PUNE,5896,All
2019,3,INDORE,PUNE,830,627,INDORE-PUNE,1457,All
2019,4,INDORE,PUNE,1577,1569,INDORE-PUNE,3146,All
2019,5,INDORE,PUNE,930,1193,INDORE-PUNE,2123,All
2019,6,INDORE,PUNE,424,455,INDORE-PUNE,879,All
2019,7,INDORE,PUNE,662,832,INDORE-PUNE,1494,All
2019,8,INDORE,PUNE,688,833,INDORE-PUNE,1521,All
2019,9,INDORE,PUNE,589,747,INDORE-PUNE,1336,All
2019,10,INDORE,PUNE,560,640,INDORE-PUNE,1200,All
2019,11,INDORE,PUNE,355,475,INDORE-PUNE,830,All
2019,12,INDORE,PUNE,752,816,INDORE-PUNE,1568,All
2020,1,INDORE,PUNE,630,877,INDORE-PUNE,1507,All
2020,2,INDORE,PUNE,641,849,INDORE-PUNE,1490,All
2020,3,INDORE,PUNE,395,836,INDORE-PUNE,1231,All
2020,6,INDORE,PUNE,0,23,INDORE-PUNE,23,All
2020,7,INDORE,PUNE,108,0,INDORE-PUNE,108,All
2020,8,INDORE,PUNE,261,0,INDORE-PUNE,261,All
2020,9,INDORE,PUNE,193,22,INDORE-PUNE,215,All
2020,10,INDORE,PUNE,141,40,INDORE-PUNE,181,All
2020,11,INDORE,PUNE,13,0,INDORE-PUNE,13,All
2021,3,INDORE,PUNE,229,244,INDORE-PUNE,473,All
2021,4,INDORE,PUNE,761,766,INDORE-PUNE,1527,All
2021,7,INDORE,PUNE,477,500,INDORE-PUNE,977,All
2021,8,INDORE,PUNE,2122,2170,INDORE-PUNE,4292,All
2021,9,INDORE,PUNE,3103,2925,INDORE-PUNE,6028,All
2021,10,INDORE,PUNE,1856,1994,INDORE-PUNE,3850,All
2021,11,INDORE,PUNE,4361,4471,INDORE-PUNE,8832,All
2021,12,INDORE,PUNE,4541,3977,INDORE-PUNE,8518,All
2022,1,INDORE,PUNE,2182,2711,INDORE-PUNE,4893,All
2022,2,INDORE,PUNE,3135,3331,INDORE-PUNE,6466,All
2022,3,INDORE,PUNE,5279,5414,INDORE-PUNE,10693,All
2022,4,INDORE,PUNE,3824,3812,INDORE-PUNE,7636,All
2022,5,INDORE,PUNE,4293,4285,INDORE-PUNE,8578,All
2022,6,INDORE,PUNE,3975,4106,INDORE-PUNE,8081,All
2022,7,INDORE,PUNE,4134,4045,INDORE-PUNE,8179,All
2022,8,INDORE,PUNE,4505,4609,INDORE-PUNE,9114,All
2022,9,INDORE,PUNE,3929,3160,INDORE-PUNE,7089,All
2022,10,INDORE,PUNE,4351,4317,INDORE-PUNE,8668,All
2022,11,INDORE,PUNE,6332,4854,INDORE-PUNE,11186,All
2022,12,INDORE,PUNE,5958,5308,INDORE-PUNE,11266,All
2023,1,INDORE,PUNE,5122,4448,INDORE-PUNE,9570,All
2023,2,INDORE,PUNE,6144,5744,INDORE-PUNE,11888,All
2023,3,INDORE,PUNE,6358,6239,INDORE-PUNE,12597,All
2023,4,INDORE,PUNE,5062,4749,INDORE-PUNE,9811,All
2023,5,INDORE,PUNE,5262,5071,INDORE-PUNE,10333,All
2023,6,INDORE,PUNE,5104,4939,INDORE-PUNE,10043,All
2023,7,INDORE,PUNE,5065,4983,INDORE-PUNE,10048,All
2023,8,INDORE,PUNE,5081,4866,INDORE-PUNE,9947,All
2023,9,INDORE,PUNE,5251,4916,INDORE-PUNE,10167,All
2023,10,INDORE,PUNE,4949,4575,INDORE-PUNE,9524,All
2023,11,INDORE,PUNE,4553,4688,INDORE-PUNE,9241,All
2023,12,INDORE,PUNE,5296,5004,INDORE-PUNE,10300,All
2024,1,INDORE,PUNE,5142,4893,INDORE-PUNE,10035,All
2024,2,INDORE,PUNE,5069,4743,INDORE-PUNE,9812,All
2024,3,INDORE,PUNE,5412,5024,INDORE-PUNE,10436,All
2024,4,INDORE,PUNE,5185,5023,INDORE-PUNE,10208,All
2024,6,INDORE,PUNE,5262,5039,INDORE-PUNE,10301,All
2024,7,INDORE,PUNE,5037,4853,INDORE-PUNE,9890,All
2024,8,INDORE,PUNE,5280,4820,INDORE-PUNE,10100,All
2024,9,INDORE,PUNE,5152,4580,INDORE-PUNE,9732,All
2024,10,INDORE,PUNE,4803,5504,INDORE-PUNE,10307,All
2024,11,INDORE,PUNE,8689,7673,INDORE-PUNE,16362,All
2024,12,INDORE,PUNE,8934,8423,INDORE-PUNE,17357,All
2025,1,INDORE,PUNE,9382,8920,INDORE-PUNE,18302,All
2025,2,INDORE,PUNE,8076,8059,INDORE-PUNE,16135,All
2025,3,INDORE,PUNE,8565,7873,INDORE-PUNE,16438,All
2015,4,INDORE,RAIPUR,2310,2287,INDORE-RAIPUR,4597,All
2015,5,INDORE,RAIPUR,2960,2719,INDORE-RAIPUR,5679,All
2015,6,INDORE,RAIPUR,3297,2828,INDORE-RAIPUR,6125,All
2015,7,INDORE,RAIPUR,3018,2809,INDORE-RAIPUR,5827,All
2015,8,INDORE,RAIPUR,2799,2646,INDORE-RAIPUR,5445,All
2015,9,INDORE,RAIPUR,2613,2422,INDORE-RAIPUR,5035,All
2015,10,INDORE,RAIPUR,2671,2404,INDORE-RAIPUR,5075,All
2015,11,INDORE,RAIPUR,2398,2285,INDORE-RAIPUR,4683,All
2015,12,INDORE,RAIPUR,2612,2432,INDORE-RAIPUR,5044,All
2016,1,INDORE,RAIPUR,2673,2590,INDORE-RAIPUR,5263,All
2016,2,INDORE,RAIPUR,2423,2167,INDORE-RAIPUR,4590,All
2016,3,INDORE,RAIPUR,1851,1700,INDORE-RAIPUR,3551,All
2016,4,INDORE,RAIPUR,2086,2062,INDORE-RAIPUR,4148,All
2016,5,INDORE,RAIPUR,2575,2426,INDORE-RAIPUR,5001,All
2016,6,INDORE,RAIPUR,1888,1775,INDORE-RAIPUR,3663,All
2016,7,INDORE,RAIPUR,1884,1784,INDORE-RAIPUR,3668,All
2016,8,INDORE,RAIPUR,1818,1653,INDORE-RAIPUR,3471,All
2016,9,INDORE,RAIPUR,1629,1568,INDORE-RAIPUR,3197,All
2016,10,INDORE,RAIPUR,2481,2390,INDORE-RAIPUR,4871,All
2016,11,INDORE,RAIPUR,3052,2931,INDORE-RAIPUR,5983,All
2016,12,INDORE,RAIPUR,4886,5111,INDORE-RAIPUR,9997,All
2017,1,INDORE,RAIPUR,5109,5012,INDORE-RAIPUR,10121,All
2017,2,INDORE,RAIPUR,4672,4339,INDORE-RAIPUR,9011,All
2017,3,INDORE,RAIPUR,4094,3597,INDORE-RAIPUR,7691,All
2017,4,INDORE,RAIPUR,5537,4635,INDORE-RAIPUR,10172,All
2017,5,INDORE,RAIPUR,7049,6042,INDORE-RAIPUR,13091,All
2017,6,INDORE,RAIPUR,6181,5315,INDORE-RAIPUR,11496,All
2017,7,INDORE,RAIPUR,4285,3914,INDORE-RAIPUR,8199,All
2017,8,INDORE,RAIPUR,4345,4222,INDORE-RAIPUR,8567,All
2017,9,INDORE,RAIPUR,4017,3564,INDORE-RAIPUR,7581,All
2017,10,INDORE,RAIPUR,4779,4393,INDORE-RAIPUR,9172,All
2017,11,INDORE,RAIPUR,4264,4659,INDORE-RAIPUR,8923,All
2017,12,INDORE,RAIPUR,4898,4537,INDORE-RAIPUR,9435,All
2018,1,INDORE,RAIPUR,4147,4048,INDORE-RAIPUR,8195,All
2018,2,INDORE,RAIPUR,4977,4994,INDORE-RAIPUR,9971,All
2018,3,INDORE,RAIPUR,4085,4214,INDORE-RAIPUR,8299,All
2018,4,INDORE,RAIPUR,4970,5055,INDORE-RAIPUR,10025,All
2018,5,INDORE,RAIPUR,5256,5622,INDORE-RAIPUR,10878,All
2018,6,INDORE,RAIPUR,4571,5186,INDORE-RAIPUR,9757,All
2018,7,INDORE,RAIPUR,4106,4955,INDORE-RAIPUR,9061,All
2018,8,INDORE,RAIPUR,4213,4092,INDORE-RAIPUR,8305,All
2018,9,INDORE,RAIPUR,3758,3631,INDORE-RAIPUR,7389,All
2018,10,INDORE,RAIPUR,3622,3358,INDORE-RAIPUR,6980,All
2018,11,INDORE,RAIPUR,3115,3217,INDORE-RAIPUR,6332,All
2018,12,INDORE,RAIPUR,5277,5229,INDORE-RAIPUR,10506,All
2019,1,INDORE,RAIPUR,6042,6260,INDORE-RAIPUR,12302,All
2019,2,INDORE,RAIPUR,5702,6292,INDORE-RAIPUR,11994,All
2019,3,INDORE,RAIPUR,4649,5933,INDORE-RAIPUR,10582,All
2019,4,INDORE,RAIPUR,5144,5165,INDORE-RAIPUR,10309,All
2019,5,INDORE,RAIPUR,5743,6188,INDORE-RAIPUR,11931,All
2019,6,INDORE,RAIPUR,5859,6371,INDORE-RAIPUR,12230,All
2019,7,INDORE,RAIPUR,5151,5573,INDORE-RAIPUR,10724,All
2019,8,INDORE,RAIPUR,5670,5646,INDORE-RAIPUR,11316,All
2019,9,INDORE,RAIPUR,5096,5414,INDORE-RAIPUR,10510,All
2019,10,INDORE,RAIPUR,5437,5325,INDORE-RAIPUR,10762,All
2019,11,INDORE,RAIPUR,6618,7025,INDORE-RAIPUR,13643,All
2019,12,INDORE,RAIPUR,6404,6473,INDORE-RAIPUR,12877,All
2020,1,INDORE,RAIPUR,6542,7362,INDORE-RAIPUR,13904,All
2020,2,INDORE,RAIPUR,6599,7353,INDORE-RAIPUR,13952,All
2020,3,INDORE,RAIPUR,3692,3690,INDORE-RAIPUR,7382,All
2020,8,INDORE,RAIPUR,287,332,INDORE-RAIPUR,619,All
2020,9,INDORE,RAIPUR,1118,1164,INDORE-RAIPUR,2282,All
2020,10,INDORE,RAIPUR,1678,1810,INDORE-RAIPUR,3488,All
2020,11,INDORE,RAIPUR,1828,1893,INDORE-RAIPUR,3721,All
2020,12,INDORE,RAIPUR,2915,2792,INDORE-RAIPUR,5707,All
2021,1,INDORE,RAIPUR,3887,3945,INDORE-RAIPUR,7832,All
2021,2,INDORE,RAIPUR,3805,4596,INDORE-RAIPUR,8401,All
2021,3,INDORE,RAIPUR,3945,3781,INDORE-RAIPUR,7726,All
2021,4,INDORE,RAIPUR,2428,1528,INDORE-RAIPUR,3956,All
2021,7,INDORE,RAIPUR,780,895,INDORE-RAIPUR,1675,All
2021,8,INDORE,RAIPUR,3961,4140,INDORE-RAIPUR,8101,All
2021,9,INDORE,RAIPUR,3415,3395,INDORE-RAIPUR,6810,All
2021,10,INDORE,RAIPUR,3946,3886,INDORE-RAIPUR,7832,All
2021,11,INDORE,RAIPUR,5760,5910,INDORE-RAIPUR,11670,All
2021,12,INDORE,RAIPUR,5629,5613,INDORE-RAIPUR,11242,All
2022,1,INDORE,RAIPUR,3128,3157,INDORE-RAIPUR,6285,All
2022,2,INDORE,RAIPUR,3189,3302,INDORE-RAIPUR,6491,All
2022,3,INDORE,RAIPUR,4515,4820,INDORE-RAIPUR,9335,All
2022,4,INDORE,RAIPUR,5186,4664,INDORE-RAIPUR,9850,All
2022,5,INDORE,RAIPUR,4145,4077,INDORE-RAIPUR,8222,All
2022,6,INDORE,RAIPUR,3519,3245,INDORE-RAIPUR,6764,All
2022,7,INDORE,RAIPUR,3536,2933,INDORE-RAIPUR,6469,All
2022,8,INDORE,RAIPUR,3858,3368,INDORE-RAIPUR,7226,All
2022,9,INDORE,RAIPUR,3396,2699,INDORE-RAIPUR,6095,All
2022,10,INDORE,RAIPUR,4929,4679,INDORE-RAIPUR,9608,All
2022,11,INDORE,RAIPUR,5761,5581,INDORE-RAIPUR,11342,All
2022,12,INDORE,RAIPUR,5320,4955,INDORE-RAIPUR,10275,All
2023,1,INDORE,RAIPUR,6023,5759,INDORE-RAIPUR,11782,All
2023,2,INDORE,RAIPUR,5541,5385,INDORE-RAIPUR,10926,All
2023,3,INDORE,RAIPUR,5600,5398,INDORE-RAIPUR,10998,All
2023,4,INDORE,RAIPUR,5801,5954,INDORE-RAIPUR,11755,All
2023,5,INDORE,RAIPUR,6072,6105,INDORE-RAIPUR,12177,All
2023,6,INDORE,RAIPUR,6041,6332,INDORE-RAIPUR,12373,All
2023,7,INDORE,RAIPUR,5783,6226,INDORE-RAIPUR,12009,All
2023,8,INDORE,RAIPUR,6414,6468,INDORE-RAIPUR,12882,All
2023,9,INDORE,RAIPUR,5749,5889,INDORE-RAIPUR,11638,All
2023,10,INDORE,RAIPUR,6020,5798,INDORE-RAIPUR,11818,All
2023,11,INDORE,RAIPUR,4207,4027,INDORE-RAIPUR,8234,All
2023,12,INDORE,RAIPUR,4223,4268,INDORE-RAIPUR,8491,All
2024,1,INDORE,RAIPUR,3900,4021,INDORE-RAIPUR,7921,All
2024,2,INDORE,RAIPUR,3955,4026,INDORE-RAIPUR,7981,All
2024,3,INDORE,RAIPUR,4395,4438,INDORE-RAIPUR,8833,All
2024,4,INDORE,RAIPUR,4419,4267,INDORE-RAIPUR,8686,All
2024,6,INDORE,RAIPUR,4629,4298,INDORE-RAIPUR,8927,All
2024,7,INDORE,RAIPUR,4303,4121,INDORE-RAIPUR,8424,All
2024,8,INDORE,RAIPUR,4346,4174,INDORE-RAIPUR,8520,All
2024,9,INDORE,RAIPUR,4163,3820,INDORE-RAIPUR,7983,All
2024,10,INDORE,RAIPUR,3297,3106,INDORE-RAIPUR,6403,All
2024,11,INDORE,RAIPUR,2914,3565,INDORE-RAIPUR,6479,All
2024,12,INDORE,RAIPUR,2754,3434,INDORE-RAIPUR,6188,All
2025,1,INDORE,RAIPUR,3133,3853,INDORE-RAIPUR,6986,All
2025,2,INDORE,RAIPUR,3719,3721,INDORE-RAIPUR,7440,All
2025,3,INDORE,RAIPUR,4234,4339,INDORE-RAIPUR,8573,All
2023,8,INDORE,RAJKOT,462,470,INDORE-RAJKOT,932,All
2023,9,INDORE,RAJKOT,395,441,INDORE-RAJKOT,836,All
2016,12,INDORE,RANCHI,0,4,INDORE-RANCHI,4,All
2017,1,INDORE,RANCHI,0,18,INDORE-RANCHI,18,All
2017,2,INDORE,RANCHI,0,10,INDORE-RANCHI,10,All
2017,3,INDORE,RANCHI,0,9,INDORE-RANCHI,9,All
2017,4,INDORE,RANCHI,0,3,INDORE-RANCHI,3,All
2017,5,INDORE,RANCHI,16,17,INDORE-RANCHI,33,All
2017,6,INDORE,RANCHI,47,70,INDORE-RANCHI,117,All
2017,7,INDORE,RANCHI,101,187,INDORE-RANCHI,288,All
2017,8,INDORE,RANCHI,188,271,INDORE-RANCHI,459,All
2017,9,INDORE,RANCHI,197,294,INDORE-RANCHI,491,All
2017,10,INDORE,RANCHI,334,281,INDORE-RANCHI,615,All
2017,11,INDORE,RANCHI,535,477,INDORE-RANCHI,1012,All
2017,12,INDORE,RANCHI,588,663,INDORE-RANCHI,1251,All
2018,1,INDORE,RANCHI,577,585,INDORE-RANCHI,1162,All
2018,2,INDORE,RANCHI,379,342,INDORE-RANCHI,721,All
2018,3,INDORE,RANCHI,343,389,INDORE-RANCHI,732,All
2018,4,INDORE,RANCHI,400,407,INDORE-RANCHI,807,All
2018,5,INDORE,RANCHI,397,301,INDORE-RANCHI,698,All
2018,6,INDORE,RANCHI,305,264,INDORE-RANCHI,569,All
2018,7,INDORE,RANCHI,369,361,INDORE-RANCHI,730,All
2018,8,INDORE,RANCHI,408,356,INDORE-RANCHI,764,All
2018,9,INDORE,RANCHI,287,238,INDORE-RANCHI,525,All
2018,10,INDORE,RANCHI,513,348,INDORE-RANCHI,861,All
2018,11,INDORE,RANCHI,197,271,INDORE-RANCHI,468,All
2018,12,INDORE,RANCHI,367,263,INDORE-RANCHI,630,All
2019,1,INDORE,RANCHI,341,282,INDORE-RANCHI,623,All
2019,2,INDORE,RANCHI,292,322,INDORE-RANCHI,614,All
2019,3,INDORE,RANCHI,438,401,INDORE-RANCHI,839,All
2019,4,INDORE,RANCHI,405,334,INDORE-RANCHI,739,All
2019,5,INDORE,RANCHI,623,457,INDORE-RANCHI,1080,All
2019,6,INDORE,RANCHI,558,595,INDORE-RANCHI,1153,All
2019,7,INDORE,RANCHI,437,450,INDORE-RANCHI,887,All
2019,8,INDORE,RANCHI,389,405,INDORE-RANCHI,794,All
2019,9,INDORE,RANCHI,207,222,INDORE-RANCHI,429,All
2019,10,INDORE,RANCHI,468,429,INDORE-RANCHI,897,All
2019,11,INDORE,RANCHI,390,494,INDORE-RANCHI,884,All
2019,12,INDORE,RANCHI,535,635,INDORE-RANCHI,1170,All
2020,1,INDORE,RANCHI,378,389,INDORE-RANCHI,767,All
2020,2,INDORE,RANCHI,413,384,INDORE-RANCHI,797,All
2020,3,INDORE,RANCHI,251,271,INDORE-RANCHI,522,All
2023,9,INDORE,RANCHI,0,36,INDORE-RANCHI,36,All
2023,11,INDORE,Rajkot International Airport,1443,1640,INDORE-Rajkot International Airport,3083,All
2023,12,INDORE,Rajkot International Airport,1875,1728,INDORE-Rajkot International Airport,3603,All
2024,1,INDORE,Rajkot International Airport,1830,1782,INDORE-Rajkot International Airport,3612,All
2024,2,INDORE,Rajkot International Airport,1676,1751,INDORE-Rajkot International Airport,3427,All
2024,3,INDORE,Rajkot International Airport,1697,1699,INDORE-Rajkot International Airport,3396,All
2019,10,INDORE,SHIRDI,114,93,INDORE-SHIRDI,207,All
2019,11,INDORE,SHIRDI,547,265,INDORE-SHIRDI,812,All
2020,2,INDORE,SHIRDI,679,297,INDORE-SHIRDI,976,All
2020,3,INDORE,SHIRDI,852,396,INDORE-SHIRDI,1248,All
2021,2,INDORE,SHIRDI,415,234,INDORE-SHIRDI,649,All
2021,3,INDORE,SHIRDI,159,136,INDORE-SHIRDI,295,All
2023,3,INDORE,SHIRDI,248,195,INDORE-SHIRDI,443,All
2023,4,INDORE,SHIRDI,1561,1320,INDORE-SHIRDI,2881,All
2023,5,INDORE,SHIRDI,1677,1346,INDORE-SHIRDI,3023,All
2023,6,INDORE,SHIRDI,1757,1210,INDORE-SHIRDI,2967,All
2023,7,INDORE,SHIRDI,1381,1147,INDORE-SHIRDI,2528,All
2023,8,INDORE,SHIRDI,1349,1045,INDORE-SHIRDI,2394,All
2023,9,INDORE,SHIRDI,1415,1125,INDORE-SHIRDI,2540,All
2023,10,INDORE,SHIRDI,1155,1138,INDORE-SHIRDI,2293,All
2023,11,INDORE,SHIRDI,1504,1471,INDORE-SHIRDI,2975,All
2023,12,INDORE,SHIRDI,1930,1585,INDORE-SHIRDI,3515,All
2024,1,INDORE,SHIRDI,1723,1653,INDORE-SHIRDI,3376,All
2024,2,INDORE,SHIRDI,1437,1493,INDORE-SHIRDI,2930,All
2024,3,INDORE,SHIRDI,1400,1221,INDORE-SHIRDI,2621,All
2024,4,INDORE,SHIRDI,964,1056,INDORE-SHIRDI,2020,All
2024,6,INDORE,SHIRDI,1622,1371,INDORE-SHIRDI,2993,All
2024,7,INDORE,SHIRDI,1322,1231,INDORE-SHIRDI,2553,All
2024,8,INDORE,SHIRDI,1376,1376,INDORE-SHIRDI,2752,All
2024,9,INDORE,SHIRDI,1331,1296,INDORE-SHIRDI,2627,All
2024,10,INDORE,SHIRDI,1243,1501,INDORE-SHIRDI,2744,All
2024,11,INDORE,SHIRDI,1789,1284,INDORE-SHIRDI,3073,All
2024,12,INDORE,SHIRDI,1993,1577,INDORE-SHIRDI,3570,All
2025,1,INDORE,SHIRDI,1810,1338,INDORE-SHIRDI,3148,All
2025,2,INDORE,SHIRDI,1512,1440,INDORE-SHIRDI,2952,All
2025,3,INDORE,SHIRDI,1510,1467,INDORE-SHIRDI,2977,All
2015,4,INDORE,SRINAGAR,232,182,INDORE-SRINAGAR,414,All
2015,5,INDORE,SRINAGAR,267,265,INDORE-SRINAGAR,532,All
2015,6,INDORE,SRINAGAR,337,326,INDORE-SRINAGAR,663,All
2015,7,INDORE,SRINAGAR,453,469,INDORE-SRINAGAR,922,All
2015,8,INDORE,SRINAGAR,266,262,INDORE-SRINAGAR,528,All
2015,9,INDORE,SRINAGAR,218,168,INDORE-SRINAGAR,386,All
2015,10,INDORE,SRINAGAR,178,271,INDORE-SRINAGAR,449,All
2015,11,INDORE,SRINAGAR,184,170,INDORE-SRINAGAR,354,All
2015,12,INDORE,SRINAGAR,221,236,INDORE-SRINAGAR,457,All
2016,1,INDORE,SRINAGAR,160,277,INDORE-SRINAGAR,437,All
2016,2,INDORE,SRINAGAR,196,172,INDORE-SRINAGAR,368,All
2016,3,INDORE,SRINAGAR,568,489,INDORE-SRINAGAR,1057,All
2016,4,INDORE,SRINAGAR,258,221,INDORE-SRINAGAR,479,All
2016,5,INDORE,SRINAGAR,126,96,INDORE-SRINAGAR,222,All
2016,6,INDORE,SRINAGAR,89,50,INDORE-SRINAGAR,139,All
2016,7,INDORE,SRINAGAR,27,23,INDORE-SRINAGAR,50,All
2016,8,INDORE,SRINAGAR,1,2,INDORE-SRINAGAR,3,All
2021,10,INDORE,SURAT,10,78,INDORE-SURAT,88,All
2021,11,INDORE,SURAT,1221,1491,INDORE-SURAT,2712,All
2021,12,INDORE,SURAT,1491,1758,INDORE-SURAT,3249,All
2022,1,INDORE,SURAT,506,643,INDORE-SURAT,1149,All
2022,2,INDORE,SURAT,623,876,INDORE-SURAT,1499,All
2022,3,INDORE,SURAT,481,730,INDORE-SURAT,1211,All
2023,8,INDORE,SURAT,603,661,INDORE-SURAT,1264,All
2023,9,INDORE,SURAT,1957,1919,INDORE-SURAT,3876,All
2023,10,INDORE,SURAT,1615,1617,INDORE-SURAT,3232,All
2023,11,INDORE,SURAT,1722,1634,INDORE-SURAT,3356,All
2023,12,INDORE,SURAT,2166,1686,INDORE-SURAT,3852,All
2024,1,INDORE,SURAT,2140,1974,INDORE-SURAT,4114,All
2024,2,INDORE,SURAT,2015,1756,INDORE-SURAT,3771,All
2024,3,INDORE,SURAT,2046,1644,INDORE-SURAT,3690,All
2024,4,INDORE,SURAT,1492,1319,INDORE-SURAT,2811,All
2024,6,INDORE,SURAT,2125,1905,INDORE-SURAT,4030,All
2024,7,INDORE,SURAT,2061,1557,INDORE-SURAT,3618,All
2024,8,INDORE,SURAT,2036,1940,INDORE-SURAT,3976,All
2024,9,INDORE,SURAT,1904,1795,INDORE-SURAT,3699,All
2024,10,INDORE,SURAT,1442,1432,INDORE-SURAT,2874,All
2023,10,INDORE,TIRUPATI,5,0,INDORE-TIRUPATI,5,All
2024,10,INDORE,TIRUPATI,2,0,INDORE-TIRUPATI,2,All
2024,11,INDORE,TIRUPATI,16,0,INDORE-TIRUPATI,16,All
2021,3,INDORE,TRIVANDRUM,12,4,INDORE-TRIVANDRUM,16,All
2021,4,INDORE,TRIVANDRUM,110,28,INDORE-TRIVANDRUM,138,All
2021,7,INDORE,TRIVANDRUM,0,10,INDORE-TRIVANDRUM,10,All
2021,12,INDORE,TRIVANDRUM,2,4,INDORE-TRIVANDRUM,6,All
2022,1,INDORE,TRIVANDRUM,3,3,INDORE-TRIVANDRUM,6,All
2023,1,INDORE,TRIVANDRUM,32,15,INDORE-TRIVANDRUM,47,All
2020,10,INDORE,UDAIPUR,1,0,INDORE-UDAIPUR,1,All
2020,11,INDORE,UDAIPUR,0,1,INDORE-UDAIPUR,1,All
2022,4,INDORE,UDAIPUR,149,0,INDORE-UDAIPUR,149,All
2023,3,INDORE,UDAIPUR,256,342,INDORE-UDAIPUR,598,All
2023,4,INDORE,UDAIPUR,1572,1713,INDORE-UDAIPUR,3285,All
2023,5,INDORE,UDAIPUR,1739,1917,INDORE-UDAIPUR,3656,All
2023,6,INDORE,UDAIPUR,1607,1737,INDORE-UDAIPUR,3344,All
2023,7,INDORE,UDAIPUR,1676,1693,INDORE-UDAIPUR,3369,All
2023,8,INDORE,UDAIPUR,1557,1625,INDORE-UDAIPUR,3182,All
2023,9,INDORE,UDAIPUR,1650,1550,INDORE-UDAIPUR,3200,All
2023,10,INDORE,UDAIPUR,1604,1233,INDORE-UDAIPUR,2837,All
2023,11,INDORE,UDAIPUR,1586,1551,INDORE-UDAIPUR,3137,All
2023,12,INDORE,UDAIPUR,1532,1540,INDORE-UDAIPUR,3072,All
2024,1,INDORE,UDAIPUR,1631,1544,INDORE-UDAIPUR,3175,All
2024,2,INDORE,UDAIPUR,1656,1771,INDORE-UDAIPUR,3427,All
2024,3,INDORE,UDAIPUR,1516,1412,INDORE-UDAIPUR,2928,All
2024,4,INDORE,UDAIPUR,943,665,INDORE-UDAIPUR,1608,All
2024,6,INDORE,UDAIPUR,993,798,INDORE-UDAIPUR,1791,All
2024,7,INDORE,UDAIPUR,1203,797,INDORE-UDAIPUR,2000,All
2024,8,INDORE,UDAIPUR,1079,743,INDORE-UDAIPUR,1822,All
2024,9,INDORE,UDAIPUR,982,755,INDORE-UDAIPUR,1737,All
2024,10,INDORE,UDAIPUR,944,853,INDORE-UDAIPUR,1797,All
2024,11,INDORE,UDAIPUR,1046,995,INDORE-UDAIPUR,2041,All
2024,12,INDORE,UDAIPUR,1272,1238,INDORE-UDAIPUR,2510,All
2025,1,INDORE,UDAIPUR,1207,1161,INDORE-UDAIPUR,2368,All
2025,2,INDORE,UDAIPUR,1198,1179,INDORE-UDAIPUR,2377,All
2025,3,INDORE,UDAIPUR,1281,1245,INDORE-UDAIPUR,2526,All
2020,9,INDORE,VADODARA,3,0,INDORE-VADODARA,3,All
2024,8,INDORE,VADODARA,150,0,INDORE-VADODARA,150,All
2020,9,INDORE,VARANASI,0,180,INDORE-VARANASI,180,All
2024,1,INDORE,VARANASI,0,52,INDORE-VARANASI,52,All
2024,3,INDORE,VARANASI,59,66,INDORE-VARANASI,125,All
2024,4,INDORE,VARANASI,1950,1330,INDORE-VARANASI,3280,All
2024,6,INDORE,VARANASI,1723,1639,INDORE-VARANASI,3362,All
2024,7,INDORE,VARANASI,1832,1439,INDORE-VARANASI,3271,All
2024,8,INDORE,VARANASI,1723,1477,INDORE-VARANASI,3200,All
2024,9,INDORE,VARANASI,1886,1703,INDORE-VARANASI,3589,All
2024,10,INDORE,VARANASI,1807,1522,INDORE-VARANASI,3329,All
2023,10,INDORE,VIDYANAGAR,66,67,INDORE-VIDYANAGAR,133,All
2023,9,INDORE,VIJAYAWADA,33,10,INDORE-VIJAYAWADA,43,All
2023,10,INDORE,VIJAYAWADA,88,68,INDORE-VIJAYAWADA,156,All
2024,10,INDORE,VIJAYAWADA,12,24,INDORE-VIJAYAWADA,36,All
2024,11,INDORE,VIJAYAWADA,101,148,INDORE-VIJAYAWADA,249,All
2024,12,INDORE,VIJAYAWADA,94,103,INDORE-VIJAYAWADA,197,All
2025,3,INDORE,VIJAYAWADA,87,75,INDORE-VIJAYAWADA,162,All
2018,3,INDORE,VISAKHAPATNAM,0,26,INDORE-VISAKHAPATNAM,26,All
2018,4,INDORE,VISAKHAPATNAM,0,16,INDORE-VISAKHAPATNAM,16,All
2018,10,INDORE,VISAKHAPATNAM,0,11,INDORE-VISAKHAPATNAM,11,All
2019,2,INDORE,VISAKHAPATNAM,0,18,INDORE-VISAKHAPATNAM,18,All
2019,3,INDORE,VISAKHAPATNAM,0,67,INDORE-VISAKHAPATNAM,67,All
2025,3,INDORE,VISAKHAPATNAM,1,5,INDORE-VISAKHAPATNAM,6,All
2022,11,ITANAGAR,DIBRUGARH,1,3,DIBRUGARH-ITANAGAR,4,All
2022,11,ITANAGAR,KOLKATA,164,239,ITANAGAR-KOLKATA,403,All
2022,11,ITANAGAR,MUMBAI,10,17,ITANAGAR-MUMBAI,27,All
2022,11,ITANAGAR,PASIGHAT,7,0,ITANAGAR-PASIGHAT,7,All
2022,11,ITANAGAR,ZIRO,3,5,ITANAGAR-ZIRO,8,All
2025,2,Itanagar,JORHAT,0,8,Itanagar-JORHAT,8,All
2023,1,Itanagar,KOLKATA,3175,3523,Itanagar-KOLKATA,6698,All
2023,6,Itanagar,KOLKATA,3590,3746,Itanagar-KOLKATA,7336,All
2023,7,Itanagar,KOLKATA,3848,4084,Itanagar-KOLKATA,7932,All
2023,8,Itanagar,KOLKATA,3400,3634,Itanagar-KOLKATA,7034,All
2023,9,Itanagar,KOLKATA,2983,3474,Itanagar-KOLKATA,6457,All
2023,10,Itanagar,KOLKATA,3928,3925,Itanagar-KOLKATA,7853,All
2023,11,Itanagar,KOLKATA,3598,3805,Itanagar-KOLKATA,7403,All
2023,12,Itanagar,KOLKATA,3450,4219,Itanagar-KOLKATA,7669,All
2024,1,Itanagar,KOLKATA,4037,3853,Itanagar-KOLKATA,7890,All
2024,2,Itanagar,KOLKATA,3100,3353,Itanagar-KOLKATA,6453,All
2024,3,Itanagar,KOLKATA,3546,3773,Itanagar-KOLKATA,7319,All
2024,4,Itanagar,KOLKATA,3560,3979,Itanagar-KOLKATA,7539,All
2024,6,Itanagar,KOLKATA,3919,3931,Itanagar-KOLKATA,7850,All
2024,7,Itanagar,KOLKATA,4110,3837,Itanagar-KOLKATA,7947,All
2024,8,Itanagar,KOLKATA,3968,4146,Itanagar-KOLKATA,8114,All
2024,9,Itanagar,KOLKATA,4111,4648,Itanagar-KOLKATA,8759,All
2024,10,Itanagar,KOLKATA,4956,4919,Itanagar-KOLKATA,9875,All
2024,11,Itanagar,KOLKATA,3781,4143,Itanagar-KOLKATA,7924,All
2024,12,Itanagar,KOLKATA,3875,4605,Itanagar-KOLKATA,8480,All
2025,1,Itanagar,KOLKATA,4095,4189,Itanagar-KOLKATA,8284,All
2025,2,Itanagar,KOLKATA,2855,3346,Itanagar-KOLKATA,6201,All
2025,3,Itanagar,KOLKATA,3428,3895,Itanagar-KOLKATA,7323,All
2023,1,Itanagar,PASIGHAT,15,20,Itanagar-PASIGHAT,35,All
2023,6,Itanagar,PASIGHAT,0,4,Itanagar-PASIGHAT,4,All
2023,7,Itanagar,PASIGHAT,2,1,Itanagar-PASIGHAT,3,All
2023,8,Itanagar,PASIGHAT,2,2,Itanagar-PASIGHAT,4,All
2023,9,Itanagar,PASIGHAT,18,18,Itanagar-PASIGHAT,36,All
2023,10,Itanagar,PASIGHAT,40,22,Itanagar-PASIGHAT,62,All
2023,11,Itanagar,PASIGHAT,2,1,Itanagar-PASIGHAT,3,All
2023,12,Itanagar,PASIGHAT,19,4,Itanagar-PASIGHAT,23,All
2024,1,Itanagar,PASIGHAT,30,11,Itanagar-PASIGHAT,41,All
2024,2,Itanagar,PASIGHAT,2,0,Itanagar-PASIGHAT,2,All
2024,3,Itanagar,PASIGHAT,16,7,Itanagar-PASIGHAT,23,All
2024,4,Itanagar,PASIGHAT,44,13,Itanagar-PASIGHAT,57,All
2024,6,Itanagar,PASIGHAT,0,7,Itanagar-PASIGHAT,7,All
2024,7,Itanagar,PASIGHAT,2,0,Itanagar-PASIGHAT,2,All
2024,8,Itanagar,PASIGHAT,5,5,Itanagar-PASIGHAT,10,All
2024,9,Itanagar,PASIGHAT,12,17,Itanagar-PASIGHAT,29,All
2024,10,Itanagar,PASIGHAT,7,3,Itanagar-PASIGHAT,10,All
2024,11,Itanagar,PASIGHAT,4,21,Itanagar-PASIGHAT,25,All
2024,12,Itanagar,PASIGHAT,2,0,Itanagar-PASIGHAT,2,All
2024,12,Itanagar,TEZU,20,39,Itanagar-TEZU,59,All
2025,1,Itanagar,TEZU,18,47,Itanagar-TEZU,65,All
2025,2,Itanagar,TEZU,8,17,Itanagar-TEZU,25,All
2025,3,Itanagar,TEZU,4,12,Itanagar-TEZU,16,All
2023,1,Itanagar,Ziro,34,27,Itanagar-Ziro,61,All
2023,6,Itanagar,Ziro,3,5,Itanagar-Ziro,8,All
2023,7,Itanagar,Ziro,10,10,Itanagar-Ziro,20,All
2023,8,Itanagar,Ziro,16,7,Itanagar-Ziro,23,All
2023,9,Itanagar,Ziro,54,35,Itanagar-Ziro,89,All
2023,10,Itanagar,Ziro,6,25,Itanagar-Ziro,31,All
2023,11,Itanagar,Ziro,2,1,Itanagar-Ziro,3,All
2023,12,Itanagar,Ziro,17,14,Itanagar-Ziro,31,All
2024,1,Itanagar,Ziro,7,15,Itanagar-Ziro,22,All
2024,2,Itanagar,Ziro,9,13,Itanagar-Ziro,22,All
2024,3,Itanagar,Ziro,6,7,Itanagar-Ziro,13,All
2024,4,Itanagar,Ziro,22,18,Itanagar-Ziro,40,All
2024,7,Itanagar,Ziro,12,8,Itanagar-Ziro,20,All
2024,8,Itanagar,Ziro,5,8,Itanagar-Ziro,13,All
2024,9,Itanagar,Ziro,0,4,Itanagar-Ziro,4,All
2024,10,Itanagar,Ziro,1,8,Itanagar-Ziro,9,All
2024,11,Itanagar,Ziro,5,5,Itanagar-Ziro,10,All
2024,12,Itanagar,Ziro,0,2,Itanagar-Ziro,2,All
2024,4,JABALPUR,JAGDALPUR,99,165,JABALPUR-JAGDALPUR,264,All
2024,6,JABALPUR,JAGDALPUR,444,196,JABALPUR-JAGDALPUR,640,All
2024,7,JABALPUR,JAGDALPUR,173,165,JABALPUR-JAGDALPUR,338,All
2024,8,JABALPUR,JAGDALPUR,225,129,JABALPUR-JAGDALPUR,354,All
2024,9,JABALPUR,JAGDALPUR,214,102,JABALPUR-JAGDALPUR,316,All
2024,10,JABALPUR,JAGDALPUR,257,221,JABALPUR-JAGDALPUR,478,All
2024,11,JABALPUR,JAGDALPUR,294,189,JABALPUR-JAGDALPUR,483,All
2024,12,JABALPUR,JAGDALPUR,394,175,JABALPUR-JAGDALPUR,569,All
2025,1,JABALPUR,JAGDALPUR,215,180,JABALPUR-JAGDALPUR,395,All
2025,2,JABALPUR,JAGDALPUR,300,209,JABALPUR-JAGDALPUR,509,All
2025,3,JABALPUR,JAGDALPUR,300,178,JABALPUR-JAGDALPUR,478,All
2021,1,JABALPUR,JAIPUR,49,0,JABALPUR-JAIPUR,49,All
2021,7,JABALPUR,JAIPUR,0,8,JABALPUR-JAIPUR,8,All
2021,10,JABALPUR,JAIPUR,54,0,JABALPUR-JAIPUR,54,All
2022,4,JABALPUR,JAIPUR,19,0,JABALPUR-JAIPUR,19,All
2022,10,JABALPUR,JODHPUR,11,0,JABALPUR-JODHPUR,11,All
2019,5,JABALPUR,KOLKATA,1248,1007,JABALPUR-KOLKATA,2255,All
2019,6,JABALPUR,KOLKATA,1708,1408,JABALPUR-KOLKATA,3116,All
2019,7,JABALPUR,KOLKATA,2148,2022,JABALPUR-KOLKATA,4170,All
2019,8,JABALPUR,KOLKATA,1765,1726,JABALPUR-KOLKATA,3491,All
2019,9,JABALPUR,KOLKATA,1429,1432,JABALPUR-KOLKATA,2861,All
2019,10,JABALPUR,KOLKATA,2396,1958,JABALPUR-KOLKATA,4354,All
2019,11,JABALPUR,KOLKATA,2797,2667,JABALPUR-KOLKATA,5464,All
2019,12,JABALPUR,KOLKATA,2945,2602,JABALPUR-KOLKATA,5547,All
2020,1,JABALPUR,KOLKATA,2858,2303,JABALPUR-KOLKATA,5161,All
2020,2,JABALPUR,KOLKATA,2928,2536,JABALPUR-KOLKATA,5464,All
2020,3,JABALPUR,KOLKATA,2080,1810,JABALPUR-KOLKATA,3890,All
2022,7,JABALPUR,KOLKATA,201,173,JABALPUR-KOLKATA,374,All
2022,8,JABALPUR,KOLKATA,750,679,JABALPUR-KOLKATA,1429,All
2022,9,JABALPUR,KOLKATA,500,443,JABALPUR-KOLKATA,943,All
2019,5,JABALPUR,MUMBAI,2481,2529,JABALPUR-MUMBAI,5010,All
2019,6,JABALPUR,MUMBAI,2524,2312,JABALPUR-MUMBAI,4836,All
2019,7,JABALPUR,MUMBAI,2432,2067,JABALPUR-MUMBAI,4499,All
2019,8,JABALPUR,MUMBAI,2522,2293,JABALPUR-MUMBAI,4815,All
2019,9,JABALPUR,MUMBAI,2353,2140,JABALPUR-MUMBAI,4493,All
2019,10,JABALPUR,MUMBAI,2223,2425,JABALPUR-MUMBAI,4648,All
2019,11,JABALPUR,MUMBAI,2475,2450,JABALPUR-MUMBAI,4925,All
2019,12,JABALPUR,MUMBAI,2493,2382,JABALPUR-MUMBAI,4875,All
2020,1,JABALPUR,MUMBAI,2515,2457,JABALPUR-MUMBAI,4972,All
2020,2,JABALPUR,MUMBAI,2447,2385,JABALPUR-MUMBAI,4832,All
2020,3,JABALPUR,MUMBAI,1565,1829,JABALPUR-MUMBAI,3394,All
2020,6,JABALPUR,MUMBAI,256,718,JABALPUR-MUMBAI,974,All
2020,7,JABALPUR,MUMBAI,718,1685,JABALPUR-MUMBAI,2403,All
2020,8,JABALPUR,MUMBAI,719,776,JABALPUR-MUMBAI,1495,All
2020,9,JABALPUR,MUMBAI,1510,1133,JABALPUR-MUMBAI,2643,All
2020,10,JABALPUR,MUMBAI,2264,2225,JABALPUR-MUMBAI,4489,All
2020,11,JABALPUR,MUMBAI,2152,2263,JABALPUR-MUMBAI,4415,All
2020,12,JABALPUR,MUMBAI,2282,2250,JABALPUR-MUMBAI,4532,All
2021,1,JABALPUR,MUMBAI,2273,2309,JABALPUR-MUMBAI,4582,All
2021,2,JABALPUR,MUMBAI,2456,2479,JABALPUR-MUMBAI,4935,All
2021,3,JABALPUR,MUMBAI,2359,2412,JABALPUR-MUMBAI,4771,All
2021,4,JABALPUR,MUMBAI,927,1525,JABALPUR-MUMBAI,2452,All
2021,6,JABALPUR,MUMBAI,1566,1481,JABALPUR-MUMBAI,3047,All
2021,7,JABALPUR,MUMBAI,1853,1767,JABALPUR-MUMBAI,3620,All
2021,8,JABALPUR,MUMBAI,2480,2242,JABALPUR-MUMBAI,4722,All
2021,9,JABALPUR,MUMBAI,3153,2583,JABALPUR-MUMBAI,5736,All
2021,10,JABALPUR,MUMBAI,4134,4345,JABALPUR-MUMBAI,8479,All
2021,11,JABALPUR,MUMBAI,4218,4330,JABALPUR-MUMBAI,8548,All
2021,12,JABALPUR,MUMBAI,4464,4023,JABALPUR-MUMBAI,8487,All
2022,1,JABALPUR,MUMBAI,2556,2775,JABALPUR-MUMBAI,5331,All
2022,2,JABALPUR,MUMBAI,3828,3802,JABALPUR-MUMBAI,7630,All
2022,3,JABALPUR,MUMBAI,3957,3652,JABALPUR-MUMBAI,7609,All
2022,4,JABALPUR,MUMBAI,4724,5170,JABALPUR-MUMBAI,9894,All
2022,5,JABALPUR,MUMBAI,5543,5232,JABALPUR-MUMBAI,10775,All
2022,6,JABALPUR,MUMBAI,5657,4132,JABALPUR-MUMBAI,9789,All
2022,7,JABALPUR,MUMBAI,3482,3259,JABALPUR-MUMBAI,6741,All
2022,8,JABALPUR,MUMBAI,3736,3240,JABALPUR-MUMBAI,6976,All
2022,9,JABALPUR,MUMBAI,3246,3156,JABALPUR-MUMBAI,6402,All
2022,10,JABALPUR,MUMBAI,3115,3123,JABALPUR-MUMBAI,6238,All
2022,11,JABALPUR,MUMBAI,6217,5088,JABALPUR-MUMBAI,11305,All
2022,12,JABALPUR,MUMBAI,4744,4717,JABALPUR-MUMBAI,9461,All
2023,11,JABALPUR,MUMBAI,2243,2623,JABALPUR-MUMBAI,4866,All
2023,12,JABALPUR,MUMBAI,2292,2270,JABALPUR-MUMBAI,4562,All
2024,1,JABALPUR,MUMBAI,2100,2102,JABALPUR-MUMBAI,4202,All
2024,2,JABALPUR,MUMBAI,1026,1022,JABALPUR-MUMBAI,2048,All
2024,3,JABALPUR,MUMBAI,307,345,JABALPUR-MUMBAI,652,All
2024,4,JABALPUR,MUMBAI,116,139,JABALPUR-MUMBAI,255,All
2024,6,JABALPUR,MUMBAI,191,225,JABALPUR-MUMBAI,416,All
2024,7,JABALPUR,MUMBAI,5093,4802,JABALPUR-MUMBAI,9895,All
2024,8,JABALPUR,MUMBAI,4969,4594,JABALPUR-MUMBAI,9563,All
2024,9,JABALPUR,MUMBAI,4336,4151,JABALPUR-MUMBAI,8487,All
2024,10,JABALPUR,MUMBAI,3816,5088,JABALPUR-MUMBAI,8904,All
2024,11,JABALPUR,MUMBAI,5263,5301,JABALPUR-MUMBAI,10564,All
2024,12,JABALPUR,MUMBAI,5485,5138,JABALPUR-MUMBAI,10623,All
2025,1,JABALPUR,MUMBAI,5204,5235,JABALPUR-MUMBAI,10439,All
2025,2,JABALPUR,MUMBAI,4699,4827,JABALPUR-MUMBAI,9526,All
2025,3,JABALPUR,MUMBAI,4984,5092,JABALPUR-MUMBAI,10076,All
2021,12,JABALPUR,NAGPUR,0,69,JABALPUR-NAGPUR,69,All
2023,8,JABALPUR,NAGPUR,0,41,JABALPUR-NAGPUR,41,All
2024,9,JABALPUR,NAGPUR,51,0,JABALPUR-NAGPUR,51,All
2021,3,JABALPUR,PUNE,45,49,JABALPUR-PUNE,94,All
2021,4,JABALPUR,PUNE,313,510,JABALPUR-PUNE,823,All
2021,6,JABALPUR,PUNE,677,593,JABALPUR-PUNE,1270,All
2021,7,JABALPUR,PUNE,1161,943,JABALPUR-PUNE,2104,All
2021,8,JABALPUR,PUNE,1292,1140,JABALPUR-PUNE,2432,All
2021,9,JABALPUR,PUNE,1165,969,JABALPUR-PUNE,2134,All
2021,10,JABALPUR,PUNE,814,969,JABALPUR-PUNE,1783,All
2021,11,JABALPUR,PUNE,845,965,JABALPUR-PUNE,1810,All
2021,12,JABALPUR,PUNE,1508,1116,JABALPUR-PUNE,2624,All
2022,1,JABALPUR,PUNE,1346,1404,JABALPUR-PUNE,2750,All
2022,2,JABALPUR,PUNE,1778,1638,JABALPUR-PUNE,3416,All
2022,3,JABALPUR,PUNE,2062,1829,JABALPUR-PUNE,3891,All
2022,4,JABALPUR,PUNE,1947,2064,JABALPUR-PUNE,4011,All
2022,5,JABALPUR,PUNE,2256,2237,JABALPUR-PUNE,4493,All
2022,6,JABALPUR,PUNE,1831,1651,JABALPUR-PUNE,3482,All
2022,7,JABALPUR,PUNE,1546,1512,JABALPUR-PUNE,3058,All
2022,8,JABALPUR,PUNE,1596,1474,JABALPUR-PUNE,3070,All
2022,9,JABALPUR,PUNE,1336,1326,JABALPUR-PUNE,2662,All
2022,10,JABALPUR,PUNE,1733,2024,JABALPUR-PUNE,3757,All
2022,11,JABALPUR,PUNE,2027,2009,JABALPUR-PUNE,4036,All
2022,12,JABALPUR,PUNE,2124,1921,JABALPUR-PUNE,4045,All
2023,1,JABALPUR,PUNE,1987,2089,JABALPUR-PUNE,4076,All
2023,2,JABALPUR,PUNE,1987,2122,JABALPUR-PUNE,4109,All
2023,3,JABALPUR,PUNE,134,144,JABALPUR-PUNE,278,All
2021,9,JABALPUR,RAIPUR,0,33,JABALPUR-RAIPUR,33,All
2023,1,JABALPUR,RAIPUR,3,0,JABALPUR-RAIPUR,3,All
2023,12,JABALPUR,RAIPUR,0,90,JABALPUR-RAIPUR,90,All
2021,7,JABALPUR,SURAT,74,56,JABALPUR-SURAT,130,All
2018,5,JABALPUR,TEZPUR,3,1,JABALPUR-TEZPUR,4,All
2018,6,JABALPUR,TEZPUR,3,4,JABALPUR-TEZPUR,7,All
2021,9,JABALPUR,TIRUPATI,8,0,JABALPUR-TIRUPATI,8,All
2018,6,JAGDALPUR,RAIPUR,147,137,JAGDALPUR-RAIPUR,284,All
2018,7,JAGDALPUR,RAIPUR,45,32,JAGDALPUR-RAIPUR,77,All
2018,8,JAGDALPUR,RAIPUR,14,15,JAGDALPUR-RAIPUR,29,All
2018,9,JAGDALPUR,RAIPUR,50,40,JAGDALPUR-RAIPUR,90,All
2020,9,JAGDALPUR,RAIPUR,252,195,JAGDALPUR-RAIPUR,447,All
2020,10,JAGDALPUR,RAIPUR,1089,760,JAGDALPUR-RAIPUR,1849,All
2020,11,JAGDALPUR,RAIPUR,1213,1023,JAGDALPUR-RAIPUR,2236,All
2020,12,JAGDALPUR,RAIPUR,1170,1202,JAGDALPUR-RAIPUR,2372,All
2021,1,JAGDALPUR,RAIPUR,1209,1196,JAGDALPUR-RAIPUR,2405,All
2021,2,JAGDALPUR,RAIPUR,1151,1042,JAGDALPUR-RAIPUR,2193,All
2021,3,JAGDALPUR,RAIPUR,986,981,JAGDALPUR-RAIPUR,1967,All
2021,4,JAGDALPUR,RAIPUR,614,580,JAGDALPUR-RAIPUR,1194,All
2021,6,JAGDALPUR,RAIPUR,543,606,JAGDALPUR-RAIPUR,1149,All
2021,7,JAGDALPUR,RAIPUR,891,785,JAGDALPUR-RAIPUR,1676,All
2021,8,JAGDALPUR,RAIPUR,1101,1057,JAGDALPUR-RAIPUR,2158,All
2021,9,JAGDALPUR,RAIPUR,1090,1055,JAGDALPUR-RAIPUR,2145,All
2021,10,JAGDALPUR,RAIPUR,1193,1258,JAGDALPUR-RAIPUR,2451,All
2021,11,JAGDALPUR,RAIPUR,1192,1137,JAGDALPUR-RAIPUR,2329,All
2021,12,JAGDALPUR,RAIPUR,1278,1339,JAGDALPUR-RAIPUR,2617,All
2022,1,JAGDALPUR,RAIPUR,782,858,JAGDALPUR-RAIPUR,1640,All
2022,2,JAGDALPUR,RAIPUR,1005,1043,JAGDALPUR-RAIPUR,2048,All
2022,3,JAGDALPUR,RAIPUR,1207,1303,JAGDALPUR-RAIPUR,2510,All
2022,4,JAGDALPUR,RAIPUR,1192,1137,JAGDALPUR-RAIPUR,2329,All
2022,5,JAGDALPUR,RAIPUR,1279,1342,JAGDALPUR-RAIPUR,2621,All
2022,6,JAGDALPUR,RAIPUR,1192,1137,JAGDALPUR-RAIPUR,2329,All
2022,7,JAGDALPUR,RAIPUR,1005,1043,JAGDALPUR-RAIPUR,2048,All
2022,8,JAGDALPUR,RAIPUR,1278,1339,JAGDALPUR-RAIPUR,2617,All
2022,9,JAGDALPUR,RAIPUR,1192,1137,JAGDALPUR-RAIPUR,2329,All
2022,10,JAGDALPUR,RAIPUR,1228,1206,JAGDALPUR-RAIPUR,2434,All
2022,11,JAGDALPUR,RAIPUR,1249,1157,JAGDALPUR-RAIPUR,2406,All
2022,12,JAGDALPUR,RAIPUR,1223,1183,JAGDALPUR-RAIPUR,2406,All
2023,1,JAGDALPUR,RAIPUR,1470,1514,JAGDALPUR-RAIPUR,2984,All
2023,2,JAGDALPUR,RAIPUR,1065,1034,JAGDALPUR-RAIPUR,2099,All
2023,3,JAGDALPUR,RAIPUR,1186,1184,JAGDALPUR-RAIPUR,2370,All
2023,4,JAGDALPUR,RAIPUR,1328,1177,JAGDALPUR-RAIPUR,2505,All
2023,5,JAGDALPUR,RAIPUR,1448,1535,JAGDALPUR-RAIPUR,2983,All
2023,6,JAGDALPUR,RAIPUR,1197,1367,JAGDALPUR-RAIPUR,2564,All
2023,7,JAGDALPUR,RAIPUR,811,847,JAGDALPUR-RAIPUR,1658,All
2023,8,JAGDALPUR,RAIPUR,1242,1200,JAGDALPUR-RAIPUR,2442,All
2023,9,JAGDALPUR,RAIPUR,937,1053,JAGDALPUR-RAIPUR,1990,All
2023,10,JAGDALPUR,RAIPUR,1202,972,JAGDALPUR-RAIPUR,2174,All
2023,11,JAGDALPUR,RAIPUR,363,360,JAGDALPUR-RAIPUR,723,All
2023,12,JAGDALPUR,RAIPUR,277,225,JAGDALPUR-RAIPUR,502,All
2024,1,JAGDALPUR,RAIPUR,433,299,JAGDALPUR-RAIPUR,732,All
2024,2,JAGDALPUR,RAIPUR,417,400,JAGDALPUR-RAIPUR,817,All
2024,3,JAGDALPUR,RAIPUR,458,276,JAGDALPUR-RAIPUR,734,All
2024,4,JAGDALPUR,RAIPUR,1061,807,JAGDALPUR-RAIPUR,1868,All
2024,6,JAGDALPUR,RAIPUR,704,674,JAGDALPUR-RAIPUR,1378,All
2024,7,JAGDALPUR,RAIPUR,656,539,JAGDALPUR-RAIPUR,1195,All
2024,8,JAGDALPUR,RAIPUR,1006,775,JAGDALPUR-RAIPUR,1781,All
2024,9,JAGDALPUR,RAIPUR,952,754,JAGDALPUR-RAIPUR,1706,All
2024,10,JAGDALPUR,RAIPUR,896,911,JAGDALPUR-RAIPUR,1807,All
2025,1,JAGDALPUR,RAIPUR,0,80,JAGDALPUR-RAIPUR,80,All
2025,2,JAGDALPUR,RAIPUR,2,2,JAGDALPUR-RAIPUR,4,All
2018,6,JAGDALPUR,VISAKHAPATNAM,67,50,JAGDALPUR-VISAKHAPATNAM,117,All
2018,7,JAGDALPUR,VISAKHAPATNAM,41,27,JAGDALPUR-VISAKHAPATNAM,68,All
2018,8,JAGDALPUR,VISAKHAPATNAM,3,7,JAGDALPUR-VISAKHAPATNAM,10,All
2018,9,JAGDALPUR,VISAKHAPATNAM,20,40,JAGDALPUR-VISAKHAPATNAM,60,All
2024,2,JAIPUR,Ayodhya International Airport ,1015,901,Ayodhya International Airport -JAIPUR,1916,All
2024,7,JAIPUR,Ayodhya International Airport ,1227,1205,Ayodhya International Airport -JAIPUR,2432,All
2024,8,JAIPUR,Ayodhya International Airport ,2593,2497,Ayodhya International Airport -JAIPUR,5090,All
2024,9,JAIPUR,Ayodhya International Airport ,3674,3430,Ayodhya International Airport -JAIPUR,7104,All
2024,10,JAIPUR,Ayodhya International Airport ,1465,1081,Ayodhya International Airport -JAIPUR,2546,All
2015,4,JAIPUR,CHENNAI,2305,3122,CHENNAI-JAIPUR,5427,All
2015,5,JAIPUR,CHENNAI,2907,2902,CHENNAI-JAIPUR,5809,All
2015,6,JAIPUR,CHENNAI,2685,2656,CHENNAI-JAIPUR,5341,All
2015,7,JAIPUR,CHENNAI,3239,3412,CHENNAI-JAIPUR,6651,All
2015,8,JAIPUR,CHENNAI,3108,3126,CHENNAI-JAIPUR,6234,All
2015,9,JAIPUR,CHENNAI,3219,3339,CHENNAI-JAIPUR,6558,All
2015,10,JAIPUR,CHENNAI,3617,3568,CHENNAI-JAIPUR,7185,All
2015,11,JAIPUR,CHENNAI,2683,2821,CHENNAI-JAIPUR,5504,All
2015,12,JAIPUR,CHENNAI,2571,2342,CHENNAI-JAIPUR,4913,All
2016,1,JAIPUR,CHENNAI,2434,2583,CHENNAI-JAIPUR,5017,All
2016,2,JAIPUR,CHENNAI,1649,1780,CHENNAI-JAIPUR,3429,All
2016,3,JAIPUR,CHENNAI,1367,1369,CHENNAI-JAIPUR,2736,All
2016,4,JAIPUR,CHENNAI,3303,3720,CHENNAI-JAIPUR,7023,All
2016,5,JAIPUR,CHENNAI,5518,4609,CHENNAI-JAIPUR,10127,All
2016,6,JAIPUR,CHENNAI,4090,3986,CHENNAI-JAIPUR,8076,All
2016,7,JAIPUR,CHENNAI,4783,4316,CHENNAI-JAIPUR,9099,All
2016,8,JAIPUR,CHENNAI,3831,4055,CHENNAI-JAIPUR,7886,All
2016,9,JAIPUR,CHENNAI,3427,3863,CHENNAI-JAIPUR,7290,All
2016,10,JAIPUR,CHENNAI,5643,5722,CHENNAI-JAIPUR,11365,All
2016,11,JAIPUR,CHENNAI,7152,7340,CHENNAI-JAIPUR,14492,All
2016,12,JAIPUR,CHENNAI,7148,6535,CHENNAI-JAIPUR,13683,All
2017,1,JAIPUR,CHENNAI,6512,5240,CHENNAI-JAIPUR,11752,All
2017,2,JAIPUR,CHENNAI,5692,5228,CHENNAI-JAIPUR,10920,All
2017,3,JAIPUR,CHENNAI,6065,6082,CHENNAI-JAIPUR,12147,All
2017,4,JAIPUR,CHENNAI,5256,5788,CHENNAI-JAIPUR,11044,All
2017,5,JAIPUR,CHENNAI,5861,5264,CHENNAI-JAIPUR,11125,All
2017,6,JAIPUR,CHENNAI,5236,5487,CHENNAI-JAIPUR,10723,All
2017,7,JAIPUR,CHENNAI,5080,5050,CHENNAI-JAIPUR,10130,All
2017,8,JAIPUR,CHENNAI,3915,4522,CHENNAI-JAIPUR,8437,All
2017,9,JAIPUR,CHENNAI,3584,6500,CHENNAI-JAIPUR,10084,All
2017,10,JAIPUR,CHENNAI,6910,8524,CHENNAI-JAIPUR,15434,All
2017,11,JAIPUR,CHENNAI,7261,8557,CHENNAI-JAIPUR,15818,All
2017,12,JAIPUR,CHENNAI,10619,10195,CHENNAI-JAIPUR,20814,All
2018,1,JAIPUR,CHENNAI,10064,9240,CHENNAI-JAIPUR,19304,All
2018,2,JAIPUR,CHENNAI,10607,10954,CHENNAI-JAIPUR,21561,All
2018,3,JAIPUR,CHENNAI,7321,7077,CHENNAI-JAIPUR,14398,All
2018,4,JAIPUR,CHENNAI,7035,7886,CHENNAI-JAIPUR,14921,All
2018,5,JAIPUR,CHENNAI,9983,5592,CHENNAI-JAIPUR,15575,All
2018,6,JAIPUR,CHENNAI,8464,8452,CHENNAI-JAIPUR,16916,All
2018,7,JAIPUR,CHENNAI,8164,6526,CHENNAI-JAIPUR,14690,All
2018,8,JAIPUR,CHENNAI,7366,7478,CHENNAI-JAIPUR,14844,All
2018,9,JAIPUR,CHENNAI,8231,9305,CHENNAI-JAIPUR,17536,All
2018,10,JAIPUR,CHENNAI,10619,10941,CHENNAI-JAIPUR,21560,All
2018,11,JAIPUR,CHENNAI,9245,10164,CHENNAI-JAIPUR,19409,All
2018,12,JAIPUR,CHENNAI,11825,12367,CHENNAI-JAIPUR,24192,All
2019,1,JAIPUR,CHENNAI,14199,14730,CHENNAI-JAIPUR,28929,All
2019,2,JAIPUR,CHENNAI,12194,12354,CHENNAI-JAIPUR,24548,All
2019,3,JAIPUR,CHENNAI,13234,13697,CHENNAI-JAIPUR,26931,All
2019,4,JAIPUR,CHENNAI,5314,7085,CHENNAI-JAIPUR,12399,All
2017,10,JAIPUR,JAISALMER,148,105,JAIPUR-JAISALMER,253,All
2017,11,JAIPUR,JAISALMER,1601,1304,JAIPUR-JAISALMER,2905,All
2017,12,JAIPUR,JAISALMER,1885,1861,JAIPUR-JAISALMER,3746,All
2018,1,JAIPUR,JAISALMER,1961,1926,JAIPUR-JAISALMER,3887,All
2018,2,JAIPUR,JAISALMER,1715,1574,JAIPUR-JAISALMER,3289,All
2018,3,JAIPUR,JAISALMER,1648,1642,JAIPUR-JAISALMER,3290,All
2018,4,JAIPUR,JAISALMER,1325,1480,JAIPUR-JAISALMER,2805,All
2018,5,JAIPUR,JAISALMER,1053,1156,JAIPUR-JAISALMER,2209,All
2018,6,JAIPUR,JAISALMER,1182,1148,JAIPUR-JAISALMER,2330,All
2018,7,JAIPUR,JAISALMER,1982,1510,JAIPUR-JAISALMER,3492,All
2018,8,JAIPUR,JAISALMER,1971,1984,JAIPUR-JAISALMER,3955,All
2018,9,JAIPUR,JAISALMER,1934,1910,JAIPUR-JAISALMER,3844,All
2018,10,JAIPUR,JAISALMER,2084,2034,JAIPUR-JAISALMER,4118,All
2018,11,JAIPUR,JAISALMER,1871,1725,JAIPUR-JAISALMER,3596,All
2018,12,JAIPUR,JAISALMER,1789,1796,JAIPUR-JAISALMER,3585,All
2019,1,JAIPUR,JAISALMER,2134,2126,JAIPUR-JAISALMER,4260,All
2019,2,JAIPUR,JAISALMER,1848,1906,JAIPUR-JAISALMER,3754,All
2019,3,JAIPUR,JAISALMER,2204,2183,JAIPUR-JAISALMER,4387,All
2019,4,JAIPUR,JAISALMER,1736,1723,JAIPUR-JAISALMER,3459,All
2019,5,JAIPUR,JAISALMER,1105,1218,JAIPUR-JAISALMER,2323,All
2019,6,JAIPUR,JAISALMER,581,479,JAIPUR-JAISALMER,1060,All
2019,7,JAIPUR,JAISALMER,971,924,JAIPUR-JAISALMER,1895,All
2019,8,JAIPUR,JAISALMER,2128,2065,JAIPUR-JAISALMER,4193,All
2019,9,JAIPUR,JAISALMER,2101,1848,JAIPUR-JAISALMER,3949,All
2019,10,JAIPUR,JAISALMER,2139,1781,JAIPUR-JAISALMER,3920,All
2019,11,JAIPUR,JAISALMER,2209,1816,JAIPUR-JAISALMER,4025,All
2019,12,JAIPUR,JAISALMER,2329,2037,JAIPUR-JAISALMER,4366,All
2020,1,JAIPUR,JAISALMER,2234,1829,JAIPUR-JAISALMER,4063,All
2020,2,JAIPUR,JAISALMER,2150,1743,JAIPUR-JAISALMER,3893,All
2020,3,JAIPUR,JAISALMER,1302,1065,JAIPUR-JAISALMER,2367,All
2021,10,JAIPUR,JAISALMER,42,14,JAIPUR-JAISALMER,56,All
2021,11,JAIPUR,JAISALMER,1809,1768,JAIPUR-JAISALMER,3577,All
2021,12,JAIPUR,JAISALMER,2178,2137,JAIPUR-JAISALMER,4315,All
2022,1,JAIPUR,JAISALMER,1392,1548,JAIPUR-JAISALMER,2940,All
2022,2,JAIPUR,JAISALMER,1769,1632,JAIPUR-JAISALMER,3401,All
2022,3,JAIPUR,JAISALMER,1357,1502,JAIPUR-JAISALMER,2859,All
2022,10,JAIPUR,JAISALMER,78,88,JAIPUR-JAISALMER,166,All
2022,11,JAIPUR,JAISALMER,999,1041,JAIPUR-JAISALMER,2040,All
2022,12,JAIPUR,JAISALMER,1765,1489,JAIPUR-JAISALMER,3254,All
2023,1,JAIPUR,JAISALMER,1678,1615,JAIPUR-JAISALMER,3293,All
2023,2,JAIPUR,JAISALMER,478,383,JAIPUR-JAISALMER,861,All
2023,3,JAIPUR,JAISALMER,66,39,JAIPUR-JAISALMER,105,All
2023,10,JAIPUR,JAISALMER,114,137,JAIPUR-JAISALMER,251,All
2023,11,JAIPUR,JAISALMER,1486,1532,JAIPUR-JAISALMER,3018,All
2023,12,JAIPUR,JAISALMER,1746,1508,JAIPUR-JAISALMER,3254,All
2024,1,JAIPUR,JAISALMER,1779,1714,JAIPUR-JAISALMER,3493,All
2024,2,JAIPUR,JAISALMER,1732,1778,JAIPUR-JAISALMER,3510,All
2024,3,JAIPUR,JAISALMER,566,557,JAIPUR-JAISALMER,1123,All
2024,12,JAIPUR,JAISALMER,2157,1862,JAIPUR-JAISALMER,4019,All
2025,1,JAIPUR,JAISALMER,2133,2111,JAIPUR-JAISALMER,4244,All
2025,2,JAIPUR,JAISALMER,1928,1790,JAIPUR-JAISALMER,3718,All
2025,3,JAIPUR,JAISALMER,774,726,JAIPUR-JAISALMER,1500,All
2019,5,JAIPUR,JAMMU,193,0,JAIPUR-JAMMU,193,All
2019,6,JAIPUR,JAMMU,256,0,JAIPUR-JAMMU,256,All
2019,7,JAIPUR,JAMMU,546,0,JAIPUR-JAMMU,546,All
2019,8,JAIPUR,JAMMU,152,0,JAIPUR-JAMMU,152,All
2019,9,JAIPUR,JAMMU,16,0,JAIPUR-JAMMU,16,All
2020,8,JAIPUR,JAMMU,0,16,JAIPUR-JAMMU,16,All
2021,4,JAIPUR,JAMMU,33,0,JAIPUR-JAMMU,33,All
2017,2,JAIPUR,JODHPUR,36,34,JAIPUR-JODHPUR,70,All
2017,3,JAIPUR,JODHPUR,32,33,JAIPUR-JODHPUR,65,All
2017,4,JAIPUR,JODHPUR,45,100,JAIPUR-JODHPUR,145,All
2017,6,JAIPUR,JODHPUR,8,0,JAIPUR-JODHPUR,8,All
2017,7,JAIPUR,JODHPUR,0,3,JAIPUR-JODHPUR,3,All
2017,8,JAIPUR,JODHPUR,9,8,JAIPUR-JODHPUR,17,All
2017,9,JAIPUR,JODHPUR,0,73,JAIPUR-JODHPUR,73,All
2017,10,JAIPUR,JODHPUR,0,16,JAIPUR-JODHPUR,16,All
2017,11,JAIPUR,JODHPUR,0,20,JAIPUR-JODHPUR,20,All
2017,12,JAIPUR,JODHPUR,1379,1101,JAIPUR-JODHPUR,2480,All
2018,1,JAIPUR,JODHPUR,1333,1415,JAIPUR-JODHPUR,2748,All
2018,2,JAIPUR,JODHPUR,1364,1369,JAIPUR-JODHPUR,2733,All
2019,2,JAIPUR,JODHPUR,560,557,JAIPUR-JODHPUR,1117,All
2019,3,JAIPUR,JODHPUR,636,568,JAIPUR-JODHPUR,1204,All
2020,3,JAIPUR,JODHPUR,58,0,JAIPUR-JODHPUR,58,All
2021,7,JAIPUR,JODHPUR,1,0,JAIPUR-JODHPUR,1,All
2021,8,JAIPUR,JODHPUR,3,0,JAIPUR-JODHPUR,3,All
2021,10,JAIPUR,JODHPUR,6,0,JAIPUR-JODHPUR,6,All
2023,2,JAIPUR,JODHPUR,603,990,JAIPUR-JODHPUR,1593,All
2023,3,JAIPUR,JODHPUR,1079,1112,JAIPUR-JODHPUR,2191,All
2023,4,JAIPUR,JODHPUR,1846,1505,JAIPUR-JODHPUR,3351,All
2023,5,JAIPUR,JODHPUR,1873,1932,JAIPUR-JODHPUR,3805,All
2023,6,JAIPUR,JODHPUR,1970,1644,JAIPUR-JODHPUR,3614,All
2023,7,JAIPUR,JODHPUR,2017,1542,JAIPUR-JODHPUR,3559,All
2023,8,JAIPUR,JODHPUR,2131,1781,JAIPUR-JODHPUR,3912,All
2023,9,JAIPUR,JODHPUR,2038,1782,JAIPUR-JODHPUR,3820,All
2023,10,JAIPUR,JODHPUR,1747,1698,JAIPUR-JODHPUR,3445,All
2023,11,JAIPUR,JODHPUR,1790,1544,JAIPUR-JODHPUR,3334,All
2023,12,JAIPUR,JODHPUR,1932,1781,JAIPUR-JODHPUR,3713,All
2024,1,JAIPUR,JODHPUR,1986,1843,JAIPUR-JODHPUR,3829,All
2024,2,JAIPUR,JODHPUR,1827,1846,JAIPUR-JODHPUR,3673,All
2024,3,JAIPUR,JODHPUR,1620,1540,JAIPUR-JODHPUR,3160,All
2024,4,JAIPUR,JODHPUR,1479,1419,JAIPUR-JODHPUR,2898,All
2024,6,JAIPUR,JODHPUR,1083,1123,JAIPUR-JODHPUR,2206,All
2024,7,JAIPUR,JODHPUR,1300,1185,JAIPUR-JODHPUR,2485,All
2024,8,JAIPUR,JODHPUR,1378,1376,JAIPUR-JODHPUR,2754,All
2024,9,JAIPUR,JODHPUR,1665,1484,JAIPUR-JODHPUR,3149,All
2024,10,JAIPUR,JODHPUR,1902,1740,JAIPUR-JODHPUR,3642,All
2024,11,JAIPUR,JODHPUR,1993,1902,JAIPUR-JODHPUR,3895,All
2024,12,JAIPUR,JODHPUR,1909,1679,JAIPUR-JODHPUR,3588,All
2025,1,JAIPUR,JODHPUR,1565,1617,JAIPUR-JODHPUR,3182,All
2025,2,JAIPUR,JODHPUR,1668,1551,JAIPUR-JODHPUR,3219,All
2025,3,JAIPUR,JODHPUR,1783,1427,JAIPUR-JODHPUR,3210,All
2024,4,JAIPUR,KANPUR,0,9,JAIPUR-KANPUR,9,All
2025,2,JAIPUR,KHAJURAHO,25,0,JAIPUR-KHAJURAHO,25,All
2019,5,JAIPUR,KOCHI,4463,3559,JAIPUR-KOCHI,8022,All
2019,6,JAIPUR,KOCHI,3119,4045,JAIPUR-KOCHI,7164,All
2020,2,JAIPUR,KOCHI,2,0,JAIPUR-KOCHI,2,All
2020,8,JAIPUR,KOCHI,45,54,JAIPUR-KOCHI,99,All
2020,9,JAIPUR,KOCHI,222,205,JAIPUR-KOCHI,427,All
2020,10,JAIPUR,KOCHI,116,135,JAIPUR-KOCHI,251,All
2020,11,JAIPUR,KOCHI,307,265,JAIPUR-KOCHI,572,All
2020,12,JAIPUR,KOCHI,426,382,JAIPUR-KOCHI,808,All
2021,1,JAIPUR,KOCHI,178,145,JAIPUR-KOCHI,323,All
2021,2,JAIPUR,KOCHI,29,30,JAIPUR-KOCHI,59,All
2021,3,JAIPUR,KOCHI,108,93,JAIPUR-KOCHI,201,All
2021,4,JAIPUR,KOCHI,459,867,JAIPUR-KOCHI,1326,All
2021,7,JAIPUR,KOCHI,182,102,JAIPUR-KOCHI,284,All
2024,10,JAIPUR,KOCHI,120,214,JAIPUR-KOCHI,334,All
2024,11,JAIPUR,KOCHI,1146,1132,JAIPUR-KOCHI,2278,All
2024,12,JAIPUR,KOCHI,1209,1076,JAIPUR-KOCHI,2285,All
2025,3,JAIPUR,KOCHI,918,899,JAIPUR-KOCHI,1817,All
2019,5,JAIPUR,KOLKATA,14607,13008,JAIPUR-KOLKATA,27615,All
2019,6,JAIPUR,KOLKATA,20896,21687,JAIPUR-KOLKATA,42583,All
2019,7,JAIPUR,KOLKATA,18118,19092,JAIPUR-KOLKATA,37210,All
2019,8,JAIPUR,KOLKATA,15108,15438,JAIPUR-KOLKATA,30546,All
2019,9,JAIPUR,KOLKATA,18063,17273,JAIPUR-KOLKATA,35336,All
2019,10,JAIPUR,KOLKATA,21772,20282,JAIPUR-KOLKATA,42054,All
2019,11,JAIPUR,KOLKATA,20956,20866,JAIPUR-KOLKATA,41822,All
2019,12,JAIPUR,KOLKATA,22170,22074,JAIPUR-KOLKATA,44244,All
2020,1,JAIPUR,KOLKATA,21836,20790,JAIPUR-KOLKATA,42626,All
2020,2,JAIPUR,KOLKATA,18217,17977,JAIPUR-KOLKATA,36194,All
2020,3,JAIPUR,KOLKATA,14475,11830,JAIPUR-KOLKATA,26305,All
2020,6,JAIPUR,KOLKATA,3766,4249,JAIPUR-KOLKATA,8015,All
2020,7,JAIPUR,KOLKATA,3489,5690,JAIPUR-KOLKATA,9179,All
2020,8,JAIPUR,KOLKATA,5665,9968,JAIPUR-KOLKATA,15633,All
2020,9,JAIPUR,KOLKATA,5815,15606,JAIPUR-KOLKATA,21421,All
2020,10,JAIPUR,KOLKATA,8833,15622,JAIPUR-KOLKATA,24455,All
2020,11,JAIPUR,KOLKATA,12600,16764,JAIPUR-KOLKATA,29364,All
2020,12,JAIPUR,KOLKATA,16597,15886,JAIPUR-KOLKATA,32483,All
2021,1,JAIPUR,KOLKATA,12676,14745,JAIPUR-KOLKATA,27421,All
2021,2,JAIPUR,KOLKATA,14143,16913,JAIPUR-KOLKATA,31056,All
2021,3,JAIPUR,KOLKATA,15835,18408,JAIPUR-KOLKATA,34243,All
2021,4,JAIPUR,KOLKATA,8121,5920,JAIPUR-KOLKATA,14041,All
2021,6,JAIPUR,KOLKATA,2913,2346,JAIPUR-KOLKATA,5259,All
2021,7,JAIPUR,KOLKATA,6810,7943,JAIPUR-KOLKATA,14753,All
2021,8,JAIPUR,KOLKATA,10020,10991,JAIPUR-KOLKATA,21011,All
2021,9,JAIPUR,KOLKATA,10817,11522,JAIPUR-KOLKATA,22339,All
2021,10,JAIPUR,KOLKATA,18633,18290,JAIPUR-KOLKATA,36923,All
2021,11,JAIPUR,KOLKATA,19463,21787,JAIPUR-KOLKATA,41250,All
2021,12,JAIPUR,KOLKATA,22145,23154,JAIPUR-KOLKATA,45299,All
2022,1,JAIPUR,KOLKATA,12412,10184,JAIPUR-KOLKATA,22596,All
2022,2,JAIPUR,KOLKATA,16688,17458,JAIPUR-KOLKATA,34146,All
2022,3,JAIPUR,KOLKATA,20504,20987,JAIPUR-KOLKATA,41491,All
2022,4,JAIPUR,KOLKATA,13112,14599,JAIPUR-KOLKATA,27711,All
2022,5,JAIPUR,KOLKATA,14945,15362,JAIPUR-KOLKATA,30307,All
2022,6,JAIPUR,KOLKATA,12421,13911,JAIPUR-KOLKATA,26332,All
2022,7,JAIPUR,KOLKATA,12878,15080,JAIPUR-KOLKATA,27958,All
2022,8,JAIPUR,KOLKATA,12055,14171,JAIPUR-KOLKATA,26226,All
2022,9,JAIPUR,KOLKATA,12447,13501,JAIPUR-KOLKATA,25948,All
2022,10,JAIPUR,KOLKATA,15397,15241,JAIPUR-KOLKATA,30638,All
2022,11,JAIPUR,KOLKATA,11917,12127,JAIPUR-KOLKATA,24044,All
2022,12,JAIPUR,KOLKATA,16533,15626,JAIPUR-KOLKATA,32159,All
2023,1,JAIPUR,KOLKATA,15287,15849,JAIPUR-KOLKATA,31136,All
2023,2,JAIPUR,KOLKATA,15196,15121,JAIPUR-KOLKATA,30317,All
2023,3,JAIPUR,KOLKATA,14992,15003,JAIPUR-KOLKATA,29995,All
2023,4,JAIPUR,KOLKATA,14242,14254,JAIPUR-KOLKATA,28496,All
2023,5,JAIPUR,KOLKATA,15977,15228,JAIPUR-KOLKATA,31205,All
2023,6,JAIPUR,KOLKATA,14243,13618,JAIPUR-KOLKATA,27861,All
2023,7,JAIPUR,KOLKATA,13303,14364,JAIPUR-KOLKATA,27667,All
2023,8,JAIPUR,KOLKATA,13562,13878,JAIPUR-KOLKATA,27440,All
2023,9,JAIPUR,KOLKATA,14612,13990,JAIPUR-KOLKATA,28602,All
2023,10,JAIPUR,KOLKATA,14938,13394,JAIPUR-KOLKATA,28332,All
2023,11,JAIPUR,KOLKATA,17631,16447,JAIPUR-KOLKATA,34078,All
2023,12,JAIPUR,KOLKATA,15917,14492,JAIPUR-KOLKATA,30409,All
2024,1,JAIPUR,KOLKATA,13990,13525,JAIPUR-KOLKATA,27515,All
2024,2,JAIPUR,KOLKATA,13844,13894,JAIPUR-KOLKATA,27738,All
2024,3,JAIPUR,KOLKATA,19413,19005,JAIPUR-KOLKATA,38418,All
2024,4,JAIPUR,KOLKATA,18082,16699,JAIPUR-KOLKATA,34781,All
2024,6,JAIPUR,KOLKATA,16854,14951,JAIPUR-KOLKATA,31805,All
2024,7,JAIPUR,KOLKATA,17581,18545,JAIPUR-KOLKATA,36126,All
2024,8,JAIPUR,KOLKATA,15887,16991,JAIPUR-KOLKATA,32878,All
2024,9,JAIPUR,KOLKATA,16465,14687,JAIPUR-KOLKATA,31152,All
2024,10,JAIPUR,KOLKATA,23986,22039,JAIPUR-KOLKATA,46025,All
2024,11,JAIPUR,KOLKATA,28057,27571,JAIPUR-KOLKATA,55628,All
2024,12,JAIPUR,KOLKATA,29273,26096,JAIPUR-KOLKATA,55369,All
2025,1,JAIPUR,KOLKATA,26655,27272,JAIPUR-KOLKATA,53927,All
2025,2,JAIPUR,KOLKATA,26723,27998,JAIPUR-KOLKATA,54721,All
2025,3,JAIPUR,KOLKATA,27127,25212,JAIPUR-KOLKATA,52339,All
2024,10,JAIPUR,KULLU,303,116,JAIPUR-KULLU,419,All
2024,11,JAIPUR,KULLU,661,206,JAIPUR-KULLU,867,All
2024,12,JAIPUR,KULLU,472,176,JAIPUR-KULLU,648,All
2025,1,JAIPUR,KULLU,372,208,JAIPUR-KULLU,580,All
2025,2,JAIPUR,KULLU,260,142,JAIPUR-KULLU,402,All
2025,3,JAIPUR,KULLU,297,163,JAIPUR-KULLU,460,All
2022,7,JAIPUR,LEH,0,20,JAIPUR-LEH,20,All
2017,3,JAIPUR,LUCKNOW,0,35,JAIPUR-LUCKNOW,35,All
2017,4,JAIPUR,LUCKNOW,0,356,JAIPUR-LUCKNOW,356,All
2017,7,JAIPUR,LUCKNOW,2771,2271,JAIPUR-LUCKNOW,5042,All
2017,8,JAIPUR,LUCKNOW,3197,2855,JAIPUR-LUCKNOW,6052,All
2017,9,JAIPUR,LUCKNOW,3028,2901,JAIPUR-LUCKNOW,5929,All
2017,10,JAIPUR,LUCKNOW,3320,3295,JAIPUR-LUCKNOW,6615,All
2017,11,JAIPUR,LUCKNOW,3250,3184,JAIPUR-LUCKNOW,6434,All
2017,12,JAIPUR,LUCKNOW,3459,3233,JAIPUR-LUCKNOW,6692,All
2018,1,JAIPUR,LUCKNOW,3209,3177,JAIPUR-LUCKNOW,6386,All
2018,2,JAIPUR,LUCKNOW,3117,2620,JAIPUR-LUCKNOW,5737,All
2018,3,JAIPUR,LUCKNOW,3353,3505,JAIPUR-LUCKNOW,6858,All
2018,4,JAIPUR,LUCKNOW,3367,3083,JAIPUR-LUCKNOW,6450,All
2018,5,JAIPUR,LUCKNOW,2997,3182,JAIPUR-LUCKNOW,6179,All
2018,6,JAIPUR,LUCKNOW,2685,2994,JAIPUR-LUCKNOW,5679,All
2018,7,JAIPUR,LUCKNOW,2976,2994,JAIPUR-LUCKNOW,5970,All
2018,8,JAIPUR,LUCKNOW,4428,4371,JAIPUR-LUCKNOW,8799,All
2018,9,JAIPUR,LUCKNOW,3965,4705,JAIPUR-LUCKNOW,8670,All
2018,10,JAIPUR,LUCKNOW,2581,2615,JAIPUR-LUCKNOW,5196,All
2018,11,JAIPUR,LUCKNOW,5189,4668,JAIPUR-LUCKNOW,9857,All
2018,12,JAIPUR,LUCKNOW,5457,5863,JAIPUR-LUCKNOW,11320,All
2019,1,JAIPUR,LUCKNOW,5351,5428,JAIPUR-LUCKNOW,10779,All
2019,2,JAIPUR,LUCKNOW,5511,5689,JAIPUR-LUCKNOW,11200,All
2019,3,JAIPUR,LUCKNOW,4871,5603,JAIPUR-LUCKNOW,10474,All
2019,4,JAIPUR,LUCKNOW,4783,4657,JAIPUR-LUCKNOW,9440,All
2019,5,JAIPUR,LUCKNOW,5675,5505,JAIPUR-LUCKNOW,11180,All
2019,6,JAIPUR,LUCKNOW,4100,5664,JAIPUR-LUCKNOW,9764,All
2019,7,JAIPUR,LUCKNOW,3964,5529,JAIPUR-LUCKNOW,9493,All
2019,8,JAIPUR,LUCKNOW,1597,1693,JAIPUR-LUCKNOW,3290,All
2019,9,JAIPUR,LUCKNOW,4486,5189,JAIPUR-LUCKNOW,9675,All
2019,10,JAIPUR,LUCKNOW,5162,5035,JAIPUR-LUCKNOW,10197,All
2019,11,JAIPUR,LUCKNOW,1544,1750,JAIPUR-LUCKNOW,3294,All
2019,12,JAIPUR,LUCKNOW,1145,1209,JAIPUR-LUCKNOW,2354,All
2020,1,JAIPUR,LUCKNOW,1131,1230,JAIPUR-LUCKNOW,2361,All
2020,2,JAIPUR,LUCKNOW,1322,1399,JAIPUR-LUCKNOW,2721,All
2020,3,JAIPUR,LUCKNOW,824,744,JAIPUR-LUCKNOW,1568,All
2020,6,JAIPUR,LUCKNOW,26,0,JAIPUR-LUCKNOW,26,All
2020,7,JAIPUR,LUCKNOW,860,2,JAIPUR-LUCKNOW,862,All
2020,8,JAIPUR,LUCKNOW,610,122,JAIPUR-LUCKNOW,732,All
2020,10,JAIPUR,LUCKNOW,0,939,JAIPUR-LUCKNOW,939,All
2020,12,JAIPUR,LUCKNOW,27,0,JAIPUR-LUCKNOW,27,All
2021,6,JAIPUR,LUCKNOW,41,0,JAIPUR-LUCKNOW,41,All
2021,9,JAIPUR,LUCKNOW,1318,1574,JAIPUR-LUCKNOW,2892,All
2021,10,JAIPUR,LUCKNOW,1577,1665,JAIPUR-LUCKNOW,3242,All
2021,12,JAIPUR,LUCKNOW,374,376,JAIPUR-LUCKNOW,750,All
2022,1,JAIPUR,LUCKNOW,987,1164,JAIPUR-LUCKNOW,2151,All
2022,2,JAIPUR,LUCKNOW,905,981,JAIPUR-LUCKNOW,1886,All
2022,3,JAIPUR,LUCKNOW,1891,2077,JAIPUR-LUCKNOW,3968,All
2022,4,JAIPUR,LUCKNOW,2041,1976,JAIPUR-LUCKNOW,4017,All
2022,5,JAIPUR,LUCKNOW,1825,1788,JAIPUR-LUCKNOW,3613,All
2022,6,JAIPUR,LUCKNOW,1844,2040,JAIPUR-LUCKNOW,3884,All
2022,7,JAIPUR,LUCKNOW,1775,1823,JAIPUR-LUCKNOW,3598,All
2022,8,JAIPUR,LUCKNOW,1928,1744,JAIPUR-LUCKNOW,3672,All
2022,9,JAIPUR,LUCKNOW,1970,1795,JAIPUR-LUCKNOW,3765,All
2022,10,JAIPUR,LUCKNOW,2189,2088,JAIPUR-LUCKNOW,4277,All
2022,11,JAIPUR,LUCKNOW,2109,2076,JAIPUR-LUCKNOW,4185,All
2022,12,JAIPUR,LUCKNOW,2053,2036,JAIPUR-LUCKNOW,4089,All
2023,1,JAIPUR,LUCKNOW,2011,2048,JAIPUR-LUCKNOW,4059,All
2023,2,JAIPUR,LUCKNOW,1909,1839,JAIPUR-LUCKNOW,3748,All
2023,3,JAIPUR,LUCKNOW,1941,2204,JAIPUR-LUCKNOW,4145,All
2023,4,JAIPUR,LUCKNOW,2344,2418,JAIPUR-LUCKNOW,4762,All
2023,5,JAIPUR,LUCKNOW,2538,2353,JAIPUR-LUCKNOW,4891,All
2023,6,JAIPUR,LUCKNOW,2348,2446,JAIPUR-LUCKNOW,4794,All
2023,7,JAIPUR,LUCKNOW,2192,2495,JAIPUR-LUCKNOW,4687,All
2023,8,JAIPUR,LUCKNOW,2168,2346,JAIPUR-LUCKNOW,4514,All
2023,9,JAIPUR,LUCKNOW,2072,2304,JAIPUR-LUCKNOW,4376,All
2023,10,JAIPUR,LUCKNOW,2059,2242,JAIPUR-LUCKNOW,4301,All
2023,11,JAIPUR,LUCKNOW,2135,1983,JAIPUR-LUCKNOW,4118,All
2023,12,JAIPUR,LUCKNOW,2151,2182,JAIPUR-LUCKNOW,4333,All
2024,1,JAIPUR,LUCKNOW,2110,2135,JAIPUR-LUCKNOW,4245,All
2024,2,JAIPUR,LUCKNOW,2017,1930,JAIPUR-LUCKNOW,3947,All
2024,3,JAIPUR,LUCKNOW,2219,2187,JAIPUR-LUCKNOW,4406,All
2024,4,JAIPUR,LUCKNOW,4286,3588,JAIPUR-LUCKNOW,7874,All
2024,6,JAIPUR,LUCKNOW,3684,3546,JAIPUR-LUCKNOW,7230,All
2024,7,JAIPUR,LUCKNOW,3901,3512,JAIPUR-LUCKNOW,7413,All
2024,8,JAIPUR,LUCKNOW,3605,3396,JAIPUR-LUCKNOW,7001,All
2024,9,JAIPUR,LUCKNOW,3570,3069,JAIPUR-LUCKNOW,6639,All
2024,10,JAIPUR,LUCKNOW,4238,3255,JAIPUR-LUCKNOW,7493,All
2024,11,JAIPUR,LUCKNOW,4294,4145,JAIPUR-LUCKNOW,8439,All
2024,12,JAIPUR,LUCKNOW,3269,3277,JAIPUR-LUCKNOW,6546,All
2025,1,JAIPUR,LUCKNOW,2198,2228,JAIPUR-LUCKNOW,4426,All
2025,2,JAIPUR,LUCKNOW,3846,3836,JAIPUR-LUCKNOW,7682,All
2025,3,JAIPUR,LUCKNOW,2228,2126,JAIPUR-LUCKNOW,4354,All
2019,5,JAIPUR,MUMBAI,39521,37479,JAIPUR-MUMBAI,77000,All
2019,6,JAIPUR,MUMBAI,40614,40089,JAIPUR-MUMBAI,80703,All
2019,7,JAIPUR,MUMBAI,39746,40984,JAIPUR-MUMBAI,80730,All
2019,8,JAIPUR,MUMBAI,40536,41374,JAIPUR-MUMBAI,81910,All
2019,9,JAIPUR,MUMBAI,39102,40171,JAIPUR-MUMBAI,79273,All
2019,10,JAIPUR,MUMBAI,34538,41858,JAIPUR-MUMBAI,76396,All
2019,11,JAIPUR,MUMBAI,42758,42025,JAIPUR-MUMBAI,84783,All
2019,12,JAIPUR,MUMBAI,44263,43652,JAIPUR-MUMBAI,87915,All
2020,1,JAIPUR,MUMBAI,44046,43937,JAIPUR-MUMBAI,87983,All
2020,2,JAIPUR,MUMBAI,45692,46065,JAIPUR-MUMBAI,91757,All
2020,3,JAIPUR,MUMBAI,26879,28227,JAIPUR-MUMBAI,55106,All
2020,5,JAIPUR,MUMBAI,153,508,JAIPUR-MUMBAI,661,All
2020,6,JAIPUR,MUMBAI,2759,6265,JAIPUR-MUMBAI,9024,All
2020,7,JAIPUR,MUMBAI,4618,7274,JAIPUR-MUMBAI,11892,All
2020,8,JAIPUR,MUMBAI,7850,6787,JAIPUR-MUMBAI,14637,All
2020,9,JAIPUR,MUMBAI,13408,8187,JAIPUR-MUMBAI,21595,All
2020,10,JAIPUR,MUMBAI,15704,14829,JAIPUR-MUMBAI,30533,All
2020,11,JAIPUR,MUMBAI,19793,26616,JAIPUR-MUMBAI,46409,All
2020,12,JAIPUR,MUMBAI,24052,23966,JAIPUR-MUMBAI,48018,All
2021,1,JAIPUR,MUMBAI,22863,24344,JAIPUR-MUMBAI,47207,All
2021,2,JAIPUR,MUMBAI,26027,28512,JAIPUR-MUMBAI,54539,All
2021,3,JAIPUR,MUMBAI,24317,26576,JAIPUR-MUMBAI,50893,All
2021,4,JAIPUR,MUMBAI,10151,18582,JAIPUR-MUMBAI,28733,All
2021,6,JAIPUR,MUMBAI,9590,8187,JAIPUR-MUMBAI,17777,All
2021,7,JAIPUR,MUMBAI,16980,16792,JAIPUR-MUMBAI,33772,All
2021,8,JAIPUR,MUMBAI,24321,24658,JAIPUR-MUMBAI,48979,All
2021,9,JAIPUR,MUMBAI,24031,25655,JAIPUR-MUMBAI,49686,All
2021,10,JAIPUR,MUMBAI,32010,39838,JAIPUR-MUMBAI,71848,All
2021,11,JAIPUR,MUMBAI,49702,52767,JAIPUR-MUMBAI,102469,All
2021,12,JAIPUR,MUMBAI,52119,50404,JAIPUR-MUMBAI,102523,All
2022,1,JAIPUR,MUMBAI,27982,28823,JAIPUR-MUMBAI,56805,All
2022,2,JAIPUR,MUMBAI,42098,44470,JAIPUR-MUMBAI,86568,All
2022,3,JAIPUR,MUMBAI,46756,47522,JAIPUR-MUMBAI,94278,All
2022,4,JAIPUR,MUMBAI,36418,41061,JAIPUR-MUMBAI,77479,All
2022,5,JAIPUR,MUMBAI,38547,35855,JAIPUR-MUMBAI,74402,All
2022,6,JAIPUR,MUMBAI,33244,30957,JAIPUR-MUMBAI,64201,All
2022,7,JAIPUR,MUMBAI,31404,31797,JAIPUR-MUMBAI,63201,All
2022,8,JAIPUR,MUMBAI,34457,35110,JAIPUR-MUMBAI,69567,All
2022,9,JAIPUR,MUMBAI,34138,36025,JAIPUR-MUMBAI,70163,All
2022,10,JAIPUR,MUMBAI,35935,44903,JAIPUR-MUMBAI,80838,All
2022,11,JAIPUR,MUMBAI,55813,51355,JAIPUR-MUMBAI,107168,All
2022,12,JAIPUR,MUMBAI,62357,61204,JAIPUR-MUMBAI,123561,All
2023,11,JAIPUR,MUMBAI,51548,59320,JAIPUR-MUMBAI,110868,All
2023,12,JAIPUR,MUMBAI,63466,58527,JAIPUR-MUMBAI,121993,All
2024,1,JAIPUR,MUMBAI,61338,61741,JAIPUR-MUMBAI,123079,All
2024,2,JAIPUR,MUMBAI,55401,54715,JAIPUR-MUMBAI,110116,All
2024,3,JAIPUR,MUMBAI,55506,53088,JAIPUR-MUMBAI,108594,All
2024,4,JAIPUR,MUMBAI,48523,52704,JAIPUR-MUMBAI,101227,All
2024,6,JAIPUR,MUMBAI,53284,45160,JAIPUR-MUMBAI,98444,All
2024,7,JAIPUR,MUMBAI,52528,52166,JAIPUR-MUMBAI,104694,All
2024,8,JAIPUR,MUMBAI,51462,50661,JAIPUR-MUMBAI,102123,All
2024,9,JAIPUR,MUMBAI,50570,50256,JAIPUR-MUMBAI,100826,All
2024,10,JAIPUR,MUMBAI,39244,51773,JAIPUR-MUMBAI,91017,All
2024,11,JAIPUR,MUMBAI,56044,53836,JAIPUR-MUMBAI,109880,All
2024,12,JAIPUR,MUMBAI,55255,52583,JAIPUR-MUMBAI,107838,All
2025,1,JAIPUR,MUMBAI,50064,51485,JAIPUR-MUMBAI,101549,All
2025,2,JAIPUR,MUMBAI,47740,49073,JAIPUR-MUMBAI,96813,All
2025,3,JAIPUR,MUMBAI,47862,47785,JAIPUR-MUMBAI,95647,All
2019,3,JAIPUR,NAGPUR,78,169,JAIPUR-NAGPUR,247,All
2019,5,JAIPUR,NAGPUR,34,0,JAIPUR-NAGPUR,34,All
2019,6,JAIPUR,NAGPUR,69,0,JAIPUR-NAGPUR,69,All
2019,7,JAIPUR,NAGPUR,57,0,JAIPUR-NAGPUR,57,All
2019,8,JAIPUR,NAGPUR,98,0,JAIPUR-NAGPUR,98,All
2019,9,JAIPUR,NAGPUR,54,0,JAIPUR-NAGPUR,54,All
2019,10,JAIPUR,NAGPUR,55,0,JAIPUR-NAGPUR,55,All
2019,11,JAIPUR,NAGPUR,40,0,JAIPUR-NAGPUR,40,All
2019,12,JAIPUR,NAGPUR,57,0,JAIPUR-NAGPUR,57,All
2020,9,JAIPUR,NAGPUR,243,0,JAIPUR-NAGPUR,243,All
2020,10,JAIPUR,NAGPUR,318,0,JAIPUR-NAGPUR,318,All
2020,11,JAIPUR,NAGPUR,61,63,JAIPUR-NAGPUR,124,All
2020,12,JAIPUR,NAGPUR,139,160,JAIPUR-NAGPUR,299,All
2021,1,JAIPUR,NAGPUR,438,485,JAIPUR-NAGPUR,923,All
2021,2,JAIPUR,NAGPUR,352,463,JAIPUR-NAGPUR,815,All
2021,3,JAIPUR,NAGPUR,270,265,JAIPUR-NAGPUR,535,All
2022,1,JAIPUR,NAGPUR,22,0,JAIPUR-NAGPUR,22,All
2023,2,JAIPUR,NAGPUR,0,188,JAIPUR-NAGPUR,188,All
2023,12,JAIPUR,NAGPUR,0,1,JAIPUR-NAGPUR,1,All
2024,3,JAIPUR,NAGPUR,18,0,JAIPUR-NAGPUR,18,All
2024,10,JAIPUR,NAGPUR,111,87,JAIPUR-NAGPUR,198,All
2024,11,JAIPUR,NAGPUR,822,983,JAIPUR-NAGPUR,1805,All
2024,12,JAIPUR,NAGPUR,950,989,JAIPUR-NAGPUR,1939,All
2025,3,JAIPUR,NAGPUR,835,915,JAIPUR-NAGPUR,1750,All
2024,10,JAIPUR,NASIK,12,23,JAIPUR-NASIK,35,All
2024,11,JAIPUR,NASIK,186,201,JAIPUR-NASIK,387,All
2024,12,JAIPUR,NASIK,107,114,JAIPUR-NASIK,221,All
2025,3,JAIPUR,NASIK,247,250,JAIPUR-NASIK,497,All
2023,3,JAIPUR,PANTNAGAR,183,126,JAIPUR-PANTNAGAR,309,All
2023,4,JAIPUR,PANTNAGAR,1383,1093,JAIPUR-PANTNAGAR,2476,All
2023,5,JAIPUR,PANTNAGAR,1547,1232,JAIPUR-PANTNAGAR,2779,All
2023,6,JAIPUR,PANTNAGAR,1503,1500,JAIPUR-PANTNAGAR,3003,All
2023,7,JAIPUR,PANTNAGAR,880,881,JAIPUR-PANTNAGAR,1761,All
2023,8,JAIPUR,PANTNAGAR,946,884,JAIPUR-PANTNAGAR,1830,All
2023,9,JAIPUR,PANTNAGAR,1417,1105,JAIPUR-PANTNAGAR,2522,All
2023,10,JAIPUR,PANTNAGAR,1528,1517,JAIPUR-PANTNAGAR,3045,All
2023,11,JAIPUR,PANTNAGAR,1498,1579,JAIPUR-PANTNAGAR,3077,All
2023,12,JAIPUR,PANTNAGAR,1234,1476,JAIPUR-PANTNAGAR,2710,All
2024,2,JAIPUR,PANTNAGAR,1163,1088,JAIPUR-PANTNAGAR,2251,All
2024,3,JAIPUR,PANTNAGAR,1868,1786,JAIPUR-PANTNAGAR,3654,All
2017,10,JAIPUR,PATNA,0,3,JAIPUR-PATNA,3,All
2018,7,JAIPUR,PATNA,0,15,JAIPUR-PATNA,15,All
2018,8,JAIPUR,PATNA,0,6,JAIPUR-PATNA,6,All
2018,9,JAIPUR,PATNA,0,50,JAIPUR-PATNA,50,All
2018,10,JAIPUR,PATNA,0,679,JAIPUR-PATNA,679,All
2020,8,JAIPUR,PATNA,244,436,JAIPUR-PATNA,680,All
2020,9,JAIPUR,PATNA,898,1292,JAIPUR-PATNA,2190,All
2020,10,JAIPUR,PATNA,978,878,JAIPUR-PATNA,1856,All
2020,11,JAIPUR,PATNA,1175,865,JAIPUR-PATNA,2040,All
2020,12,JAIPUR,PATNA,1074,1238,JAIPUR-PATNA,2312,All
2021,1,JAIPUR,PATNA,967,1135,JAIPUR-PATNA,2102,All
2021,2,JAIPUR,PATNA,922,810,JAIPUR-PATNA,1732,All
2021,3,JAIPUR,PATNA,1127,655,JAIPUR-PATNA,1782,All
2022,3,JAIPUR,PATNA,304,414,JAIPUR-PATNA,718,All
2022,4,JAIPUR,PATNA,3225,3103,JAIPUR-PATNA,6328,All
2022,5,JAIPUR,PATNA,1657,1776,JAIPUR-PATNA,3433,All
2022,6,JAIPUR,PATNA,370,723,JAIPUR-PATNA,1093,All
2022,7,JAIPUR,PATNA,117,153,JAIPUR-PATNA,270,All
2022,8,JAIPUR,PATNA,40,54,JAIPUR-PATNA,94,All
2022,9,JAIPUR,PATNA,0,14,JAIPUR-PATNA,14,All
2023,1,JAIPUR,PATNA,31,37,JAIPUR-PATNA,68,All
2023,2,JAIPUR,PATNA,0,2,JAIPUR-PATNA,2,All
2023,3,JAIPUR,PATNA,0,1,JAIPUR-PATNA,1,All
2023,5,JAIPUR,PATNA,47,37,JAIPUR-PATNA,84,All
2023,6,JAIPUR,PATNA,113,89,JAIPUR-PATNA,202,All
2023,7,JAIPUR,PATNA,23,48,JAIPUR-PATNA,71,All
2023,10,JAIPUR,PATNA,0,172,JAIPUR-PATNA,172,All
2024,6,JAIPUR,PATNA,0,5,JAIPUR-PATNA,5,All
2022,2,JAIPUR,PORT BLAIR,19,0,JAIPUR-PORT BLAIR,19,All
2015,4,JAIPUR,PUNE,3793,4128,JAIPUR-PUNE,7921,All
2015,5,JAIPUR,PUNE,4772,4259,JAIPUR-PUNE,9031,All
2015,6,JAIPUR,PUNE,5127,4516,JAIPUR-PUNE,9643,All
2015,7,JAIPUR,PUNE,4843,4772,JAIPUR-PUNE,9615,All
2015,8,JAIPUR,PUNE,4584,4371,JAIPUR-PUNE,8955,All
2015,9,JAIPUR,PUNE,3686,3882,JAIPUR-PUNE,7568,All
2015,10,JAIPUR,PUNE,3761,4099,JAIPUR-PUNE,7860,All
2015,11,JAIPUR,PUNE,4383,4515,JAIPUR-PUNE,8898,All
2015,12,JAIPUR,PUNE,4831,4433,JAIPUR-PUNE,9264,All
2016,1,JAIPUR,PUNE,4586,4468,JAIPUR-PUNE,9054,All
2016,2,JAIPUR,PUNE,5861,5363,JAIPUR-PUNE,11224,All
2016,3,JAIPUR,PUNE,8018,13681,JAIPUR-PUNE,21699,All
2016,4,JAIPUR,PUNE,7445,9101,JAIPUR-PUNE,16546,All
2016,5,JAIPUR,PUNE,9486,14061,JAIPUR-PUNE,23547,All
2016,6,JAIPUR,PUNE,8918,8420,JAIPUR-PUNE,17338,All
2016,7,JAIPUR,PUNE,9220,9305,JAIPUR-PUNE,18525,All
2016,8,JAIPUR,PUNE,9670,9586,JAIPUR-PUNE,19256,All
2016,9,JAIPUR,PUNE,8286,8174,JAIPUR-PUNE,16460,All
2016,10,JAIPUR,PUNE,7834,9875,JAIPUR-PUNE,17709,All
2016,11,JAIPUR,PUNE,10442,9871,JAIPUR-PUNE,20313,All
2016,12,JAIPUR,PUNE,9923,9688,JAIPUR-PUNE,19611,All
2017,1,JAIPUR,PUNE,10175,10010,JAIPUR-PUNE,20185,All
2017,2,JAIPUR,PUNE,9283,9246,JAIPUR-PUNE,18529,All
2017,3,JAIPUR,PUNE,9323,8833,JAIPUR-PUNE,18156,All
2017,4,JAIPUR,PUNE,8627,9431,JAIPUR-PUNE,18058,All
2017,5,JAIPUR,PUNE,10669,10270,JAIPUR-PUNE,20939,All
2017,6,JAIPUR,PUNE,10080,9757,JAIPUR-PUNE,19837,All
2017,7,JAIPUR,PUNE,9655,9788,JAIPUR-PUNE,19443,All
2017,8,JAIPUR,PUNE,9868,9783,JAIPUR-PUNE,19651,All
2017,9,JAIPUR,PUNE,8086,8613,JAIPUR-PUNE,16699,All
2017,10,JAIPUR,PUNE,9073,9641,JAIPUR-PUNE,18714,All
2017,11,JAIPUR,PUNE,10150,9726,JAIPUR-PUNE,19876,All
2017,12,JAIPUR,PUNE,10511,9961,JAIPUR-PUNE,20472,All
2018,1,JAIPUR,PUNE,10185,9904,JAIPUR-PUNE,20089,All
2018,2,JAIPUR,PUNE,9583,9831,JAIPUR-PUNE,19414,All
2018,3,JAIPUR,PUNE,9092,8925,JAIPUR-PUNE,18017,All
2018,4,JAIPUR,PUNE,5066,5206,JAIPUR-PUNE,10272,All
2018,5,JAIPUR,PUNE,5493,5263,JAIPUR-PUNE,10756,All
2018,6,JAIPUR,PUNE,10112,9214,JAIPUR-PUNE,19326,All
2018,7,JAIPUR,PUNE,10097,8102,JAIPUR-PUNE,18199,All
2018,8,JAIPUR,PUNE,9044,8846,JAIPUR-PUNE,17890,All
2018,9,JAIPUR,PUNE,8589,7882,JAIPUR-PUNE,16471,All
2018,10,JAIPUR,PUNE,9043,9273,JAIPUR-PUNE,18316,All
2018,11,JAIPUR,PUNE,9418,9616,JAIPUR-PUNE,19034,All
2018,12,JAIPUR,PUNE,10193,10015,JAIPUR-PUNE,20208,All
2019,1,JAIPUR,PUNE,10031,9417,JAIPUR-PUNE,19448,All
2019,2,JAIPUR,PUNE,8782,8479,JAIPUR-PUNE,17261,All
2019,3,JAIPUR,PUNE,9654,9456,JAIPUR-PUNE,19110,All
2019,4,JAIPUR,PUNE,9070,10420,JAIPUR-PUNE,19490,All
2019,5,JAIPUR,PUNE,12147,11258,JAIPUR-PUNE,23405,All
2019,6,JAIPUR,PUNE,12516,11502,JAIPUR-PUNE,24018,All
2019,7,JAIPUR,PUNE,12119,11996,JAIPUR-PUNE,24115,All
2019,8,JAIPUR,PUNE,11400,11844,JAIPUR-PUNE,23244,All
2019,9,JAIPUR,PUNE,11006,11188,JAIPUR-PUNE,22194,All
2019,10,JAIPUR,PUNE,9737,11397,JAIPUR-PUNE,21134,All
2019,11,JAIPUR,PUNE,12196,11075,JAIPUR-PUNE,23271,All
2019,12,JAIPUR,PUNE,11705,11664,JAIPUR-PUNE,23369,All
2020,1,JAIPUR,PUNE,11694,11617,JAIPUR-PUNE,23311,All
2020,2,JAIPUR,PUNE,11689,11217,JAIPUR-PUNE,22906,All
2020,3,JAIPUR,PUNE,7276,8633,JAIPUR-PUNE,15909,All
2020,5,JAIPUR,PUNE,282,1030,JAIPUR-PUNE,1312,All
2020,6,JAIPUR,PUNE,4054,6403,JAIPUR-PUNE,10457,All
2020,7,JAIPUR,PUNE,4181,6763,JAIPUR-PUNE,10944,All
2020,8,JAIPUR,PUNE,5973,4608,JAIPUR-PUNE,10581,All
2020,9,JAIPUR,PUNE,4834,4511,JAIPUR-PUNE,9345,All
2020,10,JAIPUR,PUNE,4756,5370,JAIPUR-PUNE,10126,All
2020,11,JAIPUR,PUNE,3250,4175,JAIPUR-PUNE,7425,All
2020,12,JAIPUR,PUNE,4804,4434,JAIPUR-PUNE,9238,All
2021,1,JAIPUR,PUNE,4536,5016,JAIPUR-PUNE,9552,All
2021,2,JAIPUR,PUNE,3288,3993,JAIPUR-PUNE,7281,All
2021,3,JAIPUR,PUNE,4050,4484,JAIPUR-PUNE,8534,All
2021,4,JAIPUR,PUNE,2135,3335,JAIPUR-PUNE,5470,All
2021,6,JAIPUR,PUNE,3278,2492,JAIPUR-PUNE,5770,All
2021,7,JAIPUR,PUNE,3908,3638,JAIPUR-PUNE,7546,All
2021,8,JAIPUR,PUNE,4402,4181,JAIPUR-PUNE,8583,All
2021,9,JAIPUR,PUNE,5953,5731,JAIPUR-PUNE,11684,All
2021,10,JAIPUR,PUNE,3414,4009,JAIPUR-PUNE,7423,All
2021,11,JAIPUR,PUNE,9359,9287,JAIPUR-PUNE,18646,All
2021,12,JAIPUR,PUNE,11213,8738,JAIPUR-PUNE,19951,All
2022,1,JAIPUR,PUNE,6559,5508,JAIPUR-PUNE,12067,All
2022,2,JAIPUR,PUNE,6813,6198,JAIPUR-PUNE,13011,All
2022,3,JAIPUR,PUNE,10119,8244,JAIPUR-PUNE,18363,All
2022,4,JAIPUR,PUNE,10293,9327,JAIPUR-PUNE,19620,All
2022,5,JAIPUR,PUNE,12384,9212,JAIPUR-PUNE,21596,All
2022,6,JAIPUR,PUNE,11724,8646,JAIPUR-PUNE,20370,All
2022,7,JAIPUR,PUNE,9380,8005,JAIPUR-PUNE,17385,All
2022,8,JAIPUR,PUNE,11044,9389,JAIPUR-PUNE,20433,All
2022,9,JAIPUR,PUNE,9733,8863,JAIPUR-PUNE,18596,All
2022,10,JAIPUR,PUNE,10894,11654,JAIPUR-PUNE,22548,All
2022,11,JAIPUR,PUNE,10546,9016,JAIPUR-PUNE,19562,All
2022,12,JAIPUR,PUNE,11839,10913,JAIPUR-PUNE,22752,All
2023,1,JAIPUR,PUNE,11239,10030,JAIPUR-PUNE,21269,All
2023,2,JAIPUR,PUNE,10745,8916,JAIPUR-PUNE,19661,All
2023,3,JAIPUR,PUNE,11215,9145,JAIPUR-PUNE,20360,All
2023,4,JAIPUR,PUNE,11768,11734,JAIPUR-PUNE,23502,All
2023,5,JAIPUR,PUNE,13337,12467,JAIPUR-PUNE,25804,All
2023,6,JAIPUR,PUNE,12770,11583,JAIPUR-PUNE,24353,All
2023,7,JAIPUR,PUNE,12388,11118,JAIPUR-PUNE,23506,All
2023,8,JAIPUR,PUNE,12442,11819,JAIPUR-PUNE,24261,All
2023,9,JAIPUR,PUNE,12454,11057,JAIPUR-PUNE,23511,All
2023,10,JAIPUR,PUNE,10624,10534,JAIPUR-PUNE,21158,All
2023,11,JAIPUR,PUNE,9168,9346,JAIPUR-PUNE,18514,All
2023,12,JAIPUR,PUNE,11289,10225,JAIPUR-PUNE,21514,All
2024,1,JAIPUR,PUNE,11622,11324,JAIPUR-PUNE,22946,All
2024,2,JAIPUR,PUNE,11048,10440,JAIPUR-PUNE,21488,All
2024,3,JAIPUR,PUNE,11837,11069,JAIPUR-PUNE,22906,All
2024,4,JAIPUR,PUNE,12023,10933,JAIPUR-PUNE,22956,All
2024,6,JAIPUR,PUNE,11375,9847,JAIPUR-PUNE,21222,All
2024,7,JAIPUR,PUNE,12670,11245,JAIPUR-PUNE,23915,All
2024,8,JAIPUR,PUNE,12023,10533,JAIPUR-PUNE,22556,All
2024,9,JAIPUR,PUNE,11331,10401,JAIPUR-PUNE,21732,All
2024,10,JAIPUR,PUNE,11084,12027,JAIPUR-PUNE,23111,All
2024,11,JAIPUR,PUNE,13136,12004,JAIPUR-PUNE,25140,All
2024,12,JAIPUR,PUNE,12969,12040,JAIPUR-PUNE,25009,All
2025,1,JAIPUR,PUNE,13382,14201,JAIPUR-PUNE,27583,All
2025,2,JAIPUR,PUNE,12159,12093,JAIPUR-PUNE,24252,All
2025,3,JAIPUR,PUNE,12375,11913,JAIPUR-PUNE,24288,All
2018,10,JAIPUR,RAIPUR,259,252,JAIPUR-RAIPUR,511,All
2018,11,JAIPUR,RAIPUR,281,0,JAIPUR-RAIPUR,281,All
2018,12,JAIPUR,RAIPUR,427,0,JAIPUR-RAIPUR,427,All
2019,1,JAIPUR,RAIPUR,847,392,JAIPUR-RAIPUR,1239,All
2019,2,JAIPUR,RAIPUR,788,0,JAIPUR-RAIPUR,788,All
2019,3,JAIPUR,RAIPUR,1010,391,JAIPUR-RAIPUR,1401,All
2019,4,JAIPUR,RAIPUR,299,287,JAIPUR-RAIPUR,586,All
2019,5,JAIPUR,RAIPUR,450,377,JAIPUR-RAIPUR,827,All
2019,6,JAIPUR,RAIPUR,387,365,JAIPUR-RAIPUR,752,All
2019,7,JAIPUR,RAIPUR,458,454,JAIPUR-RAIPUR,912,All
2019,8,JAIPUR,RAIPUR,422,478,JAIPUR-RAIPUR,900,All
2019,9,JAIPUR,RAIPUR,368,393,JAIPUR-RAIPUR,761,All
2019,10,JAIPUR,RAIPUR,605,694,JAIPUR-RAIPUR,1299,All
2019,11,JAIPUR,RAIPUR,525,518,JAIPUR-RAIPUR,1043,All
2019,12,JAIPUR,RAIPUR,430,328,JAIPUR-RAIPUR,758,All
2020,1,JAIPUR,RAIPUR,287,415,JAIPUR-RAIPUR,702,All
2020,2,JAIPUR,RAIPUR,300,466,JAIPUR-RAIPUR,766,All
2020,3,JAIPUR,RAIPUR,313,282,JAIPUR-RAIPUR,595,All
2021,10,JAIPUR,RAIPUR,0,33,JAIPUR-RAIPUR,33,All
2021,11,JAIPUR,RAIPUR,135,136,JAIPUR-RAIPUR,271,All
2021,12,JAIPUR,RAIPUR,91,249,JAIPUR-RAIPUR,340,All
2023,2,JAIPUR,RAIPUR,218,219,JAIPUR-RAIPUR,437,All
2023,12,JAIPUR,RAIPUR,0,22,JAIPUR-RAIPUR,22,All
2024,6,JAIPUR,RAIPUR,0,9,JAIPUR-RAIPUR,9,All
2025,3,JAIPUR,RAIPUR,0,67,JAIPUR-RAIPUR,67,All
2023,1,JAIPUR,RAJKOT,0,168,JAIPUR-RAJKOT,168,All
2023,2,JAIPUR,RAJKOT,346,75,JAIPUR-RAJKOT,421,All
2021,11,JAIPUR,RANCHI,118,0,JAIPUR-RANCHI,118,All
2023,9,JAIPUR,RANCHI,0,12,JAIPUR-RANCHI,12,All
2019,1,JAIPUR,SHIRDI,1096,700,JAIPUR-SHIRDI,1796,All
2019,2,JAIPUR,SHIRDI,1482,1002,JAIPUR-SHIRDI,2484,All
2019,3,JAIPUR,SHIRDI,1110,893,JAIPUR-SHIRDI,2003,All
2020,10,JAIPUR,SILCHAR,6,26,JAIPUR-SILCHAR,32,All
2020,11,JAIPUR,SILCHAR,87,251,JAIPUR-SILCHAR,338,All
2020,12,JAIPUR,SILCHAR,258,176,JAIPUR-SILCHAR,434,All
2021,1,JAIPUR,SILCHAR,121,210,JAIPUR-SILCHAR,331,All
2021,2,JAIPUR,SILCHAR,113,172,JAIPUR-SILCHAR,285,All
2021,3,JAIPUR,SILCHAR,73,130,JAIPUR-SILCHAR,203,All
2016,5,JAIPUR,SRINAGAR,39,73,JAIPUR-SRINAGAR,112,All
2016,6,JAIPUR,SRINAGAR,86,104,JAIPUR-SRINAGAR,190,All
2016,7,JAIPUR,SRINAGAR,40,136,JAIPUR-SRINAGAR,176,All
2016,8,JAIPUR,SRINAGAR,90,148,JAIPUR-SRINAGAR,238,All
2016,9,JAIPUR,SRINAGAR,70,0,JAIPUR-SRINAGAR,70,All
2016,10,JAIPUR,SRINAGAR,80,0,JAIPUR-SRINAGAR,80,All
2016,11,JAIPUR,SRINAGAR,69,0,JAIPUR-SRINAGAR,69,All
2016,12,JAIPUR,SRINAGAR,192,0,JAIPUR-SRINAGAR,192,All
2017,1,JAIPUR,SRINAGAR,129,0,JAIPUR-SRINAGAR,129,All
2017,2,JAIPUR,SRINAGAR,249,0,JAIPUR-SRINAGAR,249,All
2017,3,JAIPUR,SRINAGAR,217,0,JAIPUR-SRINAGAR,217,All
2017,4,JAIPUR,SRINAGAR,209,0,JAIPUR-SRINAGAR,209,All
2017,5,JAIPUR,SRINAGAR,201,0,JAIPUR-SRINAGAR,201,All
2017,6,JAIPUR,SRINAGAR,123,0,JAIPUR-SRINAGAR,123,All
2017,7,JAIPUR,SRINAGAR,65,0,JAIPUR-SRINAGAR,65,All
2017,10,JAIPUR,SRINAGAR,129,0,JAIPUR-SRINAGAR,129,All
2017,11,JAIPUR,SRINAGAR,105,0,JAIPUR-SRINAGAR,105,All
2017,12,JAIPUR,SRINAGAR,216,0,JAIPUR-SRINAGAR,216,All
2018,1,JAIPUR,SRINAGAR,123,0,JAIPUR-SRINAGAR,123,All
2018,2,JAIPUR,SRINAGAR,121,0,JAIPUR-SRINAGAR,121,All
2018,3,JAIPUR,SRINAGAR,54,0,JAIPUR-SRINAGAR,54,All
2019,10,JAIPUR,SRINAGAR,0,2,JAIPUR-SRINAGAR,2,All
2021,3,JAIPUR,SRINAGAR,294,141,JAIPUR-SRINAGAR,435,All
2021,4,JAIPUR,SRINAGAR,1069,1173,JAIPUR-SRINAGAR,2242,All
2021,6,JAIPUR,SRINAGAR,0,6,JAIPUR-SRINAGAR,6,All
2021,7,JAIPUR,SRINAGAR,0,6,JAIPUR-SRINAGAR,6,All
2023,5,JAIPUR,SRINAGAR,0,1,JAIPUR-SRINAGAR,1,All
2017,6,JAIPUR,SURAT,1910,1849,JAIPUR-SURAT,3759,All
2017,7,JAIPUR,SURAT,1394,1886,JAIPUR-SURAT,3280,All
2017,8,JAIPUR,SURAT,1918,1985,JAIPUR-SURAT,3903,All
2017,9,JAIPUR,SURAT,1753,1924,JAIPUR-SURAT,3677,All
2017,10,JAIPUR,SURAT,1752,1930,JAIPUR-SURAT,3682,All
2017,11,JAIPUR,SURAT,2146,1963,JAIPUR-SURAT,4109,All
2017,12,JAIPUR,SURAT,2027,1921,JAIPUR-SURAT,3948,All
2018,1,JAIPUR,SURAT,1877,2086,JAIPUR-SURAT,3963,All
2018,2,JAIPUR,SURAT,1586,2021,JAIPUR-SURAT,3607,All
2018,3,JAIPUR,SURAT,1358,1898,JAIPUR-SURAT,3256,All
2018,4,JAIPUR,SURAT,1636,2019,JAIPUR-SURAT,3655,All
2018,5,JAIPUR,SURAT,2033,1931,JAIPUR-SURAT,3964,All
2018,6,JAIPUR,SURAT,1844,1980,JAIPUR-SURAT,3824,All
2018,7,JAIPUR,SURAT,1876,1991,JAIPUR-SURAT,3867,All
2018,8,JAIPUR,SURAT,2609,2810,JAIPUR-SURAT,5419,All
2018,9,JAIPUR,SURAT,3263,3181,JAIPUR-SURAT,6444,All
2018,10,JAIPUR,SURAT,2636,3042,JAIPUR-SURAT,5678,All
2018,11,JAIPUR,SURAT,3362,3446,JAIPUR-SURAT,6808,All
2018,12,JAIPUR,SURAT,4035,3140,JAIPUR-SURAT,7175,All
2019,1,JAIPUR,SURAT,3809,3430,JAIPUR-SURAT,7239,All
2019,2,JAIPUR,SURAT,3822,3484,JAIPUR-SURAT,7306,All
2019,3,JAIPUR,SURAT,3673,3394,JAIPUR-SURAT,7067,All
2019,4,JAIPUR,SURAT,3665,3697,JAIPUR-SURAT,7362,All
2019,5,JAIPUR,SURAT,4373,4161,JAIPUR-SURAT,8534,All
2019,6,JAIPUR,SURAT,4076,3581,JAIPUR-SURAT,7657,All
2019,7,JAIPUR,SURAT,3472,3327,JAIPUR-SURAT,6799,All
2019,8,JAIPUR,SURAT,3277,3128,JAIPUR-SURAT,6405,All
2019,9,JAIPUR,SURAT,3247,3211,JAIPUR-SURAT,6458,All
2019,10,JAIPUR,SURAT,3080,3524,JAIPUR-SURAT,6604,All
2019,11,JAIPUR,SURAT,4115,3579,JAIPUR-SURAT,7694,All
2019,12,JAIPUR,SURAT,4246,3299,JAIPUR-SURAT,7545,All
2020,1,JAIPUR,SURAT,4154,4219,JAIPUR-SURAT,8373,All
2020,2,JAIPUR,SURAT,3962,4142,JAIPUR-SURAT,8104,All
2020,3,JAIPUR,SURAT,2545,2669,JAIPUR-SURAT,5214,All
2020,8,JAIPUR,SURAT,0,3,JAIPUR-SURAT,3,All
2020,11,JAIPUR,SURAT,468,452,JAIPUR-SURAT,920,All
2020,12,JAIPUR,SURAT,2194,2063,JAIPUR-SURAT,4257,All
2021,1,JAIPUR,SURAT,2015,2231,JAIPUR-SURAT,4246,All
2021,2,JAIPUR,SURAT,2675,2867,JAIPUR-SURAT,5542,All
2021,3,JAIPUR,SURAT,2437,2749,JAIPUR-SURAT,5186,All
2021,4,JAIPUR,SURAT,573,599,JAIPUR-SURAT,1172,All
2021,7,JAIPUR,SURAT,783,827,JAIPUR-SURAT,1610,All
2021,8,JAIPUR,SURAT,1570,1616,JAIPUR-SURAT,3186,All
2021,9,JAIPUR,SURAT,1470,1441,JAIPUR-SURAT,2911,All
2021,10,JAIPUR,SURAT,1563,1890,JAIPUR-SURAT,3453,All
2021,11,JAIPUR,SURAT,4153,3594,JAIPUR-SURAT,7747,All
2021,12,JAIPUR,SURAT,5697,4366,JAIPUR-SURAT,10063,All
2022,1,JAIPUR,SURAT,2788,2544,JAIPUR-SURAT,5332,All
2022,2,JAIPUR,SURAT,2057,2095,JAIPUR-SURAT,4152,All
2022,3,JAIPUR,SURAT,2989,2837,JAIPUR-SURAT,5826,All
2022,4,JAIPUR,SURAT,2687,2851,JAIPUR-SURAT,5538,All
2022,5,JAIPUR,SURAT,3304,2780,JAIPUR-SURAT,6084,All
2022,6,JAIPUR,SURAT,2142,1662,JAIPUR-SURAT,3804,All
2022,7,JAIPUR,SURAT,1877,1902,JAIPUR-SURAT,3779,All
2022,8,JAIPUR,SURAT,3265,3229,JAIPUR-SURAT,6494,All
2022,9,JAIPUR,SURAT,2715,2999,JAIPUR-SURAT,5714,All
2022,10,JAIPUR,SURAT,3208,4001,JAIPUR-SURAT,7209,All
2022,11,JAIPUR,SURAT,4455,3822,JAIPUR-SURAT,8277,All
2022,12,JAIPUR,SURAT,5016,4893,JAIPUR-SURAT,9909,All
2023,1,JAIPUR,SURAT,4055,4509,JAIPUR-SURAT,8564,All
2023,2,JAIPUR,SURAT,3494,3805,JAIPUR-SURAT,7299,All
2023,3,JAIPUR,SURAT,2696,3042,JAIPUR-SURAT,5738,All
2023,4,JAIPUR,SURAT,3140,3608,JAIPUR-SURAT,6748,All
2023,5,JAIPUR,SURAT,4366,4324,JAIPUR-SURAT,8690,All
2023,6,JAIPUR,SURAT,4156,3453,JAIPUR-SURAT,7609,All
2023,7,JAIPUR,SURAT,3734,3248,JAIPUR-SURAT,6982,All
2023,8,JAIPUR,SURAT,3875,3831,JAIPUR-SURAT,7706,All
2023,9,JAIPUR,SURAT,3965,3929,JAIPUR-SURAT,7894,All
2023,10,JAIPUR,SURAT,4250,4308,JAIPUR-SURAT,8558,All
2023,11,JAIPUR,SURAT,5333,6425,JAIPUR-SURAT,11758,All
2023,12,JAIPUR,SURAT,7027,6842,JAIPUR-SURAT,13869,All
2024,1,JAIPUR,SURAT,6943,7327,JAIPUR-SURAT,14270,All
2024,2,JAIPUR,SURAT,4755,4785,JAIPUR-SURAT,9540,All
2024,3,JAIPUR,SURAT,5450,5270,JAIPUR-SURAT,10720,All
2024,4,JAIPUR,SURAT,4521,4791,JAIPUR-SURAT,9312,All
2024,6,JAIPUR,SURAT,4211,4027,JAIPUR-SURAT,8238,All
2024,7,JAIPUR,SURAT,3960,3835,JAIPUR-SURAT,7795,All
2024,8,JAIPUR,SURAT,3876,3929,JAIPUR-SURAT,7805,All
2024,9,JAIPUR,SURAT,3699,3380,JAIPUR-SURAT,7079,All
2024,10,JAIPUR,SURAT,3305,4136,JAIPUR-SURAT,7441,All
2024,11,JAIPUR,SURAT,5478,5492,JAIPUR-SURAT,10970,All
2024,12,JAIPUR,SURAT,5931,5720,JAIPUR-SURAT,11651,All
2025,1,JAIPUR,SURAT,4944,5169,JAIPUR-SURAT,10113,All
2025,2,JAIPUR,SURAT,4996,5447,JAIPUR-SURAT,10443,All
2025,3,JAIPUR,SURAT,4577,4823,JAIPUR-SURAT,9400,All
2023,11,JAIPUR,TIRUPATI,0,16,JAIPUR-TIRUPATI,16,All
2023,12,JAIPUR,TIRUPATI,0,23,JAIPUR-TIRUPATI,23,All
2015,7,JAIPUR,UDAIPUR,515,482,JAIPUR-UDAIPUR,997,All
2015,8,JAIPUR,UDAIPUR,924,946,JAIPUR-UDAIPUR,1870,All
2015,9,JAIPUR,UDAIPUR,1048,1105,JAIPUR-UDAIPUR,2153,All
2015,10,JAIPUR,UDAIPUR,1188,989,JAIPUR-UDAIPUR,2177,All
2015,11,JAIPUR,UDAIPUR,1759,1474,JAIPUR-UDAIPUR,3233,All
2015,12,JAIPUR,UDAIPUR,1972,1811,JAIPUR-UDAIPUR,3783,All
2016,1,JAIPUR,UDAIPUR,1675,1460,JAIPUR-UDAIPUR,3135,All
2016,2,JAIPUR,UDAIPUR,1831,1580,JAIPUR-UDAIPUR,3411,All
2016,3,JAIPUR,UDAIPUR,1926,1661,JAIPUR-UDAIPUR,3587,All
2016,4,JAIPUR,UDAIPUR,1828,1473,JAIPUR-UDAIPUR,3301,All
2016,5,JAIPUR,UDAIPUR,1534,1406,JAIPUR-UDAIPUR,2940,All
2016,6,JAIPUR,UDAIPUR,1247,1165,JAIPUR-UDAIPUR,2412,All
2016,7,JAIPUR,UDAIPUR,1610,1301,JAIPUR-UDAIPUR,2911,All
2016,8,JAIPUR,UDAIPUR,1701,1473,JAIPUR-UDAIPUR,3174,All
2016,9,JAIPUR,UDAIPUR,1716,1567,JAIPUR-UDAIPUR,3283,All
2016,10,JAIPUR,UDAIPUR,2818,2573,JAIPUR-UDAIPUR,5391,All
2016,11,JAIPUR,UDAIPUR,2566,2304,JAIPUR-UDAIPUR,4870,All
2016,12,JAIPUR,UDAIPUR,2141,1915,JAIPUR-UDAIPUR,4056,All
2017,1,JAIPUR,UDAIPUR,2124,1875,JAIPUR-UDAIPUR,3999,All
2017,2,JAIPUR,UDAIPUR,2023,1816,JAIPUR-UDAIPUR,3839,All
2017,3,JAIPUR,UDAIPUR,1904,1603,JAIPUR-UDAIPUR,3507,All
2017,4,JAIPUR,UDAIPUR,1641,1279,JAIPUR-UDAIPUR,2920,All
2017,5,JAIPUR,UDAIPUR,1524,1303,JAIPUR-UDAIPUR,2827,All
2017,6,JAIPUR,UDAIPUR,1387,1329,JAIPUR-UDAIPUR,2716,All
2017,7,JAIPUR,UDAIPUR,2186,2052,JAIPUR-UDAIPUR,4238,All
2017,8,JAIPUR,UDAIPUR,2469,2394,JAIPUR-UDAIPUR,4863,All
2017,9,JAIPUR,UDAIPUR,2515,2246,JAIPUR-UDAIPUR,4761,All
2017,10,JAIPUR,UDAIPUR,3842,3353,JAIPUR-UDAIPUR,7195,All
2017,11,JAIPUR,UDAIPUR,5182,4575,JAIPUR-UDAIPUR,9757,All
2017,12,JAIPUR,UDAIPUR,5423,5120,JAIPUR-UDAIPUR,10543,All
2018,1,JAIPUR,UDAIPUR,5442,5066,JAIPUR-UDAIPUR,10508,All
2018,2,JAIPUR,UDAIPUR,5005,6454,JAIPUR-UDAIPUR,11459,All
2018,3,JAIPUR,UDAIPUR,4221,6356,JAIPUR-UDAIPUR,10577,All
2018,4,JAIPUR,UDAIPUR,4997,7121,JAIPUR-UDAIPUR,12118,All
2018,5,JAIPUR,UDAIPUR,3961,6480,JAIPUR-UDAIPUR,10441,All
2018,6,JAIPUR,UDAIPUR,3532,4816,JAIPUR-UDAIPUR,8348,All
2018,7,JAIPUR,UDAIPUR,5240,5948,JAIPUR-UDAIPUR,11188,All
2018,8,JAIPUR,UDAIPUR,5854,6573,JAIPUR-UDAIPUR,12427,All
2018,9,JAIPUR,UDAIPUR,6161,6191,JAIPUR-UDAIPUR,12352,All
2018,10,JAIPUR,UDAIPUR,5804,6115,JAIPUR-UDAIPUR,11919,All
2018,11,JAIPUR,UDAIPUR,6446,5383,JAIPUR-UDAIPUR,11829,All
2018,12,JAIPUR,UDAIPUR,6397,5772,JAIPUR-UDAIPUR,12169,All
2019,1,JAIPUR,UDAIPUR,5829,5892,JAIPUR-UDAIPUR,11721,All
2019,2,JAIPUR,UDAIPUR,4813,4454,JAIPUR-UDAIPUR,9267,All
2019,3,JAIPUR,UDAIPUR,4943,4953,JAIPUR-UDAIPUR,9896,All
2019,4,JAIPUR,UDAIPUR,1315,1258,JAIPUR-UDAIPUR,2573,All
2019,5,JAIPUR,UDAIPUR,2475,2524,JAIPUR-UDAIPUR,4999,All
2019,6,JAIPUR,UDAIPUR,2354,2296,JAIPUR-UDAIPUR,4650,All
2019,7,JAIPUR,UDAIPUR,2515,2375,JAIPUR-UDAIPUR,4890,All
2019,8,JAIPUR,UDAIPUR,2494,2411,JAIPUR-UDAIPUR,4905,All
2019,9,JAIPUR,UDAIPUR,2587,2481,JAIPUR-UDAIPUR,5068,All
2019,10,JAIPUR,UDAIPUR,3004,2874,JAIPUR-UDAIPUR,5878,All
2019,11,JAIPUR,UDAIPUR,2959,2983,JAIPUR-UDAIPUR,5942,All
2019,12,JAIPUR,UDAIPUR,2954,2834,JAIPUR-UDAIPUR,5788,All
2020,1,JAIPUR,UDAIPUR,2862,2530,JAIPUR-UDAIPUR,5392,All
2020,2,JAIPUR,UDAIPUR,2623,2495,JAIPUR-UDAIPUR,5118,All
2020,3,JAIPUR,UDAIPUR,1423,1462,JAIPUR-UDAIPUR,2885,All
2020,9,JAIPUR,UDAIPUR,6,0,JAIPUR-UDAIPUR,6,All
2020,10,JAIPUR,UDAIPUR,14,4,JAIPUR-UDAIPUR,18,All
2021,1,JAIPUR,UDAIPUR,0,8,JAIPUR-UDAIPUR,8,All
2021,2,JAIPUR,UDAIPUR,1196,1214,JAIPUR-UDAIPUR,2410,All
2021,3,JAIPUR,UDAIPUR,1297,1345,JAIPUR-UDAIPUR,2642,All
2021,4,JAIPUR,UDAIPUR,91,86,JAIPUR-UDAIPUR,177,All
2021,7,JAIPUR,UDAIPUR,460,369,JAIPUR-UDAIPUR,829,All
2021,8,JAIPUR,UDAIPUR,1631,1333,JAIPUR-UDAIPUR,2964,All
2021,9,JAIPUR,UDAIPUR,1711,1684,JAIPUR-UDAIPUR,3395,All
2021,10,JAIPUR,UDAIPUR,1894,1890,JAIPUR-UDAIPUR,3784,All
2021,11,JAIPUR,UDAIPUR,2880,2851,JAIPUR-UDAIPUR,5731,All
2021,12,JAIPUR,UDAIPUR,3895,3945,JAIPUR-UDAIPUR,7840,All
2022,1,JAIPUR,UDAIPUR,1157,1333,JAIPUR-UDAIPUR,2490,All
2022,2,JAIPUR,UDAIPUR,2282,2295,JAIPUR-UDAIPUR,4577,All
2022,3,JAIPUR,UDAIPUR,2778,2629,JAIPUR-UDAIPUR,5407,All
2022,6,JAIPUR,UDAIPUR,1147,1159,JAIPUR-UDAIPUR,2306,All
2022,7,JAIPUR,UDAIPUR,965,791,JAIPUR-UDAIPUR,1756,All
2022,8,JAIPUR,UDAIPUR,1714,2272,JAIPUR-UDAIPUR,3986,All
2022,9,JAIPUR,UDAIPUR,2037,1646,JAIPUR-UDAIPUR,3683,All
2022,10,JAIPUR,UDAIPUR,2861,2260,JAIPUR-UDAIPUR,5121,All
2022,11,JAIPUR,UDAIPUR,2411,2148,JAIPUR-UDAIPUR,4559,All
2022,12,JAIPUR,UDAIPUR,3563,3386,JAIPUR-UDAIPUR,6949,All
2023,1,JAIPUR,UDAIPUR,2855,2778,JAIPUR-UDAIPUR,5633,All
2023,2,JAIPUR,UDAIPUR,2112,2193,JAIPUR-UDAIPUR,4305,All
2023,3,JAIPUR,UDAIPUR,2105,2047,JAIPUR-UDAIPUR,4152,All
2023,4,JAIPUR,UDAIPUR,1828,1959,JAIPUR-UDAIPUR,3787,All
2023,5,JAIPUR,UDAIPUR,2022,2067,JAIPUR-UDAIPUR,4089,All
2023,6,JAIPUR,UDAIPUR,2046,1994,JAIPUR-UDAIPUR,4040,All
2023,7,JAIPUR,UDAIPUR,2144,1952,JAIPUR-UDAIPUR,4096,All
2023,8,JAIPUR,UDAIPUR,2109,2023,JAIPUR-UDAIPUR,4132,All
2023,9,JAIPUR,UDAIPUR,2040,1784,JAIPUR-UDAIPUR,3824,All
2023,10,JAIPUR,UDAIPUR,1839,1894,JAIPUR-UDAIPUR,3733,All
2023,11,JAIPUR,UDAIPUR,3635,3596,JAIPUR-UDAIPUR,7231,All
2023,12,JAIPUR,UDAIPUR,3990,3856,JAIPUR-UDAIPUR,7846,All
2024,1,JAIPUR,UDAIPUR,3400,3451,JAIPUR-UDAIPUR,6851,All
2024,2,JAIPUR,UDAIPUR,3777,3951,JAIPUR-UDAIPUR,7728,All
2024,3,JAIPUR,UDAIPUR,4097,3919,JAIPUR-UDAIPUR,8016,All
2024,4,JAIPUR,UDAIPUR,3125,3088,JAIPUR-UDAIPUR,6213,All
2024,6,JAIPUR,UDAIPUR,3062,2757,JAIPUR-UDAIPUR,5819,All
2024,7,JAIPUR,UDAIPUR,3486,3503,JAIPUR-UDAIPUR,6989,All
2024,8,JAIPUR,UDAIPUR,3345,3560,JAIPUR-UDAIPUR,6905,All
2024,9,JAIPUR,UDAIPUR,3439,3653,JAIPUR-UDAIPUR,7092,All
2024,10,JAIPUR,UDAIPUR,3757,3943,JAIPUR-UDAIPUR,7700,All
2024,11,JAIPUR,UDAIPUR,4004,4002,JAIPUR-UDAIPUR,8006,All
2024,12,JAIPUR,UDAIPUR,4236,4297,JAIPUR-UDAIPUR,8533,All
2025,1,JAIPUR,UDAIPUR,3489,3544,JAIPUR-UDAIPUR,7033,All
2025,2,JAIPUR,UDAIPUR,4156,4044,JAIPUR-UDAIPUR,8200,All
2025,3,JAIPUR,UDAIPUR,3981,3948,JAIPUR-UDAIPUR,7929,All
2020,3,JAIPUR,VADODARA,0,9,JAIPUR-VADODARA,9,All
2020,6,JAIPUR,VADODARA,3,0,JAIPUR-VADODARA,3,All
2022,3,JAIPUR,VADODARA,1167,1259,JAIPUR-VADODARA,2426,All
2022,4,JAIPUR,VADODARA,737,940,JAIPUR-VADODARA,1677,All
2022,5,JAIPUR,VADODARA,317,202,JAIPUR-VADODARA,519,All
2022,6,JAIPUR,VADODARA,259,182,JAIPUR-VADODARA,441,All
2022,7,JAIPUR,VADODARA,434,236,JAIPUR-VADODARA,670,All
2022,8,JAIPUR,VADODARA,216,168,JAIPUR-VADODARA,384,All
2022,9,JAIPUR,VADODARA,200,181,JAIPUR-VADODARA,381,All
2022,10,JAIPUR,VADODARA,208,191,JAIPUR-VADODARA,399,All
2025,3,JAIPUR,VADODARA,8,0,JAIPUR-VADODARA,8,All
2017,10,JAIPUR,VARANASI,176,227,JAIPUR-VARANASI,403,All
2017,11,JAIPUR,VARANASI,2186,2211,JAIPUR-VARANASI,4397,All
2017,12,JAIPUR,VARANASI,2104,2152,JAIPUR-VARANASI,4256,All
2018,1,JAIPUR,VARANASI,2258,1904,JAIPUR-VARANASI,4162,All
2018,2,JAIPUR,VARANASI,2159,1842,JAIPUR-VARANASI,4001,All
2018,3,JAIPUR,VARANASI,2286,2019,JAIPUR-VARANASI,4305,All
2018,4,JAIPUR,VARANASI,2255,2192,JAIPUR-VARANASI,4447,All
2018,5,JAIPUR,VARANASI,2241,2350,JAIPUR-VARANASI,4591,All
2018,6,JAIPUR,VARANASI,2221,2267,JAIPUR-VARANASI,4488,All
2018,7,JAIPUR,VARANASI,2094,2345,JAIPUR-VARANASI,4439,All
2018,8,JAIPUR,VARANASI,2669,2687,JAIPUR-VARANASI,5356,All
2018,9,JAIPUR,VARANASI,3797,3957,JAIPUR-VARANASI,7754,All
2018,10,JAIPUR,VARANASI,3716,3903,JAIPUR-VARANASI,7619,All
2018,11,JAIPUR,VARANASI,4349,4513,JAIPUR-VARANASI,8862,All
2018,12,JAIPUR,VARANASI,4084,4658,JAIPUR-VARANASI,8742,All
2019,1,JAIPUR,VARANASI,5101,5293,JAIPUR-VARANASI,10394,All
2019,2,JAIPUR,VARANASI,6730,6660,JAIPUR-VARANASI,13390,All
2019,3,JAIPUR,VARANASI,6729,7234,JAIPUR-VARANASI,13963,All
2019,4,JAIPUR,VARANASI,2554,2475,JAIPUR-VARANASI,5029,All
2019,5,JAIPUR,VARANASI,2471,2399,JAIPUR-VARANASI,4870,All
2019,6,JAIPUR,VARANASI,2410,2782,JAIPUR-VARANASI,5192,All
2019,7,JAIPUR,VARANASI,1701,2180,JAIPUR-VARANASI,3881,All
2019,8,JAIPUR,VARANASI,2313,2562,JAIPUR-VARANASI,4875,All
2019,9,JAIPUR,VARANASI,2001,2004,JAIPUR-VARANASI,4005,All
2019,10,JAIPUR,VARANASI,3131,2846,JAIPUR-VARANASI,5977,All
2019,11,JAIPUR,VARANASI,4614,4622,JAIPUR-VARANASI,9236,All
2019,12,JAIPUR,VARANASI,4651,4753,JAIPUR-VARANASI,9404,All
2020,1,JAIPUR,VARANASI,4343,4575,JAIPUR-VARANASI,8918,All
2020,2,JAIPUR,VARANASI,4753,4558,JAIPUR-VARANASI,9311,All
2020,3,JAIPUR,VARANASI,3761,3033,JAIPUR-VARANASI,6794,All
2020,5,JAIPUR,VARANASI,311,148,JAIPUR-VARANASI,459,All
2020,6,JAIPUR,VARANASI,1811,845,JAIPUR-VARANASI,2656,All
2020,7,JAIPUR,VARANASI,829,831,JAIPUR-VARANASI,1660,All
2020,8,JAIPUR,VARANASI,723,1127,JAIPUR-VARANASI,1850,All
2020,9,JAIPUR,VARANASI,845,997,JAIPUR-VARANASI,1842,All
2020,10,JAIPUR,VARANASI,879,911,JAIPUR-VARANASI,1790,All
2020,11,JAIPUR,VARANASI,1121,1052,JAIPUR-VARANASI,2173,All
2020,12,JAIPUR,VARANASI,1150,1298,JAIPUR-VARANASI,2448,All
2021,1,JAIPUR,VARANASI,1271,1352,JAIPUR-VARANASI,2623,All
2021,2,JAIPUR,VARANASI,1253,1135,JAIPUR-VARANASI,2388,All
2021,3,JAIPUR,VARANASI,1232,1173,JAIPUR-VARANASI,2405,All
2021,10,JAIPUR,VARANASI,30,20,JAIPUR-VARANASI,50,All
2022,3,JAIPUR,VARANASI,312,383,JAIPUR-VARANASI,695,All
2022,4,JAIPUR,VARANASI,1608,1383,JAIPUR-VARANASI,2991,All
2022,5,JAIPUR,VARANASI,1433,1234,JAIPUR-VARANASI,2667,All
2022,6,JAIPUR,VARANASI,1019,1282,JAIPUR-VARANASI,2301,All
2022,7,JAIPUR,VARANASI,864,848,JAIPUR-VARANASI,1712,All
2022,8,JAIPUR,VARANASI,770,774,JAIPUR-VARANASI,1544,All
2022,9,JAIPUR,VARANASI,727,487,JAIPUR-VARANASI,1214,All
2022,10,JAIPUR,VARANASI,560,441,JAIPUR-VARANASI,1001,All
2023,8,JAIPUR,VARANASI,108,60,JAIPUR-VARANASI,168,All
2023,9,JAIPUR,VARANASI,235,107,JAIPUR-VARANASI,342,All
2023,10,JAIPUR,VARANASI,382,269,JAIPUR-VARANASI,651,All
2023,11,JAIPUR,VARANASI,2459,2251,JAIPUR-VARANASI,4710,All
2023,12,JAIPUR,VARANASI,2347,2355,JAIPUR-VARANASI,4702,All
2024,1,JAIPUR,VARANASI,2533,2538,JAIPUR-VARANASI,5071,All
2024,11,JAIPUR,VARANASI,282,327,JAIPUR-VARANASI,609,All
2024,12,JAIPUR,VARANASI,1446,1555,JAIPUR-VARANASI,3001,All
2025,1,JAIPUR,VARANASI,1714,1813,JAIPUR-VARANASI,3527,All
2025,2,JAIPUR,VARANASI,1617,1661,JAIPUR-VARANASI,3278,All
2025,3,JAIPUR,VARANASI,992,869,JAIPUR-VARANASI,1861,All
2018,10,JAIPUR,VISAKHAPATNAM,5,0,JAIPUR-VISAKHAPATNAM,5,All
2018,11,JAIPUR,VISAKHAPATNAM,65,0,JAIPUR-VISAKHAPATNAM,65,All
2018,12,JAIPUR,VISAKHAPATNAM,145,0,JAIPUR-VISAKHAPATNAM,145,All
2019,1,JAIPUR,VISAKHAPATNAM,37,0,JAIPUR-VISAKHAPATNAM,37,All
2019,2,JAIPUR,VISAKHAPATNAM,78,0,JAIPUR-VISAKHAPATNAM,78,All
2025,3,JAISALMER,Ayodhya International Airport ,13,0,Ayodhya International Airport -JAISALMER,13,All
2023,11,JAISALMER,JODHPUR,0,2,JAISALMER-JODHPUR,2,All
2019,11,JAISALMER,LEH,0,1,JAISALMER-LEH,1,All
2019,12,JAISALMER,LEH,0,5,JAISALMER-LEH,5,All
2020,1,JAISALMER,LEH,0,9,JAISALMER-LEH,9,All
2020,2,JAISALMER,LEH,0,9,JAISALMER-LEH,9,All
2019,10,JAISALMER,MUMBAI,702,820,JAISALMER-MUMBAI,1522,All
2019,11,JAISALMER,MUMBAI,4171,3992,JAISALMER-MUMBAI,8163,All
2019,12,JAISALMER,MUMBAI,4922,4961,JAISALMER-MUMBAI,9883,All
2020,1,JAISALMER,MUMBAI,4550,4724,JAISALMER-MUMBAI,9274,All
2020,2,JAISALMER,MUMBAI,4067,4176,JAISALMER-MUMBAI,8243,All
2020,3,JAISALMER,MUMBAI,1430,1215,JAISALMER-MUMBAI,2645,All
2020,10,JAISALMER,MUMBAI,29,46,JAISALMER-MUMBAI,75,All
2020,11,JAISALMER,MUMBAI,911,958,JAISALMER-MUMBAI,1869,All
2020,12,JAISALMER,MUMBAI,1399,1297,JAISALMER-MUMBAI,2696,All
2021,1,JAISALMER,MUMBAI,312,182,JAISALMER-MUMBAI,494,All
2021,10,JAISALMER,MUMBAI,59,166,JAISALMER-MUMBAI,225,All
2021,11,JAISALMER,MUMBAI,2099,1840,JAISALMER-MUMBAI,3939,All
2021,12,JAISALMER,MUMBAI,4041,4099,JAISALMER-MUMBAI,8140,All
2022,1,JAISALMER,MUMBAI,1084,764,JAISALMER-MUMBAI,1848,All
2022,2,JAISALMER,MUMBAI,214,179,JAISALMER-MUMBAI,393,All
2022,3,JAISALMER,MUMBAI,75,92,JAISALMER-MUMBAI,167,All
2022,10,JAISALMER,MUMBAI,378,273,JAISALMER-MUMBAI,651,All
2022,11,JAISALMER,MUMBAI,3704,2862,JAISALMER-MUMBAI,6566,All
2022,12,JAISALMER,MUMBAI,4128,3938,JAISALMER-MUMBAI,8066,All
2023,11,JAISALMER,MUMBAI,3555,4032,JAISALMER-MUMBAI,7587,All
2023,12,JAISALMER,MUMBAI,6083,5527,JAISALMER-MUMBAI,11610,All
2024,1,JAISALMER,MUMBAI,6172,5811,JAISALMER-MUMBAI,11983,All
2024,2,JAISALMER,MUMBAI,4781,4545,JAISALMER-MUMBAI,9326,All
2024,3,JAISALMER,MUMBAI,1965,1807,JAISALMER-MUMBAI,3772,All
2024,10,JAISALMER,MUMBAI,3017,3762,JAISALMER-MUMBAI,6779,All
2024,11,JAISALMER,MUMBAI,4942,4698,JAISALMER-MUMBAI,9640,All
2024,12,JAISALMER,MUMBAI,5161,5160,JAISALMER-MUMBAI,10321,All
2025,1,JAISALMER,MUMBAI,5152,4902,JAISALMER-MUMBAI,10054,All
2025,2,JAISALMER,MUMBAI,4667,4794,JAISALMER-MUMBAI,9461,All
2025,3,JAISALMER,MUMBAI,1808,1659,JAISALMER-MUMBAI,3467,All
2020,10,JAISALMER,PATNA,6,0,JAISALMER-PATNA,6,All
2020,11,JAISALMER,PATNA,27,0,JAISALMER-PATNA,27,All
2018,11,JAISALMER,SURAT,17,32,JAISALMER-SURAT,49,All
2018,12,JAISALMER,SURAT,1067,935,JAISALMER-SURAT,2002,All
2019,1,JAISALMER,SURAT,1179,1141,JAISALMER-SURAT,2320,All
2019,2,JAISALMER,SURAT,1080,924,JAISALMER-SURAT,2004,All
2019,3,JAISALMER,SURAT,818,610,JAISALMER-SURAT,1428,All
2019,4,JAISALMER,SURAT,158,217,JAISALMER-SURAT,375,All
2019,5,JAISALMER,SURAT,450,421,JAISALMER-SURAT,871,All
2019,6,JAISALMER,SURAT,183,172,JAISALMER-SURAT,355,All
2019,7,JAISALMER,SURAT,116,80,JAISALMER-SURAT,196,All
2019,8,JAISALMER,SURAT,582,623,JAISALMER-SURAT,1205,All
2019,9,JAISALMER,SURAT,738,829,JAISALMER-SURAT,1567,All
2019,10,JAISALMER,SURAT,1013,1277,JAISALMER-SURAT,2290,All
2019,11,JAISALMER,SURAT,1268,1051,JAISALMER-SURAT,2319,All
2019,12,JAISALMER,SURAT,1320,1379,JAISALMER-SURAT,2699,All
2020,1,JAISALMER,SURAT,1166,1233,JAISALMER-SURAT,2399,All
2020,2,JAISALMER,SURAT,1053,1132,JAISALMER-SURAT,2185,All
2020,3,JAISALMER,SURAT,443,454,JAISALMER-SURAT,897,All
2022,3,JAISALMER,SURAT,0,18,JAISALMER-SURAT,18,All
2017,12,JAISALMER,UDAIPUR,38,0,JAISALMER-UDAIPUR,38,All
2018,1,JAISALMER,UDAIPUR,113,0,JAISALMER-UDAIPUR,113,All
2018,2,JAISALMER,UDAIPUR,148,0,JAISALMER-UDAIPUR,148,All
2018,3,JAISALMER,UDAIPUR,100,0,JAISALMER-UDAIPUR,100,All
2017,11,JAISALMER,VARANASI,0,24,JAISALMER-VARANASI,24,All
2017,12,JAISALMER,VARANASI,0,53,JAISALMER-VARANASI,53,All
2018,1,JAISALMER,VARANASI,0,128,JAISALMER-VARANASI,128,All
2018,2,JAISALMER,VARANASI,0,150,JAISALMER-VARANASI,150,All
2018,3,JAISALMER,VARANASI,0,90,JAISALMER-VARANASI,90,All
2019,9,JALGAON,MUMBAI,802,293,JALGAON-MUMBAI,1095,All
2019,10,JALGAON,MUMBAI,636,443,JALGAON-MUMBAI,1079,All
2019,11,JALGAON,MUMBAI,913,215,JALGAON-MUMBAI,1128,All
2019,12,JALGAON,MUMBAI,476,570,JALGAON-MUMBAI,1046,All
2020,1,JALGAON,MUMBAI,619,831,JALGAON-MUMBAI,1450,All
2020,2,JALGAON,MUMBAI,963,801,JALGAON-MUMBAI,1764,All
2020,3,JALGAON,MUMBAI,423,391,JALGAON-MUMBAI,814,All
2020,6,JALGAON,MUMBAI,38,29,JALGAON-MUMBAI,67,All
2020,7,JALGAON,MUMBAI,20,20,JALGAON-MUMBAI,40,All
2020,9,JALGAON,MUMBAI,84,18,JALGAON-MUMBAI,102,All
2020,10,JALGAON,MUMBAI,149,112,JALGAON-MUMBAI,261,All
2020,11,JALGAON,MUMBAI,204,236,JALGAON-MUMBAI,440,All
2020,12,JALGAON,MUMBAI,226,175,JALGAON-MUMBAI,401,All
2021,1,JALGAON,MUMBAI,179,163,JALGAON-MUMBAI,342,All
2021,2,JALGAON,MUMBAI,211,188,JALGAON-MUMBAI,399,All
2021,3,JALGAON,MUMBAI,146,104,JALGAON-MUMBAI,250,All
2021,4,JALGAON,MUMBAI,107,101,JALGAON-MUMBAI,208,All
2021,6,JALGAON,MUMBAI,167,85,JALGAON-MUMBAI,252,All
2021,7,JALGAON,MUMBAI,171,159,JALGAON-MUMBAI,330,All
2021,8,JALGAON,MUMBAI,446,396,JALGAON-MUMBAI,842,All
2021,9,JALGAON,MUMBAI,331,263,JALGAON-MUMBAI,594,All
2021,10,JALGAON,MUMBAI,383,413,JALGAON-MUMBAI,796,All
2021,11,JALGAON,MUMBAI,355,332,JALGAON-MUMBAI,687,All
2021,12,JALGAON,MUMBAI,416,323,JALGAON-MUMBAI,739,All
2022,1,JALGAON,MUMBAI,485,350,JALGAON-MUMBAI,835,All
2022,2,JALGAON,MUMBAI,161,97,JALGAON-MUMBAI,258,All
2024,6,JALGAON,MUMBAI,194,141,JALGAON-MUMBAI,335,All
2024,7,JALGAON,MUMBAI,537,408,JALGAON-MUMBAI,945,All
2024,8,JALGAON,MUMBAI,661,597,JALGAON-MUMBAI,1258,All
2024,9,JALGAON,MUMBAI,500,368,JALGAON-MUMBAI,868,All
2024,10,JALGAON,MUMBAI,586,625,JALGAON-MUMBAI,1211,All
2024,11,JALGAON,MUMBAI,755,652,JALGAON-MUMBAI,1407,All
2024,12,JALGAON,MUMBAI,731,693,JALGAON-MUMBAI,1424,All
2025,1,JALGAON,MUMBAI,554,462,JALGAON-MUMBAI,1016,All
2025,2,JALGAON,MUMBAI,657,602,JALGAON-MUMBAI,1259,All
2025,3,JALGAON,MUMBAI,375,292,JALGAON-MUMBAI,667,All
2024,6,JALGAON,PUNE,731,808,JALGAON-PUNE,1539,All
2024,7,JALGAON,PUNE,687,654,JALGAON-PUNE,1341,All
2024,8,JALGAON,PUNE,885,784,JALGAON-PUNE,1669,All
2024,9,JALGAON,PUNE,877,794,JALGAON-PUNE,1671,All
2024,10,JALGAON,PUNE,768,1038,JALGAON-PUNE,1806,All
2024,11,JALGAON,PUNE,1592,1343,JALGAON-PUNE,2935,All
2024,12,JALGAON,PUNE,1826,1700,JALGAON-PUNE,3526,All
2025,1,JALGAON,PUNE,1485,1281,JALGAON-PUNE,2766,All
2025,2,JALGAON,PUNE,733,674,JALGAON-PUNE,1407,All
2025,3,JALGAON,PUNE,812,844,JALGAON-PUNE,1656,All
2018,12,JAMMU,CHENNAI,0,127,CHENNAI-JAMMU,127,All
2019,1,JAMMU,CHENNAI,0,125,CHENNAI-JAMMU,125,All
2019,2,JAMMU,CHENNAI,0,230,CHENNAI-JAMMU,230,All
2019,3,JAMMU,CHENNAI,0,50,CHENNAI-JAMMU,50,All
2025,3,JAMMU,HINDON AIRPORT,550,975,HINDON AIRPORT-JAMMU,1525,All
2017,5,JAMMU,JAIPUR,442,0,JAIPUR-JAMMU,442,All
2017,6,JAMMU,JAIPUR,561,0,JAIPUR-JAMMU,561,All
2017,7,JAMMU,JAIPUR,416,0,JAIPUR-JAMMU,416,All
2017,8,JAMMU,JAIPUR,397,0,JAIPUR-JAMMU,397,All
2017,9,JAMMU,JAIPUR,393,0,JAIPUR-JAMMU,393,All
2017,10,JAMMU,JAIPUR,1436,191,JAIPUR-JAMMU,1627,All
2018,1,JAMMU,JAIPUR,2541,2553,JAIPUR-JAMMU,5094,All
2018,2,JAMMU,JAIPUR,2100,2183,JAIPUR-JAMMU,4283,All
2018,4,JAMMU,JAIPUR,2548,1790,JAIPUR-JAMMU,4338,All
2018,5,JAMMU,JAIPUR,2475,2211,JAIPUR-JAMMU,4686,All
2018,6,JAMMU,JAIPUR,3018,2373,JAIPUR-JAMMU,5391,All
2018,7,JAMMU,JAIPUR,3139,3122,JAIPUR-JAMMU,6261,All
2018,8,JAMMU,JAIPUR,1638,1634,JAIPUR-JAMMU,3272,All
2019,1,JAMMU,JAIPUR,0,110,JAIPUR-JAMMU,110,All
2019,2,JAMMU,JAIPUR,0,316,JAIPUR-JAMMU,316,All
2019,3,JAMMU,JAIPUR,0,305,JAIPUR-JAMMU,305,All
2019,4,JAMMU,JAIPUR,0,308,JAIPUR-JAMMU,308,All
2022,3,JAMMU,KOLKATA,0,21,JAMMU-KOLKATA,21,All
2022,4,JAMMU,KOLKATA,83,204,JAMMU-KOLKATA,287,All
2022,5,JAMMU,KOLKATA,298,599,JAMMU-KOLKATA,897,All
2022,6,JAMMU,KOLKATA,0,53,JAMMU-KOLKATA,53,All
2023,7,JAMMU,KOLKATA,3,3,JAMMU-KOLKATA,6,All
2023,8,JAMMU,KOLKATA,32,19,JAMMU-KOLKATA,51,All
2023,9,JAMMU,KOLKATA,210,238,JAMMU-KOLKATA,448,All
2023,10,JAMMU,KOLKATA,125,142,JAMMU-KOLKATA,267,All
2024,4,JAMMU,KOLKATA,502,421,JAMMU-KOLKATA,923,All
2024,6,JAMMU,KOLKATA,727,790,JAMMU-KOLKATA,1517,All
2024,7,JAMMU,KOLKATA,573,880,JAMMU-KOLKATA,1453,All
2024,8,JAMMU,KOLKATA,617,967,JAMMU-KOLKATA,1584,All
2024,9,JAMMU,KOLKATA,1104,1242,JAMMU-KOLKATA,2346,All
2024,10,JAMMU,KOLKATA,1651,1465,JAMMU-KOLKATA,3116,All
2025,3,JAMMU,KOLKATA,216,214,JAMMU-KOLKATA,430,All
2015,4,JAMMU,LEH,905,795,JAMMU-LEH,1700,All
2015,5,JAMMU,LEH,1017,925,JAMMU-LEH,1942,All
2015,6,JAMMU,LEH,1006,1045,JAMMU-LEH,2051,All
2015,7,JAMMU,LEH,916,1044,JAMMU-LEH,1960,All
2015,8,JAMMU,LEH,772,1018,JAMMU-LEH,1790,All
2015,9,JAMMU,LEH,680,818,JAMMU-LEH,1498,All
2015,10,JAMMU,LEH,3017,2952,JAMMU-LEH,5969,All
2015,11,JAMMU,LEH,901,1026,JAMMU-LEH,1927,All
2015,12,JAMMU,LEH,656,959,JAMMU-LEH,1615,All
2016,1,JAMMU,LEH,882,1032,JAMMU-LEH,1914,All
2016,2,JAMMU,LEH,1063,933,JAMMU-LEH,1996,All
2016,3,JAMMU,LEH,1029,767,JAMMU-LEH,1796,All
2016,4,JAMMU,LEH,1399,1201,JAMMU-LEH,2600,All
2016,5,JAMMU,LEH,1450,1296,JAMMU-LEH,2746,All
2016,6,JAMMU,LEH,1237,1366,JAMMU-LEH,2603,All
2016,7,JAMMU,LEH,1459,1603,JAMMU-LEH,3062,All
2016,8,JAMMU,LEH,1336,1472,JAMMU-LEH,2808,All
2016,9,JAMMU,LEH,1323,1402,JAMMU-LEH,2725,All
2016,10,JAMMU,LEH,1230,1532,JAMMU-LEH,2762,All
2016,11,JAMMU,LEH,1032,1326,JAMMU-LEH,2358,All
2016,12,JAMMU,LEH,1266,1522,JAMMU-LEH,2788,All
2017,1,JAMMU,LEH,1154,1213,JAMMU-LEH,2367,All
2017,2,JAMMU,LEH,1452,1029,JAMMU-LEH,2481,All
2017,3,JAMMU,LEH,1538,1016,JAMMU-LEH,2554,All
2017,4,JAMMU,LEH,1499,1281,JAMMU-LEH,2780,All
2017,5,JAMMU,LEH,1383,1317,JAMMU-LEH,2700,All
2017,6,JAMMU,LEH,1348,1380,JAMMU-LEH,2728,All
2017,7,JAMMU,LEH,1401,1528,JAMMU-LEH,2929,All
2017,8,JAMMU,LEH,1029,1260,JAMMU-LEH,2289,All
2017,9,JAMMU,LEH,951,1099,JAMMU-LEH,2050,All
2017,10,JAMMU,LEH,1315,1224,JAMMU-LEH,2539,All
2017,11,JAMMU,LEH,4211,1315,JAMMU-LEH,5526,All
2017,12,JAMMU,LEH,4198,1631,JAMMU-LEH,5829,All
2018,1,JAMMU,LEH,4615,1233,JAMMU-LEH,5848,All
2018,2,JAMMU,LEH,1343,4845,JAMMU-LEH,6188,All
2018,3,JAMMU,LEH,1478,3432,JAMMU-LEH,4910,All
2018,4,JAMMU,LEH,1544,1390,JAMMU-LEH,2934,All
2018,5,JAMMU,LEH,1358,1170,JAMMU-LEH,2528,All
2018,6,JAMMU,LEH,1451,1534,JAMMU-LEH,2985,All
2018,7,JAMMU,LEH,1623,1633,JAMMU-LEH,3256,All
2018,8,JAMMU,LEH,1320,1409,JAMMU-LEH,2729,All
2018,9,JAMMU,LEH,1362,1459,JAMMU-LEH,2821,All
2018,10,JAMMU,LEH,1620,1491,JAMMU-LEH,3111,All
2018,11,JAMMU,LEH,4502,1400,JAMMU-LEH,5902,All
2018,12,JAMMU,LEH,4762,1642,JAMMU-LEH,6404,All
2019,1,JAMMU,LEH,5569,1371,JAMMU-LEH,6940,All
2019,2,JAMMU,LEH,1394,4407,JAMMU-LEH,5801,All
2019,3,JAMMU,LEH,1637,3606,JAMMU-LEH,5243,All
2019,4,JAMMU,LEH,1496,1360,JAMMU-LEH,2856,All
2019,5,JAMMU,LEH,1416,1375,JAMMU-LEH,2791,All
2019,6,JAMMU,LEH,1448,1494,JAMMU-LEH,2942,All
2019,7,JAMMU,LEH,1398,1446,JAMMU-LEH,2844,All
2019,8,JAMMU,LEH,1247,1438,JAMMU-LEH,2685,All
2019,9,JAMMU,LEH,1425,1570,JAMMU-LEH,2995,All
2019,10,JAMMU,LEH,1111,2123,JAMMU-LEH,3234,All
2019,11,JAMMU,LEH,1412,3978,JAMMU-LEH,5390,All
2019,12,JAMMU,LEH,1305,1471,JAMMU-LEH,2776,All
2020,1,JAMMU,LEH,1305,1339,JAMMU-LEH,2644,All
2020,2,JAMMU,LEH,1379,1213,JAMMU-LEH,2592,All
2020,3,JAMMU,LEH,1114,920,JAMMU-LEH,2034,All
2020,12,JAMMU,LEH,907,1250,JAMMU-LEH,2157,All
2021,1,JAMMU,LEH,2350,1745,JAMMU-LEH,4095,All
2021,2,JAMMU,LEH,3009,1382,JAMMU-LEH,4391,All
2021,3,JAMMU,LEH,3257,1507,JAMMU-LEH,4764,All
2021,4,JAMMU,LEH,1497,1359,JAMMU-LEH,2856,All
2021,6,JAMMU,LEH,1072,1092,JAMMU-LEH,2164,All
2021,7,JAMMU,LEH,1405,1500,JAMMU-LEH,2905,All
2021,8,JAMMU,LEH,1410,1468,JAMMU-LEH,2878,All
2021,9,JAMMU,LEH,1307,1299,JAMMU-LEH,2606,All
2021,10,JAMMU,LEH,1492,1888,JAMMU-LEH,3380,All
2021,11,JAMMU,LEH,2651,8304,JAMMU-LEH,10955,All
2021,12,JAMMU,LEH,2701,7390,JAMMU-LEH,10091,All
2022,1,JAMMU,LEH,3057,4107,JAMMU-LEH,7164,All
2022,2,JAMMU,LEH,3593,3854,JAMMU-LEH,7447,All
2022,3,JAMMU,LEH,3876,2853,JAMMU-LEH,6729,All
2022,4,JAMMU,LEH,1894,3735,JAMMU-LEH,5629,All
2022,5,JAMMU,LEH,2045,6746,JAMMU-LEH,8791,All
2022,6,JAMMU,LEH,1846,6048,JAMMU-LEH,7894,All
2022,7,JAMMU,LEH,1954,3249,JAMMU-LEH,5203,All
2022,8,JAMMU,LEH,1915,2545,JAMMU-LEH,4460,All
2022,9,JAMMU,LEH,1804,2579,JAMMU-LEH,4383,All
2022,10,JAMMU,LEH,1817,2484,JAMMU-LEH,4301,All
2022,11,JAMMU,LEH,2211,9214,JAMMU-LEH,11425,All
2022,12,JAMMU,LEH,2187,8921,JAMMU-LEH,11108,All
2023,1,JAMMU,LEH,3287,7919,JAMMU-LEH,11206,All
2023,2,JAMMU,LEH,4531,5040,JAMMU-LEH,9571,All
2023,3,JAMMU,LEH,4529,4515,JAMMU-LEH,9044,All
2023,4,JAMMU,LEH,1876,4878,JAMMU-LEH,6754,All
2023,5,JAMMU,LEH,1929,2230,JAMMU-LEH,4159,All
2023,6,JAMMU,LEH,1840,1989,JAMMU-LEH,3829,All
2023,7,JAMMU,LEH,1396,1830,JAMMU-LEH,3226,All
2023,8,JAMMU,LEH,1411,1587,JAMMU-LEH,2998,All
2023,9,JAMMU,LEH,1672,1882,JAMMU-LEH,3554,All
2023,10,JAMMU,LEH,1651,2479,JAMMU-LEH,4130,All
2023,11,JAMMU,LEH,2850,4620,JAMMU-LEH,7470,All
2023,12,JAMMU,LEH,3460,4776,JAMMU-LEH,8236,All
2024,1,JAMMU,LEH,3129,3727,JAMMU-LEH,6856,All
2024,2,JAMMU,LEH,3958,3312,JAMMU-LEH,7270,All
2024,3,JAMMU,LEH,4387,3398,JAMMU-LEH,7785,All
2024,4,JAMMU,LEH,1402,1600,JAMMU-LEH,3002,All
2024,6,JAMMU,LEH,1730,1776,JAMMU-LEH,3506,All
2024,7,JAMMU,LEH,1554,1638,JAMMU-LEH,3192,All
2024,8,JAMMU,LEH,1626,1874,JAMMU-LEH,3500,All
2024,9,JAMMU,LEH,1716,2072,JAMMU-LEH,3788,All
2024,10,JAMMU,LEH,1301,2205,JAMMU-LEH,3506,All
2024,11,JAMMU,LEH,3156,4466,JAMMU-LEH,7622,All
2024,12,JAMMU,LEH,3304,4919,JAMMU-LEH,8223,All
2025,1,JAMMU,LEH,3645,4404,JAMMU-LEH,8049,All
2025,2,JAMMU,LEH,3308,2943,JAMMU-LEH,6251,All
2025,3,JAMMU,LEH,4390,3858,JAMMU-LEH,8248,All
2017,12,JAMMU,LUCKNOW,0,444,JAMMU-LUCKNOW,444,All
2018,1,JAMMU,LUCKNOW,0,2237,JAMMU-LUCKNOW,2237,All
2018,2,JAMMU,LUCKNOW,643,2137,JAMMU-LUCKNOW,2780,All
2018,3,JAMMU,LUCKNOW,577,2769,JAMMU-LUCKNOW,3346,All
2018,4,JAMMU,LUCKNOW,712,2580,JAMMU-LUCKNOW,3292,All
2018,5,JAMMU,LUCKNOW,397,2360,JAMMU-LUCKNOW,2757,All
2018,6,JAMMU,LUCKNOW,523,2035,JAMMU-LUCKNOW,2558,All
2018,7,JAMMU,LUCKNOW,446,2571,JAMMU-LUCKNOW,3017,All
2018,8,JAMMU,LUCKNOW,695,3752,JAMMU-LUCKNOW,4447,All
2018,9,JAMMU,LUCKNOW,786,3660,JAMMU-LUCKNOW,4446,All
2018,10,JAMMU,LUCKNOW,1250,3431,JAMMU-LUCKNOW,4681,All
2018,11,JAMMU,LUCKNOW,1121,3145,JAMMU-LUCKNOW,4266,All
2018,12,JAMMU,LUCKNOW,1093,3028,JAMMU-LUCKNOW,4121,All
2019,1,JAMMU,LUCKNOW,1031,2513,JAMMU-LUCKNOW,3544,All
2019,2,JAMMU,LUCKNOW,411,2537,JAMMU-LUCKNOW,2948,All
2019,3,JAMMU,LUCKNOW,397,2995,JAMMU-LUCKNOW,3392,All
2019,4,JAMMU,LUCKNOW,393,2844,JAMMU-LUCKNOW,3237,All
2019,5,JAMMU,LUCKNOW,345,3218,JAMMU-LUCKNOW,3563,All
2019,6,JAMMU,LUCKNOW,490,3357,JAMMU-LUCKNOW,3847,All
2019,7,JAMMU,LUCKNOW,132,2601,JAMMU-LUCKNOW,2733,All
2019,8,JAMMU,LUCKNOW,158,2357,JAMMU-LUCKNOW,2515,All
2019,9,JAMMU,LUCKNOW,206,2887,JAMMU-LUCKNOW,3093,All
2019,10,JAMMU,LUCKNOW,509,3166,JAMMU-LUCKNOW,3675,All
2019,11,JAMMU,LUCKNOW,536,2759,JAMMU-LUCKNOW,3295,All
2019,12,JAMMU,LUCKNOW,377,2804,JAMMU-LUCKNOW,3181,All
2020,1,JAMMU,LUCKNOW,302,2779,JAMMU-LUCKNOW,3081,All
2020,2,JAMMU,LUCKNOW,64,3470,JAMMU-LUCKNOW,3534,All
2020,3,JAMMU,LUCKNOW,125,2591,JAMMU-LUCKNOW,2716,All
2019,5,JAMMU,MUMBAI,4401,7142,JAMMU-MUMBAI,11543,All
2019,6,JAMMU,MUMBAI,4797,6607,JAMMU-MUMBAI,11404,All
2019,7,JAMMU,MUMBAI,4367,7141,JAMMU-MUMBAI,11508,All
2019,8,JAMMU,MUMBAI,3115,6057,JAMMU-MUMBAI,9172,All
2019,9,JAMMU,MUMBAI,1614,6660,JAMMU-MUMBAI,8274,All
2019,10,JAMMU,MUMBAI,4199,8562,JAMMU-MUMBAI,12761,All
2019,11,JAMMU,MUMBAI,5399,9219,JAMMU-MUMBAI,14618,All
2019,12,JAMMU,MUMBAI,5117,11526,JAMMU-MUMBAI,16643,All
2020,1,JAMMU,MUMBAI,5046,11866,JAMMU-MUMBAI,16912,All
2020,2,JAMMU,MUMBAI,4323,10534,JAMMU-MUMBAI,14857,All
2020,3,JAMMU,MUMBAI,2968,5594,JAMMU-MUMBAI,8562,All
2020,6,JAMMU,MUMBAI,180,695,JAMMU-MUMBAI,875,All
2020,7,JAMMU,MUMBAI,317,1120,JAMMU-MUMBAI,1437,All
2020,8,JAMMU,MUMBAI,0,716,JAMMU-MUMBAI,716,All
2020,10,JAMMU,MUMBAI,774,1066,JAMMU-MUMBAI,1840,All
2020,11,JAMMU,MUMBAI,4134,4306,JAMMU-MUMBAI,8440,All
2020,12,JAMMU,MUMBAI,4281,3451,JAMMU-MUMBAI,7732,All
2021,1,JAMMU,MUMBAI,4044,4259,JAMMU-MUMBAI,8303,All
2021,2,JAMMU,MUMBAI,3764,3997,JAMMU-MUMBAI,7761,All
2021,3,JAMMU,MUMBAI,3457,3688,JAMMU-MUMBAI,7145,All
2021,4,JAMMU,MUMBAI,1826,1470,JAMMU-MUMBAI,3296,All
2021,6,JAMMU,MUMBAI,0,1344,JAMMU-MUMBAI,1344,All
2021,7,JAMMU,MUMBAI,532,2689,JAMMU-MUMBAI,3221,All
2021,8,JAMMU,MUMBAI,1006,3903,JAMMU-MUMBAI,4909,All
2021,9,JAMMU,MUMBAI,879,4630,JAMMU-MUMBAI,5509,All
2021,10,JAMMU,MUMBAI,1173,8260,JAMMU-MUMBAI,9433,All
2021,11,JAMMU,MUMBAI,796,8139,JAMMU-MUMBAI,8935,All
2021,12,JAMMU,MUMBAI,4410,8458,JAMMU-MUMBAI,12868,All
2022,1,JAMMU,MUMBAI,2227,5658,JAMMU-MUMBAI,7885,All
2022,2,JAMMU,MUMBAI,3140,8083,JAMMU-MUMBAI,11223,All
2022,3,JAMMU,MUMBAI,4119,9440,JAMMU-MUMBAI,13559,All
2022,4,JAMMU,MUMBAI,1163,7602,JAMMU-MUMBAI,8765,All
2022,5,JAMMU,MUMBAI,2292,7388,JAMMU-MUMBAI,9680,All
2022,6,JAMMU,MUMBAI,1597,7531,JAMMU-MUMBAI,9128,All
2022,7,JAMMU,MUMBAI,2212,7010,JAMMU-MUMBAI,9222,All
2022,8,JAMMU,MUMBAI,2025,6856,JAMMU-MUMBAI,8881,All
2022,9,JAMMU,MUMBAI,1668,7634,JAMMU-MUMBAI,9302,All
2022,10,JAMMU,MUMBAI,1231,6732,JAMMU-MUMBAI,7963,All
2022,11,JAMMU,MUMBAI,1977,8145,JAMMU-MUMBAI,10122,All
2022,12,JAMMU,MUMBAI,2624,8491,JAMMU-MUMBAI,11115,All
2023,11,JAMMU,MUMBAI,3359,4187,JAMMU-MUMBAI,7546,All
2023,12,JAMMU,MUMBAI,3847,4294,JAMMU-MUMBAI,8141,All
2024,1,JAMMU,MUMBAI,3203,4509,JAMMU-MUMBAI,7712,All
2024,2,JAMMU,MUMBAI,3893,4390,JAMMU-MUMBAI,8283,All
2024,3,JAMMU,MUMBAI,3816,4307,JAMMU-MUMBAI,8123,All
2024,4,JAMMU,MUMBAI,1641,1036,JAMMU-MUMBAI,2677,All
2024,6,JAMMU,MUMBAI,3593,3335,JAMMU-MUMBAI,6928,All
2024,7,JAMMU,MUMBAI,3867,3418,JAMMU-MUMBAI,7285,All
2024,8,JAMMU,MUMBAI,3415,3289,JAMMU-MUMBAI,6704,All
2024,9,JAMMU,MUMBAI,3290,3628,JAMMU-MUMBAI,6918,All
2024,10,JAMMU,MUMBAI,2111,2504,JAMMU-MUMBAI,4615,All
2024,11,JAMMU,MUMBAI,3335,3873,JAMMU-MUMBAI,7208,All
2024,12,JAMMU,MUMBAI,3837,4073,JAMMU-MUMBAI,7910,All
2025,1,JAMMU,MUMBAI,2755,3400,JAMMU-MUMBAI,6155,All
2025,2,JAMMU,MUMBAI,3306,3204,JAMMU-MUMBAI,6510,All
2025,3,JAMMU,MUMBAI,3480,3293,JAMMU-MUMBAI,6773,All
2018,3,JAMMU,PATNA,2,25,JAMMU-PATNA,27,All
2018,4,JAMMU,PATNA,30,76,JAMMU-PATNA,106,All
2018,5,JAMMU,PATNA,62,141,JAMMU-PATNA,203,All
2018,6,JAMMU,PATNA,124,300,JAMMU-PATNA,424,All
2018,7,JAMMU,PATNA,128,439,JAMMU-PATNA,567,All
2018,8,JAMMU,PATNA,263,800,JAMMU-PATNA,1063,All
2018,9,JAMMU,PATNA,476,508,JAMMU-PATNA,984,All
2018,10,JAMMU,PATNA,773,894,JAMMU-PATNA,1667,All
2018,11,JAMMU,PATNA,273,158,JAMMU-PATNA,431,All
2018,12,JAMMU,PATNA,116,167,JAMMU-PATNA,283,All
2019,1,JAMMU,PATNA,90,0,JAMMU-PATNA,90,All
2019,2,JAMMU,PATNA,95,0,JAMMU-PATNA,95,All
2019,3,JAMMU,PATNA,122,0,JAMMU-PATNA,122,All
2019,4,JAMMU,PATNA,165,0,JAMMU-PATNA,165,All
2019,5,JAMMU,PATNA,229,0,JAMMU-PATNA,229,All
2019,6,JAMMU,PATNA,317,0,JAMMU-PATNA,317,All
2019,7,JAMMU,PATNA,298,0,JAMMU-PATNA,298,All
2019,8,JAMMU,PATNA,275,0,JAMMU-PATNA,275,All
2019,9,JAMMU,PATNA,211,0,JAMMU-PATNA,211,All
2019,10,JAMMU,PATNA,154,0,JAMMU-PATNA,154,All
2019,11,JAMMU,PATNA,272,0,JAMMU-PATNA,272,All
2019,12,JAMMU,PATNA,190,0,JAMMU-PATNA,190,All
2020,1,JAMMU,PATNA,114,0,JAMMU-PATNA,114,All
2020,2,JAMMU,PATNA,95,0,JAMMU-PATNA,95,All
2020,3,JAMMU,PATNA,115,0,JAMMU-PATNA,115,All
2020,6,JAMMU,PATNA,23,0,JAMMU-PATNA,23,All
2017,9,JAMMU,PUNE,0,233,JAMMU-PUNE,233,All
2017,10,JAMMU,PUNE,0,330,JAMMU-PUNE,330,All
2017,11,JAMMU,PUNE,0,303,JAMMU-PUNE,303,All
2017,12,JAMMU,PUNE,0,319,JAMMU-PUNE,319,All
2018,1,JAMMU,PUNE,0,461,JAMMU-PUNE,461,All
2018,2,JAMMU,PUNE,0,351,JAMMU-PUNE,351,All
2018,3,JAMMU,PUNE,0,115,JAMMU-PUNE,115,All
2019,10,JAMMU,RANCHI,6,0,JAMMU-RANCHI,6,All
2019,11,JAMMU,RANCHI,70,0,JAMMU-RANCHI,70,All
2019,12,JAMMU,RANCHI,209,0,JAMMU-RANCHI,209,All
2020,1,JAMMU,RANCHI,167,0,JAMMU-RANCHI,167,All
2020,2,JAMMU,RANCHI,98,0,JAMMU-RANCHI,98,All
2020,3,JAMMU,RANCHI,116,0,JAMMU-RANCHI,116,All
2015,4,JAMMU,SRINAGAR,23020,16179,JAMMU-SRINAGAR,39199,All
2015,5,JAMMU,SRINAGAR,20131,15302,JAMMU-SRINAGAR,35433,All
2015,6,JAMMU,SRINAGAR,18261,13267,JAMMU-SRINAGAR,31528,All
2015,7,JAMMU,SRINAGAR,20321,16015,JAMMU-SRINAGAR,36336,All
2015,8,JAMMU,SRINAGAR,17444,14857,JAMMU-SRINAGAR,32301,All
2015,9,JAMMU,SRINAGAR,20031,15169,JAMMU-SRINAGAR,35200,All
2015,10,JAMMU,SRINAGAR,20900,11695,JAMMU-SRINAGAR,32595,All
2015,11,JAMMU,SRINAGAR,17607,15587,JAMMU-SRINAGAR,33194,All
2015,12,JAMMU,SRINAGAR,21443,17470,JAMMU-SRINAGAR,38913,All
2016,1,JAMMU,SRINAGAR,21048,15388,JAMMU-SRINAGAR,36436,All
2016,2,JAMMU,SRINAGAR,22742,15022,JAMMU-SRINAGAR,37764,All
2016,3,JAMMU,SRINAGAR,23792,16778,JAMMU-SRINAGAR,40570,All
2016,4,JAMMU,SRINAGAR,23195,16370,JAMMU-SRINAGAR,39565,All
2016,5,JAMMU,SRINAGAR,24010,15056,JAMMU-SRINAGAR,39066,All
2016,6,JAMMU,SRINAGAR,23188,14503,JAMMU-SRINAGAR,37691,All
2016,7,JAMMU,SRINAGAR,20388,17246,JAMMU-SRINAGAR,37634,All
2016,8,JAMMU,SRINAGAR,21046,19220,JAMMU-SRINAGAR,40266,All
2016,9,JAMMU,SRINAGAR,23076,15186,JAMMU-SRINAGAR,38262,All
2016,10,JAMMU,SRINAGAR,19133,16150,JAMMU-SRINAGAR,35283,All
2016,11,JAMMU,SRINAGAR,13271,14724,JAMMU-SRINAGAR,27995,All
2016,12,JAMMU,SRINAGAR,16493,13787,JAMMU-SRINAGAR,30280,All
2017,1,JAMMU,SRINAGAR,14006,11339,JAMMU-SRINAGAR,25345,All
2017,2,JAMMU,SRINAGAR,18959,18664,JAMMU-SRINAGAR,37623,All
2017,3,JAMMU,SRINAGAR,23376,21234,JAMMU-SRINAGAR,44610,All
2017,4,JAMMU,SRINAGAR,18057,14289,JAMMU-SRINAGAR,32346,All
2017,5,JAMMU,SRINAGAR,18356,12562,JAMMU-SRINAGAR,30918,All
2017,6,JAMMU,SRINAGAR,18533,12194,JAMMU-SRINAGAR,30727,All
2017,7,JAMMU,SRINAGAR,18981,16001,JAMMU-SRINAGAR,34982,All
2017,8,JAMMU,SRINAGAR,19189,15009,JAMMU-SRINAGAR,34198,All
2017,9,JAMMU,SRINAGAR,20614,16520,JAMMU-SRINAGAR,37134,All
2017,10,JAMMU,SRINAGAR,24113,19485,JAMMU-SRINAGAR,43598,All
2017,11,JAMMU,SRINAGAR,22985,21154,JAMMU-SRINAGAR,44139,All
2017,12,JAMMU,SRINAGAR,24212,21319,JAMMU-SRINAGAR,45531,All
2018,1,JAMMU,SRINAGAR,28394,20452,JAMMU-SRINAGAR,48846,All
2018,2,JAMMU,SRINAGAR,25312,19814,JAMMU-SRINAGAR,45126,All
2018,3,JAMMU,SRINAGAR,25191,20804,JAMMU-SRINAGAR,45995,All
2018,4,JAMMU,SRINAGAR,18663,14833,JAMMU-SRINAGAR,33496,All
2018,5,JAMMU,SRINAGAR,20287,15423,JAMMU-SRINAGAR,35710,All
2018,6,JAMMU,SRINAGAR,16277,13178,JAMMU-SRINAGAR,29455,All
2018,7,JAMMU,SRINAGAR,18324,14531,JAMMU-SRINAGAR,32855,All
2018,8,JAMMU,SRINAGAR,19862,14138,JAMMU-SRINAGAR,34000,All
2018,9,JAMMU,SRINAGAR,23764,16605,JAMMU-SRINAGAR,40369,All
2018,10,JAMMU,SRINAGAR,22067,16993,JAMMU-SRINAGAR,39060,All
2018,11,JAMMU,SRINAGAR,24416,23264,JAMMU-SRINAGAR,47680,All
2018,12,JAMMU,SRINAGAR,28690,26068,JAMMU-SRINAGAR,54758,All
2019,1,JAMMU,SRINAGAR,25486,19549,JAMMU-SRINAGAR,45035,All
2019,2,JAMMU,SRINAGAR,30416,20163,JAMMU-SRINAGAR,50579,All
2019,3,JAMMU,SRINAGAR,34181,23023,JAMMU-SRINAGAR,57204,All
2019,4,JAMMU,SRINAGAR,27175,19845,JAMMU-SRINAGAR,47020,All
2019,5,JAMMU,SRINAGAR,27509,23059,JAMMU-SRINAGAR,50568,All
2019,6,JAMMU,SRINAGAR,25617,22524,JAMMU-SRINAGAR,48141,All
2019,7,JAMMU,SRINAGAR,25565,23071,JAMMU-SRINAGAR,48636,All
2019,8,JAMMU,SRINAGAR,21079,19257,JAMMU-SRINAGAR,40336,All
2019,9,JAMMU,SRINAGAR,25608,19738,JAMMU-SRINAGAR,45346,All
2019,10,JAMMU,SRINAGAR,26880,21330,JAMMU-SRINAGAR,48210,All
2019,11,JAMMU,SRINAGAR,28924,23735,JAMMU-SRINAGAR,52659,All
2019,12,JAMMU,SRINAGAR,20501,17360,JAMMU-SRINAGAR,37861,All
2020,1,JAMMU,SRINAGAR,27337,18676,JAMMU-SRINAGAR,46013,All
2020,2,JAMMU,SRINAGAR,32299,21799,JAMMU-SRINAGAR,54098,All
2020,3,JAMMU,SRINAGAR,24876,16414,JAMMU-SRINAGAR,41290,All
2020,5,JAMMU,SRINAGAR,1273,518,JAMMU-SRINAGAR,1791,All
2020,6,JAMMU,SRINAGAR,5396,5272,JAMMU-SRINAGAR,10668,All
2020,7,JAMMU,SRINAGAR,5489,4941,JAMMU-SRINAGAR,10430,All
2020,8,JAMMU,SRINAGAR,7557,6351,JAMMU-SRINAGAR,13908,All
2020,9,JAMMU,SRINAGAR,9182,9209,JAMMU-SRINAGAR,18391,All
2020,10,JAMMU,SRINAGAR,10200,12522,JAMMU-SRINAGAR,22722,All
2020,11,JAMMU,SRINAGAR,14223,15079,JAMMU-SRINAGAR,29302,All
2020,12,JAMMU,SRINAGAR,11877,11909,JAMMU-SRINAGAR,23786,All
2021,1,JAMMU,SRINAGAR,16315,15306,JAMMU-SRINAGAR,31621,All
2021,2,JAMMU,SRINAGAR,17749,16314,JAMMU-SRINAGAR,34063,All
2021,3,JAMMU,SRINAGAR,16933,12010,JAMMU-SRINAGAR,28943,All
2021,4,JAMMU,SRINAGAR,14763,9279,JAMMU-SRINAGAR,24042,All
2021,6,JAMMU,SRINAGAR,10295,7915,JAMMU-SRINAGAR,18210,All
2021,7,JAMMU,SRINAGAR,15120,12151,JAMMU-SRINAGAR,27271,All
2021,8,JAMMU,SRINAGAR,15346,16922,JAMMU-SRINAGAR,32268,All
2021,9,JAMMU,SRINAGAR,15076,15704,JAMMU-SRINAGAR,30780,All
2021,10,JAMMU,SRINAGAR,15416,19249,JAMMU-SRINAGAR,34665,All
2021,11,JAMMU,SRINAGAR,17712,17805,JAMMU-SRINAGAR,35517,All
2021,12,JAMMU,SRINAGAR,19986,18953,JAMMU-SRINAGAR,38939,All
2022,1,JAMMU,SRINAGAR,20533,16251,JAMMU-SRINAGAR,36784,All
2022,2,JAMMU,SRINAGAR,20790,13864,JAMMU-SRINAGAR,34654,All
2022,3,JAMMU,SRINAGAR,25709,15236,JAMMU-SRINAGAR,40945,All
2022,4,JAMMU,SRINAGAR,19424,15023,JAMMU-SRINAGAR,34447,All
2022,5,JAMMU,SRINAGAR,19703,14506,JAMMU-SRINAGAR,34209,All
2022,6,JAMMU,SRINAGAR,18838,14417,JAMMU-SRINAGAR,33255,All
2022,7,JAMMU,SRINAGAR,18671,17999,JAMMU-SRINAGAR,36670,All
2022,8,JAMMU,SRINAGAR,16944,15027,JAMMU-SRINAGAR,31971,All
2022,9,JAMMU,SRINAGAR,18058,15909,JAMMU-SRINAGAR,33967,All
2022,10,JAMMU,SRINAGAR,17422,17775,JAMMU-SRINAGAR,35197,All
2022,11,JAMMU,SRINAGAR,21275,21390,JAMMU-SRINAGAR,42665,All
2022,12,JAMMU,SRINAGAR,27538,25227,JAMMU-SRINAGAR,52765,All
2023,1,JAMMU,SRINAGAR,25135,19790,JAMMU-SRINAGAR,44925,All
2023,2,JAMMU,SRINAGAR,30421,24512,JAMMU-SRINAGAR,54933,All
2023,3,JAMMU,SRINAGAR,32778,25762,JAMMU-SRINAGAR,58540,All
2023,4,JAMMU,SRINAGAR,21590,18748,JAMMU-SRINAGAR,40338,All
2023,5,JAMMU,SRINAGAR,17175,16356,JAMMU-SRINAGAR,33531,All
2023,6,JAMMU,SRINAGAR,16491,16356,JAMMU-SRINAGAR,32847,All
2023,7,JAMMU,SRINAGAR,17736,19351,JAMMU-SRINAGAR,37087,All
2023,8,JAMMU,SRINAGAR,16406,18791,JAMMU-SRINAGAR,35197,All
2023,9,JAMMU,SRINAGAR,17516,17179,JAMMU-SRINAGAR,34695,All
2023,10,JAMMU,SRINAGAR,16371,18869,JAMMU-SRINAGAR,35240,All
2023,11,JAMMU,SRINAGAR,19991,22517,JAMMU-SRINAGAR,42508,All
2023,12,JAMMU,SRINAGAR,22623,23180,JAMMU-SRINAGAR,45803,All
2024,1,JAMMU,SRINAGAR,19079,18960,JAMMU-SRINAGAR,38039,All
2024,2,JAMMU,SRINAGAR,23800,23322,JAMMU-SRINAGAR,47122,All
2024,3,JAMMU,SRINAGAR,27529,26405,JAMMU-SRINAGAR,53934,All
2024,4,JAMMU,SRINAGAR,25724,26622,JAMMU-SRINAGAR,52346,All
2024,6,JAMMU,SRINAGAR,27759,26374,JAMMU-SRINAGAR,54133,All
2024,7,JAMMU,SRINAGAR,24740,23912,JAMMU-SRINAGAR,48652,All
2024,8,JAMMU,SRINAGAR,20727,19588,JAMMU-SRINAGAR,40315,All
2024,9,JAMMU,SRINAGAR,18511,15137,JAMMU-SRINAGAR,33648,All
2024,10,JAMMU,SRINAGAR,17222,18608,JAMMU-SRINAGAR,35830,All
2024,11,JAMMU,SRINAGAR,19923,18876,JAMMU-SRINAGAR,38799,All
2024,12,JAMMU,SRINAGAR,21529,22079,JAMMU-SRINAGAR,43608,All
2025,1,JAMMU,SRINAGAR,23521,19385,JAMMU-SRINAGAR,42906,All
2025,2,JAMMU,SRINAGAR,20780,17587,JAMMU-SRINAGAR,38367,All
2025,3,JAMMU,SRINAGAR,19512,18125,JAMMU-SRINAGAR,37637,All
2018,7,JAMMU,VARANASI,66,0,JAMMU-VARANASI,66,All
2018,8,JAMMU,VARANASI,149,0,JAMMU-VARANASI,149,All
2018,9,JAMMU,VARANASI,150,0,JAMMU-VARANASI,150,All
2018,10,JAMMU,VARANASI,239,0,JAMMU-VARANASI,239,All
2018,11,JAMMU,VARANASI,69,0,JAMMU-VARANASI,69,All
2018,12,JAMMU,VARANASI,75,0,JAMMU-VARANASI,75,All
2019,1,JAMMU,VARANASI,108,0,JAMMU-VARANASI,108,All
2019,2,JAMMU,VARANASI,67,0,JAMMU-VARANASI,67,All
2019,3,JAMMU,VARANASI,89,0,JAMMU-VARANASI,89,All
2019,4,JAMMU,VARANASI,94,0,JAMMU-VARANASI,94,All
2019,5,JAMMU,VARANASI,182,0,JAMMU-VARANASI,182,All
2019,6,JAMMU,VARANASI,230,0,JAMMU-VARANASI,230,All
2019,7,JAMMU,VARANASI,193,0,JAMMU-VARANASI,193,All
2019,8,JAMMU,VARANASI,105,0,JAMMU-VARANASI,105,All
2019,9,JAMMU,VARANASI,52,0,JAMMU-VARANASI,52,All
2019,10,JAMMU,VARANASI,138,0,JAMMU-VARANASI,138,All
2022,3,JAMMU,VARANASI,39,43,JAMMU-VARANASI,82,All
2022,4,JAMMU,VARANASI,725,755,JAMMU-VARANASI,1480,All
2022,5,JAMMU,VARANASI,1234,1312,JAMMU-VARANASI,2546,All
2019,5,JAMNAGAR,MUMBAI,3491,3555,JAMNAGAR-MUMBAI,7046,All
2019,6,JAMNAGAR,MUMBAI,2436,2618,JAMNAGAR-MUMBAI,5054,All
2019,7,JAMNAGAR,MUMBAI,1735,1925,JAMNAGAR-MUMBAI,3660,All
2019,8,JAMNAGAR,MUMBAI,2203,2262,JAMNAGAR-MUMBAI,4465,All
2019,9,JAMNAGAR,MUMBAI,2380,2507,JAMNAGAR-MUMBAI,4887,All
2019,10,JAMNAGAR,MUMBAI,3176,3493,JAMNAGAR-MUMBAI,6669,All
2019,11,JAMNAGAR,MUMBAI,3104,3394,JAMNAGAR-MUMBAI,6498,All
2019,12,JAMNAGAR,MUMBAI,3188,3420,JAMNAGAR-MUMBAI,6608,All
2020,1,JAMNAGAR,MUMBAI,3250,3536,JAMNAGAR-MUMBAI,6786,All
2020,2,JAMNAGAR,MUMBAI,3209,3402,JAMNAGAR-MUMBAI,6611,All
2020,3,JAMNAGAR,MUMBAI,1301,1261,JAMNAGAR-MUMBAI,2562,All
2020,7,JAMNAGAR,MUMBAI,185,263,JAMNAGAR-MUMBAI,448,All
2020,8,JAMNAGAR,MUMBAI,494,442,JAMNAGAR-MUMBAI,936,All
2020,9,JAMNAGAR,MUMBAI,695,567,JAMNAGAR-MUMBAI,1262,All
2020,10,JAMNAGAR,MUMBAI,969,950,JAMNAGAR-MUMBAI,1919,All
2020,11,JAMNAGAR,MUMBAI,1676,1631,JAMNAGAR-MUMBAI,3307,All
2020,12,JAMNAGAR,MUMBAI,1498,1367,JAMNAGAR-MUMBAI,2865,All
2021,1,JAMNAGAR,MUMBAI,1736,1922,JAMNAGAR-MUMBAI,3658,All
2021,2,JAMNAGAR,MUMBAI,1805,1831,JAMNAGAR-MUMBAI,3636,All
2021,3,JAMNAGAR,MUMBAI,1525,1826,JAMNAGAR-MUMBAI,3351,All
2021,4,JAMNAGAR,MUMBAI,903,1201,JAMNAGAR-MUMBAI,2104,All
2021,7,JAMNAGAR,MUMBAI,476,647,JAMNAGAR-MUMBAI,1123,All
2021,8,JAMNAGAR,MUMBAI,1735,1984,JAMNAGAR-MUMBAI,3719,All
2021,9,JAMNAGAR,MUMBAI,1573,1883,JAMNAGAR-MUMBAI,3456,All
2021,10,JAMNAGAR,MUMBAI,2673,3064,JAMNAGAR-MUMBAI,5737,All
2021,11,JAMNAGAR,MUMBAI,2304,2404,JAMNAGAR-MUMBAI,4708,All
2021,12,JAMNAGAR,MUMBAI,3152,3426,JAMNAGAR-MUMBAI,6578,All
2022,1,JAMNAGAR,MUMBAI,2152,2477,JAMNAGAR-MUMBAI,4629,All
2022,2,JAMNAGAR,MUMBAI,3156,3197,JAMNAGAR-MUMBAI,6353,All
2022,3,JAMNAGAR,MUMBAI,3547,3549,JAMNAGAR-MUMBAI,7096,All
2022,4,JAMNAGAR,MUMBAI,3221,3441,JAMNAGAR-MUMBAI,6662,All
2022,5,JAMNAGAR,MUMBAI,3452,3374,JAMNAGAR-MUMBAI,6826,All
2022,6,JAMNAGAR,MUMBAI,2896,3208,JAMNAGAR-MUMBAI,6104,All
2022,7,JAMNAGAR,MUMBAI,2544,3109,JAMNAGAR-MUMBAI,5653,All
2022,8,JAMNAGAR,MUMBAI,3250,3675,JAMNAGAR-MUMBAI,6925,All
2022,9,JAMNAGAR,MUMBAI,3494,4310,JAMNAGAR-MUMBAI,7804,All
2022,10,JAMNAGAR,MUMBAI,4613,5048,JAMNAGAR-MUMBAI,9661,All
2022,11,JAMNAGAR,MUMBAI,4878,5241,JAMNAGAR-MUMBAI,10119,All
2022,12,JAMNAGAR,MUMBAI,5321,5286,JAMNAGAR-MUMBAI,10607,All
2023,11,JAMNAGAR,MUMBAI,4256,5037,JAMNAGAR-MUMBAI,9293,All
2023,12,JAMNAGAR,MUMBAI,4935,5419,JAMNAGAR-MUMBAI,10354,All
2024,1,JAMNAGAR,MUMBAI,4684,5269,JAMNAGAR-MUMBAI,9953,All
2024,2,JAMNAGAR,MUMBAI,4692,5035,JAMNAGAR-MUMBAI,9727,All
2024,3,JAMNAGAR,MUMBAI,4471,4752,JAMNAGAR-MUMBAI,9223,All
2024,4,JAMNAGAR,MUMBAI,4042,4446,JAMNAGAR-MUMBAI,8488,All
2024,6,JAMNAGAR,MUMBAI,3821,4359,JAMNAGAR-MUMBAI,8180,All
2024,7,JAMNAGAR,MUMBAI,3766,4323,JAMNAGAR-MUMBAI,8089,All
2024,8,JAMNAGAR,MUMBAI,4192,4077,JAMNAGAR-MUMBAI,8269,All
2024,9,JAMNAGAR,MUMBAI,3687,4177,JAMNAGAR-MUMBAI,7864,All
2024,10,JAMNAGAR,MUMBAI,4303,4954,JAMNAGAR-MUMBAI,9257,All
2024,11,JAMNAGAR,MUMBAI,4447,4619,JAMNAGAR-MUMBAI,9066,All
2024,12,JAMNAGAR,MUMBAI,4518,4967,JAMNAGAR-MUMBAI,9485,All
2025,1,JAMNAGAR,MUMBAI,5060,5258,JAMNAGAR-MUMBAI,10318,All
2025,2,JAMNAGAR,MUMBAI,4906,4989,JAMNAGAR-MUMBAI,9895,All
2025,3,JAMNAGAR,MUMBAI,4997,5101,JAMNAGAR-MUMBAI,10098,All
2023,1,JAMSHEDPUR,KOLKATA,9,9,JAMSHEDPUR-KOLKATA,18,All
2023,2,JAMSHEDPUR,KOLKATA,200,175,JAMSHEDPUR-KOLKATA,375,All
2023,3,JAMSHEDPUR,KOLKATA,176,137,JAMSHEDPUR-KOLKATA,313,All
2023,4,JAMSHEDPUR,KOLKATA,234,215,JAMSHEDPUR-KOLKATA,449,All
2023,5,JAMSHEDPUR,KOLKATA,179,165,JAMSHEDPUR-KOLKATA,344,All
2023,6,JAMSHEDPUR,KOLKATA,193,134,JAMSHEDPUR-KOLKATA,327,All
2023,7,JAMSHEDPUR,KOLKATA,124,96,JAMSHEDPUR-KOLKATA,220,All
2023,8,JAMSHEDPUR,KOLKATA,156,117,JAMSHEDPUR-KOLKATA,273,All
2023,9,JAMSHEDPUR,KOLKATA,156,114,JAMSHEDPUR-KOLKATA,270,All
2023,10,JAMSHEDPUR,KOLKATA,138,99,JAMSHEDPUR-KOLKATA,237,All
2023,11,JAMSHEDPUR,KOLKATA,227,199,JAMSHEDPUR-KOLKATA,426,All
2023,12,JAMSHEDPUR,KOLKATA,220,197,JAMSHEDPUR-KOLKATA,417,All
2024,1,JAMSHEDPUR,KOLKATA,196,180,JAMSHEDPUR-KOLKATA,376,All
2024,2,JAMSHEDPUR,KOLKATA,191,149,JAMSHEDPUR-KOLKATA,340,All
2024,3,JAMSHEDPUR,KOLKATA,238,211,JAMSHEDPUR-KOLKATA,449,All
2024,4,JAMSHEDPUR,KOLKATA,165,129,JAMSHEDPUR-KOLKATA,294,All
2024,6,JAMSHEDPUR,KOLKATA,177,100,JAMSHEDPUR-KOLKATA,277,All
2024,7,JAMSHEDPUR,KOLKATA,189,142,JAMSHEDPUR-KOLKATA,331,All
2024,8,JAMSHEDPUR,KOLKATA,222,170,JAMSHEDPUR-KOLKATA,392,All
2024,9,JAMSHEDPUR,KOLKATA,199,132,JAMSHEDPUR-KOLKATA,331,All
2024,10,JAMSHEDPUR,KOLKATA,194,145,JAMSHEDPUR-KOLKATA,339,All
2024,11,JAMSHEDPUR,KOLKATA,245,154,JAMSHEDPUR-KOLKATA,399,All
2024,12,JAMSHEDPUR,KOLKATA,264,209,JAMSHEDPUR-KOLKATA,473,All
2025,1,JAMSHEDPUR,KOLKATA,201,141,JAMSHEDPUR-KOLKATA,342,All
2025,2,JAMSHEDPUR,KOLKATA,226,155,JAMSHEDPUR-KOLKATA,381,All
2025,3,JAMSHEDPUR,KOLKATA,243,171,JAMSHEDPUR-KOLKATA,414,All
2022,11,JEYPORE,VISAKHAPATNAM,155,148,JEYPORE-VISAKHAPATNAM,303,All
2022,12,JEYPORE,VISAKHAPATNAM,119,89,JEYPORE-VISAKHAPATNAM,208,All
2023,1,JEYPORE,VISAKHAPATNAM,242,201,JEYPORE-VISAKHAPATNAM,443,All
2023,2,JEYPORE,VISAKHAPATNAM,206,197,JEYPORE-VISAKHAPATNAM,403,All
2023,3,JEYPORE,VISAKHAPATNAM,218,181,JEYPORE-VISAKHAPATNAM,399,All
2023,4,JEYPORE,VISAKHAPATNAM,223,212,JEYPORE-VISAKHAPATNAM,435,All
2023,5,JEYPORE,VISAKHAPATNAM,175,157,JEYPORE-VISAKHAPATNAM,332,All
2023,6,JEYPORE,VISAKHAPATNAM,162,383,JEYPORE-VISAKHAPATNAM,545,All
2023,7,JEYPORE,VISAKHAPATNAM,95,70,JEYPORE-VISAKHAPATNAM,165,All
2023,8,JEYPORE,VISAKHAPATNAM,125,116,JEYPORE-VISAKHAPATNAM,241,All
2023,9,JEYPORE,VISAKHAPATNAM,171,142,JEYPORE-VISAKHAPATNAM,313,All
2023,10,JEYPORE,VISAKHAPATNAM,213,189,JEYPORE-VISAKHAPATNAM,402,All
2023,11,JEYPORE,VISAKHAPATNAM,222,194,JEYPORE-VISAKHAPATNAM,416,All
2023,12,JEYPORE,VISAKHAPATNAM,216,207,JEYPORE-VISAKHAPATNAM,423,All
2024,1,JEYPORE,VISAKHAPATNAM,219,194,JEYPORE-VISAKHAPATNAM,413,All
2024,2,JEYPORE,VISAKHAPATNAM,206,144,JEYPORE-VISAKHAPATNAM,350,All
2024,3,JEYPORE,VISAKHAPATNAM,212,151,JEYPORE-VISAKHAPATNAM,363,All
2024,4,JEYPORE,VISAKHAPATNAM,160,138,JEYPORE-VISAKHAPATNAM,298,All
2024,6,JEYPORE,VISAKHAPATNAM,96,82,JEYPORE-VISAKHAPATNAM,178,All
2024,7,JEYPORE,VISAKHAPATNAM,39,34,JEYPORE-VISAKHAPATNAM,73,All
2024,8,JEYPORE,VISAKHAPATNAM,110,73,JEYPORE-VISAKHAPATNAM,183,All
2024,9,JEYPORE,VISAKHAPATNAM,145,95,JEYPORE-VISAKHAPATNAM,240,All
2024,10,JEYPORE,VISAKHAPATNAM,58,76,JEYPORE-VISAKHAPATNAM,134,All
2024,11,JEYPORE,VISAKHAPATNAM,185,143,JEYPORE-VISAKHAPATNAM,328,All
2024,12,JEYPORE,VISAKHAPATNAM,141,131,JEYPORE-VISAKHAPATNAM,272,All
2025,1,JEYPORE,VISAKHAPATNAM,199,138,JEYPORE-VISAKHAPATNAM,337,All
2025,2,JEYPORE,VISAKHAPATNAM,152,149,JEYPORE-VISAKHAPATNAM,301,All
2025,3,JEYPORE,VISAKHAPATNAM,179,145,JEYPORE-VISAKHAPATNAM,324,All
2019,5,JHARSUGUDA,KOLKATA,2136,1857,JHARSUGUDA-KOLKATA,3993,All
2019,6,JHARSUGUDA,KOLKATA,2091,2135,JHARSUGUDA-KOLKATA,4226,All
2019,7,JHARSUGUDA,KOLKATA,1556,1564,JHARSUGUDA-KOLKATA,3120,All
2019,8,JHARSUGUDA,KOLKATA,1794,1562,JHARSUGUDA-KOLKATA,3356,All
2019,9,JHARSUGUDA,KOLKATA,1723,1653,JHARSUGUDA-KOLKATA,3376,All
2019,10,JHARSUGUDA,KOLKATA,2131,1969,JHARSUGUDA-KOLKATA,4100,All
2019,11,JHARSUGUDA,KOLKATA,1727,1887,JHARSUGUDA-KOLKATA,3614,All
2019,12,JHARSUGUDA,KOLKATA,2083,2256,JHARSUGUDA-KOLKATA,4339,All
2020,1,JHARSUGUDA,KOLKATA,2039,1884,JHARSUGUDA-KOLKATA,3923,All
2020,2,JHARSUGUDA,KOLKATA,2706,2873,JHARSUGUDA-KOLKATA,5579,All
2020,3,JHARSUGUDA,KOLKATA,1868,2093,JHARSUGUDA-KOLKATA,3961,All
2020,6,JHARSUGUDA,KOLKATA,1311,1479,JHARSUGUDA-KOLKATA,2790,All
2020,7,JHARSUGUDA,KOLKATA,1619,2387,JHARSUGUDA-KOLKATA,4006,All
2020,8,JHARSUGUDA,KOLKATA,1357,2643,JHARSUGUDA-KOLKATA,4000,All
2020,9,JHARSUGUDA,KOLKATA,2182,2764,JHARSUGUDA-KOLKATA,4946,All
2020,10,JHARSUGUDA,KOLKATA,3030,3191,JHARSUGUDA-KOLKATA,6221,All
2020,11,JHARSUGUDA,KOLKATA,3266,3480,JHARSUGUDA-KOLKATA,6746,All
2020,12,JHARSUGUDA,KOLKATA,3650,3718,JHARSUGUDA-KOLKATA,7368,All
2021,1,JHARSUGUDA,KOLKATA,3695,3455,JHARSUGUDA-KOLKATA,7150,All
2021,2,JHARSUGUDA,KOLKATA,3642,3654,JHARSUGUDA-KOLKATA,7296,All
2021,3,JHARSUGUDA,KOLKATA,3643,3222,JHARSUGUDA-KOLKATA,6865,All
2021,4,JHARSUGUDA,KOLKATA,1965,1763,JHARSUGUDA-KOLKATA,3728,All
2021,6,JHARSUGUDA,KOLKATA,678,858,JHARSUGUDA-KOLKATA,1536,All
2021,7,JHARSUGUDA,KOLKATA,2180,1871,JHARSUGUDA-KOLKATA,4051,All
2021,8,JHARSUGUDA,KOLKATA,2263,2236,JHARSUGUDA-KOLKATA,4499,All
2021,9,JHARSUGUDA,KOLKATA,2365,2285,JHARSUGUDA-KOLKATA,4650,All
2021,10,JHARSUGUDA,KOLKATA,2918,2831,JHARSUGUDA-KOLKATA,5749,All
2021,11,JHARSUGUDA,KOLKATA,2824,2720,JHARSUGUDA-KOLKATA,5544,All
2021,12,JHARSUGUDA,KOLKATA,3268,2996,JHARSUGUDA-KOLKATA,6264,All
2022,1,JHARSUGUDA,KOLKATA,1517,1322,JHARSUGUDA-KOLKATA,2839,All
2022,2,JHARSUGUDA,KOLKATA,2457,2328,JHARSUGUDA-KOLKATA,4785,All
2022,3,JHARSUGUDA,KOLKATA,2734,2435,JHARSUGUDA-KOLKATA,5169,All
2022,4,JHARSUGUDA,KOLKATA,3206,2607,JHARSUGUDA-KOLKATA,5813,All
2022,5,JHARSUGUDA,KOLKATA,3139,2853,JHARSUGUDA-KOLKATA,5992,All
2022,6,JHARSUGUDA,KOLKATA,2405,2351,JHARSUGUDA-KOLKATA,4756,All
2022,7,JHARSUGUDA,KOLKATA,1307,1328,JHARSUGUDA-KOLKATA,2635,All
2022,8,JHARSUGUDA,KOLKATA,1265,1250,JHARSUGUDA-KOLKATA,2515,All
2022,9,JHARSUGUDA,KOLKATA,1056,1006,JHARSUGUDA-KOLKATA,2062,All
2022,10,JHARSUGUDA,KOLKATA,1271,1254,JHARSUGUDA-KOLKATA,2525,All
2022,11,JHARSUGUDA,KOLKATA,1405,1336,JHARSUGUDA-KOLKATA,2741,All
2022,12,JHARSUGUDA,KOLKATA,1423,1371,JHARSUGUDA-KOLKATA,2794,All
2023,1,JHARSUGUDA,KOLKATA,1471,1346,JHARSUGUDA-KOLKATA,2817,All
2023,2,JHARSUGUDA,KOLKATA,1344,1154,JHARSUGUDA-KOLKATA,2498,All
2023,3,JHARSUGUDA,KOLKATA,1267,992,JHARSUGUDA-KOLKATA,2259,All
2023,4,JHARSUGUDA,KOLKATA,1530,1065,JHARSUGUDA-KOLKATA,2595,All
2023,5,JHARSUGUDA,KOLKATA,1872,1543,JHARSUGUDA-KOLKATA,3415,All
2023,6,JHARSUGUDA,KOLKATA,1681,1496,JHARSUGUDA-KOLKATA,3177,All
2023,7,JHARSUGUDA,KOLKATA,1292,1330,JHARSUGUDA-KOLKATA,2622,All
2023,8,JHARSUGUDA,KOLKATA,1461,1324,JHARSUGUDA-KOLKATA,2785,All
2023,9,JHARSUGUDA,KOLKATA,1392,1260,JHARSUGUDA-KOLKATA,2652,All
2023,10,JHARSUGUDA,KOLKATA,1303,1232,JHARSUGUDA-KOLKATA,2535,All
2023,11,JHARSUGUDA,KOLKATA,1792,1692,JHARSUGUDA-KOLKATA,3484,All
2023,12,JHARSUGUDA,KOLKATA,2108,2114,JHARSUGUDA-KOLKATA,4222,All
2024,1,JHARSUGUDA,KOLKATA,2228,2031,JHARSUGUDA-KOLKATA,4259,All
2024,2,JHARSUGUDA,KOLKATA,1925,1913,JHARSUGUDA-KOLKATA,3838,All
2024,3,JHARSUGUDA,KOLKATA,1958,1854,JHARSUGUDA-KOLKATA,3812,All
2024,4,JHARSUGUDA,KOLKATA,2191,2156,JHARSUGUDA-KOLKATA,4347,All
2024,6,JHARSUGUDA,KOLKATA,1628,1867,JHARSUGUDA-KOLKATA,3495,All
2024,7,JHARSUGUDA,KOLKATA,1774,1932,JHARSUGUDA-KOLKATA,3706,All
2024,8,JHARSUGUDA,KOLKATA,1804,1893,JHARSUGUDA-KOLKATA,3697,All
2024,9,JHARSUGUDA,KOLKATA,1792,1916,JHARSUGUDA-KOLKATA,3708,All
2024,10,JHARSUGUDA,KOLKATA,1908,1872,JHARSUGUDA-KOLKATA,3780,All
2024,11,JHARSUGUDA,KOLKATA,2056,2037,JHARSUGUDA-KOLKATA,4093,All
2024,12,JHARSUGUDA,KOLKATA,2036,2113,JHARSUGUDA-KOLKATA,4149,All
2025,1,JHARSUGUDA,KOLKATA,1979,2083,JHARSUGUDA-KOLKATA,4062,All
2025,2,JHARSUGUDA,KOLKATA,1958,1989,JHARSUGUDA-KOLKATA,3947,All
2025,3,JHARSUGUDA,KOLKATA,1928,1922,JHARSUGUDA-KOLKATA,3850,All
2025,2,JHARSUGUDA,LUCKNOW,1010,979,JHARSUGUDA-LUCKNOW,1989,All
2025,3,JHARSUGUDA,LUCKNOW,676,594,JHARSUGUDA-LUCKNOW,1270,All
2021,1,JHARSUGUDA,MUMBAI,1396,1090,JHARSUGUDA-MUMBAI,2486,All
2021,2,JHARSUGUDA,MUMBAI,2155,1928,JHARSUGUDA-MUMBAI,4083,All
2021,3,JHARSUGUDA,MUMBAI,1350,1371,JHARSUGUDA-MUMBAI,2721,All
2021,4,JHARSUGUDA,MUMBAI,566,548,JHARSUGUDA-MUMBAI,1114,All
2021,11,JHARSUGUDA,MUMBAI,144,105,JHARSUGUDA-MUMBAI,249,All
2022,8,JHARSUGUDA,MUMBAI,202,221,JHARSUGUDA-MUMBAI,423,All
2025,1,JHARSUGUDA,MUMBAI,0,57,JHARSUGUDA-MUMBAI,57,All
2025,3,JHARSUGUDA,MUMBAI,3306,3422,JHARSUGUDA-MUMBAI,6728,All
2021,10,JHARSUGUDA,PAKYONG,0,2,JHARSUGUDA-PAKYONG,2,All
2021,6,JHARSUGUDA,PATNA,74,124,JHARSUGUDA-PATNA,198,All
2021,7,JHARSUGUDA,PATNA,138,160,JHARSUGUDA-PATNA,298,All
2021,8,JHARSUGUDA,PATNA,69,93,JHARSUGUDA-PATNA,162,All
2019,6,JHARSUGUDA,RAIPUR,578,459,JHARSUGUDA-RAIPUR,1037,All
2019,7,JHARSUGUDA,RAIPUR,281,222,JHARSUGUDA-RAIPUR,503,All
2019,8,JHARSUGUDA,RAIPUR,509,513,JHARSUGUDA-RAIPUR,1022,All
2019,9,JHARSUGUDA,RAIPUR,461,466,JHARSUGUDA-RAIPUR,927,All
2019,10,JHARSUGUDA,RAIPUR,706,871,JHARSUGUDA-RAIPUR,1577,All
2019,11,JHARSUGUDA,RAIPUR,735,603,JHARSUGUDA-RAIPUR,1338,All
2019,12,JHARSUGUDA,RAIPUR,698,658,JHARSUGUDA-RAIPUR,1356,All
2020,1,JHARSUGUDA,RAIPUR,485,466,JHARSUGUDA-RAIPUR,951,All
2020,2,JHARSUGUDA,RAIPUR,830,856,JHARSUGUDA-RAIPUR,1686,All
2020,3,JHARSUGUDA,RAIPUR,417,512,JHARSUGUDA-RAIPUR,929,All
2020,6,JHARSUGUDA,RAIPUR,32,41,JHARSUGUDA-RAIPUR,73,All
2020,7,JHARSUGUDA,RAIPUR,465,173,JHARSUGUDA-RAIPUR,638,All
2020,8,JHARSUGUDA,RAIPUR,663,174,JHARSUGUDA-RAIPUR,837,All
2020,9,JHARSUGUDA,RAIPUR,556,240,JHARSUGUDA-RAIPUR,796,All
2020,10,JHARSUGUDA,RAIPUR,523,451,JHARSUGUDA-RAIPUR,974,All
2020,11,JHARSUGUDA,RAIPUR,687,521,JHARSUGUDA-RAIPUR,1208,All
2020,12,JHARSUGUDA,RAIPUR,823,667,JHARSUGUDA-RAIPUR,1490,All
2021,1,JHARSUGUDA,RAIPUR,755,645,JHARSUGUDA-RAIPUR,1400,All
2021,2,JHARSUGUDA,RAIPUR,631,539,JHARSUGUDA-RAIPUR,1170,All
2021,3,JHARSUGUDA,RAIPUR,548,489,JHARSUGUDA-RAIPUR,1037,All
2021,4,JHARSUGUDA,RAIPUR,197,170,JHARSUGUDA-RAIPUR,367,All
2021,6,JHARSUGUDA,RAIPUR,409,174,JHARSUGUDA-RAIPUR,583,All
2021,7,JHARSUGUDA,RAIPUR,757,511,JHARSUGUDA-RAIPUR,1268,All
2021,8,JHARSUGUDA,RAIPUR,880,603,JHARSUGUDA-RAIPUR,1483,All
2021,9,JHARSUGUDA,RAIPUR,702,548,JHARSUGUDA-RAIPUR,1250,All
2021,10,JHARSUGUDA,RAIPUR,903,693,JHARSUGUDA-RAIPUR,1596,All
2021,11,JHARSUGUDA,RAIPUR,784,523,JHARSUGUDA-RAIPUR,1307,All
2021,12,JHARSUGUDA,RAIPUR,830,637,JHARSUGUDA-RAIPUR,1467,All
2022,1,JHARSUGUDA,RAIPUR,410,371,JHARSUGUDA-RAIPUR,781,All
2022,2,JHARSUGUDA,RAIPUR,773,614,JHARSUGUDA-RAIPUR,1387,All
2022,3,JHARSUGUDA,RAIPUR,923,735,JHARSUGUDA-RAIPUR,1658,All
2022,4,JHARSUGUDA,RAIPUR,784,523,JHARSUGUDA-RAIPUR,1307,All
2022,5,JHARSUGUDA,RAIPUR,830,637,JHARSUGUDA-RAIPUR,1467,All
2022,6,JHARSUGUDA,RAIPUR,784,523,JHARSUGUDA-RAIPUR,1307,All
2022,7,JHARSUGUDA,RAIPUR,773,614,JHARSUGUDA-RAIPUR,1387,All
2022,8,JHARSUGUDA,RAIPUR,830,637,JHARSUGUDA-RAIPUR,1467,All
2022,9,JHARSUGUDA,RAIPUR,784,523,JHARSUGUDA-RAIPUR,1307,All
2022,10,JHARSUGUDA,RAIPUR,899,756,JHARSUGUDA-RAIPUR,1655,All
2022,11,JHARSUGUDA,RAIPUR,0,10,JHARSUGUDA-RAIPUR,10,All
2025,2,JHARSUGUDA,RAIPUR,421,365,JHARSUGUDA-RAIPUR,786,All
2025,3,JHARSUGUDA,RAIPUR,391,423,JHARSUGUDA-RAIPUR,814,All
2019,6,JHARSUGUDA,RANCHI,22,27,JHARSUGUDA-RANCHI,49,All
2019,7,JHARSUGUDA,RANCHI,36,23,JHARSUGUDA-RANCHI,59,All
2019,8,JHARSUGUDA,RANCHI,35,54,JHARSUGUDA-RANCHI,89,All
2019,9,JHARSUGUDA,RANCHI,37,47,JHARSUGUDA-RANCHI,84,All
2019,10,JHARSUGUDA,RANCHI,48,42,JHARSUGUDA-RANCHI,90,All
2019,11,JHARSUGUDA,RANCHI,81,70,JHARSUGUDA-RANCHI,151,All
2019,12,JHARSUGUDA,RANCHI,45,47,JHARSUGUDA-RANCHI,92,All
2020,1,JHARSUGUDA,RANCHI,31,31,JHARSUGUDA-RANCHI,62,All
2021,11,JHARSUGUDA,UDAIPUR,118,0,JHARSUGUDA-UDAIPUR,118,All
2020,1,JHARSUGUDA,VARANASI,0,1,JHARSUGUDA-VARANASI,1,All
2020,2,JHARSUGUDA,VARANASI,51,61,JHARSUGUDA-VARANASI,112,All
2020,3,JHARSUGUDA,VARANASI,59,57,JHARSUGUDA-VARANASI,116,All
2020,11,JODHPUR,KOLKATA,61,65,JODHPUR-KOLKATA,126,All
2021,2,JODHPUR,KOLKATA,120,108,JODHPUR-KOLKATA,228,All
2021,7,JODHPUR,KOLKATA,181,84,JODHPUR-KOLKATA,265,All
2021,8,JODHPUR,KOLKATA,76,65,JODHPUR-KOLKATA,141,All
2021,11,JODHPUR,KOLKATA,1737,1862,JODHPUR-KOLKATA,3599,All
2021,12,JODHPUR,KOLKATA,2545,2247,JODHPUR-KOLKATA,4792,All
2022,1,JODHPUR,KOLKATA,926,727,JODHPUR-KOLKATA,1653,All
2022,2,JODHPUR,KOLKATA,1052,1065,JODHPUR-KOLKATA,2117,All
2022,3,JODHPUR,KOLKATA,1140,1158,JODHPUR-KOLKATA,2298,All
2022,4,JODHPUR,KOLKATA,1438,1549,JODHPUR-KOLKATA,2987,All
2022,5,JODHPUR,KOLKATA,1126,1135,JODHPUR-KOLKATA,2261,All
2022,6,JODHPUR,KOLKATA,1028,993,JODHPUR-KOLKATA,2021,All
2022,7,JODHPUR,KOLKATA,1024,806,JODHPUR-KOLKATA,1830,All
2022,8,JODHPUR,KOLKATA,1415,1132,JODHPUR-KOLKATA,2547,All
2022,9,JODHPUR,KOLKATA,866,777,JODHPUR-KOLKATA,1643,All
2022,10,JODHPUR,KOLKATA,1914,1809,JODHPUR-KOLKATA,3723,All
2022,11,JODHPUR,KOLKATA,1002,952,JODHPUR-KOLKATA,1954,All
2022,12,JODHPUR,KOLKATA,2343,1992,JODHPUR-KOLKATA,4335,All
2023,1,JODHPUR,KOLKATA,2266,2014,JODHPUR-KOLKATA,4280,All
2023,2,JODHPUR,KOLKATA,2205,2137,JODHPUR-KOLKATA,4342,All
2023,8,JODHPUR,KOLKATA,676,736,JODHPUR-KOLKATA,1412,All
2023,10,JODHPUR,KOLKATA,904,877,JODHPUR-KOLKATA,1781,All
2025,1,JODHPUR,KOLKATA,367,500,JODHPUR-KOLKATA,867,All
2019,9,JODHPUR,LUCKNOW,0,116,JODHPUR-LUCKNOW,116,All
2019,10,JODHPUR,LUCKNOW,0,120,JODHPUR-LUCKNOW,120,All
2019,5,JODHPUR,MUMBAI,4220,4330,JODHPUR-MUMBAI,8550,All
2019,6,JODHPUR,MUMBAI,4296,4385,JODHPUR-MUMBAI,8681,All
2019,7,JODHPUR,MUMBAI,2366,2504,JODHPUR-MUMBAI,4870,All
2019,8,JODHPUR,MUMBAI,2855,2967,JODHPUR-MUMBAI,5822,All
2019,9,JODHPUR,MUMBAI,4645,5296,JODHPUR-MUMBAI,9941,All
2019,10,JODHPUR,MUMBAI,8441,10045,JODHPUR-MUMBAI,18486,All
2019,11,JODHPUR,MUMBAI,16324,15860,JODHPUR-MUMBAI,32184,All
2019,12,JODHPUR,MUMBAI,16615,16388,JODHPUR-MUMBAI,33003,All
2020,1,JODHPUR,MUMBAI,15589,16884,JODHPUR-MUMBAI,32473,All
2020,2,JODHPUR,MUMBAI,17564,18085,JODHPUR-MUMBAI,35649,All
2020,3,JODHPUR,MUMBAI,9614,10952,JODHPUR-MUMBAI,20566,All
2020,9,JODHPUR,MUMBAI,1308,1464,JODHPUR-MUMBAI,2772,All
2020,10,JODHPUR,MUMBAI,2640,2618,JODHPUR-MUMBAI,5258,All
2020,11,JODHPUR,MUMBAI,2074,2313,JODHPUR-MUMBAI,4387,All
2020,12,JODHPUR,MUMBAI,3228,3124,JODHPUR-MUMBAI,6352,All
2021,1,JODHPUR,MUMBAI,3788,3734,JODHPUR-MUMBAI,7522,All
2021,2,JODHPUR,MUMBAI,4453,4871,JODHPUR-MUMBAI,9324,All
2021,3,JODHPUR,MUMBAI,4871,5569,JODHPUR-MUMBAI,10440,All
2021,4,JODHPUR,MUMBAI,3638,7071,JODHPUR-MUMBAI,10709,All
2021,6,JODHPUR,MUMBAI,3043,2438,JODHPUR-MUMBAI,5481,All
2021,7,JODHPUR,MUMBAI,5198,5140,JODHPUR-MUMBAI,10338,All
2021,8,JODHPUR,MUMBAI,7253,7497,JODHPUR-MUMBAI,14750,All
2021,9,JODHPUR,MUMBAI,8679,9545,JODHPUR-MUMBAI,18224,All
2021,10,JODHPUR,MUMBAI,12248,13831,JODHPUR-MUMBAI,26079,All
2021,11,JODHPUR,MUMBAI,19633,22539,JODHPUR-MUMBAI,42172,All
2021,12,JODHPUR,MUMBAI,23454,21937,JODHPUR-MUMBAI,45391,All
2022,1,JODHPUR,MUMBAI,13360,12643,JODHPUR-MUMBAI,26003,All
2022,2,JODHPUR,MUMBAI,17218,17999,JODHPUR-MUMBAI,35217,All
2022,3,JODHPUR,MUMBAI,14676,14849,JODHPUR-MUMBAI,29525,All
2022,4,JODHPUR,MUMBAI,5415,5444,JODHPUR-MUMBAI,10859,All
2022,5,JODHPUR,MUMBAI,5430,5343,JODHPUR-MUMBAI,10773,All
2022,6,JODHPUR,MUMBAI,5308,5437,JODHPUR-MUMBAI,10745,All
2022,7,JODHPUR,MUMBAI,7521,8130,JODHPUR-MUMBAI,15651,All
2022,8,JODHPUR,MUMBAI,7899,8459,JODHPUR-MUMBAI,16358,All
2022,9,JODHPUR,MUMBAI,7939,8422,JODHPUR-MUMBAI,16361,All
2022,10,JODHPUR,MUMBAI,8656,9259,JODHPUR-MUMBAI,17915,All
2022,11,JODHPUR,MUMBAI,14000,12849,JODHPUR-MUMBAI,26849,All
2022,12,JODHPUR,MUMBAI,19882,19095,JODHPUR-MUMBAI,38977,All
2023,11,JODHPUR,MUMBAI,11138,13297,JODHPUR-MUMBAI,24435,All
2023,12,JODHPUR,MUMBAI,13695,12844,JODHPUR-MUMBAI,26539,All
2024,1,JODHPUR,MUMBAI,13780,14890,JODHPUR-MUMBAI,28670,All
2024,2,JODHPUR,MUMBAI,12962,13769,JODHPUR-MUMBAI,26731,All
2024,3,JODHPUR,MUMBAI,12875,13588,JODHPUR-MUMBAI,26463,All
2024,4,JODHPUR,MUMBAI,10215,10551,JODHPUR-MUMBAI,20766,All
2024,6,JODHPUR,MUMBAI,10542,10442,JODHPUR-MUMBAI,20984,All
2024,7,JODHPUR,MUMBAI,10951,11223,JODHPUR-MUMBAI,22174,All
2024,8,JODHPUR,MUMBAI,11128,10963,JODHPUR-MUMBAI,22091,All
2024,9,JODHPUR,MUMBAI,10954,10990,JODHPUR-MUMBAI,21944,All
2024,10,JODHPUR,MUMBAI,9419,12054,JODHPUR-MUMBAI,21473,All
2024,11,JODHPUR,MUMBAI,14535,14432,JODHPUR-MUMBAI,28967,All
2024,12,JODHPUR,MUMBAI,15143,15595,JODHPUR-MUMBAI,30738,All
2025,1,JODHPUR,MUMBAI,13953,15003,JODHPUR-MUMBAI,28956,All
2025,2,JODHPUR,MUMBAI,12821,13796,JODHPUR-MUMBAI,26617,All
2025,3,JODHPUR,MUMBAI,12555,13609,JODHPUR-MUMBAI,26164,All
2021,11,JODHPUR,NAGPUR,93,71,JODHPUR-NAGPUR,164,All
2021,12,JODHPUR,NAGPUR,104,157,JODHPUR-NAGPUR,261,All
2022,1,JODHPUR,NAGPUR,28,23,JODHPUR-NAGPUR,51,All
2016,2,JODHPUR,PUNE,35,0,JODHPUR-PUNE,35,All
2019,11,JODHPUR,PUNE,1448,1440,JODHPUR-PUNE,2888,All
2019,12,JODHPUR,PUNE,4306,4325,JODHPUR-PUNE,8631,All
2020,1,JODHPUR,PUNE,4078,4380,JODHPUR-PUNE,8458,All
2020,2,JODHPUR,PUNE,3762,3844,JODHPUR-PUNE,7606,All
2020,3,JODHPUR,PUNE,2240,2801,JODHPUR-PUNE,5041,All
2021,11,JODHPUR,PUNE,153,176,JODHPUR-PUNE,329,All
2021,12,JODHPUR,PUNE,169,180,JODHPUR-PUNE,349,All
2023,6,JODHPUR,PUNE,1675,1804,JODHPUR-PUNE,3479,All
2023,7,JODHPUR,PUNE,3122,3093,JODHPUR-PUNE,6215,All
2023,8,JODHPUR,PUNE,3574,3661,JODHPUR-PUNE,7235,All
2023,9,JODHPUR,PUNE,3319,3450,JODHPUR-PUNE,6769,All
2023,10,JODHPUR,PUNE,2934,2999,JODHPUR-PUNE,5933,All
2023,11,JODHPUR,PUNE,2029,2025,JODHPUR-PUNE,4054,All
2023,12,JODHPUR,PUNE,4528,4317,JODHPUR-PUNE,8845,All
2024,1,JODHPUR,PUNE,4485,4436,JODHPUR-PUNE,8921,All
2024,2,JODHPUR,PUNE,4132,4116,JODHPUR-PUNE,8248,All
2024,3,JODHPUR,PUNE,3757,3977,JODHPUR-PUNE,7734,All
2024,4,JODHPUR,PUNE,3544,4244,JODHPUR-PUNE,7788,All
2024,6,JODHPUR,PUNE,3686,3824,JODHPUR-PUNE,7510,All
2024,7,JODHPUR,PUNE,3811,4167,JODHPUR-PUNE,7978,All
2024,8,JODHPUR,PUNE,3685,4042,JODHPUR-PUNE,7727,All
2024,9,JODHPUR,PUNE,2443,2769,JODHPUR-PUNE,5212,All
2024,10,JODHPUR,PUNE,3507,4100,JODHPUR-PUNE,7607,All
2024,11,JODHPUR,PUNE,4247,4223,JODHPUR-PUNE,8470,All
2024,12,JODHPUR,PUNE,4429,4561,JODHPUR-PUNE,8990,All
2025,1,JODHPUR,PUNE,4474,4753,JODHPUR-PUNE,9227,All
2025,2,JODHPUR,PUNE,4060,4145,JODHPUR-PUNE,8205,All
2025,3,JODHPUR,PUNE,4021,4141,JODHPUR-PUNE,8162,All
2019,12,JODHPUR,RAIPUR,179,176,JODHPUR-RAIPUR,355,All
2021,11,JODHPUR,RAJKOT,290,163,JODHPUR-RAJKOT,453,All
2017,12,JODHPUR,SURAT,1034,1232,JODHPUR-SURAT,2266,All
2018,1,JODHPUR,SURAT,981,1355,JODHPUR-SURAT,2336,All
2018,2,JODHPUR,SURAT,1401,1621,JODHPUR-SURAT,3022,All
2021,11,JODHPUR,SURAT,101,115,JODHPUR-SURAT,216,All
2018,10,JODHPUR,UDAIPUR,0,0,JODHPUR-UDAIPUR,0,All
2019,10,JODHPUR,UDAIPUR,0,0,JODHPUR-UDAIPUR,0,All
2020,1,JODHPUR,UDAIPUR,6,0,JODHPUR-UDAIPUR,6,All
2020,3,JODHPUR,UDAIPUR,8,0,JODHPUR-UDAIPUR,8,All
2021,11,JODHPUR,UDAIPUR,1,0,JODHPUR-UDAIPUR,1,All
2019,5,JORHAT,KOLKATA,4981,5110,JORHAT-KOLKATA,10091,All
2019,6,JORHAT,KOLKATA,5224,4884,JORHAT-KOLKATA,10108,All
2019,7,JORHAT,KOLKATA,5191,5016,JORHAT-KOLKATA,10207,All
2019,8,JORHAT,KOLKATA,4584,4564,JORHAT-KOLKATA,9148,All
2019,9,JORHAT,KOLKATA,4187,4761,JORHAT-KOLKATA,8948,All
2019,10,JORHAT,KOLKATA,4932,4883,JORHAT-KOLKATA,9815,All
2019,11,JORHAT,KOLKATA,4446,4687,JORHAT-KOLKATA,9133,All
2019,12,JORHAT,KOLKATA,4732,4868,JORHAT-KOLKATA,9600,All
2020,1,JORHAT,KOLKATA,4952,4800,JORHAT-KOLKATA,9752,All
2020,2,JORHAT,KOLKATA,4174,4235,JORHAT-KOLKATA,8409,All
2020,3,JORHAT,KOLKATA,2603,3467,JORHAT-KOLKATA,6070,All
2020,6,JORHAT,KOLKATA,403,724,JORHAT-KOLKATA,1127,All
2020,7,JORHAT,KOLKATA,760,692,JORHAT-KOLKATA,1452,All
2020,8,JORHAT,KOLKATA,767,733,JORHAT-KOLKATA,1500,All
2020,9,JORHAT,KOLKATA,809,1183,JORHAT-KOLKATA,1992,All
2020,10,JORHAT,KOLKATA,1328,1203,JORHAT-KOLKATA,2531,All
2020,11,JORHAT,KOLKATA,1633,1250,JORHAT-KOLKATA,2883,All
2020,12,JORHAT,KOLKATA,1952,1883,JORHAT-KOLKATA,3835,All
2021,1,JORHAT,KOLKATA,2209,1868,JORHAT-KOLKATA,4077,All
2021,2,JORHAT,KOLKATA,2323,1980,JORHAT-KOLKATA,4303,All
2021,3,JORHAT,KOLKATA,1899,1856,JORHAT-KOLKATA,3755,All
2021,4,JORHAT,KOLKATA,2162,2174,JORHAT-KOLKATA,4336,All
2021,6,JORHAT,KOLKATA,113,108,JORHAT-KOLKATA,221,All
2021,7,JORHAT,KOLKATA,1299,919,JORHAT-KOLKATA,2218,All
2021,8,JORHAT,KOLKATA,535,416,JORHAT-KOLKATA,951,All
2021,9,JORHAT,KOLKATA,1152,1262,JORHAT-KOLKATA,2414,All
2021,10,JORHAT,KOLKATA,2117,1975,JORHAT-KOLKATA,4092,All
2021,11,JORHAT,KOLKATA,3026,3379,JORHAT-KOLKATA,6405,All
2021,12,JORHAT,KOLKATA,3069,4022,JORHAT-KOLKATA,7091,All
2022,1,JORHAT,KOLKATA,1996,2363,JORHAT-KOLKATA,4359,All
2022,2,JORHAT,KOLKATA,1942,1875,JORHAT-KOLKATA,3817,All
2022,3,JORHAT,KOLKATA,2467,2733,JORHAT-KOLKATA,5200,All
2022,4,JORHAT,KOLKATA,3753,4012,JORHAT-KOLKATA,7765,All
2022,5,JORHAT,KOLKATA,3653,4111,JORHAT-KOLKATA,7764,All
2022,6,JORHAT,KOLKATA,3593,3624,JORHAT-KOLKATA,7217,All
2022,7,JORHAT,KOLKATA,3624,3738,JORHAT-KOLKATA,7362,All
2022,8,JORHAT,KOLKATA,3642,3846,JORHAT-KOLKATA,7488,All
2022,9,JORHAT,KOLKATA,2970,3453,JORHAT-KOLKATA,6423,All
2022,10,JORHAT,KOLKATA,3852,3913,JORHAT-KOLKATA,7765,All
2022,11,JORHAT,KOLKATA,3167,3515,JORHAT-KOLKATA,6682,All
2022,12,JORHAT,KOLKATA,3072,3697,JORHAT-KOLKATA,6769,All
2023,1,JORHAT,KOLKATA,3037,3270,JORHAT-KOLKATA,6307,All
2023,2,JORHAT,KOLKATA,3550,3705,JORHAT-KOLKATA,7255,All
2023,3,JORHAT,KOLKATA,3996,4153,JORHAT-KOLKATA,8149,All
2023,4,JORHAT,KOLKATA,3619,3761,JORHAT-KOLKATA,7380,All
2023,5,JORHAT,KOLKATA,4033,4298,JORHAT-KOLKATA,8331,All
2023,6,JORHAT,KOLKATA,3842,3961,JORHAT-KOLKATA,7803,All
2023,7,JORHAT,KOLKATA,4138,4366,JORHAT-KOLKATA,8504,All
2023,8,JORHAT,KOLKATA,4057,4333,JORHAT-KOLKATA,8390,All
2023,9,JORHAT,KOLKATA,4492,4471,JORHAT-KOLKATA,8963,All
2023,10,JORHAT,KOLKATA,4650,4752,JORHAT-KOLKATA,9402,All
2023,11,JORHAT,KOLKATA,4582,5009,JORHAT-KOLKATA,9591,All
2023,12,JORHAT,KOLKATA,4824,5262,JORHAT-KOLKATA,10086,All
2024,1,JORHAT,KOLKATA,4986,5046,JORHAT-KOLKATA,10032,All
2024,2,JORHAT,KOLKATA,4267,4637,JORHAT-KOLKATA,8904,All
2024,3,JORHAT,KOLKATA,4942,5161,JORHAT-KOLKATA,10103,All
2024,4,JORHAT,KOLKATA,5221,5425,JORHAT-KOLKATA,10646,All
2024,6,JORHAT,KOLKATA,5109,5126,JORHAT-KOLKATA,10235,All
2024,7,JORHAT,KOLKATA,5300,5259,JORHAT-KOLKATA,10559,All
2024,8,JORHAT,KOLKATA,4891,4978,JORHAT-KOLKATA,9869,All
2024,9,JORHAT,KOLKATA,4380,4809,JORHAT-KOLKATA,9189,All
2024,10,JORHAT,KOLKATA,4995,5114,JORHAT-KOLKATA,10109,All
2024,11,JORHAT,KOLKATA,5101,5140,JORHAT-KOLKATA,10241,All
2024,12,JORHAT,KOLKATA,5287,5386,JORHAT-KOLKATA,10673,All
2025,1,JORHAT,KOLKATA,6415,6510,JORHAT-KOLKATA,12925,All
2025,2,JORHAT,KOLKATA,5212,5627,JORHAT-KOLKATA,10839,All
2025,3,JORHAT,KOLKATA,6073,6621,JORHAT-KOLKATA,12694,All
2017,10,JORHAT,LUCKNOW,3,4,JORHAT-LUCKNOW,7,All
2017,11,JORHAT,LUCKNOW,4,2,JORHAT-LUCKNOW,6,All
2017,12,JORHAT,LUCKNOW,1,5,JORHAT-LUCKNOW,6,All
2018,1,JORHAT,LUCKNOW,2,0,JORHAT-LUCKNOW,2,All
2018,2,JORHAT,LUCKNOW,5,1,JORHAT-LUCKNOW,6,All
2018,3,JORHAT,LUCKNOW,1,4,JORHAT-LUCKNOW,5,All
2022,2,JORHAT,NAGPUR,0,7,JORHAT-NAGPUR,7,All
2024,12,JORHAT,PASIGHAT,16,3,JORHAT-PASIGHAT,19,All
2025,1,JORHAT,PASIGHAT,2,12,JORHAT-PASIGHAT,14,All
2024,10,JORHAT,TEZU,1,6,JORHAT-TEZU,7,All
2024,11,JORHAT,TEZU,45,28,JORHAT-TEZU,73,All
2024,12,JORHAT,TEZU,459,280,JORHAT-TEZU,739,All
2025,1,JORHAT,TEZU,278,204,JORHAT-TEZU,482,All
2019,1,KADAPA,CHENNAI,1556,1279,CHENNAI-KADAPA,2835,All
2019,2,KADAPA,CHENNAI,1251,1046,CHENNAI-KADAPA,2297,All
2019,3,KADAPA,CHENNAI,1569,1129,CHENNAI-KADAPA,2698,All
2019,4,KADAPA,CHENNAI,1694,1381,CHENNAI-KADAPA,3075,All
2019,1,KADAPA,HYDERABAD,1612,1718,HYDERABAD-KADAPA,3330,All
2019,2,KADAPA,HYDERABAD,1491,1617,HYDERABAD-KADAPA,3108,All
2019,3,KADAPA,HYDERABAD,1653,1731,HYDERABAD-KADAPA,3384,All
2019,4,KADAPA,HYDERABAD,1708,1675,HYDERABAD-KADAPA,3383,All
2019,1,KADAPA,VIJAYAWADA,1657,1657,KADAPA-VIJAYAWADA,3314,All
2019,2,KADAPA,VIJAYAWADA,1295,1236,KADAPA-VIJAYAWADA,2531,All
2019,3,KADAPA,VIJAYAWADA,1341,1290,KADAPA-VIJAYAWADA,2631,All
2019,4,KADAPA,VIJAYAWADA,1493,1321,KADAPA-VIJAYAWADA,2814,All
2019,5,KADAPA,VIJAYAWADA,1629,1475,KADAPA-VIJAYAWADA,3104,All
2019,6,KADAPA,VIJAYAWADA,1635,1484,KADAPA-VIJAYAWADA,3119,All
2019,7,KADAPA,VIJAYAWADA,1589,1440,KADAPA-VIJAYAWADA,3029,All
2019,8,KADAPA,VIJAYAWADA,1600,1468,KADAPA-VIJAYAWADA,3068,All
2019,9,KADAPA,VIJAYAWADA,1123,1134,KADAPA-VIJAYAWADA,2257,All
2019,10,KADAPA,VIJAYAWADA,1497,1541,KADAPA-VIJAYAWADA,3038,All
2019,11,KADAPA,VIJAYAWADA,1548,1767,KADAPA-VIJAYAWADA,3315,All
2019,12,KADAPA,VIJAYAWADA,1652,1860,KADAPA-VIJAYAWADA,3512,All
2020,1,KADAPA,VIJAYAWADA,1462,1625,KADAPA-VIJAYAWADA,3087,All
2020,2,KADAPA,VIJAYAWADA,1729,1842,KADAPA-VIJAYAWADA,3571,All
2020,3,KADAPA,VIJAYAWADA,1375,1370,KADAPA-VIJAYAWADA,2745,All
2020,5,KADAPA,VIJAYAWADA,44,14,KADAPA-VIJAYAWADA,58,All
2020,6,KADAPA,VIJAYAWADA,568,379,KADAPA-VIJAYAWADA,947,All
2020,7,KADAPA,VIJAYAWADA,275,240,KADAPA-VIJAYAWADA,515,All
2020,8,KADAPA,VIJAYAWADA,33,35,KADAPA-VIJAYAWADA,68,All
2020,9,KADAPA,VIJAYAWADA,67,64,KADAPA-VIJAYAWADA,131,All
2020,10,KADAPA,VIJAYAWADA,668,702,KADAPA-VIJAYAWADA,1370,All
2020,11,KADAPA,VIJAYAWADA,599,600,KADAPA-VIJAYAWADA,1199,All
2020,12,KADAPA,VIJAYAWADA,1484,1399,KADAPA-VIJAYAWADA,2883,All
2021,1,KADAPA,VIJAYAWADA,1705,1297,KADAPA-VIJAYAWADA,3002,All
2021,2,KADAPA,VIJAYAWADA,1279,1183,KADAPA-VIJAYAWADA,2462,All
2021,3,KADAPA,VIJAYAWADA,1414,1219,KADAPA-VIJAYAWADA,2633,All
2021,4,KADAPA,VIJAYAWADA,817,690,KADAPA-VIJAYAWADA,1507,All
2022,3,KADAPA,VIJAYAWADA,34,41,KADAPA-VIJAYAWADA,75,All
2022,4,KADAPA,VIJAYAWADA,241,192,KADAPA-VIJAYAWADA,433,All
2022,5,KADAPA,VIJAYAWADA,177,180,KADAPA-VIJAYAWADA,357,All
2022,6,KADAPA,VIJAYAWADA,229,159,KADAPA-VIJAYAWADA,388,All
2022,7,KADAPA,VIJAYAWADA,233,235,KADAPA-VIJAYAWADA,468,All
2022,8,KADAPA,VIJAYAWADA,229,200,KADAPA-VIJAYAWADA,429,All
2022,9,KADAPA,VIJAYAWADA,249,328,KADAPA-VIJAYAWADA,577,All
2022,10,KADAPA,VIJAYAWADA,450,342,KADAPA-VIJAYAWADA,792,All
2022,11,KADAPA,VIJAYAWADA,208,228,KADAPA-VIJAYAWADA,436,All
2022,12,KADAPA,VIJAYAWADA,216,254,KADAPA-VIJAYAWADA,470,All
2023,2,KADAPA,VIJAYAWADA,296,270,KADAPA-VIJAYAWADA,566,All
2023,3,KADAPA,VIJAYAWADA,358,286,KADAPA-VIJAYAWADA,644,All
2023,4,KADAPA,VIJAYAWADA,272,322,KADAPA-VIJAYAWADA,594,All
2023,5,KADAPA,VIJAYAWADA,411,360,KADAPA-VIJAYAWADA,771,All
2022,3,KADAPA,VISAKHAPATNAM,65,85,KADAPA-VISAKHAPATNAM,150,All
2022,4,KADAPA,VISAKHAPATNAM,565,561,KADAPA-VISAKHAPATNAM,1126,All
2022,5,KADAPA,VISAKHAPATNAM,452,512,KADAPA-VISAKHAPATNAM,964,All
2022,6,KADAPA,VISAKHAPATNAM,622,637,KADAPA-VISAKHAPATNAM,1259,All
2022,7,KADAPA,VISAKHAPATNAM,508,540,KADAPA-VISAKHAPATNAM,1048,All
2022,8,KADAPA,VISAKHAPATNAM,571,533,KADAPA-VISAKHAPATNAM,1104,All
2022,9,KADAPA,VISAKHAPATNAM,391,368,KADAPA-VISAKHAPATNAM,759,All
2022,10,KADAPA,VISAKHAPATNAM,400,482,KADAPA-VISAKHAPATNAM,882,All
2022,11,KADAPA,VISAKHAPATNAM,275,245,KADAPA-VISAKHAPATNAM,520,All
2022,12,KADAPA,VISAKHAPATNAM,329,448,KADAPA-VISAKHAPATNAM,777,All
2023,2,KADAPA,VISAKHAPATNAM,231,244,KADAPA-VISAKHAPATNAM,475,All
2023,3,KADAPA,VISAKHAPATNAM,369,354,KADAPA-VISAKHAPATNAM,723,All
2023,4,KADAPA,VISAKHAPATNAM,311,280,KADAPA-VISAKHAPATNAM,591,All
2023,5,KADAPA,VISAKHAPATNAM,499,426,KADAPA-VISAKHAPATNAM,925,All
2022,11,KALABURAGI,TIRUPATI,372,290,KALABURAGI-TIRUPATI,662,All
2023,1,KALABURAGI,TIRUPATI,353,286,KALABURAGI-TIRUPATI,639,All
2023,2,KALABURAGI,TIRUPATI,473,318,KALABURAGI-TIRUPATI,791,All
2023,3,KALABURAGI,TIRUPATI,508,398,KALABURAGI-TIRUPATI,906,All
2023,4,KALABURAGI,TIRUPATI,577,428,KALABURAGI-TIRUPATI,1005,All
2023,5,KALABURAGI,TIRUPATI,603,690,KALABURAGI-TIRUPATI,1293,All
2023,6,KALABURAGI,TIRUPATI,645,374,KALABURAGI-TIRUPATI,1019,All
2023,7,KALABURAGI,TIRUPATI,740,680,KALABURAGI-TIRUPATI,1420,All
2023,8,KALABURAGI,TIRUPATI,756,433,KALABURAGI-TIRUPATI,1189,All
2023,9,KALABURAGI,TIRUPATI,610,480,KALABURAGI-TIRUPATI,1090,All
2023,10,KALABURAGI,TIRUPATI,618,453,KALABURAGI-TIRUPATI,1071,All
2023,11,KALABURAGI,TIRUPATI,950,790,KALABURAGI-TIRUPATI,1740,All
2023,12,KALABURAGI,TIRUPATI,924,647,KALABURAGI-TIRUPATI,1571,All
2024,1,KALABURAGI,TIRUPATI,713,609,KALABURAGI-TIRUPATI,1322,All
2024,2,KALABURAGI,TIRUPATI,701,432,KALABURAGI-TIRUPATI,1133,All
2024,3,KALABURAGI,TIRUPATI,870,672,KALABURAGI-TIRUPATI,1542,All
2024,4,KALABURAGI,TIRUPATI,421,360,KALABURAGI-TIRUPATI,781,All
2024,6,KALABURAGI,TIRUPATI,423,282,KALABURAGI-TIRUPATI,705,All
2023,11,KALABURAGI,VIDYANAGAR,18,0,KALABURAGI-VIDYANAGAR,18,All
2020,11,"KALABURAGI, KARNATAKA",KOZHIKODE,0,23,"KALABURAGI, KARNATAKA-KOZHIKODE",23,All
2020,12,"KALABURAGI, KARNATAKA",KOZHIKODE,0,49,"KALABURAGI, KARNATAKA-KOZHIKODE",49,All
2021,1,"KALABURAGI, KARNATAKA",KOZHIKODE,0,21,"KALABURAGI, KARNATAKA-KOZHIKODE",21,All
2021,2,"KALABURAGI, KARNATAKA",KOZHIKODE,0,5,"KALABURAGI, KARNATAKA-KOZHIKODE",5,All
2020,11,"KALABURAGI, KARNATAKA",MUMBAI,65,60,"KALABURAGI, KARNATAKA-MUMBAI",125,All
2021,3,"KALABURAGI, KARNATAKA",MUMBAI,39,16,"KALABURAGI, KARNATAKA-MUMBAI",55,All
2021,4,"KALABURAGI, KARNATAKA",MUMBAI,46,31,"KALABURAGI, KARNATAKA-MUMBAI",77,All
2021,1,"KALABURAGI, KARNATAKA",TIRUPATI,445,319,"KALABURAGI, KARNATAKA-TIRUPATI",764,All
2021,2,"KALABURAGI, KARNATAKA",TIRUPATI,662,560,"KALABURAGI, KARNATAKA-TIRUPATI",1222,All
2021,3,"KALABURAGI, KARNATAKA",TIRUPATI,742,582,"KALABURAGI, KARNATAKA-TIRUPATI",1324,All
2021,4,"KALABURAGI, KARNATAKA",TIRUPATI,373,320,"KALABURAGI, KARNATAKA-TIRUPATI",693,All
2021,6,"KALABURAGI, KARNATAKA",TIRUPATI,493,452,"KALABURAGI, KARNATAKA-TIRUPATI",945,All
2021,7,"KALABURAGI, KARNATAKA",TIRUPATI,493,400,"KALABURAGI, KARNATAKA-TIRUPATI",893,All
2021,8,"KALABURAGI, KARNATAKA",TIRUPATI,586,405,"KALABURAGI, KARNATAKA-TIRUPATI",991,All
2021,9,"KALABURAGI, KARNATAKA",TIRUPATI,359,285,"KALABURAGI, KARNATAKA-TIRUPATI",644,All
2021,10,"KALABURAGI, KARNATAKA",TIRUPATI,485,335,"KALABURAGI, KARNATAKA-TIRUPATI",820,All
2021,11,"KALABURAGI, KARNATAKA",TIRUPATI,360,280,"KALABURAGI, KARNATAKA-TIRUPATI",640,All
2021,12,"KALABURAGI, KARNATAKA",TIRUPATI,420,370,"KALABURAGI, KARNATAKA-TIRUPATI",790,All
2022,1,"KALABURAGI, KARNATAKA",TIRUPATI,272,256,"KALABURAGI, KARNATAKA-TIRUPATI",528,All
2022,2,"KALABURAGI, KARNATAKA",TIRUPATI,393,280,"KALABURAGI, KARNATAKA-TIRUPATI",673,All
2022,3,"KALABURAGI, KARNATAKA",TIRUPATI,632,482,"KALABURAGI, KARNATAKA-TIRUPATI",1114,All
2022,4,"KALABURAGI, KARNATAKA",TIRUPATI,613,500,"KALABURAGI, KARNATAKA-TIRUPATI",1113,All
2022,5,"KALABURAGI, KARNATAKA",TIRUPATI,643,428,"KALABURAGI, KARNATAKA-TIRUPATI",1071,All
2022,6,"KALABURAGI, KARNATAKA",TIRUPATI,382,260,"KALABURAGI, KARNATAKA-TIRUPATI",642,All
2022,7,"KALABURAGI, KARNATAKA",TIRUPATI,320,180,"KALABURAGI, KARNATAKA-TIRUPATI",500,All
2022,8,"KALABURAGI, KARNATAKA",TIRUPATI,410,296,"KALABURAGI, KARNATAKA-TIRUPATI",706,All
2022,9,"KALABURAGI, KARNATAKA",TIRUPATI,272,196,"KALABURAGI, KARNATAKA-TIRUPATI",468,All
2022,10,"KALABURAGI, KARNATAKA",TIRUPATI,202,124,"KALABURAGI, KARNATAKA-TIRUPATI",326,All
2022,12,"KALABURAGI, KARNATAKA",TIRUPATI,205,153,"KALABURAGI, KARNATAKA-TIRUPATI",358,All
2019,5,KANDLA,MUMBAI,2133,2333,KANDLA-MUMBAI,4466,All
2019,6,KANDLA,MUMBAI,1962,2158,KANDLA-MUMBAI,4120,All
2019,7,KANDLA,MUMBAI,2026,2158,KANDLA-MUMBAI,4184,All
2019,8,KANDLA,MUMBAI,2171,2253,KANDLA-MUMBAI,4424,All
2019,9,KANDLA,MUMBAI,2066,2096,KANDLA-MUMBAI,4162,All
2019,10,KANDLA,MUMBAI,2238,2336,KANDLA-MUMBAI,4574,All
2019,11,KANDLA,MUMBAI,1816,1902,KANDLA-MUMBAI,3718,All
2019,12,KANDLA,MUMBAI,2307,2405,KANDLA-MUMBAI,4712,All
2020,1,KANDLA,MUMBAI,2252,2325,KANDLA-MUMBAI,4577,All
2020,2,KANDLA,MUMBAI,2227,2257,KANDLA-MUMBAI,4484,All
2020,3,KANDLA,MUMBAI,1433,1510,KANDLA-MUMBAI,2943,All
2020,8,KANDLA,MUMBAI,500,411,KANDLA-MUMBAI,911,All
2020,9,KANDLA,MUMBAI,1849,1760,KANDLA-MUMBAI,3609,All
2020,10,KANDLA,MUMBAI,2022,2171,KANDLA-MUMBAI,4193,All
2020,11,KANDLA,MUMBAI,1943,2086,KANDLA-MUMBAI,4029,All
2020,12,KANDLA,MUMBAI,1772,1930,KANDLA-MUMBAI,3702,All
2021,1,KANDLA,MUMBAI,2150,2265,KANDLA-MUMBAI,4415,All
2021,2,KANDLA,MUMBAI,1867,2178,KANDLA-MUMBAI,4045,All
2021,3,KANDLA,MUMBAI,1928,2114,KANDLA-MUMBAI,4042,All
2021,4,KANDLA,MUMBAI,940,1088,KANDLA-MUMBAI,2028,All
2021,6,KANDLA,MUMBAI,1356,1542,KANDLA-MUMBAI,2898,All
2021,7,KANDLA,MUMBAI,1407,1537,KANDLA-MUMBAI,2944,All
2021,8,KANDLA,MUMBAI,2008,2253,KANDLA-MUMBAI,4261,All
2021,9,KANDLA,MUMBAI,2071,2318,KANDLA-MUMBAI,4389,All
2021,10,KANDLA,MUMBAI,2129,2311,KANDLA-MUMBAI,4440,All
2021,11,KANDLA,MUMBAI,1760,1864,KANDLA-MUMBAI,3624,All
2021,12,KANDLA,MUMBAI,2919,3130,KANDLA-MUMBAI,6049,All
2022,1,KANDLA,MUMBAI,2525,2685,KANDLA-MUMBAI,5210,All
2022,2,KANDLA,MUMBAI,3036,3164,KANDLA-MUMBAI,6200,All
2022,3,KANDLA,MUMBAI,3255,3379,KANDLA-MUMBAI,6634,All
2022,4,KANDLA,MUMBAI,2256,2277,KANDLA-MUMBAI,4533,All
2022,5,KANDLA,MUMBAI,2243,2269,KANDLA-MUMBAI,4512,All
2022,6,KANDLA,MUMBAI,2152,2265,KANDLA-MUMBAI,4417,All
2022,7,KANDLA,MUMBAI,1952,1995,KANDLA-MUMBAI,3947,All
2022,8,KANDLA,MUMBAI,2390,2459,KANDLA-MUMBAI,4849,All
2022,9,KANDLA,MUMBAI,2340,2386,KANDLA-MUMBAI,4726,All
2022,10,KANDLA,MUMBAI,2224,2277,KANDLA-MUMBAI,4501,All
2022,11,KANDLA,MUMBAI,2631,2628,KANDLA-MUMBAI,5259,All
2022,12,KANDLA,MUMBAI,2557,2710,KANDLA-MUMBAI,5267,All
2023,11,KANDLA,MUMBAI,2364,2352,KANDLA-MUMBAI,4716,All
2023,12,KANDLA,MUMBAI,2439,2461,KANDLA-MUMBAI,4900,All
2024,1,KANDLA,MUMBAI,2448,2370,KANDLA-MUMBAI,4818,All
2024,2,KANDLA,MUMBAI,2241,2178,KANDLA-MUMBAI,4419,All
2024,3,KANDLA,MUMBAI,1884,2095,KANDLA-MUMBAI,3979,All
2024,4,KANDLA,MUMBAI,1630,1837,KANDLA-MUMBAI,3467,All
2024,6,KANDLA,MUMBAI,559,688,KANDLA-MUMBAI,1247,All
2024,7,KANDLA,MUMBAI,1145,1437,KANDLA-MUMBAI,2582,All
2024,8,KANDLA,MUMBAI,905,1017,KANDLA-MUMBAI,1922,All
2024,9,KANDLA,MUMBAI,828,1132,KANDLA-MUMBAI,1960,All
2024,10,KANDLA,MUMBAI,1299,1729,KANDLA-MUMBAI,3028,All
2024,11,KANDLA,MUMBAI,2159,2367,KANDLA-MUMBAI,4526,All
2024,12,KANDLA,MUMBAI,2274,2444,KANDLA-MUMBAI,4718,All
2025,1,KANDLA,MUMBAI,2352,2455,KANDLA-MUMBAI,4807,All
2025,2,KANDLA,MUMBAI,2099,2082,KANDLA-MUMBAI,4181,All
2025,3,KANDLA,MUMBAI,1783,1884,KANDLA-MUMBAI,3667,All
2019,11,KANDLA,NASIK,16,27,KANDLA-NASIK,43,All
2019,12,KANDLA,NASIK,59,99,KANDLA-NASIK,158,All
2020,1,KANDLA,NASIK,42,118,KANDLA-NASIK,160,All
2020,2,KANDLA,NASIK,88,133,KANDLA-NASIK,221,All
2020,3,KANDLA,NASIK,9,30,KANDLA-NASIK,39,All
2020,6,KANDLA,NASIK,4,21,KANDLA-NASIK,25,All
2020,7,KANDLA,NASIK,12,23,KANDLA-NASIK,35,All
2018,12,KANNUR,CHENNAI,1090,1249,CHENNAI-KANNUR,2339,All
2019,1,KANNUR,CHENNAI,2218,2199,CHENNAI-KANNUR,4417,All
2019,2,KANNUR,CHENNAI,2925,3469,CHENNAI-KANNUR,6394,All
2019,3,KANNUR,CHENNAI,3118,3851,CHENNAI-KANNUR,6969,All
2019,4,KANNUR,CHENNAI,4202,4464,CHENNAI-KANNUR,8666,All
2019,1,KANNUR,DABOLIM,292,292,DABOLIM-KANNUR,584,All
2019,2,KANNUR,DABOLIM,1398,1375,DABOLIM-KANNUR,2773,All
2019,3,KANNUR,DABOLIM,1334,1261,DABOLIM-KANNUR,2595,All
2019,4,KANNUR,DABOLIM,1986,2053,DABOLIM-KANNUR,4039,All
2018,12,KANNUR,DELHI,0,497,DELHI-KANNUR,497,All
2019,3,KANNUR,DELHI,0,2,DELHI-KANNUR,2,All
2019,4,KANNUR,DELHI,1718,1784,DELHI-KANNUR,3502,All
2019,1,KANNUR,HUBLI,147,156,HUBLI-KANNUR,303,All
2019,2,KANNUR,HUBLI,666,766,HUBLI-KANNUR,1432,All
2019,3,KANNUR,HUBLI,605,686,HUBLI-KANNUR,1291,All
2019,4,KANNUR,HUBLI,896,1058,HUBLI-KANNUR,1954,All
2018,12,KANNUR,HYDERABAD,1402,1337,HYDERABAD-KANNUR,2739,All
2019,1,KANNUR,HYDERABAD,2506,2157,HYDERABAD-KANNUR,4663,All
2019,2,KANNUR,HYDERABAD,3873,3131,HYDERABAD-KANNUR,7004,All
2019,3,KANNUR,HYDERABAD,4281,3160,HYDERABAD-KANNUR,7441,All
2019,4,KANNUR,HYDERABAD,5001,4790,HYDERABAD-KANNUR,9791,All
2019,3,KANNUR,KOCHI,130,139,KANNUR-KOCHI,269,All
2019,4,KANNUR,KOCHI,4087,3929,KANNUR-KOCHI,8016,All
2019,5,KANNUR,KOCHI,4186,3866,KANNUR-KOCHI,8052,All
2019,6,KANNUR,KOCHI,3371,3390,KANNUR-KOCHI,6761,All
2019,7,KANNUR,KOCHI,3673,3504,KANNUR-KOCHI,7177,All
2019,8,KANNUR,KOCHI,3303,3374,KANNUR-KOCHI,6677,All
2019,9,KANNUR,KOCHI,3796,3673,KANNUR-KOCHI,7469,All
2019,10,KANNUR,KOCHI,3886,3263,KANNUR-KOCHI,7149,All
2019,11,KANNUR,KOCHI,4091,3548,KANNUR-KOCHI,7639,All
2019,12,KANNUR,KOCHI,4500,4214,KANNUR-KOCHI,8714,All
2020,1,KANNUR,KOCHI,4347,4357,KANNUR-KOCHI,8704,All
2020,2,KANNUR,KOCHI,3923,3577,KANNUR-KOCHI,7500,All
2020,3,KANNUR,KOCHI,1793,2050,KANNUR-KOCHI,3843,All
2020,5,KANNUR,KOCHI,45,98,KANNUR-KOCHI,143,All
2020,6,KANNUR,KOCHI,198,418,KANNUR-KOCHI,616,All
2020,7,KANNUR,KOCHI,76,12,KANNUR-KOCHI,88,All
2020,8,KANNUR,KOCHI,255,135,KANNUR-KOCHI,390,All
2020,9,KANNUR,KOCHI,240,444,KANNUR-KOCHI,684,All
2020,10,KANNUR,KOCHI,260,528,KANNUR-KOCHI,788,All
2020,11,KANNUR,KOCHI,482,416,KANNUR-KOCHI,898,All
2020,12,KANNUR,KOCHI,5618,4690,KANNUR-KOCHI,10308,All
2021,1,KANNUR,KOCHI,813,624,KANNUR-KOCHI,1437,All
2021,2,KANNUR,KOCHI,642,624,KANNUR-KOCHI,1266,All
2021,3,KANNUR,KOCHI,836,874,KANNUR-KOCHI,1710,All
2021,4,KANNUR,KOCHI,1606,1221,KANNUR-KOCHI,2827,All
2021,6,KANNUR,KOCHI,1363,606,KANNUR-KOCHI,1969,All
2021,7,KANNUR,KOCHI,1979,1138,KANNUR-KOCHI,3117,All
2021,8,KANNUR,KOCHI,1705,1586,KANNUR-KOCHI,3291,All
2021,9,KANNUR,KOCHI,1631,1903,KANNUR-KOCHI,3534,All
2021,10,KANNUR,KOCHI,1978,1977,KANNUR-KOCHI,3955,All
2021,11,KANNUR,KOCHI,2045,1914,KANNUR-KOCHI,3959,All
2021,12,KANNUR,KOCHI,2151,2092,KANNUR-KOCHI,4243,All
2022,1,KANNUR,KOCHI,1721,1510,KANNUR-KOCHI,3231,All
2022,2,KANNUR,KOCHI,1082,1032,KANNUR-KOCHI,2114,All
2022,3,KANNUR,KOCHI,2003,2070,KANNUR-KOCHI,4073,All
2022,4,KANNUR,KOCHI,2206,2169,KANNUR-KOCHI,4375,All
2022,5,KANNUR,KOCHI,2294,2241,KANNUR-KOCHI,4535,All
2022,6,KANNUR,KOCHI,1877,1705,KANNUR-KOCHI,3582,All
2022,7,KANNUR,KOCHI,2029,2001,KANNUR-KOCHI,4030,All
2022,8,KANNUR,KOCHI,2055,1954,KANNUR-KOCHI,4009,All
2022,9,KANNUR,KOCHI,2006,1825,KANNUR-KOCHI,3831,All
2022,10,KANNUR,KOCHI,1551,1380,KANNUR-KOCHI,2931,All
2022,11,KANNUR,KOCHI,1292,1227,KANNUR-KOCHI,2519,All
2022,12,KANNUR,KOCHI,1666,1675,KANNUR-KOCHI,3341,All
2023,11,KANNUR,KOCHI,1824,1817,KANNUR-KOCHI,3641,All
2023,12,KANNUR,KOCHI,2025,1872,KANNUR-KOCHI,3897,All
2024,1,KANNUR,KOCHI,1991,1904,KANNUR-KOCHI,3895,All
2024,2,KANNUR,KOCHI,1682,1334,KANNUR-KOCHI,3016,All
2024,3,KANNUR,KOCHI,1312,1287,KANNUR-KOCHI,2599,All
2024,4,KANNUR,KOCHI,1493,1682,KANNUR-KOCHI,3175,All
2024,6,KANNUR,KOCHI,1005,1640,KANNUR-KOCHI,2645,All
2024,7,KANNUR,KOCHI,1280,1728,KANNUR-KOCHI,3008,All
2024,8,KANNUR,KOCHI,1230,1778,KANNUR-KOCHI,3008,All
2024,9,KANNUR,KOCHI,1133,1399,KANNUR-KOCHI,2532,All
2024,10,KANNUR,KOCHI,941,1167,KANNUR-KOCHI,2108,All
2024,11,KANNUR,KOCHI,1102,1141,KANNUR-KOCHI,2243,All
2024,12,KANNUR,KOCHI,1443,1422,KANNUR-KOCHI,2865,All
2025,1,KANNUR,KOCHI,1407,1592,KANNUR-KOCHI,2999,All
2025,2,KANNUR,KOCHI,1242,1264,KANNUR-KOCHI,2506,All
2025,3,KANNUR,KOCHI,1081,1442,KANNUR-KOCHI,2523,All
2019,5,KANNUR,KOZHIKODE,53,115,KANNUR-KOZHIKODE,168,All
2019,6,KANNUR,KOZHIKODE,50,56,KANNUR-KOZHIKODE,106,All
2019,7,KANNUR,KOZHIKODE,30,78,KANNUR-KOZHIKODE,108,All
2019,8,KANNUR,KOZHIKODE,25,59,KANNUR-KOZHIKODE,84,All
2019,9,KANNUR,KOZHIKODE,27,56,KANNUR-KOZHIKODE,83,All
2019,10,KANNUR,KOZHIKODE,37,87,KANNUR-KOZHIKODE,124,All
2019,11,KANNUR,KOZHIKODE,0,131,KANNUR-KOZHIKODE,131,All
2019,12,KANNUR,KOZHIKODE,0,132,KANNUR-KOZHIKODE,132,All
2020,1,KANNUR,KOZHIKODE,0,98,KANNUR-KOZHIKODE,98,All
2020,2,KANNUR,KOZHIKODE,0,380,KANNUR-KOZHIKODE,380,All
2020,3,KANNUR,KOZHIKODE,0,268,KANNUR-KOZHIKODE,268,All
2020,7,KANNUR,KOZHIKODE,5,0,KANNUR-KOZHIKODE,5,All
2020,8,KANNUR,KOZHIKODE,1,0,KANNUR-KOZHIKODE,1,All
2020,9,KANNUR,KOZHIKODE,3,0,KANNUR-KOZHIKODE,3,All
2020,10,KANNUR,KOZHIKODE,3,0,KANNUR-KOZHIKODE,3,All
2020,11,KANNUR,KOZHIKODE,15,0,KANNUR-KOZHIKODE,15,All
2020,12,KANNUR,KOZHIKODE,9,0,KANNUR-KOZHIKODE,9,All
2021,1,KANNUR,KOZHIKODE,9,0,KANNUR-KOZHIKODE,9,All
2021,2,KANNUR,KOZHIKODE,5,0,KANNUR-KOZHIKODE,5,All
2021,3,KANNUR,KOZHIKODE,10,0,KANNUR-KOZHIKODE,10,All
2021,4,KANNUR,KOZHIKODE,3,0,KANNUR-KOZHIKODE,3,All
2021,6,KANNUR,KOZHIKODE,4,0,KANNUR-KOZHIKODE,4,All
2021,7,KANNUR,KOZHIKODE,6,8,KANNUR-KOZHIKODE,14,All
2021,8,KANNUR,KOZHIKODE,0,6,KANNUR-KOZHIKODE,6,All
2021,9,KANNUR,KOZHIKODE,1,0,KANNUR-KOZHIKODE,1,All
2021,10,KANNUR,KOZHIKODE,1,0,KANNUR-KOZHIKODE,1,All
2021,12,KANNUR,KOZHIKODE,1,11,KANNUR-KOZHIKODE,12,All
2022,1,KANNUR,KOZHIKODE,6,8,KANNUR-KOZHIKODE,14,All
2022,2,KANNUR,KOZHIKODE,1,13,KANNUR-KOZHIKODE,14,All
2022,3,KANNUR,KOZHIKODE,2,33,KANNUR-KOZHIKODE,35,All
2022,4,KANNUR,KOZHIKODE,13,179,KANNUR-KOZHIKODE,192,All
2022,5,KANNUR,KOZHIKODE,16,69,KANNUR-KOZHIKODE,85,All
2022,6,KANNUR,KOZHIKODE,6,52,KANNUR-KOZHIKODE,58,All
2022,7,KANNUR,KOZHIKODE,8,60,KANNUR-KOZHIKODE,68,All
2022,8,KANNUR,KOZHIKODE,12,106,KANNUR-KOZHIKODE,118,All
2022,9,KANNUR,KOZHIKODE,23,170,KANNUR-KOZHIKODE,193,All
2022,10,KANNUR,KOZHIKODE,16,77,KANNUR-KOZHIKODE,93,All
2022,11,KANNUR,KOZHIKODE,6,127,KANNUR-KOZHIKODE,133,All
2022,12,KANNUR,KOZHIKODE,28,121,KANNUR-KOZHIKODE,149,All
2023,1,KANNUR,KOZHIKODE,4,136,KANNUR-KOZHIKODE,140,All
2023,2,KANNUR,KOZHIKODE,0,110,KANNUR-KOZHIKODE,110,All
2021,9,KANNUR,MANGALORE,119,0,KANNUR-MANGALORE,119,All
2022,2,KANNUR,MANGALORE,158,100,KANNUR-MANGALORE,258,All
2022,5,KANNUR,MANGALORE,0,77,KANNUR-MANGALORE,77,All
2023,2,KANNUR,MANGALORE,63,0,KANNUR-MANGALORE,63,All
2023,5,KANNUR,MANGALORE,165,0,KANNUR-MANGALORE,165,All
2023,10,KANNUR,MANGALORE,135,0,KANNUR-MANGALORE,135,All
2024,2,KANNUR,MANGALORE,119,0,KANNUR-MANGALORE,119,All
2025,3,KANNUR,MANGALORE,167,0,KANNUR-MANGALORE,167,All
2019,5,KANNUR,MUMBAI,9991,11411,KANNUR-MUMBAI,21402,All
2019,6,KANNUR,MUMBAI,8674,8346,KANNUR-MUMBAI,17020,All
2019,7,KANNUR,MUMBAI,6747,9245,KANNUR-MUMBAI,15992,All
2019,8,KANNUR,MUMBAI,9283,9537,KANNUR-MUMBAI,18820,All
2019,9,KANNUR,MUMBAI,7891,7186,KANNUR-MUMBAI,15077,All
2019,10,KANNUR,MUMBAI,6518,8405,KANNUR-MUMBAI,14923,All
2019,11,KANNUR,MUMBAI,3641,3593,KANNUR-MUMBAI,7234,All
2019,12,KANNUR,MUMBAI,3980,4962,KANNUR-MUMBAI,8942,All
2020,1,KANNUR,MUMBAI,4350,5014,KANNUR-MUMBAI,9364,All
2020,2,KANNUR,MUMBAI,4409,4830,KANNUR-MUMBAI,9239,All
2020,3,KANNUR,MUMBAI,2758,2811,KANNUR-MUMBAI,5569,All
2020,7,KANNUR,MUMBAI,0,733,KANNUR-MUMBAI,733,All
2020,9,KANNUR,MUMBAI,354,197,KANNUR-MUMBAI,551,All
2020,10,KANNUR,MUMBAI,157,0,KANNUR-MUMBAI,157,All
2020,11,KANNUR,MUMBAI,2343,2693,KANNUR-MUMBAI,5036,All
2020,12,KANNUR,MUMBAI,5623,3737,KANNUR-MUMBAI,9360,All
2021,1,KANNUR,MUMBAI,3618,3869,KANNUR-MUMBAI,7487,All
2021,2,KANNUR,MUMBAI,3304,3660,KANNUR-MUMBAI,6964,All
2021,3,KANNUR,MUMBAI,3098,3432,KANNUR-MUMBAI,6530,All
2021,4,KANNUR,MUMBAI,2317,3243,KANNUR-MUMBAI,5560,All
2021,6,KANNUR,MUMBAI,0,1050,KANNUR-MUMBAI,1050,All
2021,7,KANNUR,MUMBAI,592,1426,KANNUR-MUMBAI,2018,All
2021,8,KANNUR,MUMBAI,793,1134,KANNUR-MUMBAI,1927,All
2021,9,KANNUR,MUMBAI,2627,1583,KANNUR-MUMBAI,4210,All
2021,10,KANNUR,MUMBAI,2865,2626,KANNUR-MUMBAI,5491,All
2021,11,KANNUR,MUMBAI,3901,3713,KANNUR-MUMBAI,7614,All
2021,12,KANNUR,MUMBAI,2837,3401,KANNUR-MUMBAI,6238,All
2022,1,KANNUR,MUMBAI,1789,1558,KANNUR-MUMBAI,3347,All
2022,2,KANNUR,MUMBAI,1491,1407,KANNUR-MUMBAI,2898,All
2022,3,KANNUR,MUMBAI,2566,3050,KANNUR-MUMBAI,5616,All
2022,4,KANNUR,MUMBAI,3036,4394,KANNUR-MUMBAI,7430,All
2022,5,KANNUR,MUMBAI,3954,5323,KANNUR-MUMBAI,9277,All
2022,6,KANNUR,MUMBAI,2480,2453,KANNUR-MUMBAI,4933,All
2022,7,KANNUR,MUMBAI,3528,4499,KANNUR-MUMBAI,8027,All
2022,8,KANNUR,MUMBAI,5161,5871,KANNUR-MUMBAI,11032,All
2022,9,KANNUR,MUMBAI,5566,5362,KANNUR-MUMBAI,10928,All
2022,10,KANNUR,MUMBAI,2098,1783,KANNUR-MUMBAI,3881,All
2022,11,KANNUR,MUMBAI,5097,4779,KANNUR-MUMBAI,9876,All
2022,12,KANNUR,MUMBAI,5277,5684,KANNUR-MUMBAI,10961,All
2023,11,KANNUR,MUMBAI,3433,3516,KANNUR-MUMBAI,6949,All
2023,12,KANNUR,MUMBAI,4494,5564,KANNUR-MUMBAI,10058,All
2024,1,KANNUR,MUMBAI,4846,4640,KANNUR-MUMBAI,9486,All
2024,2,KANNUR,MUMBAI,3243,3086,KANNUR-MUMBAI,6329,All
2024,3,KANNUR,MUMBAI,3140,3059,KANNUR-MUMBAI,6199,All
2024,4,KANNUR,MUMBAI,2829,2897,KANNUR-MUMBAI,5726,All
2024,6,KANNUR,MUMBAI,2642,2821,KANNUR-MUMBAI,5463,All
2024,7,KANNUR,MUMBAI,2545,2933,KANNUR-MUMBAI,5478,All
2024,8,KANNUR,MUMBAI,2950,2801,KANNUR-MUMBAI,5751,All
2024,9,KANNUR,MUMBAI,3360,3422,KANNUR-MUMBAI,6782,All
2024,10,KANNUR,MUMBAI,2416,2734,KANNUR-MUMBAI,5150,All
2024,11,KANNUR,MUMBAI,2828,2747,KANNUR-MUMBAI,5575,All
2024,12,KANNUR,MUMBAI,2856,3232,KANNUR-MUMBAI,6088,All
2025,1,KANNUR,MUMBAI,2991,3105,KANNUR-MUMBAI,6096,All
2025,2,KANNUR,MUMBAI,2552,2499,KANNUR-MUMBAI,5051,All
2025,3,KANNUR,MUMBAI,2521,2570,KANNUR-MUMBAI,5091,All
2021,7,KANNUR,PATNA,3,0,KANNUR-PATNA,3,All
2024,2,KANNUR,PUNE,0,3,KANNUR-PUNE,3,All
2022,12,KANNUR,TIRUCHIRAPALLY,87,12,KANNUR-TIRUCHIRAPALLY,99,All
2023,1,KANNUR,TIRUCHIRAPALLY,70,28,KANNUR-TIRUCHIRAPALLY,98,All
2023,2,KANNUR,TIRUCHIRAPALLY,39,18,KANNUR-TIRUCHIRAPALLY,57,All
2023,3,KANNUR,TIRUCHIRAPALLY,65,8,KANNUR-TIRUCHIRAPALLY,73,All
2018,12,KANNUR,TRIVANDRUM,179,0,KANNUR-TRIVANDRUM,179,All
2019,3,KANNUR,TRIVANDRUM,64,73,KANNUR-TRIVANDRUM,137,All
2019,4,KANNUR,TRIVANDRUM,2114,2119,KANNUR-TRIVANDRUM,4233,All
2019,5,KANNUR,TRIVANDRUM,2234,2100,KANNUR-TRIVANDRUM,4334,All
2019,6,KANNUR,TRIVANDRUM,1988,1900,KANNUR-TRIVANDRUM,3888,All
2019,7,KANNUR,TRIVANDRUM,1946,1903,KANNUR-TRIVANDRUM,3849,All
2019,8,KANNUR,TRIVANDRUM,1833,1898,KANNUR-TRIVANDRUM,3731,All
2019,9,KANNUR,TRIVANDRUM,1884,1977,KANNUR-TRIVANDRUM,3861,All
2019,10,KANNUR,TRIVANDRUM,1876,1619,KANNUR-TRIVANDRUM,3495,All
2019,11,KANNUR,TRIVANDRUM,3018,2722,KANNUR-TRIVANDRUM,5740,All
2019,12,KANNUR,TRIVANDRUM,4374,3890,KANNUR-TRIVANDRUM,8264,All
2020,1,KANNUR,TRIVANDRUM,4160,4054,KANNUR-TRIVANDRUM,8214,All
2020,2,KANNUR,TRIVANDRUM,3840,3927,KANNUR-TRIVANDRUM,7767,All
2020,3,KANNUR,TRIVANDRUM,1910,2106,KANNUR-TRIVANDRUM,4016,All
2020,5,KANNUR,TRIVANDRUM,40,70,KANNUR-TRIVANDRUM,110,All
2020,6,KANNUR,TRIVANDRUM,251,448,KANNUR-TRIVANDRUM,699,All
2020,7,KANNUR,TRIVANDRUM,67,231,KANNUR-TRIVANDRUM,298,All
2020,8,KANNUR,TRIVANDRUM,160,166,KANNUR-TRIVANDRUM,326,All
2020,9,KANNUR,TRIVANDRUM,533,494,KANNUR-TRIVANDRUM,1027,All
2020,10,KANNUR,TRIVANDRUM,491,536,KANNUR-TRIVANDRUM,1027,All
2020,11,KANNUR,TRIVANDRUM,944,946,KANNUR-TRIVANDRUM,1890,All
2020,12,KANNUR,TRIVANDRUM,1031,1102,KANNUR-TRIVANDRUM,2133,All
2021,1,KANNUR,TRIVANDRUM,1177,1172,KANNUR-TRIVANDRUM,2349,All
2021,2,KANNUR,TRIVANDRUM,1025,996,KANNUR-TRIVANDRUM,2021,All
2021,3,KANNUR,TRIVANDRUM,1082,1043,KANNUR-TRIVANDRUM,2125,All
2021,4,KANNUR,TRIVANDRUM,1404,1302,KANNUR-TRIVANDRUM,2706,All
2021,6,KANNUR,TRIVANDRUM,788,779,KANNUR-TRIVANDRUM,1567,All
2021,7,KANNUR,TRIVANDRUM,1288,1070,KANNUR-TRIVANDRUM,2358,All
2021,8,KANNUR,TRIVANDRUM,1671,1334,KANNUR-TRIVANDRUM,3005,All
2021,9,KANNUR,TRIVANDRUM,1308,1066,KANNUR-TRIVANDRUM,2374,All
2021,10,KANNUR,TRIVANDRUM,1832,1547,KANNUR-TRIVANDRUM,3379,All
2021,11,KANNUR,TRIVANDRUM,1702,1671,KANNUR-TRIVANDRUM,3373,All
2021,12,KANNUR,TRIVANDRUM,2100,1929,KANNUR-TRIVANDRUM,4029,All
2022,1,KANNUR,TRIVANDRUM,1514,1527,KANNUR-TRIVANDRUM,3041,All
2022,2,KANNUR,TRIVANDRUM,1037,935,KANNUR-TRIVANDRUM,1972,All
2022,3,KANNUR,TRIVANDRUM,1831,1685,KANNUR-TRIVANDRUM,3516,All
2022,4,KANNUR,TRIVANDRUM,2099,1979,KANNUR-TRIVANDRUM,4078,All
2022,5,KANNUR,TRIVANDRUM,2249,2224,KANNUR-TRIVANDRUM,4473,All
2022,6,KANNUR,TRIVANDRUM,1435,1833,KANNUR-TRIVANDRUM,3268,All
2022,7,KANNUR,TRIVANDRUM,1728,1877,KANNUR-TRIVANDRUM,3605,All
2022,8,KANNUR,TRIVANDRUM,1764,1904,KANNUR-TRIVANDRUM,3668,All
2022,9,KANNUR,TRIVANDRUM,1706,1943,KANNUR-TRIVANDRUM,3649,All
2022,10,KANNUR,TRIVANDRUM,1452,1533,KANNUR-TRIVANDRUM,2985,All
2022,11,KANNUR,TRIVANDRUM,1011,1213,KANNUR-TRIVANDRUM,2224,All
2022,12,KANNUR,TRIVANDRUM,1634,1705,KANNUR-TRIVANDRUM,3339,All
2023,1,KANNUR,TRIVANDRUM,1559,2170,KANNUR-TRIVANDRUM,3729,All
2023,2,KANNUR,TRIVANDRUM,1468,1367,KANNUR-TRIVANDRUM,2835,All
2023,3,KANNUR,TRIVANDRUM,1647,1168,KANNUR-TRIVANDRUM,2815,All
2023,4,KANNUR,TRIVANDRUM,1900,1820,KANNUR-TRIVANDRUM,3720,All
2023,5,KANNUR,TRIVANDRUM,2150,2050,KANNUR-TRIVANDRUM,4200,All
2023,6,KANNUR,TRIVANDRUM,1525,1695,KANNUR-TRIVANDRUM,3220,All
2023,7,KANNUR,TRIVANDRUM,1670,1602,KANNUR-TRIVANDRUM,3272,All
2023,8,KANNUR,TRIVANDRUM,1847,1770,KANNUR-TRIVANDRUM,3617,All
2023,9,KANNUR,TRIVANDRUM,1656,1513,KANNUR-TRIVANDRUM,3169,All
2023,10,KANNUR,TRIVANDRUM,1587,1283,KANNUR-TRIVANDRUM,2870,All
2023,11,KANNUR,TRIVANDRUM,2070,1596,KANNUR-TRIVANDRUM,3666,All
2023,12,KANNUR,TRIVANDRUM,2516,2269,KANNUR-TRIVANDRUM,4785,All
2024,1,KANNUR,TRIVANDRUM,2762,1992,KANNUR-TRIVANDRUM,4754,All
2024,2,KANNUR,TRIVANDRUM,2304,1497,KANNUR-TRIVANDRUM,3801,All
2024,3,KANNUR,TRIVANDRUM,2354,1297,KANNUR-TRIVANDRUM,3651,All
2024,4,KANNUR,TRIVANDRUM,1303,1268,KANNUR-TRIVANDRUM,2571,All
2024,6,KANNUR,TRIVANDRUM,1285,1034,KANNUR-TRIVANDRUM,2319,All
2024,7,KANNUR,TRIVANDRUM,770,883,KANNUR-TRIVANDRUM,1653,All
2024,8,KANNUR,TRIVANDRUM,1026,1173,KANNUR-TRIVANDRUM,2199,All
2024,9,KANNUR,TRIVANDRUM,1472,1332,KANNUR-TRIVANDRUM,2804,All
2024,10,KANNUR,TRIVANDRUM,785,721,KANNUR-TRIVANDRUM,1506,All
2024,11,KANNUR,TRIVANDRUM,734,677,KANNUR-TRIVANDRUM,1411,All
2024,12,KANNUR,TRIVANDRUM,1472,1206,KANNUR-TRIVANDRUM,2678,All
2025,1,KANNUR,TRIVANDRUM,874,1037,KANNUR-TRIVANDRUM,1911,All
2025,2,KANNUR,TRIVANDRUM,914,659,KANNUR-TRIVANDRUM,1573,All
2025,3,KANNUR,TRIVANDRUM,681,544,KANNUR-TRIVANDRUM,1225,All
2022,11,KANNUR,VARANASI,8,0,KANNUR-VARANASI,8,All
2022,12,KANNUR,VARANASI,3,0,KANNUR-VARANASI,3,All
2023,2,KANNUR,VARANASI,14,0,KANNUR-VARANASI,14,All
2023,3,KANNUR,VARANASI,6,0,KANNUR-VARANASI,6,All
2023,4,KANNUR,VARANASI,17,0,KANNUR-VARANASI,17,All
2023,5,KANNUR,VARANASI,16,0,KANNUR-VARANASI,16,All
2021,3,KANNUR,VIJAYAWADA,0,0,KANNUR-VIJAYAWADA,0,All
2021,8,KANPUR,KOLKATA,48,37,KANPUR-KOLKATA,85,All
2021,9,KANPUR,KOLKATA,482,435,KANPUR-KOLKATA,917,All
2021,10,KANPUR,KOLKATA,311,317,KANPUR-KOLKATA,628,All
2023,6,KANPUR,LUCKNOW,0,102,KANPUR-LUCKNOW,102,All
2019,5,KANPUR,MUMBAI,5649,5478,KANPUR-MUMBAI,11127,All
2019,6,KANPUR,MUMBAI,9864,8545,KANPUR-MUMBAI,18409,All
2019,7,KANPUR,MUMBAI,7634,6911,KANPUR-MUMBAI,14545,All
2019,8,KANPUR,MUMBAI,7711,8000,KANPUR-MUMBAI,15711,All
2019,9,KANPUR,MUMBAI,4613,5083,KANPUR-MUMBAI,9696,All
2019,10,KANPUR,MUMBAI,6991,9836,KANPUR-MUMBAI,16827,All
2019,11,KANPUR,MUMBAI,10251,9404,KANPUR-MUMBAI,19655,All
2019,12,KANPUR,MUMBAI,9781,7890,KANPUR-MUMBAI,17671,All
2020,1,KANPUR,MUMBAI,8053,8432,KANPUR-MUMBAI,16485,All
2020,2,KANPUR,MUMBAI,5000,5323,KANPUR-MUMBAI,10323,All
2020,3,KANPUR,MUMBAI,3533,4304,KANPUR-MUMBAI,7837,All
2020,9,KANPUR,MUMBAI,2226,1330,KANPUR-MUMBAI,3556,All
2020,10,KANPUR,MUMBAI,2540,2152,KANPUR-MUMBAI,4692,All
2020,11,KANPUR,MUMBAI,3396,3589,KANPUR-MUMBAI,6985,All
2020,12,KANPUR,MUMBAI,4461,3954,KANPUR-MUMBAI,8415,All
2021,1,KANPUR,MUMBAI,4429,3654,KANPUR-MUMBAI,8083,All
2021,2,KANPUR,MUMBAI,4167,4151,KANPUR-MUMBAI,8318,All
2021,3,KANPUR,MUMBAI,3833,4090,KANPUR-MUMBAI,7923,All
2021,4,KANPUR,MUMBAI,1655,2589,KANPUR-MUMBAI,4244,All
2021,6,KANPUR,MUMBAI,1556,1017,KANPUR-MUMBAI,2573,All
2021,7,KANPUR,MUMBAI,1692,1734,KANPUR-MUMBAI,3426,All
2021,8,KANPUR,MUMBAI,2334,2389,KANPUR-MUMBAI,4723,All
2021,9,KANPUR,MUMBAI,2014,1761,KANPUR-MUMBAI,3775,All
2021,10,KANPUR,MUMBAI,3200,3916,KANPUR-MUMBAI,7116,All
2021,11,KANPUR,MUMBAI,8002,8983,KANPUR-MUMBAI,16985,All
2021,12,KANPUR,MUMBAI,9492,6751,KANPUR-MUMBAI,16243,All
2022,1,KANPUR,MUMBAI,2516,2835,KANPUR-MUMBAI,5351,All
2022,2,KANPUR,MUMBAI,4486,4480,KANPUR-MUMBAI,8966,All
2022,3,KANPUR,MUMBAI,5286,4933,KANPUR-MUMBAI,10219,All
2022,4,KANPUR,MUMBAI,5733,7629,KANPUR-MUMBAI,13362,All
2022,5,KANPUR,MUMBAI,7539,7443,KANPUR-MUMBAI,14982,All
2022,6,KANPUR,MUMBAI,8070,6144,KANPUR-MUMBAI,14214,All
2022,7,KANPUR,MUMBAI,5186,5204,KANPUR-MUMBAI,10390,All
2022,8,KANPUR,MUMBAI,5840,6134,KANPUR-MUMBAI,11974,All
2022,9,KANPUR,MUMBAI,4347,4520,KANPUR-MUMBAI,8867,All
2022,10,KANPUR,MUMBAI,4705,6724,KANPUR-MUMBAI,11429,All
2022,11,KANPUR,MUMBAI,7477,6942,KANPUR-MUMBAI,14419,All
2022,12,KANPUR,MUMBAI,6303,6091,KANPUR-MUMBAI,12394,All
2023,11,KANPUR,MUMBAI,4267,5132,KANPUR-MUMBAI,9399,All
2023,12,KANPUR,MUMBAI,5414,4817,KANPUR-MUMBAI,10231,All
2024,1,KANPUR,MUMBAI,4600,4642,KANPUR-MUMBAI,9242,All
2024,2,KANPUR,MUMBAI,4531,4676,KANPUR-MUMBAI,9207,All
2024,3,KANPUR,MUMBAI,4495,4949,KANPUR-MUMBAI,9444,All
2024,4,KANPUR,MUMBAI,4530,4974,KANPUR-MUMBAI,9504,All
2024,6,KANPUR,MUMBAI,5015,4689,KANPUR-MUMBAI,9704,All
2024,7,KANPUR,MUMBAI,4842,4728,KANPUR-MUMBAI,9570,All
2024,8,KANPUR,MUMBAI,4612,4306,KANPUR-MUMBAI,8918,All
2024,9,KANPUR,MUMBAI,4296,4483,KANPUR-MUMBAI,8779,All
2024,10,KANPUR,MUMBAI,3751,5315,KANPUR-MUMBAI,9066,All
2024,11,KANPUR,MUMBAI,5170,5310,KANPUR-MUMBAI,10480,All
2024,12,KANPUR,MUMBAI,5588,4981,KANPUR-MUMBAI,10569,All
2025,1,KANPUR,MUMBAI,5489,5249,KANPUR-MUMBAI,10738,All
2025,2,KANPUR,MUMBAI,4898,5004,KANPUR-MUMBAI,9902,All
2025,3,KANPUR,MUMBAI,5364,5484,KANPUR-MUMBAI,10848,All
2022,10,KESHOD,MUMBAI,674,705,KESHOD-MUMBAI,1379,All
2022,11,KESHOD,MUMBAI,674,727,KESHOD-MUMBAI,1401,All
2022,12,KESHOD,MUMBAI,693,739,KESHOD-MUMBAI,1432,All
2023,11,KESHOD,MUMBAI,506,551,KESHOD-MUMBAI,1057,All
2023,12,KESHOD,MUMBAI,303,348,KESHOD-MUMBAI,651,All
2024,1,KESHOD,MUMBAI,414,493,KESHOD-MUMBAI,907,All
2024,2,KESHOD,MUMBAI,600,639,KESHOD-MUMBAI,1239,All
2024,3,KESHOD,MUMBAI,646,695,KESHOD-MUMBAI,1341,All
2024,4,KESHOD,MUMBAI,573,591,KESHOD-MUMBAI,1164,All
2024,6,KESHOD,MUMBAI,571,572,KESHOD-MUMBAI,1143,All
2024,7,KESHOD,MUMBAI,192,206,KESHOD-MUMBAI,398,All
2024,8,KESHOD,MUMBAI,401,454,KESHOD-MUMBAI,855,All
2024,9,KESHOD,MUMBAI,547,603,KESHOD-MUMBAI,1150,All
2024,10,KESHOD,MUMBAI,411,536,KESHOD-MUMBAI,947,All
2024,11,KESHOD,MUMBAI,876,1002,KESHOD-MUMBAI,1878,All
2024,12,KESHOD,MUMBAI,705,825,KESHOD-MUMBAI,1530,All
2025,1,KESHOD,MUMBAI,478,544,KESHOD-MUMBAI,1022,All
2025,2,KESHOD,MUMBAI,671,761,KESHOD-MUMBAI,1432,All
2025,3,KESHOD,MUMBAI,308,328,KESHOD-MUMBAI,636,All
2024,11,KHAJURAHO,REWA,9,15,KHAJURAHO-REWA,24,All
2024,12,KHAJURAHO,REWA,22,24,KHAJURAHO-REWA,46,All
2025,1,KHAJURAHO,REWA,8,5,KHAJURAHO-REWA,13,All
2025,2,KHAJURAHO,REWA,5,12,KHAJURAHO-REWA,17,All
2025,3,KHAJURAHO,REWA,12,4,KHAJURAHO-REWA,16,All
2015,4,KHAJURAHO,VARANASI,2333,912,KHAJURAHO-VARANASI,3245,All
2015,5,KHAJURAHO,VARANASI,426,200,KHAJURAHO-VARANASI,626,All
2015,6,KHAJURAHO,VARANASI,370,108,KHAJURAHO-VARANASI,478,All
2015,7,KHAJURAHO,VARANASI,694,202,KHAJURAHO-VARANASI,896,All
2015,8,KHAJURAHO,VARANASI,1607,677,KHAJURAHO-VARANASI,2284,All
2015,9,KHAJURAHO,VARANASI,1199,550,KHAJURAHO-VARANASI,1749,All
2015,10,KHAJURAHO,VARANASI,5149,4604,KHAJURAHO-VARANASI,9753,All
2015,11,KHAJURAHO,VARANASI,4436,2699,KHAJURAHO-VARANASI,7135,All
2015,12,KHAJURAHO,VARANASI,2775,1691,KHAJURAHO-VARANASI,4466,All
2016,1,KHAJURAHO,VARANASI,3642,2408,KHAJURAHO-VARANASI,6050,All
2016,2,KHAJURAHO,VARANASI,4735,2969,KHAJURAHO-VARANASI,7704,All
2016,3,KHAJURAHO,VARANASI,4650,2321,KHAJURAHO-VARANASI,6971,All
2016,4,KHAJURAHO,VARANASI,2414,816,KHAJURAHO-VARANASI,3230,All
2016,5,KHAJURAHO,VARANASI,398,183,KHAJURAHO-VARANASI,581,All
2016,6,KHAJURAHO,VARANASI,398,93,KHAJURAHO-VARANASI,491,All
2016,7,KHAJURAHO,VARANASI,865,398,KHAJURAHO-VARANASI,1263,All
2016,8,KHAJURAHO,VARANASI,1449,1151,KHAJURAHO-VARANASI,2600,All
2016,9,KHAJURAHO,VARANASI,1033,760,KHAJURAHO-VARANASI,1793,All
2016,10,KHAJURAHO,VARANASI,3456,1724,KHAJURAHO-VARANASI,5180,All
2016,11,KHAJURAHO,VARANASI,4410,2527,KHAJURAHO-VARANASI,6937,All
2016,12,KHAJURAHO,VARANASI,2445,1974,KHAJURAHO-VARANASI,4419,All
2017,1,KHAJURAHO,VARANASI,3760,2691,KHAJURAHO-VARANASI,6451,All
2017,2,KHAJURAHO,VARANASI,4321,3107,KHAJURAHO-VARANASI,7428,All
2017,3,KHAJURAHO,VARANASI,3746,1921,KHAJURAHO-VARANASI,5667,All
2017,4,KHAJURAHO,VARANASI,2113,0,KHAJURAHO-VARANASI,2113,All
2017,5,KHAJURAHO,VARANASI,548,0,KHAJURAHO-VARANASI,548,All
2017,6,KHAJURAHO,VARANASI,272,190,KHAJURAHO-VARANASI,462,All
2017,7,KHAJURAHO,VARANASI,938,350,KHAJURAHO-VARANASI,1288,All
2017,8,KHAJURAHO,VARANASI,1352,870,KHAJURAHO-VARANASI,2222,All
2017,9,KHAJURAHO,VARANASI,1113,683,KHAJURAHO-VARANASI,1796,All
2017,10,KHAJURAHO,VARANASI,3159,1746,KHAJURAHO-VARANASI,4905,All
2017,11,KHAJURAHO,VARANASI,4209,2393,KHAJURAHO-VARANASI,6602,All
2017,12,KHAJURAHO,VARANASI,2140,1293,KHAJURAHO-VARANASI,3433,All
2018,1,KHAJURAHO,VARANASI,3272,2479,KHAJURAHO-VARANASI,5751,All
2018,2,KHAJURAHO,VARANASI,3787,2904,KHAJURAHO-VARANASI,6691,All
2018,3,KHAJURAHO,VARANASI,3689,2115,KHAJURAHO-VARANASI,5804,All
2018,4,KHAJURAHO,VARANASI,2218,700,KHAJURAHO-VARANASI,2918,All
2018,5,KHAJURAHO,VARANASI,632,161,KHAJURAHO-VARANASI,793,All
2018,6,KHAJURAHO,VARANASI,559,151,KHAJURAHO-VARANASI,710,All
2018,7,KHAJURAHO,VARANASI,790,374,KHAJURAHO-VARANASI,1164,All
2018,8,KHAJURAHO,VARANASI,1241,739,KHAJURAHO-VARANASI,1980,All
2018,9,KHAJURAHO,VARANASI,1139,562,KHAJURAHO-VARANASI,1701,All
2018,10,KHAJURAHO,VARANASI,3171,1544,KHAJURAHO-VARANASI,4715,All
2018,11,KHAJURAHO,VARANASI,4188,2682,KHAJURAHO-VARANASI,6870,All
2018,12,KHAJURAHO,VARANASI,2101,1497,KHAJURAHO-VARANASI,3598,All
2019,1,KHAJURAHO,VARANASI,2668,2009,KHAJURAHO-VARANASI,4677,All
2019,2,KHAJURAHO,VARANASI,2899,1946,KHAJURAHO-VARANASI,4845,All
2019,3,KHAJURAHO,VARANASI,1365,469,KHAJURAHO-VARANASI,1834,All
2019,4,KHAJURAHO,VARANASI,1228,668,KHAJURAHO-VARANASI,1896,All
2019,5,KHAJURAHO,VARANASI,600,95,KHAJURAHO-VARANASI,695,All
2019,6,KHAJURAHO,VARANASI,113,42,KHAJURAHO-VARANASI,155,All
2019,7,KHAJURAHO,VARANASI,600,261,KHAJURAHO-VARANASI,861,All
2019,8,KHAJURAHO,VARANASI,1078,570,KHAJURAHO-VARANASI,1648,All
2019,9,KHAJURAHO,VARANASI,1040,391,KHAJURAHO-VARANASI,1431,All
2019,10,KHAJURAHO,VARANASI,1353,653,KHAJURAHO-VARANASI,2006,All
2019,11,KHAJURAHO,VARANASI,2644,1753,KHAJURAHO-VARANASI,4397,All
2019,12,KHAJURAHO,VARANASI,2009,1766,KHAJURAHO-VARANASI,3775,All
2020,1,KHAJURAHO,VARANASI,2725,1856,KHAJURAHO-VARANASI,4581,All
2020,2,KHAJURAHO,VARANASI,3563,1972,KHAJURAHO-VARANASI,5535,All
2020,3,KHAJURAHO,VARANASI,1349,614,KHAJURAHO-VARANASI,1963,All
2022,11,KHAJURAHO,VARANASI,508,215,KHAJURAHO-VARANASI,723,All
2022,12,KHAJURAHO,VARANASI,138,132,KHAJURAHO-VARANASI,270,All
2023,10,KHAJURAHO,VARANASI,1093,577,KHAJURAHO-VARANASI,1670,All
2023,11,KHAJURAHO,VARANASI,2641,1460,KHAJURAHO-VARANASI,4101,All
2023,12,KHAJURAHO,VARANASI,1512,1594,KHAJURAHO-VARANASI,3106,All
2024,1,KHAJURAHO,VARANASI,697,583,KHAJURAHO-VARANASI,1280,All
2024,10,KHAJURAHO,VARANASI,287,89,KHAJURAHO-VARANASI,376,All
2024,11,KHAJURAHO,VARANASI,2440,1524,KHAJURAHO-VARANASI,3964,All
2024,12,KHAJURAHO,VARANASI,1797,1058,KHAJURAHO-VARANASI,2855,All
2025,1,KHAJURAHO,VARANASI,1633,1296,KHAJURAHO-VARANASI,2929,All
2025,2,KHAJURAHO,VARANASI,2495,1794,KHAJURAHO-VARANASI,4289,All
2025,3,KHAJURAHO,VARANASI,2811,1489,KHAJURAHO-VARANASI,4300,All
2017,12,KOCHI,AGARTALA,0,3,AGARTALA-KOCHI,3,All
2018,1,KOCHI,AGARTALA,0,20,AGARTALA-KOCHI,20,All
2018,2,KOCHI,AGARTALA,0,5,AGARTALA-KOCHI,5,All
2018,3,KOCHI,AGARTALA,0,24,AGARTALA-KOCHI,24,All
2018,5,KOCHI,AGARTALA,0,17,AGARTALA-KOCHI,17,All
2018,6,KOCHI,AGARTALA,0,77,AGARTALA-KOCHI,77,All
2018,7,KOCHI,AGARTALA,0,33,AGARTALA-KOCHI,33,All
2018,8,KOCHI,AGARTALA,0,56,AGARTALA-KOCHI,56,All
2018,9,KOCHI,AGARTALA,0,81,AGARTALA-KOCHI,81,All
2018,10,KOCHI,AGARTALA,0,102,AGARTALA-KOCHI,102,All
2018,11,KOCHI,AGARTALA,0,151,AGARTALA-KOCHI,151,All
2018,12,KOCHI,AGARTALA,0,50,AGARTALA-KOCHI,50,All
2019,1,KOCHI,AGARTALA,0,37,AGARTALA-KOCHI,37,All
2019,2,KOCHI,AGARTALA,0,15,AGARTALA-KOCHI,15,All
2016,2,KOCHI,CHANDIGARH,57,64,CHANDIGARH-KOCHI,121,All
2016,3,KOCHI,CHANDIGARH,270,335,CHANDIGARH-KOCHI,605,All
2016,4,KOCHI,CHANDIGARH,361,354,CHANDIGARH-KOCHI,715,All
2016,5,KOCHI,CHANDIGARH,497,498,CHANDIGARH-KOCHI,995,All
2016,6,KOCHI,CHANDIGARH,356,488,CHANDIGARH-KOCHI,844,All
2016,7,KOCHI,CHANDIGARH,343,368,CHANDIGARH-KOCHI,711,All
2016,8,KOCHI,CHANDIGARH,374,354,CHANDIGARH-KOCHI,728,All
2016,9,KOCHI,CHANDIGARH,218,250,CHANDIGARH-KOCHI,468,All
2016,10,KOCHI,CHANDIGARH,24,23,CHANDIGARH-KOCHI,47,All
2016,11,KOCHI,CHANDIGARH,8,11,CHANDIGARH-KOCHI,19,All
2016,12,KOCHI,CHANDIGARH,51,43,CHANDIGARH-KOCHI,94,All
2017,1,KOCHI,CHANDIGARH,31,31,CHANDIGARH-KOCHI,62,All
2017,2,KOCHI,CHANDIGARH,22,29,CHANDIGARH-KOCHI,51,All
2017,3,KOCHI,CHANDIGARH,16,5,CHANDIGARH-KOCHI,21,All
2017,11,KOCHI,CHANDIGARH,27,15,CHANDIGARH-KOCHI,42,All
2017,12,KOCHI,CHANDIGARH,14,0,CHANDIGARH-KOCHI,14,All
2018,1,KOCHI,CHANDIGARH,21,6,CHANDIGARH-KOCHI,27,All
2018,2,KOCHI,CHANDIGARH,3,0,CHANDIGARH-KOCHI,3,All
2015,4,KOCHI,CHENNAI,17896,18633,CHENNAI-KOCHI,36529,All
2015,5,KOCHI,CHENNAI,18498,20061,CHENNAI-KOCHI,38559,All
2015,6,KOCHI,CHENNAI,17428,16619,CHENNAI-KOCHI,34047,All
2015,7,KOCHI,CHENNAI,16511,17384,CHENNAI-KOCHI,33895,All
2015,8,KOCHI,CHENNAI,17133,18011,CHENNAI-KOCHI,35144,All
2015,9,KOCHI,CHENNAI,15874,16380,CHENNAI-KOCHI,32254,All
2015,10,KOCHI,CHENNAI,15924,16088,CHENNAI-KOCHI,32012,All
2015,11,KOCHI,CHENNAI,15821,17167,CHENNAI-KOCHI,32988,All
2015,12,KOCHI,CHENNAI,14558,15273,CHENNAI-KOCHI,29831,All
2016,1,KOCHI,CHENNAI,19674,19674,CHENNAI-KOCHI,39348,All
2016,2,KOCHI,CHENNAI,18627,18892,CHENNAI-KOCHI,37519,All
2016,3,KOCHI,CHENNAI,18767,19587,CHENNAI-KOCHI,38354,All
2016,4,KOCHI,CHENNAI,19685,20453,CHENNAI-KOCHI,40138,All
2016,5,KOCHI,CHENNAI,24328,26045,CHENNAI-KOCHI,50373,All
2016,6,KOCHI,CHENNAI,21544,20191,CHENNAI-KOCHI,41735,All
2016,7,KOCHI,CHENNAI,24613,24633,CHENNAI-KOCHI,49246,All
2016,8,KOCHI,CHENNAI,25387,24907,CHENNAI-KOCHI,50294,All
2016,9,KOCHI,CHENNAI,23785,24216,CHENNAI-KOCHI,48001,All
2016,10,KOCHI,CHENNAI,23842,23682,CHENNAI-KOCHI,47524,All
2016,11,KOCHI,CHENNAI,23781,25775,CHENNAI-KOCHI,49556,All
2016,12,KOCHI,CHENNAI,24415,26670,CHENNAI-KOCHI,51085,All
2017,1,KOCHI,CHENNAI,29224,27587,CHENNAI-KOCHI,56811,All
2017,2,KOCHI,CHENNAI,25529,25575,CHENNAI-KOCHI,51104,All
2017,3,KOCHI,CHENNAI,25069,24459,CHENNAI-KOCHI,49528,All
2017,4,KOCHI,CHENNAI,24216,26090,CHENNAI-KOCHI,50306,All
2017,5,KOCHI,CHENNAI,23573,24837,CHENNAI-KOCHI,48410,All
2017,6,KOCHI,CHENNAI,21379,21405,CHENNAI-KOCHI,42784,All
2017,7,KOCHI,CHENNAI,22127,22875,CHENNAI-KOCHI,45002,All
2017,8,KOCHI,CHENNAI,21937,22611,CHENNAI-KOCHI,44548,All
2017,9,KOCHI,CHENNAI,20580,22348,CHENNAI-KOCHI,42928,All
2017,10,KOCHI,CHENNAI,21860,21913,CHENNAI-KOCHI,43773,All
2017,11,KOCHI,CHENNAI,22351,23436,CHENNAI-KOCHI,45787,All
2017,12,KOCHI,CHENNAI,27757,31601,CHENNAI-KOCHI,59358,All
2018,1,KOCHI,CHENNAI,38961,42943,CHENNAI-KOCHI,81904,All
2018,2,KOCHI,CHENNAI,32636,34716,CHENNAI-KOCHI,67352,All
2018,3,KOCHI,CHENNAI,27198,28920,CHENNAI-KOCHI,56118,All
2018,4,KOCHI,CHENNAI,29148,30654,CHENNAI-KOCHI,59802,All
2018,5,KOCHI,CHENNAI,30459,31822,CHENNAI-KOCHI,62281,All
2018,6,KOCHI,CHENNAI,23603,23491,CHENNAI-KOCHI,47094,All
2018,7,KOCHI,CHENNAI,26751,27383,CHENNAI-KOCHI,54134,All
2018,8,KOCHI,CHENNAI,13053,13442,CHENNAI-KOCHI,26495,All
2018,9,KOCHI,CHENNAI,30199,32148,CHENNAI-KOCHI,62347,All
2018,10,KOCHI,CHENNAI,29790,28715,CHENNAI-KOCHI,58505,All
2018,11,KOCHI,CHENNAI,24703,28007,CHENNAI-KOCHI,52710,All
2018,12,KOCHI,CHENNAI,28786,32900,CHENNAI-KOCHI,61686,All
2019,1,KOCHI,CHENNAI,30433,26161,CHENNAI-KOCHI,56594,All
2019,2,KOCHI,CHENNAI,26535,27162,CHENNAI-KOCHI,53697,All
2019,3,KOCHI,CHENNAI,29526,29891,CHENNAI-KOCHI,59417,All
2019,4,KOCHI,CHENNAI,26555,31928,CHENNAI-KOCHI,58483,All
2023,3,KOCHI,COIMBATORE,0,129,COIMBATORE-KOCHI,129,All
2023,10,KOCHI,COIMBATORE,0,1,COIMBATORE-KOCHI,1,All
2019,1,KOCHI,DABOLIM,5318,5280,DABOLIM-KOCHI,10598,All
2019,2,KOCHI,DABOLIM,4485,4435,DABOLIM-KOCHI,8920,All
2019,3,KOCHI,DABOLIM,4563,3990,DABOLIM-KOCHI,8553,All
2019,4,KOCHI,DABOLIM,4136,4795,DABOLIM-KOCHI,8931,All
2023,1,KOCHI,DABOLIM,2476,2907,DABOLIM-KOCHI,5383,All
2023,2,KOCHI,DABOLIM,3503,3787,DABOLIM-KOCHI,7290,All
2023,3,KOCHI,DABOLIM,3380,3532,DABOLIM-KOCHI,6912,All
2023,4,KOCHI,DABOLIM,4327,4444,DABOLIM-KOCHI,8771,All
2023,5,KOCHI,DABOLIM,3422,5180,DABOLIM-KOCHI,8602,All
2023,6,KOCHI,DABOLIM,3423,4610,DABOLIM-KOCHI,8033,All
2023,7,KOCHI,DABOLIM,3479,4593,DABOLIM-KOCHI,8072,All
2023,8,KOCHI,DABOLIM,4503,4795,DABOLIM-KOCHI,9298,All
2023,9,KOCHI,DABOLIM,4818,4454,DABOLIM-KOCHI,9272,All
2023,10,KOCHI,DABOLIM,4089,4516,DABOLIM-KOCHI,8605,All
2017,2,KOCHI,DEHRA DUN,22,0,DEHRA DUN-KOCHI,22,All
2017,11,KOCHI,DEHRA DUN,0,24,DEHRA DUN-KOCHI,24,All
2017,12,KOCHI,DEHRA DUN,0,15,DEHRA DUN-KOCHI,15,All
2018,1,KOCHI,DEHRA DUN,0,15,DEHRA DUN-KOCHI,15,All
2018,2,KOCHI,DEHRA DUN,0,24,DEHRA DUN-KOCHI,24,All
2018,3,KOCHI,DEHRA DUN,4,14,DEHRA DUN-KOCHI,18,All
2018,4,KOCHI,DEHRA DUN,0,16,DEHRA DUN-KOCHI,16,All
2018,5,KOCHI,DEHRA DUN,0,23,DEHRA DUN-KOCHI,23,All
2018,6,KOCHI,DEHRA DUN,0,27,DEHRA DUN-KOCHI,27,All
2018,7,KOCHI,DEHRA DUN,0,47,DEHRA DUN-KOCHI,47,All
2018,8,KOCHI,DEHRA DUN,0,13,DEHRA DUN-KOCHI,13,All
2018,9,KOCHI,DEHRA DUN,0,15,DEHRA DUN-KOCHI,15,All
2018,10,KOCHI,DEHRA DUN,0,24,DEHRA DUN-KOCHI,24,All
2018,11,KOCHI,DEHRA DUN,0,19,DEHRA DUN-KOCHI,19,All
2018,12,KOCHI,DEHRA DUN,0,24,DEHRA DUN-KOCHI,24,All
2019,1,KOCHI,DEHRA DUN,0,7,DEHRA DUN-KOCHI,7,All
2019,2,KOCHI,DEHRA DUN,0,1,DEHRA DUN-KOCHI,1,All
2019,4,KOCHI,DEHRA DUN,0,3,DEHRA DUN-KOCHI,3,All
2015,4,KOCHI,DELHI,20048,19179,DELHI-KOCHI,39227,All
2015,5,KOCHI,DELHI,17118,22701,DELHI-KOCHI,39819,All
2015,6,KOCHI,DELHI,20901,21430,DELHI-KOCHI,42331,All
2015,7,KOCHI,DELHI,16415,18400,DELHI-KOCHI,34815,All
2015,8,KOCHI,DELHI,20438,20962,DELHI-KOCHI,41400,All
2015,9,KOCHI,DELHI,19461,17591,DELHI-KOCHI,37052,All
2015,10,KOCHI,DELHI,14140,16774,DELHI-KOCHI,30914,All
2015,11,KOCHI,DELHI,18437,20535,DELHI-KOCHI,38972,All
2015,12,KOCHI,DELHI,22026,27138,DELHI-KOCHI,49164,All
2016,1,KOCHI,DELHI,25619,25325,DELHI-KOCHI,50944,All
2016,2,KOCHI,DELHI,24283,24468,DELHI-KOCHI,48751,All
2016,3,KOCHI,DELHI,25833,27721,DELHI-KOCHI,53554,All
2016,4,KOCHI,DELHI,27644,28924,DELHI-KOCHI,56568,All
2016,5,KOCHI,DELHI,24506,32749,DELHI-KOCHI,57255,All
2016,6,KOCHI,DELHI,30591,30849,DELHI-KOCHI,61440,All
2016,7,KOCHI,DELHI,28953,30834,DELHI-KOCHI,59787,All
2016,8,KOCHI,DELHI,32232,32768,DELHI-KOCHI,65000,All
2016,9,KOCHI,DELHI,34460,33474,DELHI-KOCHI,67934,All
2016,10,KOCHI,DELHI,31667,31699,DELHI-KOCHI,63366,All
2016,11,KOCHI,DELHI,31666,36088,DELHI-KOCHI,67754,All
2016,12,KOCHI,DELHI,34058,38632,DELHI-KOCHI,72690,All
2017,1,KOCHI,DELHI,39391,35703,DELHI-KOCHI,75094,All
2017,2,KOCHI,DELHI,35537,33605,DELHI-KOCHI,69142,All
2017,3,KOCHI,DELHI,35871,35531,DELHI-KOCHI,71402,All
2017,4,KOCHI,DELHI,38693,38003,DELHI-KOCHI,76696,All
2017,5,KOCHI,DELHI,33652,42287,DELHI-KOCHI,75939,All
2017,6,KOCHI,DELHI,40657,41447,DELHI-KOCHI,82104,All
2017,7,KOCHI,DELHI,36425,37672,DELHI-KOCHI,74097,All
2017,8,KOCHI,DELHI,38574,39073,DELHI-KOCHI,77647,All
2017,9,KOCHI,DELHI,43638,39896,DELHI-KOCHI,83534,All
2017,10,KOCHI,DELHI,41411,40691,DELHI-KOCHI,82102,All
2017,11,KOCHI,DELHI,40662,43742,DELHI-KOCHI,84404,All
2017,12,KOCHI,DELHI,40656,49562,DELHI-KOCHI,90218,All
2018,1,KOCHI,DELHI,45991,47003,DELHI-KOCHI,92994,All
2018,2,KOCHI,DELHI,42010,41095,DELHI-KOCHI,83105,All
2018,3,KOCHI,DELHI,41633,43591,DELHI-KOCHI,85224,All
2018,4,KOCHI,DELHI,45644,43254,DELHI-KOCHI,88898,All
2018,5,KOCHI,DELHI,38199,48373,DELHI-KOCHI,86572,All
2018,6,KOCHI,DELHI,42034,41212,DELHI-KOCHI,83246,All
2018,7,KOCHI,DELHI,42501,44025,DELHI-KOCHI,86526,All
2018,8,KOCHI,DELHI,22130,23806,DELHI-KOCHI,45936,All
2018,9,KOCHI,DELHI,42723,37428,DELHI-KOCHI,80151,All
2018,10,KOCHI,DELHI,39775,36696,DELHI-KOCHI,76471,All
2018,11,KOCHI,DELHI,32651,36791,DELHI-KOCHI,69442,All
2018,12,KOCHI,DELHI,35294,41927,DELHI-KOCHI,77221,All
2019,1,KOCHI,DELHI,42688,40337,DELHI-KOCHI,83025,All
2019,2,KOCHI,DELHI,35127,36660,DELHI-KOCHI,71787,All
2019,3,KOCHI,DELHI,34967,36088,DELHI-KOCHI,71055,All
2019,4,KOCHI,DELHI,39090,37129,DELHI-KOCHI,76219,All
2023,1,KOCHI,DELHI,42294,38282,DELHI-KOCHI,80576,All
2023,2,KOCHI,DELHI,40409,38442,DELHI-KOCHI,78851,All
2023,3,KOCHI,DELHI,42216,43014,DELHI-KOCHI,85230,All
2023,4,KOCHI,DELHI,45371,43251,DELHI-KOCHI,88622,All
2023,5,KOCHI,DELHI,44109,48359,DELHI-KOCHI,92468,All
2023,6,KOCHI,DELHI,40506,45029,DELHI-KOCHI,85535,All
2023,7,KOCHI,DELHI,41224,43900,DELHI-KOCHI,85124,All
2023,8,KOCHI,DELHI,46673,45965,DELHI-KOCHI,92638,All
2023,9,KOCHI,DELHI,44811,41748,DELHI-KOCHI,86559,All
2023,10,KOCHI,DELHI,45778,40688,DELHI-KOCHI,86466,All
2016,10,KOCHI,GOA,0,2,GOA-KOCHI,2,All
2018,3,KOCHI,GOA,3,0,GOA-KOCHI,3,All
2018,4,KOCHI,GOA,12,0,GOA-KOCHI,12,All
2018,5,KOCHI,GOA,34,0,GOA-KOCHI,34,All
2018,6,KOCHI,GOA,24,0,GOA-KOCHI,24,All
2018,7,KOCHI,GOA,17,0,GOA-KOCHI,17,All
2018,8,KOCHI,GOA,13,0,GOA-KOCHI,13,All
2018,9,KOCHI,GOA,4,0,GOA-KOCHI,4,All
2018,10,KOCHI,GOA,3,27,GOA-KOCHI,30,All
2018,11,KOCHI,GOA,27,332,GOA-KOCHI,359,All
2018,12,KOCHI,GOA,4801,5279,GOA-KOCHI,10080,All
2017,10,KOCHI,GUWAHATI,0,2,GUWAHATI-KOCHI,2,All
2017,11,KOCHI,GUWAHATI,0,319,GUWAHATI-KOCHI,319,All
2017,12,KOCHI,GUWAHATI,434,841,GUWAHATI-KOCHI,1275,All
2018,1,KOCHI,GUWAHATI,1769,798,GUWAHATI-KOCHI,2567,All
2018,2,KOCHI,GUWAHATI,1210,463,GUWAHATI-KOCHI,1673,All
2018,3,KOCHI,GUWAHATI,1372,326,GUWAHATI-KOCHI,1698,All
2018,4,KOCHI,GUWAHATI,1448,0,GUWAHATI-KOCHI,1448,All
2018,5,KOCHI,GUWAHATI,873,0,GUWAHATI-KOCHI,873,All
2018,8,KOCHI,GUWAHATI,106,0,GUWAHATI-KOCHI,106,All
2018,9,KOCHI,GUWAHATI,656,0,GUWAHATI-KOCHI,656,All
2018,10,KOCHI,GUWAHATI,968,60,GUWAHATI-KOCHI,1028,All
2018,11,KOCHI,GUWAHATI,3879,1828,GUWAHATI-KOCHI,5707,All
2018,12,KOCHI,GUWAHATI,6328,5490,GUWAHATI-KOCHI,11818,All
2019,1,KOCHI,GUWAHATI,6120,3722,GUWAHATI-KOCHI,9842,All
2019,2,KOCHI,GUWAHATI,5374,2739,GUWAHATI-KOCHI,8113,All
2019,3,KOCHI,GUWAHATI,7429,3099,GUWAHATI-KOCHI,10528,All
2019,4,KOCHI,GUWAHATI,7279,5094,GUWAHATI-KOCHI,12373,All
2023,10,KOCHI,GUWAHATI,10,19,GUWAHATI-KOCHI,29,All
2018,6,KOCHI,HUBLI,69,113,HUBLI-KOCHI,182,All
2018,7,KOCHI,HUBLI,1278,1112,HUBLI-KOCHI,2390,All
2018,8,KOCHI,HUBLI,559,570,HUBLI-KOCHI,1129,All
2018,9,KOCHI,HUBLI,1021,943,HUBLI-KOCHI,1964,All
2018,10,KOCHI,HUBLI,1469,1328,HUBLI-KOCHI,2797,All
2018,11,KOCHI,HUBLI,1451,1444,HUBLI-KOCHI,2895,All
2018,12,KOCHI,HUBLI,1670,1710,HUBLI-KOCHI,3380,All
2019,1,KOCHI,HUBLI,1778,1859,HUBLI-KOCHI,3637,All
2019,2,KOCHI,HUBLI,1593,1425,HUBLI-KOCHI,3018,All
2019,3,KOCHI,HUBLI,1413,1449,HUBLI-KOCHI,2862,All
2019,4,KOCHI,HUBLI,1686,1796,HUBLI-KOCHI,3482,All
2015,4,KOCHI,HYDERABAD,11724,12952,HYDERABAD-KOCHI,24676,All
2015,5,KOCHI,HYDERABAD,12769,13143,HYDERABAD-KOCHI,25912,All
2015,6,KOCHI,HYDERABAD,11501,10125,HYDERABAD-KOCHI,21626,All
2015,7,KOCHI,HYDERABAD,7492,7874,HYDERABAD-KOCHI,15366,All
2015,8,KOCHI,HYDERABAD,8006,8233,HYDERABAD-KOCHI,16239,All
2015,9,KOCHI,HYDERABAD,7282,7364,HYDERABAD-KOCHI,14646,All
2015,10,KOCHI,HYDERABAD,8663,8874,HYDERABAD-KOCHI,17537,All
2015,11,KOCHI,HYDERABAD,10534,11730,HYDERABAD-KOCHI,22264,All
2015,12,KOCHI,HYDERABAD,13204,13599,HYDERABAD-KOCHI,26803,All
2016,1,KOCHI,HYDERABAD,12994,13199,HYDERABAD-KOCHI,26193,All
2016,2,KOCHI,HYDERABAD,9697,9294,HYDERABAD-KOCHI,18991,All
2016,3,KOCHI,HYDERABAD,9976,10021,HYDERABAD-KOCHI,19997,All
2016,4,KOCHI,HYDERABAD,11134,11515,HYDERABAD-KOCHI,22649,All
2016,5,KOCHI,HYDERABAD,13019,12936,HYDERABAD-KOCHI,25955,All
2016,6,KOCHI,HYDERABAD,11637,9900,HYDERABAD-KOCHI,21537,All
2016,7,KOCHI,HYDERABAD,13171,13820,HYDERABAD-KOCHI,26991,All
2016,8,KOCHI,HYDERABAD,15440,14816,HYDERABAD-KOCHI,30256,All
2016,9,KOCHI,HYDERABAD,15659,15588,HYDERABAD-KOCHI,31247,All
2016,10,KOCHI,HYDERABAD,21282,21588,HYDERABAD-KOCHI,42870,All
2016,11,KOCHI,HYDERABAD,24258,25256,HYDERABAD-KOCHI,49514,All
2016,12,KOCHI,HYDERABAD,27529,28351,HYDERABAD-KOCHI,55880,All
2017,1,KOCHI,HYDERABAD,25963,24962,HYDERABAD-KOCHI,50925,All
2017,2,KOCHI,HYDERABAD,21014,20159,HYDERABAD-KOCHI,41173,All
2017,3,KOCHI,HYDERABAD,22142,19280,HYDERABAD-KOCHI,41422,All
2017,4,KOCHI,HYDERABAD,27774,26646,HYDERABAD-KOCHI,54420,All
2017,5,KOCHI,HYDERABAD,27151,28549,HYDERABAD-KOCHI,55700,All
2017,6,KOCHI,HYDERABAD,25369,22398,HYDERABAD-KOCHI,47767,All
2017,7,KOCHI,HYDERABAD,24151,22732,HYDERABAD-KOCHI,46883,All
2017,8,KOCHI,HYDERABAD,28139,27721,HYDERABAD-KOCHI,55860,All
2017,9,KOCHI,HYDERABAD,28435,29339,HYDERABAD-KOCHI,57774,All
2017,10,KOCHI,HYDERABAD,28332,27615,HYDERABAD-KOCHI,55947,All
2017,11,KOCHI,HYDERABAD,26737,28154,HYDERABAD-KOCHI,54891,All
2017,12,KOCHI,HYDERABAD,32878,35865,HYDERABAD-KOCHI,68743,All
2018,1,KOCHI,HYDERABAD,32055,33215,HYDERABAD-KOCHI,65270,All
2018,2,KOCHI,HYDERABAD,23657,24578,HYDERABAD-KOCHI,48235,All
2018,3,KOCHI,HYDERABAD,26718,27420,HYDERABAD-KOCHI,54138,All
2018,4,KOCHI,HYDERABAD,24182,26729,HYDERABAD-KOCHI,50911,All
2018,5,KOCHI,HYDERABAD,24082,26793,HYDERABAD-KOCHI,50875,All
2018,6,KOCHI,HYDERABAD,22962,36682,HYDERABAD-KOCHI,59644,All
2018,7,KOCHI,HYDERABAD,21204,37203,HYDERABAD-KOCHI,58407,All
2018,8,KOCHI,HYDERABAD,7606,8515,HYDERABAD-KOCHI,16121,All
2018,9,KOCHI,HYDERABAD,17292,17944,HYDERABAD-KOCHI,35236,All
2018,10,KOCHI,HYDERABAD,20011,21675,HYDERABAD-KOCHI,41686,All
2018,11,KOCHI,HYDERABAD,19846,24366,HYDERABAD-KOCHI,44212,All
2018,12,KOCHI,HYDERABAD,26692,29563,HYDERABAD-KOCHI,56255,All
2019,1,KOCHI,HYDERABAD,24007,25991,HYDERABAD-KOCHI,49998,All
2019,2,KOCHI,HYDERABAD,21461,20433,HYDERABAD-KOCHI,41894,All
2019,3,KOCHI,HYDERABAD,20302,17861,HYDERABAD-KOCHI,38163,All
2019,4,KOCHI,HYDERABAD,16985,14348,HYDERABAD-KOCHI,31333,All
2023,1,KOCHI,HYDERABAD,24329,24029,HYDERABAD-KOCHI,48358,All
2023,2,KOCHI,HYDERABAD,21234,21029,HYDERABAD-KOCHI,42263,All
2023,3,KOCHI,HYDERABAD,20582,20095,HYDERABAD-KOCHI,40677,All
2023,4,KOCHI,HYDERABAD,30251,29169,HYDERABAD-KOCHI,59420,All
2023,5,KOCHI,HYDERABAD,25880,26418,HYDERABAD-KOCHI,52298,All
2023,6,KOCHI,HYDERABAD,26038,25381,HYDERABAD-KOCHI,51419,All
2023,7,KOCHI,HYDERABAD,25818,26260,HYDERABAD-KOCHI,52078,All
2023,8,KOCHI,HYDERABAD,28112,27703,HYDERABAD-KOCHI,55815,All
2023,9,KOCHI,HYDERABAD,27722,24706,HYDERABAD-KOCHI,52428,All
2023,10,KOCHI,HYDERABAD,24876,24266,HYDERABAD-KOCHI,49142,All
2017,9,KOCHI,INDORE,0,34,INDORE-KOCHI,34,All
2017,10,KOCHI,INDORE,0,157,INDORE-KOCHI,157,All
2018,4,KOCHI,INDORE,52,0,INDORE-KOCHI,52,All
2023,1,KOCHI,INDORE,22,26,INDORE-KOCHI,48,All
2016,4,KOCHI,JAIPUR,2,8,JAIPUR-KOCHI,10,All
2016,5,KOCHI,JAIPUR,0,15,JAIPUR-KOCHI,15,All
2017,10,KOCHI,JAIPUR,3,0,JAIPUR-KOCHI,3,All
2017,11,KOCHI,JAIPUR,20,10,JAIPUR-KOCHI,30,All
2017,12,KOCHI,JAIPUR,110,4,JAIPUR-KOCHI,114,All
2018,1,KOCHI,JAIPUR,451,0,JAIPUR-KOCHI,451,All
2018,2,KOCHI,JAIPUR,613,0,JAIPUR-KOCHI,613,All
2018,3,KOCHI,JAIPUR,295,0,JAIPUR-KOCHI,295,All
2018,6,KOCHI,JAIPUR,318,0,JAIPUR-KOCHI,318,All
2018,7,KOCHI,JAIPUR,141,0,JAIPUR-KOCHI,141,All
2018,8,KOCHI,JAIPUR,40,0,JAIPUR-KOCHI,40,All
2018,9,KOCHI,JAIPUR,79,0,JAIPUR-KOCHI,79,All
2018,10,KOCHI,JAIPUR,132,0,JAIPUR-KOCHI,132,All
2018,11,KOCHI,JAIPUR,1552,1719,JAIPUR-KOCHI,3271,All
2018,12,KOCHI,JAIPUR,4355,4092,JAIPUR-KOCHI,8447,All
2019,1,KOCHI,JAIPUR,5036,3802,JAIPUR-KOCHI,8838,All
2019,2,KOCHI,JAIPUR,4121,3039,JAIPUR-KOCHI,7160,All
2019,3,KOCHI,JAIPUR,4342,3035,JAIPUR-KOCHI,7377,All
2019,4,KOCHI,JAIPUR,4362,3603,JAIPUR-KOCHI,7965,All
2023,1,KOCHI,KANNUR,1640,1898,KANNUR-KOCHI,3538,All
2023,2,KOCHI,KANNUR,1631,1871,KANNUR-KOCHI,3502,All
2023,3,KOCHI,KANNUR,1686,1818,KANNUR-KOCHI,3504,All
2023,4,KOCHI,KANNUR,1879,2098,KANNUR-KOCHI,3977,All
2023,5,KOCHI,KANNUR,2052,2169,KANNUR-KOCHI,4221,All
2023,6,KOCHI,KANNUR,1844,1569,KANNUR-KOCHI,3413,All
2023,7,KOCHI,KANNUR,1768,1812,KANNUR-KOCHI,3580,All
2023,8,KOCHI,KANNUR,1922,1947,KANNUR-KOCHI,3869,All
2023,9,KOCHI,KANNUR,1635,1788,KANNUR-KOCHI,3423,All
2023,10,KOCHI,KANNUR,1326,1742,KANNUR-KOCHI,3068,All
2019,5,KOCHI,KOLKATA,6876,5845,KOCHI-KOLKATA,12721,All
2019,6,KOCHI,KOLKATA,6224,4543,KOCHI-KOLKATA,10767,All
2019,7,KOCHI,KOLKATA,6751,4290,KOCHI-KOLKATA,11041,All
2019,8,KOCHI,KOLKATA,5740,3980,KOCHI-KOLKATA,9720,All
2019,9,KOCHI,KOLKATA,5109,4669,KOCHI-KOLKATA,9778,All
2019,10,KOCHI,KOLKATA,5208,5746,KOCHI-KOLKATA,10954,All
2019,11,KOCHI,KOLKATA,3712,5090,KOCHI-KOLKATA,8802,All
2019,12,KOCHI,KOLKATA,4751,6286,KOCHI-KOLKATA,11037,All
2020,1,KOCHI,KOLKATA,4912,5794,KOCHI-KOLKATA,10706,All
2020,2,KOCHI,KOLKATA,1981,3344,KOCHI-KOLKATA,5325,All
2020,3,KOCHI,KOLKATA,0,887,KOCHI-KOLKATA,887,All
2020,5,KOCHI,KOLKATA,0,0,KOCHI-KOLKATA,0,All
2020,6,KOCHI,KOLKATA,0,0,KOCHI-KOLKATA,0,All
2020,9,KOCHI,KOLKATA,1544,2643,KOCHI-KOLKATA,4187,All
2020,10,KOCHI,KOLKATA,4455,9698,KOCHI-KOLKATA,14153,All
2020,11,KOCHI,KOLKATA,4725,9149,KOCHI-KOLKATA,13874,All
2020,12,KOCHI,KOLKATA,6274,12177,KOCHI-KOLKATA,18451,All
2021,1,KOCHI,KOLKATA,7348,12214,KOCHI-KOLKATA,19562,All
2021,2,KOCHI,KOLKATA,7396,9498,KOCHI-KOLKATA,16894,All
2021,3,KOCHI,KOLKATA,7126,7301,KOCHI-KOLKATA,14427,All
2021,4,KOCHI,KOLKATA,4354,3536,KOCHI-KOLKATA,7890,All
2021,6,KOCHI,KOLKATA,1443,2719,KOCHI-KOLKATA,4162,All
2021,7,KOCHI,KOLKATA,2751,3838,KOCHI-KOLKATA,6589,All
2021,8,KOCHI,KOLKATA,2271,4478,KOCHI-KOLKATA,6749,All
2021,9,KOCHI,KOLKATA,2262,3314,KOCHI-KOLKATA,5576,All
2021,10,KOCHI,KOLKATA,4640,3960,KOCHI-KOLKATA,8600,All
2021,11,KOCHI,KOLKATA,4015,4880,KOCHI-KOLKATA,8895,All
2021,12,KOCHI,KOLKATA,4362,4727,KOCHI-KOLKATA,9089,All
2022,1,KOCHI,KOLKATA,4540,4604,KOCHI-KOLKATA,9144,All
2022,2,KOCHI,KOLKATA,4693,4298,KOCHI-KOLKATA,8991,All
2022,3,KOCHI,KOLKATA,4235,3977,KOCHI-KOLKATA,8212,All
2022,4,KOCHI,KOLKATA,4138,4699,KOCHI-KOLKATA,8837,All
2022,5,KOCHI,KOLKATA,3307,5118,KOCHI-KOLKATA,8425,All
2022,6,KOCHI,KOLKATA,2578,2672,KOCHI-KOLKATA,5250,All
2022,7,KOCHI,KOLKATA,2344,2699,KOCHI-KOLKATA,5043,All
2022,8,KOCHI,KOLKATA,2331,3040,KOCHI-KOLKATA,5371,All
2022,9,KOCHI,KOLKATA,2736,2910,KOCHI-KOLKATA,5646,All
2022,10,KOCHI,KOLKATA,3470,3438,KOCHI-KOLKATA,6908,All
2022,11,KOCHI,KOLKATA,5260,5498,KOCHI-KOLKATA,10758,All
2022,12,KOCHI,KOLKATA,4288,4447,KOCHI-KOLKATA,8735,All
2023,1,KOCHI,KOLKATA,5481,5052,KOCHI-KOLKATA,10533,All
2023,2,KOCHI,KOLKATA,5027,4827,KOCHI-KOLKATA,9854,All
2023,3,KOCHI,KOLKATA,5483,5487,KOCHI-KOLKATA,10970,All
2023,4,KOCHI,KOLKATA,4650,4133,KOCHI-KOLKATA,8783,All
2023,5,KOCHI,KOLKATA,4620,5100,KOCHI-KOLKATA,9720,All
2023,6,KOCHI,KOLKATA,4026,3977,KOCHI-KOLKATA,8003,All
2023,7,KOCHI,KOLKATA,2576,2772,KOCHI-KOLKATA,5348,All
2023,8,KOCHI,KOLKATA,2877,2831,KOCHI-KOLKATA,5708,All
2023,9,KOCHI,KOLKATA,4607,4390,KOCHI-KOLKATA,8997,All
2023,10,KOCHI,KOLKATA,4818,4504,KOCHI-KOLKATA,9322,All
2023,11,KOCHI,KOLKATA,4720,4568,KOCHI-KOLKATA,9288,All
2023,12,KOCHI,KOLKATA,4932,5207,KOCHI-KOLKATA,10139,All
2024,4,KOCHI,KOLKATA,2945,2376,KOCHI-KOLKATA,5321,All
2024,6,KOCHI,KOLKATA,3540,3677,KOCHI-KOLKATA,7217,All
2024,7,KOCHI,KOLKATA,679,822,KOCHI-KOLKATA,1501,All
2024,8,KOCHI,KOLKATA,2645,3232,KOCHI-KOLKATA,5877,All
2024,9,KOCHI,KOLKATA,2975,3075,KOCHI-KOLKATA,6050,All
2024,10,KOCHI,KOLKATA,6949,6580,KOCHI-KOLKATA,13529,All
2024,11,KOCHI,KOLKATA,4050,4605,KOCHI-KOLKATA,8655,All
2024,12,KOCHI,KOLKATA,8780,9680,KOCHI-KOLKATA,18460,All
2025,1,KOCHI,KOLKATA,8580,8279,KOCHI-KOLKATA,16859,All
2025,2,KOCHI,KOLKATA,3746,3649,KOCHI-KOLKATA,7395,All
2025,3,KOCHI,KOLKATA,3683,3524,KOCHI-KOLKATA,7207,All
2019,5,KOCHI,KOZHIKODE,257,234,KOCHI-KOZHIKODE,491,All
2019,6,KOCHI,KOZHIKODE,236,226,KOCHI-KOZHIKODE,462,All
2019,7,KOCHI,KOZHIKODE,331,246,KOCHI-KOZHIKODE,577,All
2019,8,KOCHI,KOZHIKODE,1226,302,KOCHI-KOZHIKODE,1528,All
2019,9,KOCHI,KOZHIKODE,957,303,KOCHI-KOZHIKODE,1260,All
2019,10,KOCHI,KOZHIKODE,204,254,KOCHI-KOZHIKODE,458,All
2019,11,KOCHI,KOZHIKODE,202,369,KOCHI-KOZHIKODE,571,All
2019,12,KOCHI,KOZHIKODE,427,398,KOCHI-KOZHIKODE,825,All
2020,1,KOCHI,KOZHIKODE,200,276,KOCHI-KOZHIKODE,476,All
2020,2,KOCHI,KOZHIKODE,302,303,KOCHI-KOZHIKODE,605,All
2020,3,KOCHI,KOZHIKODE,109,82,KOCHI-KOZHIKODE,191,All
2021,1,KOCHI,KOZHIKODE,0,0,KOCHI-KOZHIKODE,0,All
2021,8,KOCHI,KOZHIKODE,0,11,KOCHI-KOZHIKODE,11,All
2021,9,KOCHI,KOZHIKODE,162,11,KOCHI-KOZHIKODE,173,All
2021,10,KOCHI,KOZHIKODE,0,1,KOCHI-KOZHIKODE,1,All
2022,8,KOCHI,KOZHIKODE,34,0,KOCHI-KOZHIKODE,34,All
2024,6,KOCHI,KOZHIKODE,1340,1077,KOCHI-KOZHIKODE,2417,All
2024,7,KOCHI,KOZHIKODE,1345,1343,KOCHI-KOZHIKODE,2688,All
2024,8,KOCHI,KOZHIKODE,1232,1403,KOCHI-KOZHIKODE,2635,All
2024,9,KOCHI,KOZHIKODE,1031,1146,KOCHI-KOZHIKODE,2177,All
2024,10,KOCHI,KOZHIKODE,660,988,KOCHI-KOZHIKODE,1648,All
2024,11,KOCHI,KOZHIKODE,950,1053,KOCHI-KOZHIKODE,2003,All
2024,12,KOCHI,KOZHIKODE,910,731,KOCHI-KOZHIKODE,1641,All
2025,1,KOCHI,KOZHIKODE,1067,1213,KOCHI-KOZHIKODE,2280,All
2025,2,KOCHI,KOZHIKODE,896,978,KOCHI-KOZHIKODE,1874,All
2025,3,KOCHI,KOZHIKODE,988,1017,KOCHI-KOZHIKODE,2005,All
2017,4,KOCHI,LUCKNOW,1,0,KOCHI-LUCKNOW,1,All
2018,12,KOCHI,LUCKNOW,2743,3552,KOCHI-LUCKNOW,6295,All
2019,1,KOCHI,LUCKNOW,5010,4248,KOCHI-LUCKNOW,9258,All
2019,2,KOCHI,LUCKNOW,4672,4239,KOCHI-LUCKNOW,8911,All
2019,3,KOCHI,LUCKNOW,4948,3807,KOCHI-LUCKNOW,8755,All
2019,4,KOCHI,LUCKNOW,4640,3776,KOCHI-LUCKNOW,8416,All
2019,5,KOCHI,LUCKNOW,4480,5388,KOCHI-LUCKNOW,9868,All
2019,6,KOCHI,LUCKNOW,4593,5042,KOCHI-LUCKNOW,9635,All
2021,3,KOCHI,LUCKNOW,23,30,KOCHI-LUCKNOW,53,All
2021,4,KOCHI,LUCKNOW,214,373,KOCHI-LUCKNOW,587,All
2021,6,KOCHI,LUCKNOW,123,295,KOCHI-LUCKNOW,418,All
2021,7,KOCHI,LUCKNOW,308,253,KOCHI-LUCKNOW,561,All
2021,8,KOCHI,LUCKNOW,412,419,KOCHI-LUCKNOW,831,All
2021,9,KOCHI,LUCKNOW,428,329,KOCHI-LUCKNOW,757,All
2021,10,KOCHI,LUCKNOW,195,186,KOCHI-LUCKNOW,381,All
2021,11,KOCHI,LUCKNOW,401,481,KOCHI-LUCKNOW,882,All
2021,12,KOCHI,LUCKNOW,0,265,KOCHI-LUCKNOW,265,All
2022,1,KOCHI,LUCKNOW,0,104,KOCHI-LUCKNOW,104,All
2022,10,KOCHI,LUCKNOW,8,6,KOCHI-LUCKNOW,14,All
2022,11,KOCHI,LUCKNOW,211,201,KOCHI-LUCKNOW,412,All
2022,12,KOCHI,LUCKNOW,360,525,KOCHI-LUCKNOW,885,All
2023,1,KOCHI,LUCKNOW,507,319,KOCHI-LUCKNOW,826,All
2023,2,KOCHI,LUCKNOW,338,148,KOCHI-LUCKNOW,486,All
2023,3,KOCHI,LUCKNOW,239,169,KOCHI-LUCKNOW,408,All
2023,4,KOCHI,LUCKNOW,280,67,KOCHI-LUCKNOW,347,All
2023,5,KOCHI,LUCKNOW,256,204,KOCHI-LUCKNOW,460,All
2023,6,KOCHI,LUCKNOW,211,171,KOCHI-LUCKNOW,382,All
2023,7,KOCHI,LUCKNOW,119,84,KOCHI-LUCKNOW,203,All
2023,8,KOCHI,LUCKNOW,174,68,KOCHI-LUCKNOW,242,All
2023,9,KOCHI,LUCKNOW,208,84,KOCHI-LUCKNOW,292,All
2023,10,KOCHI,LUCKNOW,353,193,KOCHI-LUCKNOW,546,All
2023,11,KOCHI,LUCKNOW,361,289,KOCHI-LUCKNOW,650,All
2023,12,KOCHI,LUCKNOW,560,135,KOCHI-LUCKNOW,695,All
2024,3,KOCHI,LUCKNOW,34,1,KOCHI-LUCKNOW,35,All
2024,4,KOCHI,LUCKNOW,396,286,KOCHI-LUCKNOW,682,All
2024,6,KOCHI,LUCKNOW,654,348,KOCHI-LUCKNOW,1002,All
2024,7,KOCHI,LUCKNOW,343,143,KOCHI-LUCKNOW,486,All
2024,8,KOCHI,LUCKNOW,247,180,KOCHI-LUCKNOW,427,All
2024,9,KOCHI,LUCKNOW,456,362,KOCHI-LUCKNOW,818,All
2024,10,KOCHI,LUCKNOW,391,341,KOCHI-LUCKNOW,732,All
2024,11,KOCHI,LUCKNOW,110,183,KOCHI-LUCKNOW,293,All
2024,12,KOCHI,LUCKNOW,230,402,KOCHI-LUCKNOW,632,All
2018,5,KOCHI,MADURAI,0,0,KOCHI-MADURAI,0,All
2018,6,KOCHI,MADURAI,0,0,KOCHI-MADURAI,0,All
2018,7,KOCHI,MADURAI,0,1,KOCHI-MADURAI,1,All
2018,8,KOCHI,MADURAI,0,3,KOCHI-MADURAI,3,All
2018,9,KOCHI,MADURAI,0,3,KOCHI-MADURAI,3,All
2018,10,KOCHI,MADURAI,0,0,KOCHI-MADURAI,0,All
2019,3,KOCHI,MADURAI,0,0,KOCHI-MADURAI,0,All
2020,2,KOCHI,MADURAI,0,0,KOCHI-MADURAI,0,All
2015,8,KOCHI,MANGALORE,0,33,KOCHI-MANGALORE,33,All
2019,1,KOCHI,MANGALORE,0,82,KOCHI-MANGALORE,82,All
2020,8,KOCHI,MANGALORE,0,63,KOCHI-MANGALORE,63,All
2020,9,KOCHI,MANGALORE,0,158,KOCHI-MANGALORE,158,All
2020,10,KOCHI,MANGALORE,0,51,KOCHI-MANGALORE,51,All
2020,12,KOCHI,MANGALORE,70,0,KOCHI-MANGALORE,70,All
2021,1,KOCHI,MANGALORE,136,0,KOCHI-MANGALORE,136,All
2021,2,KOCHI,MANGALORE,149,0,KOCHI-MANGALORE,149,All
2021,3,KOCHI,MANGALORE,76,0,KOCHI-MANGALORE,76,All
2021,4,KOCHI,MANGALORE,266,0,KOCHI-MANGALORE,266,All
2021,6,KOCHI,MANGALORE,0,37,KOCHI-MANGALORE,37,All
2024,11,KOCHI,MANGALORE,3,8,KOCHI-MANGALORE,11,All
2019,5,KOCHI,MUMBAI,46558,49450,KOCHI-MUMBAI,96008,All
2019,6,KOCHI,MUMBAI,49909,48057,KOCHI-MUMBAI,97966,All
2019,7,KOCHI,MUMBAI,48818,49903,KOCHI-MUMBAI,98721,All
2019,8,KOCHI,MUMBAI,45527,44739,KOCHI-MUMBAI,90266,All
2019,9,KOCHI,MUMBAI,50483,48860,KOCHI-MUMBAI,99343,All
2019,10,KOCHI,MUMBAI,48070,49865,KOCHI-MUMBAI,97935,All
2019,11,KOCHI,MUMBAI,43912,43691,KOCHI-MUMBAI,87603,All
2019,12,KOCHI,MUMBAI,43778,45078,KOCHI-MUMBAI,88856,All
2020,1,KOCHI,MUMBAI,45831,45644,KOCHI-MUMBAI,91475,All
2020,2,KOCHI,MUMBAI,42016,41310,KOCHI-MUMBAI,83326,All
2020,3,KOCHI,MUMBAI,21931,20407,KOCHI-MUMBAI,42338,All
2020,5,KOCHI,MUMBAI,219,1427,KOCHI-MUMBAI,1646,All
2020,6,KOCHI,MUMBAI,1982,4349,KOCHI-MUMBAI,6331,All
2020,7,KOCHI,MUMBAI,3323,4288,KOCHI-MUMBAI,7611,All
2020,8,KOCHI,MUMBAI,3707,3637,KOCHI-MUMBAI,7344,All
2020,9,KOCHI,MUMBAI,6716,5320,KOCHI-MUMBAI,12036,All
2020,10,KOCHI,MUMBAI,7642,10125,KOCHI-MUMBAI,17767,All
2020,11,KOCHI,MUMBAI,13126,14390,KOCHI-MUMBAI,27516,All
2020,12,KOCHI,MUMBAI,20493,22108,KOCHI-MUMBAI,42601,All
2021,1,KOCHI,MUMBAI,21900,21399,KOCHI-MUMBAI,43299,All
2021,2,KOCHI,MUMBAI,18786,18314,KOCHI-MUMBAI,37100,All
2021,3,KOCHI,MUMBAI,17485,16606,KOCHI-MUMBAI,34091,All
2021,4,KOCHI,MUMBAI,13245,16093,KOCHI-MUMBAI,29338,All
2021,6,KOCHI,MUMBAI,11335,8239,KOCHI-MUMBAI,19574,All
2021,7,KOCHI,MUMBAI,13100,11453,KOCHI-MUMBAI,24553,All
2021,8,KOCHI,MUMBAI,18874,19450,KOCHI-MUMBAI,38324,All
2021,9,KOCHI,MUMBAI,19743,17373,KOCHI-MUMBAI,37116,All
2021,10,KOCHI,MUMBAI,26354,25453,KOCHI-MUMBAI,51807,All
2021,11,KOCHI,MUMBAI,32017,31043,KOCHI-MUMBAI,63060,All
2021,12,KOCHI,MUMBAI,33483,35627,KOCHI-MUMBAI,69110,All
2022,1,KOCHI,MUMBAI,25105,22612,KOCHI-MUMBAI,47717,All
2022,2,KOCHI,MUMBAI,28256,26023,KOCHI-MUMBAI,54279,All
2022,3,KOCHI,MUMBAI,33563,31910,KOCHI-MUMBAI,65473,All
2022,4,KOCHI,MUMBAI,34952,36881,KOCHI-MUMBAI,71833,All
2022,5,KOCHI,MUMBAI,35313,36419,KOCHI-MUMBAI,71732,All
2022,6,KOCHI,MUMBAI,30301,28446,KOCHI-MUMBAI,58747,All
2022,7,KOCHI,MUMBAI,26930,27888,KOCHI-MUMBAI,54818,All
2022,8,KOCHI,MUMBAI,34126,30239,KOCHI-MUMBAI,64365,All
2022,9,KOCHI,MUMBAI,35113,31331,KOCHI-MUMBAI,66444,All
2022,10,KOCHI,MUMBAI,24803,27155,KOCHI-MUMBAI,51958,All
2022,11,KOCHI,MUMBAI,33635,32450,KOCHI-MUMBAI,66085,All
2022,12,KOCHI,MUMBAI,34317,37208,KOCHI-MUMBAI,71525,All
2023,11,KOCHI,MUMBAI,42938,46624,KOCHI-MUMBAI,89562,All
2023,12,KOCHI,MUMBAI,54078,58589,KOCHI-MUMBAI,112667,All
2024,1,KOCHI,MUMBAI,59340,55268,KOCHI-MUMBAI,114608,All
2024,2,KOCHI,MUMBAI,48188,47321,KOCHI-MUMBAI,95509,All
2024,3,KOCHI,MUMBAI,44795,47202,KOCHI-MUMBAI,91997,All
2024,4,KOCHI,MUMBAI,48058,47974,KOCHI-MUMBAI,96032,All
2024,6,KOCHI,MUMBAI,45873,47717,KOCHI-MUMBAI,93590,All
2024,7,KOCHI,MUMBAI,47903,54948,KOCHI-MUMBAI,102851,All
2024,8,KOCHI,MUMBAI,54558,50454,KOCHI-MUMBAI,105012,All
2024,9,KOCHI,MUMBAI,53260,47267,KOCHI-MUMBAI,100527,All
2024,10,KOCHI,MUMBAI,42724,44064,KOCHI-MUMBAI,86788,All
2024,11,KOCHI,MUMBAI,50654,48790,KOCHI-MUMBAI,99444,All
2024,12,KOCHI,MUMBAI,48982,54753,KOCHI-MUMBAI,103735,All
2025,1,KOCHI,MUMBAI,52503,51601,KOCHI-MUMBAI,104104,All
2025,2,KOCHI,MUMBAI,47305,46714,KOCHI-MUMBAI,94019,All
2025,3,KOCHI,MUMBAI,42583,42176,KOCHI-MUMBAI,84759,All
2019,7,KOCHI,MYSORE,628,651,KOCHI-MYSORE,1279,All
2019,8,KOCHI,MYSORE,1311,1225,KOCHI-MYSORE,2536,All
2019,9,KOCHI,MYSORE,1525,1504,KOCHI-MYSORE,3029,All
2019,10,KOCHI,MYSORE,1498,1473,KOCHI-MYSORE,2971,All
2019,11,KOCHI,MYSORE,1006,873,KOCHI-MYSORE,1879,All
2020,5,KOCHI,MYSORE,49,69,KOCHI-MYSORE,118,All
2020,6,KOCHI,MYSORE,345,307,KOCHI-MYSORE,652,All
2020,7,KOCHI,MYSORE,375,323,KOCHI-MYSORE,698,All
2020,8,KOCHI,MYSORE,453,306,KOCHI-MYSORE,759,All
2020,9,KOCHI,MYSORE,429,301,KOCHI-MYSORE,730,All
2020,10,KOCHI,MYSORE,373,396,KOCHI-MYSORE,769,All
2020,11,KOCHI,MYSORE,645,492,KOCHI-MYSORE,1137,All
2020,12,KOCHI,MYSORE,928,931,KOCHI-MYSORE,1859,All
2021,1,KOCHI,MYSORE,981,810,KOCHI-MYSORE,1791,All
2021,2,KOCHI,MYSORE,811,756,KOCHI-MYSORE,1567,All
2021,3,KOCHI,MYSORE,530,593,KOCHI-MYSORE,1123,All
2021,4,KOCHI,MYSORE,471,621,KOCHI-MYSORE,1092,All
2021,6,KOCHI,MYSORE,310,318,KOCHI-MYSORE,628,All
2021,7,KOCHI,MYSORE,692,473,KOCHI-MYSORE,1165,All
2021,8,KOCHI,MYSORE,586,609,KOCHI-MYSORE,1195,All
2021,9,KOCHI,MYSORE,511,544,KOCHI-MYSORE,1055,All
2021,10,KOCHI,MYSORE,782,825,KOCHI-MYSORE,1607,All
2021,11,KOCHI,MYSORE,901,880,KOCHI-MYSORE,1781,All
2021,12,KOCHI,MYSORE,879,858,KOCHI-MYSORE,1737,All
2022,1,KOCHI,MYSORE,713,622,KOCHI-MYSORE,1335,All
2022,2,KOCHI,MYSORE,799,775,KOCHI-MYSORE,1574,All
2022,3,KOCHI,MYSORE,981,992,KOCHI-MYSORE,1973,All
2022,4,KOCHI,MYSORE,901,880,KOCHI-MYSORE,1781,All
2022,5,KOCHI,MYSORE,879,858,KOCHI-MYSORE,1737,All
2022,6,KOCHI,MYSORE,901,880,KOCHI-MYSORE,1781,All
2022,7,KOCHI,MYSORE,799,775,KOCHI-MYSORE,1574,All
2022,8,KOCHI,MYSORE,879,858,KOCHI-MYSORE,1737,All
2022,9,KOCHI,MYSORE,901,880,KOCHI-MYSORE,1781,All
2022,10,KOCHI,MYSORE,1245,1174,KOCHI-MYSORE,2419,All
2022,12,KOCHI,MYSORE,28,0,KOCHI-MYSORE,28,All
2015,7,KOCHI,NAGPUR,0,104,KOCHI-NAGPUR,104,All
2018,11,KOCHI,NAGPUR,992,984,KOCHI-NAGPUR,1976,All
2018,12,KOCHI,NAGPUR,2740,3845,KOCHI-NAGPUR,6585,All
2019,1,KOCHI,NAGPUR,3116,3279,KOCHI-NAGPUR,6395,All
2019,2,KOCHI,NAGPUR,3070,3225,KOCHI-NAGPUR,6295,All
2019,3,KOCHI,NAGPUR,2871,2606,KOCHI-NAGPUR,5477,All
2019,4,KOCHI,NAGPUR,3535,3754,KOCHI-NAGPUR,7289,All
2019,5,KOCHI,NAGPUR,4889,5974,KOCHI-NAGPUR,10863,All
2019,6,KOCHI,NAGPUR,5556,4504,KOCHI-NAGPUR,10060,All
2019,7,KOCHI,NAGPUR,1269,927,KOCHI-NAGPUR,2196,All
2019,8,KOCHI,NAGPUR,1115,1062,KOCHI-NAGPUR,2177,All
2019,9,KOCHI,NAGPUR,1346,1030,KOCHI-NAGPUR,2376,All
2019,10,KOCHI,NAGPUR,660,662,KOCHI-NAGPUR,1322,All
2021,1,KOCHI,NAGPUR,198,185,KOCHI-NAGPUR,383,All
2021,2,KOCHI,NAGPUR,283,220,KOCHI-NAGPUR,503,All
2021,3,KOCHI,NAGPUR,124,114,KOCHI-NAGPUR,238,All
2022,10,KOCHI,NAGPUR,8,26,KOCHI-NAGPUR,34,All
2022,11,KOCHI,NAGPUR,0,6,KOCHI-NAGPUR,6,All
2023,9,KOCHI,NAGPUR,0,12,KOCHI-NAGPUR,12,All
2024,4,KOCHI,NAGPUR,7,23,KOCHI-NAGPUR,30,All
2025,2,KOCHI,NAGPUR,11,0,KOCHI-NAGPUR,11,All
2017,10,KOCHI,PATNA,0,5,KOCHI-PATNA,5,All
2021,3,KOCHI,PATNA,156,36,KOCHI-PATNA,192,All
2022,10,KOCHI,PATNA,31,4,KOCHI-PATNA,35,All
2022,11,KOCHI,PATNA,579,335,KOCHI-PATNA,914,All
2022,12,KOCHI,PATNA,628,595,KOCHI-PATNA,1223,All
2023,1,KOCHI,PATNA,540,238,KOCHI-PATNA,778,All
2023,2,KOCHI,PATNA,253,163,KOCHI-PATNA,416,All
2023,3,KOCHI,PATNA,186,232,KOCHI-PATNA,418,All
2023,4,KOCHI,PATNA,235,195,KOCHI-PATNA,430,All
2023,5,KOCHI,PATNA,202,306,KOCHI-PATNA,508,All
2023,6,KOCHI,PATNA,312,245,KOCHI-PATNA,557,All
2023,7,KOCHI,PATNA,92,161,KOCHI-PATNA,253,All
2023,8,KOCHI,PATNA,273,231,KOCHI-PATNA,504,All
2023,9,KOCHI,PATNA,203,204,KOCHI-PATNA,407,All
2023,10,KOCHI,PATNA,343,259,KOCHI-PATNA,602,All
2023,11,KOCHI,PATNA,277,261,KOCHI-PATNA,538,All
2023,12,KOCHI,PATNA,477,555,KOCHI-PATNA,1032,All
2024,1,KOCHI,PATNA,231,212,KOCHI-PATNA,443,All
2024,2,KOCHI,PATNA,190,144,KOCHI-PATNA,334,All
2024,3,KOCHI,PATNA,94,115,KOCHI-PATNA,209,All
2024,10,KOCHI,PATNA,26,66,KOCHI-PATNA,92,All
2024,11,KOCHI,PATNA,311,220,KOCHI-PATNA,531,All
2024,12,KOCHI,PATNA,280,308,KOCHI-PATNA,588,All
2025,3,KOCHI,PATNA,261,239,KOCHI-PATNA,500,All
2015,7,KOCHI,PORT BLAIR,54,0,KOCHI-PORT BLAIR,54,All
2015,8,KOCHI,PORT BLAIR,186,0,KOCHI-PORT BLAIR,186,All
2015,9,KOCHI,PORT BLAIR,209,0,KOCHI-PORT BLAIR,209,All
2015,10,KOCHI,PORT BLAIR,86,0,KOCHI-PORT BLAIR,86,All
2016,1,KOCHI,PORT BLAIR,66,0,KOCHI-PORT BLAIR,66,All
2016,2,KOCHI,PORT BLAIR,116,0,KOCHI-PORT BLAIR,116,All
2016,3,KOCHI,PORT BLAIR,146,0,KOCHI-PORT BLAIR,146,All
2016,4,KOCHI,PORT BLAIR,273,0,KOCHI-PORT BLAIR,273,All
2016,5,KOCHI,PORT BLAIR,151,0,KOCHI-PORT BLAIR,151,All
2016,6,KOCHI,PORT BLAIR,249,0,KOCHI-PORT BLAIR,249,All
2016,7,KOCHI,PORT BLAIR,202,0,KOCHI-PORT BLAIR,202,All
2016,8,KOCHI,PORT BLAIR,195,0,KOCHI-PORT BLAIR,195,All
2016,9,KOCHI,PORT BLAIR,186,0,KOCHI-PORT BLAIR,186,All
2016,10,KOCHI,PORT BLAIR,280,0,KOCHI-PORT BLAIR,280,All
2016,11,KOCHI,PORT BLAIR,253,0,KOCHI-PORT BLAIR,253,All
2016,12,KOCHI,PORT BLAIR,171,0,KOCHI-PORT BLAIR,171,All
2017,1,KOCHI,PORT BLAIR,276,0,KOCHI-PORT BLAIR,276,All
2017,2,KOCHI,PORT BLAIR,376,0,KOCHI-PORT BLAIR,376,All
2017,3,KOCHI,PORT BLAIR,357,0,KOCHI-PORT BLAIR,357,All
2017,4,KOCHI,PORT BLAIR,669,0,KOCHI-PORT BLAIR,669,All
2017,5,KOCHI,PORT BLAIR,334,0,KOCHI-PORT BLAIR,334,All
2017,6,KOCHI,PORT BLAIR,360,0,KOCHI-PORT BLAIR,360,All
2017,7,KOCHI,PORT BLAIR,333,0,KOCHI-PORT BLAIR,333,All
2017,8,KOCHI,PORT BLAIR,379,0,KOCHI-PORT BLAIR,379,All
2017,9,KOCHI,PORT BLAIR,638,0,KOCHI-PORT BLAIR,638,All
2017,10,KOCHI,PORT BLAIR,315,0,KOCHI-PORT BLAIR,315,All
2017,11,KOCHI,PORT BLAIR,302,0,KOCHI-PORT BLAIR,302,All
2017,12,KOCHI,PORT BLAIR,221,0,KOCHI-PORT BLAIR,221,All
2018,1,KOCHI,PORT BLAIR,230,0,KOCHI-PORT BLAIR,230,All
2018,2,KOCHI,PORT BLAIR,460,0,KOCHI-PORT BLAIR,460,All
2018,3,KOCHI,PORT BLAIR,515,0,KOCHI-PORT BLAIR,515,All
2018,4,KOCHI,PORT BLAIR,590,0,KOCHI-PORT BLAIR,590,All
2018,5,KOCHI,PORT BLAIR,422,0,KOCHI-PORT BLAIR,422,All
2018,6,KOCHI,PORT BLAIR,593,0,KOCHI-PORT BLAIR,593,All
2018,7,KOCHI,PORT BLAIR,502,0,KOCHI-PORT BLAIR,502,All
2018,8,KOCHI,PORT BLAIR,236,0,KOCHI-PORT BLAIR,236,All
2018,9,KOCHI,PORT BLAIR,566,0,KOCHI-PORT BLAIR,566,All
2018,10,KOCHI,PORT BLAIR,485,0,KOCHI-PORT BLAIR,485,All
2018,11,KOCHI,PORT BLAIR,319,0,KOCHI-PORT BLAIR,319,All
2018,12,KOCHI,PORT BLAIR,327,0,KOCHI-PORT BLAIR,327,All
2019,1,KOCHI,PORT BLAIR,936,0,KOCHI-PORT BLAIR,936,All
2019,2,KOCHI,PORT BLAIR,888,0,KOCHI-PORT BLAIR,888,All
2019,3,KOCHI,PORT BLAIR,734,0,KOCHI-PORT BLAIR,734,All
2019,4,KOCHI,PORT BLAIR,834,0,KOCHI-PORT BLAIR,834,All
2019,5,KOCHI,PORT BLAIR,538,0,KOCHI-PORT BLAIR,538,All
2019,6,KOCHI,PORT BLAIR,599,0,KOCHI-PORT BLAIR,599,All
2019,7,KOCHI,PORT BLAIR,472,0,KOCHI-PORT BLAIR,472,All
2019,8,KOCHI,PORT BLAIR,416,0,KOCHI-PORT BLAIR,416,All
2019,9,KOCHI,PORT BLAIR,956,0,KOCHI-PORT BLAIR,956,All
2019,10,KOCHI,PORT BLAIR,660,0,KOCHI-PORT BLAIR,660,All
2019,11,KOCHI,PORT BLAIR,289,0,KOCHI-PORT BLAIR,289,All
2015,4,KOCHI,PUNE,5049,5564,KOCHI-PUNE,10613,All
2015,5,KOCHI,PUNE,5976,5486,KOCHI-PUNE,11462,All
2015,6,KOCHI,PUNE,4529,3824,KOCHI-PUNE,8353,All
2015,7,KOCHI,PUNE,4466,4647,KOCHI-PUNE,9113,All
2015,8,KOCHI,PUNE,4497,5040,KOCHI-PUNE,9537,All
2015,9,KOCHI,PUNE,5396,5409,KOCHI-PUNE,10805,All
2015,10,KOCHI,PUNE,5236,5355,KOCHI-PUNE,10591,All
2015,11,KOCHI,PUNE,6460,6935,KOCHI-PUNE,13395,All
2015,12,KOCHI,PUNE,6769,6947,KOCHI-PUNE,13716,All
2016,1,KOCHI,PUNE,7000,7133,KOCHI-PUNE,14133,All
2016,2,KOCHI,PUNE,6612,6368,KOCHI-PUNE,12980,All
2016,3,KOCHI,PUNE,5795,6009,KOCHI-PUNE,11804,All
2016,4,KOCHI,PUNE,6018,6668,KOCHI-PUNE,12686,All
2016,5,KOCHI,PUNE,6918,7290,KOCHI-PUNE,14208,All
2016,6,KOCHI,PUNE,5496,4834,KOCHI-PUNE,10330,All
2016,7,KOCHI,PUNE,4681,5089,KOCHI-PUNE,9770,All
2016,8,KOCHI,PUNE,4996,5332,KOCHI-PUNE,10328,All
2016,9,KOCHI,PUNE,5366,5724,KOCHI-PUNE,11090,All
2016,10,KOCHI,PUNE,5234,5767,KOCHI-PUNE,11001,All
2016,11,KOCHI,PUNE,6460,7099,KOCHI-PUNE,13559,All
2016,12,KOCHI,PUNE,6949,7961,KOCHI-PUNE,14910,All
2017,1,KOCHI,PUNE,6034,6962,KOCHI-PUNE,12996,All
2017,2,KOCHI,PUNE,6305,6792,KOCHI-PUNE,13097,All
2017,3,KOCHI,PUNE,8316,8225,KOCHI-PUNE,16541,All
2017,4,KOCHI,PUNE,8328,8594,KOCHI-PUNE,16922,All
2017,5,KOCHI,PUNE,6580,7463,KOCHI-PUNE,14043,All
2017,6,KOCHI,PUNE,6857,6898,KOCHI-PUNE,13755,All
2017,7,KOCHI,PUNE,8093,8474,KOCHI-PUNE,16567,All
2017,8,KOCHI,PUNE,9230,9795,KOCHI-PUNE,19025,All
2017,9,KOCHI,PUNE,8352,8192,KOCHI-PUNE,16544,All
2017,10,KOCHI,PUNE,9736,11408,KOCHI-PUNE,21144,All
2017,11,KOCHI,PUNE,10458,11074,KOCHI-PUNE,21532,All
2017,12,KOCHI,PUNE,11603,11943,KOCHI-PUNE,23546,All
2018,1,KOCHI,PUNE,11309,10906,KOCHI-PUNE,22215,All
2018,2,KOCHI,PUNE,9077,9082,KOCHI-PUNE,18159,All
2018,3,KOCHI,PUNE,8780,9601,KOCHI-PUNE,18381,All
2018,4,KOCHI,PUNE,9647,10167,KOCHI-PUNE,19814,All
2018,5,KOCHI,PUNE,11013,10940,KOCHI-PUNE,21953,All
2018,6,KOCHI,PUNE,7580,6195,KOCHI-PUNE,13775,All
2018,7,KOCHI,PUNE,7107,7379,KOCHI-PUNE,14486,All
2018,8,KOCHI,PUNE,3642,3693,KOCHI-PUNE,7335,All
2018,9,KOCHI,PUNE,7640,6393,KOCHI-PUNE,14033,All
2018,10,KOCHI,PUNE,7069,7208,KOCHI-PUNE,14277,All
2018,11,KOCHI,PUNE,9839,9833,KOCHI-PUNE,19672,All
2018,12,KOCHI,PUNE,9750,9844,KOCHI-PUNE,19594,All
2019,1,KOCHI,PUNE,10183,10134,KOCHI-PUNE,20317,All
2019,2,KOCHI,PUNE,10246,8835,KOCHI-PUNE,19081,All
2019,3,KOCHI,PUNE,5413,5218,KOCHI-PUNE,10631,All
2019,4,KOCHI,PUNE,9471,9357,KOCHI-PUNE,18828,All
2019,5,KOCHI,PUNE,11052,11052,KOCHI-PUNE,22104,All
2019,6,KOCHI,PUNE,5255,4656,KOCHI-PUNE,9911,All
2019,7,KOCHI,PUNE,8662,8595,KOCHI-PUNE,17257,All
2019,8,KOCHI,PUNE,8453,8748,KOCHI-PUNE,17201,All
2019,9,KOCHI,PUNE,9329,8737,KOCHI-PUNE,18066,All
2019,10,KOCHI,PUNE,8401,9143,KOCHI-PUNE,17544,All
2019,11,KOCHI,PUNE,7844,7766,KOCHI-PUNE,15610,All
2019,12,KOCHI,PUNE,5413,6094,KOCHI-PUNE,11507,All
2020,1,KOCHI,PUNE,5477,6024,KOCHI-PUNE,11501,All
2020,2,KOCHI,PUNE,5009,5316,KOCHI-PUNE,10325,All
2020,3,KOCHI,PUNE,2868,4138,KOCHI-PUNE,7006,All
2020,5,KOCHI,PUNE,105,453,KOCHI-PUNE,558,All
2020,6,KOCHI,PUNE,1097,1981,KOCHI-PUNE,3078,All
2020,7,KOCHI,PUNE,786,1165,KOCHI-PUNE,1951,All
2020,8,KOCHI,PUNE,1025,1099,KOCHI-PUNE,2124,All
2020,9,KOCHI,PUNE,843,1023,KOCHI-PUNE,1866,All
2020,10,KOCHI,PUNE,594,982,KOCHI-PUNE,1576,All
2020,12,KOCHI,PUNE,521,635,KOCHI-PUNE,1156,All
2021,1,KOCHI,PUNE,2662,2442,KOCHI-PUNE,5104,All
2021,2,KOCHI,PUNE,3244,2730,KOCHI-PUNE,5974,All
2021,3,KOCHI,PUNE,2312,2382,KOCHI-PUNE,4694,All
2021,4,KOCHI,PUNE,1713,2645,KOCHI-PUNE,4358,All
2021,6,KOCHI,PUNE,1182,1156,KOCHI-PUNE,2338,All
2021,7,KOCHI,PUNE,2567,2137,KOCHI-PUNE,4704,All
2021,8,KOCHI,PUNE,2514,2545,KOCHI-PUNE,5059,All
2021,9,KOCHI,PUNE,3000,2135,KOCHI-PUNE,5135,All
2021,10,KOCHI,PUNE,2111,1904,KOCHI-PUNE,4015,All
2021,11,KOCHI,PUNE,4505,4322,KOCHI-PUNE,8827,All
2021,12,KOCHI,PUNE,3984,4510,KOCHI-PUNE,8494,All
2022,1,KOCHI,PUNE,2710,2779,KOCHI-PUNE,5489,All
2022,2,KOCHI,PUNE,2120,2150,KOCHI-PUNE,4270,All
2022,3,KOCHI,PUNE,4255,4298,KOCHI-PUNE,8553,All
2022,4,KOCHI,PUNE,4530,4739,KOCHI-PUNE,9269,All
2022,5,KOCHI,PUNE,5517,5495,KOCHI-PUNE,11012,All
2022,6,KOCHI,PUNE,5146,4429,KOCHI-PUNE,9575,All
2022,7,KOCHI,PUNE,4832,4166,KOCHI-PUNE,8998,All
2022,8,KOCHI,PUNE,4622,4450,KOCHI-PUNE,9072,All
2022,9,KOCHI,PUNE,4039,4058,KOCHI-PUNE,8097,All
2022,10,KOCHI,PUNE,4199,4796,KOCHI-PUNE,8995,All
2022,11,KOCHI,PUNE,4787,5032,KOCHI-PUNE,9819,All
2022,12,KOCHI,PUNE,6476,7257,KOCHI-PUNE,13733,All
2023,1,KOCHI,PUNE,6689,6354,KOCHI-PUNE,13043,All
2023,2,KOCHI,PUNE,4237,4316,KOCHI-PUNE,8553,All
2023,3,KOCHI,PUNE,3309,3822,KOCHI-PUNE,7131,All
2023,4,KOCHI,PUNE,4661,4701,KOCHI-PUNE,9362,All
2023,5,KOCHI,PUNE,5045,5273,KOCHI-PUNE,10318,All
2023,6,KOCHI,PUNE,4696,4421,KOCHI-PUNE,9117,All
2023,7,KOCHI,PUNE,4682,4619,KOCHI-PUNE,9301,All
2023,8,KOCHI,PUNE,5416,5643,KOCHI-PUNE,11059,All
2023,9,KOCHI,PUNE,4905,4670,KOCHI-PUNE,9575,All
2023,10,KOCHI,PUNE,4458,4224,KOCHI-PUNE,8682,All
2023,11,KOCHI,PUNE,4254,4431,KOCHI-PUNE,8685,All
2023,12,KOCHI,PUNE,4461,4565,KOCHI-PUNE,9026,All
2024,1,KOCHI,PUNE,4901,4631,KOCHI-PUNE,9532,All
2024,2,KOCHI,PUNE,4182,4079,KOCHI-PUNE,8261,All
2024,3,KOCHI,PUNE,4008,4308,KOCHI-PUNE,8316,All
2024,4,KOCHI,PUNE,4548,4418,KOCHI-PUNE,8966,All
2024,6,KOCHI,PUNE,4206,3804,KOCHI-PUNE,8010,All
2024,7,KOCHI,PUNE,4744,4844,KOCHI-PUNE,9588,All
2024,8,KOCHI,PUNE,4224,4076,KOCHI-PUNE,8300,All
2024,9,KOCHI,PUNE,3683,3774,KOCHI-PUNE,7457,All
2024,10,KOCHI,PUNE,3931,4953,KOCHI-PUNE,8884,All
2024,11,KOCHI,PUNE,9772,9361,KOCHI-PUNE,19133,All
2024,12,KOCHI,PUNE,9873,10848,KOCHI-PUNE,20721,All
2025,1,KOCHI,PUNE,10401,10452,KOCHI-PUNE,20853,All
2025,2,KOCHI,PUNE,9070,9395,KOCHI-PUNE,18465,All
2025,3,KOCHI,PUNE,8808,8963,KOCHI-PUNE,17771,All
2017,7,KOCHI,RAIPUR,372,394,KOCHI-RAIPUR,766,All
2017,9,KOCHI,RAIPUR,0,30,KOCHI-RAIPUR,30,All
2017,10,KOCHI,RAIPUR,115,350,KOCHI-RAIPUR,465,All
2017,11,KOCHI,RAIPUR,360,545,KOCHI-RAIPUR,905,All
2017,12,KOCHI,RAIPUR,468,544,KOCHI-RAIPUR,1012,All
2018,1,KOCHI,RAIPUR,548,567,KOCHI-RAIPUR,1115,All
2018,2,KOCHI,RAIPUR,373,418,KOCHI-RAIPUR,791,All
2018,3,KOCHI,RAIPUR,341,749,KOCHI-RAIPUR,1090,All
2018,4,KOCHI,RAIPUR,332,470,KOCHI-RAIPUR,802,All
2018,5,KOCHI,RAIPUR,458,725,KOCHI-RAIPUR,1183,All
2018,6,KOCHI,RAIPUR,502,384,KOCHI-RAIPUR,886,All
2018,7,KOCHI,RAIPUR,240,313,KOCHI-RAIPUR,553,All
2018,8,KOCHI,RAIPUR,174,197,KOCHI-RAIPUR,371,All
2018,9,KOCHI,RAIPUR,376,469,KOCHI-RAIPUR,845,All
2018,10,KOCHI,RAIPUR,413,469,KOCHI-RAIPUR,882,All
2018,11,KOCHI,RAIPUR,341,385,KOCHI-RAIPUR,726,All
2018,12,KOCHI,RAIPUR,329,405,KOCHI-RAIPUR,734,All
2019,1,KOCHI,RAIPUR,324,328,KOCHI-RAIPUR,652,All
2019,2,KOCHI,RAIPUR,340,399,KOCHI-RAIPUR,739,All
2019,3,KOCHI,RAIPUR,297,394,KOCHI-RAIPUR,691,All
2019,4,KOCHI,RAIPUR,185,141,KOCHI-RAIPUR,326,All
2019,10,KOCHI,RAIPUR,71,57,KOCHI-RAIPUR,128,All
2019,11,KOCHI,RAIPUR,533,410,KOCHI-RAIPUR,943,All
2019,12,KOCHI,RAIPUR,396,511,KOCHI-RAIPUR,907,All
2020,1,KOCHI,RAIPUR,346,461,KOCHI-RAIPUR,807,All
2020,2,KOCHI,RAIPUR,225,253,KOCHI-RAIPUR,478,All
2020,3,KOCHI,RAIPUR,117,146,KOCHI-RAIPUR,263,All
2022,3,KOCHI,RAIPUR,0,76,KOCHI-RAIPUR,76,All
2022,10,KOCHI,RAIPUR,16,0,KOCHI-RAIPUR,16,All
2022,11,KOCHI,RAIPUR,182,183,KOCHI-RAIPUR,365,All
2022,12,KOCHI,RAIPUR,386,164,KOCHI-RAIPUR,550,All
2023,1,KOCHI,RAIPUR,424,457,KOCHI-RAIPUR,881,All
2023,2,KOCHI,RAIPUR,240,310,KOCHI-RAIPUR,550,All
2023,3,KOCHI,RAIPUR,85,122,KOCHI-RAIPUR,207,All
2023,4,KOCHI,RAIPUR,145,142,KOCHI-RAIPUR,287,All
2023,5,KOCHI,RAIPUR,338,392,KOCHI-RAIPUR,730,All
2023,6,KOCHI,RAIPUR,419,249,KOCHI-RAIPUR,668,All
2023,7,KOCHI,RAIPUR,138,166,KOCHI-RAIPUR,304,All
2023,8,KOCHI,RAIPUR,240,150,KOCHI-RAIPUR,390,All
2023,9,KOCHI,RAIPUR,197,172,KOCHI-RAIPUR,369,All
2023,10,KOCHI,RAIPUR,381,300,KOCHI-RAIPUR,681,All
2023,11,KOCHI,RAIPUR,580,552,KOCHI-RAIPUR,1132,All
2023,12,KOCHI,RAIPUR,552,607,KOCHI-RAIPUR,1159,All
2024,1,KOCHI,RAIPUR,602,430,KOCHI-RAIPUR,1032,All
2024,2,KOCHI,RAIPUR,380,328,KOCHI-RAIPUR,708,All
2024,3,KOCHI,RAIPUR,350,352,KOCHI-RAIPUR,702,All
2024,4,KOCHI,RAIPUR,665,576,KOCHI-RAIPUR,1241,All
2024,6,KOCHI,RAIPUR,772,548,KOCHI-RAIPUR,1320,All
2024,7,KOCHI,RAIPUR,500,497,KOCHI-RAIPUR,997,All
2024,8,KOCHI,RAIPUR,473,371,KOCHI-RAIPUR,844,All
2024,9,KOCHI,RAIPUR,377,394,KOCHI-RAIPUR,771,All
2024,10,KOCHI,RAIPUR,618,536,KOCHI-RAIPUR,1154,All
2024,11,KOCHI,RAIPUR,304,555,KOCHI-RAIPUR,859,All
2024,12,KOCHI,RAIPUR,281,393,KOCHI-RAIPUR,674,All
2025,3,KOCHI,RAIPUR,129,299,KOCHI-RAIPUR,428,All
2021,10,KOCHI,RANCHI,7,5,KOCHI-RANCHI,12,All
2021,11,KOCHI,RANCHI,251,247,KOCHI-RANCHI,498,All
2021,12,KOCHI,RANCHI,380,318,KOCHI-RANCHI,698,All
2022,1,KOCHI,RANCHI,282,148,KOCHI-RANCHI,430,All
2022,2,KOCHI,RANCHI,357,138,KOCHI-RANCHI,495,All
2022,3,KOCHI,RANCHI,451,379,KOCHI-RANCHI,830,All
2022,4,KOCHI,RANCHI,437,301,KOCHI-RANCHI,738,All
2022,5,KOCHI,RANCHI,436,415,KOCHI-RANCHI,851,All
2022,6,KOCHI,RANCHI,385,281,KOCHI-RANCHI,666,All
2022,7,KOCHI,RANCHI,227,223,KOCHI-RANCHI,450,All
2022,8,KOCHI,RANCHI,324,254,KOCHI-RANCHI,578,All
2022,9,KOCHI,RANCHI,416,263,KOCHI-RANCHI,679,All
2022,10,KOCHI,RANCHI,433,237,KOCHI-RANCHI,670,All
2024,12,KOCHI,RANCHI,58,45,KOCHI-RANCHI,103,All
2023,10,KOCHI,SALEM,71,101,KOCHI-SALEM,172,All
2023,11,KOCHI,SALEM,112,174,KOCHI-SALEM,286,All
2023,12,KOCHI,SALEM,169,258,KOCHI-SALEM,427,All
2024,1,KOCHI,SALEM,183,296,KOCHI-SALEM,479,All
2024,2,KOCHI,SALEM,185,296,KOCHI-SALEM,481,All
2024,3,KOCHI,SALEM,195,275,KOCHI-SALEM,470,All
2024,4,KOCHI,SALEM,802,790,KOCHI-SALEM,1592,All
2024,6,KOCHI,SALEM,869,764,KOCHI-SALEM,1633,All
2024,7,KOCHI,SALEM,694,603,KOCHI-SALEM,1297,All
2024,8,KOCHI,SALEM,658,573,KOCHI-SALEM,1231,All
2024,9,KOCHI,SALEM,711,678,KOCHI-SALEM,1389,All
2024,10,KOCHI,SALEM,1014,899,KOCHI-SALEM,1913,All
2024,11,KOCHI,SALEM,833,747,KOCHI-SALEM,1580,All
2024,12,KOCHI,SALEM,766,728,KOCHI-SALEM,1494,All
2025,1,KOCHI,SALEM,916,826,KOCHI-SALEM,1742,All
2025,2,KOCHI,SALEM,774,730,KOCHI-SALEM,1504,All
2025,3,KOCHI,SALEM,886,854,KOCHI-SALEM,1740,All
2017,12,KOCHI,SRINAGAR,6,0,KOCHI-SRINAGAR,6,All
2018,1,KOCHI,SRINAGAR,57,0,KOCHI-SRINAGAR,57,All
2018,9,KOCHI,SURAT,16,0,KOCHI-SURAT,16,All
2018,10,KOCHI,SURAT,79,0,KOCHI-SURAT,79,All
2018,11,KOCHI,SURAT,13,0,KOCHI-SURAT,13,All
2018,12,KOCHI,SURAT,45,0,KOCHI-SURAT,45,All
2019,1,KOCHI,SURAT,4,0,KOCHI-SURAT,4,All
2020,6,KOCHI,SURAT,0,0,KOCHI-SURAT,0,All
2021,12,KOCHI,SURAT,186,185,KOCHI-SURAT,371,All
2024,11,KOCHI,Shivamogga Airport,15,5,KOCHI-Shivamogga Airport,20,All
2024,12,KOCHI,Shivamogga Airport,19,12,KOCHI-Shivamogga Airport,31,All
2025,1,KOCHI,Shivamogga Airport,27,11,KOCHI-Shivamogga Airport,38,All
2018,6,KOCHI,TIRUCHIRAPALLY,84,58,KOCHI-TIRUCHIRAPALLY,142,All
2018,7,KOCHI,TIRUCHIRAPALLY,1170,1290,KOCHI-TIRUCHIRAPALLY,2460,All
2018,8,KOCHI,TIRUCHIRAPALLY,518,702,KOCHI-TIRUCHIRAPALLY,1220,All
2018,9,KOCHI,TIRUCHIRAPALLY,1017,1267,KOCHI-TIRUCHIRAPALLY,2284,All
2018,10,KOCHI,TIRUCHIRAPALLY,917,991,KOCHI-TIRUCHIRAPALLY,1908,All
2018,11,KOCHI,TIRUCHIRAPALLY,951,1430,KOCHI-TIRUCHIRAPALLY,2381,All
2018,12,KOCHI,TIRUCHIRAPALLY,1304,1784,KOCHI-TIRUCHIRAPALLY,3088,All
2019,1,KOCHI,TIRUCHIRAPALLY,1791,1697,KOCHI-TIRUCHIRAPALLY,3488,All
2019,2,KOCHI,TIRUCHIRAPALLY,1448,1702,KOCHI-TIRUCHIRAPALLY,3150,All
2019,3,KOCHI,TIRUCHIRAPALLY,1463,1733,KOCHI-TIRUCHIRAPALLY,3196,All
2019,4,KOCHI,TIRUCHIRAPALLY,1136,1651,KOCHI-TIRUCHIRAPALLY,2787,All
2019,5,KOCHI,TIRUCHIRAPALLY,1730,1912,KOCHI-TIRUCHIRAPALLY,3642,All
2019,6,KOCHI,TIRUCHIRAPALLY,1398,1527,KOCHI-TIRUCHIRAPALLY,2925,All
2019,7,KOCHI,TIRUCHIRAPALLY,1464,1479,KOCHI-TIRUCHIRAPALLY,2943,All
2019,8,KOCHI,TIRUCHIRAPALLY,1379,1293,KOCHI-TIRUCHIRAPALLY,2672,All
2019,9,KOCHI,TIRUCHIRAPALLY,1466,1642,KOCHI-TIRUCHIRAPALLY,3108,All
2019,10,KOCHI,TIRUCHIRAPALLY,1444,1169,KOCHI-TIRUCHIRAPALLY,2613,All
2024,3,KOCHI,TIRUCHIRAPALLY,3,0,KOCHI-TIRUCHIRAPALLY,3,All
2015,12,KOCHI,TIRUPATI,0,13,KOCHI-TIRUPATI,13,All
2019,3,KOCHI,TIRUPATI,268,350,KOCHI-TIRUPATI,618,All
2015,4,KOCHI,TRIVANDRUM,2566,2197,KOCHI-TRIVANDRUM,4763,All
2015,5,KOCHI,TRIVANDRUM,2874,2712,KOCHI-TRIVANDRUM,5586,All
2015,6,KOCHI,TRIVANDRUM,1758,1891,KOCHI-TRIVANDRUM,3649,All
2015,7,KOCHI,TRIVANDRUM,2234,2382,KOCHI-TRIVANDRUM,4616,All
2015,8,KOCHI,TRIVANDRUM,2905,2692,KOCHI-TRIVANDRUM,5597,All
2015,9,KOCHI,TRIVANDRUM,2539,2959,KOCHI-TRIVANDRUM,5498,All
2015,10,KOCHI,TRIVANDRUM,6293,4692,KOCHI-TRIVANDRUM,10985,All
2015,11,KOCHI,TRIVANDRUM,2910,2604,KOCHI-TRIVANDRUM,5514,All
2015,12,KOCHI,TRIVANDRUM,3381,3591,KOCHI-TRIVANDRUM,6972,All
2016,1,KOCHI,TRIVANDRUM,3226,3398,KOCHI-TRIVANDRUM,6624,All
2016,2,KOCHI,TRIVANDRUM,3031,3692,KOCHI-TRIVANDRUM,6723,All
2016,3,KOCHI,TRIVANDRUM,2616,2618,KOCHI-TRIVANDRUM,5234,All
2016,4,KOCHI,TRIVANDRUM,3386,2729,KOCHI-TRIVANDRUM,6115,All
2016,5,KOCHI,TRIVANDRUM,3290,3134,KOCHI-TRIVANDRUM,6424,All
2016,6,KOCHI,TRIVANDRUM,2438,2369,KOCHI-TRIVANDRUM,4807,All
2016,7,KOCHI,TRIVANDRUM,3011,2653,KOCHI-TRIVANDRUM,5664,All
2016,8,KOCHI,TRIVANDRUM,3921,3550,KOCHI-TRIVANDRUM,7471,All
2016,9,KOCHI,TRIVANDRUM,4255,3643,KOCHI-TRIVANDRUM,7898,All
2016,10,KOCHI,TRIVANDRUM,3195,2845,KOCHI-TRIVANDRUM,6040,All
2016,11,KOCHI,TRIVANDRUM,4523,2651,KOCHI-TRIVANDRUM,7174,All
2016,12,KOCHI,TRIVANDRUM,4015,3465,KOCHI-TRIVANDRUM,7480,All
2017,1,KOCHI,TRIVANDRUM,2546,3354,KOCHI-TRIVANDRUM,5900,All
2017,2,KOCHI,TRIVANDRUM,2135,3134,KOCHI-TRIVANDRUM,5269,All
2017,3,KOCHI,TRIVANDRUM,2172,3105,KOCHI-TRIVANDRUM,5277,All
2017,4,KOCHI,TRIVANDRUM,3919,3715,KOCHI-TRIVANDRUM,7634,All
2017,5,KOCHI,TRIVANDRUM,5210,4361,KOCHI-TRIVANDRUM,9571,All
2017,6,KOCHI,TRIVANDRUM,2768,2891,KOCHI-TRIVANDRUM,5659,All
2017,7,KOCHI,TRIVANDRUM,3230,3115,KOCHI-TRIVANDRUM,6345,All
2017,8,KOCHI,TRIVANDRUM,4193,3727,KOCHI-TRIVANDRUM,7920,All
2017,9,KOCHI,TRIVANDRUM,4499,3820,KOCHI-TRIVANDRUM,8319,All
2017,10,KOCHI,TRIVANDRUM,4929,3936,KOCHI-TRIVANDRUM,8865,All
2017,11,KOCHI,TRIVANDRUM,6460,3923,KOCHI-TRIVANDRUM,10383,All
2017,12,KOCHI,TRIVANDRUM,5964,4177,KOCHI-TRIVANDRUM,10141,All
2018,1,KOCHI,TRIVANDRUM,7074,4524,KOCHI-TRIVANDRUM,11598,All
2018,2,KOCHI,TRIVANDRUM,6336,3797,KOCHI-TRIVANDRUM,10133,All
2018,3,KOCHI,TRIVANDRUM,6991,4585,KOCHI-TRIVANDRUM,11576,All
2018,4,KOCHI,TRIVANDRUM,8017,5233,KOCHI-TRIVANDRUM,13250,All
2018,5,KOCHI,TRIVANDRUM,8707,5084,KOCHI-TRIVANDRUM,13791,All
2018,6,KOCHI,TRIVANDRUM,5121,3853,KOCHI-TRIVANDRUM,8974,All
2018,7,KOCHI,TRIVANDRUM,7319,5423,KOCHI-TRIVANDRUM,12742,All
2018,8,KOCHI,TRIVANDRUM,3981,2745,KOCHI-TRIVANDRUM,6726,All
2018,9,KOCHI,TRIVANDRUM,7083,5292,KOCHI-TRIVANDRUM,12375,All
2018,10,KOCHI,TRIVANDRUM,6099,4050,KOCHI-TRIVANDRUM,10149,All
2018,11,KOCHI,TRIVANDRUM,5416,3366,KOCHI-TRIVANDRUM,8782,All
2018,12,KOCHI,TRIVANDRUM,5948,4797,KOCHI-TRIVANDRUM,10745,All
2019,1,KOCHI,TRIVANDRUM,6525,4627,KOCHI-TRIVANDRUM,11152,All
2019,2,KOCHI,TRIVANDRUM,5965,4730,KOCHI-TRIVANDRUM,10695,All
2019,3,KOCHI,TRIVANDRUM,5195,4413,KOCHI-TRIVANDRUM,9608,All
2019,4,KOCHI,TRIVANDRUM,5914,3958,KOCHI-TRIVANDRUM,9872,All
2019,5,KOCHI,TRIVANDRUM,6041,4301,KOCHI-TRIVANDRUM,10342,All
2019,6,KOCHI,TRIVANDRUM,4354,4175,KOCHI-TRIVANDRUM,8529,All
2019,7,KOCHI,TRIVANDRUM,5447,4304,KOCHI-TRIVANDRUM,9751,All
2019,8,KOCHI,TRIVANDRUM,4938,3979,KOCHI-TRIVANDRUM,8917,All
2019,9,KOCHI,TRIVANDRUM,5984,4671,KOCHI-TRIVANDRUM,10655,All
2019,10,KOCHI,TRIVANDRUM,4757,4465,KOCHI-TRIVANDRUM,9222,All
2019,11,KOCHI,TRIVANDRUM,3472,3297,KOCHI-TRIVANDRUM,6769,All
2019,12,KOCHI,TRIVANDRUM,3688,3322,KOCHI-TRIVANDRUM,7010,All
2020,1,KOCHI,TRIVANDRUM,3244,3062,KOCHI-TRIVANDRUM,6306,All
2020,2,KOCHI,TRIVANDRUM,3257,2718,KOCHI-TRIVANDRUM,5975,All
2020,3,KOCHI,TRIVANDRUM,1323,1135,KOCHI-TRIVANDRUM,2458,All
2020,8,KOCHI,TRIVANDRUM,0,969,KOCHI-TRIVANDRUM,969,All
2020,9,KOCHI,TRIVANDRUM,0,481,KOCHI-TRIVANDRUM,481,All
2021,3,KOCHI,TRIVANDRUM,99,74,KOCHI-TRIVANDRUM,173,All
2021,4,KOCHI,TRIVANDRUM,602,536,KOCHI-TRIVANDRUM,1138,All
2021,6,KOCHI,TRIVANDRUM,3,0,KOCHI-TRIVANDRUM,3,All
2021,9,KOCHI,TRIVANDRUM,0,13,KOCHI-TRIVANDRUM,13,All
2021,10,KOCHI,TRIVANDRUM,16,24,KOCHI-TRIVANDRUM,40,All
2021,11,KOCHI,TRIVANDRUM,1272,1007,KOCHI-TRIVANDRUM,2279,All
2021,12,KOCHI,TRIVANDRUM,1978,1569,KOCHI-TRIVANDRUM,3547,All
2022,1,KOCHI,TRIVANDRUM,896,882,KOCHI-TRIVANDRUM,1778,All
2022,2,KOCHI,TRIVANDRUM,751,716,KOCHI-TRIVANDRUM,1467,All
2022,3,KOCHI,TRIVANDRUM,1730,1807,KOCHI-TRIVANDRUM,3537,All
2022,4,KOCHI,TRIVANDRUM,1982,1908,KOCHI-TRIVANDRUM,3890,All
2022,5,KOCHI,TRIVANDRUM,2021,1734,KOCHI-TRIVANDRUM,3755,All
2022,6,KOCHI,TRIVANDRUM,1866,1590,KOCHI-TRIVANDRUM,3456,All
2022,7,KOCHI,TRIVANDRUM,1916,1850,KOCHI-TRIVANDRUM,3766,All
2022,8,KOCHI,TRIVANDRUM,2044,2033,KOCHI-TRIVANDRUM,4077,All
2022,9,KOCHI,TRIVANDRUM,2013,1955,KOCHI-TRIVANDRUM,3968,All
2022,10,KOCHI,TRIVANDRUM,1982,2091,KOCHI-TRIVANDRUM,4073,All
2022,11,KOCHI,TRIVANDRUM,1926,1807,KOCHI-TRIVANDRUM,3733,All
2022,12,KOCHI,TRIVANDRUM,1884,1995,KOCHI-TRIVANDRUM,3879,All
2023,1,KOCHI,TRIVANDRUM,1854,2135,KOCHI-TRIVANDRUM,3989,All
2023,2,KOCHI,TRIVANDRUM,1704,2011,KOCHI-TRIVANDRUM,3715,All
2023,3,KOCHI,TRIVANDRUM,1996,2076,KOCHI-TRIVANDRUM,4072,All
2023,4,KOCHI,TRIVANDRUM,1872,1947,KOCHI-TRIVANDRUM,3819,All
2023,5,KOCHI,TRIVANDRUM,1998,2107,KOCHI-TRIVANDRUM,4105,All
2023,6,KOCHI,TRIVANDRUM,1845,1988,KOCHI-TRIVANDRUM,3833,All
2023,7,KOCHI,TRIVANDRUM,2021,2043,KOCHI-TRIVANDRUM,4064,All
2023,8,KOCHI,TRIVANDRUM,2152,2181,KOCHI-TRIVANDRUM,4333,All
2023,9,KOCHI,TRIVANDRUM,1881,2119,KOCHI-TRIVANDRUM,4000,All
2023,10,KOCHI,TRIVANDRUM,1950,1966,KOCHI-TRIVANDRUM,3916,All
2023,11,KOCHI,TRIVANDRUM,2170,1460,KOCHI-TRIVANDRUM,3630,All
2023,12,KOCHI,TRIVANDRUM,2030,1343,KOCHI-TRIVANDRUM,3373,All
2024,1,KOCHI,TRIVANDRUM,1718,1640,KOCHI-TRIVANDRUM,3358,All
2024,2,KOCHI,TRIVANDRUM,1582,1174,KOCHI-TRIVANDRUM,2756,All
2024,3,KOCHI,TRIVANDRUM,1908,1164,KOCHI-TRIVANDRUM,3072,All
2024,4,KOCHI,TRIVANDRUM,1988,1560,KOCHI-TRIVANDRUM,3548,All
2024,6,KOCHI,TRIVANDRUM,2240,1881,KOCHI-TRIVANDRUM,4121,All
2024,7,KOCHI,TRIVANDRUM,1963,1853,KOCHI-TRIVANDRUM,3816,All
2024,8,KOCHI,TRIVANDRUM,1603,1156,KOCHI-TRIVANDRUM,2759,All
2024,9,KOCHI,TRIVANDRUM,1638,1230,KOCHI-TRIVANDRUM,2868,All
2024,10,KOCHI,TRIVANDRUM,1438,1262,KOCHI-TRIVANDRUM,2700,All
2024,11,KOCHI,TRIVANDRUM,1720,1437,KOCHI-TRIVANDRUM,3157,All
2024,12,KOCHI,TRIVANDRUM,2211,2124,KOCHI-TRIVANDRUM,4335,All
2025,1,KOCHI,TRIVANDRUM,1323,1434,KOCHI-TRIVANDRUM,2757,All
2025,2,KOCHI,TRIVANDRUM,450,684,KOCHI-TRIVANDRUM,1134,All
2025,3,KOCHI,TRIVANDRUM,620,844,KOCHI-TRIVANDRUM,1464,All
2019,11,KOCHI,UDAIPUR,0,50,KOCHI-UDAIPUR,50,All
2019,12,KOCHI,UDAIPUR,0,59,KOCHI-UDAIPUR,59,All
2020,1,KOCHI,UDAIPUR,0,69,KOCHI-UDAIPUR,69,All
2020,11,KOCHI,UDAIPUR,0,31,KOCHI-UDAIPUR,31,All
2019,5,KOCHI,VADODARA,0,10,KOCHI-VADODARA,10,All
2019,6,KOCHI,VADODARA,0,18,KOCHI-VADODARA,18,All
2019,7,KOCHI,VADODARA,0,21,KOCHI-VADODARA,21,All
2019,8,KOCHI,VADODARA,0,19,KOCHI-VADODARA,19,All
2019,9,KOCHI,VADODARA,0,44,KOCHI-VADODARA,44,All
2019,10,KOCHI,VADODARA,0,55,KOCHI-VADODARA,55,All
2021,12,KOCHI,VADODARA,50,0,KOCHI-VADODARA,50,All
2022,1,KOCHI,VADODARA,22,0,KOCHI-VADODARA,22,All
2022,2,KOCHI,VADODARA,17,0,KOCHI-VADODARA,17,All
2022,3,KOCHI,VADODARA,78,0,KOCHI-VADODARA,78,All
2021,3,KOCHI,VARANASI,9,4,KOCHI-VARANASI,13,All
2021,4,KOCHI,VARANASI,167,76,KOCHI-VARANASI,243,All
2022,10,KOCHI,VARANASI,3,0,KOCHI-VARANASI,3,All
2022,11,KOCHI,VARANASI,106,122,KOCHI-VARANASI,228,All
2022,12,KOCHI,VARANASI,105,427,KOCHI-VARANASI,532,All
2023,1,KOCHI,VARANASI,155,318,KOCHI-VARANASI,473,All
2023,2,KOCHI,VARANASI,331,339,KOCHI-VARANASI,670,All
2023,3,KOCHI,VARANASI,272,246,KOCHI-VARANASI,518,All
2023,4,KOCHI,VARANASI,311,0,KOCHI-VARANASI,311,All
2023,5,KOCHI,VARANASI,255,0,KOCHI-VARANASI,255,All
2023,6,KOCHI,VARANASI,140,0,KOCHI-VARANASI,140,All
2023,7,KOCHI,VARANASI,66,0,KOCHI-VARANASI,66,All
2023,8,KOCHI,VARANASI,134,0,KOCHI-VARANASI,134,All
2023,9,KOCHI,VARANASI,116,0,KOCHI-VARANASI,116,All
2023,10,KOCHI,VARANASI,145,8,KOCHI-VARANASI,153,All
2023,11,KOCHI,VARANASI,107,289,KOCHI-VARANASI,396,All
2023,12,KOCHI,VARANASI,139,183,KOCHI-VARANASI,322,All
2024,1,KOCHI,VARANASI,2,384,KOCHI-VARANASI,386,All
2024,3,KOCHI,VARANASI,3,1,KOCHI-VARANASI,4,All
2024,4,KOCHI,VARANASI,292,224,KOCHI-VARANASI,516,All
2024,6,KOCHI,VARANASI,86,296,KOCHI-VARANASI,382,All
2024,7,KOCHI,VARANASI,75,205,KOCHI-VARANASI,280,All
2024,8,KOCHI,VARANASI,136,302,KOCHI-VARANASI,438,All
2024,9,KOCHI,VARANASI,246,283,KOCHI-VARANASI,529,All
2024,10,KOCHI,VARANASI,430,488,KOCHI-VARANASI,918,All
2024,11,KOCHI,VARANASI,424,643,KOCHI-VARANASI,1067,All
2024,12,KOCHI,VARANASI,717,984,KOCHI-VARANASI,1701,All
2025,3,KOCHI,VARANASI,532,682,KOCHI-VARANASI,1214,All
2019,3,KOCHI,VIJAYAWADA,92,193,KOCHI-VIJAYAWADA,285,All
2020,6,KOCHI,VIJAYAWADA,0,0,KOCHI-VIJAYAWADA,0,All
2015,7,KOCHI,VISAKHAPATNAM,557,698,KOCHI-VISAKHAPATNAM,1255,All
2015,8,KOCHI,VISAKHAPATNAM,356,563,KOCHI-VISAKHAPATNAM,919,All
2015,9,KOCHI,VISAKHAPATNAM,471,554,KOCHI-VISAKHAPATNAM,1025,All
2015,10,KOCHI,VISAKHAPATNAM,465,545,KOCHI-VISAKHAPATNAM,1010,All
2018,12,KOCHI,VISAKHAPATNAM,5199,4818,KOCHI-VISAKHAPATNAM,10017,All
2019,1,KOCHI,VISAKHAPATNAM,3839,3562,KOCHI-VISAKHAPATNAM,7401,All
2019,2,KOCHI,VISAKHAPATNAM,2881,2582,KOCHI-VISAKHAPATNAM,5463,All
2019,3,KOCHI,VISAKHAPATNAM,2233,2178,KOCHI-VISAKHAPATNAM,4411,All
2019,4,KOCHI,VISAKHAPATNAM,2771,2615,KOCHI-VISAKHAPATNAM,5386,All
2019,5,KOCHI,VISAKHAPATNAM,4058,4413,KOCHI-VISAKHAPATNAM,8471,All
2019,6,KOCHI,VISAKHAPATNAM,4028,3003,KOCHI-VISAKHAPATNAM,7031,All
2019,9,KOCHI,VISAKHAPATNAM,39,0,KOCHI-VISAKHAPATNAM,39,All
2019,10,KOCHI,VISAKHAPATNAM,40,0,KOCHI-VISAKHAPATNAM,40,All
2022,11,KOCHI,VISAKHAPATNAM,117,0,KOCHI-VISAKHAPATNAM,117,All
2022,12,KOCHI,VISAKHAPATNAM,187,0,KOCHI-VISAKHAPATNAM,187,All
2023,1,KOCHI,VISAKHAPATNAM,101,0,KOCHI-VISAKHAPATNAM,101,All
2023,2,KOCHI,VISAKHAPATNAM,46,0,KOCHI-VISAKHAPATNAM,46,All
2023,3,KOCHI,VISAKHAPATNAM,14,0,KOCHI-VISAKHAPATNAM,14,All
2023,4,KOCHI,VISAKHAPATNAM,26,0,KOCHI-VISAKHAPATNAM,26,All
2020,8,KOLHAPUR,KOLKATA,15,0,KOLHAPUR-KOLKATA,15,All
2019,9,KOLHAPUR,MUMBAI,924,911,KOLHAPUR-MUMBAI,1835,All
2019,10,KOLHAPUR,MUMBAI,1230,1322,KOLHAPUR-MUMBAI,2552,All
2019,11,KOLHAPUR,MUMBAI,1128,1313,KOLHAPUR-MUMBAI,2441,All
2019,12,KOLHAPUR,MUMBAI,393,363,KOLHAPUR-MUMBAI,756,All
2020,1,KOLHAPUR,MUMBAI,1033,991,KOLHAPUR-MUMBAI,2024,All
2020,2,KOLHAPUR,MUMBAI,1179,1179,KOLHAPUR-MUMBAI,2358,All
2020,3,KOLHAPUR,MUMBAI,720,767,KOLHAPUR-MUMBAI,1487,All
2020,10,KOLHAPUR,MUMBAI,73,75,KOLHAPUR-MUMBAI,148,All
2020,11,KOLHAPUR,MUMBAI,390,455,KOLHAPUR-MUMBAI,845,All
2020,12,KOLHAPUR,MUMBAI,581,646,KOLHAPUR-MUMBAI,1227,All
2021,1,KOLHAPUR,MUMBAI,512,568,KOLHAPUR-MUMBAI,1080,All
2021,2,KOLHAPUR,MUMBAI,598,627,KOLHAPUR-MUMBAI,1225,All
2021,3,KOLHAPUR,MUMBAI,422,480,KOLHAPUR-MUMBAI,902,All
2021,4,KOLHAPUR,MUMBAI,215,233,KOLHAPUR-MUMBAI,448,All
2021,6,KOLHAPUR,MUMBAI,215,171,KOLHAPUR-MUMBAI,386,All
2021,7,KOLHAPUR,MUMBAI,139,109,KOLHAPUR-MUMBAI,248,All
2021,8,KOLHAPUR,MUMBAI,522,539,KOLHAPUR-MUMBAI,1061,All
2021,9,KOLHAPUR,MUMBAI,183,236,KOLHAPUR-MUMBAI,419,All
2021,10,KOLHAPUR,MUMBAI,275,333,KOLHAPUR-MUMBAI,608,All
2021,11,KOLHAPUR,MUMBAI,77,102,KOLHAPUR-MUMBAI,179,All
2022,1,KOLHAPUR,MUMBAI,191,195,KOLHAPUR-MUMBAI,386,All
2022,2,KOLHAPUR,MUMBAI,173,182,KOLHAPUR-MUMBAI,355,All
2022,10,KOLHAPUR,MUMBAI,334,314,KOLHAPUR-MUMBAI,648,All
2022,11,KOLHAPUR,MUMBAI,406,411,KOLHAPUR-MUMBAI,817,All
2022,12,KOLHAPUR,MUMBAI,500,547,KOLHAPUR-MUMBAI,1047,All
2023,11,KOLHAPUR,MUMBAI,1618,1629,KOLHAPUR-MUMBAI,3247,All
2023,12,KOLHAPUR,MUMBAI,1798,1876,KOLHAPUR-MUMBAI,3674,All
2024,1,KOLHAPUR,MUMBAI,1762,1728,KOLHAPUR-MUMBAI,3490,All
2024,2,KOLHAPUR,MUMBAI,1590,1655,KOLHAPUR-MUMBAI,3245,All
2024,3,KOLHAPUR,MUMBAI,1669,1670,KOLHAPUR-MUMBAI,3339,All
2024,4,KOLHAPUR,MUMBAI,1644,1674,KOLHAPUR-MUMBAI,3318,All
2024,6,KOLHAPUR,MUMBAI,1500,1607,KOLHAPUR-MUMBAI,3107,All
2024,7,KOLHAPUR,MUMBAI,996,1107,KOLHAPUR-MUMBAI,2103,All
2024,8,KOLHAPUR,MUMBAI,1352,1473,KOLHAPUR-MUMBAI,2825,All
2024,9,KOLHAPUR,MUMBAI,1331,1479,KOLHAPUR-MUMBAI,2810,All
2024,10,KOLHAPUR,MUMBAI,1199,1365,KOLHAPUR-MUMBAI,2564,All
2024,11,KOLHAPUR,MUMBAI,1199,1340,KOLHAPUR-MUMBAI,2539,All
2024,12,KOLHAPUR,MUMBAI,1212,1372,KOLHAPUR-MUMBAI,2584,All
2025,1,KOLHAPUR,MUMBAI,1238,1378,KOLHAPUR-MUMBAI,2616,All
2025,2,KOLHAPUR,MUMBAI,1191,1249,KOLHAPUR-MUMBAI,2440,All
2025,3,KOLHAPUR,MUMBAI,1287,1295,KOLHAPUR-MUMBAI,2582,All
2021,8,KOLHAPUR,NAGPUR,38,0,KOLHAPUR-NAGPUR,38,All
2019,5,KOLHAPUR,TIRUPATI,1181,1318,KOLHAPUR-TIRUPATI,2499,All
2019,6,KOLHAPUR,TIRUPATI,1790,1953,KOLHAPUR-TIRUPATI,3743,All
2019,7,KOLHAPUR,TIRUPATI,1756,2031,KOLHAPUR-TIRUPATI,3787,All
2019,8,KOLHAPUR,TIRUPATI,1374,1397,KOLHAPUR-TIRUPATI,2771,All
2019,9,KOLHAPUR,TIRUPATI,1422,1813,KOLHAPUR-TIRUPATI,3235,All
2019,10,KOLHAPUR,TIRUPATI,1224,1373,KOLHAPUR-TIRUPATI,2597,All
2019,11,KOLHAPUR,TIRUPATI,1225,1545,KOLHAPUR-TIRUPATI,2770,All
2019,12,KOLHAPUR,TIRUPATI,1008,1058,KOLHAPUR-TIRUPATI,2066,All
2020,1,KOLHAPUR,TIRUPATI,599,771,KOLHAPUR-TIRUPATI,1370,All
2020,2,KOLHAPUR,TIRUPATI,1438,1833,KOLHAPUR-TIRUPATI,3271,All
2020,3,KOLHAPUR,TIRUPATI,880,1248,KOLHAPUR-TIRUPATI,2128,All
2020,6,KOLHAPUR,TIRUPATI,64,52,KOLHAPUR-TIRUPATI,116,All
2021,2,KOLHAPUR,TIRUPATI,247,344,KOLHAPUR-TIRUPATI,591,All
2021,3,KOLHAPUR,TIRUPATI,851,1211,KOLHAPUR-TIRUPATI,2062,All
2021,4,KOLHAPUR,TIRUPATI,511,683,KOLHAPUR-TIRUPATI,1194,All
2021,8,KOLHAPUR,TIRUPATI,708,793,KOLHAPUR-TIRUPATI,1501,All
2021,9,KOLHAPUR,TIRUPATI,665,817,KOLHAPUR-TIRUPATI,1482,All
2021,10,KOLHAPUR,TIRUPATI,841,947,KOLHAPUR-TIRUPATI,1788,All
2021,11,KOLHAPUR,TIRUPATI,824,1000,KOLHAPUR-TIRUPATI,1824,All
2021,12,KOLHAPUR,TIRUPATI,1384,1825,KOLHAPUR-TIRUPATI,3209,All
2022,1,KOLHAPUR,TIRUPATI,781,1351,KOLHAPUR-TIRUPATI,2132,All
2022,2,KOLHAPUR,TIRUPATI,751,881,KOLHAPUR-TIRUPATI,1632,All
2022,3,KOLHAPUR,TIRUPATI,1110,1217,KOLHAPUR-TIRUPATI,2327,All
2022,4,KOLHAPUR,TIRUPATI,1728,1961,KOLHAPUR-TIRUPATI,3689,All
2022,5,KOLHAPUR,TIRUPATI,1567,1757,KOLHAPUR-TIRUPATI,3324,All
2022,6,KOLHAPUR,TIRUPATI,1479,1782,KOLHAPUR-TIRUPATI,3261,All
2022,7,KOLHAPUR,TIRUPATI,1485,1886,KOLHAPUR-TIRUPATI,3371,All
2022,8,KOLHAPUR,TIRUPATI,1518,1915,KOLHAPUR-TIRUPATI,3433,All
2022,9,KOLHAPUR,TIRUPATI,1318,1742,KOLHAPUR-TIRUPATI,3060,All
2022,10,KOLHAPUR,TIRUPATI,1335,1673,KOLHAPUR-TIRUPATI,3008,All
2022,11,KOLHAPUR,TIRUPATI,1594,1994,KOLHAPUR-TIRUPATI,3588,All
2022,12,KOLHAPUR,TIRUPATI,1467,1976,KOLHAPUR-TIRUPATI,3443,All
2023,1,KOLHAPUR,TIRUPATI,1268,1824,KOLHAPUR-TIRUPATI,3092,All
2023,2,KOLHAPUR,TIRUPATI,1360,1917,KOLHAPUR-TIRUPATI,3277,All
2023,3,KOLHAPUR,TIRUPATI,1682,2126,KOLHAPUR-TIRUPATI,3808,All
2023,4,KOLHAPUR,TIRUPATI,1916,2286,KOLHAPUR-TIRUPATI,4202,All
2023,5,KOLHAPUR,TIRUPATI,1541,2003,KOLHAPUR-TIRUPATI,3544,All
2023,6,KOLHAPUR,TIRUPATI,1052,1671,KOLHAPUR-TIRUPATI,2723,All
2023,7,KOLHAPUR,TIRUPATI,940,1742,KOLHAPUR-TIRUPATI,2682,All
2023,8,KOLHAPUR,TIRUPATI,1208,2002,KOLHAPUR-TIRUPATI,3210,All
2023,9,KOLHAPUR,TIRUPATI,1086,1686,KOLHAPUR-TIRUPATI,2772,All
2023,10,KOLHAPUR,TIRUPATI,1103,1767,KOLHAPUR-TIRUPATI,2870,All
2023,11,KOLHAPUR,TIRUPATI,1378,1870,KOLHAPUR-TIRUPATI,3248,All
2023,12,KOLHAPUR,TIRUPATI,627,738,KOLHAPUR-TIRUPATI,1365,All
2024,1,KOLHAPUR,TIRUPATI,102,266,KOLHAPUR-TIRUPATI,368,All
2024,2,KOLHAPUR,TIRUPATI,90,352,KOLHAPUR-TIRUPATI,442,All
2024,3,KOLHAPUR,TIRUPATI,224,597,KOLHAPUR-TIRUPATI,821,All
2024,4,KOLHAPUR,TIRUPATI,660,886,KOLHAPUR-TIRUPATI,1546,All
2024,6,KOLHAPUR,TIRUPATI,562,898,KOLHAPUR-TIRUPATI,1460,All
2024,7,KOLHAPUR,TIRUPATI,469,718,KOLHAPUR-TIRUPATI,1187,All
2024,8,KOLHAPUR,TIRUPATI,462,744,KOLHAPUR-TIRUPATI,1206,All
2024,9,KOLHAPUR,TIRUPATI,532,775,KOLHAPUR-TIRUPATI,1307,All
2024,10,KOLHAPUR,TIRUPATI,553,795,KOLHAPUR-TIRUPATI,1348,All
2024,11,KOLHAPUR,TIRUPATI,585,869,KOLHAPUR-TIRUPATI,1454,All
2024,12,KOLHAPUR,TIRUPATI,584,849,KOLHAPUR-TIRUPATI,1433,All
2025,1,KOLHAPUR,TIRUPATI,512,532,KOLHAPUR-TIRUPATI,1044,All
2025,2,KOLHAPUR,TIRUPATI,435,473,KOLHAPUR-TIRUPATI,908,All
2025,3,KOLHAPUR,TIRUPATI,634,1001,KOLHAPUR-TIRUPATI,1635,All
2015,4,KOLKATA,AGARTALA,22090,23468,AGARTALA-KOLKATA,45558,All
2015,5,KOLKATA,AGARTALA,24188,26034,AGARTALA-KOLKATA,50222,All
2015,6,KOLKATA,AGARTALA,23344,22566,AGARTALA-KOLKATA,45910,All
2015,7,KOLKATA,AGARTALA,22201,24332,AGARTALA-KOLKATA,46533,All
2015,8,KOLKATA,AGARTALA,21988,25325,AGARTALA-KOLKATA,47313,All
2015,9,KOLKATA,AGARTALA,22074,21933,AGARTALA-KOLKATA,44007,All
2015,10,KOLKATA,AGARTALA,24737,25981,AGARTALA-KOLKATA,50718,All
2015,11,KOLKATA,AGARTALA,24501,29151,AGARTALA-KOLKATA,53652,All
2015,12,KOLKATA,AGARTALA,29156,30852,AGARTALA-KOLKATA,60008,All
2016,1,KOLKATA,AGARTALA,28625,27135,AGARTALA-KOLKATA,55760,All
2016,2,KOLKATA,AGARTALA,25137,26343,AGARTALA-KOLKATA,51480,All
2016,3,KOLKATA,AGARTALA,27628,29697,AGARTALA-KOLKATA,57325,All
2016,4,KOLKATA,AGARTALA,26504,29050,AGARTALA-KOLKATA,55554,All
2016,5,KOLKATA,AGARTALA,30634,31828,AGARTALA-KOLKATA,62462,All
2016,6,KOLKATA,AGARTALA,29144,29560,AGARTALA-KOLKATA,58704,All
2016,7,KOLKATA,AGARTALA,31286,33411,AGARTALA-KOLKATA,64697,All
2016,8,KOLKATA,AGARTALA,31481,35067,AGARTALA-KOLKATA,66548,All
2016,9,KOLKATA,AGARTALA,35721,34617,AGARTALA-KOLKATA,70338,All
2016,10,KOLKATA,AGARTALA,34068,37389,AGARTALA-KOLKATA,71457,All
2016,11,KOLKATA,AGARTALA,32414,36802,AGARTALA-KOLKATA,69216,All
2016,12,KOLKATA,AGARTALA,39160,42283,AGARTALA-KOLKATA,81443,All
2017,1,KOLKATA,AGARTALA,40164,37964,AGARTALA-KOLKATA,78128,All
2017,2,KOLKATA,AGARTALA,29956,33132,AGARTALA-KOLKATA,63088,All
2017,3,KOLKATA,AGARTALA,32259,34578,AGARTALA-KOLKATA,66837,All
2017,4,KOLKATA,AGARTALA,32748,37735,AGARTALA-KOLKATA,70483,All
2017,5,KOLKATA,AGARTALA,43549,43152,AGARTALA-KOLKATA,86701,All
2017,6,KOLKATA,AGARTALA,36824,37225,AGARTALA-KOLKATA,74049,All
2017,7,KOLKATA,AGARTALA,35859,39430,AGARTALA-KOLKATA,75289,All
2017,8,KOLKATA,AGARTALA,39343,40977,AGARTALA-KOLKATA,80320,All
2017,9,KOLKATA,AGARTALA,44362,38740,AGARTALA-KOLKATA,83102,All
2017,10,KOLKATA,AGARTALA,37931,46436,AGARTALA-KOLKATA,84367,All
2017,11,KOLKATA,AGARTALA,38470,41520,AGARTALA-KOLKATA,79990,All
2017,12,KOLKATA,AGARTALA,45690,45830,AGARTALA-KOLKATA,91520,All
2018,1,KOLKATA,AGARTALA,48418,46184,AGARTALA-KOLKATA,94602,All
2018,2,KOLKATA,AGARTALA,37908,41683,AGARTALA-KOLKATA,79591,All
2018,3,KOLKATA,AGARTALA,43841,48673,AGARTALA-KOLKATA,92514,All
2018,4,KOLKATA,AGARTALA,43777,50719,AGARTALA-KOLKATA,94496,All
2018,5,KOLKATA,AGARTALA,46791,47562,AGARTALA-KOLKATA,94353,All
2018,6,KOLKATA,AGARTALA,42584,44488,AGARTALA-KOLKATA,87072,All
2018,7,KOLKATA,AGARTALA,46989,47919,AGARTALA-KOLKATA,94908,All
2018,8,KOLKATA,AGARTALA,41994,47238,AGARTALA-KOLKATA,89232,All
2018,9,KOLKATA,AGARTALA,34418,37212,AGARTALA-KOLKATA,71630,All
2018,10,KOLKATA,AGARTALA,37514,35333,AGARTALA-KOLKATA,72847,All
2018,11,KOLKATA,AGARTALA,31490,35357,AGARTALA-KOLKATA,66847,All
2018,12,KOLKATA,AGARTALA,33413,31925,AGARTALA-KOLKATA,65338,All
2019,1,KOLKATA,AGARTALA,34652,34281,AGARTALA-KOLKATA,68933,All
2019,2,KOLKATA,AGARTALA,31347,33564,AGARTALA-KOLKATA,64911,All
2019,3,KOLKATA,AGARTALA,34806,36924,AGARTALA-KOLKATA,71730,All
2019,4,KOLKATA,AGARTALA,32605,32864,AGARTALA-KOLKATA,65469,All
2019,1,KOLKATA,ALLAHABAD,990,950,ALLAHABAD-KOLKATA,1940,All
2019,2,KOLKATA,ALLAHABAD,1521,1320,ALLAHABAD-KOLKATA,2841,All
2019,3,KOLKATA,ALLAHABAD,464,493,ALLAHABAD-KOLKATA,957,All
2024,1,KOLKATA,Ayodhya International Airport ,857,733,Ayodhya International Airport -KOLKATA,1590,All
2024,2,KOLKATA,Ayodhya International Airport ,1624,1502,Ayodhya International Airport -KOLKATA,3126,All
2024,3,KOLKATA,Ayodhya International Airport ,1982,1965,Ayodhya International Airport -KOLKATA,3947,All
2024,4,KOLKATA,Ayodhya International Airport ,2113,1843,Ayodhya International Airport -KOLKATA,3956,All
2024,6,KOLKATA,Ayodhya International Airport ,1876,2254,Ayodhya International Airport -KOLKATA,4130,All
2024,7,KOLKATA,Ayodhya International Airport ,485,305,Ayodhya International Airport -KOLKATA,790,All
2015,4,KOLKATA,BAGDOGRA,14107,15672,BAGDOGRA-KOLKATA,29779,All
2015,5,KOLKATA,BAGDOGRA,18589,17588,BAGDOGRA-KOLKATA,36177,All
2015,6,KOLKATA,BAGDOGRA,15240,16940,BAGDOGRA-KOLKATA,32180,All
2015,7,KOLKATA,BAGDOGRA,11300,12675,BAGDOGRA-KOLKATA,23975,All
2015,8,KOLKATA,BAGDOGRA,11190,12675,BAGDOGRA-KOLKATA,23865,All
2015,9,KOLKATA,BAGDOGRA,12730,12733,BAGDOGRA-KOLKATA,25463,All
2015,10,KOLKATA,BAGDOGRA,15405,19130,BAGDOGRA-KOLKATA,34535,All
2015,11,KOLKATA,BAGDOGRA,14234,15171,BAGDOGRA-KOLKATA,29405,All
2015,12,KOLKATA,BAGDOGRA,15803,16181,BAGDOGRA-KOLKATA,31984,All
2016,1,KOLKATA,BAGDOGRA,13725,15412,BAGDOGRA-KOLKATA,29137,All
2016,2,KOLKATA,BAGDOGRA,14727,15121,BAGDOGRA-KOLKATA,29848,All
2016,3,KOLKATA,BAGDOGRA,17877,18310,BAGDOGRA-KOLKATA,36187,All
2016,4,KOLKATA,BAGDOGRA,17947,19050,BAGDOGRA-KOLKATA,36997,All
2016,5,KOLKATA,BAGDOGRA,22403,21891,BAGDOGRA-KOLKATA,44294,All
2016,6,KOLKATA,BAGDOGRA,18615,21114,BAGDOGRA-KOLKATA,39729,All
2016,7,KOLKATA,BAGDOGRA,16896,18549,BAGDOGRA-KOLKATA,35445,All
2016,8,KOLKATA,BAGDOGRA,16232,18984,BAGDOGRA-KOLKATA,35216,All
2016,9,KOLKATA,BAGDOGRA,19808,19913,BAGDOGRA-KOLKATA,39721,All
2016,10,KOLKATA,BAGDOGRA,23565,23992,BAGDOGRA-KOLKATA,47557,All
2016,11,KOLKATA,BAGDOGRA,21955,26152,BAGDOGRA-KOLKATA,48107,All
2016,12,KOLKATA,BAGDOGRA,24979,27330,BAGDOGRA-KOLKATA,52309,All
2017,1,KOLKATA,BAGDOGRA,22647,26763,BAGDOGRA-KOLKATA,49410,All
2017,2,KOLKATA,BAGDOGRA,23467,24983,BAGDOGRA-KOLKATA,48450,All
2017,3,KOLKATA,BAGDOGRA,30566,32914,BAGDOGRA-KOLKATA,63480,All
2017,4,KOLKATA,BAGDOGRA,31925,33030,BAGDOGRA-KOLKATA,64955,All
2017,5,KOLKATA,BAGDOGRA,36346,35819,BAGDOGRA-KOLKATA,72165,All
2017,6,KOLKATA,BAGDOGRA,29982,35031,BAGDOGRA-KOLKATA,65013,All
2017,7,KOLKATA,BAGDOGRA,22989,25224,BAGDOGRA-KOLKATA,48213,All
2017,8,KOLKATA,BAGDOGRA,35484,34882,BAGDOGRA-KOLKATA,70366,All
2017,9,KOLKATA,BAGDOGRA,36841,35275,BAGDOGRA-KOLKATA,72116,All
2017,10,KOLKATA,BAGDOGRA,34542,36640,BAGDOGRA-KOLKATA,71182,All
2017,11,KOLKATA,BAGDOGRA,30870,34584,BAGDOGRA-KOLKATA,65454,All
2017,12,KOLKATA,BAGDOGRA,35890,36757,BAGDOGRA-KOLKATA,72647,All
2018,1,KOLKATA,BAGDOGRA,33947,36545,BAGDOGRA-KOLKATA,70492,All
2018,2,KOLKATA,BAGDOGRA,31967,32303,BAGDOGRA-KOLKATA,64270,All
2018,3,KOLKATA,BAGDOGRA,36869,36042,BAGDOGRA-KOLKATA,72911,All
2018,4,KOLKATA,BAGDOGRA,33879,35438,BAGDOGRA-KOLKATA,69317,All
2018,5,KOLKATA,BAGDOGRA,39547,39552,BAGDOGRA-KOLKATA,79099,All
2018,6,KOLKATA,BAGDOGRA,32529,34362,BAGDOGRA-KOLKATA,66891,All
2018,7,KOLKATA,BAGDOGRA,29372,31238,BAGDOGRA-KOLKATA,60610,All
2018,8,KOLKATA,BAGDOGRA,30310,33297,BAGDOGRA-KOLKATA,63607,All
2018,9,KOLKATA,BAGDOGRA,30858,30823,BAGDOGRA-KOLKATA,61681,All
2018,10,KOLKATA,BAGDOGRA,37641,36813,BAGDOGRA-KOLKATA,74454,All
2018,11,KOLKATA,BAGDOGRA,38024,40742,BAGDOGRA-KOLKATA,78766,All
2018,12,KOLKATA,BAGDOGRA,40266,40780,BAGDOGRA-KOLKATA,81046,All
2019,1,KOLKATA,BAGDOGRA,38245,40973,BAGDOGRA-KOLKATA,79218,All
2019,2,KOLKATA,BAGDOGRA,37631,38479,BAGDOGRA-KOLKATA,76110,All
2019,3,KOLKATA,BAGDOGRA,42639,43471,BAGDOGRA-KOLKATA,86110,All
2019,4,KOLKATA,BAGDOGRA,36833,36435,BAGDOGRA-KOLKATA,73268,All
2015,10,KOLKATA,CHANDIGARH,0,154,CHANDIGARH-KOLKATA,154,All
2016,10,KOLKATA,CHANDIGARH,5,10,CHANDIGARH-KOLKATA,15,All
2016,11,KOLKATA,CHANDIGARH,268,164,CHANDIGARH-KOLKATA,432,All
2016,12,KOLKATA,CHANDIGARH,525,226,CHANDIGARH-KOLKATA,751,All
2017,1,KOLKATA,CHANDIGARH,423,243,CHANDIGARH-KOLKATA,666,All
2017,2,KOLKATA,CHANDIGARH,550,601,CHANDIGARH-KOLKATA,1151,All
2017,3,KOLKATA,CHANDIGARH,1074,1028,CHANDIGARH-KOLKATA,2102,All
2017,4,KOLKATA,CHANDIGARH,763,712,CHANDIGARH-KOLKATA,1475,All
2017,5,KOLKATA,CHANDIGARH,727,635,CHANDIGARH-KOLKATA,1362,All
2017,6,KOLKATA,CHANDIGARH,637,674,CHANDIGARH-KOLKATA,1311,All
2017,7,KOLKATA,CHANDIGARH,459,537,CHANDIGARH-KOLKATA,996,All
2017,8,KOLKATA,CHANDIGARH,467,465,CHANDIGARH-KOLKATA,932,All
2017,9,KOLKATA,CHANDIGARH,671,309,CHANDIGARH-KOLKATA,980,All
2017,10,KOLKATA,CHANDIGARH,422,17,CHANDIGARH-KOLKATA,439,All
2017,11,KOLKATA,CHANDIGARH,442,0,CHANDIGARH-KOLKATA,442,All
2017,12,KOLKATA,CHANDIGARH,780,0,CHANDIGARH-KOLKATA,780,All
2018,1,KOLKATA,CHANDIGARH,784,0,CHANDIGARH-KOLKATA,784,All
2018,2,KOLKATA,CHANDIGARH,350,0,CHANDIGARH-KOLKATA,350,All
2018,3,KOLKATA,CHANDIGARH,579,34,CHANDIGARH-KOLKATA,613,All
2018,4,KOLKATA,CHANDIGARH,0,188,CHANDIGARH-KOLKATA,188,All
2018,5,KOLKATA,CHANDIGARH,0,108,CHANDIGARH-KOLKATA,108,All
2018,6,KOLKATA,CHANDIGARH,0,593,CHANDIGARH-KOLKATA,593,All
2018,7,KOLKATA,CHANDIGARH,726,1278,CHANDIGARH-KOLKATA,2004,All
2018,8,KOLKATA,CHANDIGARH,1896,1961,CHANDIGARH-KOLKATA,3857,All
2018,9,KOLKATA,CHANDIGARH,3383,3659,CHANDIGARH-KOLKATA,7042,All
2018,10,KOLKATA,CHANDIGARH,4674,4265,CHANDIGARH-KOLKATA,8939,All
2018,11,KOLKATA,CHANDIGARH,4214,4627,CHANDIGARH-KOLKATA,8841,All
2018,12,KOLKATA,CHANDIGARH,3357,3508,CHANDIGARH-KOLKATA,6865,All
2019,1,KOLKATA,CHANDIGARH,3507,2971,CHANDIGARH-KOLKATA,6478,All
2019,2,KOLKATA,CHANDIGARH,3082,3209,CHANDIGARH-KOLKATA,6291,All
2019,3,KOLKATA,CHANDIGARH,3034,4147,CHANDIGARH-KOLKATA,7181,All
2019,4,KOLKATA,CHANDIGARH,2707,3635,CHANDIGARH-KOLKATA,6342,All
2015,4,KOLKATA,CHENNAI,23424,27144,CHENNAI-KOLKATA,50568,All
2015,5,KOLKATA,CHENNAI,27467,27124,CHENNAI-KOLKATA,54591,All
2015,6,KOLKATA,CHENNAI,26658,24552,CHENNAI-KOLKATA,51210,All
2015,7,KOLKATA,CHENNAI,28287,26495,CHENNAI-KOLKATA,54782,All
2015,8,KOLKATA,CHENNAI,25732,24349,CHENNAI-KOLKATA,50081,All
2015,9,KOLKATA,CHENNAI,23814,26123,CHENNAI-KOLKATA,49937,All
2015,10,KOLKATA,CHENNAI,29098,27761,CHENNAI-KOLKATA,56859,All
2015,11,KOLKATA,CHENNAI,31512,35914,CHENNAI-KOLKATA,67426,All
2015,12,KOLKATA,CHENNAI,28057,26261,CHENNAI-KOLKATA,54318,All
2016,1,KOLKATA,CHENNAI,34655,33738,CHENNAI-KOLKATA,68393,All
2016,2,KOLKATA,CHENNAI,32513,34826,CHENNAI-KOLKATA,67339,All
2016,3,KOLKATA,CHENNAI,35582,40313,CHENNAI-KOLKATA,75895,All
2016,4,KOLKATA,CHENNAI,32826,39567,CHENNAI-KOLKATA,72393,All
2016,5,KOLKATA,CHENNAI,42232,40489,CHENNAI-KOLKATA,82721,All
2016,6,KOLKATA,CHENNAI,36463,38294,CHENNAI-KOLKATA,74757,All
2016,7,KOLKATA,CHENNAI,42816,43385,CHENNAI-KOLKATA,86201,All
2016,8,KOLKATA,CHENNAI,38717,41963,CHENNAI-KOLKATA,80680,All
2016,9,KOLKATA,CHENNAI,39856,46004,CHENNAI-KOLKATA,85860,All
2016,10,KOLKATA,CHENNAI,48330,52009,CHENNAI-KOLKATA,100339,All
2016,11,KOLKATA,CHENNAI,48370,48417,CHENNAI-KOLKATA,96787,All
2016,12,KOLKATA,CHENNAI,54074,53756,CHENNAI-KOLKATA,107830,All
2017,1,KOLKATA,CHENNAI,56825,53275,CHENNAI-KOLKATA,110100,All
2017,2,KOLKATA,CHENNAI,48403,48953,CHENNAI-KOLKATA,97356,All
2017,3,KOLKATA,CHENNAI,53248,55303,CHENNAI-KOLKATA,108551,All
2017,4,KOLKATA,CHENNAI,51255,57683,CHENNAI-KOLKATA,108938,All
2017,5,KOLKATA,CHENNAI,56198,55453,CHENNAI-KOLKATA,111651,All
2017,6,KOLKATA,CHENNAI,43980,43482,CHENNAI-KOLKATA,87462,All
2017,7,KOLKATA,CHENNAI,43911,42030,CHENNAI-KOLKATA,85941,All
2017,8,KOLKATA,CHENNAI,43537,43879,CHENNAI-KOLKATA,87416,All
2017,9,KOLKATA,CHENNAI,44235,45182,CHENNAI-KOLKATA,89417,All
2017,10,KOLKATA,CHENNAI,47330,47748,CHENNAI-KOLKATA,95078,All
2017,11,KOLKATA,CHENNAI,46511,48096,CHENNAI-KOLKATA,94607,All
2017,12,KOLKATA,CHENNAI,48742,47883,CHENNAI-KOLKATA,96625,All
2018,1,KOLKATA,CHENNAI,48622,49394,CHENNAI-KOLKATA,98016,All
2018,2,KOLKATA,CHENNAI,45519,48272,CHENNAI-KOLKATA,93791,All
2018,3,KOLKATA,CHENNAI,49432,51337,CHENNAI-KOLKATA,100769,All
2018,4,KOLKATA,CHENNAI,51297,53530,CHENNAI-KOLKATA,104827,All
2018,5,KOLKATA,CHENNAI,55597,53977,CHENNAI-KOLKATA,109574,All
2018,6,KOLKATA,CHENNAI,48306,51178,CHENNAI-KOLKATA,99484,All
2018,7,KOLKATA,CHENNAI,55685,53305,CHENNAI-KOLKATA,108990,All
2018,8,KOLKATA,CHENNAI,53192,55701,CHENNAI-KOLKATA,108893,All
2018,9,KOLKATA,CHENNAI,57003,56704,CHENNAI-KOLKATA,113707,All
2018,10,KOLKATA,CHENNAI,53821,57350,CHENNAI-KOLKATA,111171,All
2018,11,KOLKATA,CHENNAI,49978,53123,CHENNAI-KOLKATA,103101,All
2018,12,KOLKATA,CHENNAI,55378,56642,CHENNAI-KOLKATA,112020,All
2019,1,KOLKATA,CHENNAI,55312,52215,CHENNAI-KOLKATA,107527,All
2019,2,KOLKATA,CHENNAI,51956,54157,CHENNAI-KOLKATA,106113,All
2019,3,KOLKATA,CHENNAI,52909,58801,CHENNAI-KOLKATA,111710,All
2019,4,KOLKATA,CHENNAI,45274,51646,CHENNAI-KOLKATA,96920,All
2015,4,KOLKATA,COIMBATORE,968,1329,COIMBATORE-KOLKATA,2297,All
2015,5,KOLKATA,COIMBATORE,1448,1660,COIMBATORE-KOLKATA,3108,All
2015,6,KOLKATA,COIMBATORE,1133,1485,COIMBATORE-KOLKATA,2618,All
2015,7,KOLKATA,COIMBATORE,1068,1129,COIMBATORE-KOLKATA,2197,All
2015,8,KOLKATA,COIMBATORE,1254,1554,COIMBATORE-KOLKATA,2808,All
2015,9,KOLKATA,COIMBATORE,1098,1756,COIMBATORE-KOLKATA,2854,All
2015,10,KOLKATA,COIMBATORE,1593,1812,COIMBATORE-KOLKATA,3405,All
2015,11,KOLKATA,COIMBATORE,2150,2394,COIMBATORE-KOLKATA,4544,All
2015,12,KOLKATA,COIMBATORE,2661,3001,COIMBATORE-KOLKATA,5662,All
2016,1,KOLKATA,COIMBATORE,2507,2378,COIMBATORE-KOLKATA,4885,All
2016,2,KOLKATA,COIMBATORE,1467,1586,COIMBATORE-KOLKATA,3053,All
2016,3,KOLKATA,COIMBATORE,1373,1566,COIMBATORE-KOLKATA,2939,All
2016,4,KOLKATA,COIMBATORE,1240,1479,COIMBATORE-KOLKATA,2719,All
2016,5,KOLKATA,COIMBATORE,1333,1412,COIMBATORE-KOLKATA,2745,All
2016,6,KOLKATA,COIMBATORE,1093,1349,COIMBATORE-KOLKATA,2442,All
2016,7,KOLKATA,COIMBATORE,1039,1092,COIMBATORE-KOLKATA,2131,All
2016,8,KOLKATA,COIMBATORE,754,1028,COIMBATORE-KOLKATA,1782,All
2016,9,KOLKATA,COIMBATORE,518,643,COIMBATORE-KOLKATA,1161,All
2016,10,KOLKATA,COIMBATORE,565,650,COIMBATORE-KOLKATA,1215,All
2016,11,KOLKATA,COIMBATORE,899,1142,COIMBATORE-KOLKATA,2041,All
2016,12,KOLKATA,COIMBATORE,1005,1115,COIMBATORE-KOLKATA,2120,All
2017,1,KOLKATA,COIMBATORE,1346,1155,COIMBATORE-KOLKATA,2501,All
2017,2,KOLKATA,COIMBATORE,995,1111,COIMBATORE-KOLKATA,2106,All
2017,3,KOLKATA,COIMBATORE,856,1079,COIMBATORE-KOLKATA,1935,All
2017,4,KOLKATA,COIMBATORE,825,1160,COIMBATORE-KOLKATA,1985,All
2017,5,KOLKATA,COIMBATORE,1047,1298,COIMBATORE-KOLKATA,2345,All
2017,6,KOLKATA,COIMBATORE,741,1170,COIMBATORE-KOLKATA,1911,All
2017,7,KOLKATA,COIMBATORE,834,1112,COIMBATORE-KOLKATA,1946,All
2017,8,KOLKATA,COIMBATORE,428,682,COIMBATORE-KOLKATA,1110,All
2017,9,KOLKATA,COIMBATORE,808,802,COIMBATORE-KOLKATA,1610,All
2017,10,KOLKATA,COIMBATORE,912,859,COIMBATORE-KOLKATA,1771,All
2017,11,KOLKATA,COIMBATORE,751,1335,COIMBATORE-KOLKATA,2086,All
2017,12,KOLKATA,COIMBATORE,1007,1152,COIMBATORE-KOLKATA,2159,All
2018,1,KOLKATA,COIMBATORE,755,801,COIMBATORE-KOLKATA,1556,All
2018,2,KOLKATA,COIMBATORE,691,931,COIMBATORE-KOLKATA,1622,All
2018,3,KOLKATA,COIMBATORE,439,883,COIMBATORE-KOLKATA,1322,All
2018,4,KOLKATA,COIMBATORE,525,1028,COIMBATORE-KOLKATA,1553,All
2018,5,KOLKATA,COIMBATORE,725,1004,COIMBATORE-KOLKATA,1729,All
2018,6,KOLKATA,COIMBATORE,521,971,COIMBATORE-KOLKATA,1492,All
2018,7,KOLKATA,COIMBATORE,436,569,COIMBATORE-KOLKATA,1005,All
2018,8,KOLKATA,COIMBATORE,481,738,COIMBATORE-KOLKATA,1219,All
2018,9,KOLKATA,COIMBATORE,650,838,COIMBATORE-KOLKATA,1488,All
2018,10,KOLKATA,COIMBATORE,629,1295,COIMBATORE-KOLKATA,1924,All
2018,11,KOLKATA,COIMBATORE,955,1878,COIMBATORE-KOLKATA,2833,All
2018,12,KOLKATA,COIMBATORE,768,1868,COIMBATORE-KOLKATA,2636,All
2019,1,KOLKATA,COIMBATORE,1604,2376,COIMBATORE-KOLKATA,3980,All
2019,2,KOLKATA,COIMBATORE,1427,2033,COIMBATORE-KOLKATA,3460,All
2019,3,KOLKATA,COIMBATORE,911,1624,COIMBATORE-KOLKATA,2535,All
2019,4,KOLKATA,COIMBATORE,750,1765,COIMBATORE-KOLKATA,2515,All
2019,1,KOLKATA,DABOLIM,8432,9879,DABOLIM-KOLKATA,18311,All
2019,2,KOLKATA,DABOLIM,8473,8915,DABOLIM-KOLKATA,17388,All
2019,3,KOLKATA,DABOLIM,5149,6318,DABOLIM-KOLKATA,11467,All
2019,4,KOLKATA,DABOLIM,4339,5541,DABOLIM-KOLKATA,9880,All
2018,3,KOLKATA,DEHRA DUN,0,4,DEHRA DUN-KOLKATA,4,All
2018,4,KOLKATA,DEHRA DUN,0,32,DEHRA DUN-KOLKATA,32,All
2018,5,KOLKATA,DEHRA DUN,0,233,DEHRA DUN-KOLKATA,233,All
2018,6,KOLKATA,DEHRA DUN,0,56,DEHRA DUN-KOLKATA,56,All
2018,7,KOLKATA,DEHRA DUN,0,40,DEHRA DUN-KOLKATA,40,All
2018,8,KOLKATA,DEHRA DUN,0,68,DEHRA DUN-KOLKATA,68,All
2018,9,KOLKATA,DEHRA DUN,0,81,DEHRA DUN-KOLKATA,81,All
2018,10,KOLKATA,DEHRA DUN,261,66,DEHRA DUN-KOLKATA,327,All
2018,11,KOLKATA,DEHRA DUN,0,45,DEHRA DUN-KOLKATA,45,All
2018,12,KOLKATA,DEHRA DUN,0,227,DEHRA DUN-KOLKATA,227,All
2019,1,KOLKATA,DEHRA DUN,0,319,DEHRA DUN-KOLKATA,319,All
2019,2,KOLKATA,DEHRA DUN,688,810,DEHRA DUN-KOLKATA,1498,All
2019,3,KOLKATA,DEHRA DUN,1414,1513,DEHRA DUN-KOLKATA,2927,All
2019,4,KOLKATA,DEHRA DUN,423,541,DEHRA DUN-KOLKATA,964,All
2015,4,KOLKATA,DELHI,71017,77153,DELHI-KOLKATA,148170,All
2015,5,KOLKATA,DELHI,80094,88056,DELHI-KOLKATA,168150,All
2015,6,KOLKATA,DELHI,79220,82389,DELHI-KOLKATA,161609,All
2015,7,KOLKATA,DELHI,76012,78585,DELHI-KOLKATA,154597,All
2015,8,KOLKATA,DELHI,73180,74669,DELHI-KOLKATA,147849,All
2015,9,KOLKATA,DELHI,71112,76785,DELHI-KOLKATA,147897,All
2015,10,KOLKATA,DELHI,65290,70016,DELHI-KOLKATA,135306,All
2015,11,KOLKATA,DELHI,85679,97634,DELHI-KOLKATA,183313,All
2015,12,KOLKATA,DELHI,91133,99971,DELHI-KOLKATA,191104,All
2016,1,KOLKATA,DELHI,91399,93021,DELHI-KOLKATA,184420,All
2016,2,KOLKATA,DELHI,87778,89409,DELHI-KOLKATA,177187,All
2016,3,KOLKATA,DELHI,99803,105622,DELHI-KOLKATA,205425,All
2016,4,KOLKATA,DELHI,90735,102325,DELHI-KOLKATA,193060,All
2016,5,KOLKATA,DELHI,97003,103524,DELHI-KOLKATA,200527,All
2016,6,KOLKATA,DELHI,95127,111451,DELHI-KOLKATA,206578,All
2016,7,KOLKATA,DELHI,118269,122390,DELHI-KOLKATA,240659,All
2016,8,KOLKATA,DELHI,114357,118783,DELHI-KOLKATA,233140,All
2016,9,KOLKATA,DELHI,114124,124022,DELHI-KOLKATA,238146,All
2016,10,KOLKATA,DELHI,120433,133492,DELHI-KOLKATA,253925,All
2016,11,KOLKATA,DELHI,119637,124011,DELHI-KOLKATA,243648,All
2016,12,KOLKATA,DELHI,127961,143613,DELHI-KOLKATA,271574,All
2017,1,KOLKATA,DELHI,135884,134211,DELHI-KOLKATA,270095,All
2017,2,KOLKATA,DELHI,119065,117494,DELHI-KOLKATA,236559,All
2017,3,KOLKATA,DELHI,123426,126247,DELHI-KOLKATA,249673,All
2017,4,KOLKATA,DELHI,113283,124007,DELHI-KOLKATA,237290,All
2017,5,KOLKATA,DELHI,116897,129792,DELHI-KOLKATA,246689,All
2017,6,KOLKATA,DELHI,112275,128197,DELHI-KOLKATA,240472,All
2017,7,KOLKATA,DELHI,116036,115376,DELHI-KOLKATA,231412,All
2017,8,KOLKATA,DELHI,113990,122065,DELHI-KOLKATA,236055,All
2017,9,KOLKATA,DELHI,120931,124480,DELHI-KOLKATA,245411,All
2017,10,KOLKATA,DELHI,134175,145770,DELHI-KOLKATA,279945,All
2017,11,KOLKATA,DELHI,124717,128184,DELHI-KOLKATA,252901,All
2017,12,KOLKATA,DELHI,133812,142643,DELHI-KOLKATA,276455,All
2018,1,KOLKATA,DELHI,135636,137355,DELHI-KOLKATA,272991,All
2018,2,KOLKATA,DELHI,129491,131739,DELHI-KOLKATA,261230,All
2018,3,KOLKATA,DELHI,142706,144300,DELHI-KOLKATA,287006,All
2018,4,KOLKATA,DELHI,137910,143576,DELHI-KOLKATA,281486,All
2018,5,KOLKATA,DELHI,134751,138020,DELHI-KOLKATA,272771,All
2018,6,KOLKATA,DELHI,130280,145374,DELHI-KOLKATA,275654,All
2018,7,KOLKATA,DELHI,138771,147254,DELHI-KOLKATA,286025,All
2018,8,KOLKATA,DELHI,132969,138672,DELHI-KOLKATA,271641,All
2018,9,KOLKATA,DELHI,129957,133951,DELHI-KOLKATA,263908,All
2018,10,KOLKATA,DELHI,146394,149868,DELHI-KOLKATA,296262,All
2018,11,KOLKATA,DELHI,130647,140978,DELHI-KOLKATA,271625,All
2018,12,KOLKATA,DELHI,136829,144971,DELHI-KOLKATA,281800,All
2019,1,KOLKATA,DELHI,140428,140327,DELHI-KOLKATA,280755,All
2019,2,KOLKATA,DELHI,126656,124902,DELHI-KOLKATA,251558,All
2019,3,KOLKATA,DELHI,135190,137562,DELHI-KOLKATA,272752,All
2019,4,KOLKATA,DELHI,117100,125502,DELHI-KOLKATA,242602,All
2015,4,KOLKATA,DIBRUGARH,6151,6396,DIBRUGARH-KOLKATA,12547,All
2015,5,KOLKATA,DIBRUGARH,7657,6733,DIBRUGARH-KOLKATA,14390,All
2015,6,KOLKATA,DIBRUGARH,6311,6529,DIBRUGARH-KOLKATA,12840,All
2015,7,KOLKATA,DIBRUGARH,6749,6441,DIBRUGARH-KOLKATA,13190,All
2015,8,KOLKATA,DIBRUGARH,5563,5773,DIBRUGARH-KOLKATA,11336,All
2015,9,KOLKATA,DIBRUGARH,5681,5297,DIBRUGARH-KOLKATA,10978,All
2015,10,KOLKATA,DIBRUGARH,14226,7263,DIBRUGARH-KOLKATA,21489,All
2015,11,KOLKATA,DIBRUGARH,6137,6031,DIBRUGARH-KOLKATA,12168,All
2015,12,KOLKATA,DIBRUGARH,6793,6781,DIBRUGARH-KOLKATA,13574,All
2016,1,KOLKATA,DIBRUGARH,6454,6458,DIBRUGARH-KOLKATA,12912,All
2016,2,KOLKATA,DIBRUGARH,5927,5757,DIBRUGARH-KOLKATA,11684,All
2016,3,KOLKATA,DIBRUGARH,6599,5976,DIBRUGARH-KOLKATA,12575,All
2016,4,KOLKATA,DIBRUGARH,6280,5907,DIBRUGARH-KOLKATA,12187,All
2016,5,KOLKATA,DIBRUGARH,7311,6598,DIBRUGARH-KOLKATA,13909,All
2016,6,KOLKATA,DIBRUGARH,7023,6824,DIBRUGARH-KOLKATA,13847,All
2016,7,KOLKATA,DIBRUGARH,7588,7658,DIBRUGARH-KOLKATA,15246,All
2016,8,KOLKATA,DIBRUGARH,7325,6965,DIBRUGARH-KOLKATA,14290,All
2016,9,KOLKATA,DIBRUGARH,6569,6253,DIBRUGARH-KOLKATA,12822,All
2016,10,KOLKATA,DIBRUGARH,7522,7306,DIBRUGARH-KOLKATA,14828,All
2016,11,KOLKATA,DIBRUGARH,6941,6984,DIBRUGARH-KOLKATA,13925,All
2016,12,KOLKATA,DIBRUGARH,7515,7715,DIBRUGARH-KOLKATA,15230,All
2017,1,KOLKATA,DIBRUGARH,7490,8109,DIBRUGARH-KOLKATA,15599,All
2017,2,KOLKATA,DIBRUGARH,6595,6343,DIBRUGARH-KOLKATA,12938,All
2017,3,KOLKATA,DIBRUGARH,6935,6656,DIBRUGARH-KOLKATA,13591,All
2017,4,KOLKATA,DIBRUGARH,7229,6952,DIBRUGARH-KOLKATA,14181,All
2017,5,KOLKATA,DIBRUGARH,7747,7110,DIBRUGARH-KOLKATA,14857,All
2017,6,KOLKATA,DIBRUGARH,7577,7906,DIBRUGARH-KOLKATA,15483,All
2017,7,KOLKATA,DIBRUGARH,8494,8540,DIBRUGARH-KOLKATA,17034,All
2017,8,KOLKATA,DIBRUGARH,8356,8034,DIBRUGARH-KOLKATA,16390,All
2017,9,KOLKATA,DIBRUGARH,7772,7175,DIBRUGARH-KOLKATA,14947,All
2017,10,KOLKATA,DIBRUGARH,6980,6962,DIBRUGARH-KOLKATA,13942,All
2017,11,KOLKATA,DIBRUGARH,6983,6951,DIBRUGARH-KOLKATA,13934,All
2017,12,KOLKATA,DIBRUGARH,7364,7239,DIBRUGARH-KOLKATA,14603,All
2018,1,KOLKATA,DIBRUGARH,7661,7540,DIBRUGARH-KOLKATA,15201,All
2018,2,KOLKATA,DIBRUGARH,6847,6547,DIBRUGARH-KOLKATA,13394,All
2018,3,KOLKATA,DIBRUGARH,7560,7006,DIBRUGARH-KOLKATA,14566,All
2018,4,KOLKATA,DIBRUGARH,7201,7069,DIBRUGARH-KOLKATA,14270,All
2018,5,KOLKATA,DIBRUGARH,7574,7096,DIBRUGARH-KOLKATA,14670,All
2018,6,KOLKATA,DIBRUGARH,7076,7001,DIBRUGARH-KOLKATA,14077,All
2018,7,KOLKATA,DIBRUGARH,7502,7476,DIBRUGARH-KOLKATA,14978,All
2018,8,KOLKATA,DIBRUGARH,7506,7030,DIBRUGARH-KOLKATA,14536,All
2018,9,KOLKATA,DIBRUGARH,9236,8613,DIBRUGARH-KOLKATA,17849,All
2018,10,KOLKATA,DIBRUGARH,8616,8075,DIBRUGARH-KOLKATA,16691,All
2018,11,KOLKATA,DIBRUGARH,8446,7748,DIBRUGARH-KOLKATA,16194,All
2018,12,KOLKATA,DIBRUGARH,9365,8330,DIBRUGARH-KOLKATA,17695,All
2019,1,KOLKATA,DIBRUGARH,9275,8787,DIBRUGARH-KOLKATA,18062,All
2019,2,KOLKATA,DIBRUGARH,8733,8338,DIBRUGARH-KOLKATA,17071,All
2019,3,KOLKATA,DIBRUGARH,9129,8796,DIBRUGARH-KOLKATA,17925,All
2019,4,KOLKATA,DIBRUGARH,8893,8042,DIBRUGARH-KOLKATA,16935,All
2015,4,KOLKATA,DIMAPUR,2363,2463,DIMAPUR-KOLKATA,4826,All
2015,5,KOLKATA,DIMAPUR,3214,2648,DIMAPUR-KOLKATA,5862,All
2015,6,KOLKATA,DIMAPUR,2812,3271,DIMAPUR-KOLKATA,6083,All
2015,7,KOLKATA,DIMAPUR,2851,3160,DIMAPUR-KOLKATA,6011,All
2015,8,KOLKATA,DIMAPUR,2333,2546,DIMAPUR-KOLKATA,4879,All
2015,9,KOLKATA,DIMAPUR,2588,2415,DIMAPUR-KOLKATA,5003,All
2015,10,KOLKATA,DIMAPUR,4849,2834,DIMAPUR-KOLKATA,7683,All
2015,11,KOLKATA,DIMAPUR,3355,3371,DIMAPUR-KOLKATA,6726,All
2015,12,KOLKATA,DIMAPUR,4250,4306,DIMAPUR-KOLKATA,8556,All
2016,1,KOLKATA,DIMAPUR,3455,4032,DIMAPUR-KOLKATA,7487,All
2016,2,KOLKATA,DIMAPUR,2938,3096,DIMAPUR-KOLKATA,6034,All
2016,3,KOLKATA,DIMAPUR,3565,3720,DIMAPUR-KOLKATA,7285,All
2016,4,KOLKATA,DIMAPUR,3561,3415,DIMAPUR-KOLKATA,6976,All
2016,5,KOLKATA,DIMAPUR,4392,4118,DIMAPUR-KOLKATA,8510,All
2016,6,KOLKATA,DIMAPUR,4225,4982,DIMAPUR-KOLKATA,9207,All
2016,7,KOLKATA,DIMAPUR,4705,5297,DIMAPUR-KOLKATA,10002,All
2016,8,KOLKATA,DIMAPUR,4255,4568,DIMAPUR-KOLKATA,8823,All
2016,9,KOLKATA,DIMAPUR,4449,4355,DIMAPUR-KOLKATA,8804,All
2016,10,KOLKATA,DIMAPUR,5274,5081,DIMAPUR-KOLKATA,10355,All
2016,11,KOLKATA,DIMAPUR,5693,5327,DIMAPUR-KOLKATA,11020,All
2016,12,KOLKATA,DIMAPUR,7259,6846,DIMAPUR-KOLKATA,14105,All
2017,1,KOLKATA,DIMAPUR,5993,7157,DIMAPUR-KOLKATA,13150,All
2017,2,KOLKATA,DIMAPUR,4360,4432,DIMAPUR-KOLKATA,8792,All
2017,3,KOLKATA,DIMAPUR,5410,5540,DIMAPUR-KOLKATA,10950,All
2017,4,KOLKATA,DIMAPUR,6284,6010,DIMAPUR-KOLKATA,12294,All
2017,5,KOLKATA,DIMAPUR,6858,5888,DIMAPUR-KOLKATA,12746,All
2017,6,KOLKATA,DIMAPUR,6134,6942,DIMAPUR-KOLKATA,13076,All
2017,7,KOLKATA,DIMAPUR,6307,7705,DIMAPUR-KOLKATA,14012,All
2017,8,KOLKATA,DIMAPUR,6229,7996,DIMAPUR-KOLKATA,14225,All
2017,9,KOLKATA,DIMAPUR,6379,7636,DIMAPUR-KOLKATA,14015,All
2017,10,KOLKATA,DIMAPUR,6074,6248,DIMAPUR-KOLKATA,12322,All
2017,11,KOLKATA,DIMAPUR,6161,5639,DIMAPUR-KOLKATA,11800,All
2017,12,KOLKATA,DIMAPUR,7121,6928,DIMAPUR-KOLKATA,14049,All
2018,1,KOLKATA,DIMAPUR,6337,7300,DIMAPUR-KOLKATA,13637,All
2018,2,KOLKATA,DIMAPUR,5866,5686,DIMAPUR-KOLKATA,11552,All
2018,3,KOLKATA,DIMAPUR,6616,6851,DIMAPUR-KOLKATA,13467,All
2018,4,KOLKATA,DIMAPUR,7199,7211,DIMAPUR-KOLKATA,14410,All
2018,5,KOLKATA,DIMAPUR,7283,6717,DIMAPUR-KOLKATA,14000,All
2018,6,KOLKATA,DIMAPUR,6181,6702,DIMAPUR-KOLKATA,12883,All
2018,7,KOLKATA,DIMAPUR,6966,6818,DIMAPUR-KOLKATA,13784,All
2018,8,KOLKATA,DIMAPUR,6023,6238,DIMAPUR-KOLKATA,12261,All
2018,9,KOLKATA,DIMAPUR,6001,5938,DIMAPUR-KOLKATA,11939,All
2018,10,KOLKATA,DIMAPUR,6591,6251,DIMAPUR-KOLKATA,12842,All
2018,11,KOLKATA,DIMAPUR,5897,5938,DIMAPUR-KOLKATA,11835,All
2018,12,KOLKATA,DIMAPUR,7113,6245,DIMAPUR-KOLKATA,13358,All
2019,1,KOLKATA,DIMAPUR,6261,6748,DIMAPUR-KOLKATA,13009,All
2019,2,KOLKATA,DIMAPUR,4973,5231,DIMAPUR-KOLKATA,10204,All
2019,3,KOLKATA,DIMAPUR,5703,5601,DIMAPUR-KOLKATA,11304,All
2019,4,KOLKATA,DIMAPUR,5843,5078,DIMAPUR-KOLKATA,10921,All
2015,5,KOLKATA,DURGAPUR,84,76,DURGAPUR-KOLKATA,160,All
2015,6,KOLKATA,DURGAPUR,96,182,DURGAPUR-KOLKATA,278,All
2015,7,KOLKATA,DURGAPUR,123,288,DURGAPUR-KOLKATA,411,All
2015,8,KOLKATA,DURGAPUR,86,135,DURGAPUR-KOLKATA,221,All
2015,9,KOLKATA,DURGAPUR,176,239,DURGAPUR-KOLKATA,415,All
2015,10,KOLKATA,DURGAPUR,183,332,DURGAPUR-KOLKATA,515,All
2015,11,KOLKATA,DURGAPUR,154,362,DURGAPUR-KOLKATA,516,All
2015,12,KOLKATA,DURGAPUR,152,165,DURGAPUR-KOLKATA,317,All
2016,1,KOLKATA,DURGAPUR,27,118,DURGAPUR-KOLKATA,145,All
2016,2,KOLKATA,DURGAPUR,77,122,DURGAPUR-KOLKATA,199,All
2016,3,KOLKATA,DURGAPUR,173,266,DURGAPUR-KOLKATA,439,All
2016,4,KOLKATA,DURGAPUR,34,92,DURGAPUR-KOLKATA,126,All
2016,5,KOLKATA,DURGAPUR,20,65,DURGAPUR-KOLKATA,85,All
2016,6,KOLKATA,DURGAPUR,12,40,DURGAPUR-KOLKATA,52,All
2017,3,KOLKATA,DURGAPUR,85,14,DURGAPUR-KOLKATA,99,All
2017,4,KOLKATA,DURGAPUR,74,114,DURGAPUR-KOLKATA,188,All
2017,5,KOLKATA,DURGAPUR,39,85,DURGAPUR-KOLKATA,124,All
2017,6,KOLKATA,DURGAPUR,53,62,DURGAPUR-KOLKATA,115,All
2017,7,KOLKATA,DURGAPUR,17,47,DURGAPUR-KOLKATA,64,All
2018,10,KOLKATA,GANGTOK,1331,1213,GANGTOK-KOLKATA,2544,All
2018,11,KOLKATA,GANGTOK,1152,1094,GANGTOK-KOLKATA,2246,All
2018,12,KOLKATA,GANGTOK,1432,1257,GANGTOK-KOLKATA,2689,All
2015,4,KOLKATA,GAYA,213,447,GAYA-KOLKATA,660,All
2015,9,KOLKATA,GAYA,0,1,GAYA-KOLKATA,1,All
2015,10,KOLKATA,GAYA,489,23609,GAYA-KOLKATA,24098,All
2015,11,KOLKATA,GAYA,248,738,GAYA-KOLKATA,986,All
2015,12,KOLKATA,GAYA,242,800,GAYA-KOLKATA,1042,All
2016,1,KOLKATA,GAYA,337,998,GAYA-KOLKATA,1335,All
2016,2,KOLKATA,GAYA,432,1130,GAYA-KOLKATA,1562,All
2016,3,KOLKATA,GAYA,475,890,GAYA-KOLKATA,1365,All
2016,4,KOLKATA,GAYA,475,569,GAYA-KOLKATA,1044,All
2016,9,KOLKATA,GAYA,50,86,GAYA-KOLKATA,136,All
2016,10,KOLKATA,GAYA,441,713,GAYA-KOLKATA,1154,All
2016,11,KOLKATA,GAYA,232,277,GAYA-KOLKATA,509,All
2016,12,KOLKATA,GAYA,477,1086,GAYA-KOLKATA,1563,All
2017,1,KOLKATA,GAYA,337,966,GAYA-KOLKATA,1303,All
2017,2,KOLKATA,GAYA,481,806,GAYA-KOLKATA,1287,All
2017,3,KOLKATA,GAYA,396,838,GAYA-KOLKATA,1234,All
2017,4,KOLKATA,GAYA,218,746,GAYA-KOLKATA,964,All
2017,5,KOLKATA,GAYA,162,232,GAYA-KOLKATA,394,All
2017,9,KOLKATA,GAYA,92,244,GAYA-KOLKATA,336,All
2017,10,KOLKATA,GAYA,257,621,GAYA-KOLKATA,878,All
2017,11,KOLKATA,GAYA,373,547,GAYA-KOLKATA,920,All
2017,12,KOLKATA,GAYA,457,637,GAYA-KOLKATA,1094,All
2018,1,KOLKATA,GAYA,331,829,GAYA-KOLKATA,1160,All
2018,2,KOLKATA,GAYA,389,725,GAYA-KOLKATA,1114,All
2018,3,KOLKATA,GAYA,452,914,GAYA-KOLKATA,1366,All
2018,4,KOLKATA,GAYA,272,553,GAYA-KOLKATA,825,All
2018,5,KOLKATA,GAYA,48,82,GAYA-KOLKATA,130,All
2018,9,KOLKATA,GAYA,202,72,GAYA-KOLKATA,274,All
2018,10,KOLKATA,GAYA,267,468,GAYA-KOLKATA,735,All
2018,11,KOLKATA,GAYA,397,682,GAYA-KOLKATA,1079,All
2018,12,KOLKATA,GAYA,371,860,GAYA-KOLKATA,1231,All
2019,1,KOLKATA,GAYA,332,824,GAYA-KOLKATA,1156,All
2019,2,KOLKATA,GAYA,212,711,GAYA-KOLKATA,923,All
2019,3,KOLKATA,GAYA,345,971,GAYA-KOLKATA,1316,All
2019,4,KOLKATA,GAYA,283,787,GAYA-KOLKATA,1070,All
2015,4,KOLKATA,GOA,2835,2973,GOA-KOLKATA,5808,All
2015,5,KOLKATA,GOA,2385,1865,GOA-KOLKATA,4250,All
2015,6,KOLKATA,GOA,3017,2601,GOA-KOLKATA,5618,All
2015,7,KOLKATA,GOA,3791,3701,GOA-KOLKATA,7492,All
2015,8,KOLKATA,GOA,3585,3399,GOA-KOLKATA,6984,All
2015,9,KOLKATA,GOA,3481,3517,GOA-KOLKATA,6998,All
2015,10,KOLKATA,GOA,4991,5202,GOA-KOLKATA,10193,All
2015,11,KOLKATA,GOA,3890,4415,GOA-KOLKATA,8305,All
2015,12,KOLKATA,GOA,6202,5278,GOA-KOLKATA,11480,All
2016,1,KOLKATA,GOA,5248,5470,GOA-KOLKATA,10718,All
2016,2,KOLKATA,GOA,4023,3905,GOA-KOLKATA,7928,All
2016,3,KOLKATA,GOA,4173,4747,GOA-KOLKATA,8920,All
2016,4,KOLKATA,GOA,3912,4324,GOA-KOLKATA,8236,All
2016,5,KOLKATA,GOA,4236,4147,GOA-KOLKATA,8383,All
2016,6,KOLKATA,GOA,3934,4293,GOA-KOLKATA,8227,All
2016,7,KOLKATA,GOA,4475,4515,GOA-KOLKATA,8990,All
2016,8,KOLKATA,GOA,3325,3515,GOA-KOLKATA,6840,All
2016,9,KOLKATA,GOA,3545,3856,GOA-KOLKATA,7401,All
2016,10,KOLKATA,GOA,4852,5595,GOA-KOLKATA,10447,All
2016,11,KOLKATA,GOA,4122,4023,GOA-KOLKATA,8145,All
2016,12,KOLKATA,GOA,4912,5333,GOA-KOLKATA,10245,All
2017,1,KOLKATA,GOA,4669,5526,GOA-KOLKATA,10195,All
2017,2,KOLKATA,GOA,3785,3942,GOA-KOLKATA,7727,All
2017,3,KOLKATA,GOA,3824,3555,GOA-KOLKATA,7379,All
2017,4,KOLKATA,GOA,4262,5280,GOA-KOLKATA,9542,All
2017,5,KOLKATA,GOA,4711,5062,GOA-KOLKATA,9773,All
2017,6,KOLKATA,GOA,4038,3704,GOA-KOLKATA,7742,All
2017,7,KOLKATA,GOA,4572,4381,GOA-KOLKATA,8953,All
2017,8,KOLKATA,GOA,4396,4428,GOA-KOLKATA,8824,All
2017,9,KOLKATA,GOA,4890,4195,GOA-KOLKATA,9085,All
2017,10,KOLKATA,GOA,4312,5226,GOA-KOLKATA,9538,All
2017,11,KOLKATA,GOA,4305,5029,GOA-KOLKATA,9334,All
2017,12,KOLKATA,GOA,4586,5323,GOA-KOLKATA,9909,All
2018,1,KOLKATA,GOA,4666,5872,GOA-KOLKATA,10538,All
2018,2,KOLKATA,GOA,3993,4832,GOA-KOLKATA,8825,All
2018,3,KOLKATA,GOA,4538,5252,GOA-KOLKATA,9790,All
2018,4,KOLKATA,GOA,4259,5449,GOA-KOLKATA,9708,All
2018,5,KOLKATA,GOA,4293,4828,GOA-KOLKATA,9121,All
2018,6,KOLKATA,GOA,3894,4902,GOA-KOLKATA,8796,All
2018,7,KOLKATA,GOA,4287,4697,GOA-KOLKATA,8984,All
2018,8,KOLKATA,GOA,3827,4793,GOA-KOLKATA,8620,All
2018,9,KOLKATA,GOA,3904,4280,GOA-KOLKATA,8184,All
2018,10,KOLKATA,GOA,4326,5964,GOA-KOLKATA,10290,All
2018,11,KOLKATA,GOA,4941,5022,GOA-KOLKATA,9963,All
2018,12,KOLKATA,GOA,7506,6888,GOA-KOLKATA,14394,All
2016,10,KOLKATA,GORAKHPUR,1876,1772,GORAKHPUR-KOLKATA,3648,All
2016,11,KOLKATA,GORAKHPUR,1486,1638,GORAKHPUR-KOLKATA,3124,All
2017,2,KOLKATA,GORAKHPUR,1179,1096,GORAKHPUR-KOLKATA,2275,All
2017,3,KOLKATA,GORAKHPUR,1860,1926,GORAKHPUR-KOLKATA,3786,All
2017,4,KOLKATA,GORAKHPUR,2167,1909,GORAKHPUR-KOLKATA,4076,All
2017,5,KOLKATA,GORAKHPUR,2320,2127,GORAKHPUR-KOLKATA,4447,All
2017,6,KOLKATA,GORAKHPUR,2026,1925,GORAKHPUR-KOLKATA,3951,All
2017,7,KOLKATA,GORAKHPUR,1836,1849,GORAKHPUR-KOLKATA,3685,All
2017,8,KOLKATA,GORAKHPUR,1793,1956,GORAKHPUR-KOLKATA,3749,All
2017,9,KOLKATA,GORAKHPUR,1989,1994,GORAKHPUR-KOLKATA,3983,All
2017,10,KOLKATA,GORAKHPUR,150,143,GORAKHPUR-KOLKATA,293,All
2019,4,KOLKATA,GORAKHPUR,145,159,GORAKHPUR-KOLKATA,304,All
2015,4,KOLKATA,GUWAHATI,34788,35316,GUWAHATI-KOLKATA,70104,All
2015,5,KOLKATA,GUWAHATI,33851,32291,GUWAHATI-KOLKATA,66142,All
2015,6,KOLKATA,GUWAHATI,31831,34754,GUWAHATI-KOLKATA,66585,All
2015,7,KOLKATA,GUWAHATI,36278,37251,GUWAHATI-KOLKATA,73529,All
2015,8,KOLKATA,GUWAHATI,31855,31786,GUWAHATI-KOLKATA,63641,All
2015,9,KOLKATA,GUWAHATI,32637,32507,GUWAHATI-KOLKATA,65144,All
2015,10,KOLKATA,GUWAHATI,36710,34183,GUWAHATI-KOLKATA,70893,All
2015,11,KOLKATA,GUWAHATI,32175,33505,GUWAHATI-KOLKATA,65680,All
2015,12,KOLKATA,GUWAHATI,36852,36801,GUWAHATI-KOLKATA,73653,All
2016,1,KOLKATA,GUWAHATI,36071,36742,GUWAHATI-KOLKATA,72813,All
2016,2,KOLKATA,GUWAHATI,34990,33343,GUWAHATI-KOLKATA,68333,All
2016,3,KOLKATA,GUWAHATI,39602,37497,GUWAHATI-KOLKATA,77099,All
2016,4,KOLKATA,GUWAHATI,37786,36040,GUWAHATI-KOLKATA,73826,All
2016,5,KOLKATA,GUWAHATI,42759,38435,GUWAHATI-KOLKATA,81194,All
2016,6,KOLKATA,GUWAHATI,37612,40730,GUWAHATI-KOLKATA,78342,All
2016,7,KOLKATA,GUWAHATI,41431,41256,GUWAHATI-KOLKATA,82687,All
2016,8,KOLKATA,GUWAHATI,37348,36780,GUWAHATI-KOLKATA,74128,All
2016,9,KOLKATA,GUWAHATI,40767,39256,GUWAHATI-KOLKATA,80023,All
2016,10,KOLKATA,GUWAHATI,46581,47099,GUWAHATI-KOLKATA,93680,All
2016,11,KOLKATA,GUWAHATI,44375,45656,GUWAHATI-KOLKATA,90031,All
2016,12,KOLKATA,GUWAHATI,52161,53686,GUWAHATI-KOLKATA,105847,All
2017,1,KOLKATA,GUWAHATI,50881,51162,GUWAHATI-KOLKATA,102043,All
2017,2,KOLKATA,GUWAHATI,44700,43462,GUWAHATI-KOLKATA,88162,All
2017,3,KOLKATA,GUWAHATI,52389,51810,GUWAHATI-KOLKATA,104199,All
2017,4,KOLKATA,GUWAHATI,57300,54154,GUWAHATI-KOLKATA,111454,All
2017,5,KOLKATA,GUWAHATI,62345,57312,GUWAHATI-KOLKATA,119657,All
2017,6,KOLKATA,GUWAHATI,54519,58587,GUWAHATI-KOLKATA,113106,All
2017,7,KOLKATA,GUWAHATI,56517,57480,GUWAHATI-KOLKATA,113997,All
2017,8,KOLKATA,GUWAHATI,57539,56554,GUWAHATI-KOLKATA,114093,All
2017,9,KOLKATA,GUWAHATI,57541,54839,GUWAHATI-KOLKATA,112380,All
2017,10,KOLKATA,GUWAHATI,54498,55590,GUWAHATI-KOLKATA,110088,All
2017,11,KOLKATA,GUWAHATI,55304,54738,GUWAHATI-KOLKATA,110042,All
2017,12,KOLKATA,GUWAHATI,56797,59441,GUWAHATI-KOLKATA,116238,All
2018,1,KOLKATA,GUWAHATI,59591,62994,GUWAHATI-KOLKATA,122585,All
2018,2,KOLKATA,GUWAHATI,54442,55386,GUWAHATI-KOLKATA,109828,All
2018,3,KOLKATA,GUWAHATI,62347,61814,GUWAHATI-KOLKATA,124161,All
2018,4,KOLKATA,GUWAHATI,62052,60330,GUWAHATI-KOLKATA,122382,All
2018,5,KOLKATA,GUWAHATI,66840,62496,GUWAHATI-KOLKATA,129336,All
2018,6,KOLKATA,GUWAHATI,54369,58472,GUWAHATI-KOLKATA,112841,All
2018,7,KOLKATA,GUWAHATI,61492,59235,GUWAHATI-KOLKATA,120727,All
2018,8,KOLKATA,GUWAHATI,55072,53396,GUWAHATI-KOLKATA,108468,All
2018,9,KOLKATA,GUWAHATI,57007,54229,GUWAHATI-KOLKATA,111236,All
2018,10,KOLKATA,GUWAHATI,62920,58842,GUWAHATI-KOLKATA,121762,All
2018,11,KOLKATA,GUWAHATI,56191,55478,GUWAHATI-KOLKATA,111669,All
2018,12,KOLKATA,GUWAHATI,61799,58711,GUWAHATI-KOLKATA,120510,All
2019,1,KOLKATA,GUWAHATI,61387,62438,GUWAHATI-KOLKATA,123825,All
2019,2,KOLKATA,GUWAHATI,57220,55123,GUWAHATI-KOLKATA,112343,All
2019,3,KOLKATA,GUWAHATI,68796,67242,GUWAHATI-KOLKATA,136038,All
2019,4,KOLKATA,GUWAHATI,68727,65873,GUWAHATI-KOLKATA,134600,All
2025,3,KOLKATA,HINDON AIRPORT,5010,4291,HINDON AIRPORT-KOLKATA,9301,All
2015,4,KOLKATA,HYDERABAD,13831,15795,HYDERABAD-KOLKATA,29626,All
2015,5,KOLKATA,HYDERABAD,17067,16845,HYDERABAD-KOLKATA,33912,All
2015,6,KOLKATA,HYDERABAD,16012,14459,HYDERABAD-KOLKATA,30471,All
2015,7,KOLKATA,HYDERABAD,16614,16789,HYDERABAD-KOLKATA,33403,All
2015,8,KOLKATA,HYDERABAD,16276,16065,HYDERABAD-KOLKATA,32341,All
2015,9,KOLKATA,HYDERABAD,15367,16490,HYDERABAD-KOLKATA,31857,All
2015,10,KOLKATA,HYDERABAD,15970,16805,HYDERABAD-KOLKATA,32775,All
2015,11,KOLKATA,HYDERABAD,20145,21012,HYDERABAD-KOLKATA,41157,All
2015,12,KOLKATA,HYDERABAD,21930,22401,HYDERABAD-KOLKATA,44331,All
2016,1,KOLKATA,HYDERABAD,21213,21345,HYDERABAD-KOLKATA,42558,All
2016,2,KOLKATA,HYDERABAD,19330,19656,HYDERABAD-KOLKATA,38986,All
2016,3,KOLKATA,HYDERABAD,20079,20736,HYDERABAD-KOLKATA,40815,All
2016,4,KOLKATA,HYDERABAD,19669,21388,HYDERABAD-KOLKATA,41057,All
2016,5,KOLKATA,HYDERABAD,26443,24650,HYDERABAD-KOLKATA,51093,All
2016,6,KOLKATA,HYDERABAD,25019,22140,HYDERABAD-KOLKATA,47159,All
2016,7,KOLKATA,HYDERABAD,27232,25825,HYDERABAD-KOLKATA,53057,All
2016,8,KOLKATA,HYDERABAD,25297,24765,HYDERABAD-KOLKATA,50062,All
2016,9,KOLKATA,HYDERABAD,24875,28766,HYDERABAD-KOLKATA,53641,All
2016,10,KOLKATA,HYDERABAD,28427,31987,HYDERABAD-KOLKATA,60414,All
2016,11,KOLKATA,HYDERABAD,31676,27387,HYDERABAD-KOLKATA,59063,All
2016,12,KOLKATA,HYDERABAD,30809,31157,HYDERABAD-KOLKATA,61966,All
2017,1,KOLKATA,HYDERABAD,30602,31391,HYDERABAD-KOLKATA,61993,All
2017,2,KOLKATA,HYDERABAD,27300,28588,HYDERABAD-KOLKATA,55888,All
2017,3,KOLKATA,HYDERABAD,25198,28398,HYDERABAD-KOLKATA,53596,All
2017,4,KOLKATA,HYDERABAD,21966,27579,HYDERABAD-KOLKATA,49545,All
2017,5,KOLKATA,HYDERABAD,30288,29909,HYDERABAD-KOLKATA,60197,All
2017,6,KOLKATA,HYDERABAD,26311,26010,HYDERABAD-KOLKATA,52321,All
2017,7,KOLKATA,HYDERABAD,28033,25744,HYDERABAD-KOLKATA,53777,All
2017,8,KOLKATA,HYDERABAD,26582,28043,HYDERABAD-KOLKATA,54625,All
2017,9,KOLKATA,HYDERABAD,26682,31251,HYDERABAD-KOLKATA,57933,All
2017,10,KOLKATA,HYDERABAD,36858,38409,HYDERABAD-KOLKATA,75267,All
2017,11,KOLKATA,HYDERABAD,33879,34670,HYDERABAD-KOLKATA,68549,All
2017,12,KOLKATA,HYDERABAD,36890,37860,HYDERABAD-KOLKATA,74750,All
2018,1,KOLKATA,HYDERABAD,38454,39653,HYDERABAD-KOLKATA,78107,All
2018,2,KOLKATA,HYDERABAD,37185,38718,HYDERABAD-KOLKATA,75903,All
2018,3,KOLKATA,HYDERABAD,38837,38552,HYDERABAD-KOLKATA,77389,All
2018,4,KOLKATA,HYDERABAD,39006,44727,HYDERABAD-KOLKATA,83733,All
2018,5,KOLKATA,HYDERABAD,44343,42491,HYDERABAD-KOLKATA,86834,All
2018,6,KOLKATA,HYDERABAD,42701,43803,HYDERABAD-KOLKATA,86504,All
2018,7,KOLKATA,HYDERABAD,46688,44037,HYDERABAD-KOLKATA,90725,All
2018,8,KOLKATA,HYDERABAD,40333,43708,HYDERABAD-KOLKATA,84041,All
2018,9,KOLKATA,HYDERABAD,38410,42000,HYDERABAD-KOLKATA,80410,All
2018,10,KOLKATA,HYDERABAD,44372,52911,HYDERABAD-KOLKATA,97283,All
2018,11,KOLKATA,HYDERABAD,43448,48288,HYDERABAD-KOLKATA,91736,All
2018,12,KOLKATA,HYDERABAD,47923,46839,HYDERABAD-KOLKATA,94762,All
2019,1,KOLKATA,HYDERABAD,48510,51913,HYDERABAD-KOLKATA,100423,All
2019,2,KOLKATA,HYDERABAD,48468,50675,HYDERABAD-KOLKATA,99143,All
2019,3,KOLKATA,HYDERABAD,46110,48941,HYDERABAD-KOLKATA,95051,All
2019,4,KOLKATA,HYDERABAD,48644,58963,HYDERABAD-KOLKATA,107607,All
2015,4,KOLKATA,IMPHAL,7804,7771,IMPHAL-KOLKATA,15575,All
2015,5,KOLKATA,IMPHAL,9935,8971,IMPHAL-KOLKATA,18906,All
2015,6,KOLKATA,IMPHAL,8582,10497,IMPHAL-KOLKATA,19079,All
2015,7,KOLKATA,IMPHAL,7326,9091,IMPHAL-KOLKATA,16417,All
2015,8,KOLKATA,IMPHAL,5640,7911,IMPHAL-KOLKATA,13551,All
2015,9,KOLKATA,IMPHAL,6472,7097,IMPHAL-KOLKATA,13569,All
2015,10,KOLKATA,IMPHAL,6391,9812,IMPHAL-KOLKATA,16203,All
2015,11,KOLKATA,IMPHAL,7543,8617,IMPHAL-KOLKATA,16160,All
2015,12,KOLKATA,IMPHAL,9812,8920,IMPHAL-KOLKATA,18732,All
2016,1,KOLKATA,IMPHAL,7369,10160,IMPHAL-KOLKATA,17529,All
2016,2,KOLKATA,IMPHAL,7533,8538,IMPHAL-KOLKATA,16071,All
2016,3,KOLKATA,IMPHAL,9579,9344,IMPHAL-KOLKATA,18923,All
2016,4,KOLKATA,IMPHAL,8438,8609,IMPHAL-KOLKATA,17047,All
2016,5,KOLKATA,IMPHAL,9718,7751,IMPHAL-KOLKATA,17469,All
2016,6,KOLKATA,IMPHAL,9063,9806,IMPHAL-KOLKATA,18869,All
2016,7,KOLKATA,IMPHAL,8332,9222,IMPHAL-KOLKATA,17554,All
2016,8,KOLKATA,IMPHAL,7115,7864,IMPHAL-KOLKATA,14979,All
2016,9,KOLKATA,IMPHAL,8351,8564,IMPHAL-KOLKATA,16915,All
2016,10,KOLKATA,IMPHAL,12109,11479,IMPHAL-KOLKATA,23588,All
2016,11,KOLKATA,IMPHAL,10335,13372,IMPHAL-KOLKATA,23707,All
2016,12,KOLKATA,IMPHAL,15643,12600,IMPHAL-KOLKATA,28243,All
2017,1,KOLKATA,IMPHAL,12809,17009,IMPHAL-KOLKATA,29818,All
2017,2,KOLKATA,IMPHAL,11124,12454,IMPHAL-KOLKATA,23578,All
2017,3,KOLKATA,IMPHAL,13990,14388,IMPHAL-KOLKATA,28378,All
2017,4,KOLKATA,IMPHAL,13039,14061,IMPHAL-KOLKATA,27100,All
2017,5,KOLKATA,IMPHAL,15171,13169,IMPHAL-KOLKATA,28340,All
2017,6,KOLKATA,IMPHAL,13083,14843,IMPHAL-KOLKATA,27926,All
2017,7,KOLKATA,IMPHAL,11857,14308,IMPHAL-KOLKATA,26165,All
2017,8,KOLKATA,IMPHAL,12147,12680,IMPHAL-KOLKATA,24827,All
2017,9,KOLKATA,IMPHAL,13227,12531,IMPHAL-KOLKATA,25758,All
2017,10,KOLKATA,IMPHAL,12851,12934,IMPHAL-KOLKATA,25785,All
2017,11,KOLKATA,IMPHAL,10944,11691,IMPHAL-KOLKATA,22635,All
2017,12,KOLKATA,IMPHAL,16021,13056,IMPHAL-KOLKATA,29077,All
2018,1,KOLKATA,IMPHAL,13087,16019,IMPHAL-KOLKATA,29106,All
2018,2,KOLKATA,IMPHAL,11416,12995,IMPHAL-KOLKATA,24411,All
2018,3,KOLKATA,IMPHAL,14613,14019,IMPHAL-KOLKATA,28632,All
2018,4,KOLKATA,IMPHAL,12501,13022,IMPHAL-KOLKATA,25523,All
2018,5,KOLKATA,IMPHAL,16311,13863,IMPHAL-KOLKATA,30174,All
2018,6,KOLKATA,IMPHAL,10408,12848,IMPHAL-KOLKATA,23256,All
2018,7,KOLKATA,IMPHAL,13194,13307,IMPHAL-KOLKATA,26501,All
2018,8,KOLKATA,IMPHAL,12997,14685,IMPHAL-KOLKATA,27682,All
2018,9,KOLKATA,IMPHAL,14307,13906,IMPHAL-KOLKATA,28213,All
2018,10,KOLKATA,IMPHAL,12915,12895,IMPHAL-KOLKATA,25810,All
2018,11,KOLKATA,IMPHAL,11258,11082,IMPHAL-KOLKATA,22340,All
2018,12,KOLKATA,IMPHAL,13267,10695,IMPHAL-KOLKATA,23962,All
2019,1,KOLKATA,IMPHAL,10187,12620,IMPHAL-KOLKATA,22807,All
2019,2,KOLKATA,IMPHAL,8823,10425,IMPHAL-KOLKATA,19248,All
2019,3,KOLKATA,IMPHAL,10923,11867,IMPHAL-KOLKATA,22790,All
2019,4,KOLKATA,IMPHAL,9599,11520,IMPHAL-KOLKATA,21119,All
2015,4,KOLKATA,INDORE,1368,1597,INDORE-KOLKATA,2965,All
2015,5,KOLKATA,INDORE,1754,1843,INDORE-KOLKATA,3597,All
2015,6,KOLKATA,INDORE,1391,1292,INDORE-KOLKATA,2683,All
2015,7,KOLKATA,INDORE,1209,1293,INDORE-KOLKATA,2502,All
2015,8,KOLKATA,INDORE,1586,1600,INDORE-KOLKATA,3186,All
2015,9,KOLKATA,INDORE,1410,1515,INDORE-KOLKATA,2925,All
2015,10,KOLKATA,INDORE,1609,1575,INDORE-KOLKATA,3184,All
2015,11,KOLKATA,INDORE,1561,1664,INDORE-KOLKATA,3225,All
2015,12,KOLKATA,INDORE,1997,1886,INDORE-KOLKATA,3883,All
2016,1,KOLKATA,INDORE,1766,1893,INDORE-KOLKATA,3659,All
2016,2,KOLKATA,INDORE,1595,1567,INDORE-KOLKATA,3162,All
2016,3,KOLKATA,INDORE,1435,1372,INDORE-KOLKATA,2807,All
2016,4,KOLKATA,INDORE,1606,1591,INDORE-KOLKATA,3197,All
2016,5,KOLKATA,INDORE,1780,1961,INDORE-KOLKATA,3741,All
2016,6,KOLKATA,INDORE,838,969,INDORE-KOLKATA,1807,All
2016,7,KOLKATA,INDORE,1033,1162,INDORE-KOLKATA,2195,All
2016,8,KOLKATA,INDORE,1247,1250,INDORE-KOLKATA,2497,All
2016,9,KOLKATA,INDORE,1261,1564,INDORE-KOLKATA,2825,All
2016,10,KOLKATA,INDORE,1504,1708,INDORE-KOLKATA,3212,All
2016,11,KOLKATA,INDORE,1563,1793,INDORE-KOLKATA,3356,All
2016,12,KOLKATA,INDORE,2370,2858,INDORE-KOLKATA,5228,All
2017,1,KOLKATA,INDORE,2321,2863,INDORE-KOLKATA,5184,All
2017,2,KOLKATA,INDORE,1847,2337,INDORE-KOLKATA,4184,All
2017,3,KOLKATA,INDORE,1788,2257,INDORE-KOLKATA,4045,All
2017,4,KOLKATA,INDORE,1634,1909,INDORE-KOLKATA,3543,All
2017,5,KOLKATA,INDORE,1481,1958,INDORE-KOLKATA,3439,All
2017,6,KOLKATA,INDORE,1773,1984,INDORE-KOLKATA,3757,All
2017,7,KOLKATA,INDORE,1852,1999,INDORE-KOLKATA,3851,All
2017,8,KOLKATA,INDORE,1926,2376,INDORE-KOLKATA,4302,All
2017,9,KOLKATA,INDORE,2232,2349,INDORE-KOLKATA,4581,All
2017,10,KOLKATA,INDORE,1872,2833,INDORE-KOLKATA,4705,All
2017,11,KOLKATA,INDORE,2549,2742,INDORE-KOLKATA,5291,All
2017,12,KOLKATA,INDORE,3094,3297,INDORE-KOLKATA,6391,All
2018,1,KOLKATA,INDORE,2580,3330,INDORE-KOLKATA,5910,All
2018,2,KOLKATA,INDORE,2060,2358,INDORE-KOLKATA,4418,All
2018,3,KOLKATA,INDORE,2004,2281,INDORE-KOLKATA,4285,All
2018,4,KOLKATA,INDORE,1831,2208,INDORE-KOLKATA,4039,All
2018,5,KOLKATA,INDORE,2271,2441,INDORE-KOLKATA,4712,All
2018,6,KOLKATA,INDORE,3123,3130,INDORE-KOLKATA,6253,All
2018,7,KOLKATA,INDORE,3851,3675,INDORE-KOLKATA,7526,All
2018,8,KOLKATA,INDORE,4528,4668,INDORE-KOLKATA,9196,All
2018,9,KOLKATA,INDORE,6335,6833,INDORE-KOLKATA,13168,All
2018,10,KOLKATA,INDORE,6777,8113,INDORE-KOLKATA,14890,All
2018,11,KOLKATA,INDORE,6485,7560,INDORE-KOLKATA,14045,All
2018,12,KOLKATA,INDORE,5988,7103,INDORE-KOLKATA,13091,All
2019,1,KOLKATA,INDORE,5060,6890,INDORE-KOLKATA,11950,All
2019,2,KOLKATA,INDORE,5791,7151,INDORE-KOLKATA,12942,All
2019,3,KOLKATA,INDORE,5898,7886,INDORE-KOLKATA,13784,All
2019,4,KOLKATA,INDORE,5219,7740,INDORE-KOLKATA,12959,All
2017,10,KOLKATA,JABALPUR,695,695,JABALPUR-KOLKATA,1390,All
2017,11,KOLKATA,JABALPUR,542,556,JABALPUR-KOLKATA,1098,All
2017,12,KOLKATA,JABALPUR,657,625,JABALPUR-KOLKATA,1282,All
2018,1,KOLKATA,JABALPUR,394,392,JABALPUR-KOLKATA,786,All
2018,2,KOLKATA,JABALPUR,1061,1203,JABALPUR-KOLKATA,2264,All
2018,3,KOLKATA,JABALPUR,1615,1681,JABALPUR-KOLKATA,3296,All
2018,4,KOLKATA,JABALPUR,1928,2233,JABALPUR-KOLKATA,4161,All
2018,5,KOLKATA,JABALPUR,2272,2482,JABALPUR-KOLKATA,4754,All
2018,6,KOLKATA,JABALPUR,1292,1332,JABALPUR-KOLKATA,2624,All
2019,1,KOLKATA,JABALPUR,682,829,JABALPUR-KOLKATA,1511,All
2019,2,KOLKATA,JABALPUR,1315,1533,JABALPUR-KOLKATA,2848,All
2019,3,KOLKATA,JABALPUR,1474,1630,JABALPUR-KOLKATA,3104,All
2019,4,KOLKATA,JABALPUR,1338,1256,JABALPUR-KOLKATA,2594,All
2015,4,KOLKATA,JAIPUR,6398,6490,JAIPUR-KOLKATA,12888,All
2015,5,KOLKATA,JAIPUR,6195,7231,JAIPUR-KOLKATA,13426,All
2015,6,KOLKATA,JAIPUR,6259,7421,JAIPUR-KOLKATA,13680,All
2015,7,KOLKATA,JAIPUR,6224,6143,JAIPUR-KOLKATA,12367,All
2015,8,KOLKATA,JAIPUR,5817,6303,JAIPUR-KOLKATA,12120,All
2015,9,KOLKATA,JAIPUR,6449,7139,JAIPUR-KOLKATA,13588,All
2015,10,KOLKATA,JAIPUR,6651,6857,JAIPUR-KOLKATA,13508,All
2015,11,KOLKATA,JAIPUR,6060,6843,JAIPUR-KOLKATA,12903,All
2015,12,KOLKATA,JAIPUR,7434,7644,JAIPUR-KOLKATA,15078,All
2016,1,KOLKATA,JAIPUR,7482,8046,JAIPUR-KOLKATA,15528,All
2016,2,KOLKATA,JAIPUR,7624,8238,JAIPUR-KOLKATA,15862,All
2016,3,KOLKATA,JAIPUR,10892,12175,JAIPUR-KOLKATA,23067,All
2016,4,KOLKATA,JAIPUR,10320,10899,JAIPUR-KOLKATA,21219,All
2016,5,KOLKATA,JAIPUR,7570,8537,JAIPUR-KOLKATA,16107,All
2016,6,KOLKATA,JAIPUR,7181,7993,JAIPUR-KOLKATA,15174,All
2016,7,KOLKATA,JAIPUR,9444,9130,JAIPUR-KOLKATA,18574,All
2016,8,KOLKATA,JAIPUR,7978,7891,JAIPUR-KOLKATA,15869,All
2016,9,KOLKATA,JAIPUR,7056,7746,JAIPUR-KOLKATA,14802,All
2016,10,KOLKATA,JAIPUR,10799,11121,JAIPUR-KOLKATA,21920,All
2016,11,KOLKATA,JAIPUR,12118,12448,JAIPUR-KOLKATA,24566,All
2016,12,KOLKATA,JAIPUR,13984,13943,JAIPUR-KOLKATA,27927,All
2017,1,KOLKATA,JAIPUR,13076,13163,JAIPUR-KOLKATA,26239,All
2017,2,KOLKATA,JAIPUR,14030,13944,JAIPUR-KOLKATA,27974,All
2017,3,KOLKATA,JAIPUR,15974,16737,JAIPUR-KOLKATA,32711,All
2017,4,KOLKATA,JAIPUR,16087,17229,JAIPUR-KOLKATA,33316,All
2017,5,KOLKATA,JAIPUR,15237,17905,JAIPUR-KOLKATA,33142,All
2017,6,KOLKATA,JAIPUR,15930,16211,JAIPUR-KOLKATA,32141,All
2017,7,KOLKATA,JAIPUR,15746,15494,JAIPUR-KOLKATA,31240,All
2017,8,KOLKATA,JAIPUR,20976,20863,JAIPUR-KOLKATA,41839,All
2017,9,KOLKATA,JAIPUR,22790,22596,JAIPUR-KOLKATA,45386,All
2017,10,KOLKATA,JAIPUR,22275,24160,JAIPUR-KOLKATA,46435,All
2017,11,KOLKATA,JAIPUR,23070,22747,JAIPUR-KOLKATA,45817,All
2017,12,KOLKATA,JAIPUR,23815,24161,JAIPUR-KOLKATA,47976,All
2018,1,KOLKATA,JAIPUR,23208,23892,JAIPUR-KOLKATA,47100,All
2018,2,KOLKATA,JAIPUR,22912,22230,JAIPUR-KOLKATA,45142,All
2018,3,KOLKATA,JAIPUR,24462,23873,JAIPUR-KOLKATA,48335,All
2018,4,KOLKATA,JAIPUR,18102,18322,JAIPUR-KOLKATA,36424,All
2018,5,KOLKATA,JAIPUR,16754,18983,JAIPUR-KOLKATA,35737,All
2018,6,KOLKATA,JAIPUR,26438,22016,JAIPUR-KOLKATA,48454,All
2018,7,KOLKATA,JAIPUR,25457,22330,JAIPUR-KOLKATA,47787,All
2018,8,KOLKATA,JAIPUR,16101,15899,JAIPUR-KOLKATA,32000,All
2018,9,KOLKATA,JAIPUR,17112,17219,JAIPUR-KOLKATA,34331,All
2018,10,KOLKATA,JAIPUR,18411,19128,JAIPUR-KOLKATA,37539,All
2018,11,KOLKATA,JAIPUR,14734,16118,JAIPUR-KOLKATA,30852,All
2018,12,KOLKATA,JAIPUR,18347,19496,JAIPUR-KOLKATA,37843,All
2019,1,KOLKATA,JAIPUR,20468,20882,JAIPUR-KOLKATA,41350,All
2019,2,KOLKATA,JAIPUR,18485,18189,JAIPUR-KOLKATA,36674,All
2019,3,KOLKATA,JAIPUR,20399,21296,JAIPUR-KOLKATA,41695,All
2019,4,KOLKATA,JAIPUR,14828,16179,JAIPUR-KOLKATA,31007,All
2017,4,KOLKATA,JAMMU,1043,365,JAMMU-KOLKATA,1408,All
2017,5,KOLKATA,JAMMU,2214,727,JAMMU-KOLKATA,2941,All
2017,6,KOLKATA,JAMMU,1012,611,JAMMU-KOLKATA,1623,All
2017,10,KOLKATA,JAMMU,0,8,JAMMU-KOLKATA,8,All
2017,11,KOLKATA,JAMMU,0,64,JAMMU-KOLKATA,64,All
2017,12,KOLKATA,JAMMU,0,320,JAMMU-KOLKATA,320,All
2018,1,KOLKATA,JAMMU,0,299,JAMMU-KOLKATA,299,All
2018,2,KOLKATA,JAMMU,0,232,JAMMU-KOLKATA,232,All
2018,3,KOLKATA,JAMMU,0,202,JAMMU-KOLKATA,202,All
2018,4,KOLKATA,JAMMU,0,169,JAMMU-KOLKATA,169,All
2018,5,KOLKATA,JAMMU,0,142,JAMMU-KOLKATA,142,All
2018,6,KOLKATA,JAMMU,0,174,JAMMU-KOLKATA,174,All
2018,7,KOLKATA,JAMMU,0,93,JAMMU-KOLKATA,93,All
2018,8,KOLKATA,JAMMU,0,300,JAMMU-KOLKATA,300,All
2015,4,KOLKATA,JORHAT,1955,1945,JORHAT-KOLKATA,3900,All
2015,5,KOLKATA,JORHAT,1933,1720,JORHAT-KOLKATA,3653,All
2015,6,KOLKATA,JORHAT,1544,1599,JORHAT-KOLKATA,3143,All
2015,7,KOLKATA,JORHAT,1816,1768,JORHAT-KOLKATA,3584,All
2015,8,KOLKATA,JORHAT,1734,1655,JORHAT-KOLKATA,3389,All
2015,9,KOLKATA,JORHAT,1682,1643,JORHAT-KOLKATA,3325,All
2015,10,KOLKATA,JORHAT,1751,1540,JORHAT-KOLKATA,3291,All
2015,11,KOLKATA,JORHAT,1714,1718,JORHAT-KOLKATA,3432,All
2015,12,KOLKATA,JORHAT,1737,1647,JORHAT-KOLKATA,3384,All
2016,1,KOLKATA,JORHAT,1791,1806,JORHAT-KOLKATA,3597,All
2016,2,KOLKATA,JORHAT,1660,1587,JORHAT-KOLKATA,3247,All
2016,3,KOLKATA,JORHAT,1837,1641,JORHAT-KOLKATA,3478,All
2016,4,KOLKATA,JORHAT,1717,1311,JORHAT-KOLKATA,3028,All
2016,5,KOLKATA,JORHAT,1917,1300,JORHAT-KOLKATA,3217,All
2016,6,KOLKATA,JORHAT,1522,1267,JORHAT-KOLKATA,2789,All
2016,7,KOLKATA,JORHAT,1651,1326,JORHAT-KOLKATA,2977,All
2016,8,KOLKATA,JORHAT,1511,1048,JORHAT-KOLKATA,2559,All
2016,9,KOLKATA,JORHAT,1511,957,JORHAT-KOLKATA,2468,All
2016,10,KOLKATA,JORHAT,1508,1122,JORHAT-KOLKATA,2630,All
2016,11,KOLKATA,JORHAT,1533,1429,JORHAT-KOLKATA,2962,All
2016,12,KOLKATA,JORHAT,1851,1892,JORHAT-KOLKATA,3743,All
2017,1,KOLKATA,JORHAT,1755,1750,JORHAT-KOLKATA,3505,All
2017,2,KOLKATA,JORHAT,1575,1485,JORHAT-KOLKATA,3060,All
2017,3,KOLKATA,JORHAT,1337,1157,JORHAT-KOLKATA,2494,All
2017,4,KOLKATA,JORHAT,1837,1563,JORHAT-KOLKATA,3400,All
2017,5,KOLKATA,JORHAT,1722,1677,JORHAT-KOLKATA,3399,All
2017,6,KOLKATA,JORHAT,1114,1243,JORHAT-KOLKATA,2357,All
2017,7,KOLKATA,JORHAT,1538,1324,JORHAT-KOLKATA,2862,All
2017,8,KOLKATA,JORHAT,1494,1301,JORHAT-KOLKATA,2795,All
2017,9,KOLKATA,JORHAT,1229,1250,JORHAT-KOLKATA,2479,All
2017,10,KOLKATA,JORHAT,1439,1274,JORHAT-KOLKATA,2713,All
2017,11,KOLKATA,JORHAT,1586,1594,JORHAT-KOLKATA,3180,All
2017,12,KOLKATA,JORHAT,1602,1523,JORHAT-KOLKATA,3125,All
2018,1,KOLKATA,JORHAT,1855,1742,JORHAT-KOLKATA,3597,All
2018,2,KOLKATA,JORHAT,1588,1444,JORHAT-KOLKATA,3032,All
2018,3,KOLKATA,JORHAT,1227,1214,JORHAT-KOLKATA,2441,All
2018,8,KOLKATA,JORHAT,2497,2519,JORHAT-KOLKATA,5016,All
2018,9,KOLKATA,JORHAT,2547,2570,JORHAT-KOLKATA,5117,All
2018,10,KOLKATA,JORHAT,3351,3254,JORHAT-KOLKATA,6605,All
2018,11,KOLKATA,JORHAT,3286,3628,JORHAT-KOLKATA,6914,All
2018,12,KOLKATA,JORHAT,4764,4640,JORHAT-KOLKATA,9404,All
2019,1,KOLKATA,JORHAT,4089,4410,JORHAT-KOLKATA,8499,All
2019,2,KOLKATA,JORHAT,4527,4724,JORHAT-KOLKATA,9251,All
2019,3,KOLKATA,JORHAT,4797,4894,JORHAT-KOLKATA,9691,All
2019,4,KOLKATA,JORHAT,5196,4802,JORHAT-KOLKATA,9998,All
2019,3,KOLKATA,Jharsuguda,24,43,Jharsuguda-KOLKATA,67,All
2019,4,KOLKATA,Jharsuguda,1346,1992,Jharsuguda-KOLKATA,3338,All
2018,11,KOLKATA,KANPUR,4410,4626,KANPUR-KOLKATA,9036,All
2018,12,KOLKATA,KANPUR,4972,4967,KANPUR-KOLKATA,9939,All
2019,1,KOLKATA,KANPUR,5240,4876,KANPUR-KOLKATA,10116,All
2019,2,KOLKATA,KANPUR,4871,4542,KANPUR-KOLKATA,9413,All
2019,3,KOLKATA,KANPUR,1915,1907,KANPUR-KOLKATA,3822,All
2015,4,KOLKATA,KOCHI,1416,1386,KOCHI-KOLKATA,2802,All
2015,5,KOLKATA,KOCHI,1510,1634,KOCHI-KOLKATA,3144,All
2015,6,KOLKATA,KOCHI,1194,1729,KOCHI-KOLKATA,2923,All
2015,7,KOLKATA,KOCHI,1010,1441,KOCHI-KOLKATA,2451,All
2015,8,KOLKATA,KOCHI,1184,1061,KOCHI-KOLKATA,2245,All
2015,9,KOLKATA,KOCHI,1145,1750,KOCHI-KOLKATA,2895,All
2015,10,KOLKATA,KOCHI,1513,1677,KOCHI-KOLKATA,3190,All
2015,11,KOLKATA,KOCHI,1143,1388,KOCHI-KOLKATA,2531,All
2015,12,KOLKATA,KOCHI,2120,1544,KOCHI-KOLKATA,3664,All
2016,1,KOLKATA,KOCHI,1693,2004,KOCHI-KOLKATA,3697,All
2016,2,KOLKATA,KOCHI,1661,1810,KOCHI-KOLKATA,3471,All
2016,3,KOLKATA,KOCHI,1505,1661,KOCHI-KOLKATA,3166,All
2016,4,KOLKATA,KOCHI,1610,1680,KOCHI-KOLKATA,3290,All
2016,5,KOLKATA,KOCHI,1965,1679,KOCHI-KOLKATA,3644,All
2016,6,KOLKATA,KOCHI,1069,1471,KOCHI-KOLKATA,2540,All
2016,7,KOLKATA,KOCHI,1113,1257,KOCHI-KOLKATA,2370,All
2016,8,KOLKATA,KOCHI,1071,1106,KOCHI-KOLKATA,2177,All
2016,9,KOLKATA,KOCHI,864,1143,KOCHI-KOLKATA,2007,All
2016,10,KOLKATA,KOCHI,1039,937,KOCHI-KOLKATA,1976,All
2016,11,KOLKATA,KOCHI,669,693,KOCHI-KOLKATA,1362,All
2016,12,KOLKATA,KOCHI,1130,1412,KOCHI-KOLKATA,2542,All
2017,1,KOLKATA,KOCHI,1029,1240,KOCHI-KOLKATA,2269,All
2017,2,KOLKATA,KOCHI,1179,1476,KOCHI-KOLKATA,2655,All
2017,3,KOLKATA,KOCHI,448,1006,KOCHI-KOLKATA,1454,All
2017,4,KOLKATA,KOCHI,474,1014,KOCHI-KOLKATA,1488,All
2017,5,KOLKATA,KOCHI,897,882,KOCHI-KOLKATA,1779,All
2017,6,KOLKATA,KOCHI,707,897,KOCHI-KOLKATA,1604,All
2017,7,KOLKATA,KOCHI,441,804,KOCHI-KOLKATA,1245,All
2017,8,KOLKATA,KOCHI,460,582,KOCHI-KOLKATA,1042,All
2017,9,KOLKATA,KOCHI,918,464,KOCHI-KOLKATA,1382,All
2017,10,KOLKATA,KOCHI,560,906,KOCHI-KOLKATA,1466,All
2017,11,KOLKATA,KOCHI,1018,1225,KOCHI-KOLKATA,2243,All
2017,12,KOLKATA,KOCHI,1941,1605,KOCHI-KOLKATA,3546,All
2018,1,KOLKATA,KOCHI,2110,3296,KOCHI-KOLKATA,5406,All
2018,2,KOLKATA,KOCHI,1257,1708,KOCHI-KOLKATA,2965,All
2018,3,KOLKATA,KOCHI,1159,1246,KOCHI-KOLKATA,2405,All
2018,4,KOLKATA,KOCHI,962,782,KOCHI-KOLKATA,1744,All
2018,5,KOLKATA,KOCHI,1684,1287,KOCHI-KOLKATA,2971,All
2018,6,KOLKATA,KOCHI,1137,1268,KOCHI-KOLKATA,2405,All
2018,7,KOLKATA,KOCHI,726,747,KOCHI-KOLKATA,1473,All
2018,8,KOLKATA,KOCHI,516,701,KOCHI-KOLKATA,1217,All
2018,9,KOLKATA,KOCHI,1084,694,KOCHI-KOLKATA,1778,All
2018,10,KOLKATA,KOCHI,2078,1850,KOCHI-KOLKATA,3928,All
2018,11,KOLKATA,KOCHI,5012,5683,KOCHI-KOLKATA,10695,All
2018,12,KOLKATA,KOCHI,10742,9910,KOCHI-KOLKATA,20652,All
2019,1,KOLKATA,KOCHI,8796,9607,KOCHI-KOLKATA,18403,All
2019,2,KOLKATA,KOCHI,6723,7318,KOCHI-KOLKATA,14041,All
2019,3,KOLKATA,KOCHI,4792,6472,KOCHI-KOLKATA,11264,All
2019,4,KOLKATA,KOCHI,5511,7435,KOCHI-KOLKATA,12946,All
2021,8,KOLKATA,KOZHIKODE,214,247,KOLKATA-KOZHIKODE,461,All
2021,9,KOLKATA,KOZHIKODE,269,312,KOLKATA-KOZHIKODE,581,All
2021,10,KOLKATA,KOZHIKODE,209,334,KOLKATA-KOZHIKODE,543,All
2022,3,KOLKATA,Kushinagar International Airport,59,170,KOLKATA-Kushinagar International Airport,229,All
2015,9,KOLKATA,LILABARI,126,108,KOLKATA-LILABARI,234,All
2015,12,KOLKATA,LILABARI,116,124,KOLKATA-LILABARI,240,All
2016,1,KOLKATA,LILABARI,38,39,KOLKATA-LILABARI,77,All
2016,2,KOLKATA,LILABARI,167,135,KOLKATA-LILABARI,302,All
2016,3,KOLKATA,LILABARI,211,225,KOLKATA-LILABARI,436,All
2018,5,KOLKATA,LILABARI,257,260,KOLKATA-LILABARI,517,All
2018,6,KOLKATA,LILABARI,209,215,KOLKATA-LILABARI,424,All
2018,7,KOLKATA,LILABARI,8,338,KOLKATA-LILABARI,346,All
2018,8,KOLKATA,LILABARI,193,210,KOLKATA-LILABARI,403,All
2018,9,KOLKATA,LILABARI,148,175,KOLKATA-LILABARI,323,All
2018,10,KOLKATA,LILABARI,643,598,KOLKATA-LILABARI,1241,All
2019,1,KOLKATA,LILABARI,394,476,KOLKATA-LILABARI,870,All
2019,2,KOLKATA,LILABARI,641,535,KOLKATA-LILABARI,1176,All
2019,3,KOLKATA,LILABARI,680,538,KOLKATA-LILABARI,1218,All
2019,4,KOLKATA,LILABARI,351,412,KOLKATA-LILABARI,763,All
2019,5,KOLKATA,LILABARI,318,435,KOLKATA-LILABARI,753,All
2019,6,KOLKATA,LILABARI,324,297,KOLKATA-LILABARI,621,All
2019,7,KOLKATA,LILABARI,114,284,KOLKATA-LILABARI,398,All
2019,8,KOLKATA,LILABARI,417,473,KOLKATA-LILABARI,890,All
2019,9,KOLKATA,LILABARI,770,722,KOLKATA-LILABARI,1492,All
2019,10,KOLKATA,LILABARI,788,894,KOLKATA-LILABARI,1682,All
2019,11,KOLKATA,LILABARI,895,956,KOLKATA-LILABARI,1851,All
2019,12,KOLKATA,LILABARI,784,841,KOLKATA-LILABARI,1625,All
2020,1,KOLKATA,LILABARI,783,701,KOLKATA-LILABARI,1484,All
2020,2,KOLKATA,LILABARI,784,771,KOLKATA-LILABARI,1555,All
2020,3,KOLKATA,LILABARI,718,519,KOLKATA-LILABARI,1237,All
2020,5,KOLKATA,LILABARI,5,1,KOLKATA-LILABARI,6,All
2020,6,KOLKATA,LILABARI,328,192,KOLKATA-LILABARI,520,All
2020,7,KOLKATA,LILABARI,218,201,KOLKATA-LILABARI,419,All
2020,8,KOLKATA,LILABARI,320,202,KOLKATA-LILABARI,522,All
2020,9,KOLKATA,LILABARI,565,295,KOLKATA-LILABARI,860,All
2020,10,KOLKATA,LILABARI,496,542,KOLKATA-LILABARI,1038,All
2020,11,KOLKATA,LILABARI,659,539,KOLKATA-LILABARI,1198,All
2020,12,KOLKATA,LILABARI,813,667,KOLKATA-LILABARI,1480,All
2021,1,KOLKATA,LILABARI,755,599,KOLKATA-LILABARI,1354,All
2021,2,KOLKATA,LILABARI,848,712,KOLKATA-LILABARI,1560,All
2021,3,KOLKATA,LILABARI,802,746,KOLKATA-LILABARI,1548,All
2021,4,KOLKATA,LILABARI,857,721,KOLKATA-LILABARI,1578,All
2021,6,KOLKATA,LILABARI,412,426,KOLKATA-LILABARI,838,All
2021,7,KOLKATA,LILABARI,507,535,KOLKATA-LILABARI,1042,All
2021,8,KOLKATA,LILABARI,699,623,KOLKATA-LILABARI,1322,All
2021,9,KOLKATA,LILABARI,795,749,KOLKATA-LILABARI,1544,All
2021,10,KOLKATA,LILABARI,870,984,KOLKATA-LILABARI,1854,All
2021,11,KOLKATA,LILABARI,862,971,KOLKATA-LILABARI,1833,All
2021,12,KOLKATA,LILABARI,887,984,KOLKATA-LILABARI,1871,All
2022,1,KOLKATA,LILABARI,690,711,KOLKATA-LILABARI,1401,All
2022,2,KOLKATA,LILABARI,794,1049,KOLKATA-LILABARI,1843,All
2022,3,KOLKATA,LILABARI,1148,1385,KOLKATA-LILABARI,2533,All
2022,4,KOLKATA,LILABARI,862,971,KOLKATA-LILABARI,1833,All
2022,5,KOLKATA,LILABARI,887,984,KOLKATA-LILABARI,1871,All
2022,6,KOLKATA,LILABARI,862,971,KOLKATA-LILABARI,1833,All
2022,7,KOLKATA,LILABARI,794,1049,KOLKATA-LILABARI,1843,All
2022,8,KOLKATA,LILABARI,887,984,KOLKATA-LILABARI,1871,All
2022,9,KOLKATA,LILABARI,862,971,KOLKATA-LILABARI,1833,All
2022,10,KOLKATA,LILABARI,1363,1333,KOLKATA-LILABARI,2696,All
2022,11,KOLKATA,LILABARI,1230,1235,KOLKATA-LILABARI,2465,All
2022,12,KOLKATA,LILABARI,1062,1063,KOLKATA-LILABARI,2125,All
2023,1,KOLKATA,LILABARI,895,1057,KOLKATA-LILABARI,1952,All
2023,2,KOLKATA,LILABARI,642,744,KOLKATA-LILABARI,1386,All
2023,3,KOLKATA,LILABARI,998,1176,KOLKATA-LILABARI,2174,All
2023,4,KOLKATA,LILABARI,1343,1207,KOLKATA-LILABARI,2550,All
2023,5,KOLKATA,LILABARI,1305,1221,KOLKATA-LILABARI,2526,All
2023,6,KOLKATA,LILABARI,924,1178,KOLKATA-LILABARI,2102,All
2023,7,KOLKATA,LILABARI,1008,1331,KOLKATA-LILABARI,2339,All
2023,8,KOLKATA,LILABARI,735,928,KOLKATA-LILABARI,1663,All
2023,9,KOLKATA,LILABARI,605,637,KOLKATA-LILABARI,1242,All
2023,10,KOLKATA,LILABARI,785,944,KOLKATA-LILABARI,1729,All
2023,11,KOLKATA,LILABARI,714,801,KOLKATA-LILABARI,1515,All
2023,12,KOLKATA,LILABARI,975,951,KOLKATA-LILABARI,1926,All
2024,1,KOLKATA,LILABARI,724,770,KOLKATA-LILABARI,1494,All
2024,2,KOLKATA,LILABARI,490,625,KOLKATA-LILABARI,1115,All
2024,3,KOLKATA,LILABARI,1066,1099,KOLKATA-LILABARI,2165,All
2024,4,KOLKATA,LILABARI,1102,1059,KOLKATA-LILABARI,2161,All
2024,6,KOLKATA,LILABARI,620,860,KOLKATA-LILABARI,1480,All
2024,7,KOLKATA,LILABARI,908,1098,KOLKATA-LILABARI,2006,All
2024,8,KOLKATA,LILABARI,544,705,KOLKATA-LILABARI,1249,All
2024,9,KOLKATA,LILABARI,560,619,KOLKATA-LILABARI,1179,All
2024,10,KOLKATA,LILABARI,710,721,KOLKATA-LILABARI,1431,All
2024,11,KOLKATA,LILABARI,608,628,KOLKATA-LILABARI,1236,All
2024,12,KOLKATA,LILABARI,728,707,KOLKATA-LILABARI,1435,All
2025,1,KOLKATA,LILABARI,705,766,KOLKATA-LILABARI,1471,All
2025,2,KOLKATA,LILABARI,609,658,KOLKATA-LILABARI,1267,All
2025,3,KOLKATA,LILABARI,683,822,KOLKATA-LILABARI,1505,All
2015,4,KOLKATA,LUCKNOW,3764,3721,KOLKATA-LUCKNOW,7485,All
2015,5,KOLKATA,LUCKNOW,3670,3800,KOLKATA-LUCKNOW,7470,All
2015,6,KOLKATA,LUCKNOW,4344,4288,KOLKATA-LUCKNOW,8632,All
2015,7,KOLKATA,LUCKNOW,3546,3327,KOLKATA-LUCKNOW,6873,All
2015,8,KOLKATA,LUCKNOW,3797,3762,KOLKATA-LUCKNOW,7559,All
2015,9,KOLKATA,LUCKNOW,3394,3505,KOLKATA-LUCKNOW,6899,All
2015,10,KOLKATA,LUCKNOW,5257,4746,KOLKATA-LUCKNOW,10003,All
2015,11,KOLKATA,LUCKNOW,3034,3544,KOLKATA-LUCKNOW,6578,All
2015,12,KOLKATA,LUCKNOW,5056,6185,KOLKATA-LUCKNOW,11241,All
2016,1,KOLKATA,LUCKNOW,4598,4941,KOLKATA-LUCKNOW,9539,All
2016,2,KOLKATA,LUCKNOW,4092,3961,KOLKATA-LUCKNOW,8053,All
2016,3,KOLKATA,LUCKNOW,3701,3463,KOLKATA-LUCKNOW,7164,All
2016,4,KOLKATA,LUCKNOW,2524,2676,KOLKATA-LUCKNOW,5200,All
2016,5,KOLKATA,LUCKNOW,2899,2978,KOLKATA-LUCKNOW,5877,All
2016,6,KOLKATA,LUCKNOW,4725,5398,KOLKATA-LUCKNOW,10123,All
2016,7,KOLKATA,LUCKNOW,4791,4669,KOLKATA-LUCKNOW,9460,All
2016,8,KOLKATA,LUCKNOW,4574,4571,KOLKATA-LUCKNOW,9145,All
2016,9,KOLKATA,LUCKNOW,4929,4957,KOLKATA-LUCKNOW,9886,All
2016,10,KOLKATA,LUCKNOW,7268,6988,KOLKATA-LUCKNOW,14256,All
2016,11,KOLKATA,LUCKNOW,6319,6521,KOLKATA-LUCKNOW,12840,All
2016,12,KOLKATA,LUCKNOW,11231,15433,KOLKATA-LUCKNOW,26664,All
2017,1,KOLKATA,LUCKNOW,13649,16217,KOLKATA-LUCKNOW,29866,All
2017,2,KOLKATA,LUCKNOW,10610,12068,KOLKATA-LUCKNOW,22678,All
2017,3,KOLKATA,LUCKNOW,9683,10189,KOLKATA-LUCKNOW,19872,All
2017,4,KOLKATA,LUCKNOW,10192,10511,KOLKATA-LUCKNOW,20703,All
2017,5,KOLKATA,LUCKNOW,9530,9996,KOLKATA-LUCKNOW,19526,All
2017,6,KOLKATA,LUCKNOW,9582,9527,KOLKATA-LUCKNOW,19109,All
2017,7,KOLKATA,LUCKNOW,8310,8143,KOLKATA-LUCKNOW,16453,All
2017,8,KOLKATA,LUCKNOW,9218,9180,KOLKATA-LUCKNOW,18398,All
2017,9,KOLKATA,LUCKNOW,9532,8338,KOLKATA-LUCKNOW,17870,All
2017,10,KOLKATA,LUCKNOW,12397,12118,KOLKATA-LUCKNOW,24515,All
2017,11,KOLKATA,LUCKNOW,17053,15294,KOLKATA-LUCKNOW,32347,All
2017,12,KOLKATA,LUCKNOW,17988,19600,KOLKATA-LUCKNOW,37588,All
2018,1,KOLKATA,LUCKNOW,23303,24111,KOLKATA-LUCKNOW,47414,All
2018,2,KOLKATA,LUCKNOW,19312,18632,KOLKATA-LUCKNOW,37944,All
2018,3,KOLKATA,LUCKNOW,16309,16225,KOLKATA-LUCKNOW,32534,All
2018,4,KOLKATA,LUCKNOW,10991,10378,KOLKATA-LUCKNOW,21369,All
2018,5,KOLKATA,LUCKNOW,10958,11321,KOLKATA-LUCKNOW,22279,All
2018,6,KOLKATA,LUCKNOW,10910,11767,KOLKATA-LUCKNOW,22677,All
2018,7,KOLKATA,LUCKNOW,8387,8769,KOLKATA-LUCKNOW,17156,All
2018,8,KOLKATA,LUCKNOW,6759,7640,KOLKATA-LUCKNOW,14399,All
2018,9,KOLKATA,LUCKNOW,7069,7756,KOLKATA-LUCKNOW,14825,All
2018,10,KOLKATA,LUCKNOW,10903,11368,KOLKATA-LUCKNOW,22271,All
2018,11,KOLKATA,LUCKNOW,11086,12517,KOLKATA-LUCKNOW,23603,All
2018,12,KOLKATA,LUCKNOW,12901,14167,KOLKATA-LUCKNOW,27068,All
2019,1,KOLKATA,LUCKNOW,13355,14271,KOLKATA-LUCKNOW,27626,All
2019,2,KOLKATA,LUCKNOW,11704,12178,KOLKATA-LUCKNOW,23882,All
2019,3,KOLKATA,LUCKNOW,10456,11580,KOLKATA-LUCKNOW,22036,All
2019,4,KOLKATA,LUCKNOW,10351,11763,KOLKATA-LUCKNOW,22114,All
2019,5,KOLKATA,LUCKNOW,9671,11490,KOLKATA-LUCKNOW,21161,All
2019,6,KOLKATA,LUCKNOW,10040,12322,KOLKATA-LUCKNOW,22362,All
2019,7,KOLKATA,LUCKNOW,12396,11623,KOLKATA-LUCKNOW,24019,All
2019,8,KOLKATA,LUCKNOW,11984,12185,KOLKATA-LUCKNOW,24169,All
2019,9,KOLKATA,LUCKNOW,11307,11638,KOLKATA-LUCKNOW,22945,All
2019,10,KOLKATA,LUCKNOW,19020,20357,KOLKATA-LUCKNOW,39377,All
2019,11,KOLKATA,LUCKNOW,18822,19058,KOLKATA-LUCKNOW,37880,All
2019,12,KOLKATA,LUCKNOW,17787,19670,KOLKATA-LUCKNOW,37457,All
2020,1,KOLKATA,LUCKNOW,18508,18932,KOLKATA-LUCKNOW,37440,All
2020,2,KOLKATA,LUCKNOW,17773,17809,KOLKATA-LUCKNOW,35582,All
2020,3,KOLKATA,LUCKNOW,12413,12771,KOLKATA-LUCKNOW,25184,All
2020,6,KOLKATA,LUCKNOW,3894,3168,KOLKATA-LUCKNOW,7062,All
2020,7,KOLKATA,LUCKNOW,4989,5143,KOLKATA-LUCKNOW,10132,All
2020,8,KOLKATA,LUCKNOW,6829,5227,KOLKATA-LUCKNOW,12056,All
2020,9,KOLKATA,LUCKNOW,9217,7949,KOLKATA-LUCKNOW,17166,All
2020,10,KOLKATA,LUCKNOW,10840,13743,KOLKATA-LUCKNOW,24583,All
2020,11,KOLKATA,LUCKNOW,9830,13143,KOLKATA-LUCKNOW,22973,All
2020,12,KOLKATA,LUCKNOW,10826,15635,KOLKATA-LUCKNOW,26461,All
2021,1,KOLKATA,LUCKNOW,9973,14297,KOLKATA-LUCKNOW,24270,All
2021,2,KOLKATA,LUCKNOW,10727,14785,KOLKATA-LUCKNOW,25512,All
2021,3,KOLKATA,LUCKNOW,10872,14599,KOLKATA-LUCKNOW,25471,All
2021,4,KOLKATA,LUCKNOW,4098,9189,KOLKATA-LUCKNOW,13287,All
2021,6,KOLKATA,LUCKNOW,1560,4189,KOLKATA-LUCKNOW,5749,All
2021,7,KOLKATA,LUCKNOW,3934,8859,KOLKATA-LUCKNOW,12793,All
2021,8,KOLKATA,LUCKNOW,4921,10023,KOLKATA-LUCKNOW,14944,All
2021,9,KOLKATA,LUCKNOW,5311,10557,KOLKATA-LUCKNOW,15868,All
2021,10,KOLKATA,LUCKNOW,7114,11878,KOLKATA-LUCKNOW,18992,All
2021,11,KOLKATA,LUCKNOW,9596,15953,KOLKATA-LUCKNOW,25549,All
2021,12,KOLKATA,LUCKNOW,9913,15802,KOLKATA-LUCKNOW,25715,All
2022,1,KOLKATA,LUCKNOW,6853,12650,KOLKATA-LUCKNOW,19503,All
2022,2,KOLKATA,LUCKNOW,6404,9692,KOLKATA-LUCKNOW,16096,All
2022,3,KOLKATA,LUCKNOW,9125,8811,KOLKATA-LUCKNOW,17936,All
2022,4,KOLKATA,LUCKNOW,8999,9049,KOLKATA-LUCKNOW,18048,All
2022,5,KOLKATA,LUCKNOW,8544,8783,KOLKATA-LUCKNOW,17327,All
2022,6,KOLKATA,LUCKNOW,8252,9323,KOLKATA-LUCKNOW,17575,All
2022,7,KOLKATA,LUCKNOW,8732,8713,KOLKATA-LUCKNOW,17445,All
2022,8,KOLKATA,LUCKNOW,8464,8082,KOLKATA-LUCKNOW,16546,All
2022,9,KOLKATA,LUCKNOW,10334,11339,KOLKATA-LUCKNOW,21673,All
2022,10,KOLKATA,LUCKNOW,13946,14349,KOLKATA-LUCKNOW,28295,All
2022,11,KOLKATA,LUCKNOW,10797,12584,KOLKATA-LUCKNOW,23381,All
2022,12,KOLKATA,LUCKNOW,11980,16728,KOLKATA-LUCKNOW,28708,All
2023,1,KOLKATA,LUCKNOW,11837,13563,KOLKATA-LUCKNOW,25400,All
2023,2,KOLKATA,LUCKNOW,12477,13416,KOLKATA-LUCKNOW,25893,All
2023,3,KOLKATA,LUCKNOW,12881,15720,KOLKATA-LUCKNOW,28601,All
2023,4,KOLKATA,LUCKNOW,14590,17227,KOLKATA-LUCKNOW,31817,All
2023,5,KOLKATA,LUCKNOW,21147,21078,KOLKATA-LUCKNOW,42225,All
2023,6,KOLKATA,LUCKNOW,15080,17542,KOLKATA-LUCKNOW,32622,All
2023,7,KOLKATA,LUCKNOW,12347,12655,KOLKATA-LUCKNOW,25002,All
2023,8,KOLKATA,LUCKNOW,12269,12244,KOLKATA-LUCKNOW,24513,All
2023,9,KOLKATA,LUCKNOW,12387,12855,KOLKATA-LUCKNOW,25242,All
2023,10,KOLKATA,LUCKNOW,13443,14091,KOLKATA-LUCKNOW,27534,All
2023,11,KOLKATA,LUCKNOW,14404,16700,KOLKATA-LUCKNOW,31104,All
2023,12,KOLKATA,LUCKNOW,15103,17855,KOLKATA-LUCKNOW,32958,All
2024,1,KOLKATA,LUCKNOW,11481,12327,KOLKATA-LUCKNOW,23808,All
2024,2,KOLKATA,LUCKNOW,10294,10992,KOLKATA-LUCKNOW,21286,All
2024,3,KOLKATA,LUCKNOW,10927,12611,KOLKATA-LUCKNOW,23538,All
2024,4,KOLKATA,LUCKNOW,9158,9816,KOLKATA-LUCKNOW,18974,All
2024,6,KOLKATA,LUCKNOW,8653,10788,KOLKATA-LUCKNOW,19441,All
2024,7,KOLKATA,LUCKNOW,9749,10048,KOLKATA-LUCKNOW,19797,All
2024,8,KOLKATA,LUCKNOW,9006,9273,KOLKATA-LUCKNOW,18279,All
2024,9,KOLKATA,LUCKNOW,8975,10190,KOLKATA-LUCKNOW,19165,All
2024,10,KOLKATA,LUCKNOW,11064,11538,KOLKATA-LUCKNOW,22602,All
2024,11,KOLKATA,LUCKNOW,11133,11614,KOLKATA-LUCKNOW,22747,All
2024,12,KOLKATA,LUCKNOW,11534,12532,KOLKATA-LUCKNOW,24066,All
2025,1,KOLKATA,LUCKNOW,12680,12557,KOLKATA-LUCKNOW,25237,All
2025,2,KOLKATA,LUCKNOW,13575,13412,KOLKATA-LUCKNOW,26987,All
2025,3,KOLKATA,LUCKNOW,10701,11707,KOLKATA-LUCKNOW,22408,All
2018,2,KOLKATA,MADURAI,0,35,KOLKATA-MADURAI,35,All
2018,3,KOLKATA,MADURAI,0,275,KOLKATA-MADURAI,275,All
2018,4,KOLKATA,MADURAI,0,314,KOLKATA-MADURAI,314,All
2018,5,KOLKATA,MADURAI,0,271,KOLKATA-MADURAI,271,All
2018,6,KOLKATA,MADURAI,0,318,KOLKATA-MADURAI,318,All
2018,7,KOLKATA,MADURAI,0,151,KOLKATA-MADURAI,151,All
2018,8,KOLKATA,MADURAI,0,236,KOLKATA-MADURAI,236,All
2018,9,KOLKATA,MADURAI,0,98,KOLKATA-MADURAI,98,All
2020,10,KOLKATA,MADURAI,56,23,KOLKATA-MADURAI,79,All
2020,11,KOLKATA,MADURAI,378,467,KOLKATA-MADURAI,845,All
2020,12,KOLKATA,MADURAI,563,462,KOLKATA-MADURAI,1025,All
2021,1,KOLKATA,MADURAI,412,449,KOLKATA-MADURAI,861,All
2021,2,KOLKATA,MADURAI,332,323,KOLKATA-MADURAI,655,All
2021,3,KOLKATA,MADURAI,262,401,KOLKATA-MADURAI,663,All
2017,6,KOLKATA,MANGALORE,88,0,KOLKATA-MANGALORE,88,All
2017,7,KOLKATA,MANGALORE,109,0,KOLKATA-MANGALORE,109,All
2017,8,KOLKATA,MANGALORE,91,0,KOLKATA-MANGALORE,91,All
2017,9,KOLKATA,MANGALORE,132,0,KOLKATA-MANGALORE,132,All
2017,10,KOLKATA,MANGALORE,61,0,KOLKATA-MANGALORE,61,All
2017,11,KOLKATA,MANGALORE,15,0,KOLKATA-MANGALORE,15,All
2017,12,KOLKATA,MANGALORE,360,0,KOLKATA-MANGALORE,360,All
2018,1,KOLKATA,MANGALORE,237,0,KOLKATA-MANGALORE,237,All
2018,2,KOLKATA,MANGALORE,131,0,KOLKATA-MANGALORE,131,All
2018,4,KOLKATA,MANGALORE,198,0,KOLKATA-MANGALORE,198,All
2018,5,KOLKATA,MANGALORE,298,0,KOLKATA-MANGALORE,298,All
2018,6,KOLKATA,MANGALORE,394,36,KOLKATA-MANGALORE,430,All
2018,7,KOLKATA,MANGALORE,551,34,KOLKATA-MANGALORE,585,All
2018,8,KOLKATA,MANGALORE,462,33,KOLKATA-MANGALORE,495,All
2018,9,KOLKATA,MANGALORE,221,0,KOLKATA-MANGALORE,221,All
2018,10,KOLKATA,MANGALORE,373,0,KOLKATA-MANGALORE,373,All
2018,11,KOLKATA,MANGALORE,395,0,KOLKATA-MANGALORE,395,All
2018,12,KOLKATA,MANGALORE,334,0,KOLKATA-MANGALORE,334,All
2019,1,KOLKATA,MANGALORE,320,0,KOLKATA-MANGALORE,320,All
2019,2,KOLKATA,MANGALORE,264,0,KOLKATA-MANGALORE,264,All
2019,3,KOLKATA,MANGALORE,216,0,KOLKATA-MANGALORE,216,All
2019,4,KOLKATA,MANGALORE,238,0,KOLKATA-MANGALORE,238,All
2019,5,KOLKATA,MANGALORE,374,0,KOLKATA-MANGALORE,374,All
2019,6,KOLKATA,MANGALORE,342,0,KOLKATA-MANGALORE,342,All
2019,7,KOLKATA,MANGALORE,474,0,KOLKATA-MANGALORE,474,All
2019,8,KOLKATA,MANGALORE,270,0,KOLKATA-MANGALORE,270,All
2019,9,KOLKATA,MANGALORE,198,0,KOLKATA-MANGALORE,198,All
2019,10,KOLKATA,MANGALORE,317,6,KOLKATA-MANGALORE,323,All
2019,11,KOLKATA,MANGALORE,220,168,KOLKATA-MANGALORE,388,All
2019,12,KOLKATA,MANGALORE,293,295,KOLKATA-MANGALORE,588,All
2020,1,KOLKATA,MANGALORE,278,248,KOLKATA-MANGALORE,526,All
2020,2,KOLKATA,MANGALORE,224,301,KOLKATA-MANGALORE,525,All
2020,3,KOLKATA,MANGALORE,145,241,KOLKATA-MANGALORE,386,All
2021,3,KOLKATA,MANGALORE,20,0,KOLKATA-MANGALORE,20,All
2021,4,KOLKATA,MANGALORE,80,0,KOLKATA-MANGALORE,80,All
2021,10,KOLKATA,MANGALORE,14,22,KOLKATA-MANGALORE,36,All
2021,11,KOLKATA,MANGALORE,275,354,KOLKATA-MANGALORE,629,All
2021,12,KOLKATA,MANGALORE,198,406,KOLKATA-MANGALORE,604,All
2022,1,KOLKATA,MANGALORE,38,196,KOLKATA-MANGALORE,234,All
2022,2,KOLKATA,MANGALORE,13,79,KOLKATA-MANGALORE,92,All
2022,3,KOLKATA,MANGALORE,139,372,KOLKATA-MANGALORE,511,All
2022,4,KOLKATA,MANGALORE,355,497,KOLKATA-MANGALORE,852,All
2022,5,KOLKATA,MANGALORE,445,482,KOLKATA-MANGALORE,927,All
2022,6,KOLKATA,MANGALORE,381,475,KOLKATA-MANGALORE,856,All
2022,7,KOLKATA,MANGALORE,373,359,KOLKATA-MANGALORE,732,All
2022,8,KOLKATA,MANGALORE,367,422,KOLKATA-MANGALORE,789,All
2022,9,KOLKATA,MANGALORE,309,263,KOLKATA-MANGALORE,572,All
2022,10,KOLKATA,MANGALORE,232,198,KOLKATA-MANGALORE,430,All
2022,11,KOLKATA,MANGALORE,323,343,KOLKATA-MANGALORE,666,All
2022,12,KOLKATA,MANGALORE,333,450,KOLKATA-MANGALORE,783,All
2023,1,KOLKATA,MANGALORE,451,418,KOLKATA-MANGALORE,869,All
2023,2,KOLKATA,MANGALORE,57,49,KOLKATA-MANGALORE,106,All
2023,3,KOLKATA,MANGALORE,9,22,KOLKATA-MANGALORE,31,All
2023,6,KOLKATA,MANGALORE,350,244,KOLKATA-MANGALORE,594,All
2023,7,KOLKATA,MANGALORE,399,306,KOLKATA-MANGALORE,705,All
2023,8,KOLKATA,MANGALORE,229,223,KOLKATA-MANGALORE,452,All
2023,9,KOLKATA,MANGALORE,153,193,KOLKATA-MANGALORE,346,All
2023,10,KOLKATA,MANGALORE,123,200,KOLKATA-MANGALORE,323,All
2019,5,KOLKATA,MUMBAI,79836,82560,KOLKATA-MUMBAI,162396,All
2019,6,KOLKATA,MUMBAI,83967,81502,KOLKATA-MUMBAI,165469,All
2019,7,KOLKATA,MUMBAI,79713,80825,KOLKATA-MUMBAI,160538,All
2019,8,KOLKATA,MUMBAI,79148,88209,KOLKATA-MUMBAI,167357,All
2019,9,KOLKATA,MUMBAI,81050,90414,KOLKATA-MUMBAI,171464,All
2019,10,KOLKATA,MUMBAI,85369,102277,KOLKATA-MUMBAI,187646,All
2019,11,KOLKATA,MUMBAI,94144,90825,KOLKATA-MUMBAI,184969,All
2019,12,KOLKATA,MUMBAI,95750,98504,KOLKATA-MUMBAI,194254,All
2020,1,KOLKATA,MUMBAI,91566,97611,KOLKATA-MUMBAI,189177,All
2020,2,KOLKATA,MUMBAI,89177,90339,KOLKATA-MUMBAI,179516,All
2020,3,KOLKATA,MUMBAI,48530,63264,KOLKATA-MUMBAI,111794,All
2020,5,KOLKATA,MUMBAI,612,1439,KOLKATA-MUMBAI,2051,All
2020,6,KOLKATA,MUMBAI,6478,21835,KOLKATA-MUMBAI,28313,All
2020,7,KOLKATA,MUMBAI,1548,4101,KOLKATA-MUMBAI,5649,All
2020,8,KOLKATA,MUMBAI,6891,3685,KOLKATA-MUMBAI,10576,All
2020,9,KOLKATA,MUMBAI,28525,15724,KOLKATA-MUMBAI,44249,All
2020,10,KOLKATA,MUMBAI,40290,19668,KOLKATA-MUMBAI,59958,All
2020,11,KOLKATA,MUMBAI,38918,26339,KOLKATA-MUMBAI,65257,All
2020,12,KOLKATA,MUMBAI,39020,26660,KOLKATA-MUMBAI,65680,All
2021,1,KOLKATA,MUMBAI,44101,30765,KOLKATA-MUMBAI,74866,All
2021,2,KOLKATA,MUMBAI,40415,33450,KOLKATA-MUMBAI,73865,All
2021,3,KOLKATA,MUMBAI,31919,25806,KOLKATA-MUMBAI,57725,All
2021,4,KOLKATA,MUMBAI,14754,27541,KOLKATA-MUMBAI,42295,All
2021,6,KOLKATA,MUMBAI,14567,9697,KOLKATA-MUMBAI,24264,All
2021,7,KOLKATA,MUMBAI,20030,16909,KOLKATA-MUMBAI,36939,All
2021,8,KOLKATA,MUMBAI,33069,23167,KOLKATA-MUMBAI,56236,All
2021,9,KOLKATA,MUMBAI,33880,26663,KOLKATA-MUMBAI,60543,All
2021,10,KOLKATA,MUMBAI,48163,41838,KOLKATA-MUMBAI,90001,All
2021,11,KOLKATA,MUMBAI,54429,54644,KOLKATA-MUMBAI,109073,All
2021,12,KOLKATA,MUMBAI,65557,63851,KOLKATA-MUMBAI,129408,All
2022,1,KOLKATA,MUMBAI,35757,28181,KOLKATA-MUMBAI,63938,All
2022,2,KOLKATA,MUMBAI,53445,50680,KOLKATA-MUMBAI,104125,All
2022,3,KOLKATA,MUMBAI,64562,61857,KOLKATA-MUMBAI,126419,All
2022,4,KOLKATA,MUMBAI,59603,67986,KOLKATA-MUMBAI,127589,All
2022,5,KOLKATA,MUMBAI,69397,68891,KOLKATA-MUMBAI,138288,All
2022,6,KOLKATA,MUMBAI,61093,58707,KOLKATA-MUMBAI,119800,All
2022,7,KOLKATA,MUMBAI,58771,60547,KOLKATA-MUMBAI,119318,All
2022,8,KOLKATA,MUMBAI,66975,61784,KOLKATA-MUMBAI,128759,All
2022,9,KOLKATA,MUMBAI,64636,67302,KOLKATA-MUMBAI,131938,All
2022,10,KOLKATA,MUMBAI,61758,71734,KOLKATA-MUMBAI,133492,All
2022,11,KOLKATA,MUMBAI,65164,63465,KOLKATA-MUMBAI,128629,All
2022,12,KOLKATA,MUMBAI,71763,74032,KOLKATA-MUMBAI,145795,All
2023,11,KOLKATA,MUMBAI,74470,83246,KOLKATA-MUMBAI,157716,All
2023,12,KOLKATA,MUMBAI,83096,82598,KOLKATA-MUMBAI,165694,All
2024,1,KOLKATA,MUMBAI,78355,79428,KOLKATA-MUMBAI,157783,All
2024,2,KOLKATA,MUMBAI,73696,76950,KOLKATA-MUMBAI,150646,All
2024,3,KOLKATA,MUMBAI,73853,78438,KOLKATA-MUMBAI,152291,All
2024,4,KOLKATA,MUMBAI,79037,92277,KOLKATA-MUMBAI,171314,All
2024,6,KOLKATA,MUMBAI,81635,80175,KOLKATA-MUMBAI,161810,All
2024,7,KOLKATA,MUMBAI,89171,77665,KOLKATA-MUMBAI,166836,All
2024,8,KOLKATA,MUMBAI,87800,76956,KOLKATA-MUMBAI,164756,All
2024,9,KOLKATA,MUMBAI,85272,84679,KOLKATA-MUMBAI,169951,All
2024,10,KOLKATA,MUMBAI,84155,103743,KOLKATA-MUMBAI,187898,All
2024,11,KOLKATA,MUMBAI,98940,98968,KOLKATA-MUMBAI,197908,All
2024,12,KOLKATA,MUMBAI,98172,101233,KOLKATA-MUMBAI,199405,All
2025,1,KOLKATA,MUMBAI,96998,97527,KOLKATA-MUMBAI,194525,All
2025,2,KOLKATA,MUMBAI,87209,90906,KOLKATA-MUMBAI,178115,All
2025,3,KOLKATA,MUMBAI,92609,101280,KOLKATA-MUMBAI,193889,All
2015,4,KOLKATA,NAGPUR,3913,4631,KOLKATA-NAGPUR,8544,All
2015,5,KOLKATA,NAGPUR,6887,7617,KOLKATA-NAGPUR,14504,All
2015,6,KOLKATA,NAGPUR,7911,6850,KOLKATA-NAGPUR,14761,All
2015,7,KOLKATA,NAGPUR,5380,5357,KOLKATA-NAGPUR,10737,All
2015,8,KOLKATA,NAGPUR,4192,4161,KOLKATA-NAGPUR,8353,All
2015,9,KOLKATA,NAGPUR,3774,4222,KOLKATA-NAGPUR,7996,All
2015,10,KOLKATA,NAGPUR,4227,4404,KOLKATA-NAGPUR,8631,All
2015,11,KOLKATA,NAGPUR,4461,4873,KOLKATA-NAGPUR,9334,All
2015,12,KOLKATA,NAGPUR,4917,5187,KOLKATA-NAGPUR,10104,All
2016,1,KOLKATA,NAGPUR,4610,4998,KOLKATA-NAGPUR,9608,All
2016,2,KOLKATA,NAGPUR,4454,4647,KOLKATA-NAGPUR,9101,All
2016,3,KOLKATA,NAGPUR,4881,5147,KOLKATA-NAGPUR,10028,All
2016,4,KOLKATA,NAGPUR,4343,4859,KOLKATA-NAGPUR,9202,All
2016,5,KOLKATA,NAGPUR,4783,4772,KOLKATA-NAGPUR,9555,All
2016,6,KOLKATA,NAGPUR,4731,4487,KOLKATA-NAGPUR,9218,All
2016,7,KOLKATA,NAGPUR,4343,4418,KOLKATA-NAGPUR,8761,All
2016,8,KOLKATA,NAGPUR,3969,4178,KOLKATA-NAGPUR,8147,All
2016,9,KOLKATA,NAGPUR,4067,4261,KOLKATA-NAGPUR,8328,All
2016,10,KOLKATA,NAGPUR,4740,5007,KOLKATA-NAGPUR,9747,All
2016,11,KOLKATA,NAGPUR,5129,4781,KOLKATA-NAGPUR,9910,All
2016,12,KOLKATA,NAGPUR,4973,5173,KOLKATA-NAGPUR,10146,All
2017,1,KOLKATA,NAGPUR,4613,4887,KOLKATA-NAGPUR,9500,All
2017,2,KOLKATA,NAGPUR,4150,4219,KOLKATA-NAGPUR,8369,All
2017,3,KOLKATA,NAGPUR,4662,4230,KOLKATA-NAGPUR,8892,All
2017,4,KOLKATA,NAGPUR,4304,4862,KOLKATA-NAGPUR,9166,All
2017,5,KOLKATA,NAGPUR,5491,5466,KOLKATA-NAGPUR,10957,All
2017,6,KOLKATA,NAGPUR,5239,4907,KOLKATA-NAGPUR,10146,All
2017,7,KOLKATA,NAGPUR,3878,3794,KOLKATA-NAGPUR,7672,All
2017,8,KOLKATA,NAGPUR,3994,4000,KOLKATA-NAGPUR,7994,All
2017,9,KOLKATA,NAGPUR,4157,4175,KOLKATA-NAGPUR,8332,All
2017,10,KOLKATA,NAGPUR,4711,5052,KOLKATA-NAGPUR,9763,All
2017,11,KOLKATA,NAGPUR,4941,4962,KOLKATA-NAGPUR,9903,All
2017,12,KOLKATA,NAGPUR,7969,5742,KOLKATA-NAGPUR,13711,All
2018,1,KOLKATA,NAGPUR,7130,5714,KOLKATA-NAGPUR,12844,All
2018,2,KOLKATA,NAGPUR,5849,4793,KOLKATA-NAGPUR,10642,All
2018,3,KOLKATA,NAGPUR,9222,9817,KOLKATA-NAGPUR,19039,All
2018,4,KOLKATA,NAGPUR,9205,11348,KOLKATA-NAGPUR,20553,All
2018,5,KOLKATA,NAGPUR,10028,9960,KOLKATA-NAGPUR,19988,All
2018,6,KOLKATA,NAGPUR,8796,8540,KOLKATA-NAGPUR,17336,All
2018,7,KOLKATA,NAGPUR,8141,7451,KOLKATA-NAGPUR,15592,All
2018,8,KOLKATA,NAGPUR,9203,9527,KOLKATA-NAGPUR,18730,All
2018,9,KOLKATA,NAGPUR,9257,10115,KOLKATA-NAGPUR,19372,All
2018,10,KOLKATA,NAGPUR,11350,12761,KOLKATA-NAGPUR,24111,All
2018,11,KOLKATA,NAGPUR,13263,13896,KOLKATA-NAGPUR,27159,All
2018,12,KOLKATA,NAGPUR,11048,11374,KOLKATA-NAGPUR,22422,All
2019,1,KOLKATA,NAGPUR,9610,10450,KOLKATA-NAGPUR,20060,All
2019,2,KOLKATA,NAGPUR,7596,8583,KOLKATA-NAGPUR,16179,All
2019,3,KOLKATA,NAGPUR,6238,6300,KOLKATA-NAGPUR,12538,All
2019,4,KOLKATA,NAGPUR,6693,8441,KOLKATA-NAGPUR,15134,All
2019,5,KOLKATA,NAGPUR,8976,8786,KOLKATA-NAGPUR,17762,All
2019,6,KOLKATA,NAGPUR,9083,8388,KOLKATA-NAGPUR,17471,All
2019,7,KOLKATA,NAGPUR,8005,8123,KOLKATA-NAGPUR,16128,All
2019,8,KOLKATA,NAGPUR,5888,6943,KOLKATA-NAGPUR,12831,All
2019,9,KOLKATA,NAGPUR,6244,7086,KOLKATA-NAGPUR,13330,All
2019,10,KOLKATA,NAGPUR,5836,7403,KOLKATA-NAGPUR,13239,All
2019,11,KOLKATA,NAGPUR,7548,7397,KOLKATA-NAGPUR,14945,All
2019,12,KOLKATA,NAGPUR,7417,7433,KOLKATA-NAGPUR,14850,All
2020,1,KOLKATA,NAGPUR,7195,7965,KOLKATA-NAGPUR,15160,All
2020,2,KOLKATA,NAGPUR,7978,8381,KOLKATA-NAGPUR,16359,All
2020,3,KOLKATA,NAGPUR,5022,6497,KOLKATA-NAGPUR,11519,All
2020,6,KOLKATA,NAGPUR,1521,1902,KOLKATA-NAGPUR,3423,All
2020,7,KOLKATA,NAGPUR,586,456,KOLKATA-NAGPUR,1042,All
2020,9,KOLKATA,NAGPUR,2436,1541,KOLKATA-NAGPUR,3977,All
2020,10,KOLKATA,NAGPUR,2107,1722,KOLKATA-NAGPUR,3829,All
2020,11,KOLKATA,NAGPUR,2325,2265,KOLKATA-NAGPUR,4590,All
2020,12,KOLKATA,NAGPUR,2096,1993,KOLKATA-NAGPUR,4089,All
2021,1,KOLKATA,NAGPUR,2593,2439,KOLKATA-NAGPUR,5032,All
2021,2,KOLKATA,NAGPUR,2033,2031,KOLKATA-NAGPUR,4064,All
2021,3,KOLKATA,NAGPUR,1680,1627,KOLKATA-NAGPUR,3307,All
2021,4,KOLKATA,NAGPUR,980,1580,KOLKATA-NAGPUR,2560,All
2021,7,KOLKATA,NAGPUR,474,547,KOLKATA-NAGPUR,1021,All
2021,8,KOLKATA,NAGPUR,1851,1823,KOLKATA-NAGPUR,3674,All
2021,9,KOLKATA,NAGPUR,1647,1550,KOLKATA-NAGPUR,3197,All
2021,10,KOLKATA,NAGPUR,1759,1787,KOLKATA-NAGPUR,3546,All
2021,11,KOLKATA,NAGPUR,2150,2124,KOLKATA-NAGPUR,4274,All
2021,12,KOLKATA,NAGPUR,2230,2075,KOLKATA-NAGPUR,4305,All
2022,1,KOLKATA,NAGPUR,1355,1082,KOLKATA-NAGPUR,2437,All
2022,2,KOLKATA,NAGPUR,2038,2696,KOLKATA-NAGPUR,4734,All
2022,3,KOLKATA,NAGPUR,2227,2394,KOLKATA-NAGPUR,4621,All
2022,4,KOLKATA,NAGPUR,3639,4313,KOLKATA-NAGPUR,7952,All
2022,5,KOLKATA,NAGPUR,4375,4842,KOLKATA-NAGPUR,9217,All
2022,6,KOLKATA,NAGPUR,4305,4403,KOLKATA-NAGPUR,8708,All
2022,7,KOLKATA,NAGPUR,3603,4072,KOLKATA-NAGPUR,7675,All
2022,8,KOLKATA,NAGPUR,3559,3396,KOLKATA-NAGPUR,6955,All
2022,9,KOLKATA,NAGPUR,3713,4122,KOLKATA-NAGPUR,7835,All
2022,10,KOLKATA,NAGPUR,4573,5242,KOLKATA-NAGPUR,9815,All
2022,11,KOLKATA,NAGPUR,6060,6384,KOLKATA-NAGPUR,12444,All
2022,12,KOLKATA,NAGPUR,4913,5317,KOLKATA-NAGPUR,10230,All
2023,1,KOLKATA,NAGPUR,4979,5822,KOLKATA-NAGPUR,10801,All
2023,2,KOLKATA,NAGPUR,4588,5018,KOLKATA-NAGPUR,9606,All
2023,3,KOLKATA,NAGPUR,5088,5378,KOLKATA-NAGPUR,10466,All
2023,4,KOLKATA,NAGPUR,5398,6034,KOLKATA-NAGPUR,11432,All
2023,5,KOLKATA,NAGPUR,6463,6726,KOLKATA-NAGPUR,13189,All
2023,6,KOLKATA,NAGPUR,5467,5690,KOLKATA-NAGPUR,11157,All
2023,7,KOLKATA,NAGPUR,4528,4673,KOLKATA-NAGPUR,9201,All
2023,8,KOLKATA,NAGPUR,4625,4927,KOLKATA-NAGPUR,9552,All
2023,9,KOLKATA,NAGPUR,4800,5227,KOLKATA-NAGPUR,10027,All
2023,10,KOLKATA,NAGPUR,5410,5839,KOLKATA-NAGPUR,11249,All
2023,11,KOLKATA,NAGPUR,6109,5719,KOLKATA-NAGPUR,11828,All
2023,12,KOLKATA,NAGPUR,6694,5786,KOLKATA-NAGPUR,12480,All
2024,1,KOLKATA,NAGPUR,6231,6125,KOLKATA-NAGPUR,12356,All
2024,2,KOLKATA,NAGPUR,5797,5436,KOLKATA-NAGPUR,11233,All
2024,3,KOLKATA,NAGPUR,6239,5793,KOLKATA-NAGPUR,12032,All
2024,4,KOLKATA,NAGPUR,4827,5134,KOLKATA-NAGPUR,9961,All
2024,6,KOLKATA,NAGPUR,4884,4964,KOLKATA-NAGPUR,9848,All
2024,7,KOLKATA,NAGPUR,5423,5319,KOLKATA-NAGPUR,10742,All
2024,8,KOLKATA,NAGPUR,5141,5096,KOLKATA-NAGPUR,10237,All
2024,9,KOLKATA,NAGPUR,4930,4823,KOLKATA-NAGPUR,9753,All
2024,10,KOLKATA,NAGPUR,4721,5090,KOLKATA-NAGPUR,9811,All
2024,11,KOLKATA,NAGPUR,5198,5317,KOLKATA-NAGPUR,10515,All
2024,12,KOLKATA,NAGPUR,5463,5475,KOLKATA-NAGPUR,10938,All
2025,1,KOLKATA,NAGPUR,5416,5522,KOLKATA-NAGPUR,10938,All
2025,2,KOLKATA,NAGPUR,4802,5006,KOLKATA-NAGPUR,9808,All
2025,3,KOLKATA,NAGPUR,5065,5284,KOLKATA-NAGPUR,10349,All
2019,1,KOLKATA,PAKYONG,1874,1653,KOLKATA-PAKYONG,3527,All
2019,2,KOLKATA,PAKYONG,835,708,KOLKATA-PAKYONG,1543,All
2019,3,KOLKATA,PAKYONG,436,355,KOLKATA-PAKYONG,791,All
2019,4,KOLKATA,PAKYONG,1415,1292,KOLKATA-PAKYONG,2707,All
2019,5,KOLKATA,PAKYONG,783,701,KOLKATA-PAKYONG,1484,All
2021,2,KOLKATA,PAKYONG,966,855,KOLKATA-PAKYONG,1821,All
2021,3,KOLKATA,PAKYONG,1811,1742,KOLKATA-PAKYONG,3553,All
2021,4,KOLKATA,PAKYONG,1353,1546,KOLKATA-PAKYONG,2899,All
2021,10,KOLKATA,PAKYONG,1310,1128,KOLKATA-PAKYONG,2438,All
2021,11,KOLKATA,PAKYONG,1984,1876,KOLKATA-PAKYONG,3860,All
2021,12,KOLKATA,PAKYONG,2180,2207,KOLKATA-PAKYONG,4387,All
2022,1,KOLKATA,PAKYONG,1474,1458,KOLKATA-PAKYONG,2932,All
2022,2,KOLKATA,PAKYONG,1579,1349,KOLKATA-PAKYONG,2928,All
2022,3,KOLKATA,PAKYONG,2039,1844,KOLKATA-PAKYONG,3883,All
2022,4,KOLKATA,PAKYONG,1259,1143,KOLKATA-PAKYONG,2402,All
2022,5,KOLKATA,PAKYONG,1007,866,KOLKATA-PAKYONG,1873,All
2022,6,KOLKATA,PAKYONG,121,136,KOLKATA-PAKYONG,257,All
2022,8,KOLKATA,PAKYONG,375,302,KOLKATA-PAKYONG,677,All
2022,9,KOLKATA,PAKYONG,536,418,KOLKATA-PAKYONG,954,All
2022,10,KOLKATA,PAKYONG,555,537,KOLKATA-PAKYONG,1092,All
2024,4,KOLKATA,PAKYONG,1615,1533,KOLKATA-PAKYONG,3148,All
2024,6,KOLKATA,PAKYONG,533,542,KOLKATA-PAKYONG,1075,All
2018,5,KOLKATA,PASIGHAT,16,11,KOLKATA-PASIGHAT,27,All
2018,6,KOLKATA,PASIGHAT,40,48,KOLKATA-PASIGHAT,88,All
2018,7,KOLKATA,PASIGHAT,34,23,KOLKATA-PASIGHAT,57,All
2018,8,KOLKATA,PASIGHAT,51,69,KOLKATA-PASIGHAT,120,All
2018,9,KOLKATA,PASIGHAT,22,20,KOLKATA-PASIGHAT,42,All
2018,10,KOLKATA,PASIGHAT,263,271,KOLKATA-PASIGHAT,534,All
2019,1,KOLKATA,PASIGHAT,17,0,KOLKATA-PASIGHAT,17,All
2019,4,KOLKATA,PASIGHAT,18,0,KOLKATA-PASIGHAT,18,All
2019,5,KOLKATA,PASIGHAT,11,0,KOLKATA-PASIGHAT,11,All
2019,6,KOLKATA,PASIGHAT,7,0,KOLKATA-PASIGHAT,7,All
2019,7,KOLKATA,PASIGHAT,5,0,KOLKATA-PASIGHAT,5,All
2019,8,KOLKATA,PASIGHAT,24,13,KOLKATA-PASIGHAT,37,All
2019,9,KOLKATA,PASIGHAT,14,14,KOLKATA-PASIGHAT,28,All
2019,10,KOLKATA,PASIGHAT,20,12,KOLKATA-PASIGHAT,32,All
2019,11,KOLKATA,PASIGHAT,28,35,KOLKATA-PASIGHAT,63,All
2019,12,KOLKATA,PASIGHAT,9,3,KOLKATA-PASIGHAT,12,All
2020,6,KOLKATA,PASIGHAT,12,0,KOLKATA-PASIGHAT,12,All
2020,7,KOLKATA,PASIGHAT,1,0,KOLKATA-PASIGHAT,1,All
2020,10,KOLKATA,PASIGHAT,14,0,KOLKATA-PASIGHAT,14,All
2020,11,KOLKATA,PASIGHAT,16,0,KOLKATA-PASIGHAT,16,All
2020,12,KOLKATA,PASIGHAT,22,0,KOLKATA-PASIGHAT,22,All
2021,1,KOLKATA,PASIGHAT,13,0,KOLKATA-PASIGHAT,13,All
2021,2,KOLKATA,PASIGHAT,24,0,KOLKATA-PASIGHAT,24,All
2021,3,KOLKATA,PASIGHAT,17,0,KOLKATA-PASIGHAT,17,All
2021,4,KOLKATA,PASIGHAT,19,0,KOLKATA-PASIGHAT,19,All
2021,6,KOLKATA,PASIGHAT,24,0,KOLKATA-PASIGHAT,24,All
2021,7,KOLKATA,PASIGHAT,18,0,KOLKATA-PASIGHAT,18,All
2021,8,KOLKATA,PASIGHAT,18,0,KOLKATA-PASIGHAT,18,All
2021,9,KOLKATA,PASIGHAT,33,0,KOLKATA-PASIGHAT,33,All
2021,10,KOLKATA,PASIGHAT,29,4,KOLKATA-PASIGHAT,33,All
2021,11,KOLKATA,PASIGHAT,0,57,KOLKATA-PASIGHAT,57,All
2021,12,KOLKATA,PASIGHAT,0,41,KOLKATA-PASIGHAT,41,All
2022,1,KOLKATA,PASIGHAT,0,64,KOLKATA-PASIGHAT,64,All
2022,2,KOLKATA,PASIGHAT,0,62,KOLKATA-PASIGHAT,62,All
2022,3,KOLKATA,PASIGHAT,0,59,KOLKATA-PASIGHAT,59,All
2022,4,KOLKATA,PASIGHAT,0,57,KOLKATA-PASIGHAT,57,All
2022,5,KOLKATA,PASIGHAT,0,41,KOLKATA-PASIGHAT,41,All
2022,6,KOLKATA,PASIGHAT,0,57,KOLKATA-PASIGHAT,57,All
2022,7,KOLKATA,PASIGHAT,0,62,KOLKATA-PASIGHAT,62,All
2022,8,KOLKATA,PASIGHAT,0,41,KOLKATA-PASIGHAT,41,All
2022,9,KOLKATA,PASIGHAT,0,57,KOLKATA-PASIGHAT,57,All
2022,10,KOLKATA,PASIGHAT,0,66,KOLKATA-PASIGHAT,66,All
2023,3,KOLKATA,PASIGHAT,6,5,KOLKATA-PASIGHAT,11,All
2015,4,KOLKATA,PATNA,9764,9315,KOLKATA-PATNA,19079,All
2015,5,KOLKATA,PATNA,7162,6569,KOLKATA-PATNA,13731,All
2015,6,KOLKATA,PATNA,7838,9300,KOLKATA-PATNA,17138,All
2015,7,KOLKATA,PATNA,9808,9635,KOLKATA-PATNA,19443,All
2015,8,KOLKATA,PATNA,8986,9284,KOLKATA-PATNA,18270,All
2015,9,KOLKATA,PATNA,9429,8840,KOLKATA-PATNA,18269,All
2015,10,KOLKATA,PATNA,9206,9312,KOLKATA-PATNA,18518,All
2015,11,KOLKATA,PATNA,10465,8831,KOLKATA-PATNA,19296,All
2015,12,KOLKATA,PATNA,9225,9249,KOLKATA-PATNA,18474,All
2016,1,KOLKATA,PATNA,9587,9521,KOLKATA-PATNA,19108,All
2016,2,KOLKATA,PATNA,10343,9769,KOLKATA-PATNA,20112,All
2016,3,KOLKATA,PATNA,10981,10490,KOLKATA-PATNA,21471,All
2016,4,KOLKATA,PATNA,5920,5842,KOLKATA-PATNA,11762,All
2016,5,KOLKATA,PATNA,6266,6409,KOLKATA-PATNA,12675,All
2016,6,KOLKATA,PATNA,6312,6500,KOLKATA-PATNA,12812,All
2016,7,KOLKATA,PATNA,6963,7165,KOLKATA-PATNA,14128,All
2016,8,KOLKATA,PATNA,6785,7207,KOLKATA-PATNA,13992,All
2016,9,KOLKATA,PATNA,6696,6868,KOLKATA-PATNA,13564,All
2016,10,KOLKATA,PATNA,7777,7753,KOLKATA-PATNA,15530,All
2016,11,KOLKATA,PATNA,11843,12640,KOLKATA-PATNA,24483,All
2016,12,KOLKATA,PATNA,12648,12495,KOLKATA-PATNA,25143,All
2017,1,KOLKATA,PATNA,13119,12554,KOLKATA-PATNA,25673,All
2017,2,KOLKATA,PATNA,12459,12471,KOLKATA-PATNA,24930,All
2017,3,KOLKATA,PATNA,12800,14350,KOLKATA-PATNA,27150,All
2017,4,KOLKATA,PATNA,13511,14887,KOLKATA-PATNA,28398,All
2017,5,KOLKATA,PATNA,15474,15613,KOLKATA-PATNA,31087,All
2017,6,KOLKATA,PATNA,11148,11544,KOLKATA-PATNA,22692,All
2017,7,KOLKATA,PATNA,13092,15706,KOLKATA-PATNA,28798,All
2017,8,KOLKATA,PATNA,14052,16096,KOLKATA-PATNA,30148,All
2017,9,KOLKATA,PATNA,13920,15494,KOLKATA-PATNA,29414,All
2017,10,KOLKATA,PATNA,18104,18832,KOLKATA-PATNA,36936,All
2017,11,KOLKATA,PATNA,16843,20865,KOLKATA-PATNA,37708,All
2017,12,KOLKATA,PATNA,15092,18150,KOLKATA-PATNA,33242,All
2018,1,KOLKATA,PATNA,15372,18572,KOLKATA-PATNA,33944,All
2018,2,KOLKATA,PATNA,18055,18228,KOLKATA-PATNA,36283,All
2018,3,KOLKATA,PATNA,20001,21930,KOLKATA-PATNA,41931,All
2018,4,KOLKATA,PATNA,19002,20147,KOLKATA-PATNA,39149,All
2018,5,KOLKATA,PATNA,20188,22148,KOLKATA-PATNA,42336,All
2018,6,KOLKATA,PATNA,19217,20899,KOLKATA-PATNA,40116,All
2018,7,KOLKATA,PATNA,20070,21933,KOLKATA-PATNA,42003,All
2018,8,KOLKATA,PATNA,21610,23742,KOLKATA-PATNA,45352,All
2018,9,KOLKATA,PATNA,20371,21672,KOLKATA-PATNA,42043,All
2018,10,KOLKATA,PATNA,23738,24300,KOLKATA-PATNA,48038,All
2018,11,KOLKATA,PATNA,20898,22647,KOLKATA-PATNA,43545,All
2018,12,KOLKATA,PATNA,17625,18421,KOLKATA-PATNA,36046,All
2019,1,KOLKATA,PATNA,18353,17750,KOLKATA-PATNA,36103,All
2019,2,KOLKATA,PATNA,19452,18206,KOLKATA-PATNA,37658,All
2019,3,KOLKATA,PATNA,20562,21654,KOLKATA-PATNA,42216,All
2019,4,KOLKATA,PATNA,25763,24236,KOLKATA-PATNA,49999,All
2019,5,KOLKATA,PATNA,27177,24985,KOLKATA-PATNA,52162,All
2019,6,KOLKATA,PATNA,27205,25843,KOLKATA-PATNA,53048,All
2019,7,KOLKATA,PATNA,26156,25940,KOLKATA-PATNA,52096,All
2019,8,KOLKATA,PATNA,27195,25381,KOLKATA-PATNA,52576,All
2019,9,KOLKATA,PATNA,18633,17986,KOLKATA-PATNA,36619,All
2019,10,KOLKATA,PATNA,30387,26486,KOLKATA-PATNA,56873,All
2019,11,KOLKATA,PATNA,29185,32768,KOLKATA-PATNA,61953,All
2019,12,KOLKATA,PATNA,21625,24578,KOLKATA-PATNA,46203,All
2020,1,KOLKATA,PATNA,20682,21534,KOLKATA-PATNA,42216,All
2020,2,KOLKATA,PATNA,20963,20295,KOLKATA-PATNA,41258,All
2020,3,KOLKATA,PATNA,21067,18666,KOLKATA-PATNA,39733,All
2020,5,KOLKATA,PATNA,0,0,KOLKATA-PATNA,0,All
2020,6,KOLKATA,PATNA,4262,3794,KOLKATA-PATNA,8056,All
2020,7,KOLKATA,PATNA,4985,4659,KOLKATA-PATNA,9644,All
2020,8,KOLKATA,PATNA,7501,8929,KOLKATA-PATNA,16430,All
2020,9,KOLKATA,PATNA,9014,13225,KOLKATA-PATNA,22239,All
2020,10,KOLKATA,PATNA,11478,12436,KOLKATA-PATNA,23914,All
2020,11,KOLKATA,PATNA,12945,11993,KOLKATA-PATNA,24938,All
2020,12,KOLKATA,PATNA,10417,14431,KOLKATA-PATNA,24848,All
2021,1,KOLKATA,PATNA,10048,13061,KOLKATA-PATNA,23109,All
2021,2,KOLKATA,PATNA,8942,9934,KOLKATA-PATNA,18876,All
2021,3,KOLKATA,PATNA,10373,8875,KOLKATA-PATNA,19248,All
2021,4,KOLKATA,PATNA,9087,7381,KOLKATA-PATNA,16468,All
2021,6,KOLKATA,PATNA,3246,3320,KOLKATA-PATNA,6566,All
2021,7,KOLKATA,PATNA,4348,5002,KOLKATA-PATNA,9350,All
2021,8,KOLKATA,PATNA,7722,7865,KOLKATA-PATNA,15587,All
2021,9,KOLKATA,PATNA,7839,6777,KOLKATA-PATNA,14616,All
2021,10,KOLKATA,PATNA,9963,9496,KOLKATA-PATNA,19459,All
2021,11,KOLKATA,PATNA,13396,13076,KOLKATA-PATNA,26472,All
2021,12,KOLKATA,PATNA,9237,11400,KOLKATA-PATNA,20637,All
2022,1,KOLKATA,PATNA,5909,5019,KOLKATA-PATNA,10928,All
2022,2,KOLKATA,PATNA,6379,6697,KOLKATA-PATNA,13076,All
2022,3,KOLKATA,PATNA,11262,10904,KOLKATA-PATNA,22166,All
2022,4,KOLKATA,PATNA,8571,7788,KOLKATA-PATNA,16359,All
2022,5,KOLKATA,PATNA,10034,10487,KOLKATA-PATNA,20521,All
2022,6,KOLKATA,PATNA,9626,11708,KOLKATA-PATNA,21334,All
2022,7,KOLKATA,PATNA,9247,10406,KOLKATA-PATNA,19653,All
2022,8,KOLKATA,PATNA,8147,9525,KOLKATA-PATNA,17672,All
2022,9,KOLKATA,PATNA,9030,10074,KOLKATA-PATNA,19104,All
2022,10,KOLKATA,PATNA,15628,12239,KOLKATA-PATNA,27867,All
2022,11,KOLKATA,PATNA,11380,12884,KOLKATA-PATNA,24264,All
2022,12,KOLKATA,PATNA,9802,10658,KOLKATA-PATNA,20460,All
2023,1,KOLKATA,PATNA,9711,9457,KOLKATA-PATNA,19168,All
2023,2,KOLKATA,PATNA,11075,9748,KOLKATA-PATNA,20823,All
2023,3,KOLKATA,PATNA,11718,13014,KOLKATA-PATNA,24732,All
2023,4,KOLKATA,PATNA,13362,12369,KOLKATA-PATNA,25731,All
2023,5,KOLKATA,PATNA,15511,14579,KOLKATA-PATNA,30090,All
2023,6,KOLKATA,PATNA,14246,15689,KOLKATA-PATNA,29935,All
2023,7,KOLKATA,PATNA,11247,12796,KOLKATA-PATNA,24043,All
2023,8,KOLKATA,PATNA,11860,11866,KOLKATA-PATNA,23726,All
2023,9,KOLKATA,PATNA,14742,15494,KOLKATA-PATNA,30236,All
2023,10,KOLKATA,PATNA,14589,14181,KOLKATA-PATNA,28770,All
2023,11,KOLKATA,PATNA,14209,13258,KOLKATA-PATNA,27467,All
2023,12,KOLKATA,PATNA,11942,13263,KOLKATA-PATNA,25205,All
2024,1,KOLKATA,PATNA,10644,10506,KOLKATA-PATNA,21150,All
2024,2,KOLKATA,PATNA,11622,11484,KOLKATA-PATNA,23106,All
2024,3,KOLKATA,PATNA,13240,13004,KOLKATA-PATNA,26244,All
2024,4,KOLKATA,PATNA,13392,12848,KOLKATA-PATNA,26240,All
2024,6,KOLKATA,PATNA,12046,12803,KOLKATA-PATNA,24849,All
2024,7,KOLKATA,PATNA,12369,13063,KOLKATA-PATNA,25432,All
2024,8,KOLKATA,PATNA,12972,13774,KOLKATA-PATNA,26746,All
2024,9,KOLKATA,PATNA,12819,12738,KOLKATA-PATNA,25557,All
2024,10,KOLKATA,PATNA,15035,12336,KOLKATA-PATNA,27371,All
2024,11,KOLKATA,PATNA,18285,17512,KOLKATA-PATNA,35797,All
2024,12,KOLKATA,PATNA,12188,13296,KOLKATA-PATNA,25484,All
2025,1,KOLKATA,PATNA,10525,10348,KOLKATA-PATNA,20873,All
2025,2,KOLKATA,PATNA,14899,14758,KOLKATA-PATNA,29657,All
2025,3,KOLKATA,PATNA,17251,16619,KOLKATA-PATNA,33870,All
2015,4,KOLKATA,PORT BLAIR,12658,16877,KOLKATA-PORT BLAIR,29535,All
2015,5,KOLKATA,PORT BLAIR,14606,16616,KOLKATA-PORT BLAIR,31222,All
2015,6,KOLKATA,PORT BLAIR,13813,11974,KOLKATA-PORT BLAIR,25787,All
2015,7,KOLKATA,PORT BLAIR,8171,7635,KOLKATA-PORT BLAIR,15806,All
2015,8,KOLKATA,PORT BLAIR,9174,8322,KOLKATA-PORT BLAIR,17496,All
2015,9,KOLKATA,PORT BLAIR,9357,8688,KOLKATA-PORT BLAIR,18045,All
2015,10,KOLKATA,PORT BLAIR,11698,12955,KOLKATA-PORT BLAIR,24653,All
2015,11,KOLKATA,PORT BLAIR,15730,16650,KOLKATA-PORT BLAIR,32380,All
2015,12,KOLKATA,PORT BLAIR,17232,16776,KOLKATA-PORT BLAIR,34008,All
2016,1,KOLKATA,PORT BLAIR,16449,16575,KOLKATA-PORT BLAIR,33024,All
2016,2,KOLKATA,PORT BLAIR,15430,16242,KOLKATA-PORT BLAIR,31672,All
2016,3,KOLKATA,PORT BLAIR,16105,17435,KOLKATA-PORT BLAIR,33540,All
2016,4,KOLKATA,PORT BLAIR,13239,17187,KOLKATA-PORT BLAIR,30426,All
2016,5,KOLKATA,PORT BLAIR,15935,17424,KOLKATA-PORT BLAIR,33359,All
2016,6,KOLKATA,PORT BLAIR,16932,15175,KOLKATA-PORT BLAIR,32107,All
2016,7,KOLKATA,PORT BLAIR,15971,12414,KOLKATA-PORT BLAIR,28385,All
2016,8,KOLKATA,PORT BLAIR,17605,16132,KOLKATA-PORT BLAIR,33737,All
2016,9,KOLKATA,PORT BLAIR,18443,18529,KOLKATA-PORT BLAIR,36972,All
2016,10,KOLKATA,PORT BLAIR,23159,23744,KOLKATA-PORT BLAIR,46903,All
2016,11,KOLKATA,PORT BLAIR,21862,21305,KOLKATA-PORT BLAIR,43167,All
2016,12,KOLKATA,PORT BLAIR,23146,22516,KOLKATA-PORT BLAIR,45662,All
2017,1,KOLKATA,PORT BLAIR,24437,26201,KOLKATA-PORT BLAIR,50638,All
2017,2,KOLKATA,PORT BLAIR,22677,24099,KOLKATA-PORT BLAIR,46776,All
2017,3,KOLKATA,PORT BLAIR,24624,26770,KOLKATA-PORT BLAIR,51394,All
2017,4,KOLKATA,PORT BLAIR,19258,24447,KOLKATA-PORT BLAIR,43705,All
2017,5,KOLKATA,PORT BLAIR,22062,26428,KOLKATA-PORT BLAIR,48490,All
2017,6,KOLKATA,PORT BLAIR,23216,20383,KOLKATA-PORT BLAIR,43599,All
2017,7,KOLKATA,PORT BLAIR,18249,14468,KOLKATA-PORT BLAIR,32717,All
2017,8,KOLKATA,PORT BLAIR,18818,17829,KOLKATA-PORT BLAIR,36647,All
2017,9,KOLKATA,PORT BLAIR,23339,22819,KOLKATA-PORT BLAIR,46158,All
2017,10,KOLKATA,PORT BLAIR,24622,26326,KOLKATA-PORT BLAIR,50948,All
2017,11,KOLKATA,PORT BLAIR,28072,27298,KOLKATA-PORT BLAIR,55370,All
2017,12,KOLKATA,PORT BLAIR,30981,30205,KOLKATA-PORT BLAIR,61186,All
2018,1,KOLKATA,PORT BLAIR,33306,35271,KOLKATA-PORT BLAIR,68577,All
2018,2,KOLKATA,PORT BLAIR,27120,29060,KOLKATA-PORT BLAIR,56180,All
2018,3,KOLKATA,PORT BLAIR,28640,30646,KOLKATA-PORT BLAIR,59286,All
2018,4,KOLKATA,PORT BLAIR,20472,28041,KOLKATA-PORT BLAIR,48513,All
2018,5,KOLKATA,PORT BLAIR,26311,28994,KOLKATA-PORT BLAIR,55305,All
2018,6,KOLKATA,PORT BLAIR,25038,24318,KOLKATA-PORT BLAIR,49356,All
2018,7,KOLKATA,PORT BLAIR,20035,14903,KOLKATA-PORT BLAIR,34938,All
2018,8,KOLKATA,PORT BLAIR,17748,17051,KOLKATA-PORT BLAIR,34799,All
2018,9,KOLKATA,PORT BLAIR,24447,24670,KOLKATA-PORT BLAIR,49117,All
2018,10,KOLKATA,PORT BLAIR,25835,27535,KOLKATA-PORT BLAIR,53370,All
2018,11,KOLKATA,PORT BLAIR,24990,26657,KOLKATA-PORT BLAIR,51647,All
2018,12,KOLKATA,PORT BLAIR,27728,27878,KOLKATA-PORT BLAIR,55606,All
2019,1,KOLKATA,PORT BLAIR,26349,29821,KOLKATA-PORT BLAIR,56170,All
2019,2,KOLKATA,PORT BLAIR,22678,24982,KOLKATA-PORT BLAIR,47660,All
2019,3,KOLKATA,PORT BLAIR,25558,27557,KOLKATA-PORT BLAIR,53115,All
2019,4,KOLKATA,PORT BLAIR,19974,25148,KOLKATA-PORT BLAIR,45122,All
2019,5,KOLKATA,PORT BLAIR,19699,22734,KOLKATA-PORT BLAIR,42433,All
2019,6,KOLKATA,PORT BLAIR,18794,17993,KOLKATA-PORT BLAIR,36787,All
2019,7,KOLKATA,PORT BLAIR,19866,16938,KOLKATA-PORT BLAIR,36804,All
2019,8,KOLKATA,PORT BLAIR,19609,20324,KOLKATA-PORT BLAIR,39933,All
2019,9,KOLKATA,PORT BLAIR,21521,23405,KOLKATA-PORT BLAIR,44926,All
2019,10,KOLKATA,PORT BLAIR,24038,25256,KOLKATA-PORT BLAIR,49294,All
2019,11,KOLKATA,PORT BLAIR,23100,26079,KOLKATA-PORT BLAIR,49179,All
2019,12,KOLKATA,PORT BLAIR,25369,27558,KOLKATA-PORT BLAIR,52927,All
2020,1,KOLKATA,PORT BLAIR,26584,30628,KOLKATA-PORT BLAIR,57212,All
2020,2,KOLKATA,PORT BLAIR,23079,25541,KOLKATA-PORT BLAIR,48620,All
2020,3,KOLKATA,PORT BLAIR,10351,14778,KOLKATA-PORT BLAIR,25129,All
2020,6,KOLKATA,PORT BLAIR,3394,6628,KOLKATA-PORT BLAIR,10022,All
2020,7,KOLKATA,PORT BLAIR,3265,5084,KOLKATA-PORT BLAIR,8349,All
2020,8,KOLKATA,PORT BLAIR,1152,1429,KOLKATA-PORT BLAIR,2581,All
2020,9,KOLKATA,PORT BLAIR,2445,3178,KOLKATA-PORT BLAIR,5623,All
2020,10,KOLKATA,PORT BLAIR,4168,4860,KOLKATA-PORT BLAIR,9028,All
2020,11,KOLKATA,PORT BLAIR,5497,6716,KOLKATA-PORT BLAIR,12213,All
2020,12,KOLKATA,PORT BLAIR,9668,7739,KOLKATA-PORT BLAIR,17407,All
2021,1,KOLKATA,PORT BLAIR,10720,10703,KOLKATA-PORT BLAIR,21423,All
2021,2,KOLKATA,PORT BLAIR,14120,15511,KOLKATA-PORT BLAIR,29631,All
2021,3,KOLKATA,PORT BLAIR,16282,19421,KOLKATA-PORT BLAIR,35703,All
2021,4,KOLKATA,PORT BLAIR,9525,13976,KOLKATA-PORT BLAIR,23501,All
2021,6,KOLKATA,PORT BLAIR,2861,4319,KOLKATA-PORT BLAIR,7180,All
2021,7,KOLKATA,PORT BLAIR,3660,5946,KOLKATA-PORT BLAIR,9606,All
2021,8,KOLKATA,PORT BLAIR,5022,6040,KOLKATA-PORT BLAIR,11062,All
2021,9,KOLKATA,PORT BLAIR,11355,7068,KOLKATA-PORT BLAIR,18423,All
2021,10,KOLKATA,PORT BLAIR,14655,15106,KOLKATA-PORT BLAIR,29761,All
2021,11,KOLKATA,PORT BLAIR,17910,17912,KOLKATA-PORT BLAIR,35822,All
2021,12,KOLKATA,PORT BLAIR,19775,19199,KOLKATA-PORT BLAIR,38974,All
2022,1,KOLKATA,PORT BLAIR,10356,13899,KOLKATA-PORT BLAIR,24255,All
2022,2,KOLKATA,PORT BLAIR,14663,12959,KOLKATA-PORT BLAIR,27622,All
2022,3,KOLKATA,PORT BLAIR,13647,14286,KOLKATA-PORT BLAIR,27933,All
2022,4,KOLKATA,PORT BLAIR,14971,19481,KOLKATA-PORT BLAIR,34452,All
2022,5,KOLKATA,PORT BLAIR,16575,20492,KOLKATA-PORT BLAIR,37067,All
2022,6,KOLKATA,PORT BLAIR,16879,16365,KOLKATA-PORT BLAIR,33244,All
2022,7,KOLKATA,PORT BLAIR,13230,11507,KOLKATA-PORT BLAIR,24737,All
2022,8,KOLKATA,PORT BLAIR,14751,12117,KOLKATA-PORT BLAIR,26868,All
2022,9,KOLKATA,PORT BLAIR,17791,17030,KOLKATA-PORT BLAIR,34821,All
2022,10,KOLKATA,PORT BLAIR,19898,21563,KOLKATA-PORT BLAIR,41461,All
2022,11,KOLKATA,PORT BLAIR,19932,19994,KOLKATA-PORT BLAIR,39926,All
2022,12,KOLKATA,PORT BLAIR,26282,25373,KOLKATA-PORT BLAIR,51655,All
2023,1,KOLKATA,PORT BLAIR,23942,27135,KOLKATA-PORT BLAIR,51077,All
2023,2,KOLKATA,PORT BLAIR,19896,22101,KOLKATA-PORT BLAIR,41997,All
2023,3,KOLKATA,PORT BLAIR,21372,22552,KOLKATA-PORT BLAIR,43924,All
2023,4,KOLKATA,PORT BLAIR,19953,25112,KOLKATA-PORT BLAIR,45065,All
2023,5,KOLKATA,PORT BLAIR,19928,22112,KOLKATA-PORT BLAIR,42040,All
2023,6,KOLKATA,PORT BLAIR,24113,23754,KOLKATA-PORT BLAIR,47867,All
2023,7,KOLKATA,PORT BLAIR,15852,12724,KOLKATA-PORT BLAIR,28576,All
2023,8,KOLKATA,PORT BLAIR,14301,13194,KOLKATA-PORT BLAIR,27495,All
2023,9,KOLKATA,PORT BLAIR,20420,18043,KOLKATA-PORT BLAIR,38463,All
2023,10,KOLKATA,PORT BLAIR,23705,25553,KOLKATA-PORT BLAIR,49258,All
2023,11,KOLKATA,PORT BLAIR,25653,27486,KOLKATA-PORT BLAIR,53139,All
2023,12,KOLKATA,PORT BLAIR,30683,29170,KOLKATA-PORT BLAIR,59853,All
2024,1,KOLKATA,PORT BLAIR,28723,30598,KOLKATA-PORT BLAIR,59321,All
2024,2,KOLKATA,PORT BLAIR,26838,27086,KOLKATA-PORT BLAIR,53924,All
2024,3,KOLKATA,PORT BLAIR,29348,28844,KOLKATA-PORT BLAIR,58192,All
2024,4,KOLKATA,PORT BLAIR,19096,25011,KOLKATA-PORT BLAIR,44107,All
2024,6,KOLKATA,PORT BLAIR,19884,18676,KOLKATA-PORT BLAIR,38560,All
2024,7,KOLKATA,PORT BLAIR,16463,11230,KOLKATA-PORT BLAIR,27693,All
2024,8,KOLKATA,PORT BLAIR,14953,12779,KOLKATA-PORT BLAIR,27732,All
2024,9,KOLKATA,PORT BLAIR,18797,16710,KOLKATA-PORT BLAIR,35507,All
2024,10,KOLKATA,PORT BLAIR,21866,23651,KOLKATA-PORT BLAIR,45517,All
2024,11,KOLKATA,PORT BLAIR,26229,23685,KOLKATA-PORT BLAIR,49914,All
2024,12,KOLKATA,PORT BLAIR,32836,29605,KOLKATA-PORT BLAIR,62441,All
2025,1,KOLKATA,PORT BLAIR,28715,30642,KOLKATA-PORT BLAIR,59357,All
2025,2,KOLKATA,PORT BLAIR,26410,27236,KOLKATA-PORT BLAIR,53646,All
2025,3,KOLKATA,PORT BLAIR,27934,27751,KOLKATA-PORT BLAIR,55685,All
2015,4,KOLKATA,PUNE,7126,7927,KOLKATA-PUNE,15053,All
2015,5,KOLKATA,PUNE,8181,8471,KOLKATA-PUNE,16652,All
2015,6,KOLKATA,PUNE,7759,6977,KOLKATA-PUNE,14736,All
2015,7,KOLKATA,PUNE,7221,7097,KOLKATA-PUNE,14318,All
2015,8,KOLKATA,PUNE,7856,7427,KOLKATA-PUNE,15283,All
2015,9,KOLKATA,PUNE,7101,7521,KOLKATA-PUNE,14622,All
2015,10,KOLKATA,PUNE,7710,8141,KOLKATA-PUNE,15851,All
2015,11,KOLKATA,PUNE,7789,8363,KOLKATA-PUNE,16152,All
2015,12,KOLKATA,PUNE,8963,8672,KOLKATA-PUNE,17635,All
2016,1,KOLKATA,PUNE,9510,9163,KOLKATA-PUNE,18673,All
2016,2,KOLKATA,PUNE,9545,9177,KOLKATA-PUNE,18722,All
2016,3,KOLKATA,PUNE,9929,9972,KOLKATA-PUNE,19901,All
2016,4,KOLKATA,PUNE,8241,9401,KOLKATA-PUNE,17642,All
2016,5,KOLKATA,PUNE,9778,9545,KOLKATA-PUNE,19323,All
2016,6,KOLKATA,PUNE,9035,7925,KOLKATA-PUNE,16960,All
2016,7,KOLKATA,PUNE,8796,8440,KOLKATA-PUNE,17236,All
2016,8,KOLKATA,PUNE,7843,7605,KOLKATA-PUNE,15448,All
2016,9,KOLKATA,PUNE,7067,7362,KOLKATA-PUNE,14429,All
2016,10,KOLKATA,PUNE,7145,7853,KOLKATA-PUNE,14998,All
2016,11,KOLKATA,PUNE,9275,8230,KOLKATA-PUNE,17505,All
2016,12,KOLKATA,PUNE,8993,8101,KOLKATA-PUNE,17094,All
2017,1,KOLKATA,PUNE,8878,8833,KOLKATA-PUNE,17711,All
2017,2,KOLKATA,PUNE,8039,7811,KOLKATA-PUNE,15850,All
2017,3,KOLKATA,PUNE,9288,9050,KOLKATA-PUNE,18338,All
2017,4,KOLKATA,PUNE,11146,12106,KOLKATA-PUNE,23252,All
2017,5,KOLKATA,PUNE,15561,14870,KOLKATA-PUNE,30431,All
2017,6,KOLKATA,PUNE,20886,19577,KOLKATA-PUNE,40463,All
2017,7,KOLKATA,PUNE,18353,17999,KOLKATA-PUNE,36352,All
2017,8,KOLKATA,PUNE,18179,19120,KOLKATA-PUNE,37299,All
2017,9,KOLKATA,PUNE,19767,22983,KOLKATA-PUNE,42750,All
2017,10,KOLKATA,PUNE,23839,24402,KOLKATA-PUNE,48241,All
2017,11,KOLKATA,PUNE,24158,24474,KOLKATA-PUNE,48632,All
2017,12,KOLKATA,PUNE,20997,20590,KOLKATA-PUNE,41587,All
2018,1,KOLKATA,PUNE,20163,19972,KOLKATA-PUNE,40135,All
2018,2,KOLKATA,PUNE,21899,22475,KOLKATA-PUNE,44374,All
2018,3,KOLKATA,PUNE,20198,20346,KOLKATA-PUNE,40544,All
2018,4,KOLKATA,PUNE,18342,20050,KOLKATA-PUNE,38392,All
2018,5,KOLKATA,PUNE,26393,24217,KOLKATA-PUNE,50610,All
2018,6,KOLKATA,PUNE,22348,21114,KOLKATA-PUNE,43462,All
2018,7,KOLKATA,PUNE,21665,19933,KOLKATA-PUNE,41598,All
2018,8,KOLKATA,PUNE,23659,26547,KOLKATA-PUNE,50206,All
2018,9,KOLKATA,PUNE,22011,22300,KOLKATA-PUNE,44311,All
2018,10,KOLKATA,PUNE,27594,30855,KOLKATA-PUNE,58449,All
2018,11,KOLKATA,PUNE,27729,30000,KOLKATA-PUNE,57729,All
2018,12,KOLKATA,PUNE,27445,29609,KOLKATA-PUNE,57054,All
2019,1,KOLKATA,PUNE,28096,28720,KOLKATA-PUNE,56816,All
2019,2,KOLKATA,PUNE,26298,26832,KOLKATA-PUNE,53130,All
2019,3,KOLKATA,PUNE,29181,29889,KOLKATA-PUNE,59070,All
2019,4,KOLKATA,PUNE,28267,31324,KOLKATA-PUNE,59591,All
2019,5,KOLKATA,PUNE,30055,29192,KOLKATA-PUNE,59247,All
2019,6,KOLKATA,PUNE,26049,23774,KOLKATA-PUNE,49823,All
2019,7,KOLKATA,PUNE,23169,21388,KOLKATA-PUNE,44557,All
2019,8,KOLKATA,PUNE,24631,23062,KOLKATA-PUNE,47693,All
2019,9,KOLKATA,PUNE,23136,23310,KOLKATA-PUNE,46446,All
2019,10,KOLKATA,PUNE,24964,25974,KOLKATA-PUNE,50938,All
2019,11,KOLKATA,PUNE,26689,24663,KOLKATA-PUNE,51352,All
2019,12,KOLKATA,PUNE,27206,25160,KOLKATA-PUNE,52366,All
2020,1,KOLKATA,PUNE,27959,25640,KOLKATA-PUNE,53599,All
2020,2,KOLKATA,PUNE,24089,22747,KOLKATA-PUNE,46836,All
2020,3,KOLKATA,PUNE,15820,20528,KOLKATA-PUNE,36348,All
2020,6,KOLKATA,PUNE,5190,9765,KOLKATA-PUNE,14955,All
2020,7,KOLKATA,PUNE,820,1606,KOLKATA-PUNE,2426,All
2020,9,KOLKATA,PUNE,10634,6962,KOLKATA-PUNE,17596,All
2020,10,KOLKATA,PUNE,10187,6878,KOLKATA-PUNE,17065,All
2020,11,KOLKATA,PUNE,9295,6125,KOLKATA-PUNE,15420,All
2020,12,KOLKATA,PUNE,8038,4395,KOLKATA-PUNE,12433,All
2021,1,KOLKATA,PUNE,10299,6591,KOLKATA-PUNE,16890,All
2021,2,KOLKATA,PUNE,10327,6788,KOLKATA-PUNE,17115,All
2021,3,KOLKATA,PUNE,7986,6023,KOLKATA-PUNE,14009,All
2021,4,KOLKATA,PUNE,3689,5290,KOLKATA-PUNE,8979,All
2021,6,KOLKATA,PUNE,3104,1212,KOLKATA-PUNE,4316,All
2021,7,KOLKATA,PUNE,4576,3272,KOLKATA-PUNE,7848,All
2021,8,KOLKATA,PUNE,5645,2636,KOLKATA-PUNE,8281,All
2021,9,KOLKATA,PUNE,5286,4072,KOLKATA-PUNE,9358,All
2021,10,KOLKATA,PUNE,4359,4352,KOLKATA-PUNE,8711,All
2021,11,KOLKATA,PUNE,11165,7749,KOLKATA-PUNE,18914,All
2021,12,KOLKATA,PUNE,10769,8182,KOLKATA-PUNE,18951,All
2022,1,KOLKATA,PUNE,5606,5498,KOLKATA-PUNE,11104,All
2022,2,KOLKATA,PUNE,6306,5946,KOLKATA-PUNE,12252,All
2022,3,KOLKATA,PUNE,7167,6719,KOLKATA-PUNE,13886,All
2022,4,KOLKATA,PUNE,9191,10359,KOLKATA-PUNE,19550,All
2022,5,KOLKATA,PUNE,11482,11461,KOLKATA-PUNE,22943,All
2022,6,KOLKATA,PUNE,12710,12358,KOLKATA-PUNE,25068,All
2022,7,KOLKATA,PUNE,11056,11804,KOLKATA-PUNE,22860,All
2022,8,KOLKATA,PUNE,12128,11515,KOLKATA-PUNE,23643,All
2022,9,KOLKATA,PUNE,11339,13287,KOLKATA-PUNE,24626,All
2022,10,KOLKATA,PUNE,16701,20843,KOLKATA-PUNE,37544,All
2022,11,KOLKATA,PUNE,22998,18772,KOLKATA-PUNE,41770,All
2022,12,KOLKATA,PUNE,22642,23839,KOLKATA-PUNE,46481,All
2023,1,KOLKATA,PUNE,25759,26828,KOLKATA-PUNE,52587,All
2023,2,KOLKATA,PUNE,22541,23034,KOLKATA-PUNE,45575,All
2023,3,KOLKATA,PUNE,19863,21151,KOLKATA-PUNE,41014,All
2023,4,KOLKATA,PUNE,13681,15226,KOLKATA-PUNE,28907,All
2023,5,KOLKATA,PUNE,14882,15599,KOLKATA-PUNE,30481,All
2023,6,KOLKATA,PUNE,14330,14949,KOLKATA-PUNE,29279,All
2023,7,KOLKATA,PUNE,13993,13827,KOLKATA-PUNE,27820,All
2023,8,KOLKATA,PUNE,13087,13885,KOLKATA-PUNE,26972,All
2023,9,KOLKATA,PUNE,11442,13072,KOLKATA-PUNE,24514,All
2023,10,KOLKATA,PUNE,11694,14696,KOLKATA-PUNE,26390,All
2023,11,KOLKATA,PUNE,13535,14887,KOLKATA-PUNE,28422,All
2023,12,KOLKATA,PUNE,14599,14997,KOLKATA-PUNE,29596,All
2024,1,KOLKATA,PUNE,14492,15099,KOLKATA-PUNE,29591,All
2024,2,KOLKATA,PUNE,13664,14333,KOLKATA-PUNE,27997,All
2024,3,KOLKATA,PUNE,14228,15244,KOLKATA-PUNE,29472,All
2024,4,KOLKATA,PUNE,12990,15042,KOLKATA-PUNE,28032,All
2024,6,KOLKATA,PUNE,18727,18275,KOLKATA-PUNE,37002,All
2024,7,KOLKATA,PUNE,19321,17228,KOLKATA-PUNE,36549,All
2024,8,KOLKATA,PUNE,17609,17518,KOLKATA-PUNE,35127,All
2024,9,KOLKATA,PUNE,15763,17814,KOLKATA-PUNE,33577,All
2024,10,KOLKATA,PUNE,18747,21158,KOLKATA-PUNE,39905,All
2024,11,KOLKATA,PUNE,20432,21685,KOLKATA-PUNE,42117,All
2024,12,KOLKATA,PUNE,20984,22997,KOLKATA-PUNE,43981,All
2025,1,KOLKATA,PUNE,20784,22854,KOLKATA-PUNE,43638,All
2025,2,KOLKATA,PUNE,18477,21173,KOLKATA-PUNE,39650,All
2025,3,KOLKATA,PUNE,20141,22745,KOLKATA-PUNE,42886,All
2015,4,KOLKATA,RAIPUR,2854,3497,KOLKATA-RAIPUR,6351,All
2015,5,KOLKATA,RAIPUR,3454,3666,KOLKATA-RAIPUR,7120,All
2015,6,KOLKATA,RAIPUR,3570,3494,KOLKATA-RAIPUR,7064,All
2015,7,KOLKATA,RAIPUR,3245,3470,KOLKATA-RAIPUR,6715,All
2015,8,KOLKATA,RAIPUR,3171,3423,KOLKATA-RAIPUR,6594,All
2015,9,KOLKATA,RAIPUR,3030,3341,KOLKATA-RAIPUR,6371,All
2015,10,KOLKATA,RAIPUR,3276,3583,KOLKATA-RAIPUR,6859,All
2015,11,KOLKATA,RAIPUR,3162,3614,KOLKATA-RAIPUR,6776,All
2015,12,KOLKATA,RAIPUR,3263,3509,KOLKATA-RAIPUR,6772,All
2016,1,KOLKATA,RAIPUR,3072,3343,KOLKATA-RAIPUR,6415,All
2016,2,KOLKATA,RAIPUR,2964,3388,KOLKATA-RAIPUR,6352,All
2016,3,KOLKATA,RAIPUR,3371,3765,KOLKATA-RAIPUR,7136,All
2016,4,KOLKATA,RAIPUR,2963,3517,KOLKATA-RAIPUR,6480,All
2016,5,KOLKATA,RAIPUR,3289,3387,KOLKATA-RAIPUR,6676,All
2016,6,KOLKATA,RAIPUR,3582,3336,KOLKATA-RAIPUR,6918,All
2016,7,KOLKATA,RAIPUR,3080,3533,KOLKATA-RAIPUR,6613,All
2016,8,KOLKATA,RAIPUR,3181,3604,KOLKATA-RAIPUR,6785,All
2016,9,KOLKATA,RAIPUR,3106,3334,KOLKATA-RAIPUR,6440,All
2016,10,KOLKATA,RAIPUR,3056,3617,KOLKATA-RAIPUR,6673,All
2016,11,KOLKATA,RAIPUR,4718,4716,KOLKATA-RAIPUR,9434,All
2016,12,KOLKATA,RAIPUR,5592,6579,KOLKATA-RAIPUR,12171,All
2017,1,KOLKATA,RAIPUR,5216,5875,KOLKATA-RAIPUR,11091,All
2017,2,KOLKATA,RAIPUR,4602,5247,KOLKATA-RAIPUR,9849,All
2017,3,KOLKATA,RAIPUR,5198,5290,KOLKATA-RAIPUR,10488,All
2017,4,KOLKATA,RAIPUR,6156,6574,KOLKATA-RAIPUR,12730,All
2017,5,KOLKATA,RAIPUR,8674,8333,KOLKATA-RAIPUR,17007,All
2017,6,KOLKATA,RAIPUR,8591,7359,KOLKATA-RAIPUR,15950,All
2017,7,KOLKATA,RAIPUR,6125,5898,KOLKATA-RAIPUR,12023,All
2017,8,KOLKATA,RAIPUR,6226,6482,KOLKATA-RAIPUR,12708,All
2017,9,KOLKATA,RAIPUR,5606,6284,KOLKATA-RAIPUR,11890,All
2017,10,KOLKATA,RAIPUR,7331,7172,KOLKATA-RAIPUR,14503,All
2017,11,KOLKATA,RAIPUR,6612,6830,KOLKATA-RAIPUR,13442,All
2017,12,KOLKATA,RAIPUR,6847,7352,KOLKATA-RAIPUR,14199,All
2018,1,KOLKATA,RAIPUR,6272,6493,KOLKATA-RAIPUR,12765,All
2018,2,KOLKATA,RAIPUR,5570,6802,KOLKATA-RAIPUR,12372,All
2018,3,KOLKATA,RAIPUR,6121,6888,KOLKATA-RAIPUR,13009,All
2018,4,KOLKATA,RAIPUR,6050,7068,KOLKATA-RAIPUR,13118,All
2018,5,KOLKATA,RAIPUR,7779,8019,KOLKATA-RAIPUR,15798,All
2018,6,KOLKATA,RAIPUR,6922,6641,KOLKATA-RAIPUR,13563,All
2018,7,KOLKATA,RAIPUR,5758,5665,KOLKATA-RAIPUR,11423,All
2018,8,KOLKATA,RAIPUR,5832,6250,KOLKATA-RAIPUR,12082,All
2018,9,KOLKATA,RAIPUR,5762,5911,KOLKATA-RAIPUR,11673,All
2018,10,KOLKATA,RAIPUR,5305,5912,KOLKATA-RAIPUR,11217,All
2018,11,KOLKATA,RAIPUR,6263,7396,KOLKATA-RAIPUR,13659,All
2018,12,KOLKATA,RAIPUR,7127,10512,KOLKATA-RAIPUR,17639,All
2019,1,KOLKATA,RAIPUR,7703,10022,KOLKATA-RAIPUR,17725,All
2019,2,KOLKATA,RAIPUR,7491,9411,KOLKATA-RAIPUR,16902,All
2019,3,KOLKATA,RAIPUR,8246,9221,KOLKATA-RAIPUR,17467,All
2019,4,KOLKATA,RAIPUR,6329,7804,KOLKATA-RAIPUR,14133,All
2019,5,KOLKATA,RAIPUR,8340,7953,KOLKATA-RAIPUR,16293,All
2019,6,KOLKATA,RAIPUR,8453,8158,KOLKATA-RAIPUR,16611,All
2019,7,KOLKATA,RAIPUR,7417,7640,KOLKATA-RAIPUR,15057,All
2019,8,KOLKATA,RAIPUR,8322,9094,KOLKATA-RAIPUR,17416,All
2019,9,KOLKATA,RAIPUR,7248,7731,KOLKATA-RAIPUR,14979,All
2019,10,KOLKATA,RAIPUR,7191,9750,KOLKATA-RAIPUR,16941,All
2019,11,KOLKATA,RAIPUR,8957,9023,KOLKATA-RAIPUR,17980,All
2019,12,KOLKATA,RAIPUR,8933,9608,KOLKATA-RAIPUR,18541,All
2020,1,KOLKATA,RAIPUR,8209,9269,KOLKATA-RAIPUR,17478,All
2020,2,KOLKATA,RAIPUR,8049,8403,KOLKATA-RAIPUR,16452,All
2020,3,KOLKATA,RAIPUR,4308,4712,KOLKATA-RAIPUR,9020,All
2020,6,KOLKATA,RAIPUR,1236,2752,KOLKATA-RAIPUR,3988,All
2020,7,KOLKATA,RAIPUR,1728,2248,KOLKATA-RAIPUR,3976,All
2020,8,KOLKATA,RAIPUR,3325,2971,KOLKATA-RAIPUR,6296,All
2020,9,KOLKATA,RAIPUR,3971,3432,KOLKATA-RAIPUR,7403,All
2020,10,KOLKATA,RAIPUR,5435,5375,KOLKATA-RAIPUR,10810,All
2020,11,KOLKATA,RAIPUR,6883,7269,KOLKATA-RAIPUR,14152,All
2020,12,KOLKATA,RAIPUR,7027,7453,KOLKATA-RAIPUR,14480,All
2021,1,KOLKATA,RAIPUR,5765,6581,KOLKATA-RAIPUR,12346,All
2021,2,KOLKATA,RAIPUR,5973,6737,KOLKATA-RAIPUR,12710,All
2021,3,KOLKATA,RAIPUR,5314,7002,KOLKATA-RAIPUR,12316,All
2021,4,KOLKATA,RAIPUR,1926,4975,KOLKATA-RAIPUR,6901,All
2021,6,KOLKATA,RAIPUR,1662,1258,KOLKATA-RAIPUR,2920,All
2021,7,KOLKATA,RAIPUR,2182,2460,KOLKATA-RAIPUR,4642,All
2021,8,KOLKATA,RAIPUR,3853,3504,KOLKATA-RAIPUR,7357,All
2021,9,KOLKATA,RAIPUR,3904,4023,KOLKATA-RAIPUR,7927,All
2021,10,KOLKATA,RAIPUR,4797,7863,KOLKATA-RAIPUR,12660,All
2021,11,KOLKATA,RAIPUR,7301,8571,KOLKATA-RAIPUR,15872,All
2021,12,KOLKATA,RAIPUR,9145,8736,KOLKATA-RAIPUR,17881,All
2022,1,KOLKATA,RAIPUR,3701,4289,KOLKATA-RAIPUR,7990,All
2022,2,KOLKATA,RAIPUR,4286,5152,KOLKATA-RAIPUR,9438,All
2022,3,KOLKATA,RAIPUR,6223,6985,KOLKATA-RAIPUR,13208,All
2022,4,KOLKATA,RAIPUR,6438,8584,KOLKATA-RAIPUR,15022,All
2022,5,KOLKATA,RAIPUR,8070,8925,KOLKATA-RAIPUR,16995,All
2022,6,KOLKATA,RAIPUR,7801,7960,KOLKATA-RAIPUR,15761,All
2022,7,KOLKATA,RAIPUR,7242,8705,KOLKATA-RAIPUR,15947,All
2022,8,KOLKATA,RAIPUR,8490,8404,KOLKATA-RAIPUR,16894,All
2022,9,KOLKATA,RAIPUR,7416,8223,KOLKATA-RAIPUR,15639,All
2022,10,KOLKATA,RAIPUR,10567,11330,KOLKATA-RAIPUR,21897,All
2022,11,KOLKATA,RAIPUR,8780,9055,KOLKATA-RAIPUR,17835,All
2022,12,KOLKATA,RAIPUR,9419,9756,KOLKATA-RAIPUR,19175,All
2023,1,KOLKATA,RAIPUR,9212,10302,KOLKATA-RAIPUR,19514,All
2023,2,KOLKATA,RAIPUR,9564,9835,KOLKATA-RAIPUR,19399,All
2023,3,KOLKATA,RAIPUR,9941,10251,KOLKATA-RAIPUR,20192,All
2023,4,KOLKATA,RAIPUR,10357,11684,KOLKATA-RAIPUR,22041,All
2023,5,KOLKATA,RAIPUR,11902,11817,KOLKATA-RAIPUR,23719,All
2023,6,KOLKATA,RAIPUR,10340,10721,KOLKATA-RAIPUR,21061,All
2023,7,KOLKATA,RAIPUR,8645,8270,KOLKATA-RAIPUR,16915,All
2023,8,KOLKATA,RAIPUR,8713,8576,KOLKATA-RAIPUR,17289,All
2023,9,KOLKATA,RAIPUR,10421,11012,KOLKATA-RAIPUR,21433,All
2023,10,KOLKATA,RAIPUR,11079,11854,KOLKATA-RAIPUR,22933,All
2023,11,KOLKATA,RAIPUR,10116,11209,KOLKATA-RAIPUR,21325,All
2023,12,KOLKATA,RAIPUR,11569,11631,KOLKATA-RAIPUR,23200,All
2024,1,KOLKATA,RAIPUR,11182,11436,KOLKATA-RAIPUR,22618,All
2024,2,KOLKATA,RAIPUR,9624,10093,KOLKATA-RAIPUR,19717,All
2024,3,KOLKATA,RAIPUR,9941,10437,KOLKATA-RAIPUR,20378,All
2024,4,KOLKATA,RAIPUR,9900,11483,KOLKATA-RAIPUR,21383,All
2024,6,KOLKATA,RAIPUR,11365,10819,KOLKATA-RAIPUR,22184,All
2024,7,KOLKATA,RAIPUR,11389,9809,KOLKATA-RAIPUR,21198,All
2024,8,KOLKATA,RAIPUR,10828,10359,KOLKATA-RAIPUR,21187,All
2024,9,KOLKATA,RAIPUR,9843,10260,KOLKATA-RAIPUR,20103,All
2024,10,KOLKATA,RAIPUR,10462,11822,KOLKATA-RAIPUR,22284,All
2024,11,KOLKATA,RAIPUR,12155,11932,KOLKATA-RAIPUR,24087,All
2024,12,KOLKATA,RAIPUR,11869,11888,KOLKATA-RAIPUR,23757,All
2025,1,KOLKATA,RAIPUR,11534,11718,KOLKATA-RAIPUR,23252,All
2025,2,KOLKATA,RAIPUR,12026,12287,KOLKATA-RAIPUR,24313,All
2025,3,KOLKATA,RAIPUR,10475,11843,KOLKATA-RAIPUR,22318,All
2015,4,KOLKATA,RANCHI,4612,4238,KOLKATA-RANCHI,8850,All
2015,5,KOLKATA,RANCHI,4865,4770,KOLKATA-RANCHI,9635,All
2015,6,KOLKATA,RANCHI,4420,4420,KOLKATA-RANCHI,8840,All
2015,7,KOLKATA,RANCHI,4984,4884,KOLKATA-RANCHI,9868,All
2015,8,KOLKATA,RANCHI,5016,5381,KOLKATA-RANCHI,10397,All
2015,9,KOLKATA,RANCHI,5200,5434,KOLKATA-RANCHI,10634,All
2015,10,KOLKATA,RANCHI,2629,2867,KOLKATA-RANCHI,5496,All
2015,11,KOLKATA,RANCHI,2104,2340,KOLKATA-RANCHI,4444,All
2015,12,KOLKATA,RANCHI,2431,2399,KOLKATA-RANCHI,4830,All
2016,1,KOLKATA,RANCHI,2463,2327,KOLKATA-RANCHI,4790,All
2016,2,KOLKATA,RANCHI,2841,2951,KOLKATA-RANCHI,5792,All
2016,3,KOLKATA,RANCHI,3175,3332,KOLKATA-RANCHI,6507,All
2016,4,KOLKATA,RANCHI,2963,2930,KOLKATA-RANCHI,5893,All
2016,5,KOLKATA,RANCHI,2955,3361,KOLKATA-RANCHI,6316,All
2016,6,KOLKATA,RANCHI,2864,2861,KOLKATA-RANCHI,5725,All
2016,7,KOLKATA,RANCHI,3115,3355,KOLKATA-RANCHI,6470,All
2016,8,KOLKATA,RANCHI,3192,3200,KOLKATA-RANCHI,6392,All
2016,9,KOLKATA,RANCHI,3378,3641,KOLKATA-RANCHI,7019,All
2016,10,KOLKATA,RANCHI,4228,4037,KOLKATA-RANCHI,8265,All
2016,11,KOLKATA,RANCHI,4023,4533,KOLKATA-RANCHI,8556,All
2016,12,KOLKATA,RANCHI,3978,4703,KOLKATA-RANCHI,8681,All
2017,1,KOLKATA,RANCHI,3920,4501,KOLKATA-RANCHI,8421,All
2017,2,KOLKATA,RANCHI,4113,4278,KOLKATA-RANCHI,8391,All
2017,3,KOLKATA,RANCHI,4164,4173,KOLKATA-RANCHI,8337,All
2017,4,KOLKATA,RANCHI,9553,9384,KOLKATA-RANCHI,18937,All
2017,5,KOLKATA,RANCHI,12328,13133,KOLKATA-RANCHI,25461,All
2017,6,KOLKATA,RANCHI,13511,13002,KOLKATA-RANCHI,26513,All
2017,7,KOLKATA,RANCHI,11534,12072,KOLKATA-RANCHI,23606,All
2017,8,KOLKATA,RANCHI,14934,14852,KOLKATA-RANCHI,29786,All
2017,9,KOLKATA,RANCHI,16056,15251,KOLKATA-RANCHI,31307,All
2017,10,KOLKATA,RANCHI,15985,16220,KOLKATA-RANCHI,32205,All
2017,11,KOLKATA,RANCHI,15981,17136,KOLKATA-RANCHI,33117,All
2017,12,KOLKATA,RANCHI,16983,19321,KOLKATA-RANCHI,36304,All
2018,1,KOLKATA,RANCHI,15467,18607,KOLKATA-RANCHI,34074,All
2018,2,KOLKATA,RANCHI,17075,17153,KOLKATA-RANCHI,34228,All
2018,3,KOLKATA,RANCHI,16994,17847,KOLKATA-RANCHI,34841,All
2018,4,KOLKATA,RANCHI,16226,17416,KOLKATA-RANCHI,33642,All
2018,5,KOLKATA,RANCHI,15579,17877,KOLKATA-RANCHI,33456,All
2018,6,KOLKATA,RANCHI,12830,13806,KOLKATA-RANCHI,26636,All
2018,7,KOLKATA,RANCHI,8986,11052,KOLKATA-RANCHI,20038,All
2018,8,KOLKATA,RANCHI,9889,10046,KOLKATA-RANCHI,19935,All
2018,9,KOLKATA,RANCHI,11746,12274,KOLKATA-RANCHI,24020,All
2018,10,KOLKATA,RANCHI,12743,13063,KOLKATA-RANCHI,25806,All
2018,11,KOLKATA,RANCHI,12300,12008,KOLKATA-RANCHI,24308,All
2018,12,KOLKATA,RANCHI,18896,15913,KOLKATA-RANCHI,34809,All
2019,1,KOLKATA,RANCHI,16826,17502,KOLKATA-RANCHI,34328,All
2019,2,KOLKATA,RANCHI,16208,13872,KOLKATA-RANCHI,30080,All
2019,3,KOLKATA,RANCHI,13529,14760,KOLKATA-RANCHI,28289,All
2019,4,KOLKATA,RANCHI,12346,14631,KOLKATA-RANCHI,26977,All
2019,5,KOLKATA,RANCHI,10018,11499,KOLKATA-RANCHI,21517,All
2019,6,KOLKATA,RANCHI,10145,11210,KOLKATA-RANCHI,21355,All
2019,7,KOLKATA,RANCHI,10785,11535,KOLKATA-RANCHI,22320,All
2019,8,KOLKATA,RANCHI,6186,6596,KOLKATA-RANCHI,12782,All
2019,9,KOLKATA,RANCHI,9166,9767,KOLKATA-RANCHI,18933,All
2019,10,KOLKATA,RANCHI,9262,9746,KOLKATA-RANCHI,19008,All
2019,11,KOLKATA,RANCHI,10354,10706,KOLKATA-RANCHI,21060,All
2019,12,KOLKATA,RANCHI,11525,12036,KOLKATA-RANCHI,23561,All
2020,1,KOLKATA,RANCHI,11156,12234,KOLKATA-RANCHI,23390,All
2020,2,KOLKATA,RANCHI,10021,10716,KOLKATA-RANCHI,20737,All
2020,3,KOLKATA,RANCHI,7366,6913,KOLKATA-RANCHI,14279,All
2020,5,KOLKATA,RANCHI,0,0,KOLKATA-RANCHI,0,All
2020,6,KOLKATA,RANCHI,0,0,KOLKATA-RANCHI,0,All
2020,9,KOLKATA,RANCHI,1080,901,KOLKATA-RANCHI,1981,All
2020,10,KOLKATA,RANCHI,2900,2081,KOLKATA-RANCHI,4981,All
2020,11,KOLKATA,RANCHI,2881,1701,KOLKATA-RANCHI,4582,All
2020,12,KOLKATA,RANCHI,2977,2818,KOLKATA-RANCHI,5795,All
2021,1,KOLKATA,RANCHI,3710,3032,KOLKATA-RANCHI,6742,All
2021,2,KOLKATA,RANCHI,4281,3043,KOLKATA-RANCHI,7324,All
2021,3,KOLKATA,RANCHI,5353,3491,KOLKATA-RANCHI,8844,All
2021,4,KOLKATA,RANCHI,3273,3924,KOLKATA-RANCHI,7197,All
2021,6,KOLKATA,RANCHI,1119,816,KOLKATA-RANCHI,1935,All
2021,7,KOLKATA,RANCHI,1763,1072,KOLKATA-RANCHI,2835,All
2021,8,KOLKATA,RANCHI,2758,1970,KOLKATA-RANCHI,4728,All
2021,9,KOLKATA,RANCHI,2713,2332,KOLKATA-RANCHI,5045,All
2021,10,KOLKATA,RANCHI,3475,3765,KOLKATA-RANCHI,7240,All
2021,11,KOLKATA,RANCHI,5320,5324,KOLKATA-RANCHI,10644,All
2021,12,KOLKATA,RANCHI,5915,5634,KOLKATA-RANCHI,11549,All
2022,1,KOLKATA,RANCHI,2965,4567,KOLKATA-RANCHI,7532,All
2022,2,KOLKATA,RANCHI,3029,3914,KOLKATA-RANCHI,6943,All
2022,3,KOLKATA,RANCHI,4776,4500,KOLKATA-RANCHI,9276,All
2022,4,KOLKATA,RANCHI,6003,5624,KOLKATA-RANCHI,11627,All
2022,5,KOLKATA,RANCHI,6106,5950,KOLKATA-RANCHI,12056,All
2022,6,KOLKATA,RANCHI,5767,5746,KOLKATA-RANCHI,11513,All
2022,7,KOLKATA,RANCHI,5885,5811,KOLKATA-RANCHI,11696,All
2022,8,KOLKATA,RANCHI,5627,5613,KOLKATA-RANCHI,11240,All
2022,9,KOLKATA,RANCHI,5782,5971,KOLKATA-RANCHI,11753,All
2022,10,KOLKATA,RANCHI,5664,5520,KOLKATA-RANCHI,11184,All
2022,11,KOLKATA,RANCHI,4647,4923,KOLKATA-RANCHI,9570,All
2022,12,KOLKATA,RANCHI,6334,6888,KOLKATA-RANCHI,13222,All
2023,1,KOLKATA,RANCHI,6603,6407,KOLKATA-RANCHI,13010,All
2023,2,KOLKATA,RANCHI,5969,6230,KOLKATA-RANCHI,12199,All
2023,3,KOLKATA,RANCHI,6800,7019,KOLKATA-RANCHI,13819,All
2023,4,KOLKATA,RANCHI,7040,7594,KOLKATA-RANCHI,14634,All
2023,5,KOLKATA,RANCHI,7336,7874,KOLKATA-RANCHI,15210,All
2023,6,KOLKATA,RANCHI,6851,6920,KOLKATA-RANCHI,13771,All
2023,7,KOLKATA,RANCHI,6875,6712,KOLKATA-RANCHI,13587,All
2023,8,KOLKATA,RANCHI,6763,6749,KOLKATA-RANCHI,13512,All
2023,9,KOLKATA,RANCHI,6631,6715,KOLKATA-RANCHI,13346,All
2023,10,KOLKATA,RANCHI,6644,6497,KOLKATA-RANCHI,13141,All
2023,11,KOLKATA,RANCHI,6181,6145,KOLKATA-RANCHI,12326,All
2023,12,KOLKATA,RANCHI,6237,6597,KOLKATA-RANCHI,12834,All
2024,1,KOLKATA,RANCHI,6132,6106,KOLKATA-RANCHI,12238,All
2024,2,KOLKATA,RANCHI,6064,5754,KOLKATA-RANCHI,11818,All
2024,3,KOLKATA,RANCHI,6103,6021,KOLKATA-RANCHI,12124,All
2024,4,KOLKATA,RANCHI,8320,8344,KOLKATA-RANCHI,16664,All
2024,6,KOLKATA,RANCHI,8432,8693,KOLKATA-RANCHI,17125,All
2024,7,KOLKATA,RANCHI,7571,8027,KOLKATA-RANCHI,15598,All
2024,8,KOLKATA,RANCHI,7622,7978,KOLKATA-RANCHI,15600,All
2024,9,KOLKATA,RANCHI,7175,7871,KOLKATA-RANCHI,15046,All
2024,10,KOLKATA,RANCHI,8345,7529,KOLKATA-RANCHI,15874,All
2024,11,KOLKATA,RANCHI,7999,9003,KOLKATA-RANCHI,17002,All
2024,12,KOLKATA,RANCHI,8673,9638,KOLKATA-RANCHI,18311,All
2025,1,KOLKATA,RANCHI,8410,9337,KOLKATA-RANCHI,17747,All
2025,2,KOLKATA,RANCHI,7977,8502,KOLKATA-RANCHI,16479,All
2025,3,KOLKATA,RANCHI,8828,9099,KOLKATA-RANCHI,17927,All
2023,1,KOLKATA,ROURKELA,0,20,KOLKATA-ROURKELA,20,All
2023,2,KOLKATA,ROURKELA,14,21,KOLKATA-ROURKELA,35,All
2023,3,KOLKATA,ROURKELA,13,11,KOLKATA-ROURKELA,24,All
2023,11,KOLKATA,ROURKELA,0,14,KOLKATA-ROURKELA,14,All
2024,1,KOLKATA,ROURKELA,33,0,KOLKATA-ROURKELA,33,All
2024,2,KOLKATA,ROURKELA,116,191,KOLKATA-ROURKELA,307,All
2024,3,KOLKATA,ROURKELA,305,389,KOLKATA-ROURKELA,694,All
2024,4,KOLKATA,ROURKELA,559,663,KOLKATA-ROURKELA,1222,All
2024,6,KOLKATA,ROURKELA,549,583,KOLKATA-ROURKELA,1132,All
2024,7,KOLKATA,ROURKELA,518,521,KOLKATA-ROURKELA,1039,All
2024,8,KOLKATA,ROURKELA,657,643,KOLKATA-ROURKELA,1300,All
2024,9,KOLKATA,ROURKELA,367,346,KOLKATA-ROURKELA,713,All
2024,10,KOLKATA,ROURKELA,480,322,KOLKATA-ROURKELA,802,All
2024,11,KOLKATA,ROURKELA,400,334,KOLKATA-ROURKELA,734,All
2024,12,KOLKATA,ROURKELA,519,618,KOLKATA-ROURKELA,1137,All
2025,1,KOLKATA,ROURKELA,295,407,KOLKATA-ROURKELA,702,All
2025,2,KOLKATA,ROURKELA,302,437,KOLKATA-ROURKELA,739,All
2025,3,KOLKATA,ROURKELA,223,316,KOLKATA-ROURKELA,539,All
2021,6,KOLKATA,RUPSI,359,649,KOLKATA-RUPSI,1008,All
2021,7,KOLKATA,RUPSI,683,824,KOLKATA-RUPSI,1507,All
2021,8,KOLKATA,RUPSI,891,996,KOLKATA-RUPSI,1887,All
2021,9,KOLKATA,RUPSI,740,775,KOLKATA-RUPSI,1515,All
2021,10,KOLKATA,RUPSI,1120,1226,KOLKATA-RUPSI,2346,All
2021,11,KOLKATA,RUPSI,1050,1149,KOLKATA-RUPSI,2199,All
2021,12,KOLKATA,RUPSI,1093,1090,KOLKATA-RUPSI,2183,All
2022,1,KOLKATA,RUPSI,620,838,KOLKATA-RUPSI,1458,All
2022,2,KOLKATA,RUPSI,1252,1304,KOLKATA-RUPSI,2556,All
2022,3,KOLKATA,RUPSI,1314,1382,KOLKATA-RUPSI,2696,All
2022,4,KOLKATA,RUPSI,1161,1230,KOLKATA-RUPSI,2391,All
2022,5,KOLKATA,RUPSI,1731,1684,KOLKATA-RUPSI,3415,All
2022,6,KOLKATA,RUPSI,936,1232,KOLKATA-RUPSI,2168,All
2022,7,KOLKATA,RUPSI,1245,1317,KOLKATA-RUPSI,2562,All
2022,8,KOLKATA,RUPSI,1024,1207,KOLKATA-RUPSI,2231,All
2022,9,KOLKATA,RUPSI,1237,1217,KOLKATA-RUPSI,2454,All
2022,10,KOLKATA,RUPSI,1387,1447,KOLKATA-RUPSI,2834,All
2022,11,KOLKATA,RUPSI,1636,1589,KOLKATA-RUPSI,3225,All
2022,12,KOLKATA,RUPSI,1537,1665,KOLKATA-RUPSI,3202,All
2023,1,KOLKATA,RUPSI,956,956,KOLKATA-RUPSI,1912,All
2023,2,KOLKATA,RUPSI,1087,1015,KOLKATA-RUPSI,2102,All
2023,3,KOLKATA,RUPSI,1626,1360,KOLKATA-RUPSI,2986,All
2023,4,KOLKATA,RUPSI,1677,1413,KOLKATA-RUPSI,3090,All
2023,5,KOLKATA,RUPSI,1586,1390,KOLKATA-RUPSI,2976,All
2023,6,KOLKATA,RUPSI,1172,1199,KOLKATA-RUPSI,2371,All
2023,7,KOLKATA,RUPSI,1109,1184,KOLKATA-RUPSI,2293,All
2023,8,KOLKATA,RUPSI,934,948,KOLKATA-RUPSI,1882,All
2023,9,KOLKATA,RUPSI,1509,1528,KOLKATA-RUPSI,3037,All
2023,10,KOLKATA,RUPSI,1285,1429,KOLKATA-RUPSI,2714,All
2023,11,KOLKATA,RUPSI,358,391,KOLKATA-RUPSI,749,All
2024,10,KOLKATA,RUPSI,170,387,KOLKATA-RUPSI,557,All
2024,11,KOLKATA,RUPSI,708,637,KOLKATA-RUPSI,1345,All
2024,12,KOLKATA,RUPSI,663,639,KOLKATA-RUPSI,1302,All
2025,1,KOLKATA,RUPSI,221,242,KOLKATA-RUPSI,463,All
2025,2,KOLKATA,RUPSI,85,109,KOLKATA-RUPSI,194,All
2025,3,KOLKATA,RUPSI,401,362,KOLKATA-RUPSI,763,All
2024,3,KOLKATA,Rajkot International Airport,12,7,KOLKATA-Rajkot International Airport,19,All
2024,4,KOLKATA,Rajkot International Airport,109,128,KOLKATA-Rajkot International Airport,237,All
2024,6,KOLKATA,Rajkot International Airport,182,134,KOLKATA-Rajkot International Airport,316,All
2024,7,KOLKATA,Rajkot International Airport,92,84,KOLKATA-Rajkot International Airport,176,All
2024,8,KOLKATA,Rajkot International Airport,58,85,KOLKATA-Rajkot International Airport,143,All
2024,9,KOLKATA,Rajkot International Airport,47,33,KOLKATA-Rajkot International Airport,80,All
2024,10,KOLKATA,Rajkot International Airport,135,154,KOLKATA-Rajkot International Airport,289,All
2024,11,KOLKATA,Rajkot International Airport,107,126,KOLKATA-Rajkot International Airport,233,All
2024,12,KOLKATA,Rajkot International Airport,143,146,KOLKATA-Rajkot International Airport,289,All
2025,3,KOLKATA,Rajkot International Airport,113,91,KOLKATA-Rajkot International Airport,204,All
2015,4,KOLKATA,SHILLONG,578,579,KOLKATA-SHILLONG,1157,All
2015,5,KOLKATA,SHILLONG,626,568,KOLKATA-SHILLONG,1194,All
2015,6,KOLKATA,SHILLONG,592,631,KOLKATA-SHILLONG,1223,All
2015,7,KOLKATA,SHILLONG,354,358,KOLKATA-SHILLONG,712,All
2015,8,KOLKATA,SHILLONG,297,157,KOLKATA-SHILLONG,454,All
2015,9,KOLKATA,SHILLONG,311,284,KOLKATA-SHILLONG,595,All
2015,10,KOLKATA,SHILLONG,679,719,KOLKATA-SHILLONG,1398,All
2015,11,KOLKATA,SHILLONG,604,670,KOLKATA-SHILLONG,1274,All
2015,12,KOLKATA,SHILLONG,231,245,KOLKATA-SHILLONG,476,All
2016,1,KOLKATA,SHILLONG,121,142,KOLKATA-SHILLONG,263,All
2016,2,KOLKATA,SHILLONG,349,326,KOLKATA-SHILLONG,675,All
2016,3,KOLKATA,SHILLONG,536,569,KOLKATA-SHILLONG,1105,All
2016,4,KOLKATA,SHILLONG,490,465,KOLKATA-SHILLONG,955,All
2016,5,KOLKATA,SHILLONG,712,558,KOLKATA-SHILLONG,1270,All
2016,6,KOLKATA,SHILLONG,636,613,KOLKATA-SHILLONG,1249,All
2016,7,KOLKATA,SHILLONG,422,475,KOLKATA-SHILLONG,897,All
2016,8,KOLKATA,SHILLONG,437,374,KOLKATA-SHILLONG,811,All
2016,9,KOLKATA,SHILLONG,652,567,KOLKATA-SHILLONG,1219,All
2016,10,KOLKATA,SHILLONG,686,691,KOLKATA-SHILLONG,1377,All
2016,11,KOLKATA,SHILLONG,610,555,KOLKATA-SHILLONG,1165,All
2016,12,KOLKATA,SHILLONG,690,607,KOLKATA-SHILLONG,1297,All
2017,1,KOLKATA,SHILLONG,583,557,KOLKATA-SHILLONG,1140,All
2017,2,KOLKATA,SHILLONG,456,449,KOLKATA-SHILLONG,905,All
2017,3,KOLKATA,SHILLONG,640,493,KOLKATA-SHILLONG,1133,All
2017,4,KOLKATA,SHILLONG,732,554,KOLKATA-SHILLONG,1286,All
2017,5,KOLKATA,SHILLONG,740,662,KOLKATA-SHILLONG,1402,All
2017,6,KOLKATA,SHILLONG,573,530,KOLKATA-SHILLONG,1103,All
2017,7,KOLKATA,SHILLONG,471,514,KOLKATA-SHILLONG,985,All
2017,8,KOLKATA,SHILLONG,543,487,KOLKATA-SHILLONG,1030,All
2017,9,KOLKATA,SHILLONG,643,547,KOLKATA-SHILLONG,1190,All
2017,10,KOLKATA,SHILLONG,592,565,KOLKATA-SHILLONG,1157,All
2017,11,KOLKATA,SHILLONG,491,493,KOLKATA-SHILLONG,984,All
2017,12,KOLKATA,SHILLONG,745,634,KOLKATA-SHILLONG,1379,All
2018,1,KOLKATA,SHILLONG,550,478,KOLKATA-SHILLONG,1028,All
2018,2,KOLKATA,SHILLONG,471,462,KOLKATA-SHILLONG,933,All
2018,3,KOLKATA,SHILLONG,780,675,KOLKATA-SHILLONG,1455,All
2018,4,KOLKATA,SHILLONG,854,730,KOLKATA-SHILLONG,1584,All
2018,5,KOLKATA,SHILLONG,1037,760,KOLKATA-SHILLONG,1797,All
2018,6,KOLKATA,SHILLONG,674,619,KOLKATA-SHILLONG,1293,All
2018,7,KOLKATA,SHILLONG,442,500,KOLKATA-SHILLONG,942,All
2018,8,KOLKATA,SHILLONG,533,471,KOLKATA-SHILLONG,1004,All
2018,9,KOLKATA,SHILLONG,626,542,KOLKATA-SHILLONG,1168,All
2018,10,KOLKATA,SHILLONG,678,589,KOLKATA-SHILLONG,1267,All
2018,11,KOLKATA,SHILLONG,538,436,KOLKATA-SHILLONG,974,All
2018,12,KOLKATA,SHILLONG,572,475,KOLKATA-SHILLONG,1047,All
2019,1,KOLKATA,SHILLONG,406,481,KOLKATA-SHILLONG,887,All
2019,2,KOLKATA,SHILLONG,218,209,KOLKATA-SHILLONG,427,All
2019,3,KOLKATA,SHILLONG,219,163,KOLKATA-SHILLONG,382,All
2019,4,KOLKATA,SHILLONG,328,178,KOLKATA-SHILLONG,506,All
2019,5,KOLKATA,SHILLONG,1109,518,KOLKATA-SHILLONG,1627,All
2019,6,KOLKATA,SHILLONG,915,589,KOLKATA-SHILLONG,1504,All
2019,7,KOLKATA,SHILLONG,1064,846,KOLKATA-SHILLONG,1910,All
2019,8,KOLKATA,SHILLONG,1483,1367,KOLKATA-SHILLONG,2850,All
2019,9,KOLKATA,SHILLONG,1421,1280,KOLKATA-SHILLONG,2701,All
2019,10,KOLKATA,SHILLONG,1682,1631,KOLKATA-SHILLONG,3313,All
2019,11,KOLKATA,SHILLONG,1818,1575,KOLKATA-SHILLONG,3393,All
2019,12,KOLKATA,SHILLONG,1628,1331,KOLKATA-SHILLONG,2959,All
2020,1,KOLKATA,SHILLONG,1832,1641,KOLKATA-SHILLONG,3473,All
2020,2,KOLKATA,SHILLONG,1846,1542,KOLKATA-SHILLONG,3388,All
2020,3,KOLKATA,SHILLONG,1379,1061,KOLKATA-SHILLONG,2440,All
2021,2,KOLKATA,SHILLONG,1239,1095,KOLKATA-SHILLONG,2334,All
2021,3,KOLKATA,SHILLONG,1552,1443,KOLKATA-SHILLONG,2995,All
2021,4,KOLKATA,SHILLONG,841,859,KOLKATA-SHILLONG,1700,All
2021,7,KOLKATA,SHILLONG,437,547,KOLKATA-SHILLONG,984,All
2021,8,KOLKATA,SHILLONG,686,809,KOLKATA-SHILLONG,1495,All
2021,9,KOLKATA,SHILLONG,1266,1118,KOLKATA-SHILLONG,2384,All
2021,10,KOLKATA,SHILLONG,1623,1385,KOLKATA-SHILLONG,3008,All
2021,11,KOLKATA,SHILLONG,1760,1476,KOLKATA-SHILLONG,3236,All
2021,12,KOLKATA,SHILLONG,2081,1723,KOLKATA-SHILLONG,3804,All
2022,1,KOLKATA,SHILLONG,1152,1046,KOLKATA-SHILLONG,2198,All
2022,2,KOLKATA,SHILLONG,1354,1378,KOLKATA-SHILLONG,2732,All
2022,3,KOLKATA,SHILLONG,1880,1767,KOLKATA-SHILLONG,3647,All
2022,4,KOLKATA,SHILLONG,1896,1368,KOLKATA-SHILLONG,3264,All
2022,5,KOLKATA,SHILLONG,1823,1320,KOLKATA-SHILLONG,3143,All
2022,6,KOLKATA,SHILLONG,1484,1089,KOLKATA-SHILLONG,2573,All
2022,7,KOLKATA,SHILLONG,1408,1312,KOLKATA-SHILLONG,2720,All
2022,8,KOLKATA,SHILLONG,1621,1434,KOLKATA-SHILLONG,3055,All
2022,9,KOLKATA,SHILLONG,1637,1268,KOLKATA-SHILLONG,2905,All
2022,10,KOLKATA,SHILLONG,1735,1659,KOLKATA-SHILLONG,3394,All
2022,11,KOLKATA,SHILLONG,1801,1437,KOLKATA-SHILLONG,3238,All
2022,12,KOLKATA,SHILLONG,1961,1554,KOLKATA-SHILLONG,3515,All
2023,1,KOLKATA,SHILLONG,1632,1383,KOLKATA-SHILLONG,3015,All
2023,2,KOLKATA,SHILLONG,1695,1367,KOLKATA-SHILLONG,3062,All
2023,3,KOLKATA,SHILLONG,1749,1509,KOLKATA-SHILLONG,3258,All
2023,4,KOLKATA,SHILLONG,1811,1227,KOLKATA-SHILLONG,3038,All
2023,5,KOLKATA,SHILLONG,1985,1356,KOLKATA-SHILLONG,3341,All
2023,6,KOLKATA,SHILLONG,1738,1306,KOLKATA-SHILLONG,3044,All
2023,7,KOLKATA,SHILLONG,1651,1323,KOLKATA-SHILLONG,2974,All
2023,8,KOLKATA,SHILLONG,1647,1254,KOLKATA-SHILLONG,2901,All
2023,9,KOLKATA,SHILLONG,1662,1190,KOLKATA-SHILLONG,2852,All
2023,10,KOLKATA,SHILLONG,2676,2266,KOLKATA-SHILLONG,4942,All
2023,11,KOLKATA,SHILLONG,3338,2987,KOLKATA-SHILLONG,6325,All
2023,12,KOLKATA,SHILLONG,3810,3114,KOLKATA-SHILLONG,6924,All
2024,1,KOLKATA,SHILLONG,3974,3740,KOLKATA-SHILLONG,7714,All
2024,2,KOLKATA,SHILLONG,3478,2904,KOLKATA-SHILLONG,6382,All
2024,3,KOLKATA,SHILLONG,3899,3210,KOLKATA-SHILLONG,7109,All
2024,4,KOLKATA,SHILLONG,2281,1520,KOLKATA-SHILLONG,3801,All
2024,6,KOLKATA,SHILLONG,2980,2574,KOLKATA-SHILLONG,5554,All
2024,7,KOLKATA,SHILLONG,2244,1889,KOLKATA-SHILLONG,4133,All
2024,8,KOLKATA,SHILLONG,1939,1573,KOLKATA-SHILLONG,3512,All
2024,9,KOLKATA,SHILLONG,1641,1187,KOLKATA-SHILLONG,2828,All
2024,10,KOLKATA,SHILLONG,2168,1739,KOLKATA-SHILLONG,3907,All
2024,11,KOLKATA,SHILLONG,3193,2442,KOLKATA-SHILLONG,5635,All
2024,12,KOLKATA,SHILLONG,3260,2465,KOLKATA-SHILLONG,5725,All
2025,1,KOLKATA,SHILLONG,3025,2522,KOLKATA-SHILLONG,5547,All
2025,2,KOLKATA,SHILLONG,2632,1913,KOLKATA-SHILLONG,4545,All
2025,3,KOLKATA,SHILLONG,2530,1829,KOLKATA-SHILLONG,4359,All
2019,9,KOLKATA,SHIRDI,1,8,KOLKATA-SHIRDI,9,All
2019,10,KOLKATA,SHIRDI,57,138,KOLKATA-SHIRDI,195,All
2019,11,KOLKATA,SHIRDI,59,29,KOLKATA-SHIRDI,88,All
2019,12,KOLKATA,SHIRDI,94,85,KOLKATA-SHIRDI,179,All
2020,1,KOLKATA,SHIRDI,85,90,KOLKATA-SHIRDI,175,All
2015,4,KOLKATA,SILCHAR,5405,5603,KOLKATA-SILCHAR,11008,All
2015,5,KOLKATA,SILCHAR,5702,5973,KOLKATA-SILCHAR,11675,All
2015,6,KOLKATA,SILCHAR,5479,5749,KOLKATA-SILCHAR,11228,All
2015,7,KOLKATA,SILCHAR,6318,6133,KOLKATA-SILCHAR,12451,All
2015,8,KOLKATA,SILCHAR,5426,5920,KOLKATA-SILCHAR,11346,All
2015,9,KOLKATA,SILCHAR,5632,5384,KOLKATA-SILCHAR,11016,All
2015,10,KOLKATA,SILCHAR,7480,6309,KOLKATA-SILCHAR,13789,All
2015,11,KOLKATA,SILCHAR,5862,6092,KOLKATA-SILCHAR,11954,All
2015,12,KOLKATA,SILCHAR,6213,5907,KOLKATA-SILCHAR,12120,All
2016,1,KOLKATA,SILCHAR,6420,6447,KOLKATA-SILCHAR,12867,All
2016,2,KOLKATA,SILCHAR,5834,5758,KOLKATA-SILCHAR,11592,All
2016,3,KOLKATA,SILCHAR,5598,5880,KOLKATA-SILCHAR,11478,All
2016,4,KOLKATA,SILCHAR,4630,4219,KOLKATA-SILCHAR,8849,All
2016,5,KOLKATA,SILCHAR,5120,4369,KOLKATA-SILCHAR,9489,All
2016,6,KOLKATA,SILCHAR,4565,4049,KOLKATA-SILCHAR,8614,All
2016,7,KOLKATA,SILCHAR,5032,4192,KOLKATA-SILCHAR,9224,All
2016,8,KOLKATA,SILCHAR,4171,4308,KOLKATA-SILCHAR,8479,All
2016,9,KOLKATA,SILCHAR,4277,4100,KOLKATA-SILCHAR,8377,All
2016,10,KOLKATA,SILCHAR,6433,5778,KOLKATA-SILCHAR,12211,All
2016,11,KOLKATA,SILCHAR,6677,6854,KOLKATA-SILCHAR,13531,All
2016,12,KOLKATA,SILCHAR,7495,7613,KOLKATA-SILCHAR,15108,All
2017,1,KOLKATA,SILCHAR,7845,7227,KOLKATA-SILCHAR,15072,All
2017,2,KOLKATA,SILCHAR,6642,6603,KOLKATA-SILCHAR,13245,All
2017,3,KOLKATA,SILCHAR,7926,8009,KOLKATA-SILCHAR,15935,All
2017,4,KOLKATA,SILCHAR,8091,8502,KOLKATA-SILCHAR,16593,All
2017,5,KOLKATA,SILCHAR,8812,8512,KOLKATA-SILCHAR,17324,All
2017,6,KOLKATA,SILCHAR,8070,8852,KOLKATA-SILCHAR,16922,All
2017,7,KOLKATA,SILCHAR,10225,10311,KOLKATA-SILCHAR,20536,All
2017,8,KOLKATA,SILCHAR,10893,10605,KOLKATA-SILCHAR,21498,All
2017,9,KOLKATA,SILCHAR,10652,10119,KOLKATA-SILCHAR,20771,All
2017,10,KOLKATA,SILCHAR,9079,10038,KOLKATA-SILCHAR,19117,All
2017,11,KOLKATA,SILCHAR,8739,9598,KOLKATA-SILCHAR,18337,All
2017,12,KOLKATA,SILCHAR,11032,10857,KOLKATA-SILCHAR,21889,All
2018,1,KOLKATA,SILCHAR,11302,11413,KOLKATA-SILCHAR,22715,All
2018,2,KOLKATA,SILCHAR,9906,10165,KOLKATA-SILCHAR,20071,All
2018,3,KOLKATA,SILCHAR,9947,10476,KOLKATA-SILCHAR,20423,All
2018,4,KOLKATA,SILCHAR,8266,8562,KOLKATA-SILCHAR,16828,All
2018,5,KOLKATA,SILCHAR,8726,8331,KOLKATA-SILCHAR,17057,All
2018,6,KOLKATA,SILCHAR,7520,8181,KOLKATA-SILCHAR,15701,All
2018,7,KOLKATA,SILCHAR,9119,8939,KOLKATA-SILCHAR,18058,All
2018,8,KOLKATA,SILCHAR,8180,8543,KOLKATA-SILCHAR,16723,All
2018,9,KOLKATA,SILCHAR,7868,7632,KOLKATA-SILCHAR,15500,All
2018,10,KOLKATA,SILCHAR,8567,8338,KOLKATA-SILCHAR,16905,All
2018,11,KOLKATA,SILCHAR,8210,8225,KOLKATA-SILCHAR,16435,All
2018,12,KOLKATA,SILCHAR,8592,8267,KOLKATA-SILCHAR,16859,All
2019,1,KOLKATA,SILCHAR,8975,8923,KOLKATA-SILCHAR,17898,All
2019,2,KOLKATA,SILCHAR,7943,7952,KOLKATA-SILCHAR,15895,All
2019,3,KOLKATA,SILCHAR,9191,8883,KOLKATA-SILCHAR,18074,All
2019,4,KOLKATA,SILCHAR,8119,8000,KOLKATA-SILCHAR,16119,All
2019,5,KOLKATA,SILCHAR,8271,7715,KOLKATA-SILCHAR,15986,All
2019,6,KOLKATA,SILCHAR,9470,10493,KOLKATA-SILCHAR,19963,All
2019,7,KOLKATA,SILCHAR,10874,10986,KOLKATA-SILCHAR,21860,All
2019,8,KOLKATA,SILCHAR,10155,10521,KOLKATA-SILCHAR,20676,All
2019,9,KOLKATA,SILCHAR,11698,11369,KOLKATA-SILCHAR,23067,All
2019,10,KOLKATA,SILCHAR,13208,14255,KOLKATA-SILCHAR,27463,All
2019,11,KOLKATA,SILCHAR,11739,12471,KOLKATA-SILCHAR,24210,All
2019,12,KOLKATA,SILCHAR,13392,13031,KOLKATA-SILCHAR,26423,All
2020,1,KOLKATA,SILCHAR,13113,12790,KOLKATA-SILCHAR,25903,All
2020,2,KOLKATA,SILCHAR,11856,11563,KOLKATA-SILCHAR,23419,All
2020,3,KOLKATA,SILCHAR,9290,8223,KOLKATA-SILCHAR,17513,All
2020,6,KOLKATA,SILCHAR,4154,3046,KOLKATA-SILCHAR,7200,All
2020,7,KOLKATA,SILCHAR,4607,2380,KOLKATA-SILCHAR,6987,All
2020,8,KOLKATA,SILCHAR,3710,3174,KOLKATA-SILCHAR,6884,All
2020,9,KOLKATA,SILCHAR,5077,5567,KOLKATA-SILCHAR,10644,All
2020,10,KOLKATA,SILCHAR,5768,6871,KOLKATA-SILCHAR,12639,All
2020,11,KOLKATA,SILCHAR,6746,8621,KOLKATA-SILCHAR,15367,All
2020,12,KOLKATA,SILCHAR,8829,8922,KOLKATA-SILCHAR,17751,All
2021,1,KOLKATA,SILCHAR,9526,10033,KOLKATA-SILCHAR,19559,All
2021,2,KOLKATA,SILCHAR,8905,10369,KOLKATA-SILCHAR,19274,All
2021,3,KOLKATA,SILCHAR,8959,9324,KOLKATA-SILCHAR,18283,All
2021,4,KOLKATA,SILCHAR,7756,7427,KOLKATA-SILCHAR,15183,All
2021,6,KOLKATA,SILCHAR,4112,5279,KOLKATA-SILCHAR,9391,All
2021,7,KOLKATA,SILCHAR,3729,5143,KOLKATA-SILCHAR,8872,All
2021,8,KOLKATA,SILCHAR,7297,11190,KOLKATA-SILCHAR,18487,All
2021,9,KOLKATA,SILCHAR,8338,10346,KOLKATA-SILCHAR,18684,All
2021,10,KOLKATA,SILCHAR,11335,11703,KOLKATA-SILCHAR,23038,All
2021,11,KOLKATA,SILCHAR,10988,11480,KOLKATA-SILCHAR,22468,All
2021,12,KOLKATA,SILCHAR,14570,13834,KOLKATA-SILCHAR,28404,All
2022,1,KOLKATA,SILCHAR,12358,9207,KOLKATA-SILCHAR,21565,All
2022,2,KOLKATA,SILCHAR,10127,10329,KOLKATA-SILCHAR,20456,All
2022,3,KOLKATA,SILCHAR,11109,11947,KOLKATA-SILCHAR,23056,All
2022,4,KOLKATA,SILCHAR,8867,8442,KOLKATA-SILCHAR,17309,All
2022,5,KOLKATA,SILCHAR,9195,10028,KOLKATA-SILCHAR,19223,All
2022,6,KOLKATA,SILCHAR,8550,10293,KOLKATA-SILCHAR,18843,All
2022,7,KOLKATA,SILCHAR,9639,9471,KOLKATA-SILCHAR,19110,All
2022,8,KOLKATA,SILCHAR,7897,8891,KOLKATA-SILCHAR,16788,All
2022,9,KOLKATA,SILCHAR,9157,9303,KOLKATA-SILCHAR,18460,All
2022,10,KOLKATA,SILCHAR,9653,9733,KOLKATA-SILCHAR,19386,All
2022,11,KOLKATA,SILCHAR,9442,8873,KOLKATA-SILCHAR,18315,All
2022,12,KOLKATA,SILCHAR,11967,10794,KOLKATA-SILCHAR,22761,All
2023,1,KOLKATA,SILCHAR,12520,10439,KOLKATA-SILCHAR,22959,All
2023,2,KOLKATA,SILCHAR,9755,9946,KOLKATA-SILCHAR,19701,All
2023,3,KOLKATA,SILCHAR,10052,9943,KOLKATA-SILCHAR,19995,All
2023,4,KOLKATA,SILCHAR,10360,9705,KOLKATA-SILCHAR,20065,All
2023,5,KOLKATA,SILCHAR,11361,10736,KOLKATA-SILCHAR,22097,All
2023,6,KOLKATA,SILCHAR,9327,9889,KOLKATA-SILCHAR,19216,All
2023,7,KOLKATA,SILCHAR,11039,11040,KOLKATA-SILCHAR,22079,All
2023,8,KOLKATA,SILCHAR,10189,11087,KOLKATA-SILCHAR,21276,All
2023,9,KOLKATA,SILCHAR,10635,11010,KOLKATA-SILCHAR,21645,All
2023,10,KOLKATA,SILCHAR,11717,11476,KOLKATA-SILCHAR,23193,All
2023,11,KOLKATA,SILCHAR,11164,11436,KOLKATA-SILCHAR,22600,All
2023,12,KOLKATA,SILCHAR,12769,11034,KOLKATA-SILCHAR,23803,All
2024,1,KOLKATA,SILCHAR,12045,10563,KOLKATA-SILCHAR,22608,All
2024,2,KOLKATA,SILCHAR,10740,10216,KOLKATA-SILCHAR,20956,All
2024,3,KOLKATA,SILCHAR,11768,11307,KOLKATA-SILCHAR,23075,All
2024,4,KOLKATA,SILCHAR,10443,9686,KOLKATA-SILCHAR,20129,All
2024,6,KOLKATA,SILCHAR,10519,11618,KOLKATA-SILCHAR,22137,All
2024,7,KOLKATA,SILCHAR,12938,13345,KOLKATA-SILCHAR,26283,All
2024,8,KOLKATA,SILCHAR,11935,12741,KOLKATA-SILCHAR,24676,All
2024,9,KOLKATA,SILCHAR,12363,11321,KOLKATA-SILCHAR,23684,All
2024,10,KOLKATA,SILCHAR,15785,14850,KOLKATA-SILCHAR,30635,All
2024,11,KOLKATA,SILCHAR,15392,14312,KOLKATA-SILCHAR,29704,All
2024,12,KOLKATA,SILCHAR,15421,14353,KOLKATA-SILCHAR,29774,All
2025,1,KOLKATA,SILCHAR,15321,14335,KOLKATA-SILCHAR,29656,All
2025,2,KOLKATA,SILCHAR,13954,13369,KOLKATA-SILCHAR,27323,All
2025,3,KOLKATA,SILCHAR,15050,14370,KOLKATA-SILCHAR,29420,All
2015,8,KOLKATA,SRINAGAR,138,0,KOLKATA-SRINAGAR,138,All
2015,9,KOLKATA,SRINAGAR,195,0,KOLKATA-SRINAGAR,195,All
2015,10,KOLKATA,SRINAGAR,374,34,KOLKATA-SRINAGAR,408,All
2016,11,KOLKATA,SRINAGAR,0,1,KOLKATA-SRINAGAR,1,All
2017,4,KOLKATA,SRINAGAR,424,1318,KOLKATA-SRINAGAR,1742,All
2017,5,KOLKATA,SRINAGAR,1036,3089,KOLKATA-SRINAGAR,4125,All
2017,6,KOLKATA,SRINAGAR,501,1884,KOLKATA-SRINAGAR,2385,All
2017,7,KOLKATA,SRINAGAR,0,448,KOLKATA-SRINAGAR,448,All
2017,8,KOLKATA,SRINAGAR,0,156,KOLKATA-SRINAGAR,156,All
2017,9,KOLKATA,SRINAGAR,0,267,KOLKATA-SRINAGAR,267,All
2017,10,KOLKATA,SRINAGAR,0,433,KOLKATA-SRINAGAR,433,All
2017,11,KOLKATA,SRINAGAR,47,0,KOLKATA-SRINAGAR,47,All
2017,12,KOLKATA,SRINAGAR,79,0,KOLKATA-SRINAGAR,79,All
2018,1,KOLKATA,SRINAGAR,54,0,KOLKATA-SRINAGAR,54,All
2018,2,KOLKATA,SRINAGAR,51,0,KOLKATA-SRINAGAR,51,All
2018,3,KOLKATA,SRINAGAR,105,84,KOLKATA-SRINAGAR,189,All
2018,4,KOLKATA,SRINAGAR,153,311,KOLKATA-SRINAGAR,464,All
2018,5,KOLKATA,SRINAGAR,145,302,KOLKATA-SRINAGAR,447,All
2018,6,KOLKATA,SRINAGAR,170,249,KOLKATA-SRINAGAR,419,All
2018,7,KOLKATA,SRINAGAR,645,562,KOLKATA-SRINAGAR,1207,All
2018,8,KOLKATA,SRINAGAR,1609,1792,KOLKATA-SRINAGAR,3401,All
2018,9,KOLKATA,SRINAGAR,1150,1380,KOLKATA-SRINAGAR,2530,All
2018,10,KOLKATA,SRINAGAR,963,1918,KOLKATA-SRINAGAR,2881,All
2018,11,KOLKATA,SRINAGAR,1414,2084,KOLKATA-SRINAGAR,3498,All
2018,12,KOLKATA,SRINAGAR,1503,1412,KOLKATA-SRINAGAR,2915,All
2019,1,KOLKATA,SRINAGAR,1130,1247,KOLKATA-SRINAGAR,2377,All
2019,2,KOLKATA,SRINAGAR,1267,1241,KOLKATA-SRINAGAR,2508,All
2019,3,KOLKATA,SRINAGAR,1874,1359,KOLKATA-SRINAGAR,3233,All
2019,4,KOLKATA,SRINAGAR,1964,1434,KOLKATA-SRINAGAR,3398,All
2019,5,KOLKATA,SRINAGAR,1684,1131,KOLKATA-SRINAGAR,2815,All
2019,6,KOLKATA,SRINAGAR,2107,1684,KOLKATA-SRINAGAR,3791,All
2019,7,KOLKATA,SRINAGAR,2361,2273,KOLKATA-SRINAGAR,4634,All
2019,8,KOLKATA,SRINAGAR,769,666,KOLKATA-SRINAGAR,1435,All
2019,9,KOLKATA,SRINAGAR,580,868,KOLKATA-SRINAGAR,1448,All
2019,10,KOLKATA,SRINAGAR,827,1006,KOLKATA-SRINAGAR,1833,All
2019,11,KOLKATA,SRINAGAR,738,1154,KOLKATA-SRINAGAR,1892,All
2019,12,KOLKATA,SRINAGAR,315,193,KOLKATA-SRINAGAR,508,All
2020,1,KOLKATA,SRINAGAR,380,142,KOLKATA-SRINAGAR,522,All
2020,2,KOLKATA,SRINAGAR,1110,691,KOLKATA-SRINAGAR,1801,All
2020,3,KOLKATA,SRINAGAR,1659,806,KOLKATA-SRINAGAR,2465,All
2020,5,KOLKATA,SRINAGAR,79,0,KOLKATA-SRINAGAR,79,All
2020,6,KOLKATA,SRINAGAR,513,42,KOLKATA-SRINAGAR,555,All
2020,7,KOLKATA,SRINAGAR,33,0,KOLKATA-SRINAGAR,33,All
2020,9,KOLKATA,SRINAGAR,539,0,KOLKATA-SRINAGAR,539,All
2020,10,KOLKATA,SRINAGAR,430,0,KOLKATA-SRINAGAR,430,All
2020,11,KOLKATA,SRINAGAR,480,0,KOLKATA-SRINAGAR,480,All
2020,12,KOLKATA,SRINAGAR,465,0,KOLKATA-SRINAGAR,465,All
2021,1,KOLKATA,SRINAGAR,235,0,KOLKATA-SRINAGAR,235,All
2021,3,KOLKATA,SRINAGAR,536,245,KOLKATA-SRINAGAR,781,All
2021,4,KOLKATA,SRINAGAR,2689,2628,KOLKATA-SRINAGAR,5317,All
2021,6,KOLKATA,SRINAGAR,345,228,KOLKATA-SRINAGAR,573,All
2021,7,KOLKATA,SRINAGAR,1020,930,KOLKATA-SRINAGAR,1950,All
2021,8,KOLKATA,SRINAGAR,1141,638,KOLKATA-SRINAGAR,1779,All
2021,9,KOLKATA,SRINAGAR,979,635,KOLKATA-SRINAGAR,1614,All
2021,10,KOLKATA,SRINAGAR,856,1381,KOLKATA-SRINAGAR,2237,All
2021,11,KOLKATA,SRINAGAR,301,439,KOLKATA-SRINAGAR,740,All
2021,12,KOLKATA,SRINAGAR,467,684,KOLKATA-SRINAGAR,1151,All
2022,1,KOLKATA,SRINAGAR,319,582,KOLKATA-SRINAGAR,901,All
2022,2,KOLKATA,SRINAGAR,367,480,KOLKATA-SRINAGAR,847,All
2022,3,KOLKATA,SRINAGAR,1121,904,KOLKATA-SRINAGAR,2025,All
2022,4,KOLKATA,SRINAGAR,2622,2084,KOLKATA-SRINAGAR,4706,All
2022,5,KOLKATA,SRINAGAR,2577,1905,KOLKATA-SRINAGAR,4482,All
2022,6,KOLKATA,SRINAGAR,1920,1472,KOLKATA-SRINAGAR,3392,All
2022,7,KOLKATA,SRINAGAR,2245,1545,KOLKATA-SRINAGAR,3790,All
2022,8,KOLKATA,SRINAGAR,1179,1146,KOLKATA-SRINAGAR,2325,All
2022,9,KOLKATA,SRINAGAR,810,956,KOLKATA-SRINAGAR,1766,All
2022,10,KOLKATA,SRINAGAR,1040,1783,KOLKATA-SRINAGAR,2823,All
2022,11,KOLKATA,SRINAGAR,773,1825,KOLKATA-SRINAGAR,2598,All
2022,12,KOLKATA,SRINAGAR,706,1584,KOLKATA-SRINAGAR,2290,All
2023,1,KOLKATA,SRINAGAR,544,1295,KOLKATA-SRINAGAR,1839,All
2023,2,KOLKATA,SRINAGAR,1004,718,KOLKATA-SRINAGAR,1722,All
2023,3,KOLKATA,SRINAGAR,2687,1929,KOLKATA-SRINAGAR,4616,All
2023,4,KOLKATA,SRINAGAR,2606,1550,KOLKATA-SRINAGAR,4156,All
2023,5,KOLKATA,SRINAGAR,3381,2397,KOLKATA-SRINAGAR,5778,All
2023,6,KOLKATA,SRINAGAR,2398,1707,KOLKATA-SRINAGAR,4105,All
2023,7,KOLKATA,SRINAGAR,2199,2065,KOLKATA-SRINAGAR,4264,All
2023,8,KOLKATA,SRINAGAR,1594,1664,KOLKATA-SRINAGAR,3258,All
2023,9,KOLKATA,SRINAGAR,1767,1716,KOLKATA-SRINAGAR,3483,All
2023,10,KOLKATA,SRINAGAR,1961,1755,KOLKATA-SRINAGAR,3716,All
2023,11,KOLKATA,SRINAGAR,1816,2441,KOLKATA-SRINAGAR,4257,All
2023,12,KOLKATA,SRINAGAR,1770,1844,KOLKATA-SRINAGAR,3614,All
2024,1,KOLKATA,SRINAGAR,1107,1704,KOLKATA-SRINAGAR,2811,All
2024,2,KOLKATA,SRINAGAR,1096,1409,KOLKATA-SRINAGAR,2505,All
2024,3,KOLKATA,SRINAGAR,2041,1793,KOLKATA-SRINAGAR,3834,All
2024,4,KOLKATA,SRINAGAR,6026,5138,KOLKATA-SRINAGAR,11164,All
2024,6,KOLKATA,SRINAGAR,5935,5132,KOLKATA-SRINAGAR,11067,All
2024,7,KOLKATA,SRINAGAR,5516,4362,KOLKATA-SRINAGAR,9878,All
2024,8,KOLKATA,SRINAGAR,3769,2888,KOLKATA-SRINAGAR,6657,All
2024,9,KOLKATA,SRINAGAR,3587,2848,KOLKATA-SRINAGAR,6435,All
2024,10,KOLKATA,SRINAGAR,4033,4232,KOLKATA-SRINAGAR,8265,All
2024,11,KOLKATA,SRINAGAR,1871,1674,KOLKATA-SRINAGAR,3545,All
2024,12,KOLKATA,SRINAGAR,4978,5513,KOLKATA-SRINAGAR,10491,All
2025,1,KOLKATA,SRINAGAR,5050,4683,KOLKATA-SRINAGAR,9733,All
2025,2,KOLKATA,SRINAGAR,4570,3960,KOLKATA-SRINAGAR,8530,All
2025,3,KOLKATA,SRINAGAR,6342,5627,KOLKATA-SRINAGAR,11969,All
2017,7,KOLKATA,SURAT,3980,4125,KOLKATA-SURAT,8105,All
2017,8,KOLKATA,SURAT,4503,4616,KOLKATA-SURAT,9119,All
2017,9,KOLKATA,SURAT,3917,4099,KOLKATA-SURAT,8016,All
2017,10,KOLKATA,SURAT,3617,4469,KOLKATA-SURAT,8086,All
2017,11,KOLKATA,SURAT,4771,3994,KOLKATA-SURAT,8765,All
2017,12,KOLKATA,SURAT,5288,4575,KOLKATA-SURAT,9863,All
2018,1,KOLKATA,SURAT,4772,4757,KOLKATA-SURAT,9529,All
2018,2,KOLKATA,SURAT,4232,4241,KOLKATA-SURAT,8473,All
2018,3,KOLKATA,SURAT,3914,3960,KOLKATA-SURAT,7874,All
2018,4,KOLKATA,SURAT,4068,3974,KOLKATA-SURAT,8042,All
2018,5,KOLKATA,SURAT,5194,4201,KOLKATA-SURAT,9395,All
2018,6,KOLKATA,SURAT,4896,4479,KOLKATA-SURAT,9375,All
2018,7,KOLKATA,SURAT,4784,4365,KOLKATA-SURAT,9149,All
2018,8,KOLKATA,SURAT,4755,5389,KOLKATA-SURAT,10144,All
2018,9,KOLKATA,SURAT,6946,6576,KOLKATA-SURAT,13522,All
2018,10,KOLKATA,SURAT,7496,8879,KOLKATA-SURAT,16375,All
2018,11,KOLKATA,SURAT,8674,8993,KOLKATA-SURAT,17667,All
2018,12,KOLKATA,SURAT,9390,9432,KOLKATA-SURAT,18822,All
2019,1,KOLKATA,SURAT,9024,10064,KOLKATA-SURAT,19088,All
2019,2,KOLKATA,SURAT,9127,9388,KOLKATA-SURAT,18515,All
2019,3,KOLKATA,SURAT,9944,10458,KOLKATA-SURAT,20402,All
2019,4,KOLKATA,SURAT,9128,9790,KOLKATA-SURAT,18918,All
2019,5,KOLKATA,SURAT,9804,9424,KOLKATA-SURAT,19228,All
2019,6,KOLKATA,SURAT,9730,9169,KOLKATA-SURAT,18899,All
2019,7,KOLKATA,SURAT,8322,7633,KOLKATA-SURAT,15955,All
2019,8,KOLKATA,SURAT,6783,7550,KOLKATA-SURAT,14333,All
2019,9,KOLKATA,SURAT,796,879,KOLKATA-SURAT,1675,All
2019,10,KOLKATA,SURAT,7462,10080,KOLKATA-SURAT,17542,All
2019,11,KOLKATA,SURAT,9731,8147,KOLKATA-SURAT,17878,All
2019,12,KOLKATA,SURAT,8522,7869,KOLKATA-SURAT,16391,All
2020,1,KOLKATA,SURAT,7264,8054,KOLKATA-SURAT,15318,All
2020,2,KOLKATA,SURAT,6206,6397,KOLKATA-SURAT,12603,All
2020,3,KOLKATA,SURAT,2214,2345,KOLKATA-SURAT,4559,All
2020,5,KOLKATA,SURAT,0,0,KOLKATA-SURAT,0,All
2020,6,KOLKATA,SURAT,0,0,KOLKATA-SURAT,0,All
2020,9,KOLKATA,SURAT,7118,3209,KOLKATA-SURAT,10327,All
2020,10,KOLKATA,SURAT,8057,4513,KOLKATA-SURAT,12570,All
2020,11,KOLKATA,SURAT,7807,7976,KOLKATA-SURAT,15783,All
2020,12,KOLKATA,SURAT,8432,6658,KOLKATA-SURAT,15090,All
2021,1,KOLKATA,SURAT,6615,6257,KOLKATA-SURAT,12872,All
2021,2,KOLKATA,SURAT,7274,6870,KOLKATA-SURAT,14144,All
2021,3,KOLKATA,SURAT,6380,7016,KOLKATA-SURAT,13396,All
2021,4,KOLKATA,SURAT,919,1041,KOLKATA-SURAT,1960,All
2021,6,KOLKATA,SURAT,2579,1690,KOLKATA-SURAT,4269,All
2021,7,KOLKATA,SURAT,4049,3462,KOLKATA-SURAT,7511,All
2021,8,KOLKATA,SURAT,4903,4081,KOLKATA-SURAT,8984,All
2021,9,KOLKATA,SURAT,4257,4172,KOLKATA-SURAT,8429,All
2021,10,KOLKATA,SURAT,4830,5389,KOLKATA-SURAT,10219,All
2021,11,KOLKATA,SURAT,7280,6658,KOLKATA-SURAT,13938,All
2021,12,KOLKATA,SURAT,7302,7128,KOLKATA-SURAT,14430,All
2022,1,KOLKATA,SURAT,3548,3913,KOLKATA-SURAT,7461,All
2022,2,KOLKATA,SURAT,3672,3869,KOLKATA-SURAT,7541,All
2022,3,KOLKATA,SURAT,5430,5413,KOLKATA-SURAT,10843,All
2022,4,KOLKATA,SURAT,4090,4394,KOLKATA-SURAT,8484,All
2022,5,KOLKATA,SURAT,8140,6899,KOLKATA-SURAT,15039,All
2022,6,KOLKATA,SURAT,7510,5999,KOLKATA-SURAT,13509,All
2022,7,KOLKATA,SURAT,5726,5502,KOLKATA-SURAT,11228,All
2022,8,KOLKATA,SURAT,5860,5088,KOLKATA-SURAT,10948,All
2022,9,KOLKATA,SURAT,4725,5490,KOLKATA-SURAT,10215,All
2022,10,KOLKATA,SURAT,5594,8396,KOLKATA-SURAT,13990,All
2022,11,KOLKATA,SURAT,4745,3965,KOLKATA-SURAT,8710,All
2022,12,KOLKATA,SURAT,3855,3832,KOLKATA-SURAT,7687,All
2023,1,KOLKATA,SURAT,1236,1425,KOLKATA-SURAT,2661,All
2023,2,KOLKATA,SURAT,554,743,KOLKATA-SURAT,1297,All
2023,3,KOLKATA,SURAT,5151,4926,KOLKATA-SURAT,10077,All
2023,4,KOLKATA,SURAT,5104,5642,KOLKATA-SURAT,10746,All
2023,5,KOLKATA,SURAT,6135,5581,KOLKATA-SURAT,11716,All
2023,6,KOLKATA,SURAT,5412,4940,KOLKATA-SURAT,10352,All
2023,7,KOLKATA,SURAT,4414,3397,KOLKATA-SURAT,7811,All
2023,8,KOLKATA,SURAT,4156,3752,KOLKATA-SURAT,7908,All
2023,9,KOLKATA,SURAT,3955,3622,KOLKATA-SURAT,7577,All
2023,10,KOLKATA,SURAT,4935,5014,KOLKATA-SURAT,9949,All
2023,11,KOLKATA,SURAT,4535,5609,KOLKATA-SURAT,10144,All
2023,12,KOLKATA,SURAT,5647,5257,KOLKATA-SURAT,10904,All
2024,1,KOLKATA,SURAT,5006,5086,KOLKATA-SURAT,10092,All
2024,2,KOLKATA,SURAT,4005,4269,KOLKATA-SURAT,8274,All
2024,3,KOLKATA,SURAT,3961,4038,KOLKATA-SURAT,7999,All
2024,4,KOLKATA,SURAT,4077,4844,KOLKATA-SURAT,8921,All
2024,6,KOLKATA,SURAT,5655,5675,KOLKATA-SURAT,11330,All
2024,7,KOLKATA,SURAT,5629,4935,KOLKATA-SURAT,10564,All
2024,8,KOLKATA,SURAT,5329,5057,KOLKATA-SURAT,10386,All
2024,9,KOLKATA,SURAT,4491,4835,KOLKATA-SURAT,9326,All
2024,10,KOLKATA,SURAT,4275,5573,KOLKATA-SURAT,9848,All
2024,11,KOLKATA,SURAT,5622,5478,KOLKATA-SURAT,11100,All
2024,12,KOLKATA,SURAT,6776,6421,KOLKATA-SURAT,13197,All
2025,1,KOLKATA,SURAT,3392,3508,KOLKATA-SURAT,6900,All
2025,2,KOLKATA,SURAT,3274,3360,KOLKATA-SURAT,6634,All
2025,3,KOLKATA,SURAT,5206,5607,KOLKATA-SURAT,10813,All
2015,9,KOLKATA,TEZPUR,113,135,KOLKATA-TEZPUR,248,All
2015,12,KOLKATA,TEZPUR,111,92,KOLKATA-TEZPUR,203,All
2016,3,KOLKATA,TEZPUR,83,48,KOLKATA-TEZPUR,131,All
2018,4,KOLKATA,TEZPUR,38,48,KOLKATA-TEZPUR,86,All
2018,5,KOLKATA,TEZPUR,1000,756,KOLKATA-TEZPUR,1756,All
2018,6,KOLKATA,TEZPUR,846,759,KOLKATA-TEZPUR,1605,All
2018,7,KOLKATA,TEZPUR,133,0,KOLKATA-TEZPUR,133,All
2018,8,KOLKATA,TEZPUR,134,0,KOLKATA-TEZPUR,134,All
2018,9,KOLKATA,TEZPUR,132,0,KOLKATA-TEZPUR,132,All
2018,10,KOLKATA,TEZPUR,25,25,KOLKATA-TEZPUR,50,All
2019,1,KOLKATA,TEZPUR,91,98,KOLKATA-TEZPUR,189,All
2019,3,KOLKATA,TEZPUR,149,93,KOLKATA-TEZPUR,242,All
2019,4,KOLKATA,TEZPUR,53,81,KOLKATA-TEZPUR,134,All
2019,5,KOLKATA,TEZPUR,139,135,KOLKATA-TEZPUR,274,All
2019,6,KOLKATA,TEZPUR,113,198,KOLKATA-TEZPUR,311,All
2019,7,KOLKATA,TEZPUR,115,146,KOLKATA-TEZPUR,261,All
2019,8,KOLKATA,TEZPUR,71,124,KOLKATA-TEZPUR,195,All
2019,9,KOLKATA,TEZPUR,90,103,KOLKATA-TEZPUR,193,All
2019,10,KOLKATA,TEZPUR,135,145,KOLKATA-TEZPUR,280,All
2019,11,KOLKATA,TEZPUR,100,130,KOLKATA-TEZPUR,230,All
2019,12,KOLKATA,TEZPUR,26,20,KOLKATA-TEZPUR,46,All
2020,5,KOLKATA,TEZPUR,1,0,KOLKATA-TEZPUR,1,All
2020,6,KOLKATA,TEZPUR,37,42,KOLKATA-TEZPUR,79,All
2020,7,KOLKATA,TEZPUR,27,96,KOLKATA-TEZPUR,123,All
2020,8,KOLKATA,TEZPUR,66,77,KOLKATA-TEZPUR,143,All
2020,9,KOLKATA,TEZPUR,37,45,KOLKATA-TEZPUR,82,All
2020,10,KOLKATA,TEZPUR,52,141,KOLKATA-TEZPUR,193,All
2020,11,KOLKATA,TEZPUR,74,94,KOLKATA-TEZPUR,168,All
2020,12,KOLKATA,TEZPUR,119,191,KOLKATA-TEZPUR,310,All
2021,1,KOLKATA,TEZPUR,131,200,KOLKATA-TEZPUR,331,All
2021,2,KOLKATA,TEZPUR,153,164,KOLKATA-TEZPUR,317,All
2021,3,KOLKATA,TEZPUR,119,205,KOLKATA-TEZPUR,324,All
2021,4,KOLKATA,TEZPUR,109,174,KOLKATA-TEZPUR,283,All
2021,6,KOLKATA,TEZPUR,92,107,KOLKATA-TEZPUR,199,All
2021,7,KOLKATA,TEZPUR,128,224,KOLKATA-TEZPUR,352,All
2021,8,KOLKATA,TEZPUR,176,203,KOLKATA-TEZPUR,379,All
2021,9,KOLKATA,TEZPUR,245,296,KOLKATA-TEZPUR,541,All
2021,10,KOLKATA,TEZPUR,139,297,KOLKATA-TEZPUR,436,All
2021,11,KOLKATA,TEZPUR,0,238,KOLKATA-TEZPUR,238,All
2021,12,KOLKATA,TEZPUR,0,266,KOLKATA-TEZPUR,266,All
2022,1,KOLKATA,TEZPUR,0,185,KOLKATA-TEZPUR,185,All
2022,2,KOLKATA,TEZPUR,0,233,KOLKATA-TEZPUR,233,All
2022,3,KOLKATA,TEZPUR,0,213,KOLKATA-TEZPUR,213,All
2022,4,KOLKATA,TEZPUR,0,238,KOLKATA-TEZPUR,238,All
2022,5,KOLKATA,TEZPUR,0,266,KOLKATA-TEZPUR,266,All
2022,6,KOLKATA,TEZPUR,0,238,KOLKATA-TEZPUR,238,All
2022,7,KOLKATA,TEZPUR,0,233,KOLKATA-TEZPUR,233,All
2022,8,KOLKATA,TEZPUR,0,266,KOLKATA-TEZPUR,266,All
2022,9,KOLKATA,TEZPUR,0,238,KOLKATA-TEZPUR,238,All
2022,10,KOLKATA,TEZPUR,0,278,KOLKATA-TEZPUR,278,All
2023,3,KOLKATA,TEZPUR,53,40,KOLKATA-TEZPUR,93,All
2023,6,KOLKATA,TEZPUR,179,178,KOLKATA-TEZPUR,357,All
2023,7,KOLKATA,TEZPUR,1268,1477,KOLKATA-TEZPUR,2745,All
2023,8,KOLKATA,TEZPUR,632,779,KOLKATA-TEZPUR,1411,All
2023,9,KOLKATA,TEZPUR,1485,1532,KOLKATA-TEZPUR,3017,All
2023,10,KOLKATA,TEZPUR,1213,1218,KOLKATA-TEZPUR,2431,All
2023,11,KOLKATA,TEZPUR,1831,1728,KOLKATA-TEZPUR,3559,All
2023,12,KOLKATA,TEZPUR,2374,2305,KOLKATA-TEZPUR,4679,All
2024,1,KOLKATA,TEZPUR,2759,2641,KOLKATA-TEZPUR,5400,All
2024,2,KOLKATA,TEZPUR,1922,1784,KOLKATA-TEZPUR,3706,All
2024,3,KOLKATA,TEZPUR,2523,2336,KOLKATA-TEZPUR,4859,All
2024,4,KOLKATA,TEZPUR,2454,2087,KOLKATA-TEZPUR,4541,All
2024,6,KOLKATA,TEZPUR,2182,2184,KOLKATA-TEZPUR,4366,All
2024,7,KOLKATA,TEZPUR,2438,2385,KOLKATA-TEZPUR,4823,All
2024,8,KOLKATA,TEZPUR,1544,1305,KOLKATA-TEZPUR,2849,All
2024,9,KOLKATA,TEZPUR,1331,1067,KOLKATA-TEZPUR,2398,All
2019,5,KOLKATA,TIRUPATI,7,0,KOLKATA-TIRUPATI,7,All
2019,6,KOLKATA,TIRUPATI,24,0,KOLKATA-TIRUPATI,24,All
2019,7,KOLKATA,TIRUPATI,28,0,KOLKATA-TIRUPATI,28,All
2019,8,KOLKATA,TIRUPATI,10,0,KOLKATA-TIRUPATI,10,All
2019,9,KOLKATA,TIRUPATI,4,0,KOLKATA-TIRUPATI,4,All
2019,10,KOLKATA,TIRUPATI,31,0,KOLKATA-TIRUPATI,31,All
2025,2,KOLKATA,TIRUPATI,3,1,KOLKATA-TIRUPATI,4,All
2025,3,KOLKATA,TIRUPATI,5,8,KOLKATA-TIRUPATI,13,All
2015,4,KOLKATA,TRIVANDRUM,1164,1203,KOLKATA-TRIVANDRUM,2367,All
2015,5,KOLKATA,TRIVANDRUM,1145,1171,KOLKATA-TRIVANDRUM,2316,All
2015,6,KOLKATA,TRIVANDRUM,1044,1429,KOLKATA-TRIVANDRUM,2473,All
2015,7,KOLKATA,TRIVANDRUM,1043,991,KOLKATA-TRIVANDRUM,2034,All
2015,8,KOLKATA,TRIVANDRUM,1059,1001,KOLKATA-TRIVANDRUM,2060,All
2015,9,KOLKATA,TRIVANDRUM,994,1433,KOLKATA-TRIVANDRUM,2427,All
2015,10,KOLKATA,TRIVANDRUM,1648,2000,KOLKATA-TRIVANDRUM,3648,All
2015,11,KOLKATA,TRIVANDRUM,1284,1589,KOLKATA-TRIVANDRUM,2873,All
2015,12,KOLKATA,TRIVANDRUM,2354,2050,KOLKATA-TRIVANDRUM,4404,All
2016,1,KOLKATA,TRIVANDRUM,1453,1959,KOLKATA-TRIVANDRUM,3412,All
2016,2,KOLKATA,TRIVANDRUM,974,1168,KOLKATA-TRIVANDRUM,2142,All
2016,3,KOLKATA,TRIVANDRUM,681,871,KOLKATA-TRIVANDRUM,1552,All
2016,4,KOLKATA,TRIVANDRUM,489,474,KOLKATA-TRIVANDRUM,963,All
2016,5,KOLKATA,TRIVANDRUM,411,330,KOLKATA-TRIVANDRUM,741,All
2016,6,KOLKATA,TRIVANDRUM,262,355,KOLKATA-TRIVANDRUM,617,All
2016,7,KOLKATA,TRIVANDRUM,295,189,KOLKATA-TRIVANDRUM,484,All
2016,8,KOLKATA,TRIVANDRUM,327,311,KOLKATA-TRIVANDRUM,638,All
2016,9,KOLKATA,TRIVANDRUM,131,458,KOLKATA-TRIVANDRUM,589,All
2016,10,KOLKATA,TRIVANDRUM,117,173,KOLKATA-TRIVANDRUM,290,All
2016,11,KOLKATA,TRIVANDRUM,235,507,KOLKATA-TRIVANDRUM,742,All
2016,12,KOLKATA,TRIVANDRUM,717,952,KOLKATA-TRIVANDRUM,1669,All
2017,1,KOLKATA,TRIVANDRUM,967,1094,KOLKATA-TRIVANDRUM,2061,All
2017,2,KOLKATA,TRIVANDRUM,593,941,KOLKATA-TRIVANDRUM,1534,All
2017,3,KOLKATA,TRIVANDRUM,748,1060,KOLKATA-TRIVANDRUM,1808,All
2017,4,KOLKATA,TRIVANDRUM,334,635,KOLKATA-TRIVANDRUM,969,All
2017,5,KOLKATA,TRIVANDRUM,766,890,KOLKATA-TRIVANDRUM,1656,All
2017,6,KOLKATA,TRIVANDRUM,726,1375,KOLKATA-TRIVANDRUM,2101,All
2017,7,KOLKATA,TRIVANDRUM,844,859,KOLKATA-TRIVANDRUM,1703,All
2017,8,KOLKATA,TRIVANDRUM,559,892,KOLKATA-TRIVANDRUM,1451,All
2017,9,KOLKATA,TRIVANDRUM,691,636,KOLKATA-TRIVANDRUM,1327,All
2017,10,KOLKATA,TRIVANDRUM,478,1464,KOLKATA-TRIVANDRUM,1942,All
2017,11,KOLKATA,TRIVANDRUM,777,728,KOLKATA-TRIVANDRUM,1505,All
2017,12,KOLKATA,TRIVANDRUM,1311,1372,KOLKATA-TRIVANDRUM,2683,All
2018,1,KOLKATA,TRIVANDRUM,719,1466,KOLKATA-TRIVANDRUM,2185,All
2018,2,KOLKATA,TRIVANDRUM,408,785,KOLKATA-TRIVANDRUM,1193,All
2018,3,KOLKATA,TRIVANDRUM,572,575,KOLKATA-TRIVANDRUM,1147,All
2018,4,KOLKATA,TRIVANDRUM,448,890,KOLKATA-TRIVANDRUM,1338,All
2018,5,KOLKATA,TRIVANDRUM,490,1082,KOLKATA-TRIVANDRUM,1572,All
2018,6,KOLKATA,TRIVANDRUM,517,1123,KOLKATA-TRIVANDRUM,1640,All
2018,7,KOLKATA,TRIVANDRUM,379,844,KOLKATA-TRIVANDRUM,1223,All
2018,8,KOLKATA,TRIVANDRUM,623,1109,KOLKATA-TRIVANDRUM,1732,All
2018,9,KOLKATA,TRIVANDRUM,350,1043,KOLKATA-TRIVANDRUM,1393,All
2018,10,KOLKATA,TRIVANDRUM,591,1278,KOLKATA-TRIVANDRUM,1869,All
2018,11,KOLKATA,TRIVANDRUM,556,1396,KOLKATA-TRIVANDRUM,1952,All
2018,12,KOLKATA,TRIVANDRUM,753,1390,KOLKATA-TRIVANDRUM,2143,All
2019,1,KOLKATA,TRIVANDRUM,350,1540,KOLKATA-TRIVANDRUM,1890,All
2019,2,KOLKATA,TRIVANDRUM,350,855,KOLKATA-TRIVANDRUM,1205,All
2019,3,KOLKATA,TRIVANDRUM,360,812,KOLKATA-TRIVANDRUM,1172,All
2019,4,KOLKATA,TRIVANDRUM,441,1390,KOLKATA-TRIVANDRUM,1831,All
2019,5,KOLKATA,TRIVANDRUM,580,1327,KOLKATA-TRIVANDRUM,1907,All
2019,6,KOLKATA,TRIVANDRUM,419,919,KOLKATA-TRIVANDRUM,1338,All
2019,7,KOLKATA,TRIVANDRUM,258,475,KOLKATA-TRIVANDRUM,733,All
2019,8,KOLKATA,TRIVANDRUM,387,804,KOLKATA-TRIVANDRUM,1191,All
2019,9,KOLKATA,TRIVANDRUM,436,955,KOLKATA-TRIVANDRUM,1391,All
2019,10,KOLKATA,TRIVANDRUM,356,933,KOLKATA-TRIVANDRUM,1289,All
2019,11,KOLKATA,TRIVANDRUM,337,908,KOLKATA-TRIVANDRUM,1245,All
2019,12,KOLKATA,TRIVANDRUM,557,831,KOLKATA-TRIVANDRUM,1388,All
2020,1,KOLKATA,TRIVANDRUM,546,838,KOLKATA-TRIVANDRUM,1384,All
2020,2,KOLKATA,TRIVANDRUM,460,694,KOLKATA-TRIVANDRUM,1154,All
2020,3,KOLKATA,TRIVANDRUM,204,400,KOLKATA-TRIVANDRUM,604,All
2020,5,KOLKATA,TRIVANDRUM,0,0,KOLKATA-TRIVANDRUM,0,All
2021,3,KOLKATA,TRIVANDRUM,0,6,KOLKATA-TRIVANDRUM,6,All
2021,4,KOLKATA,TRIVANDRUM,0,175,KOLKATA-TRIVANDRUM,175,All
2021,11,KOLKATA,TRIVANDRUM,0,99,KOLKATA-TRIVANDRUM,99,All
2022,3,KOLKATA,TRIVANDRUM,90,44,KOLKATA-TRIVANDRUM,134,All
2022,4,KOLKATA,TRIVANDRUM,498,177,KOLKATA-TRIVANDRUM,675,All
2022,5,KOLKATA,TRIVANDRUM,745,159,KOLKATA-TRIVANDRUM,904,All
2022,6,KOLKATA,TRIVANDRUM,419,428,KOLKATA-TRIVANDRUM,847,All
2022,7,KOLKATA,TRIVANDRUM,477,106,KOLKATA-TRIVANDRUM,583,All
2022,8,KOLKATA,TRIVANDRUM,687,390,KOLKATA-TRIVANDRUM,1077,All
2022,9,KOLKATA,TRIVANDRUM,531,501,KOLKATA-TRIVANDRUM,1032,All
2022,10,KOLKATA,TRIVANDRUM,557,848,KOLKATA-TRIVANDRUM,1405,All
2022,11,KOLKATA,TRIVANDRUM,225,342,KOLKATA-TRIVANDRUM,567,All
2022,12,KOLKATA,TRIVANDRUM,609,790,KOLKATA-TRIVANDRUM,1399,All
2023,1,KOLKATA,TRIVANDRUM,688,748,KOLKATA-TRIVANDRUM,1436,All
2023,2,KOLKATA,TRIVANDRUM,242,233,KOLKATA-TRIVANDRUM,475,All
2023,3,KOLKATA,TRIVANDRUM,434,460,KOLKATA-TRIVANDRUM,894,All
2023,4,KOLKATA,TRIVANDRUM,316,341,KOLKATA-TRIVANDRUM,657,All
2023,5,KOLKATA,TRIVANDRUM,485,245,KOLKATA-TRIVANDRUM,730,All
2023,6,KOLKATA,TRIVANDRUM,306,340,KOLKATA-TRIVANDRUM,646,All
2023,7,KOLKATA,TRIVANDRUM,246,235,KOLKATA-TRIVANDRUM,481,All
2023,8,KOLKATA,TRIVANDRUM,258,295,KOLKATA-TRIVANDRUM,553,All
2023,9,KOLKATA,TRIVANDRUM,292,305,KOLKATA-TRIVANDRUM,597,All
2023,10,KOLKATA,TRIVANDRUM,269,502,KOLKATA-TRIVANDRUM,771,All
2016,1,KOLKATA,UDAIPUR,16,20,KOLKATA-UDAIPUR,36,All
2016,2,KOLKATA,UDAIPUR,80,124,KOLKATA-UDAIPUR,204,All
2016,3,KOLKATA,UDAIPUR,114,103,KOLKATA-UDAIPUR,217,All
2016,4,KOLKATA,UDAIPUR,340,378,KOLKATA-UDAIPUR,718,All
2016,5,KOLKATA,UDAIPUR,117,194,KOLKATA-UDAIPUR,311,All
2016,6,KOLKATA,UDAIPUR,100,144,KOLKATA-UDAIPUR,244,All
2016,7,KOLKATA,UDAIPUR,105,186,KOLKATA-UDAIPUR,291,All
2016,8,KOLKATA,UDAIPUR,140,145,KOLKATA-UDAIPUR,285,All
2016,9,KOLKATA,UDAIPUR,85,61,KOLKATA-UDAIPUR,146,All
2016,10,KOLKATA,UDAIPUR,173,79,KOLKATA-UDAIPUR,252,All
2016,11,KOLKATA,UDAIPUR,324,303,KOLKATA-UDAIPUR,627,All
2016,12,KOLKATA,UDAIPUR,15,409,KOLKATA-UDAIPUR,424,All
2017,1,KOLKATA,UDAIPUR,0,463,KOLKATA-UDAIPUR,463,All
2017,2,KOLKATA,UDAIPUR,0,517,KOLKATA-UDAIPUR,517,All
2017,3,KOLKATA,UDAIPUR,0,253,KOLKATA-UDAIPUR,253,All
2019,11,KOLKATA,UDAIPUR,75,0,KOLKATA-UDAIPUR,75,All
2019,12,KOLKATA,UDAIPUR,188,0,KOLKATA-UDAIPUR,188,All
2020,1,KOLKATA,UDAIPUR,69,0,KOLKATA-UDAIPUR,69,All
2021,11,KOLKATA,UDAIPUR,1545,1435,KOLKATA-UDAIPUR,2980,All
2021,12,KOLKATA,UDAIPUR,3349,3593,KOLKATA-UDAIPUR,6942,All
2022,1,KOLKATA,UDAIPUR,736,1062,KOLKATA-UDAIPUR,1798,All
2022,2,KOLKATA,UDAIPUR,283,328,KOLKATA-UDAIPUR,611,All
2022,3,KOLKATA,UDAIPUR,1179,1309,KOLKATA-UDAIPUR,2488,All
2022,6,KOLKATA,UDAIPUR,496,226,KOLKATA-UDAIPUR,722,All
2022,7,KOLKATA,UDAIPUR,327,128,KOLKATA-UDAIPUR,455,All
2022,8,KOLKATA,UDAIPUR,623,360,KOLKATA-UDAIPUR,983,All
2022,9,KOLKATA,UDAIPUR,421,285,KOLKATA-UDAIPUR,706,All
2022,10,KOLKATA,UDAIPUR,407,355,KOLKATA-UDAIPUR,762,All
2022,11,KOLKATA,UDAIPUR,458,435,KOLKATA-UDAIPUR,893,All
2022,12,KOLKATA,UDAIPUR,1339,1530,KOLKATA-UDAIPUR,2869,All
2023,1,KOLKATA,UDAIPUR,1224,1401,KOLKATA-UDAIPUR,2625,All
2023,2,KOLKATA,UDAIPUR,1615,1714,KOLKATA-UDAIPUR,3329,All
2020,9,KOLKATA,VADODARA,731,302,KOLKATA-VADODARA,1033,All
2020,10,KOLKATA,VADODARA,1033,804,KOLKATA-VADODARA,1837,All
2023,1,KOLKATA,VADODARA,25,0,KOLKATA-VADODARA,25,All
2024,4,KOLKATA,VADODARA,107,92,KOLKATA-VADODARA,199,All
2024,6,KOLKATA,VADODARA,267,313,KOLKATA-VADODARA,580,All
2024,7,KOLKATA,VADODARA,198,225,KOLKATA-VADODARA,423,All
2024,8,KOLKATA,VADODARA,165,239,KOLKATA-VADODARA,404,All
2024,9,KOLKATA,VADODARA,129,253,KOLKATA-VADODARA,382,All
2024,10,KOLKATA,VADODARA,217,140,KOLKATA-VADODARA,357,All
2024,11,KOLKATA,VADODARA,115,102,KOLKATA-VADODARA,217,All
2024,12,KOLKATA,VADODARA,98,84,KOLKATA-VADODARA,182,All
2025,3,KOLKATA,VADODARA,174,148,KOLKATA-VADODARA,322,All
2015,4,KOLKATA,VARANASI,1444,1667,KOLKATA-VARANASI,3111,All
2015,5,KOLKATA,VARANASI,1611,1764,KOLKATA-VARANASI,3375,All
2015,9,KOLKATA,VARANASI,2487,2847,KOLKATA-VARANASI,5334,All
2015,10,KOLKATA,VARANASI,3334,3588,KOLKATA-VARANASI,6922,All
2015,11,KOLKATA,VARANASI,3065,3459,KOLKATA-VARANASI,6524,All
2015,12,KOLKATA,VARANASI,3713,3847,KOLKATA-VARANASI,7560,All
2016,1,KOLKATA,VARANASI,3834,4379,KOLKATA-VARANASI,8213,All
2016,2,KOLKATA,VARANASI,3353,3643,KOLKATA-VARANASI,6996,All
2016,3,KOLKATA,VARANASI,3039,3333,KOLKATA-VARANASI,6372,All
2016,4,KOLKATA,VARANASI,2491,2656,KOLKATA-VARANASI,5147,All
2016,5,KOLKATA,VARANASI,2080,2603,KOLKATA-VARANASI,4683,All
2016,6,KOLKATA,VARANASI,1880,2394,KOLKATA-VARANASI,4274,All
2016,7,KOLKATA,VARANASI,2246,2514,KOLKATA-VARANASI,4760,All
2016,8,KOLKATA,VARANASI,2023,2654,KOLKATA-VARANASI,4677,All
2016,9,KOLKATA,VARANASI,1925,2201,KOLKATA-VARANASI,4126,All
2016,10,KOLKATA,VARANASI,3607,4378,KOLKATA-VARANASI,7985,All
2016,11,KOLKATA,VARANASI,3862,4496,KOLKATA-VARANASI,8358,All
2016,12,KOLKATA,VARANASI,4044,0,KOLKATA-VARANASI,4044,All
2017,1,KOLKATA,VARANASI,3733,0,KOLKATA-VARANASI,3733,All
2017,2,KOLKATA,VARANASI,3083,1701,KOLKATA-VARANASI,4784,All
2017,3,KOLKATA,VARANASI,2809,4099,KOLKATA-VARANASI,6908,All
2017,4,KOLKATA,VARANASI,2871,3991,KOLKATA-VARANASI,6862,All
2017,5,KOLKATA,VARANASI,2816,3842,KOLKATA-VARANASI,6658,All
2017,6,KOLKATA,VARANASI,2355,3258,KOLKATA-VARANASI,5613,All
2017,7,KOLKATA,VARANASI,2535,3155,KOLKATA-VARANASI,5690,All
2017,8,KOLKATA,VARANASI,2374,3618,KOLKATA-VARANASI,5992,All
2017,9,KOLKATA,VARANASI,2688,3668,KOLKATA-VARANASI,6356,All
2017,10,KOLKATA,VARANASI,3297,4324,KOLKATA-VARANASI,7621,All
2017,11,KOLKATA,VARANASI,3400,4525,KOLKATA-VARANASI,7925,All
2017,12,KOLKATA,VARANASI,1646,2021,KOLKATA-VARANASI,3667,All
2018,1,KOLKATA,VARANASI,1794,1963,KOLKATA-VARANASI,3757,All
2018,2,KOLKATA,VARANASI,2252,2801,KOLKATA-VARANASI,5053,All
2018,3,KOLKATA,VARANASI,4473,5480,KOLKATA-VARANASI,9953,All
2018,4,KOLKATA,VARANASI,4485,6069,KOLKATA-VARANASI,10554,All
2018,5,KOLKATA,VARANASI,4023,5618,KOLKATA-VARANASI,9641,All
2018,6,KOLKATA,VARANASI,4566,6348,KOLKATA-VARANASI,10914,All
2018,7,KOLKATA,VARANASI,5577,7003,KOLKATA-VARANASI,12580,All
2018,8,KOLKATA,VARANASI,4861,6142,KOLKATA-VARANASI,11003,All
2018,9,KOLKATA,VARANASI,4099,4858,KOLKATA-VARANASI,8957,All
2018,10,KOLKATA,VARANASI,6365,6902,KOLKATA-VARANASI,13267,All
2018,11,KOLKATA,VARANASI,6974,7912,KOLKATA-VARANASI,14886,All
2018,12,KOLKATA,VARANASI,4287,4931,KOLKATA-VARANASI,9218,All
2019,1,KOLKATA,VARANASI,4865,5234,KOLKATA-VARANASI,10099,All
2019,2,KOLKATA,VARANASI,5492,5717,KOLKATA-VARANASI,11209,All
2019,3,KOLKATA,VARANASI,7088,8164,KOLKATA-VARANASI,15252,All
2019,4,KOLKATA,VARANASI,6329,7754,KOLKATA-VARANASI,14083,All
2019,5,KOLKATA,VARANASI,7509,8459,KOLKATA-VARANASI,15968,All
2019,6,KOLKATA,VARANASI,6963,8414,KOLKATA-VARANASI,15377,All
2019,7,KOLKATA,VARANASI,9084,10120,KOLKATA-VARANASI,19204,All
2019,8,KOLKATA,VARANASI,8654,10015,KOLKATA-VARANASI,18669,All
2019,9,KOLKATA,VARANASI,9324,10456,KOLKATA-VARANASI,19780,All
2019,10,KOLKATA,VARANASI,11664,12003,KOLKATA-VARANASI,23667,All
2019,11,KOLKATA,VARANASI,9435,10262,KOLKATA-VARANASI,19697,All
2019,12,KOLKATA,VARANASI,6753,7484,KOLKATA-VARANASI,14237,All
2020,1,KOLKATA,VARANASI,6498,6305,KOLKATA-VARANASI,12803,All
2020,2,KOLKATA,VARANASI,8356,8219,KOLKATA-VARANASI,16575,All
2020,3,KOLKATA,VARANASI,5743,6998,KOLKATA-VARANASI,12741,All
2020,6,KOLKATA,VARANASI,2284,2804,KOLKATA-VARANASI,5088,All
2020,7,KOLKATA,VARANASI,2077,2041,KOLKATA-VARANASI,4118,All
2020,8,KOLKATA,VARANASI,3604,2219,KOLKATA-VARANASI,5823,All
2020,9,KOLKATA,VARANASI,3800,3080,KOLKATA-VARANASI,6880,All
2020,10,KOLKATA,VARANASI,7133,10940,KOLKATA-VARANASI,18073,All
2020,11,KOLKATA,VARANASI,6846,11469,KOLKATA-VARANASI,18315,All
2020,12,KOLKATA,VARANASI,6404,10501,KOLKATA-VARANASI,16905,All
2021,1,KOLKATA,VARANASI,5524,8952,KOLKATA-VARANASI,14476,All
2021,2,KOLKATA,VARANASI,5273,10485,KOLKATA-VARANASI,15758,All
2021,3,KOLKATA,VARANASI,5544,10488,KOLKATA-VARANASI,16032,All
2021,4,KOLKATA,VARANASI,2749,4524,KOLKATA-VARANASI,7273,All
2021,6,KOLKATA,VARANASI,903,2212,KOLKATA-VARANASI,3115,All
2021,7,KOLKATA,VARANASI,1617,4649,KOLKATA-VARANASI,6266,All
2021,8,KOLKATA,VARANASI,2080,5138,KOLKATA-VARANASI,7218,All
2021,9,KOLKATA,VARANASI,1853,4464,KOLKATA-VARANASI,6317,All
2021,10,KOLKATA,VARANASI,3109,6796,KOLKATA-VARANASI,9905,All
2021,11,KOLKATA,VARANASI,4941,4340,KOLKATA-VARANASI,9281,All
2021,12,KOLKATA,VARANASI,4801,5417,KOLKATA-VARANASI,10218,All
2022,1,KOLKATA,VARANASI,2740,2353,KOLKATA-VARANASI,5093,All
2022,2,KOLKATA,VARANASI,4244,4157,KOLKATA-VARANASI,8401,All
2022,3,KOLKATA,VARANASI,5153,5064,KOLKATA-VARANASI,10217,All
2022,4,KOLKATA,VARANASI,4475,4598,KOLKATA-VARANASI,9073,All
2022,5,KOLKATA,VARANASI,4211,4353,KOLKATA-VARANASI,8564,All
2022,6,KOLKATA,VARANASI,4470,6343,KOLKATA-VARANASI,10813,All
2022,7,KOLKATA,VARANASI,4226,5277,KOLKATA-VARANASI,9503,All
2022,8,KOLKATA,VARANASI,4047,5079,KOLKATA-VARANASI,9126,All
2022,9,KOLKATA,VARANASI,4172,5095,KOLKATA-VARANASI,9267,All
2022,10,KOLKATA,VARANASI,6495,6333,KOLKATA-VARANASI,12828,All
2022,11,KOLKATA,VARANASI,4528,4567,KOLKATA-VARANASI,9095,All
2022,12,KOLKATA,VARANASI,4083,4598,KOLKATA-VARANASI,8681,All
2023,1,KOLKATA,VARANASI,4556,4307,KOLKATA-VARANASI,8863,All
2023,2,KOLKATA,VARANASI,4687,4762,KOLKATA-VARANASI,9449,All
2023,3,KOLKATA,VARANASI,4894,5002,KOLKATA-VARANASI,9896,All
2023,4,KOLKATA,VARANASI,5670,5936,KOLKATA-VARANASI,11606,All
2023,5,KOLKATA,VARANASI,6384,6039,KOLKATA-VARANASI,12423,All
2023,6,KOLKATA,VARANASI,4731,5134,KOLKATA-VARANASI,9865,All
2023,7,KOLKATA,VARANASI,4809,4686,KOLKATA-VARANASI,9495,All
2023,8,KOLKATA,VARANASI,4912,4936,KOLKATA-VARANASI,9848,All
2023,9,KOLKATA,VARANASI,4815,4884,KOLKATA-VARANASI,9699,All
2023,10,KOLKATA,VARANASI,5696,5991,KOLKATA-VARANASI,11687,All
2023,11,KOLKATA,VARANASI,10469,9796,KOLKATA-VARANASI,20265,All
2023,12,KOLKATA,VARANASI,10273,11727,KOLKATA-VARANASI,22000,All
2024,1,KOLKATA,VARANASI,7664,7756,KOLKATA-VARANASI,15420,All
2024,2,KOLKATA,VARANASI,10762,9632,KOLKATA-VARANASI,20394,All
2024,3,KOLKATA,VARANASI,12015,11992,KOLKATA-VARANASI,24007,All
2024,4,KOLKATA,VARANASI,10430,10551,KOLKATA-VARANASI,20981,All
2024,6,KOLKATA,VARANASI,9690,10300,KOLKATA-VARANASI,19990,All
2024,7,KOLKATA,VARANASI,10793,10014,KOLKATA-VARANASI,20807,All
2024,8,KOLKATA,VARANASI,11800,12361,KOLKATA-VARANASI,24161,All
2024,9,KOLKATA,VARANASI,11361,12983,KOLKATA-VARANASI,24344,All
2024,10,KOLKATA,VARANASI,13293,14072,KOLKATA-VARANASI,27365,All
2024,11,KOLKATA,VARANASI,13948,13727,KOLKATA-VARANASI,27675,All
2024,12,KOLKATA,VARANASI,11065,12335,KOLKATA-VARANASI,23400,All
2025,1,KOLKATA,VARANASI,11309,11417,KOLKATA-VARANASI,22726,All
2025,2,KOLKATA,VARANASI,10395,10809,KOLKATA-VARANASI,21204,All
2025,3,KOLKATA,VARANASI,11373,11568,KOLKATA-VARANASI,22941,All
2020,5,KOLKATA,VIJAYAWADA,0,0,KOLKATA-VIJAYAWADA,0,All
2020,6,KOLKATA,VIJAYAWADA,0,0,KOLKATA-VIJAYAWADA,0,All
2015,4,KOLKATA,VISAKHAPATNAM,1672,2216,KOLKATA-VISAKHAPATNAM,3888,All
2015,5,KOLKATA,VISAKHAPATNAM,1885,2151,KOLKATA-VISAKHAPATNAM,4036,All
2015,6,KOLKATA,VISAKHAPATNAM,2043,1781,KOLKATA-VISAKHAPATNAM,3824,All
2015,7,KOLKATA,VISAKHAPATNAM,1535,1690,KOLKATA-VISAKHAPATNAM,3225,All
2015,8,KOLKATA,VISAKHAPATNAM,1668,1792,KOLKATA-VISAKHAPATNAM,3460,All
2015,9,KOLKATA,VISAKHAPATNAM,1390,1662,KOLKATA-VISAKHAPATNAM,3052,All
2015,10,KOLKATA,VISAKHAPATNAM,1916,2456,KOLKATA-VISAKHAPATNAM,4372,All
2015,11,KOLKATA,VISAKHAPATNAM,2031,2294,KOLKATA-VISAKHAPATNAM,4325,All
2015,12,KOLKATA,VISAKHAPATNAM,1966,2260,KOLKATA-VISAKHAPATNAM,4226,All
2016,1,KOLKATA,VISAKHAPATNAM,1898,2415,KOLKATA-VISAKHAPATNAM,4313,All
2016,2,KOLKATA,VISAKHAPATNAM,1197,1412,KOLKATA-VISAKHAPATNAM,2609,All
2016,3,KOLKATA,VISAKHAPATNAM,1078,1286,KOLKATA-VISAKHAPATNAM,2364,All
2016,4,KOLKATA,VISAKHAPATNAM,1279,1510,KOLKATA-VISAKHAPATNAM,2789,All
2016,5,KOLKATA,VISAKHAPATNAM,1432,1401,KOLKATA-VISAKHAPATNAM,2833,All
2016,6,KOLKATA,VISAKHAPATNAM,1503,1468,KOLKATA-VISAKHAPATNAM,2971,All
2016,7,KOLKATA,VISAKHAPATNAM,1204,1361,KOLKATA-VISAKHAPATNAM,2565,All
2016,8,KOLKATA,VISAKHAPATNAM,1918,2423,KOLKATA-VISAKHAPATNAM,4341,All
2016,9,KOLKATA,VISAKHAPATNAM,3205,4584,KOLKATA-VISAKHAPATNAM,7789,All
2016,10,KOLKATA,VISAKHAPATNAM,5551,7006,KOLKATA-VISAKHAPATNAM,12557,All
2016,11,KOLKATA,VISAKHAPATNAM,6805,7631,KOLKATA-VISAKHAPATNAM,14436,All
2016,12,KOLKATA,VISAKHAPATNAM,8331,8811,KOLKATA-VISAKHAPATNAM,17142,All
2017,1,KOLKATA,VISAKHAPATNAM,7916,9498,KOLKATA-VISAKHAPATNAM,17414,All
2017,2,KOLKATA,VISAKHAPATNAM,5787,7137,KOLKATA-VISAKHAPATNAM,12924,All
2017,3,KOLKATA,VISAKHAPATNAM,4614,6068,KOLKATA-VISAKHAPATNAM,10682,All
2017,4,KOLKATA,VISAKHAPATNAM,4716,7042,KOLKATA-VISAKHAPATNAM,11758,All
2017,5,KOLKATA,VISAKHAPATNAM,6229,7599,KOLKATA-VISAKHAPATNAM,13828,All
2017,6,KOLKATA,VISAKHAPATNAM,6027,6801,KOLKATA-VISAKHAPATNAM,12828,All
2017,7,KOLKATA,VISAKHAPATNAM,4862,5163,KOLKATA-VISAKHAPATNAM,10025,All
2017,8,KOLKATA,VISAKHAPATNAM,4222,4627,KOLKATA-VISAKHAPATNAM,8849,All
2017,9,KOLKATA,VISAKHAPATNAM,6883,8710,KOLKATA-VISAKHAPATNAM,15593,All
2017,10,KOLKATA,VISAKHAPATNAM,6925,8429,KOLKATA-VISAKHAPATNAM,15354,All
2017,11,KOLKATA,VISAKHAPATNAM,4665,4805,KOLKATA-VISAKHAPATNAM,9470,All
2017,12,KOLKATA,VISAKHAPATNAM,8548,9261,KOLKATA-VISAKHAPATNAM,17809,All
2018,1,KOLKATA,VISAKHAPATNAM,7075,9284,KOLKATA-VISAKHAPATNAM,16359,All
2018,2,KOLKATA,VISAKHAPATNAM,7987,9108,KOLKATA-VISAKHAPATNAM,17095,All
2018,3,KOLKATA,VISAKHAPATNAM,9548,10567,KOLKATA-VISAKHAPATNAM,20115,All
2018,4,KOLKATA,VISAKHAPATNAM,8546,10894,KOLKATA-VISAKHAPATNAM,19440,All
2018,5,KOLKATA,VISAKHAPATNAM,12491,13167,KOLKATA-VISAKHAPATNAM,25658,All
2018,6,KOLKATA,VISAKHAPATNAM,12591,14065,KOLKATA-VISAKHAPATNAM,26656,All
2018,7,KOLKATA,VISAKHAPATNAM,10698,13126,KOLKATA-VISAKHAPATNAM,23824,All
2018,8,KOLKATA,VISAKHAPATNAM,9526,10920,KOLKATA-VISAKHAPATNAM,20446,All
2018,9,KOLKATA,VISAKHAPATNAM,9600,10846,KOLKATA-VISAKHAPATNAM,20446,All
2018,10,KOLKATA,VISAKHAPATNAM,12399,13843,KOLKATA-VISAKHAPATNAM,26242,All
2018,11,KOLKATA,VISAKHAPATNAM,11983,12817,KOLKATA-VISAKHAPATNAM,24800,All
2018,12,KOLKATA,VISAKHAPATNAM,13621,13091,KOLKATA-VISAKHAPATNAM,26712,All
2019,1,KOLKATA,VISAKHAPATNAM,12634,13908,KOLKATA-VISAKHAPATNAM,26542,All
2019,2,KOLKATA,VISAKHAPATNAM,9985,11101,KOLKATA-VISAKHAPATNAM,21086,All
2019,3,KOLKATA,VISAKHAPATNAM,10657,12150,KOLKATA-VISAKHAPATNAM,22807,All
2019,4,KOLKATA,VISAKHAPATNAM,7748,9805,KOLKATA-VISAKHAPATNAM,17553,All
2019,5,KOLKATA,VISAKHAPATNAM,12385,11679,KOLKATA-VISAKHAPATNAM,24064,All
2019,6,KOLKATA,VISAKHAPATNAM,9073,9083,KOLKATA-VISAKHAPATNAM,18156,All
2019,7,KOLKATA,VISAKHAPATNAM,7887,8513,KOLKATA-VISAKHAPATNAM,16400,All
2019,8,KOLKATA,VISAKHAPATNAM,7305,8388,KOLKATA-VISAKHAPATNAM,15693,All
2019,9,KOLKATA,VISAKHAPATNAM,8148,8676,KOLKATA-VISAKHAPATNAM,16824,All
2019,10,KOLKATA,VISAKHAPATNAM,8280,9351,KOLKATA-VISAKHAPATNAM,17631,All
2019,11,KOLKATA,VISAKHAPATNAM,7880,9152,KOLKATA-VISAKHAPATNAM,17032,All
2019,12,KOLKATA,VISAKHAPATNAM,7832,9311,KOLKATA-VISAKHAPATNAM,17143,All
2020,1,KOLKATA,VISAKHAPATNAM,7149,9340,KOLKATA-VISAKHAPATNAM,16489,All
2020,2,KOLKATA,VISAKHAPATNAM,6925,8649,KOLKATA-VISAKHAPATNAM,15574,All
2020,3,KOLKATA,VISAKHAPATNAM,4900,6302,KOLKATA-VISAKHAPATNAM,11202,All
2020,5,KOLKATA,VISAKHAPATNAM,0,0,KOLKATA-VISAKHAPATNAM,0,All
2020,6,KOLKATA,VISAKHAPATNAM,285,442,KOLKATA-VISAKHAPATNAM,727,All
2020,7,KOLKATA,VISAKHAPATNAM,1462,2090,KOLKATA-VISAKHAPATNAM,3552,All
2020,8,KOLKATA,VISAKHAPATNAM,2980,1877,KOLKATA-VISAKHAPATNAM,4857,All
2020,9,KOLKATA,VISAKHAPATNAM,4703,2403,KOLKATA-VISAKHAPATNAM,7106,All
2020,10,KOLKATA,VISAKHAPATNAM,6200,3756,KOLKATA-VISAKHAPATNAM,9956,All
2020,11,KOLKATA,VISAKHAPATNAM,4706,4707,KOLKATA-VISAKHAPATNAM,9413,All
2020,12,KOLKATA,VISAKHAPATNAM,6545,5426,KOLKATA-VISAKHAPATNAM,11971,All
2021,1,KOLKATA,VISAKHAPATNAM,6780,6389,KOLKATA-VISAKHAPATNAM,13169,All
2021,2,KOLKATA,VISAKHAPATNAM,5109,5293,KOLKATA-VISAKHAPATNAM,10402,All
2021,3,KOLKATA,VISAKHAPATNAM,4399,5500,KOLKATA-VISAKHAPATNAM,9899,All
2021,4,KOLKATA,VISAKHAPATNAM,2350,6007,KOLKATA-VISAKHAPATNAM,8357,All
2021,6,KOLKATA,VISAKHAPATNAM,873,1093,KOLKATA-VISAKHAPATNAM,1966,All
2021,7,KOLKATA,VISAKHAPATNAM,1902,2024,KOLKATA-VISAKHAPATNAM,3926,All
2021,8,KOLKATA,VISAKHAPATNAM,3263,2477,KOLKATA-VISAKHAPATNAM,5740,All
2021,9,KOLKATA,VISAKHAPATNAM,2805,3011,KOLKATA-VISAKHAPATNAM,5816,All
2021,10,KOLKATA,VISAKHAPATNAM,4088,5092,KOLKATA-VISAKHAPATNAM,9180,All
2021,11,KOLKATA,VISAKHAPATNAM,4983,5541,KOLKATA-VISAKHAPATNAM,10524,All
2021,12,KOLKATA,VISAKHAPATNAM,6090,5902,KOLKATA-VISAKHAPATNAM,11992,All
2022,1,KOLKATA,VISAKHAPATNAM,2549,2976,KOLKATA-VISAKHAPATNAM,5525,All
2022,2,KOLKATA,VISAKHAPATNAM,3216,3922,KOLKATA-VISAKHAPATNAM,7138,All
2022,3,KOLKATA,VISAKHAPATNAM,5124,4838,KOLKATA-VISAKHAPATNAM,9962,All
2022,4,KOLKATA,VISAKHAPATNAM,4452,5488,KOLKATA-VISAKHAPATNAM,9940,All
2022,5,KOLKATA,VISAKHAPATNAM,5280,4510,KOLKATA-VISAKHAPATNAM,9790,All
2022,6,KOLKATA,VISAKHAPATNAM,5144,4647,KOLKATA-VISAKHAPATNAM,9791,All
2022,7,KOLKATA,VISAKHAPATNAM,4487,5032,KOLKATA-VISAKHAPATNAM,9519,All
2022,8,KOLKATA,VISAKHAPATNAM,4639,4670,KOLKATA-VISAKHAPATNAM,9309,All
2022,9,KOLKATA,VISAKHAPATNAM,4493,5484,KOLKATA-VISAKHAPATNAM,9977,All
2022,10,KOLKATA,VISAKHAPATNAM,4035,4769,KOLKATA-VISAKHAPATNAM,8804,All
2022,11,KOLKATA,VISAKHAPATNAM,2250,2403,KOLKATA-VISAKHAPATNAM,4653,All
2022,12,KOLKATA,VISAKHAPATNAM,4782,5037,KOLKATA-VISAKHAPATNAM,9819,All
2023,1,KOLKATA,VISAKHAPATNAM,4655,4856,KOLKATA-VISAKHAPATNAM,9511,All
2023,2,KOLKATA,VISAKHAPATNAM,4327,4584,KOLKATA-VISAKHAPATNAM,8911,All
2023,3,KOLKATA,VISAKHAPATNAM,4844,5001,KOLKATA-VISAKHAPATNAM,9845,All
2023,4,KOLKATA,VISAKHAPATNAM,4299,5080,KOLKATA-VISAKHAPATNAM,9379,All
2023,5,KOLKATA,VISAKHAPATNAM,5243,5042,KOLKATA-VISAKHAPATNAM,10285,All
2023,6,KOLKATA,VISAKHAPATNAM,5081,5178,KOLKATA-VISAKHAPATNAM,10259,All
2023,7,KOLKATA,VISAKHAPATNAM,2141,2065,KOLKATA-VISAKHAPATNAM,4206,All
2023,8,KOLKATA,VISAKHAPATNAM,3309,3325,KOLKATA-VISAKHAPATNAM,6634,All
2023,9,KOLKATA,VISAKHAPATNAM,3835,3670,KOLKATA-VISAKHAPATNAM,7505,All
2023,10,KOLKATA,VISAKHAPATNAM,4117,4914,KOLKATA-VISAKHAPATNAM,9031,All
2023,11,KOLKATA,VISAKHAPATNAM,4328,4814,KOLKATA-VISAKHAPATNAM,9142,All
2023,12,KOLKATA,VISAKHAPATNAM,4733,4762,KOLKATA-VISAKHAPATNAM,9495,All
2024,1,KOLKATA,VISAKHAPATNAM,4637,4887,KOLKATA-VISAKHAPATNAM,9524,All
2024,2,KOLKATA,VISAKHAPATNAM,3719,4263,KOLKATA-VISAKHAPATNAM,7982,All
2024,3,KOLKATA,VISAKHAPATNAM,4224,4623,KOLKATA-VISAKHAPATNAM,8847,All
2024,4,KOLKATA,VISAKHAPATNAM,5131,6080,KOLKATA-VISAKHAPATNAM,11211,All
2024,6,KOLKATA,VISAKHAPATNAM,5127,4993,KOLKATA-VISAKHAPATNAM,10120,All
2024,7,KOLKATA,VISAKHAPATNAM,7201,5768,KOLKATA-VISAKHAPATNAM,12969,All
2024,8,KOLKATA,VISAKHAPATNAM,9099,7245,KOLKATA-VISAKHAPATNAM,16344,All
2024,9,KOLKATA,VISAKHAPATNAM,5722,6476,KOLKATA-VISAKHAPATNAM,12198,All
2024,10,KOLKATA,VISAKHAPATNAM,7740,9428,KOLKATA-VISAKHAPATNAM,17168,All
2024,11,KOLKATA,VISAKHAPATNAM,8871,8202,KOLKATA-VISAKHAPATNAM,17073,All
2024,12,KOLKATA,VISAKHAPATNAM,8424,8249,KOLKATA-VISAKHAPATNAM,16673,All
2025,1,KOLKATA,VISAKHAPATNAM,7938,8196,KOLKATA-VISAKHAPATNAM,16134,All
2025,2,KOLKATA,VISAKHAPATNAM,7853,9042,KOLKATA-VISAKHAPATNAM,16895,All
2025,3,KOLKATA,VISAKHAPATNAM,6984,8215,KOLKATA-VISAKHAPATNAM,15199,All
2015,4,KOZHIKODE,CHENNAI,1832,1843,CHENNAI-KOZHIKODE,3675,All
2015,5,KOZHIKODE,CHENNAI,2078,2007,CHENNAI-KOZHIKODE,4085,All
2015,6,KOZHIKODE,CHENNAI,1595,1621,CHENNAI-KOZHIKODE,3216,All
2015,7,KOZHIKODE,CHENNAI,2161,2323,CHENNAI-KOZHIKODE,4484,All
2015,8,KOZHIKODE,CHENNAI,2242,2356,CHENNAI-KOZHIKODE,4598,All
2015,9,KOZHIKODE,CHENNAI,1981,1897,CHENNAI-KOZHIKODE,3878,All
2015,10,KOZHIKODE,CHENNAI,1788,1879,CHENNAI-KOZHIKODE,3667,All
2015,11,KOZHIKODE,CHENNAI,1711,1738,CHENNAI-KOZHIKODE,3449,All
2015,12,KOZHIKODE,CHENNAI,1382,1407,CHENNAI-KOZHIKODE,2789,All
2016,1,KOZHIKODE,CHENNAI,1943,1902,CHENNAI-KOZHIKODE,3845,All
2016,2,KOZHIKODE,CHENNAI,1735,1725,CHENNAI-KOZHIKODE,3460,All
2016,3,KOZHIKODE,CHENNAI,1783,1849,CHENNAI-KOZHIKODE,3632,All
2016,4,KOZHIKODE,CHENNAI,1893,1911,CHENNAI-KOZHIKODE,3804,All
2016,5,KOZHIKODE,CHENNAI,1894,1936,CHENNAI-KOZHIKODE,3830,All
2016,6,KOZHIKODE,CHENNAI,1822,1800,CHENNAI-KOZHIKODE,3622,All
2016,7,KOZHIKODE,CHENNAI,1850,1923,CHENNAI-KOZHIKODE,3773,All
2016,8,KOZHIKODE,CHENNAI,1845,1897,CHENNAI-KOZHIKODE,3742,All
2016,9,KOZHIKODE,CHENNAI,1882,1909,CHENNAI-KOZHIKODE,3791,All
2016,10,KOZHIKODE,CHENNAI,2090,2024,CHENNAI-KOZHIKODE,4114,All
2016,11,KOZHIKODE,CHENNAI,2060,1876,CHENNAI-KOZHIKODE,3936,All
2016,12,KOZHIKODE,CHENNAI,1873,1973,CHENNAI-KOZHIKODE,3846,All
2017,1,KOZHIKODE,CHENNAI,1919,1877,CHENNAI-KOZHIKODE,3796,All
2017,2,KOZHIKODE,CHENNAI,1731,1713,CHENNAI-KOZHIKODE,3444,All
2017,3,KOZHIKODE,CHENNAI,4263,4525,CHENNAI-KOZHIKODE,8788,All
2017,4,KOZHIKODE,CHENNAI,5306,5949,CHENNAI-KOZHIKODE,11255,All
2017,5,KOZHIKODE,CHENNAI,1958,1997,CHENNAI-KOZHIKODE,3955,All
2017,6,KOZHIKODE,CHENNAI,1770,1929,CHENNAI-KOZHIKODE,3699,All
2017,7,KOZHIKODE,CHENNAI,2065,2097,CHENNAI-KOZHIKODE,4162,All
2017,8,KOZHIKODE,CHENNAI,1815,1920,CHENNAI-KOZHIKODE,3735,All
2017,9,KOZHIKODE,CHENNAI,1877,1905,CHENNAI-KOZHIKODE,3782,All
2017,10,KOZHIKODE,CHENNAI,1832,1838,CHENNAI-KOZHIKODE,3670,All
2017,11,KOZHIKODE,CHENNAI,1928,1822,CHENNAI-KOZHIKODE,3750,All
2017,12,KOZHIKODE,CHENNAI,2090,2066,CHENNAI-KOZHIKODE,4156,All
2018,1,KOZHIKODE,CHENNAI,1989,2002,CHENNAI-KOZHIKODE,3991,All
2018,2,KOZHIKODE,CHENNAI,1847,1833,CHENNAI-KOZHIKODE,3680,All
2018,3,KOZHIKODE,CHENNAI,2089,2099,CHENNAI-KOZHIKODE,4188,All
2018,4,KOZHIKODE,CHENNAI,3814,3728,CHENNAI-KOZHIKODE,7542,All
2018,5,KOZHIKODE,CHENNAI,5239,3698,CHENNAI-KOZHIKODE,8937,All
2018,6,KOZHIKODE,CHENNAI,4035,3923,CHENNAI-KOZHIKODE,7958,All
2018,7,KOZHIKODE,CHENNAI,5549,6078,CHENNAI-KOZHIKODE,11627,All
2018,8,KOZHIKODE,CHENNAI,8766,9361,CHENNAI-KOZHIKODE,18127,All
2018,9,KOZHIKODE,CHENNAI,5879,5957,CHENNAI-KOZHIKODE,11836,All
2018,10,KOZHIKODE,CHENNAI,4719,4594,CHENNAI-KOZHIKODE,9313,All
2018,11,KOZHIKODE,CHENNAI,4278,4837,CHENNAI-KOZHIKODE,9115,All
2018,12,KOZHIKODE,CHENNAI,5816,7095,CHENNAI-KOZHIKODE,12911,All
2019,1,KOZHIKODE,CHENNAI,5779,5625,CHENNAI-KOZHIKODE,11404,All
2019,2,KOZHIKODE,CHENNAI,5203,5629,CHENNAI-KOZHIKODE,10832,All
2019,3,KOZHIKODE,CHENNAI,4388,4533,CHENNAI-KOZHIKODE,8921,All
2019,4,KOZHIKODE,CHENNAI,5856,5846,CHENNAI-KOZHIKODE,11702,All
2015,4,KOZHIKODE,COIMBATORE,144,159,COIMBATORE-KOZHIKODE,303,All
2015,5,KOZHIKODE,COIMBATORE,195,217,COIMBATORE-KOZHIKODE,412,All
2015,6,KOZHIKODE,COIMBATORE,126,117,COIMBATORE-KOZHIKODE,243,All
2015,7,KOZHIKODE,COIMBATORE,112,137,COIMBATORE-KOZHIKODE,249,All
2015,8,KOZHIKODE,COIMBATORE,167,264,COIMBATORE-KOZHIKODE,431,All
2018,2,KOZHIKODE,COIMBATORE,28,7,COIMBATORE-KOZHIKODE,35,All
2018,3,KOZHIKODE,COIMBATORE,12,6,COIMBATORE-KOZHIKODE,18,All
2019,2,KOZHIKODE,COIMBATORE,0,0,COIMBATORE-KOZHIKODE,0,All
2015,4,KOZHIKODE,DELHI,2441,2533,DELHI-KOZHIKODE,4974,All
2015,5,KOZHIKODE,DELHI,1722,2558,DELHI-KOZHIKODE,4280,All
2015,6,KOZHIKODE,DELHI,2206,1854,DELHI-KOZHIKODE,4060,All
2015,7,KOZHIKODE,DELHI,1533,1986,DELHI-KOZHIKODE,3519,All
2015,8,KOZHIKODE,DELHI,1938,2280,DELHI-KOZHIKODE,4218,All
2015,9,KOZHIKODE,DELHI,1571,1838,DELHI-KOZHIKODE,3409,All
2015,10,KOZHIKODE,DELHI,2237,2543,DELHI-KOZHIKODE,4780,All
2015,11,KOZHIKODE,DELHI,1399,1501,DELHI-KOZHIKODE,2900,All
2015,12,KOZHIKODE,DELHI,1858,2552,DELHI-KOZHIKODE,4410,All
2016,1,KOZHIKODE,DELHI,2155,2137,DELHI-KOZHIKODE,4292,All
2016,2,KOZHIKODE,DELHI,1661,1407,DELHI-KOZHIKODE,3068,All
2016,3,KOZHIKODE,DELHI,1372,1311,DELHI-KOZHIKODE,2683,All
2016,4,KOZHIKODE,DELHI,1174,1317,DELHI-KOZHIKODE,2491,All
2016,5,KOZHIKODE,DELHI,827,1062,DELHI-KOZHIKODE,1889,All
2016,6,KOZHIKODE,DELHI,1305,1193,DELHI-KOZHIKODE,2498,All
2016,7,KOZHIKODE,DELHI,1356,1404,DELHI-KOZHIKODE,2760,All
2016,8,KOZHIKODE,DELHI,1041,1367,DELHI-KOZHIKODE,2408,All
2016,9,KOZHIKODE,DELHI,1833,2012,DELHI-KOZHIKODE,3845,All
2016,10,KOZHIKODE,DELHI,1191,1200,DELHI-KOZHIKODE,2391,All
2016,11,KOZHIKODE,DELHI,1370,767,DELHI-KOZHIKODE,2137,All
2016,12,KOZHIKODE,DELHI,1135,1654,DELHI-KOZHIKODE,2789,All
2017,1,KOZHIKODE,DELHI,1386,1331,DELHI-KOZHIKODE,2717,All
2017,2,KOZHIKODE,DELHI,1060,1241,DELHI-KOZHIKODE,2301,All
2017,3,KOZHIKODE,DELHI,762,881,DELHI-KOZHIKODE,1643,All
2017,4,KOZHIKODE,DELHI,789,878,DELHI-KOZHIKODE,1667,All
2017,5,KOZHIKODE,DELHI,838,1204,DELHI-KOZHIKODE,2042,All
2017,6,KOZHIKODE,DELHI,1256,911,DELHI-KOZHIKODE,2167,All
2017,7,KOZHIKODE,DELHI,1137,691,DELHI-KOZHIKODE,1828,All
2017,8,KOZHIKODE,DELHI,920,808,DELHI-KOZHIKODE,1728,All
2017,9,KOZHIKODE,DELHI,614,660,DELHI-KOZHIKODE,1274,All
2017,10,KOZHIKODE,DELHI,491,557,DELHI-KOZHIKODE,1048,All
2017,11,KOZHIKODE,DELHI,790,797,DELHI-KOZHIKODE,1587,All
2017,12,KOZHIKODE,DELHI,840,1062,DELHI-KOZHIKODE,1902,All
2018,1,KOZHIKODE,DELHI,811,954,DELHI-KOZHIKODE,1765,All
2018,2,KOZHIKODE,DELHI,794,885,DELHI-KOZHIKODE,1679,All
2018,3,KOZHIKODE,DELHI,745,949,DELHI-KOZHIKODE,1694,All
2018,4,KOZHIKODE,DELHI,732,1017,DELHI-KOZHIKODE,1749,All
2018,5,KOZHIKODE,DELHI,431,683,DELHI-KOZHIKODE,1114,All
2018,6,KOZHIKODE,DELHI,790,585,DELHI-KOZHIKODE,1375,All
2018,7,KOZHIKODE,DELHI,618,587,DELHI-KOZHIKODE,1205,All
2018,8,KOZHIKODE,DELHI,685,1105,DELHI-KOZHIKODE,1790,All
2018,9,KOZHIKODE,DELHI,876,1055,DELHI-KOZHIKODE,1931,All
2018,10,KOZHIKODE,DELHI,1526,1433,DELHI-KOZHIKODE,2959,All
2018,11,KOZHIKODE,DELHI,916,858,DELHI-KOZHIKODE,1774,All
2018,12,KOZHIKODE,DELHI,802,1076,DELHI-KOZHIKODE,1878,All
2019,1,KOZHIKODE,DELHI,1202,1136,DELHI-KOZHIKODE,2338,All
2019,2,KOZHIKODE,DELHI,1984,795,DELHI-KOZHIKODE,2779,All
2019,3,KOZHIKODE,DELHI,2260,1063,DELHI-KOZHIKODE,3323,All
2019,4,KOZHIKODE,DELHI,2563,2562,DELHI-KOZHIKODE,5125,All
2015,11,KOZHIKODE,GUWAHATI,1385,1396,GUWAHATI-KOZHIKODE,2781,All
2018,3,KOZHIKODE,HYDERABAD,1175,862,HYDERABAD-KOZHIKODE,2037,All
2018,4,KOZHIKODE,HYDERABAD,6405,6418,HYDERABAD-KOZHIKODE,12823,All
2018,5,KOZHIKODE,HYDERABAD,5670,6776,HYDERABAD-KOZHIKODE,12446,All
2018,6,KOZHIKODE,HYDERABAD,1330,1254,HYDERABAD-KOZHIKODE,2584,All
2018,7,KOZHIKODE,HYDERABAD,1994,1958,HYDERABAD-KOZHIKODE,3952,All
2018,8,KOZHIKODE,HYDERABAD,1958,1898,HYDERABAD-KOZHIKODE,3856,All
2018,9,KOZHIKODE,HYDERABAD,1692,1479,HYDERABAD-KOZHIKODE,3171,All
2018,10,KOZHIKODE,HYDERABAD,1921,1620,HYDERABAD-KOZHIKODE,3541,All
2018,11,KOZHIKODE,HYDERABAD,2019,1803,HYDERABAD-KOZHIKODE,3822,All
2018,12,KOZHIKODE,HYDERABAD,1990,2006,HYDERABAD-KOZHIKODE,3996,All
2019,1,KOZHIKODE,HYDERABAD,329,292,HYDERABAD-KOZHIKODE,621,All
2019,4,KOZHIKODE,KANNUR,267,101,KANNUR-KOZHIKODE,368,All
2015,4,KOZHIKODE,KOCHI,1373,952,KOCHI-KOZHIKODE,2325,All
2015,5,KOZHIKODE,KOCHI,527,303,KOCHI-KOZHIKODE,830,All
2015,6,KOZHIKODE,KOCHI,255,204,KOCHI-KOZHIKODE,459,All
2015,7,KOZHIKODE,KOCHI,226,261,KOCHI-KOZHIKODE,487,All
2015,8,KOZHIKODE,KOCHI,402,184,KOCHI-KOZHIKODE,586,All
2015,9,KOZHIKODE,KOCHI,530,366,KOCHI-KOZHIKODE,896,All
2015,10,KOZHIKODE,KOCHI,437,321,KOCHI-KOZHIKODE,758,All
2015,11,KOZHIKODE,KOCHI,253,470,KOCHI-KOZHIKODE,723,All
2015,12,KOZHIKODE,KOCHI,107,490,KOCHI-KOZHIKODE,597,All
2016,1,KOZHIKODE,KOCHI,421,314,KOCHI-KOZHIKODE,735,All
2016,2,KOZHIKODE,KOCHI,178,332,KOCHI-KOZHIKODE,510,All
2016,3,KOZHIKODE,KOCHI,312,373,KOCHI-KOZHIKODE,685,All
2016,4,KOZHIKODE,KOCHI,229,361,KOCHI-KOZHIKODE,590,All
2016,5,KOZHIKODE,KOCHI,328,427,KOCHI-KOZHIKODE,755,All
2016,6,KOZHIKODE,KOCHI,189,240,KOCHI-KOZHIKODE,429,All
2016,7,KOZHIKODE,KOCHI,216,227,KOCHI-KOZHIKODE,443,All
2016,8,KOZHIKODE,KOCHI,401,79,KOCHI-KOZHIKODE,480,All
2016,9,KOZHIKODE,KOCHI,532,143,KOCHI-KOZHIKODE,675,All
2016,10,KOZHIKODE,KOCHI,532,143,KOCHI-KOZHIKODE,675,All
2016,11,KOZHIKODE,KOCHI,585,327,KOCHI-KOZHIKODE,912,All
2016,12,KOZHIKODE,KOCHI,876,688,KOCHI-KOZHIKODE,1564,All
2017,1,KOZHIKODE,KOCHI,551,599,KOCHI-KOZHIKODE,1150,All
2017,2,KOZHIKODE,KOCHI,350,365,KOCHI-KOZHIKODE,715,All
2017,3,KOZHIKODE,KOCHI,396,261,KOCHI-KOZHIKODE,657,All
2017,4,KOZHIKODE,KOCHI,746,384,KOCHI-KOZHIKODE,1130,All
2017,5,KOZHIKODE,KOCHI,458,615,KOCHI-KOZHIKODE,1073,All
2017,6,KOZHIKODE,KOCHI,195,270,KOCHI-KOZHIKODE,465,All
2017,7,KOZHIKODE,KOCHI,127,433,KOCHI-KOZHIKODE,560,All
2017,8,KOZHIKODE,KOCHI,251,194,KOCHI-KOZHIKODE,445,All
2017,9,KOZHIKODE,KOCHI,396,353,KOCHI-KOZHIKODE,749,All
2017,10,KOZHIKODE,KOCHI,468,814,KOCHI-KOZHIKODE,1282,All
2017,11,KOZHIKODE,KOCHI,359,410,KOCHI-KOZHIKODE,769,All
2017,12,KOZHIKODE,KOCHI,604,573,KOCHI-KOZHIKODE,1177,All
2018,1,KOZHIKODE,KOCHI,393,670,KOCHI-KOZHIKODE,1063,All
2018,2,KOZHIKODE,KOCHI,495,719,KOCHI-KOZHIKODE,1214,All
2018,3,KOZHIKODE,KOCHI,402,524,KOCHI-KOZHIKODE,926,All
2018,4,KOZHIKODE,KOCHI,635,705,KOCHI-KOZHIKODE,1340,All
2018,5,KOZHIKODE,KOCHI,565,474,KOCHI-KOZHIKODE,1039,All
2018,6,KOZHIKODE,KOCHI,194,202,KOCHI-KOZHIKODE,396,All
2018,7,KOZHIKODE,KOCHI,317,365,KOCHI-KOZHIKODE,682,All
2018,8,KOZHIKODE,KOCHI,251,235,KOCHI-KOZHIKODE,486,All
2018,9,KOZHIKODE,KOCHI,674,399,KOCHI-KOZHIKODE,1073,All
2018,10,KOZHIKODE,KOCHI,396,306,KOCHI-KOZHIKODE,702,All
2018,11,KOZHIKODE,KOCHI,268,234,KOCHI-KOZHIKODE,502,All
2018,12,KOZHIKODE,KOCHI,477,409,KOCHI-KOZHIKODE,886,All
2019,1,KOZHIKODE,KOCHI,544,355,KOCHI-KOZHIKODE,899,All
2019,2,KOZHIKODE,KOCHI,433,382,KOCHI-KOZHIKODE,815,All
2019,3,KOZHIKODE,KOCHI,321,245,KOCHI-KOZHIKODE,566,All
2019,4,KOZHIKODE,KOCHI,494,261,KOCHI-KOZHIKODE,755,All
2015,11,KOZHIKODE,KOLKATA,1555,1682,KOLKATA-KOZHIKODE,3237,All
2021,10,KOZHIKODE,LUCKNOW,0,3,KOZHIKODE-LUCKNOW,3,All
2022,1,KOZHIKODE,LUCKNOW,0,10,KOZHIKODE-LUCKNOW,10,All
2018,10,KOZHIKODE,MADURAI,144,47,KOZHIKODE-MADURAI,191,All
2021,4,KOZHIKODE,MANGALORE,0,59,KOZHIKODE-MANGALORE,59,All
2019,5,KOZHIKODE,MUMBAI,6644,9564,KOZHIKODE-MUMBAI,16208,All
2019,6,KOZHIKODE,MUMBAI,6306,6881,KOZHIKODE-MUMBAI,13187,All
2019,7,KOZHIKODE,MUMBAI,7244,8475,KOZHIKODE-MUMBAI,15719,All
2019,8,KOZHIKODE,MUMBAI,8849,8337,KOZHIKODE-MUMBAI,17186,All
2019,9,KOZHIKODE,MUMBAI,8501,7548,KOZHIKODE-MUMBAI,16049,All
2019,10,KOZHIKODE,MUMBAI,6056,7290,KOZHIKODE-MUMBAI,13346,All
2019,11,KOZHIKODE,MUMBAI,7906,7156,KOZHIKODE-MUMBAI,15062,All
2019,12,KOZHIKODE,MUMBAI,7670,8718,KOZHIKODE-MUMBAI,16388,All
2020,1,KOZHIKODE,MUMBAI,8316,7952,KOZHIKODE-MUMBAI,16268,All
2020,2,KOZHIKODE,MUMBAI,6850,7099,KOZHIKODE-MUMBAI,13949,All
2020,3,KOZHIKODE,MUMBAI,4393,4675,KOZHIKODE-MUMBAI,9068,All
2020,5,KOZHIKODE,MUMBAI,0,21,KOZHIKODE-MUMBAI,21,All
2020,6,KOZHIKODE,MUMBAI,0,0,KOZHIKODE-MUMBAI,0,All
2020,7,KOZHIKODE,MUMBAI,0,566,KOZHIKODE-MUMBAI,566,All
2020,9,KOZHIKODE,MUMBAI,844,482,KOZHIKODE-MUMBAI,1326,All
2020,10,KOZHIKODE,MUMBAI,1334,877,KOZHIKODE-MUMBAI,2211,All
2020,11,KOZHIKODE,MUMBAI,619,749,KOZHIKODE-MUMBAI,1368,All
2020,12,KOZHIKODE,MUMBAI,325,767,KOZHIKODE-MUMBAI,1092,All
2021,1,KOZHIKODE,MUMBAI,919,1154,KOZHIKODE-MUMBAI,2073,All
2021,2,KOZHIKODE,MUMBAI,1645,2246,KOZHIKODE-MUMBAI,3891,All
2021,3,KOZHIKODE,MUMBAI,1654,1797,KOZHIKODE-MUMBAI,3451,All
2021,4,KOZHIKODE,MUMBAI,1757,1674,KOZHIKODE-MUMBAI,3431,All
2021,6,KOZHIKODE,MUMBAI,114,0,KOZHIKODE-MUMBAI,114,All
2021,7,KOZHIKODE,MUMBAI,1400,1276,KOZHIKODE-MUMBAI,2676,All
2021,8,KOZHIKODE,MUMBAI,1196,328,KOZHIKODE-MUMBAI,1524,All
2021,9,KOZHIKODE,MUMBAI,233,0,KOZHIKODE-MUMBAI,233,All
2021,10,KOZHIKODE,MUMBAI,2848,1898,KOZHIKODE-MUMBAI,4746,All
2021,11,KOZHIKODE,MUMBAI,3362,3422,KOZHIKODE-MUMBAI,6784,All
2021,12,KOZHIKODE,MUMBAI,3336,3605,KOZHIKODE-MUMBAI,6941,All
2022,1,KOZHIKODE,MUMBAI,2454,2598,KOZHIKODE-MUMBAI,5052,All
2022,2,KOZHIKODE,MUMBAI,2611,2532,KOZHIKODE-MUMBAI,5143,All
2022,3,KOZHIKODE,MUMBAI,4889,4669,KOZHIKODE-MUMBAI,9558,All
2022,4,KOZHIKODE,MUMBAI,7884,7739,KOZHIKODE-MUMBAI,15623,All
2022,5,KOZHIKODE,MUMBAI,9007,9911,KOZHIKODE-MUMBAI,18918,All
2022,6,KOZHIKODE,MUMBAI,6429,7116,KOZHIKODE-MUMBAI,13545,All
2022,7,KOZHIKODE,MUMBAI,6206,6908,KOZHIKODE-MUMBAI,13114,All
2022,8,KOZHIKODE,MUMBAI,7474,6834,KOZHIKODE-MUMBAI,14308,All
2022,9,KOZHIKODE,MUMBAI,7520,6271,KOZHIKODE-MUMBAI,13791,All
2022,10,KOZHIKODE,MUMBAI,6665,6326,KOZHIKODE-MUMBAI,12991,All
2022,11,KOZHIKODE,MUMBAI,7713,7073,KOZHIKODE-MUMBAI,14786,All
2022,12,KOZHIKODE,MUMBAI,7868,10532,KOZHIKODE-MUMBAI,18400,All
2023,11,KOZHIKODE,MUMBAI,9428,9427,KOZHIKODE-MUMBAI,18855,All
2023,12,KOZHIKODE,MUMBAI,9745,10712,KOZHIKODE-MUMBAI,20457,All
2024,1,KOZHIKODE,MUMBAI,9869,9591,KOZHIKODE-MUMBAI,19460,All
2024,2,KOZHIKODE,MUMBAI,7698,7304,KOZHIKODE-MUMBAI,15002,All
2024,3,KOZHIKODE,MUMBAI,9894,9199,KOZHIKODE-MUMBAI,19093,All
2024,4,KOZHIKODE,MUMBAI,9526,9752,KOZHIKODE-MUMBAI,19278,All
2024,6,KOZHIKODE,MUMBAI,6786,7352,KOZHIKODE-MUMBAI,14138,All
2024,7,KOZHIKODE,MUMBAI,4730,5518,KOZHIKODE-MUMBAI,10248,All
2024,8,KOZHIKODE,MUMBAI,5562,5043,KOZHIKODE-MUMBAI,10605,All
2024,9,KOZHIKODE,MUMBAI,5659,5051,KOZHIKODE-MUMBAI,10710,All
2024,10,KOZHIKODE,MUMBAI,5141,5326,KOZHIKODE-MUMBAI,10467,All
2024,11,KOZHIKODE,MUMBAI,6876,6021,KOZHIKODE-MUMBAI,12897,All
2024,12,KOZHIKODE,MUMBAI,7465,8167,KOZHIKODE-MUMBAI,15632,All
2025,1,KOZHIKODE,MUMBAI,8253,8069,KOZHIKODE-MUMBAI,16322,All
2025,2,KOZHIKODE,MUMBAI,7113,6885,KOZHIKODE-MUMBAI,13998,All
2025,3,KOZHIKODE,MUMBAI,7102,6432,KOZHIKODE-MUMBAI,13534,All
2021,3,KOZHIKODE,PATNA,9,0,KOZHIKODE-PATNA,9,All
2021,4,KOZHIKODE,PATNA,20,0,KOZHIKODE-PATNA,20,All
2021,7,KOZHIKODE,PATNA,49,0,KOZHIKODE-PATNA,49,All
2018,8,KOZHIKODE,PORT BLAIR,141,0,KOZHIKODE-PORT BLAIR,141,All
2019,8,KOZHIKODE,PORT BLAIR,16,0,KOZHIKODE-PORT BLAIR,16,All
2024,7,KOZHIKODE,TIRUCHIRAPALLY,0,32,KOZHIKODE-TIRUCHIRAPALLY,32,All
2015,4,KOZHIKODE,TRIVANDRUM,539,178,KOZHIKODE-TRIVANDRUM,717,All
2015,5,KOZHIKODE,TRIVANDRUM,667,287,KOZHIKODE-TRIVANDRUM,954,All
2015,6,KOZHIKODE,TRIVANDRUM,287,138,KOZHIKODE-TRIVANDRUM,425,All
2015,7,KOZHIKODE,TRIVANDRUM,417,176,KOZHIKODE-TRIVANDRUM,593,All
2015,8,KOZHIKODE,TRIVANDRUM,684,177,KOZHIKODE-TRIVANDRUM,861,All
2015,9,KOZHIKODE,TRIVANDRUM,929,340,KOZHIKODE-TRIVANDRUM,1269,All
2015,10,KOZHIKODE,TRIVANDRUM,750,310,KOZHIKODE-TRIVANDRUM,1060,All
2015,11,KOZHIKODE,TRIVANDRUM,741,152,KOZHIKODE-TRIVANDRUM,893,All
2015,12,KOZHIKODE,TRIVANDRUM,906,348,KOZHIKODE-TRIVANDRUM,1254,All
2016,1,KOZHIKODE,TRIVANDRUM,732,360,KOZHIKODE-TRIVANDRUM,1092,All
2016,2,KOZHIKODE,TRIVANDRUM,636,173,KOZHIKODE-TRIVANDRUM,809,All
2016,3,KOZHIKODE,TRIVANDRUM,903,586,KOZHIKODE-TRIVANDRUM,1489,All
2016,4,KOZHIKODE,TRIVANDRUM,724,725,KOZHIKODE-TRIVANDRUM,1449,All
2016,5,KOZHIKODE,TRIVANDRUM,851,831,KOZHIKODE-TRIVANDRUM,1682,All
2016,6,KOZHIKODE,TRIVANDRUM,368,268,KOZHIKODE-TRIVANDRUM,636,All
2016,7,KOZHIKODE,TRIVANDRUM,269,249,KOZHIKODE-TRIVANDRUM,518,All
2016,8,KOZHIKODE,TRIVANDRUM,638,559,KOZHIKODE-TRIVANDRUM,1197,All
2016,9,KOZHIKODE,TRIVANDRUM,620,325,KOZHIKODE-TRIVANDRUM,945,All
2016,10,KOZHIKODE,TRIVANDRUM,620,325,KOZHIKODE-TRIVANDRUM,945,All
2016,11,KOZHIKODE,TRIVANDRUM,507,436,KOZHIKODE-TRIVANDRUM,943,All
2016,12,KOZHIKODE,TRIVANDRUM,469,394,KOZHIKODE-TRIVANDRUM,863,All
2017,1,KOZHIKODE,TRIVANDRUM,1175,607,KOZHIKODE-TRIVANDRUM,1782,All
2017,2,KOZHIKODE,TRIVANDRUM,981,876,KOZHIKODE-TRIVANDRUM,1857,All
2017,3,KOZHIKODE,TRIVANDRUM,1396,986,KOZHIKODE-TRIVANDRUM,2382,All
2017,4,KOZHIKODE,TRIVANDRUM,2137,1926,KOZHIKODE-TRIVANDRUM,4063,All
2017,5,KOZHIKODE,TRIVANDRUM,2193,2239,KOZHIKODE-TRIVANDRUM,4432,All
2017,6,KOZHIKODE,TRIVANDRUM,1340,944,KOZHIKODE-TRIVANDRUM,2284,All
2017,7,KOZHIKODE,TRIVANDRUM,1598,1564,KOZHIKODE-TRIVANDRUM,3162,All
2017,8,KOZHIKODE,TRIVANDRUM,2048,1428,KOZHIKODE-TRIVANDRUM,3476,All
2017,9,KOZHIKODE,TRIVANDRUM,1967,1391,KOZHIKODE-TRIVANDRUM,3358,All
2017,10,KOZHIKODE,TRIVANDRUM,1926,1315,KOZHIKODE-TRIVANDRUM,3241,All
2017,11,KOZHIKODE,TRIVANDRUM,1913,1209,KOZHIKODE-TRIVANDRUM,3122,All
2017,12,KOZHIKODE,TRIVANDRUM,2515,2080,KOZHIKODE-TRIVANDRUM,4595,All
2018,1,KOZHIKODE,TRIVANDRUM,2619,1617,KOZHIKODE-TRIVANDRUM,4236,All
2018,2,KOZHIKODE,TRIVANDRUM,1997,1495,KOZHIKODE-TRIVANDRUM,3492,All
2018,3,KOZHIKODE,TRIVANDRUM,1949,1360,KOZHIKODE-TRIVANDRUM,3309,All
2018,4,KOZHIKODE,TRIVANDRUM,2301,1364,KOZHIKODE-TRIVANDRUM,3665,All
2018,5,KOZHIKODE,TRIVANDRUM,1330,849,KOZHIKODE-TRIVANDRUM,2179,All
2018,6,KOZHIKODE,TRIVANDRUM,617,600,KOZHIKODE-TRIVANDRUM,1217,All
2018,7,KOZHIKODE,TRIVANDRUM,1243,923,KOZHIKODE-TRIVANDRUM,2166,All
2018,8,KOZHIKODE,TRIVANDRUM,1871,1511,KOZHIKODE-TRIVANDRUM,3382,All
2018,9,KOZHIKODE,TRIVANDRUM,977,720,KOZHIKODE-TRIVANDRUM,1697,All
2018,10,KOZHIKODE,TRIVANDRUM,1158,788,KOZHIKODE-TRIVANDRUM,1946,All
2018,11,KOZHIKODE,TRIVANDRUM,1409,1056,KOZHIKODE-TRIVANDRUM,2465,All
2018,12,KOZHIKODE,TRIVANDRUM,1570,1541,KOZHIKODE-TRIVANDRUM,3111,All
2019,1,KOZHIKODE,TRIVANDRUM,1495,1022,KOZHIKODE-TRIVANDRUM,2517,All
2019,2,KOZHIKODE,TRIVANDRUM,1210,896,KOZHIKODE-TRIVANDRUM,2106,All
2019,3,KOZHIKODE,TRIVANDRUM,1170,849,KOZHIKODE-TRIVANDRUM,2019,All
2019,4,KOZHIKODE,TRIVANDRUM,1126,843,KOZHIKODE-TRIVANDRUM,1969,All
2019,5,KOZHIKODE,TRIVANDRUM,687,638,KOZHIKODE-TRIVANDRUM,1325,All
2019,6,KOZHIKODE,TRIVANDRUM,625,593,KOZHIKODE-TRIVANDRUM,1218,All
2019,7,KOZHIKODE,TRIVANDRUM,631,645,KOZHIKODE-TRIVANDRUM,1276,All
2019,8,KOZHIKODE,TRIVANDRUM,929,898,KOZHIKODE-TRIVANDRUM,1827,All
2019,9,KOZHIKODE,TRIVANDRUM,927,626,KOZHIKODE-TRIVANDRUM,1553,All
2019,10,KOZHIKODE,TRIVANDRUM,754,498,KOZHIKODE-TRIVANDRUM,1252,All
2019,11,KOZHIKODE,TRIVANDRUM,957,646,KOZHIKODE-TRIVANDRUM,1603,All
2019,12,KOZHIKODE,TRIVANDRUM,822,718,KOZHIKODE-TRIVANDRUM,1540,All
2020,1,KOZHIKODE,TRIVANDRUM,909,437,KOZHIKODE-TRIVANDRUM,1346,All
2020,2,KOZHIKODE,TRIVANDRUM,639,452,KOZHIKODE-TRIVANDRUM,1091,All
2020,3,KOZHIKODE,TRIVANDRUM,383,358,KOZHIKODE-TRIVANDRUM,741,All
2021,1,KOZHIKODE,TRIVANDRUM,0,0,KOZHIKODE-TRIVANDRUM,0,All
2021,10,KOZHIKODE,TRIVANDRUM,0,0,KOZHIKODE-TRIVANDRUM,0,All
2022,11,KOZHIKODE,TRIVANDRUM,0,169,KOZHIKODE-TRIVANDRUM,169,All
2024,6,KOZHIKODE,TRIVANDRUM,59,8,KOZHIKODE-TRIVANDRUM,67,All
2024,7,KOZHIKODE,TRIVANDRUM,53,16,KOZHIKODE-TRIVANDRUM,69,All
2024,10,KOZHIKODE,TRIVANDRUM,0,11,KOZHIKODE-TRIVANDRUM,11,All
2018,3,KOZHIKODE,VARANASI,26,9,KOZHIKODE-VARANASI,35,All
2018,4,KOZHIKODE,VARANASI,71,52,KOZHIKODE-VARANASI,123,All
2021,10,KOZHIKODE,VIJAYAWADA,0,0,KOZHIKODE-VIJAYAWADA,0,All
2019,5,KULLU,SIMLA,0,12,KULLU-SIMLA,12,All
2019,6,KULLU,SIMLA,34,19,KULLU-SIMLA,53,All
2019,7,KULLU,SIMLA,0,2,KULLU-SIMLA,2,All
2019,8,KULLU,SIMLA,0,4,KULLU-SIMLA,4,All
2019,9,KULLU,SIMLA,23,2,KULLU-SIMLA,25,All
2019,10,KULLU,SIMLA,47,33,KULLU-SIMLA,80,All
2019,11,KULLU,SIMLA,74,15,KULLU-SIMLA,89,All
2019,12,KULLU,SIMLA,34,24,KULLU-SIMLA,58,All
2020,1,KULLU,SIMLA,0,1,KULLU-SIMLA,1,All
2020,2,KULLU,SIMLA,47,32,KULLU-SIMLA,79,All
2020,3,KULLU,SIMLA,23,10,KULLU-SIMLA,33,All
2020,6,KULLU,SIMLA,1,0,KULLU-SIMLA,1,All
2020,7,KULLU,SIMLA,2,5,KULLU-SIMLA,7,All
2020,8,KULLU,SIMLA,4,3,KULLU-SIMLA,7,All
2020,9,KULLU,SIMLA,12,8,KULLU-SIMLA,20,All
2020,10,KULLU,SIMLA,34,30,KULLU-SIMLA,64,All
2020,11,KULLU,SIMLA,3,4,KULLU-SIMLA,7,All
2020,12,KULLU,SIMLA,41,25,KULLU-SIMLA,66,All
2021,1,KULLU,SIMLA,33,22,KULLU-SIMLA,55,All
2021,2,KULLU,SIMLA,61,24,KULLU-SIMLA,85,All
2021,3,KULLU,SIMLA,48,30,KULLU-SIMLA,78,All
2021,4,KULLU,SIMLA,6,12,KULLU-SIMLA,18,All
2021,6,KULLU,SIMLA,24,19,KULLU-SIMLA,43,All
2021,7,KULLU,SIMLA,37,19,KULLU-SIMLA,56,All
2021,8,KULLU,SIMLA,26,7,KULLU-SIMLA,33,All
2021,9,KULLU,SIMLA,40,21,KULLU-SIMLA,61,All
2021,10,KULLU,SIMLA,70,33,KULLU-SIMLA,103,All
2021,11,KULLU,SIMLA,76,47,KULLU-SIMLA,123,All
2021,12,KULLU,SIMLA,15,5,KULLU-SIMLA,20,All
2022,12,KULLU,SIMLA,41,36,KULLU-SIMLA,77,All
2023,1,KULLU,SIMLA,34,62,KULLU-SIMLA,96,All
2023,2,KULLU,SIMLA,68,53,KULLU-SIMLA,121,All
2023,3,KULLU,SIMLA,73,75,KULLU-SIMLA,148,All
2023,4,KULLU,SIMLA,98,152,KULLU-SIMLA,250,All
2023,5,KULLU,SIMLA,158,143,KULLU-SIMLA,301,All
2023,6,KULLU,SIMLA,46,79,KULLU-SIMLA,125,All
2023,7,KULLU,SIMLA,6,18,KULLU-SIMLA,24,All
2021,3,KURNOOL,VISAKHAPATNAM,136,120,KURNOOL-VISAKHAPATNAM,256,All
2021,4,KURNOOL,VISAKHAPATNAM,693,765,KURNOOL-VISAKHAPATNAM,1458,All
2021,6,KURNOOL,VISAKHAPATNAM,501,536,KURNOOL-VISAKHAPATNAM,1037,All
2021,7,KURNOOL,VISAKHAPATNAM,670,727,KURNOOL-VISAKHAPATNAM,1397,All
2021,8,KURNOOL,VISAKHAPATNAM,804,783,KURNOOL-VISAKHAPATNAM,1587,All
2021,9,KURNOOL,VISAKHAPATNAM,653,677,KURNOOL-VISAKHAPATNAM,1330,All
2021,10,KURNOOL,VISAKHAPATNAM,900,848,KURNOOL-VISAKHAPATNAM,1748,All
2021,11,KURNOOL,VISAKHAPATNAM,655,672,KURNOOL-VISAKHAPATNAM,1327,All
2021,12,KURNOOL,VISAKHAPATNAM,810,765,KURNOOL-VISAKHAPATNAM,1575,All
2022,1,KURNOOL,VISAKHAPATNAM,671,611,KURNOOL-VISAKHAPATNAM,1282,All
2022,2,KURNOOL,VISAKHAPATNAM,611,603,KURNOOL-VISAKHAPATNAM,1214,All
2022,3,KURNOOL,VISAKHAPATNAM,626,673,KURNOOL-VISAKHAPATNAM,1299,All
2022,4,KURNOOL,VISAKHAPATNAM,735,683,KURNOOL-VISAKHAPATNAM,1418,All
2022,5,KURNOOL,VISAKHAPATNAM,761,802,KURNOOL-VISAKHAPATNAM,1563,All
2022,6,KURNOOL,VISAKHAPATNAM,883,867,KURNOOL-VISAKHAPATNAM,1750,All
2022,7,KURNOOL,VISAKHAPATNAM,500,559,KURNOOL-VISAKHAPATNAM,1059,All
2022,8,KURNOOL,VISAKHAPATNAM,707,779,KURNOOL-VISAKHAPATNAM,1486,All
2022,9,KURNOOL,VISAKHAPATNAM,472,414,KURNOOL-VISAKHAPATNAM,886,All
2022,10,KURNOOL,VISAKHAPATNAM,646,644,KURNOOL-VISAKHAPATNAM,1290,All
2022,11,KURNOOL,VISAKHAPATNAM,448,459,KURNOOL-VISAKHAPATNAM,907,All
2022,12,KURNOOL,VISAKHAPATNAM,649,651,KURNOOL-VISAKHAPATNAM,1300,All
2023,1,KURNOOL,VISAKHAPATNAM,639,672,KURNOOL-VISAKHAPATNAM,1311,All
2023,2,KURNOOL,VISAKHAPATNAM,339,269,KURNOOL-VISAKHAPATNAM,608,All
2023,3,KURNOOL,VISAKHAPATNAM,570,560,KURNOOL-VISAKHAPATNAM,1130,All
2023,4,KURNOOL,VISAKHAPATNAM,494,445,KURNOOL-VISAKHAPATNAM,939,All
2023,5,KURNOOL,VISAKHAPATNAM,743,762,KURNOOL-VISAKHAPATNAM,1505,All
2023,6,KURNOOL,VISAKHAPATNAM,706,664,KURNOOL-VISAKHAPATNAM,1370,All
2023,7,KURNOOL,VISAKHAPATNAM,649,606,KURNOOL-VISAKHAPATNAM,1255,All
2023,8,KURNOOL,VISAKHAPATNAM,664,639,KURNOOL-VISAKHAPATNAM,1303,All
2023,9,KURNOOL,VISAKHAPATNAM,666,594,KURNOOL-VISAKHAPATNAM,1260,All
2023,10,KURNOOL,VISAKHAPATNAM,871,868,KURNOOL-VISAKHAPATNAM,1739,All
2023,11,KURNOOL,VISAKHAPATNAM,774,705,KURNOOL-VISAKHAPATNAM,1479,All
2023,12,KURNOOL,VISAKHAPATNAM,717,549,KURNOOL-VISAKHAPATNAM,1266,All
2024,1,KURNOOL,VISAKHAPATNAM,778,758,KURNOOL-VISAKHAPATNAM,1536,All
2024,2,KURNOOL,VISAKHAPATNAM,626,580,KURNOOL-VISAKHAPATNAM,1206,All
2024,3,KURNOOL,VISAKHAPATNAM,390,386,KURNOOL-VISAKHAPATNAM,776,All
2024,4,KURNOOL,VISAKHAPATNAM,318,383,KURNOOL-VISAKHAPATNAM,701,All
2024,6,KURNOOL,VISAKHAPATNAM,400,382,KURNOOL-VISAKHAPATNAM,782,All
2024,7,KURNOOL,VISAKHAPATNAM,293,334,KURNOOL-VISAKHAPATNAM,627,All
2024,8,KURNOOL,VISAKHAPATNAM,359,374,KURNOOL-VISAKHAPATNAM,733,All
2024,9,KURNOOL,VISAKHAPATNAM,268,281,KURNOOL-VISAKHAPATNAM,549,All
2024,10,KURNOOL,VISAKHAPATNAM,465,460,KURNOOL-VISAKHAPATNAM,925,All
2024,11,KURNOOL,VISAKHAPATNAM,394,386,KURNOOL-VISAKHAPATNAM,780,All
2024,12,KURNOOL,VISAKHAPATNAM,298,311,KURNOOL-VISAKHAPATNAM,609,All
2025,1,KURNOOL,VISAKHAPATNAM,357,281,KURNOOL-VISAKHAPATNAM,638,All
2025,2,KURNOOL,VISAKHAPATNAM,227,214,KURNOOL-VISAKHAPATNAM,441,All
2025,3,KURNOOL,VISAKHAPATNAM,366,315,KURNOOL-VISAKHAPATNAM,681,All
2024,2,Kishangarh,HINDON AIRPORT,313,327,HINDON AIRPORT-Kishangarh,640,All
2024,3,Kishangarh,HINDON AIRPORT,458,507,HINDON AIRPORT-Kishangarh,965,All
2024,4,Kishangarh,HINDON AIRPORT,586,391,HINDON AIRPORT-Kishangarh,977,All
2024,6,Kishangarh,HINDON AIRPORT,404,559,HINDON AIRPORT-Kishangarh,963,All
2024,7,Kishangarh,HINDON AIRPORT,334,450,HINDON AIRPORT-Kishangarh,784,All
2024,8,Kishangarh,HINDON AIRPORT,385,389,HINDON AIRPORT-Kishangarh,774,All
2024,9,Kishangarh,HINDON AIRPORT,444,456,HINDON AIRPORT-Kishangarh,900,All
2024,10,Kishangarh,HINDON AIRPORT,520,525,HINDON AIRPORT-Kishangarh,1045,All
2024,11,Kishangarh,HINDON AIRPORT,570,628,HINDON AIRPORT-Kishangarh,1198,All
2024,12,Kishangarh,HINDON AIRPORT,467,720,HINDON AIRPORT-Kishangarh,1187,All
2025,1,Kishangarh,HINDON AIRPORT,567,587,HINDON AIRPORT-Kishangarh,1154,All
2025,2,Kishangarh,HINDON AIRPORT,546,623,HINDON AIRPORT-Kishangarh,1169,All
2025,3,Kishangarh,HINDON AIRPORT,771,734,HINDON AIRPORT-Kishangarh,1505,All
2023,1,Kishangarh,INDORE,235,226,INDORE-Kishangarh,461,All
2024,2,Kishangarh,LUCKNOW,331,284,Kishangarh-LUCKNOW,615,All
2024,3,Kishangarh,LUCKNOW,606,535,Kishangarh-LUCKNOW,1141,All
2024,4,Kishangarh,LUCKNOW,640,569,Kishangarh-LUCKNOW,1209,All
2024,6,Kishangarh,LUCKNOW,483,525,Kishangarh-LUCKNOW,1008,All
2024,7,Kishangarh,LUCKNOW,286,384,Kishangarh-LUCKNOW,670,All
2024,8,Kishangarh,LUCKNOW,299,524,Kishangarh-LUCKNOW,823,All
2024,9,Kishangarh,LUCKNOW,609,609,Kishangarh-LUCKNOW,1218,All
2024,10,Kishangarh,LUCKNOW,625,635,Kishangarh-LUCKNOW,1260,All
2024,11,Kishangarh,LUCKNOW,705,816,Kishangarh-LUCKNOW,1521,All
2024,12,Kishangarh,LUCKNOW,714,874,Kishangarh-LUCKNOW,1588,All
2025,1,Kishangarh,LUCKNOW,1204,1232,Kishangarh-LUCKNOW,2436,All
2025,2,Kishangarh,LUCKNOW,1179,1218,Kishangarh-LUCKNOW,2397,All
2025,3,Kishangarh,LUCKNOW,523,533,Kishangarh-LUCKNOW,1056,All
2023,9,Kishangarh,NAGPUR,24,68,Kishangarh-NAGPUR,92,All
2023,10,Kishangarh,NAGPUR,720,850,Kishangarh-NAGPUR,1570,All
2023,11,Kishangarh,NAGPUR,754,1019,Kishangarh-NAGPUR,1773,All
2023,12,Kishangarh,NAGPUR,1287,1276,Kishangarh-NAGPUR,2563,All
2024,1,Kishangarh,NAGPUR,1182,1312,Kishangarh-NAGPUR,2494,All
2024,2,Kishangarh,NAGPUR,1294,1358,Kishangarh-NAGPUR,2652,All
2024,3,Kishangarh,NAGPUR,1067,1008,Kishangarh-NAGPUR,2075,All
2024,4,Kishangarh,NAGPUR,708,831,Kishangarh-NAGPUR,1539,All
2024,6,Kishangarh,NAGPUR,527,675,Kishangarh-NAGPUR,1202,All
2024,7,Kishangarh,NAGPUR,463,660,Kishangarh-NAGPUR,1123,All
2024,8,Kishangarh,NAGPUR,624,732,Kishangarh-NAGPUR,1356,All
2024,9,Kishangarh,NAGPUR,759,717,Kishangarh-NAGPUR,1476,All
2024,10,Kishangarh,NAGPUR,777,1125,Kishangarh-NAGPUR,1902,All
2024,11,Kishangarh,NAGPUR,1180,1215,Kishangarh-NAGPUR,2395,All
2024,12,Kishangarh,NAGPUR,1086,1192,Kishangarh-NAGPUR,2278,All
2025,1,Kishangarh,NAGPUR,1182,1228,Kishangarh-NAGPUR,2410,All
2025,2,Kishangarh,NAGPUR,1110,1153,Kishangarh-NAGPUR,2263,All
2025,3,Kishangarh,NAGPUR,887,932,Kishangarh-NAGPUR,1819,All
2023,10,Kishangarh,PUNE,68,78,Kishangarh-PUNE,146,All
2023,11,Kishangarh,PUNE,551,840,Kishangarh-PUNE,1391,All
2023,12,Kishangarh,PUNE,1204,1165,Kishangarh-PUNE,2369,All
2024,1,Kishangarh,PUNE,1058,1246,Kishangarh-PUNE,2304,All
2024,2,Kishangarh,PUNE,1248,1273,Kishangarh-PUNE,2521,All
2024,3,Kishangarh,PUNE,1198,1368,Kishangarh-PUNE,2566,All
2024,4,Kishangarh,PUNE,970,1152,Kishangarh-PUNE,2122,All
2024,6,Kishangarh,PUNE,1018,1121,Kishangarh-PUNE,2139,All
2024,7,Kishangarh,PUNE,974,1231,Kishangarh-PUNE,2205,All
2024,8,Kishangarh,PUNE,1134,1382,Kishangarh-PUNE,2516,All
2024,9,Kishangarh,PUNE,1164,1339,Kishangarh-PUNE,2503,All
2024,10,Kishangarh,PUNE,942,1351,Kishangarh-PUNE,2293,All
2024,11,Kishangarh,PUNE,1405,1443,Kishangarh-PUNE,2848,All
2024,12,Kishangarh,PUNE,1412,1501,Kishangarh-PUNE,2913,All
2025,1,Kishangarh,PUNE,1481,1589,Kishangarh-PUNE,3070,All
2025,2,Kishangarh,PUNE,1217,1479,Kishangarh-PUNE,2696,All
2025,3,Kishangarh,PUNE,1213,1487,Kishangarh-PUNE,2700,All
2023,1,Kishangarh,SURAT,306,314,Kishangarh-SURAT,620,All
2023,6,Kishangarh,SURAT,620,653,Kishangarh-SURAT,1273,All
2023,7,Kishangarh,SURAT,520,623,Kishangarh-SURAT,1143,All
2023,8,Kishangarh,SURAT,670,650,Kishangarh-SURAT,1320,All
2023,9,Kishangarh,SURAT,712,643,Kishangarh-SURAT,1355,All
2023,10,Kishangarh,SURAT,712,725,Kishangarh-SURAT,1437,All
2023,11,Kishangarh,SURAT,610,677,Kishangarh-SURAT,1287,All
2023,12,Kishangarh,SURAT,794,706,Kishangarh-SURAT,1500,All
2024,1,Kishangarh,SURAT,636,687,Kishangarh-SURAT,1323,All
2024,2,Kishangarh,SURAT,670,758,Kishangarh-SURAT,1428,All
2024,3,Kishangarh,SURAT,641,756,Kishangarh-SURAT,1397,All
2024,4,Kishangarh,SURAT,596,723,Kishangarh-SURAT,1319,All
2024,6,Kishangarh,SURAT,204,159,Kishangarh-SURAT,363,All
2019,5,LEH,MUMBAI,0,5088,LEH-MUMBAI,5088,All
2019,6,LEH,MUMBAI,0,5027,LEH-MUMBAI,5027,All
2019,7,LEH,MUMBAI,0,4319,LEH-MUMBAI,4319,All
2019,8,LEH,MUMBAI,0,3797,LEH-MUMBAI,3797,All
2019,9,LEH,MUMBAI,0,2610,LEH-MUMBAI,2610,All
2021,3,LEH,MUMBAI,0,215,LEH-MUMBAI,215,All
2021,4,LEH,MUMBAI,17,748,LEH-MUMBAI,765,All
2021,6,LEH,MUMBAI,0,1774,LEH-MUMBAI,1774,All
2021,7,LEH,MUMBAI,0,4900,LEH-MUMBAI,4900,All
2021,8,LEH,MUMBAI,2164,5928,LEH-MUMBAI,8092,All
2021,9,LEH,MUMBAI,1906,5244,LEH-MUMBAI,7150,All
2021,10,LEH,MUMBAI,1590,1236,LEH-MUMBAI,2826,All
2022,4,LEH,MUMBAI,0,3754,LEH-MUMBAI,3754,All
2022,5,LEH,MUMBAI,0,5441,LEH-MUMBAI,5441,All
2022,6,LEH,MUMBAI,0,5124,LEH-MUMBAI,5124,All
2022,7,LEH,MUMBAI,0,4401,LEH-MUMBAI,4401,All
2022,8,LEH,MUMBAI,0,3814,LEH-MUMBAI,3814,All
2022,9,LEH,MUMBAI,0,2879,LEH-MUMBAI,2879,All
2024,6,LEH,MUMBAI,4415,4640,LEH-MUMBAI,9055,All
2024,7,LEH,MUMBAI,4243,4206,LEH-MUMBAI,8449,All
2024,8,LEH,MUMBAI,4044,4202,LEH-MUMBAI,8246,All
2024,9,LEH,MUMBAI,3483,3099,LEH-MUMBAI,6582,All
2025,3,LEH,MUMBAI,33,167,LEH-MUMBAI,200,All
2015,4,LEH,SRINAGAR,448,529,LEH-SRINAGAR,977,All
2015,5,LEH,SRINAGAR,441,442,LEH-SRINAGAR,883,All
2015,6,LEH,SRINAGAR,460,372,LEH-SRINAGAR,832,All
2015,7,LEH,SRINAGAR,583,482,LEH-SRINAGAR,1065,All
2015,8,LEH,SRINAGAR,450,335,LEH-SRINAGAR,785,All
2015,9,LEH,SRINAGAR,462,354,LEH-SRINAGAR,816,All
2015,10,LEH,SRINAGAR,2398,3487,LEH-SRINAGAR,5885,All
2015,11,LEH,SRINAGAR,348,281,LEH-SRINAGAR,629,All
2015,12,LEH,SRINAGAR,625,493,LEH-SRINAGAR,1118,All
2016,1,LEH,SRINAGAR,448,338,LEH-SRINAGAR,786,All
2016,2,LEH,SRINAGAR,459,460,LEH-SRINAGAR,919,All
2016,3,LEH,SRINAGAR,673,593,LEH-SRINAGAR,1266,All
2016,4,LEH,SRINAGAR,3321,461,LEH-SRINAGAR,3782,All
2016,5,LEH,SRINAGAR,5484,405,LEH-SRINAGAR,5889,All
2016,6,LEH,SRINAGAR,5669,487,LEH-SRINAGAR,6156,All
2016,7,LEH,SRINAGAR,5201,378,LEH-SRINAGAR,5579,All
2016,8,LEH,SRINAGAR,5594,392,LEH-SRINAGAR,5986,All
2016,9,LEH,SRINAGAR,4831,310,LEH-SRINAGAR,5141,All
2016,10,LEH,SRINAGAR,518,289,LEH-SRINAGAR,807,All
2016,11,LEH,SRINAGAR,883,320,LEH-SRINAGAR,1203,All
2016,12,LEH,SRINAGAR,571,296,LEH-SRINAGAR,867,All
2017,1,LEH,SRINAGAR,226,174,LEH-SRINAGAR,400,All
2017,2,LEH,SRINAGAR,2042,429,LEH-SRINAGAR,2471,All
2017,3,LEH,SRINAGAR,1698,571,LEH-SRINAGAR,2269,All
2017,4,LEH,SRINAGAR,542,464,LEH-SRINAGAR,1006,All
2017,5,LEH,SRINAGAR,5721,537,LEH-SRINAGAR,6258,All
2017,6,LEH,SRINAGAR,5654,300,LEH-SRINAGAR,5954,All
2017,7,LEH,SRINAGAR,4664,327,LEH-SRINAGAR,4991,All
2017,8,LEH,SRINAGAR,4733,406,LEH-SRINAGAR,5139,All
2017,9,LEH,SRINAGAR,4405,507,LEH-SRINAGAR,4912,All
2017,10,LEH,SRINAGAR,574,291,LEH-SRINAGAR,865,All
2017,11,LEH,SRINAGAR,804,339,LEH-SRINAGAR,1143,All
2017,12,LEH,SRINAGAR,784,563,LEH-SRINAGAR,1347,All
2018,1,LEH,SRINAGAR,1501,692,LEH-SRINAGAR,2193,All
2018,2,LEH,SRINAGAR,674,820,LEH-SRINAGAR,1494,All
2018,3,LEH,SRINAGAR,457,897,LEH-SRINAGAR,1354,All
2018,4,LEH,SRINAGAR,2955,737,LEH-SRINAGAR,3692,All
2018,5,LEH,SRINAGAR,6060,1266,LEH-SRINAGAR,7326,All
2018,6,LEH,SRINAGAR,5566,699,LEH-SRINAGAR,6265,All
2018,7,LEH,SRINAGAR,5746,776,LEH-SRINAGAR,6522,All
2018,8,LEH,SRINAGAR,5983,750,LEH-SRINAGAR,6733,All
2018,9,LEH,SRINAGAR,5967,697,LEH-SRINAGAR,6664,All
2018,10,LEH,SRINAGAR,5678,575,LEH-SRINAGAR,6253,All
2018,11,LEH,SRINAGAR,1037,816,LEH-SRINAGAR,1853,All
2018,12,LEH,SRINAGAR,925,747,LEH-SRINAGAR,1672,All
2019,1,LEH,SRINAGAR,962,767,LEH-SRINAGAR,1729,All
2019,2,LEH,SRINAGAR,653,547,LEH-SRINAGAR,1200,All
2019,3,LEH,SRINAGAR,727,973,LEH-SRINAGAR,1700,All
2019,4,LEH,SRINAGAR,3172,909,LEH-SRINAGAR,4081,All
2019,5,LEH,SRINAGAR,4614,830,LEH-SRINAGAR,5444,All
2019,6,LEH,SRINAGAR,5789,744,LEH-SRINAGAR,6533,All
2019,7,LEH,SRINAGAR,5286,795,LEH-SRINAGAR,6081,All
2019,8,LEH,SRINAGAR,5667,487,LEH-SRINAGAR,6154,All
2019,9,LEH,SRINAGAR,5518,566,LEH-SRINAGAR,6084,All
2019,10,LEH,SRINAGAR,4522,398,LEH-SRINAGAR,4920,All
2019,11,LEH,SRINAGAR,827,591,LEH-SRINAGAR,1418,All
2019,12,LEH,SRINAGAR,750,642,LEH-SRINAGAR,1392,All
2020,1,LEH,SRINAGAR,934,573,LEH-SRINAGAR,1507,All
2020,2,LEH,SRINAGAR,810,834,LEH-SRINAGAR,1644,All
2020,3,LEH,SRINAGAR,615,638,LEH-SRINAGAR,1253,All
2020,9,LEH,SRINAGAR,160,0,LEH-SRINAGAR,160,All
2021,1,LEH,SRINAGAR,1479,0,LEH-SRINAGAR,1479,All
2021,2,LEH,SRINAGAR,1743,0,LEH-SRINAGAR,1743,All
2021,3,LEH,SRINAGAR,1813,148,LEH-SRINAGAR,1961,All
2021,4,LEH,SRINAGAR,2285,1251,LEH-SRINAGAR,3536,All
2021,6,LEH,SRINAGAR,1892,570,LEH-SRINAGAR,2462,All
2021,7,LEH,SRINAGAR,6343,955,LEH-SRINAGAR,7298,All
2021,8,LEH,SRINAGAR,5852,841,LEH-SRINAGAR,6693,All
2021,9,LEH,SRINAGAR,5200,1164,LEH-SRINAGAR,6364,All
2021,10,LEH,SRINAGAR,5295,1016,LEH-SRINAGAR,6311,All
2021,11,LEH,SRINAGAR,4606,774,LEH-SRINAGAR,5380,All
2021,12,LEH,SRINAGAR,937,690,LEH-SRINAGAR,1627,All
2022,1,LEH,SRINAGAR,679,668,LEH-SRINAGAR,1347,All
2022,2,LEH,SRINAGAR,1870,1054,LEH-SRINAGAR,2924,All
2022,3,LEH,SRINAGAR,1847,1506,LEH-SRINAGAR,3353,All
2022,4,LEH,SRINAGAR,4316,1020,LEH-SRINAGAR,5336,All
2022,5,LEH,SRINAGAR,10097,1084,LEH-SRINAGAR,11181,All
2022,6,LEH,SRINAGAR,12535,1191,LEH-SRINAGAR,13726,All
2022,7,LEH,SRINAGAR,9770,1001,LEH-SRINAGAR,10771,All
2022,8,LEH,SRINAGAR,9542,913,LEH-SRINAGAR,10455,All
2022,9,LEH,SRINAGAR,8749,1131,LEH-SRINAGAR,9880,All
2022,10,LEH,SRINAGAR,6012,907,LEH-SRINAGAR,6919,All
2022,11,LEH,SRINAGAR,1282,1021,LEH-SRINAGAR,2303,All
2022,12,LEH,SRINAGAR,1250,796,LEH-SRINAGAR,2046,All
2023,1,LEH,SRINAGAR,835,706,LEH-SRINAGAR,1541,All
2023,2,LEH,SRINAGAR,1037,1239,LEH-SRINAGAR,2276,All
2023,3,LEH,SRINAGAR,2515,1471,LEH-SRINAGAR,3986,All
2023,4,LEH,SRINAGAR,10077,1160,LEH-SRINAGAR,11237,All
2023,5,LEH,SRINAGAR,1819,1252,LEH-SRINAGAR,3071,All
2023,6,LEH,SRINAGAR,1340,1153,LEH-SRINAGAR,2493,All
2023,7,LEH,SRINAGAR,1115,1113,LEH-SRINAGAR,2228,All
2023,8,LEH,SRINAGAR,1419,1228,LEH-SRINAGAR,2647,All
2023,9,LEH,SRINAGAR,1123,937,LEH-SRINAGAR,2060,All
2023,10,LEH,SRINAGAR,1197,743,LEH-SRINAGAR,1940,All
2023,11,LEH,SRINAGAR,1452,784,LEH-SRINAGAR,2236,All
2023,12,LEH,SRINAGAR,1148,678,LEH-SRINAGAR,1826,All
2024,1,LEH,SRINAGAR,776,757,LEH-SRINAGAR,1533,All
2024,2,LEH,SRINAGAR,929,1200,LEH-SRINAGAR,2129,All
2024,3,LEH,SRINAGAR,779,1190,LEH-SRINAGAR,1969,All
2024,4,LEH,SRINAGAR,1204,1070,LEH-SRINAGAR,2274,All
2024,6,LEH,SRINAGAR,1091,861,LEH-SRINAGAR,1952,All
2024,7,LEH,SRINAGAR,1236,1038,LEH-SRINAGAR,2274,All
2024,8,LEH,SRINAGAR,1270,986,LEH-SRINAGAR,2256,All
2024,9,LEH,SRINAGAR,1131,700,LEH-SRINAGAR,1831,All
2024,10,LEH,SRINAGAR,1425,834,LEH-SRINAGAR,2259,All
2024,11,LEH,SRINAGAR,1068,642,LEH-SRINAGAR,1710,All
2024,12,LEH,SRINAGAR,982,654,LEH-SRINAGAR,1636,All
2025,1,LEH,SRINAGAR,891,767,LEH-SRINAGAR,1658,All
2025,2,LEH,SRINAGAR,603,741,LEH-SRINAGAR,1344,All
2025,3,LEH,SRINAGAR,975,1159,LEH-SRINAGAR,2134,All
2019,1,LILABARI,PASIGHAT,0,6,LILABARI-PASIGHAT,6,All
2019,4,LILABARI,PASIGHAT,0,3,LILABARI-PASIGHAT,3,All
2019,5,LILABARI,PASIGHAT,0,2,LILABARI-PASIGHAT,2,All
2019,6,LILABARI,PASIGHAT,0,6,LILABARI-PASIGHAT,6,All
2022,11,LILABARI,PASIGHAT,3,0,LILABARI-PASIGHAT,3,All
2022,12,LILABARI,PASIGHAT,0,13,LILABARI-PASIGHAT,13,All
2022,10,LILABARI,SHILLONG,0,1,LILABARI-SHILLONG,1,All
2022,11,LILABARI,SHILLONG,31,25,LILABARI-SHILLONG,56,All
2022,12,LILABARI,SHILLONG,64,47,LILABARI-SHILLONG,111,All
2023,1,LILABARI,SHILLONG,57,323,LILABARI-SHILLONG,380,All
2023,2,LILABARI,SHILLONG,42,33,LILABARI-SHILLONG,75,All
2023,3,LILABARI,SHILLONG,52,52,LILABARI-SHILLONG,104,All
2023,4,LILABARI,SHILLONG,355,243,LILABARI-SHILLONG,598,All
2023,5,LILABARI,SHILLONG,213,150,LILABARI-SHILLONG,363,All
2023,6,LILABARI,SHILLONG,308,233,LILABARI-SHILLONG,541,All
2023,7,LILABARI,SHILLONG,674,444,LILABARI-SHILLONG,1118,All
2023,8,LILABARI,SHILLONG,334,244,LILABARI-SHILLONG,578,All
2023,9,LILABARI,SHILLONG,294,268,LILABARI-SHILLONG,562,All
2023,10,LILABARI,SHILLONG,302,113,LILABARI-SHILLONG,415,All
2023,11,LILABARI,SHILLONG,471,241,LILABARI-SHILLONG,712,All
2023,12,LILABARI,SHILLONG,527,254,LILABARI-SHILLONG,781,All
2024,1,LILABARI,SHILLONG,1144,651,LILABARI-SHILLONG,1795,All
2024,2,LILABARI,SHILLONG,658,336,LILABARI-SHILLONG,994,All
2024,3,LILABARI,SHILLONG,838,410,LILABARI-SHILLONG,1248,All
2024,4,LILABARI,SHILLONG,833,560,LILABARI-SHILLONG,1393,All
2024,6,LILABARI,SHILLONG,596,410,LILABARI-SHILLONG,1006,All
2024,7,LILABARI,SHILLONG,911,648,LILABARI-SHILLONG,1559,All
2024,8,LILABARI,SHILLONG,262,80,LILABARI-SHILLONG,342,All
2024,9,LILABARI,SHILLONG,207,135,LILABARI-SHILLONG,342,All
2024,10,LILABARI,SHILLONG,158,157,LILABARI-SHILLONG,315,All
2025,3,LILABARI,SILCHAR,0,53,LILABARI-SILCHAR,53,All
2018,5,LILABARI,TEZPUR,0,1,LILABARI-TEZPUR,1,All
2018,6,LILABARI,TEZPUR,0,8,LILABARI-TEZPUR,8,All
2018,7,LILABARI,TEZPUR,0,140,LILABARI-TEZPUR,140,All
2018,8,LILABARI,TEZPUR,0,12,LILABARI-TEZPUR,12,All
2018,9,LILABARI,TEZPUR,0,9,LILABARI-TEZPUR,9,All
2022,11,LILABARI,TEZPUR,4,1,LILABARI-TEZPUR,5,All
2022,12,LILABARI,TEZPUR,12,0,LILABARI-TEZPUR,12,All
2023,1,LILABARI,TEZPUR,352,6,LILABARI-TEZPUR,358,All
2023,2,LILABARI,TEZPUR,7,3,LILABARI-TEZPUR,10,All
2023,3,LILABARI,TEZPUR,12,5,LILABARI-TEZPUR,17,All
2023,4,LILABARI,TEZPUR,179,110,LILABARI-TEZPUR,289,All
2023,5,LILABARI,TEZPUR,58,69,LILABARI-TEZPUR,127,All
2023,6,LILABARI,TEZPUR,90,110,LILABARI-TEZPUR,200,All
2023,7,LILABARI,TEZPUR,182,117,LILABARI-TEZPUR,299,All
2023,8,LILABARI,TEZPUR,103,97,LILABARI-TEZPUR,200,All
2023,9,LILABARI,TEZPUR,125,90,LILABARI-TEZPUR,215,All
2023,10,LILABARI,TEZPUR,80,38,LILABARI-TEZPUR,118,All
2023,11,LILABARI,TEZPUR,98,114,LILABARI-TEZPUR,212,All
2023,12,LILABARI,TEZPUR,21,34,LILABARI-TEZPUR,55,All
2024,1,LILABARI,TEZPUR,103,127,LILABARI-TEZPUR,230,All
2024,2,LILABARI,TEZPUR,138,182,LILABARI-TEZPUR,320,All
2024,3,LILABARI,TEZPUR,134,190,LILABARI-TEZPUR,324,All
2024,4,LILABARI,TEZPUR,315,334,LILABARI-TEZPUR,649,All
2024,6,LILABARI,TEZPUR,260,343,LILABARI-TEZPUR,603,All
2024,7,LILABARI,TEZPUR,453,442,LILABARI-TEZPUR,895,All
2024,8,LILABARI,TEZPUR,288,491,LILABARI-TEZPUR,779,All
2024,9,LILABARI,TEZPUR,393,541,LILABARI-TEZPUR,934,All
2024,3,LUCKNOW,Aligarh Airport ,35,51,Aligarh Airport -LUCKNOW,86,All
2024,4,LUCKNOW,Aligarh Airport ,38,84,Aligarh Airport -LUCKNOW,122,All
2024,6,LUCKNOW,Aligarh Airport ,88,103,Aligarh Airport -LUCKNOW,191,All
2024,7,LUCKNOW,Aligarh Airport ,71,100,Aligarh Airport -LUCKNOW,171,All
2024,8,LUCKNOW,Aligarh Airport ,113,161,Aligarh Airport -LUCKNOW,274,All
2024,9,LUCKNOW,Aligarh Airport ,79,80,Aligarh Airport -LUCKNOW,159,All
2024,10,LUCKNOW,Aligarh Airport ,75,93,Aligarh Airport -LUCKNOW,168,All
2024,11,LUCKNOW,Aligarh Airport ,34,33,Aligarh Airport -LUCKNOW,67,All
2024,12,LUCKNOW,Aligarh Airport ,13,11,Aligarh Airport -LUCKNOW,24,All
2024,7,LUCKNOW,Ayodhya International Airport ,0,33,Ayodhya International Airport -LUCKNOW,33,All
2024,12,LUCKNOW,Ayodhya International Airport ,174,0,Ayodhya International Airport -LUCKNOW,174,All
2024,3,LUCKNOW,Azamgarh Airport,38,42,Azamgarh Airport-LUCKNOW,80,All
2024,4,LUCKNOW,Azamgarh Airport,34,35,Azamgarh Airport-LUCKNOW,69,All
2024,6,LUCKNOW,Azamgarh Airport,65,92,Azamgarh Airport-LUCKNOW,157,All
2024,7,LUCKNOW,Azamgarh Airport,41,64,Azamgarh Airport-LUCKNOW,105,All
2024,8,LUCKNOW,Azamgarh Airport,58,80,Azamgarh Airport-LUCKNOW,138,All
2024,9,LUCKNOW,Azamgarh Airport,78,84,Azamgarh Airport-LUCKNOW,162,All
2024,10,LUCKNOW,Azamgarh Airport,61,63,Azamgarh Airport-LUCKNOW,124,All
2024,11,LUCKNOW,Azamgarh Airport,17,12,Azamgarh Airport-LUCKNOW,29,All
2016,4,LUCKNOW,CHENNAI,204,268,CHENNAI-LUCKNOW,472,All
2016,5,LUCKNOW,CHENNAI,1151,756,CHENNAI-LUCKNOW,1907,All
2016,6,LUCKNOW,CHENNAI,711,574,CHENNAI-LUCKNOW,1285,All
2016,7,LUCKNOW,CHENNAI,644,429,CHENNAI-LUCKNOW,1073,All
2016,8,LUCKNOW,CHENNAI,698,619,CHENNAI-LUCKNOW,1317,All
2016,9,LUCKNOW,CHENNAI,529,728,CHENNAI-LUCKNOW,1257,All
2016,10,LUCKNOW,CHENNAI,488,570,CHENNAI-LUCKNOW,1058,All
2016,11,LUCKNOW,CHENNAI,770,742,CHENNAI-LUCKNOW,1512,All
2016,12,LUCKNOW,CHENNAI,1440,1194,CHENNAI-LUCKNOW,2634,All
2017,1,LUCKNOW,CHENNAI,1576,1148,CHENNAI-LUCKNOW,2724,All
2017,2,LUCKNOW,CHENNAI,828,903,CHENNAI-LUCKNOW,1731,All
2017,3,LUCKNOW,CHENNAI,1104,987,CHENNAI-LUCKNOW,2091,All
2017,4,LUCKNOW,CHENNAI,1271,1180,CHENNAI-LUCKNOW,2451,All
2017,5,LUCKNOW,CHENNAI,1338,1552,CHENNAI-LUCKNOW,2890,All
2017,6,LUCKNOW,CHENNAI,1245,1287,CHENNAI-LUCKNOW,2532,All
2017,7,LUCKNOW,CHENNAI,1278,1230,CHENNAI-LUCKNOW,2508,All
2017,8,LUCKNOW,CHENNAI,927,996,CHENNAI-LUCKNOW,1923,All
2017,9,LUCKNOW,CHENNAI,850,1095,CHENNAI-LUCKNOW,1945,All
2017,10,LUCKNOW,CHENNAI,742,637,CHENNAI-LUCKNOW,1379,All
2017,11,LUCKNOW,CHENNAI,675,931,CHENNAI-LUCKNOW,1606,All
2017,12,LUCKNOW,CHENNAI,1073,1361,CHENNAI-LUCKNOW,2434,All
2018,1,LUCKNOW,CHENNAI,1157,1529,CHENNAI-LUCKNOW,2686,All
2018,2,LUCKNOW,CHENNAI,738,1332,CHENNAI-LUCKNOW,2070,All
2018,3,LUCKNOW,CHENNAI,3903,4095,CHENNAI-LUCKNOW,7998,All
2018,4,LUCKNOW,CHENNAI,907,1593,CHENNAI-LUCKNOW,2500,All
2018,5,LUCKNOW,CHENNAI,4870,4248,CHENNAI-LUCKNOW,9118,All
2018,6,LUCKNOW,CHENNAI,6046,6372,CHENNAI-LUCKNOW,12418,All
2018,7,LUCKNOW,CHENNAI,4954,4165,CHENNAI-LUCKNOW,9119,All
2018,8,LUCKNOW,CHENNAI,2424,3276,CHENNAI-LUCKNOW,5700,All
2018,9,LUCKNOW,CHENNAI,3551,4001,CHENNAI-LUCKNOW,7552,All
2018,10,LUCKNOW,CHENNAI,4726,5394,CHENNAI-LUCKNOW,10120,All
2018,11,LUCKNOW,CHENNAI,5287,5729,CHENNAI-LUCKNOW,11016,All
2018,12,LUCKNOW,CHENNAI,5973,5917,CHENNAI-LUCKNOW,11890,All
2019,1,LUCKNOW,CHENNAI,5953,5943,CHENNAI-LUCKNOW,11896,All
2019,2,LUCKNOW,CHENNAI,4900,4989,CHENNAI-LUCKNOW,9889,All
2019,3,LUCKNOW,CHENNAI,5948,5804,CHENNAI-LUCKNOW,11752,All
2019,4,LUCKNOW,CHENNAI,4643,5839,CHENNAI-LUCKNOW,10482,All
2024,3,LUCKNOW,Chitrakoot Airport,36,46,Chitrakoot Airport-LUCKNOW,82,All
2024,4,LUCKNOW,Chitrakoot Airport,20,39,Chitrakoot Airport-LUCKNOW,59,All
2024,6,LUCKNOW,Chitrakoot Airport,81,103,Chitrakoot Airport-LUCKNOW,184,All
2024,7,LUCKNOW,Chitrakoot Airport,59,44,Chitrakoot Airport-LUCKNOW,103,All
2024,8,LUCKNOW,Chitrakoot Airport,83,104,Chitrakoot Airport-LUCKNOW,187,All
2024,9,LUCKNOW,Chitrakoot Airport,82,98,Chitrakoot Airport-LUCKNOW,180,All
2024,10,LUCKNOW,Chitrakoot Airport,115,119,Chitrakoot Airport-LUCKNOW,234,All
2024,11,LUCKNOW,Chitrakoot Airport,35,41,Chitrakoot Airport-LUCKNOW,76,All
2024,12,LUCKNOW,Chitrakoot Airport,7,9,Chitrakoot Airport-LUCKNOW,16,All
2020,8,LUCKNOW,MANGALORE,43,15,LUCKNOW-MANGALORE,58,All
2020,9,LUCKNOW,MANGALORE,269,93,LUCKNOW-MANGALORE,362,All
2020,10,LUCKNOW,MANGALORE,174,102,LUCKNOW-MANGALORE,276,All
2020,11,LUCKNOW,MANGALORE,425,204,LUCKNOW-MANGALORE,629,All
2020,12,LUCKNOW,MANGALORE,372,207,LUCKNOW-MANGALORE,579,All
2021,1,LUCKNOW,MANGALORE,198,149,LUCKNOW-MANGALORE,347,All
2021,2,LUCKNOW,MANGALORE,244,156,LUCKNOW-MANGALORE,400,All
2021,3,LUCKNOW,MANGALORE,125,216,LUCKNOW-MANGALORE,341,All
2019,5,LUCKNOW,MUMBAI,28919,32208,LUCKNOW-MUMBAI,61127,All
2019,6,LUCKNOW,MUMBAI,31596,30349,LUCKNOW-MUMBAI,61945,All
2019,7,LUCKNOW,MUMBAI,29766,29734,LUCKNOW-MUMBAI,59500,All
2019,8,LUCKNOW,MUMBAI,33453,34350,LUCKNOW-MUMBAI,67803,All
2019,9,LUCKNOW,MUMBAI,33731,35353,LUCKNOW-MUMBAI,69084,All
2019,10,LUCKNOW,MUMBAI,29959,37312,LUCKNOW-MUMBAI,67271,All
2019,11,LUCKNOW,MUMBAI,35716,35998,LUCKNOW-MUMBAI,71714,All
2019,12,LUCKNOW,MUMBAI,37019,32781,LUCKNOW-MUMBAI,69800,All
2020,1,LUCKNOW,MUMBAI,33724,35886,LUCKNOW-MUMBAI,69610,All
2020,2,LUCKNOW,MUMBAI,32844,34521,LUCKNOW-MUMBAI,67365,All
2020,3,LUCKNOW,MUMBAI,19627,25192,LUCKNOW-MUMBAI,44819,All
2020,5,LUCKNOW,MUMBAI,293,1273,LUCKNOW-MUMBAI,1566,All
2020,6,LUCKNOW,MUMBAI,3175,8817,LUCKNOW-MUMBAI,11992,All
2020,7,LUCKNOW,MUMBAI,3581,8498,LUCKNOW-MUMBAI,12079,All
2020,8,LUCKNOW,MUMBAI,13658,7384,LUCKNOW-MUMBAI,21042,All
2020,9,LUCKNOW,MUMBAI,22030,10460,LUCKNOW-MUMBAI,32490,All
2020,10,LUCKNOW,MUMBAI,19238,18520,LUCKNOW-MUMBAI,37758,All
2020,11,LUCKNOW,MUMBAI,20584,32746,LUCKNOW-MUMBAI,53330,All
2020,12,LUCKNOW,MUMBAI,22331,25960,LUCKNOW-MUMBAI,48291,All
2021,1,LUCKNOW,MUMBAI,22786,22986,LUCKNOW-MUMBAI,45772,All
2021,2,LUCKNOW,MUMBAI,19666,25279,LUCKNOW-MUMBAI,44945,All
2021,3,LUCKNOW,MUMBAI,15809,25410,LUCKNOW-MUMBAI,41219,All
2021,4,LUCKNOW,MUMBAI,10783,29689,LUCKNOW-MUMBAI,40472,All
2021,6,LUCKNOW,MUMBAI,11427,11277,LUCKNOW-MUMBAI,22704,All
2021,7,LUCKNOW,MUMBAI,11982,14819,LUCKNOW-MUMBAI,26801,All
2021,8,LUCKNOW,MUMBAI,15520,16549,LUCKNOW-MUMBAI,32069,All
2021,9,LUCKNOW,MUMBAI,14638,15836,LUCKNOW-MUMBAI,30474,All
2021,10,LUCKNOW,MUMBAI,17624,27103,LUCKNOW-MUMBAI,44727,All
2021,11,LUCKNOW,MUMBAI,29949,33126,LUCKNOW-MUMBAI,63075,All
2021,12,LUCKNOW,MUMBAI,31782,23690,LUCKNOW-MUMBAI,55472,All
2022,1,LUCKNOW,MUMBAI,14351,17116,LUCKNOW-MUMBAI,31467,All
2022,2,LUCKNOW,MUMBAI,22671,25166,LUCKNOW-MUMBAI,47837,All
2022,3,LUCKNOW,MUMBAI,25387,27671,LUCKNOW-MUMBAI,53058,All
2022,4,LUCKNOW,MUMBAI,22102,33040,LUCKNOW-MUMBAI,55142,All
2022,5,LUCKNOW,MUMBAI,31843,35788,LUCKNOW-MUMBAI,67631,All
2022,6,LUCKNOW,MUMBAI,33552,25628,LUCKNOW-MUMBAI,59180,All
2022,7,LUCKNOW,MUMBAI,23723,24784,LUCKNOW-MUMBAI,48507,All
2022,8,LUCKNOW,MUMBAI,25271,23736,LUCKNOW-MUMBAI,49007,All
2022,9,LUCKNOW,MUMBAI,25571,28930,LUCKNOW-MUMBAI,54501,All
2022,10,LUCKNOW,MUMBAI,24523,35976,LUCKNOW-MUMBAI,60499,All
2022,11,LUCKNOW,MUMBAI,39673,37673,LUCKNOW-MUMBAI,77346,All
2022,12,LUCKNOW,MUMBAI,46147,40850,LUCKNOW-MUMBAI,86997,All
2023,11,LUCKNOW,MUMBAI,32452,40228,LUCKNOW-MUMBAI,72680,All
2023,12,LUCKNOW,MUMBAI,41900,41166,LUCKNOW-MUMBAI,83066,All
2024,1,LUCKNOW,MUMBAI,41520,41839,LUCKNOW-MUMBAI,83359,All
2024,2,LUCKNOW,MUMBAI,39481,39851,LUCKNOW-MUMBAI,79332,All
2024,3,LUCKNOW,MUMBAI,40975,39629,LUCKNOW-MUMBAI,80604,All
2024,4,LUCKNOW,MUMBAI,30291,31398,LUCKNOW-MUMBAI,61689,All
2024,6,LUCKNOW,MUMBAI,35203,30077,LUCKNOW-MUMBAI,65280,All
2024,7,LUCKNOW,MUMBAI,38392,32005,LUCKNOW-MUMBAI,70397,All
2024,8,LUCKNOW,MUMBAI,41542,37388,LUCKNOW-MUMBAI,78930,All
2024,9,LUCKNOW,MUMBAI,41439,40082,LUCKNOW-MUMBAI,81521,All
2024,10,LUCKNOW,MUMBAI,30858,44300,LUCKNOW-MUMBAI,75158,All
2024,11,LUCKNOW,MUMBAI,46134,47755,LUCKNOW-MUMBAI,93889,All
2024,12,LUCKNOW,MUMBAI,48539,46196,LUCKNOW-MUMBAI,94735,All
2025,1,LUCKNOW,MUMBAI,47553,47389,LUCKNOW-MUMBAI,94942,All
2025,2,LUCKNOW,MUMBAI,43873,45038,LUCKNOW-MUMBAI,88911,All
2025,3,LUCKNOW,MUMBAI,37815,39555,LUCKNOW-MUMBAI,77370,All
2024,8,LUCKNOW,Moradabad Airport,78,108,LUCKNOW-Moradabad Airport,186,All
2024,9,LUCKNOW,Moradabad Airport,68,97,LUCKNOW-Moradabad Airport,165,All
2024,10,LUCKNOW,Moradabad Airport,51,101,LUCKNOW-Moradabad Airport,152,All
2024,11,LUCKNOW,Moradabad Airport,0,11,LUCKNOW-Moradabad Airport,11,All
2019,11,LUCKNOW,NAGPUR,0,2,LUCKNOW-NAGPUR,2,All
2020,8,LUCKNOW,NAGPUR,2,0,LUCKNOW-NAGPUR,2,All
2020,9,LUCKNOW,NAGPUR,0,211,LUCKNOW-NAGPUR,211,All
2020,10,LUCKNOW,NAGPUR,0,123,LUCKNOW-NAGPUR,123,All
2021,4,LUCKNOW,NAGPUR,8,12,LUCKNOW-NAGPUR,20,All
2021,10,LUCKNOW,NAGPUR,54,75,LUCKNOW-NAGPUR,129,All
2021,11,LUCKNOW,NAGPUR,1772,1780,LUCKNOW-NAGPUR,3552,All
2021,12,LUCKNOW,NAGPUR,2130,1757,LUCKNOW-NAGPUR,3887,All
2022,1,LUCKNOW,NAGPUR,1375,1197,LUCKNOW-NAGPUR,2572,All
2022,2,LUCKNOW,NAGPUR,1838,1692,LUCKNOW-NAGPUR,3530,All
2022,3,LUCKNOW,NAGPUR,1910,1713,LUCKNOW-NAGPUR,3623,All
2022,4,LUCKNOW,NAGPUR,1921,1915,LUCKNOW-NAGPUR,3836,All
2022,5,LUCKNOW,NAGPUR,2176,2110,LUCKNOW-NAGPUR,4286,All
2022,6,LUCKNOW,NAGPUR,2004,1361,LUCKNOW-NAGPUR,3365,All
2022,7,LUCKNOW,NAGPUR,1680,1268,LUCKNOW-NAGPUR,2948,All
2022,8,LUCKNOW,NAGPUR,1423,1233,LUCKNOW-NAGPUR,2656,All
2022,9,LUCKNOW,NAGPUR,1706,1458,LUCKNOW-NAGPUR,3164,All
2022,10,LUCKNOW,NAGPUR,2078,2216,LUCKNOW-NAGPUR,4294,All
2022,11,LUCKNOW,NAGPUR,2205,2070,LUCKNOW-NAGPUR,4275,All
2022,12,LUCKNOW,NAGPUR,2176,1802,LUCKNOW-NAGPUR,3978,All
2023,1,LUCKNOW,NAGPUR,1979,1813,LUCKNOW-NAGPUR,3792,All
2023,2,LUCKNOW,NAGPUR,1872,1870,LUCKNOW-NAGPUR,3742,All
2023,3,LUCKNOW,NAGPUR,2009,1737,LUCKNOW-NAGPUR,3746,All
2023,4,LUCKNOW,NAGPUR,1917,2061,LUCKNOW-NAGPUR,3978,All
2023,5,LUCKNOW,NAGPUR,2145,2252,LUCKNOW-NAGPUR,4397,All
2023,6,LUCKNOW,NAGPUR,2135,1931,LUCKNOW-NAGPUR,4066,All
2023,7,LUCKNOW,NAGPUR,1934,1643,LUCKNOW-NAGPUR,3577,All
2023,8,LUCKNOW,NAGPUR,1915,1793,LUCKNOW-NAGPUR,3708,All
2023,9,LUCKNOW,NAGPUR,1829,1650,LUCKNOW-NAGPUR,3479,All
2023,10,LUCKNOW,NAGPUR,1856,2007,LUCKNOW-NAGPUR,3863,All
2023,11,LUCKNOW,NAGPUR,1864,2070,LUCKNOW-NAGPUR,3934,All
2023,12,LUCKNOW,NAGPUR,2281,1910,LUCKNOW-NAGPUR,4191,All
2024,1,LUCKNOW,NAGPUR,2023,1908,LUCKNOW-NAGPUR,3931,All
2024,2,LUCKNOW,NAGPUR,1834,1945,LUCKNOW-NAGPUR,3779,All
2024,3,LUCKNOW,NAGPUR,1832,1906,LUCKNOW-NAGPUR,3738,All
2024,4,LUCKNOW,NAGPUR,1419,1633,LUCKNOW-NAGPUR,3052,All
2024,6,LUCKNOW,NAGPUR,1610,1496,LUCKNOW-NAGPUR,3106,All
2024,7,LUCKNOW,NAGPUR,1480,1546,LUCKNOW-NAGPUR,3026,All
2024,8,LUCKNOW,NAGPUR,1422,1393,LUCKNOW-NAGPUR,2815,All
2024,9,LUCKNOW,NAGPUR,1396,1516,LUCKNOW-NAGPUR,2912,All
2024,10,LUCKNOW,NAGPUR,1439,1710,LUCKNOW-NAGPUR,3149,All
2024,11,LUCKNOW,NAGPUR,1766,1844,LUCKNOW-NAGPUR,3610,All
2024,12,LUCKNOW,NAGPUR,917,796,LUCKNOW-NAGPUR,1713,All
2025,2,LUCKNOW,NAGPUR,1459,1589,LUCKNOW-NAGPUR,3048,All
2025,3,LUCKNOW,NAGPUR,1432,1374,LUCKNOW-NAGPUR,2806,All
2024,3,LUCKNOW,NASIK,0,18,LUCKNOW-NASIK,18,All
2024,4,LUCKNOW,NASIK,264,450,LUCKNOW-NASIK,714,All
2024,6,LUCKNOW,NASIK,422,301,LUCKNOW-NASIK,723,All
2024,7,LUCKNOW,NASIK,260,153,LUCKNOW-NASIK,413,All
2024,8,LUCKNOW,NASIK,234,105,LUCKNOW-NASIK,339,All
2024,9,LUCKNOW,NASIK,262,137,LUCKNOW-NASIK,399,All
2024,10,LUCKNOW,NASIK,144,106,LUCKNOW-NASIK,250,All
2024,11,LUCKNOW,NASIK,121,106,LUCKNOW-NASIK,227,All
2024,12,LUCKNOW,NASIK,114,75,LUCKNOW-NASIK,189,All
2025,3,LUCKNOW,NASIK,166,255,LUCKNOW-NASIK,421,All
2022,6,LUCKNOW,PANTNAGAR,830,671,LUCKNOW-PANTNAGAR,1501,All
2022,7,LUCKNOW,PANTNAGAR,471,375,LUCKNOW-PANTNAGAR,846,All
2022,8,LUCKNOW,PANTNAGAR,629,561,LUCKNOW-PANTNAGAR,1190,All
2022,9,LUCKNOW,PANTNAGAR,681,606,LUCKNOW-PANTNAGAR,1287,All
2022,10,LUCKNOW,PANTNAGAR,788,710,LUCKNOW-PANTNAGAR,1498,All
2022,11,LUCKNOW,PANTNAGAR,474,673,LUCKNOW-PANTNAGAR,1147,All
2022,12,LUCKNOW,PANTNAGAR,648,630,LUCKNOW-PANTNAGAR,1278,All
2023,1,LUCKNOW,PANTNAGAR,271,269,LUCKNOW-PANTNAGAR,540,All
2023,2,LUCKNOW,PANTNAGAR,457,500,LUCKNOW-PANTNAGAR,957,All
2023,3,LUCKNOW,PANTNAGAR,839,673,LUCKNOW-PANTNAGAR,1512,All
2023,4,LUCKNOW,PANTNAGAR,763,782,LUCKNOW-PANTNAGAR,1545,All
2023,5,LUCKNOW,PANTNAGAR,807,810,LUCKNOW-PANTNAGAR,1617,All
2023,6,LUCKNOW,PANTNAGAR,829,803,LUCKNOW-PANTNAGAR,1632,All
2023,7,LUCKNOW,PANTNAGAR,454,573,LUCKNOW-PANTNAGAR,1027,All
2023,8,LUCKNOW,PANTNAGAR,158,220,LUCKNOW-PANTNAGAR,378,All
2015,4,LUCKNOW,PATNA,2497,2293,LUCKNOW-PATNA,4790,All
2015,5,LUCKNOW,PATNA,3454,2741,LUCKNOW-PATNA,6195,All
2015,6,LUCKNOW,PATNA,3134,2871,LUCKNOW-PATNA,6005,All
2015,7,LUCKNOW,PATNA,1989,2020,LUCKNOW-PATNA,4009,All
2015,8,LUCKNOW,PATNA,1980,2106,LUCKNOW-PATNA,4086,All
2015,9,LUCKNOW,PATNA,1697,1804,LUCKNOW-PATNA,3501,All
2015,10,LUCKNOW,PATNA,2087,2204,LUCKNOW-PATNA,4291,All
2015,11,LUCKNOW,PATNA,2671,2102,LUCKNOW-PATNA,4773,All
2015,12,LUCKNOW,PATNA,1906,1976,LUCKNOW-PATNA,3882,All
2016,1,LUCKNOW,PATNA,1861,2048,LUCKNOW-PATNA,3909,All
2016,2,LUCKNOW,PATNA,2332,2286,LUCKNOW-PATNA,4618,All
2016,3,LUCKNOW,PATNA,2616,2607,LUCKNOW-PATNA,5223,All
2016,4,LUCKNOW,PATNA,2230,2384,LUCKNOW-PATNA,4614,All
2016,5,LUCKNOW,PATNA,2085,1990,LUCKNOW-PATNA,4075,All
2016,6,LUCKNOW,PATNA,2187,2193,LUCKNOW-PATNA,4380,All
2016,7,LUCKNOW,PATNA,2795,2647,LUCKNOW-PATNA,5442,All
2016,8,LUCKNOW,PATNA,2670,2914,LUCKNOW-PATNA,5584,All
2016,9,LUCKNOW,PATNA,2647,2970,LUCKNOW-PATNA,5617,All
2016,10,LUCKNOW,PATNA,3769,3768,LUCKNOW-PATNA,7537,All
2016,11,LUCKNOW,PATNA,3958,3756,LUCKNOW-PATNA,7714,All
2016,12,LUCKNOW,PATNA,2694,1407,LUCKNOW-PATNA,4101,All
2017,1,LUCKNOW,PATNA,2408,1709,LUCKNOW-PATNA,4117,All
2017,2,LUCKNOW,PATNA,2638,2508,LUCKNOW-PATNA,5146,All
2017,3,LUCKNOW,PATNA,2694,3370,LUCKNOW-PATNA,6064,All
2017,4,LUCKNOW,PATNA,2653,2806,LUCKNOW-PATNA,5459,All
2017,5,LUCKNOW,PATNA,3846,3676,LUCKNOW-PATNA,7522,All
2017,6,LUCKNOW,PATNA,3920,3671,LUCKNOW-PATNA,7591,All
2017,7,LUCKNOW,PATNA,2325,3540,LUCKNOW-PATNA,5865,All
2017,8,LUCKNOW,PATNA,3599,3721,LUCKNOW-PATNA,7320,All
2017,9,LUCKNOW,PATNA,4989,3998,LUCKNOW-PATNA,8987,All
2017,10,LUCKNOW,PATNA,6559,5014,LUCKNOW-PATNA,11573,All
2017,11,LUCKNOW,PATNA,6062,5347,LUCKNOW-PATNA,11409,All
2017,12,LUCKNOW,PATNA,4291,4141,LUCKNOW-PATNA,8432,All
2018,1,LUCKNOW,PATNA,3090,2343,LUCKNOW-PATNA,5433,All
2018,2,LUCKNOW,PATNA,5956,5773,LUCKNOW-PATNA,11729,All
2018,3,LUCKNOW,PATNA,7712,8411,LUCKNOW-PATNA,16123,All
2018,4,LUCKNOW,PATNA,6381,6524,LUCKNOW-PATNA,12905,All
2018,5,LUCKNOW,PATNA,6278,7512,LUCKNOW-PATNA,13790,All
2018,6,LUCKNOW,PATNA,7219,6583,LUCKNOW-PATNA,13802,All
2018,7,LUCKNOW,PATNA,6361,6670,LUCKNOW-PATNA,13031,All
2018,8,LUCKNOW,PATNA,5710,5950,LUCKNOW-PATNA,11660,All
2018,9,LUCKNOW,PATNA,4873,5850,LUCKNOW-PATNA,10723,All
2018,10,LUCKNOW,PATNA,4807,5142,LUCKNOW-PATNA,9949,All
2018,11,LUCKNOW,PATNA,5103,5759,LUCKNOW-PATNA,10862,All
2018,12,LUCKNOW,PATNA,3550,3412,LUCKNOW-PATNA,6962,All
2019,1,LUCKNOW,PATNA,3245,3922,LUCKNOW-PATNA,7167,All
2019,2,LUCKNOW,PATNA,5127,5901,LUCKNOW-PATNA,11028,All
2019,3,LUCKNOW,PATNA,7156,7057,LUCKNOW-PATNA,14213,All
2019,4,LUCKNOW,PATNA,6862,6632,LUCKNOW-PATNA,13494,All
2019,5,LUCKNOW,PATNA,6812,6320,LUCKNOW-PATNA,13132,All
2019,6,LUCKNOW,PATNA,6328,6910,LUCKNOW-PATNA,13238,All
2019,7,LUCKNOW,PATNA,4787,6148,LUCKNOW-PATNA,10935,All
2019,8,LUCKNOW,PATNA,5041,5481,LUCKNOW-PATNA,10522,All
2019,9,LUCKNOW,PATNA,3952,4729,LUCKNOW-PATNA,8681,All
2019,10,LUCKNOW,PATNA,5893,4608,LUCKNOW-PATNA,10501,All
2019,11,LUCKNOW,PATNA,4746,6324,LUCKNOW-PATNA,11070,All
2019,12,LUCKNOW,PATNA,5304,5442,LUCKNOW-PATNA,10746,All
2020,1,LUCKNOW,PATNA,4635,5987,LUCKNOW-PATNA,10622,All
2020,2,LUCKNOW,PATNA,5926,6120,LUCKNOW-PATNA,12046,All
2020,3,LUCKNOW,PATNA,4527,4725,LUCKNOW-PATNA,9252,All
2020,7,LUCKNOW,PATNA,0,70,LUCKNOW-PATNA,70,All
2020,8,LUCKNOW,PATNA,213,916,LUCKNOW-PATNA,1129,All
2020,9,LUCKNOW,PATNA,1567,4717,LUCKNOW-PATNA,6284,All
2020,10,LUCKNOW,PATNA,2439,4030,LUCKNOW-PATNA,6469,All
2020,11,LUCKNOW,PATNA,2944,3025,LUCKNOW-PATNA,5969,All
2020,12,LUCKNOW,PATNA,2833,3633,LUCKNOW-PATNA,6466,All
2021,1,LUCKNOW,PATNA,2782,3323,LUCKNOW-PATNA,6105,All
2021,2,LUCKNOW,PATNA,3151,2773,LUCKNOW-PATNA,5924,All
2021,3,LUCKNOW,PATNA,3439,2935,LUCKNOW-PATNA,6374,All
2021,4,LUCKNOW,PATNA,5326,2535,LUCKNOW-PATNA,7861,All
2021,6,LUCKNOW,PATNA,986,1096,LUCKNOW-PATNA,2082,All
2021,7,LUCKNOW,PATNA,1374,1527,LUCKNOW-PATNA,2901,All
2021,8,LUCKNOW,PATNA,1995,1835,LUCKNOW-PATNA,3830,All
2021,9,LUCKNOW,PATNA,2615,1521,LUCKNOW-PATNA,4136,All
2021,10,LUCKNOW,PATNA,2219,1648,LUCKNOW-PATNA,3867,All
2021,11,LUCKNOW,PATNA,4161,4000,LUCKNOW-PATNA,8161,All
2021,12,LUCKNOW,PATNA,3442,3910,LUCKNOW-PATNA,7352,All
2022,1,LUCKNOW,PATNA,1022,696,LUCKNOW-PATNA,1718,All
2022,2,LUCKNOW,PATNA,2798,2687,LUCKNOW-PATNA,5485,All
2022,3,LUCKNOW,PATNA,3312,3599,LUCKNOW-PATNA,6911,All
2022,4,LUCKNOW,PATNA,3637,3251,LUCKNOW-PATNA,6888,All
2022,5,LUCKNOW,PATNA,3980,4174,LUCKNOW-PATNA,8154,All
2022,6,LUCKNOW,PATNA,3974,4342,LUCKNOW-PATNA,8316,All
2022,7,LUCKNOW,PATNA,3579,3672,LUCKNOW-PATNA,7251,All
2022,8,LUCKNOW,PATNA,2998,3863,LUCKNOW-PATNA,6861,All
2022,9,LUCKNOW,PATNA,3823,3596,LUCKNOW-PATNA,7419,All
2022,10,LUCKNOW,PATNA,4144,3380,LUCKNOW-PATNA,7524,All
2022,11,LUCKNOW,PATNA,3795,4163,LUCKNOW-PATNA,7958,All
2022,12,LUCKNOW,PATNA,3646,3673,LUCKNOW-PATNA,7319,All
2023,1,LUCKNOW,PATNA,3966,3108,LUCKNOW-PATNA,7074,All
2023,2,LUCKNOW,PATNA,3726,3229,LUCKNOW-PATNA,6955,All
2023,3,LUCKNOW,PATNA,3372,3335,LUCKNOW-PATNA,6707,All
2023,4,LUCKNOW,PATNA,3661,3455,LUCKNOW-PATNA,7116,All
2023,5,LUCKNOW,PATNA,3534,3782,LUCKNOW-PATNA,7316,All
2023,6,LUCKNOW,PATNA,3770,3950,LUCKNOW-PATNA,7720,All
2023,7,LUCKNOW,PATNA,4263,4565,LUCKNOW-PATNA,8828,All
2023,8,LUCKNOW,PATNA,4466,4351,LUCKNOW-PATNA,8817,All
2023,9,LUCKNOW,PATNA,4367,4122,LUCKNOW-PATNA,8489,All
2023,10,LUCKNOW,PATNA,4692,4126,LUCKNOW-PATNA,8818,All
2023,11,LUCKNOW,PATNA,4312,3819,LUCKNOW-PATNA,8131,All
2023,12,LUCKNOW,PATNA,3892,4290,LUCKNOW-PATNA,8182,All
2024,1,LUCKNOW,PATNA,4281,4208,LUCKNOW-PATNA,8489,All
2024,2,LUCKNOW,PATNA,4103,3963,LUCKNOW-PATNA,8066,All
2024,3,LUCKNOW,PATNA,4354,4354,LUCKNOW-PATNA,8708,All
2024,4,LUCKNOW,PATNA,3973,4262,LUCKNOW-PATNA,8235,All
2024,6,LUCKNOW,PATNA,3805,4034,LUCKNOW-PATNA,7839,All
2024,7,LUCKNOW,PATNA,4041,4392,LUCKNOW-PATNA,8433,All
2024,8,LUCKNOW,PATNA,3553,4367,LUCKNOW-PATNA,7920,All
2024,9,LUCKNOW,PATNA,3303,4119,LUCKNOW-PATNA,7422,All
2024,10,LUCKNOW,PATNA,4336,3709,LUCKNOW-PATNA,8045,All
2024,11,LUCKNOW,PATNA,4203,4365,LUCKNOW-PATNA,8568,All
2024,12,LUCKNOW,PATNA,4044,4280,LUCKNOW-PATNA,8324,All
2025,1,LUCKNOW,PATNA,3720,4047,LUCKNOW-PATNA,7767,All
2025,2,LUCKNOW,PATNA,4015,3949,LUCKNOW-PATNA,7964,All
2025,3,LUCKNOW,PATNA,4278,3570,LUCKNOW-PATNA,7848,All
2020,2,LUCKNOW,PORT BLAIR,0,62,LUCKNOW-PORT BLAIR,62,All
2020,3,LUCKNOW,PORT BLAIR,0,286,LUCKNOW-PORT BLAIR,286,All
2015,4,LUCKNOW,PUNE,547,844,LUCKNOW-PUNE,1391,All
2015,5,LUCKNOW,PUNE,901,918,LUCKNOW-PUNE,1819,All
2015,6,LUCKNOW,PUNE,1086,970,LUCKNOW-PUNE,2056,All
2015,7,LUCKNOW,PUNE,869,850,LUCKNOW-PUNE,1719,All
2015,8,LUCKNOW,PUNE,941,824,LUCKNOW-PUNE,1765,All
2015,9,LUCKNOW,PUNE,1097,1235,LUCKNOW-PUNE,2332,All
2015,10,LUCKNOW,PUNE,1265,1646,LUCKNOW-PUNE,2911,All
2015,11,LUCKNOW,PUNE,1846,2715,LUCKNOW-PUNE,4561,All
2015,12,LUCKNOW,PUNE,1419,1930,LUCKNOW-PUNE,3349,All
2016,1,LUCKNOW,PUNE,942,1097,LUCKNOW-PUNE,2039,All
2016,2,LUCKNOW,PUNE,1476,1837,LUCKNOW-PUNE,3313,All
2016,3,LUCKNOW,PUNE,1354,1787,LUCKNOW-PUNE,3141,All
2016,4,LUCKNOW,PUNE,1548,2484,LUCKNOW-PUNE,4032,All
2016,5,LUCKNOW,PUNE,2270,2198,LUCKNOW-PUNE,4468,All
2016,6,LUCKNOW,PUNE,1654,1766,LUCKNOW-PUNE,3420,All
2016,7,LUCKNOW,PUNE,1350,1625,LUCKNOW-PUNE,2975,All
2016,8,LUCKNOW,PUNE,1213,1310,LUCKNOW-PUNE,2523,All
2016,9,LUCKNOW,PUNE,682,960,LUCKNOW-PUNE,1642,All
2016,10,LUCKNOW,PUNE,761,1575,LUCKNOW-PUNE,2336,All
2016,11,LUCKNOW,PUNE,1747,1791,LUCKNOW-PUNE,3538,All
2016,12,LUCKNOW,PUNE,1674,1007,LUCKNOW-PUNE,2681,All
2017,1,LUCKNOW,PUNE,1831,1609,LUCKNOW-PUNE,3440,All
2017,2,LUCKNOW,PUNE,1410,1653,LUCKNOW-PUNE,3063,All
2017,3,LUCKNOW,PUNE,1264,1328,LUCKNOW-PUNE,2592,All
2017,4,LUCKNOW,PUNE,1295,2111,LUCKNOW-PUNE,3406,All
2017,5,LUCKNOW,PUNE,2355,1329,LUCKNOW-PUNE,3684,All
2017,6,LUCKNOW,PUNE,2648,1412,LUCKNOW-PUNE,4060,All
2017,7,LUCKNOW,PUNE,1583,1327,LUCKNOW-PUNE,2910,All
2017,8,LUCKNOW,PUNE,1665,1743,LUCKNOW-PUNE,3408,All
2017,9,LUCKNOW,PUNE,1567,1778,LUCKNOW-PUNE,3345,All
2017,10,LUCKNOW,PUNE,1954,1658,LUCKNOW-PUNE,3612,All
2017,11,LUCKNOW,PUNE,1953,1207,LUCKNOW-PUNE,3160,All
2017,12,LUCKNOW,PUNE,1790,1368,LUCKNOW-PUNE,3158,All
2018,1,LUCKNOW,PUNE,2097,1690,LUCKNOW-PUNE,3787,All
2018,2,LUCKNOW,PUNE,2015,2136,LUCKNOW-PUNE,4151,All
2018,3,LUCKNOW,PUNE,1790,723,LUCKNOW-PUNE,2513,All
2018,4,LUCKNOW,PUNE,2155,1569,LUCKNOW-PUNE,3724,All
2018,5,LUCKNOW,PUNE,2110,1463,LUCKNOW-PUNE,3573,All
2018,6,LUCKNOW,PUNE,2652,1590,LUCKNOW-PUNE,4242,All
2018,7,LUCKNOW,PUNE,6178,5897,LUCKNOW-PUNE,12075,All
2018,8,LUCKNOW,PUNE,7682,7898,LUCKNOW-PUNE,15580,All
2018,9,LUCKNOW,PUNE,7937,8215,LUCKNOW-PUNE,16152,All
2018,10,LUCKNOW,PUNE,7033,8568,LUCKNOW-PUNE,15601,All
2018,11,LUCKNOW,PUNE,2258,1208,LUCKNOW-PUNE,3466,All
2018,12,LUCKNOW,PUNE,5569,4869,LUCKNOW-PUNE,10438,All
2019,1,LUCKNOW,PUNE,5620,6124,LUCKNOW-PUNE,11744,All
2019,2,LUCKNOW,PUNE,5759,5831,LUCKNOW-PUNE,11590,All
2019,3,LUCKNOW,PUNE,5563,5833,LUCKNOW-PUNE,11396,All
2019,4,LUCKNOW,PUNE,4592,5592,LUCKNOW-PUNE,10184,All
2019,5,LUCKNOW,PUNE,5284,5935,LUCKNOW-PUNE,11219,All
2019,6,LUCKNOW,PUNE,5324,5854,LUCKNOW-PUNE,11178,All
2019,7,LUCKNOW,PUNE,4227,4645,LUCKNOW-PUNE,8872,All
2019,8,LUCKNOW,PUNE,4099,4998,LUCKNOW-PUNE,9097,All
2019,9,LUCKNOW,PUNE,3369,4915,LUCKNOW-PUNE,8284,All
2019,10,LUCKNOW,PUNE,3747,6028,LUCKNOW-PUNE,9775,All
2019,11,LUCKNOW,PUNE,5418,4992,LUCKNOW-PUNE,10410,All
2019,12,LUCKNOW,PUNE,5595,5284,LUCKNOW-PUNE,10879,All
2020,1,LUCKNOW,PUNE,5346,5322,LUCKNOW-PUNE,10668,All
2020,2,LUCKNOW,PUNE,5119,5134,LUCKNOW-PUNE,10253,All
2020,3,LUCKNOW,PUNE,3160,4068,LUCKNOW-PUNE,7228,All
2020,6,LUCKNOW,PUNE,1483,2932,LUCKNOW-PUNE,4415,All
2020,7,LUCKNOW,PUNE,2336,4286,LUCKNOW-PUNE,6622,All
2020,8,LUCKNOW,PUNE,4720,3333,LUCKNOW-PUNE,8053,All
2020,9,LUCKNOW,PUNE,4806,3488,LUCKNOW-PUNE,8294,All
2020,10,LUCKNOW,PUNE,5013,5676,LUCKNOW-PUNE,10689,All
2020,11,LUCKNOW,PUNE,4276,6771,LUCKNOW-PUNE,11047,All
2020,12,LUCKNOW,PUNE,4620,4090,LUCKNOW-PUNE,8710,All
2021,1,LUCKNOW,PUNE,4097,4976,LUCKNOW-PUNE,9073,All
2021,2,LUCKNOW,PUNE,3826,5864,LUCKNOW-PUNE,9690,All
2021,3,LUCKNOW,PUNE,3673,6478,LUCKNOW-PUNE,10151,All
2021,4,LUCKNOW,PUNE,2191,6808,LUCKNOW-PUNE,8999,All
2021,6,LUCKNOW,PUNE,2031,2686,LUCKNOW-PUNE,4717,All
2021,7,LUCKNOW,PUNE,3255,4926,LUCKNOW-PUNE,8181,All
2021,8,LUCKNOW,PUNE,3438,5241,LUCKNOW-PUNE,8679,All
2021,9,LUCKNOW,PUNE,3167,4936,LUCKNOW-PUNE,8103,All
2021,10,LUCKNOW,PUNE,1978,3785,LUCKNOW-PUNE,5763,All
2021,11,LUCKNOW,PUNE,5288,7694,LUCKNOW-PUNE,12982,All
2021,12,LUCKNOW,PUNE,5087,5683,LUCKNOW-PUNE,10770,All
2022,1,LUCKNOW,PUNE,2680,4838,LUCKNOW-PUNE,7518,All
2022,2,LUCKNOW,PUNE,2841,2655,LUCKNOW-PUNE,5496,All
2022,3,LUCKNOW,PUNE,5084,4555,LUCKNOW-PUNE,9639,All
2022,4,LUCKNOW,PUNE,4980,4673,LUCKNOW-PUNE,9653,All
2022,5,LUCKNOW,PUNE,5598,4925,LUCKNOW-PUNE,10523,All
2022,6,LUCKNOW,PUNE,4174,3146,LUCKNOW-PUNE,7320,All
2022,7,LUCKNOW,PUNE,4042,3144,LUCKNOW-PUNE,7186,All
2022,8,LUCKNOW,PUNE,4021,2962,LUCKNOW-PUNE,6983,All
2022,9,LUCKNOW,PUNE,1668,1337,LUCKNOW-PUNE,3005,All
2022,10,LUCKNOW,PUNE,5116,5408,LUCKNOW-PUNE,10524,All
2022,11,LUCKNOW,PUNE,5336,5090,LUCKNOW-PUNE,10426,All
2022,12,LUCKNOW,PUNE,5238,4345,LUCKNOW-PUNE,9583,All
2023,1,LUCKNOW,PUNE,4737,4139,LUCKNOW-PUNE,8876,All
2023,2,LUCKNOW,PUNE,4278,4511,LUCKNOW-PUNE,8789,All
2023,3,LUCKNOW,PUNE,4904,4698,LUCKNOW-PUNE,9602,All
2023,4,LUCKNOW,PUNE,4800,5069,LUCKNOW-PUNE,9869,All
2023,5,LUCKNOW,PUNE,9171,9103,LUCKNOW-PUNE,18274,All
2023,6,LUCKNOW,PUNE,10902,10049,LUCKNOW-PUNE,20951,All
2023,7,LUCKNOW,PUNE,9949,9107,LUCKNOW-PUNE,19056,All
2023,8,LUCKNOW,PUNE,9021,9613,LUCKNOW-PUNE,18634,All
2023,9,LUCKNOW,PUNE,8609,8672,LUCKNOW-PUNE,17281,All
2023,10,LUCKNOW,PUNE,8285,10097,LUCKNOW-PUNE,18382,All
2023,11,LUCKNOW,PUNE,9057,10313,LUCKNOW-PUNE,19370,All
2023,12,LUCKNOW,PUNE,11883,9890,LUCKNOW-PUNE,21773,All
2024,1,LUCKNOW,PUNE,10962,9710,LUCKNOW-PUNE,20672,All
2024,2,LUCKNOW,PUNE,10138,9746,LUCKNOW-PUNE,19884,All
2024,3,LUCKNOW,PUNE,10793,10100,LUCKNOW-PUNE,20893,All
2024,4,LUCKNOW,PUNE,10347,10365,LUCKNOW-PUNE,20712,All
2024,6,LUCKNOW,PUNE,10992,9713,LUCKNOW-PUNE,20705,All
2024,7,LUCKNOW,PUNE,11187,9323,LUCKNOW-PUNE,20510,All
2024,8,LUCKNOW,PUNE,10732,8603,LUCKNOW-PUNE,19335,All
2024,9,LUCKNOW,PUNE,9760,8635,LUCKNOW-PUNE,18395,All
2024,10,LUCKNOW,PUNE,8730,10561,LUCKNOW-PUNE,19291,All
2024,11,LUCKNOW,PUNE,10167,10358,LUCKNOW-PUNE,20525,All
2024,12,LUCKNOW,PUNE,10585,10233,LUCKNOW-PUNE,20818,All
2025,1,LUCKNOW,PUNE,10951,10390,LUCKNOW-PUNE,21341,All
2025,2,LUCKNOW,PUNE,10036,9692,LUCKNOW-PUNE,19728,All
2025,3,LUCKNOW,PUNE,5837,10297,LUCKNOW-PUNE,16134,All
2017,8,LUCKNOW,RAIPUR,0,133,LUCKNOW-RAIPUR,133,All
2017,12,LUCKNOW,RAIPUR,202,122,LUCKNOW-RAIPUR,324,All
2018,1,LUCKNOW,RAIPUR,1629,1373,LUCKNOW-RAIPUR,3002,All
2018,2,LUCKNOW,RAIPUR,2611,3655,LUCKNOW-RAIPUR,6266,All
2018,3,LUCKNOW,RAIPUR,3505,3115,LUCKNOW-RAIPUR,6620,All
2018,4,LUCKNOW,RAIPUR,2961,4098,LUCKNOW-RAIPUR,7059,All
2018,5,LUCKNOW,RAIPUR,3986,3333,LUCKNOW-RAIPUR,7319,All
2018,6,LUCKNOW,RAIPUR,3745,3335,LUCKNOW-RAIPUR,7080,All
2018,7,LUCKNOW,RAIPUR,1410,951,LUCKNOW-RAIPUR,2361,All
2020,8,LUCKNOW,RAIPUR,269,238,LUCKNOW-RAIPUR,507,All
2020,9,LUCKNOW,RAIPUR,1179,1141,LUCKNOW-RAIPUR,2320,All
2020,10,LUCKNOW,RAIPUR,1280,1618,LUCKNOW-RAIPUR,2898,All
2020,11,LUCKNOW,RAIPUR,2422,2926,LUCKNOW-RAIPUR,5348,All
2020,12,LUCKNOW,RAIPUR,2578,2267,LUCKNOW-RAIPUR,4845,All
2021,1,LUCKNOW,RAIPUR,1601,1955,LUCKNOW-RAIPUR,3556,All
2021,2,LUCKNOW,RAIPUR,1617,1984,LUCKNOW-RAIPUR,3601,All
2021,3,LUCKNOW,RAIPUR,1466,1913,LUCKNOW-RAIPUR,3379,All
2021,8,LUCKNOW,RAIPUR,107,91,LUCKNOW-RAIPUR,198,All
2021,9,LUCKNOW,RAIPUR,346,518,LUCKNOW-RAIPUR,864,All
2021,10,LUCKNOW,RAIPUR,740,856,LUCKNOW-RAIPUR,1596,All
2021,11,LUCKNOW,RAIPUR,1674,1581,LUCKNOW-RAIPUR,3255,All
2021,12,LUCKNOW,RAIPUR,2172,1644,LUCKNOW-RAIPUR,3816,All
2022,1,LUCKNOW,RAIPUR,1448,1655,LUCKNOW-RAIPUR,3103,All
2022,2,LUCKNOW,RAIPUR,1722,1938,LUCKNOW-RAIPUR,3660,All
2022,3,LUCKNOW,RAIPUR,1424,1500,LUCKNOW-RAIPUR,2924,All
2022,4,LUCKNOW,RAIPUR,1743,1634,LUCKNOW-RAIPUR,3377,All
2022,5,LUCKNOW,RAIPUR,1665,1573,LUCKNOW-RAIPUR,3238,All
2022,7,LUCKNOW,RAIPUR,681,699,LUCKNOW-RAIPUR,1380,All
2022,8,LUCKNOW,RAIPUR,901,1198,LUCKNOW-RAIPUR,2099,All
2022,9,LUCKNOW,RAIPUR,163,262,LUCKNOW-RAIPUR,425,All
2022,10,LUCKNOW,RAIPUR,1662,1687,LUCKNOW-RAIPUR,3349,All
2022,11,LUCKNOW,RAIPUR,2305,1932,LUCKNOW-RAIPUR,4237,All
2022,12,LUCKNOW,RAIPUR,1923,1657,LUCKNOW-RAIPUR,3580,All
2023,1,LUCKNOW,RAIPUR,1896,1872,LUCKNOW-RAIPUR,3768,All
2023,2,LUCKNOW,RAIPUR,2132,1987,LUCKNOW-RAIPUR,4119,All
2023,3,LUCKNOW,RAIPUR,2256,1887,LUCKNOW-RAIPUR,4143,All
2023,4,LUCKNOW,RAIPUR,1568,1400,LUCKNOW-RAIPUR,2968,All
2023,6,LUCKNOW,RAIPUR,1292,1073,LUCKNOW-RAIPUR,2365,All
2023,7,LUCKNOW,RAIPUR,2242,1928,LUCKNOW-RAIPUR,4170,All
2023,8,LUCKNOW,RAIPUR,2385,2285,LUCKNOW-RAIPUR,4670,All
2023,9,LUCKNOW,RAIPUR,2245,2432,LUCKNOW-RAIPUR,4677,All
2023,10,LUCKNOW,RAIPUR,2149,2572,LUCKNOW-RAIPUR,4721,All
2023,11,LUCKNOW,RAIPUR,2069,2479,LUCKNOW-RAIPUR,4548,All
2023,12,LUCKNOW,RAIPUR,2062,1992,LUCKNOW-RAIPUR,4054,All
2024,1,LUCKNOW,RAIPUR,2069,2157,LUCKNOW-RAIPUR,4226,All
2024,2,LUCKNOW,RAIPUR,1883,2018,LUCKNOW-RAIPUR,3901,All
2024,3,LUCKNOW,RAIPUR,2251,2224,LUCKNOW-RAIPUR,4475,All
2024,4,LUCKNOW,RAIPUR,3103,3436,LUCKNOW-RAIPUR,6539,All
2024,6,LUCKNOW,RAIPUR,3967,3444,LUCKNOW-RAIPUR,7411,All
2024,7,LUCKNOW,RAIPUR,3632,3627,LUCKNOW-RAIPUR,7259,All
2024,8,LUCKNOW,RAIPUR,3696,3847,LUCKNOW-RAIPUR,7543,All
2024,9,LUCKNOW,RAIPUR,3449,3312,LUCKNOW-RAIPUR,6761,All
2024,10,LUCKNOW,RAIPUR,3252,3647,LUCKNOW-RAIPUR,6899,All
2024,11,LUCKNOW,RAIPUR,3776,4160,LUCKNOW-RAIPUR,7936,All
2024,12,LUCKNOW,RAIPUR,3719,3520,LUCKNOW-RAIPUR,7239,All
2025,1,LUCKNOW,RAIPUR,3269,3735,LUCKNOW-RAIPUR,7004,All
2025,2,LUCKNOW,RAIPUR,3451,4042,LUCKNOW-RAIPUR,7493,All
2025,3,LUCKNOW,RAIPUR,3258,3454,LUCKNOW-RAIPUR,6712,All
2019,8,LUCKNOW,RANCHI,0,1,LUCKNOW-RANCHI,1,All
2021,2,LUCKNOW,RANCHI,476,0,LUCKNOW-RANCHI,476,All
2021,3,LUCKNOW,RANCHI,107,279,LUCKNOW-RANCHI,386,All
2021,4,LUCKNOW,RANCHI,0,611,LUCKNOW-RANCHI,611,All
2021,6,LUCKNOW,RANCHI,0,184,LUCKNOW-RANCHI,184,All
2021,8,LUCKNOW,RANCHI,368,508,LUCKNOW-RANCHI,876,All
2021,9,LUCKNOW,RANCHI,1196,1143,LUCKNOW-RANCHI,2339,All
2021,10,LUCKNOW,RANCHI,1706,2074,LUCKNOW-RANCHI,3780,All
2021,11,LUCKNOW,RANCHI,2506,2524,LUCKNOW-RANCHI,5030,All
2021,12,LUCKNOW,RANCHI,2770,2544,LUCKNOW-RANCHI,5314,All
2022,1,LUCKNOW,RANCHI,1728,1960,LUCKNOW-RANCHI,3688,All
2022,2,LUCKNOW,RANCHI,2232,2669,LUCKNOW-RANCHI,4901,All
2022,3,LUCKNOW,RANCHI,2470,3055,LUCKNOW-RANCHI,5525,All
2022,4,LUCKNOW,RANCHI,3420,3319,LUCKNOW-RANCHI,6739,All
2022,5,LUCKNOW,RANCHI,3299,3644,LUCKNOW-RANCHI,6943,All
2022,6,LUCKNOW,RANCHI,3659,3409,LUCKNOW-RANCHI,7068,All
2022,7,LUCKNOW,RANCHI,3014,3334,LUCKNOW-RANCHI,6348,All
2022,8,LUCKNOW,RANCHI,2635,2996,LUCKNOW-RANCHI,5631,All
2022,9,LUCKNOW,RANCHI,2727,3062,LUCKNOW-RANCHI,5789,All
2022,10,LUCKNOW,RANCHI,3826,3552,LUCKNOW-RANCHI,7378,All
2022,11,LUCKNOW,RANCHI,3800,4537,LUCKNOW-RANCHI,8337,All
2022,12,LUCKNOW,RANCHI,3738,3156,LUCKNOW-RANCHI,6894,All
2023,1,LUCKNOW,RANCHI,2375,2669,LUCKNOW-RANCHI,5044,All
2023,2,LUCKNOW,RANCHI,3131,3637,LUCKNOW-RANCHI,6768,All
2023,3,LUCKNOW,RANCHI,2800,2737,LUCKNOW-RANCHI,5537,All
2023,4,LUCKNOW,RANCHI,2199,2407,LUCKNOW-RANCHI,4606,All
2023,5,LUCKNOW,RANCHI,1595,1465,LUCKNOW-RANCHI,3060,All
2023,6,LUCKNOW,RANCHI,2073,1789,LUCKNOW-RANCHI,3862,All
2023,7,LUCKNOW,RANCHI,2081,1941,LUCKNOW-RANCHI,4022,All
2023,8,LUCKNOW,RANCHI,2344,2175,LUCKNOW-RANCHI,4519,All
2023,9,LUCKNOW,RANCHI,2394,2516,LUCKNOW-RANCHI,4910,All
2023,10,LUCKNOW,RANCHI,2502,2421,LUCKNOW-RANCHI,4923,All
2023,11,LUCKNOW,RANCHI,2928,2624,LUCKNOW-RANCHI,5552,All
2023,12,LUCKNOW,RANCHI,2984,2546,LUCKNOW-RANCHI,5530,All
2024,1,LUCKNOW,RANCHI,2200,2167,LUCKNOW-RANCHI,4367,All
2024,2,LUCKNOW,RANCHI,2553,2671,LUCKNOW-RANCHI,5224,All
2024,3,LUCKNOW,RANCHI,2651,2517,LUCKNOW-RANCHI,5168,All
2024,4,LUCKNOW,RANCHI,1328,970,LUCKNOW-RANCHI,2298,All
2024,6,LUCKNOW,RANCHI,1198,1108,LUCKNOW-RANCHI,2306,All
2024,7,LUCKNOW,RANCHI,1034,1138,LUCKNOW-RANCHI,2172,All
2024,8,LUCKNOW,RANCHI,1301,1127,LUCKNOW-RANCHI,2428,All
2024,9,LUCKNOW,RANCHI,1159,869,LUCKNOW-RANCHI,2028,All
2024,10,LUCKNOW,RANCHI,1165,1286,LUCKNOW-RANCHI,2451,All
2024,11,LUCKNOW,RANCHI,926,695,LUCKNOW-RANCHI,1621,All
2024,12,LUCKNOW,RANCHI,1487,1038,LUCKNOW-RANCHI,2525,All
2025,3,LUCKNOW,RANCHI,1310,1614,LUCKNOW-RANCHI,2924,All
2021,2,LUCKNOW,SHIRDI,131,81,LUCKNOW-SHIRDI,212,All
2021,3,LUCKNOW,SHIRDI,37,27,LUCKNOW-SHIRDI,64,All
2023,10,LUCKNOW,SHIRDI,11,8,LUCKNOW-SHIRDI,19,All
2023,11,LUCKNOW,SHIRDI,131,314,LUCKNOW-SHIRDI,445,All
2023,12,LUCKNOW,SHIRDI,252,240,LUCKNOW-SHIRDI,492,All
2024,1,LUCKNOW,SHIRDI,158,301,LUCKNOW-SHIRDI,459,All
2024,2,LUCKNOW,SHIRDI,183,195,LUCKNOW-SHIRDI,378,All
2024,3,LUCKNOW,SHIRDI,318,280,LUCKNOW-SHIRDI,598,All
2024,4,LUCKNOW,SHIRDI,250,359,LUCKNOW-SHIRDI,609,All
2024,6,LUCKNOW,SHIRDI,324,272,LUCKNOW-SHIRDI,596,All
2024,7,LUCKNOW,SHIRDI,196,237,LUCKNOW-SHIRDI,433,All
2024,8,LUCKNOW,SHIRDI,240,223,LUCKNOW-SHIRDI,463,All
2024,9,LUCKNOW,SHIRDI,278,320,LUCKNOW-SHIRDI,598,All
2024,10,LUCKNOW,SHIRDI,193,270,LUCKNOW-SHIRDI,463,All
2024,11,LUCKNOW,SHIRDI,191,175,LUCKNOW-SHIRDI,366,All
2024,12,LUCKNOW,SHIRDI,102,242,LUCKNOW-SHIRDI,344,All
2025,3,LUCKNOW,SHIRDI,264,215,LUCKNOW-SHIRDI,479,All
2025,3,LUCKNOW,SILCHAR,3,9,LUCKNOW-SILCHAR,12,All
2017,12,LUCKNOW,SRINAGAR,158,671,LUCKNOW-SRINAGAR,829,All
2018,1,LUCKNOW,SRINAGAR,840,4541,LUCKNOW-SRINAGAR,5381,All
2018,2,LUCKNOW,SRINAGAR,1079,3587,LUCKNOW-SRINAGAR,4666,All
2018,3,LUCKNOW,SRINAGAR,1878,2657,LUCKNOW-SRINAGAR,4535,All
2018,4,LUCKNOW,SRINAGAR,1819,4163,LUCKNOW-SRINAGAR,5982,All
2018,5,LUCKNOW,SRINAGAR,2216,4051,LUCKNOW-SRINAGAR,6267,All
2018,6,LUCKNOW,SRINAGAR,2437,4627,LUCKNOW-SRINAGAR,7064,All
2018,7,LUCKNOW,SRINAGAR,2019,4603,LUCKNOW-SRINAGAR,6622,All
2018,8,LUCKNOW,SRINAGAR,704,3261,LUCKNOW-SRINAGAR,3965,All
2018,9,LUCKNOW,SRINAGAR,420,2577,LUCKNOW-SRINAGAR,2997,All
2018,10,LUCKNOW,SRINAGAR,735,4083,LUCKNOW-SRINAGAR,4818,All
2018,11,LUCKNOW,SRINAGAR,1248,4153,LUCKNOW-SRINAGAR,5401,All
2018,12,LUCKNOW,SRINAGAR,1377,4384,LUCKNOW-SRINAGAR,5761,All
2019,1,LUCKNOW,SRINAGAR,1041,3776,LUCKNOW-SRINAGAR,4817,All
2019,2,LUCKNOW,SRINAGAR,1133,3414,LUCKNOW-SRINAGAR,4547,All
2019,3,LUCKNOW,SRINAGAR,1008,3087,LUCKNOW-SRINAGAR,4095,All
2019,4,LUCKNOW,SRINAGAR,1276,3938,LUCKNOW-SRINAGAR,5214,All
2019,5,LUCKNOW,SRINAGAR,1138,4016,LUCKNOW-SRINAGAR,5154,All
2019,6,LUCKNOW,SRINAGAR,1217,4626,LUCKNOW-SRINAGAR,5843,All
2019,7,LUCKNOW,SRINAGAR,2081,5249,LUCKNOW-SRINAGAR,7330,All
2019,8,LUCKNOW,SRINAGAR,825,3053,LUCKNOW-SRINAGAR,3878,All
2019,9,LUCKNOW,SRINAGAR,451,2927,LUCKNOW-SRINAGAR,3378,All
2019,10,LUCKNOW,SRINAGAR,535,4785,LUCKNOW-SRINAGAR,5320,All
2019,11,LUCKNOW,SRINAGAR,1014,4462,LUCKNOW-SRINAGAR,5476,All
2019,12,LUCKNOW,SRINAGAR,1222,3865,LUCKNOW-SRINAGAR,5087,All
2020,1,LUCKNOW,SRINAGAR,885,4168,LUCKNOW-SRINAGAR,5053,All
2020,2,LUCKNOW,SRINAGAR,669,4662,LUCKNOW-SRINAGAR,5331,All
2020,3,LUCKNOW,SRINAGAR,505,3273,LUCKNOW-SRINAGAR,3778,All
2020,8,LUCKNOW,SRINAGAR,206,165,LUCKNOW-SRINAGAR,371,All
2020,9,LUCKNOW,SRINAGAR,857,720,LUCKNOW-SRINAGAR,1577,All
2020,10,LUCKNOW,SRINAGAR,392,773,LUCKNOW-SRINAGAR,1165,All
2021,3,LUCKNOW,SRINAGAR,522,277,LUCKNOW-SRINAGAR,799,All
2021,4,LUCKNOW,SRINAGAR,1319,1018,LUCKNOW-SRINAGAR,2337,All
2021,7,LUCKNOW,SRINAGAR,1683,1264,LUCKNOW-SRINAGAR,2947,All
2021,8,LUCKNOW,SRINAGAR,874,950,LUCKNOW-SRINAGAR,1824,All
2021,9,LUCKNOW,SRINAGAR,1351,1269,LUCKNOW-SRINAGAR,2620,All
2021,10,LUCKNOW,SRINAGAR,1166,1414,LUCKNOW-SRINAGAR,2580,All
2022,3,LUCKNOW,SRINAGAR,198,203,LUCKNOW-SRINAGAR,401,All
2022,4,LUCKNOW,SRINAGAR,1115,1293,LUCKNOW-SRINAGAR,2408,All
2022,5,LUCKNOW,SRINAGAR,1584,1868,LUCKNOW-SRINAGAR,3452,All
2022,6,LUCKNOW,SRINAGAR,93,128,LUCKNOW-SRINAGAR,221,All
2022,7,LUCKNOW,SRINAGAR,1174,1716,LUCKNOW-SRINAGAR,2890,All
2022,8,LUCKNOW,SRINAGAR,469,805,LUCKNOW-SRINAGAR,1274,All
2022,9,LUCKNOW,SRINAGAR,339,437,LUCKNOW-SRINAGAR,776,All
2022,10,LUCKNOW,SRINAGAR,770,1126,LUCKNOW-SRINAGAR,1896,All
2023,2,LUCKNOW,SRINAGAR,353,211,LUCKNOW-SRINAGAR,564,All
2023,3,LUCKNOW,SRINAGAR,1744,1437,LUCKNOW-SRINAGAR,3181,All
2023,4,LUCKNOW,SRINAGAR,1215,1337,LUCKNOW-SRINAGAR,2552,All
2023,5,LUCKNOW,SRINAGAR,2077,2102,LUCKNOW-SRINAGAR,4179,All
2023,6,LUCKNOW,SRINAGAR,2531,2662,LUCKNOW-SRINAGAR,5193,All
2023,7,LUCKNOW,SRINAGAR,1774,1858,LUCKNOW-SRINAGAR,3632,All
2023,8,LUCKNOW,SRINAGAR,975,1151,LUCKNOW-SRINAGAR,2126,All
2023,9,LUCKNOW,SRINAGAR,920,739,LUCKNOW-SRINAGAR,1659,All
2023,10,LUCKNOW,SRINAGAR,1034,1576,LUCKNOW-SRINAGAR,2610,All
2023,11,LUCKNOW,SRINAGAR,1508,1878,LUCKNOW-SRINAGAR,3386,All
2023,12,LUCKNOW,SRINAGAR,1713,1685,LUCKNOW-SRINAGAR,3398,All
2024,2,LUCKNOW,SRINAGAR,588,329,LUCKNOW-SRINAGAR,917,All
2024,3,LUCKNOW,SRINAGAR,2018,1255,LUCKNOW-SRINAGAR,3273,All
2024,4,LUCKNOW,SRINAGAR,1522,1456,LUCKNOW-SRINAGAR,2978,All
2024,6,LUCKNOW,SRINAGAR,1954,2309,LUCKNOW-SRINAGAR,4263,All
2024,7,LUCKNOW,SRINAGAR,1812,1554,LUCKNOW-SRINAGAR,3366,All
2024,8,LUCKNOW,SRINAGAR,865,923,LUCKNOW-SRINAGAR,1788,All
2024,9,LUCKNOW,SRINAGAR,1125,1133,LUCKNOW-SRINAGAR,2258,All
2024,10,LUCKNOW,SRINAGAR,1158,1746,LUCKNOW-SRINAGAR,2904,All
2024,11,LUCKNOW,SRINAGAR,1690,1326,LUCKNOW-SRINAGAR,3016,All
2024,12,LUCKNOW,SRINAGAR,1615,1577,LUCKNOW-SRINAGAR,3192,All
2025,3,LUCKNOW,SRINAGAR,418,128,LUCKNOW-SRINAGAR,546,All
2024,3,LUCKNOW,Shravasti Airport,36,49,LUCKNOW-Shravasti Airport,85,All
2024,4,LUCKNOW,Shravasti Airport,16,27,LUCKNOW-Shravasti Airport,43,All
2024,6,LUCKNOW,Shravasti Airport,29,55,LUCKNOW-Shravasti Airport,84,All
2024,7,LUCKNOW,Shravasti Airport,37,49,LUCKNOW-Shravasti Airport,86,All
2024,8,LUCKNOW,Shravasti Airport,46,58,LUCKNOW-Shravasti Airport,104,All
2024,9,LUCKNOW,Shravasti Airport,43,60,LUCKNOW-Shravasti Airport,103,All
2024,10,LUCKNOW,Shravasti Airport,40,69,LUCKNOW-Shravasti Airport,109,All
2024,11,LUCKNOW,Shravasti Airport,4,10,LUCKNOW-Shravasti Airport,14,All
2024,12,LUCKNOW,Shravasti Airport,5,8,LUCKNOW-Shravasti Airport,13,All
2017,8,LUCKNOW,TRIVANDRUM,1,0,LUCKNOW-TRIVANDRUM,1,All
2017,9,LUCKNOW,TRIVANDRUM,2,0,LUCKNOW-TRIVANDRUM,2,All
2017,11,LUCKNOW,TRIVANDRUM,4,0,LUCKNOW-TRIVANDRUM,4,All
2017,12,LUCKNOW,TRIVANDRUM,8,0,LUCKNOW-TRIVANDRUM,8,All
2018,1,LUCKNOW,TRIVANDRUM,3,0,LUCKNOW-TRIVANDRUM,3,All
2018,2,LUCKNOW,TRIVANDRUM,18,0,LUCKNOW-TRIVANDRUM,18,All
2018,3,LUCKNOW,TRIVANDRUM,3,0,LUCKNOW-TRIVANDRUM,3,All
2018,4,LUCKNOW,TRIVANDRUM,2,0,LUCKNOW-TRIVANDRUM,2,All
2018,5,LUCKNOW,TRIVANDRUM,12,0,LUCKNOW-TRIVANDRUM,12,All
2018,6,LUCKNOW,TRIVANDRUM,1,0,LUCKNOW-TRIVANDRUM,1,All
2018,7,LUCKNOW,TRIVANDRUM,7,0,LUCKNOW-TRIVANDRUM,7,All
2018,8,LUCKNOW,TRIVANDRUM,6,0,LUCKNOW-TRIVANDRUM,6,All
2018,11,LUCKNOW,TRIVANDRUM,5,0,LUCKNOW-TRIVANDRUM,5,All
2018,12,LUCKNOW,TRIVANDRUM,14,0,LUCKNOW-TRIVANDRUM,14,All
2019,1,LUCKNOW,TRIVANDRUM,4,0,LUCKNOW-TRIVANDRUM,4,All
2019,2,LUCKNOW,TRIVANDRUM,3,0,LUCKNOW-TRIVANDRUM,3,All
2019,3,LUCKNOW,TRIVANDRUM,2,0,LUCKNOW-TRIVANDRUM,2,All
2019,4,LUCKNOW,TRIVANDRUM,11,0,LUCKNOW-TRIVANDRUM,11,All
2019,5,LUCKNOW,TRIVANDRUM,16,0,LUCKNOW-TRIVANDRUM,16,All
2019,6,LUCKNOW,TRIVANDRUM,45,0,LUCKNOW-TRIVANDRUM,45,All
2019,7,LUCKNOW,TRIVANDRUM,8,0,LUCKNOW-TRIVANDRUM,8,All
2019,8,LUCKNOW,TRIVANDRUM,12,0,LUCKNOW-TRIVANDRUM,12,All
2019,9,LUCKNOW,TRIVANDRUM,15,0,LUCKNOW-TRIVANDRUM,15,All
2019,10,LUCKNOW,TRIVANDRUM,2,0,LUCKNOW-TRIVANDRUM,2,All
2021,8,LUCKNOW,TRIVANDRUM,23,18,LUCKNOW-TRIVANDRUM,41,All
2018,10,LUCKNOW,UDAIPUR,16,0,LUCKNOW-UDAIPUR,16,All
2020,11,LUCKNOW,UDAIPUR,150,39,LUCKNOW-UDAIPUR,189,All
2020,12,LUCKNOW,UDAIPUR,48,0,LUCKNOW-UDAIPUR,48,All
2021,11,LUCKNOW,UDAIPUR,70,21,LUCKNOW-UDAIPUR,91,All
2021,12,LUCKNOW,UDAIPUR,0,20,LUCKNOW-UDAIPUR,20,All
2022,3,LUCKNOW,UDAIPUR,25,30,LUCKNOW-UDAIPUR,55,All
2023,6,LUCKNOW,UDAIPUR,20,0,LUCKNOW-UDAIPUR,20,All
2015,5,LUCKNOW,VARANASI,0,12,LUCKNOW-VARANASI,12,All
2016,10,LUCKNOW,VARANASI,30,15,LUCKNOW-VARANASI,45,All
2016,11,LUCKNOW,VARANASI,295,417,LUCKNOW-VARANASI,712,All
2018,3,LUCKNOW,VARANASI,12,0,LUCKNOW-VARANASI,12,All
2018,12,LUCKNOW,VARANASI,4,0,LUCKNOW-VARANASI,4,All
2019,1,LUCKNOW,VARANASI,5,0,LUCKNOW-VARANASI,5,All
2019,2,LUCKNOW,VARANASI,481,480,LUCKNOW-VARANASI,961,All
2019,3,LUCKNOW,VARANASI,526,475,LUCKNOW-VARANASI,1001,All
2019,10,LUCKNOW,VARANASI,1,0,LUCKNOW-VARANASI,1,All
2020,7,LUCKNOW,VARANASI,12,0,LUCKNOW-VARANASI,12,All
2020,8,LUCKNOW,VARANASI,31,7,LUCKNOW-VARANASI,38,All
2020,9,LUCKNOW,VARANASI,65,0,LUCKNOW-VARANASI,65,All
2020,10,LUCKNOW,VARANASI,1006,0,LUCKNOW-VARANASI,1006,All
2020,11,LUCKNOW,VARANASI,493,47,LUCKNOW-VARANASI,540,All
2020,12,LUCKNOW,VARANASI,0,136,LUCKNOW-VARANASI,136,All
2021,1,LUCKNOW,VARANASI,154,1349,LUCKNOW-VARANASI,1503,All
2021,2,LUCKNOW,VARANASI,313,1818,LUCKNOW-VARANASI,2131,All
2021,3,LUCKNOW,VARANASI,923,1195,LUCKNOW-VARANASI,2118,All
2021,4,LUCKNOW,VARANASI,257,275,LUCKNOW-VARANASI,532,All
2021,6,LUCKNOW,VARANASI,1825,453,LUCKNOW-VARANASI,2278,All
2021,7,LUCKNOW,VARANASI,1415,170,LUCKNOW-VARANASI,1585,All
2021,8,LUCKNOW,VARANASI,980,471,LUCKNOW-VARANASI,1451,All
2021,9,LUCKNOW,VARANASI,1510,1686,LUCKNOW-VARANASI,3196,All
2021,10,LUCKNOW,VARANASI,553,3,LUCKNOW-VARANASI,556,All
2022,1,LUCKNOW,VARANASI,328,716,LUCKNOW-VARANASI,1044,All
2022,2,LUCKNOW,VARANASI,236,3,LUCKNOW-VARANASI,239,All
2022,3,LUCKNOW,VARANASI,370,0,LUCKNOW-VARANASI,370,All
2022,5,LUCKNOW,VARANASI,212,4,LUCKNOW-VARANASI,216,All
2022,6,LUCKNOW,VARANASI,250,1036,LUCKNOW-VARANASI,1286,All
2022,7,LUCKNOW,VARANASI,336,143,LUCKNOW-VARANASI,479,All
2022,9,LUCKNOW,VARANASI,0,209,LUCKNOW-VARANASI,209,All
2022,10,LUCKNOW,VARANASI,0,3,LUCKNOW-VARANASI,3,All
2023,1,LUCKNOW,VARANASI,138,0,LUCKNOW-VARANASI,138,All
2023,2,LUCKNOW,VARANASI,0,167,LUCKNOW-VARANASI,167,All
2023,5,LUCKNOW,VARANASI,0,4,LUCKNOW-VARANASI,4,All
2023,8,LUCKNOW,VARANASI,488,571,LUCKNOW-VARANASI,1059,All
2023,9,LUCKNOW,VARANASI,567,703,LUCKNOW-VARANASI,1270,All
2023,10,LUCKNOW,VARANASI,677,680,LUCKNOW-VARANASI,1357,All
2023,11,LUCKNOW,VARANASI,1658,1252,LUCKNOW-VARANASI,2910,All
2023,12,LUCKNOW,VARANASI,1338,1304,LUCKNOW-VARANASI,2642,All
2024,1,LUCKNOW,VARANASI,785,387,LUCKNOW-VARANASI,1172,All
2024,2,LUCKNOW,VARANASI,1587,1296,LUCKNOW-VARANASI,2883,All
2024,3,LUCKNOW,VARANASI,1889,1713,LUCKNOW-VARANASI,3602,All
2024,4,LUCKNOW,VARANASI,1928,1973,LUCKNOW-VARANASI,3901,All
2024,6,LUCKNOW,VARANASI,1917,1952,LUCKNOW-VARANASI,3869,All
2024,7,LUCKNOW,VARANASI,2047,2153,LUCKNOW-VARANASI,4200,All
2024,8,LUCKNOW,VARANASI,1987,2184,LUCKNOW-VARANASI,4171,All
2024,9,LUCKNOW,VARANASI,1785,2040,LUCKNOW-VARANASI,3825,All
2024,10,LUCKNOW,VARANASI,1758,1751,LUCKNOW-VARANASI,3509,All
2024,11,LUCKNOW,VARANASI,1107,914,LUCKNOW-VARANASI,2021,All
2024,12,LUCKNOW,VARANASI,907,864,LUCKNOW-VARANASI,1771,All
2025,1,LUCKNOW,VARANASI,774,779,LUCKNOW-VARANASI,1553,All
2025,2,LUCKNOW,VARANASI,798,813,LUCKNOW-VARANASI,1611,All
2018,10,LUCKNOW,VIJAYAWADA,57,0,LUCKNOW-VIJAYAWADA,57,All
2018,11,LUCKNOW,VIJAYAWADA,135,0,LUCKNOW-VIJAYAWADA,135,All
2018,12,LUCKNOW,VIJAYAWADA,59,0,LUCKNOW-VIJAYAWADA,59,All
2019,1,LUCKNOW,VIJAYAWADA,71,0,LUCKNOW-VIJAYAWADA,71,All
2019,2,LUCKNOW,VIJAYAWADA,80,0,LUCKNOW-VIJAYAWADA,80,All
2019,3,LUCKNOW,VIJAYAWADA,94,0,LUCKNOW-VIJAYAWADA,94,All
2019,4,LUCKNOW,VIJAYAWADA,58,0,LUCKNOW-VIJAYAWADA,58,All
2019,5,LUCKNOW,VIJAYAWADA,84,0,LUCKNOW-VIJAYAWADA,84,All
2019,6,LUCKNOW,VIJAYAWADA,109,0,LUCKNOW-VIJAYAWADA,109,All
2019,7,LUCKNOW,VIJAYAWADA,73,0,LUCKNOW-VIJAYAWADA,73,All
2019,8,LUCKNOW,VIJAYAWADA,81,0,LUCKNOW-VIJAYAWADA,81,All
2019,9,LUCKNOW,VIJAYAWADA,10,0,LUCKNOW-VIJAYAWADA,10,All
2020,9,LUCKNOW,VIJAYAWADA,2,0,LUCKNOW-VIJAYAWADA,2,All
2024,12,LUCKNOW,VIJAYAWADA,3,0,LUCKNOW-VIJAYAWADA,3,All
2025,3,LUCKNOW,VIJAYAWADA,0,3,LUCKNOW-VIJAYAWADA,3,All
2024,2,LUDHIANA,HINDON AIRPORT,22,10,HINDON AIRPORT-LUDHIANA,32,All
2024,3,LUDHIANA,HINDON AIRPORT,32,35,HINDON AIRPORT-LUDHIANA,67,All
2024,4,LUDHIANA,HINDON AIRPORT,42,37,HINDON AIRPORT-LUDHIANA,79,All
2024,6,LUDHIANA,HINDON AIRPORT,160,147,HINDON AIRPORT-LUDHIANA,307,All
2024,7,LUDHIANA,HINDON AIRPORT,75,68,HINDON AIRPORT-LUDHIANA,143,All
2024,8,LUDHIANA,HINDON AIRPORT,136,121,HINDON AIRPORT-LUDHIANA,257,All
2024,9,LUDHIANA,HINDON AIRPORT,116,113,HINDON AIRPORT-LUDHIANA,229,All
2024,10,LUDHIANA,HINDON AIRPORT,87,89,HINDON AIRPORT-LUDHIANA,176,All
2024,11,LUDHIANA,HINDON AIRPORT,6,14,HINDON AIRPORT-LUDHIANA,20,All
2025,3,LUDHIANA,HINDON AIRPORT,42,71,HINDON AIRPORT-LUDHIANA,113,All
2015,4,MADURAI,CHENNAI,15459,15717,CHENNAI-MADURAI,31176,All
2015,5,MADURAI,CHENNAI,16120,16684,CHENNAI-MADURAI,32804,All
2015,6,MADURAI,CHENNAI,15049,15123,CHENNAI-MADURAI,30172,All
2015,7,MADURAI,CHENNAI,18627,18770,CHENNAI-MADURAI,37397,All
2015,8,MADURAI,CHENNAI,19482,19365,CHENNAI-MADURAI,38847,All
2015,9,MADURAI,CHENNAI,18755,18831,CHENNAI-MADURAI,37586,All
2015,10,MADURAI,CHENNAI,58010,22133,CHENNAI-MADURAI,80143,All
2015,11,MADURAI,CHENNAI,20864,22296,CHENNAI-MADURAI,43160,All
2015,12,MADURAI,CHENNAI,17104,17374,CHENNAI-MADURAI,34478,All
2016,1,MADURAI,CHENNAI,24206,23720,CHENNAI-MADURAI,47926,All
2016,2,MADURAI,CHENNAI,22615,22336,CHENNAI-MADURAI,44951,All
2016,3,MADURAI,CHENNAI,23070,23222,CHENNAI-MADURAI,46292,All
2016,4,MADURAI,CHENNAI,22519,22180,CHENNAI-MADURAI,44699,All
2016,5,MADURAI,CHENNAI,21792,22378,CHENNAI-MADURAI,44170,All
2016,6,MADURAI,CHENNAI,20921,20859,CHENNAI-MADURAI,41780,All
2016,7,MADURAI,CHENNAI,21321,21548,CHENNAI-MADURAI,42869,All
2016,8,MADURAI,CHENNAI,21415,21171,CHENNAI-MADURAI,42586,All
2016,9,MADURAI,CHENNAI,21354,21249,CHENNAI-MADURAI,42603,All
2016,10,MADURAI,CHENNAI,19973,21725,CHENNAI-MADURAI,41698,All
2016,11,MADURAI,CHENNAI,20788,21292,CHENNAI-MADURAI,42080,All
2016,12,MADURAI,CHENNAI,21862,23569,CHENNAI-MADURAI,45431,All
2017,1,MADURAI,CHENNAI,23701,23067,CHENNAI-MADURAI,46768,All
2017,2,MADURAI,CHENNAI,20975,20916,CHENNAI-MADURAI,41891,All
2017,3,MADURAI,CHENNAI,26185,26609,CHENNAI-MADURAI,52794,All
2017,4,MADURAI,CHENNAI,33246,34229,CHENNAI-MADURAI,67475,All
2017,5,MADURAI,CHENNAI,33642,33403,CHENNAI-MADURAI,67045,All
2017,6,MADURAI,CHENNAI,29995,29515,CHENNAI-MADURAI,59510,All
2017,7,MADURAI,CHENNAI,30206,29219,CHENNAI-MADURAI,59425,All
2017,8,MADURAI,CHENNAI,28509,28686,CHENNAI-MADURAI,57195,All
2017,9,MADURAI,CHENNAI,29694,29085,CHENNAI-MADURAI,58779,All
2017,10,MADURAI,CHENNAI,29523,29969,CHENNAI-MADURAI,59492,All
2017,11,MADURAI,CHENNAI,31299,30989,CHENNAI-MADURAI,62288,All
2017,12,MADURAI,CHENNAI,33420,32911,CHENNAI-MADURAI,66331,All
2018,1,MADURAI,CHENNAI,35881,34820,CHENNAI-MADURAI,70701,All
2018,2,MADURAI,CHENNAI,32589,31489,CHENNAI-MADURAI,64078,All
2018,3,MADURAI,CHENNAI,34396,35556,CHENNAI-MADURAI,69952,All
2018,4,MADURAI,CHENNAI,31901,33627,CHENNAI-MADURAI,65528,All
2018,5,MADURAI,CHENNAI,34364,35032,CHENNAI-MADURAI,69396,All
2018,6,MADURAI,CHENNAI,32925,33059,CHENNAI-MADURAI,65984,All
2018,7,MADURAI,CHENNAI,31203,30514,CHENNAI-MADURAI,61717,All
2018,8,MADURAI,CHENNAI,30010,30038,CHENNAI-MADURAI,60048,All
2018,9,MADURAI,CHENNAI,25192,24953,CHENNAI-MADURAI,50145,All
2018,10,MADURAI,CHENNAI,25578,27395,CHENNAI-MADURAI,52973,All
2018,11,MADURAI,CHENNAI,24168,25649,CHENNAI-MADURAI,49817,All
2018,12,MADURAI,CHENNAI,24547,25687,CHENNAI-MADURAI,50234,All
2019,1,MADURAI,CHENNAI,25325,25369,CHENNAI-MADURAI,50694,All
2019,2,MADURAI,CHENNAI,23882,24169,CHENNAI-MADURAI,48051,All
2019,3,MADURAI,CHENNAI,25259,26676,CHENNAI-MADURAI,51935,All
2019,4,MADURAI,CHENNAI,25302,27006,CHENNAI-MADURAI,52308,All
2019,5,MADURAI,MUMBAI,5695,6331,MADURAI-MUMBAI,12026,All
2019,6,MADURAI,MUMBAI,5182,5092,MADURAI-MUMBAI,10274,All
2019,7,MADURAI,MUMBAI,5888,6167,MADURAI-MUMBAI,12055,All
2019,8,MADURAI,MUMBAI,6643,6621,MADURAI-MUMBAI,13264,All
2019,9,MADURAI,MUMBAI,6734,5932,MADURAI-MUMBAI,12666,All
2019,10,MADURAI,MUMBAI,4789,5746,MADURAI-MUMBAI,10535,All
2019,11,MADURAI,MUMBAI,5946,5120,MADURAI-MUMBAI,11066,All
2019,12,MADURAI,MUMBAI,5336,5441,MADURAI-MUMBAI,10777,All
2020,1,MADURAI,MUMBAI,5582,5532,MADURAI-MUMBAI,11114,All
2020,2,MADURAI,MUMBAI,5332,5248,MADURAI-MUMBAI,10580,All
2020,3,MADURAI,MUMBAI,2904,3096,MADURAI-MUMBAI,6000,All
2020,6,MADURAI,MUMBAI,0,0,MADURAI-MUMBAI,0,All
2020,9,MADURAI,MUMBAI,1064,1141,MADURAI-MUMBAI,2205,All
2020,10,MADURAI,MUMBAI,2883,3429,MADURAI-MUMBAI,6312,All
2020,11,MADURAI,MUMBAI,7853,8297,MADURAI-MUMBAI,16150,All
2020,12,MADURAI,MUMBAI,5719,7092,MADURAI-MUMBAI,12811,All
2021,1,MADURAI,MUMBAI,5744,6564,MADURAI-MUMBAI,12308,All
2021,2,MADURAI,MUMBAI,5931,4926,MADURAI-MUMBAI,10857,All
2021,3,MADURAI,MUMBAI,5399,4683,MADURAI-MUMBAI,10082,All
2021,4,MADURAI,MUMBAI,4282,4702,MADURAI-MUMBAI,8984,All
2021,6,MADURAI,MUMBAI,1765,1475,MADURAI-MUMBAI,3240,All
2021,7,MADURAI,MUMBAI,3070,3191,MADURAI-MUMBAI,6261,All
2021,8,MADURAI,MUMBAI,5419,5356,MADURAI-MUMBAI,10775,All
2021,9,MADURAI,MUMBAI,5548,5195,MADURAI-MUMBAI,10743,All
2021,10,MADURAI,MUMBAI,6278,6252,MADURAI-MUMBAI,12530,All
2021,11,MADURAI,MUMBAI,6522,6713,MADURAI-MUMBAI,13235,All
2021,12,MADURAI,MUMBAI,7385,7932,MADURAI-MUMBAI,15317,All
2022,1,MADURAI,MUMBAI,4894,4806,MADURAI-MUMBAI,9700,All
2022,2,MADURAI,MUMBAI,1724,1877,MADURAI-MUMBAI,3601,All
2022,3,MADURAI,MUMBAI,3815,3806,MADURAI-MUMBAI,7621,All
2022,4,MADURAI,MUMBAI,5134,5756,MADURAI-MUMBAI,10890,All
2022,5,MADURAI,MUMBAI,6494,7146,MADURAI-MUMBAI,13640,All
2022,6,MADURAI,MUMBAI,6800,6801,MADURAI-MUMBAI,13601,All
2022,7,MADURAI,MUMBAI,5844,6263,MADURAI-MUMBAI,12107,All
2022,8,MADURAI,MUMBAI,7206,7136,MADURAI-MUMBAI,14342,All
2022,9,MADURAI,MUMBAI,7288,6396,MADURAI-MUMBAI,13684,All
2022,10,MADURAI,MUMBAI,6134,7147,MADURAI-MUMBAI,13281,All
2022,11,MADURAI,MUMBAI,10666,9007,MADURAI-MUMBAI,19673,All
2022,12,MADURAI,MUMBAI,12374,12553,MADURAI-MUMBAI,24927,All
2023,11,MADURAI,MUMBAI,5584,6535,MADURAI-MUMBAI,12119,All
2023,12,MADURAI,MUMBAI,5986,6876,MADURAI-MUMBAI,12862,All
2024,1,MADURAI,MUMBAI,5897,7328,MADURAI-MUMBAI,13225,All
2024,2,MADURAI,MUMBAI,6905,7345,MADURAI-MUMBAI,14250,All
2024,3,MADURAI,MUMBAI,9572,10729,MADURAI-MUMBAI,20301,All
2024,4,MADURAI,MUMBAI,7333,8259,MADURAI-MUMBAI,15592,All
2024,6,MADURAI,MUMBAI,8011,8773,MADURAI-MUMBAI,16784,All
2024,7,MADURAI,MUMBAI,7029,8209,MADURAI-MUMBAI,15238,All
2024,8,MADURAI,MUMBAI,7754,7691,MADURAI-MUMBAI,15445,All
2024,9,MADURAI,MUMBAI,7205,7353,MADURAI-MUMBAI,14558,All
2024,10,MADURAI,MUMBAI,5920,7266,MADURAI-MUMBAI,13186,All
2024,11,MADURAI,MUMBAI,7607,7080,MADURAI-MUMBAI,14687,All
2024,12,MADURAI,MUMBAI,6337,6909,MADURAI-MUMBAI,13246,All
2025,1,MADURAI,MUMBAI,6451,6781,MADURAI-MUMBAI,13232,All
2025,2,MADURAI,MUMBAI,5523,5707,MADURAI-MUMBAI,11230,All
2025,3,MADURAI,MUMBAI,5533,5979,MADURAI-MUMBAI,11512,All
2015,7,MADURAI,PORT BLAIR,0,42,MADURAI-PORT BLAIR,42,All
2015,8,MADURAI,PORT BLAIR,0,37,MADURAI-PORT BLAIR,37,All
2015,9,MADURAI,PORT BLAIR,0,62,MADURAI-PORT BLAIR,62,All
2015,10,MADURAI,PORT BLAIR,0,16,MADURAI-PORT BLAIR,16,All
2017,3,MADURAI,PUNE,60,0,MADURAI-PUNE,60,All
2017,4,MADURAI,PUNE,101,0,MADURAI-PUNE,101,All
2017,5,MADURAI,PUNE,168,0,MADURAI-PUNE,168,All
2017,6,MADURAI,PUNE,189,0,MADURAI-PUNE,189,All
2023,8,MADURAI,PUNE,0,70,MADURAI-PUNE,70,All
2023,9,MADURAI,PUNE,0,167,MADURAI-PUNE,167,All
2023,10,MADURAI,PUNE,0,194,MADURAI-PUNE,194,All
2018,6,MADURAI,RAJAHMUNDRY,0,28,MADURAI-RAJAHMUNDRY,28,All
2018,7,MADURAI,RAJAHMUNDRY,0,27,MADURAI-RAJAHMUNDRY,27,All
2018,8,MADURAI,RAJAHMUNDRY,0,59,MADURAI-RAJAHMUNDRY,59,All
2018,9,MADURAI,RAJAHMUNDRY,0,17,MADURAI-RAJAHMUNDRY,17,All
2018,10,MADURAI,RAJAHMUNDRY,0,31,MADURAI-RAJAHMUNDRY,31,All
2018,11,MADURAI,RAJAHMUNDRY,16,24,MADURAI-RAJAHMUNDRY,40,All
2018,12,MADURAI,RAJAHMUNDRY,12,25,MADURAI-RAJAHMUNDRY,37,All
2019,1,MADURAI,RAJAHMUNDRY,30,20,MADURAI-RAJAHMUNDRY,50,All
2019,2,MADURAI,RAJAHMUNDRY,13,25,MADURAI-RAJAHMUNDRY,38,All
2019,3,MADURAI,RAJAHMUNDRY,16,19,MADURAI-RAJAHMUNDRY,35,All
2019,4,MADURAI,RAJAHMUNDRY,25,44,MADURAI-RAJAHMUNDRY,69,All
2019,5,MADURAI,RAJAHMUNDRY,46,40,MADURAI-RAJAHMUNDRY,86,All
2019,6,MADURAI,RAJAHMUNDRY,24,83,MADURAI-RAJAHMUNDRY,107,All
2019,7,MADURAI,RAJAHMUNDRY,23,42,MADURAI-RAJAHMUNDRY,65,All
2019,8,MADURAI,RAJAHMUNDRY,21,41,MADURAI-RAJAHMUNDRY,62,All
2019,9,MADURAI,RAJAHMUNDRY,17,32,MADURAI-RAJAHMUNDRY,49,All
2019,10,MADURAI,RAJAHMUNDRY,41,46,MADURAI-RAJAHMUNDRY,87,All
2019,11,MADURAI,RAJAHMUNDRY,15,0,MADURAI-RAJAHMUNDRY,15,All
2019,12,MADURAI,RAJAHMUNDRY,6,0,MADURAI-RAJAHMUNDRY,6,All
2020,1,MADURAI,RAJAHMUNDRY,32,0,MADURAI-RAJAHMUNDRY,32,All
2020,2,MADURAI,RAJAHMUNDRY,20,0,MADURAI-RAJAHMUNDRY,20,All
2020,3,MADURAI,RAJAHMUNDRY,21,0,MADURAI-RAJAHMUNDRY,21,All
2020,2,MADURAI,SHIRDI,95,65,MADURAI-SHIRDI,160,All
2020,3,MADURAI,SHIRDI,45,64,MADURAI-SHIRDI,109,All
2019,10,MADURAI,TIRUCHIRAPALLY,30,34,MADURAI-TIRUCHIRAPALLY,64,All
2017,2,MADURAI,TIRUPATI,0,14,MADURAI-TIRUPATI,14,All
2017,3,MADURAI,TIRUPATI,0,17,MADURAI-TIRUPATI,17,All
2017,4,MADURAI,TIRUPATI,0,25,MADURAI-TIRUPATI,25,All
2017,5,MADURAI,TIRUPATI,0,8,MADURAI-TIRUPATI,8,All
2017,6,MADURAI,TIRUPATI,0,11,MADURAI-TIRUPATI,11,All
2017,7,MADURAI,TIRUPATI,0,28,MADURAI-TIRUPATI,28,All
2017,8,MADURAI,TIRUPATI,0,14,MADURAI-TIRUPATI,14,All
2017,9,MADURAI,TIRUPATI,0,4,MADURAI-TIRUPATI,4,All
2017,10,MADURAI,TIRUPATI,0,4,MADURAI-TIRUPATI,4,All
2018,10,MADURAI,TIRUPATI,0,9,MADURAI-TIRUPATI,9,All
2018,11,MADURAI,TIRUPATI,0,72,MADURAI-TIRUPATI,72,All
2018,12,MADURAI,TIRUPATI,0,83,MADURAI-TIRUPATI,83,All
2019,1,MADURAI,TIRUPATI,0,109,MADURAI-TIRUPATI,109,All
2019,2,MADURAI,TIRUPATI,0,87,MADURAI-TIRUPATI,87,All
2019,3,MADURAI,TIRUPATI,0,83,MADURAI-TIRUPATI,83,All
2019,4,MADURAI,TIRUPATI,0,70,MADURAI-TIRUPATI,70,All
2019,5,MADURAI,TIRUPATI,0,55,MADURAI-TIRUPATI,55,All
2019,6,MADURAI,TIRUPATI,0,73,MADURAI-TIRUPATI,73,All
2019,7,MADURAI,TIRUPATI,0,58,MADURAI-TIRUPATI,58,All
2019,8,MADURAI,TIRUPATI,0,54,MADURAI-TIRUPATI,54,All
2019,9,MADURAI,TIRUPATI,0,51,MADURAI-TIRUPATI,51,All
2019,10,MADURAI,TIRUPATI,0,43,MADURAI-TIRUPATI,43,All
2019,11,MADURAI,TIRUPATI,0,57,MADURAI-TIRUPATI,57,All
2019,12,MADURAI,TIRUPATI,0,84,MADURAI-TIRUPATI,84,All
2020,1,MADURAI,TIRUPATI,0,53,MADURAI-TIRUPATI,53,All
2020,2,MADURAI,TIRUPATI,0,96,MADURAI-TIRUPATI,96,All
2020,3,MADURAI,TIRUPATI,0,34,MADURAI-TIRUPATI,34,All
2021,11,MADURAI,TIRUPATI,345,284,MADURAI-TIRUPATI,629,All
2021,12,MADURAI,TIRUPATI,790,1366,MADURAI-TIRUPATI,2156,All
2022,1,MADURAI,TIRUPATI,696,884,MADURAI-TIRUPATI,1580,All
2022,2,MADURAI,TIRUPATI,390,398,MADURAI-TIRUPATI,788,All
2022,3,MADURAI,TIRUPATI,760,637,MADURAI-TIRUPATI,1397,All
2022,4,MADURAI,TIRUPATI,728,605,MADURAI-TIRUPATI,1333,All
2022,5,MADURAI,TIRUPATI,804,726,MADURAI-TIRUPATI,1530,All
2022,6,MADURAI,TIRUPATI,918,638,MADURAI-TIRUPATI,1556,All
2022,7,MADURAI,TIRUPATI,1128,862,MADURAI-TIRUPATI,1990,All
2022,8,MADURAI,TIRUPATI,977,813,MADURAI-TIRUPATI,1790,All
2022,9,MADURAI,TIRUPATI,914,908,MADURAI-TIRUPATI,1822,All
2022,10,MADURAI,TIRUPATI,1128,1189,MADURAI-TIRUPATI,2317,All
2022,11,MADURAI,TIRUPATI,168,208,MADURAI-TIRUPATI,376,All
2022,12,MADURAI,TIRUPATI,154,144,MADURAI-TIRUPATI,298,All
2023,1,MADURAI,TIRUPATI,171,168,MADURAI-TIRUPATI,339,All
2023,2,MADURAI,TIRUPATI,157,121,MADURAI-TIRUPATI,278,All
2023,3,MADURAI,TIRUPATI,213,209,MADURAI-TIRUPATI,422,All
2023,4,MADURAI,TIRUPATI,196,175,MADURAI-TIRUPATI,371,All
2023,5,MADURAI,TIRUPATI,200,132,MADURAI-TIRUPATI,332,All
2023,6,MADURAI,TIRUPATI,190,196,MADURAI-TIRUPATI,386,All
2023,7,MADURAI,TIRUPATI,238,200,MADURAI-TIRUPATI,438,All
2023,8,MADURAI,TIRUPATI,201,206,MADURAI-TIRUPATI,407,All
2023,9,MADURAI,TIRUPATI,249,178,MADURAI-TIRUPATI,427,All
2023,10,MADURAI,TIRUPATI,253,224,MADURAI-TIRUPATI,477,All
2020,5,MADURAI,TRIVANDRUM,2,0,MADURAI-TRIVANDRUM,2,All
2021,3,MADURAI,TRIVANDRUM,2,0,MADURAI-TRIVANDRUM,2,All
2021,4,MADURAI,TRIVANDRUM,8,0,MADURAI-TRIVANDRUM,8,All
2020,1,MADURAI,TUTICORIN,26,0,MADURAI-TUTICORIN,26,All
2024,8,MADURAI,TUTICORIN,31,0,MADURAI-TUTICORIN,31,All
2021,3,MADURAI,VIJAYAWADA,3,10,MADURAI-VIJAYAWADA,13,All
2021,4,MADURAI,VIJAYAWADA,84,61,MADURAI-VIJAYAWADA,145,All
2021,6,MADURAI,VIJAYAWADA,44,44,MADURAI-VIJAYAWADA,88,All
2021,7,MADURAI,VIJAYAWADA,131,94,MADURAI-VIJAYAWADA,225,All
2021,8,MADURAI,VIJAYAWADA,113,101,MADURAI-VIJAYAWADA,214,All
2021,9,MADURAI,VIJAYAWADA,132,74,MADURAI-VIJAYAWADA,206,All
2021,10,MADURAI,VIJAYAWADA,131,69,MADURAI-VIJAYAWADA,200,All
2021,11,MADURAI,VIJAYAWADA,93,104,MADURAI-VIJAYAWADA,197,All
2021,12,MADURAI,VIJAYAWADA,120,146,MADURAI-VIJAYAWADA,266,All
2022,1,MADURAI,VIJAYAWADA,117,77,MADURAI-VIJAYAWADA,194,All
2022,2,MADURAI,VIJAYAWADA,0,110,MADURAI-VIJAYAWADA,110,All
2022,3,MADURAI,VIJAYAWADA,67,54,MADURAI-VIJAYAWADA,121,All
2022,4,MADURAI,VIJAYAWADA,174,175,MADURAI-VIJAYAWADA,349,All
2022,5,MADURAI,VIJAYAWADA,185,162,MADURAI-VIJAYAWADA,347,All
2022,6,MADURAI,VIJAYAWADA,189,145,MADURAI-VIJAYAWADA,334,All
2022,7,MADURAI,VIJAYAWADA,184,167,MADURAI-VIJAYAWADA,351,All
2022,8,MADURAI,VIJAYAWADA,140,105,MADURAI-VIJAYAWADA,245,All
2022,9,MADURAI,VIJAYAWADA,81,95,MADURAI-VIJAYAWADA,176,All
2022,10,MADURAI,VIJAYAWADA,135,129,MADURAI-VIJAYAWADA,264,All
2022,11,MADURAI,VIJAYAWADA,147,137,MADURAI-VIJAYAWADA,284,All
2022,12,MADURAI,VIJAYAWADA,165,134,MADURAI-VIJAYAWADA,299,All
2023,1,MADURAI,VIJAYAWADA,188,88,MADURAI-VIJAYAWADA,276,All
2023,2,MADURAI,VIJAYAWADA,126,81,MADURAI-VIJAYAWADA,207,All
2023,3,MADURAI,VIJAYAWADA,154,135,MADURAI-VIJAYAWADA,289,All
2023,4,MADURAI,VIJAYAWADA,132,146,MADURAI-VIJAYAWADA,278,All
2023,5,MADURAI,VIJAYAWADA,89,92,MADURAI-VIJAYAWADA,181,All
2023,6,MADURAI,VIJAYAWADA,95,105,MADURAI-VIJAYAWADA,200,All
2023,7,MADURAI,VIJAYAWADA,140,109,MADURAI-VIJAYAWADA,249,All
2023,8,MADURAI,VIJAYAWADA,114,111,MADURAI-VIJAYAWADA,225,All
2023,9,MADURAI,VIJAYAWADA,24,52,MADURAI-VIJAYAWADA,76,All
2023,10,MADURAI,VIJAYAWADA,101,181,MADURAI-VIJAYAWADA,282,All
2025,3,MADURAI,VIJAYAWADA,6,5,MADURAI-VIJAYAWADA,11,All
2023,8,MADURAI,VISAKHAPATNAM,13,0,MADURAI-VISAKHAPATNAM,13,All
2023,9,MADURAI,VISAKHAPATNAM,53,0,MADURAI-VISAKHAPATNAM,53,All
2023,10,MADURAI,VISAKHAPATNAM,37,0,MADURAI-VISAKHAPATNAM,37,All
2015,11,MANGALORE,BELGAUM,30,23,BELGAUM-MANGALORE,53,All
2015,12,MANGALORE,BELGAUM,76,67,BELGAUM-MANGALORE,143,All
2016,1,MANGALORE,BELGAUM,51,41,BELGAUM-MANGALORE,92,All
2016,2,MANGALORE,BELGAUM,37,43,BELGAUM-MANGALORE,80,All
2016,3,MANGALORE,BELGAUM,52,49,BELGAUM-MANGALORE,101,All
2016,4,MANGALORE,BELGAUM,26,46,BELGAUM-MANGALORE,72,All
2016,5,MANGALORE,BELGAUM,40,33,BELGAUM-MANGALORE,73,All
2016,6,MANGALORE,BELGAUM,39,28,BELGAUM-MANGALORE,67,All
2016,7,MANGALORE,BELGAUM,41,29,BELGAUM-MANGALORE,70,All
2016,8,MANGALORE,BELGAUM,36,37,BELGAUM-MANGALORE,73,All
2016,9,MANGALORE,BELGAUM,21,21,BELGAUM-MANGALORE,42,All
2016,10,MANGALORE,BELGAUM,23,42,BELGAUM-MANGALORE,65,All
2016,11,MANGALORE,BELGAUM,27,27,BELGAUM-MANGALORE,54,All
2016,12,MANGALORE,BELGAUM,28,31,BELGAUM-MANGALORE,59,All
2017,1,MANGALORE,BELGAUM,55,63,BELGAUM-MANGALORE,118,All
2017,2,MANGALORE,BELGAUM,28,35,BELGAUM-MANGALORE,63,All
2017,3,MANGALORE,BELGAUM,46,46,BELGAUM-MANGALORE,92,All
2017,4,MANGALORE,BELGAUM,26,81,BELGAUM-MANGALORE,107,All
2017,5,MANGALORE,BELGAUM,48,54,BELGAUM-MANGALORE,102,All
2017,6,MANGALORE,BELGAUM,37,27,BELGAUM-MANGALORE,64,All
2017,7,MANGALORE,BELGAUM,16,40,BELGAUM-MANGALORE,56,All
2017,8,MANGALORE,BELGAUM,29,46,BELGAUM-MANGALORE,75,All
2017,9,MANGALORE,BELGAUM,20,24,BELGAUM-MANGALORE,44,All
2017,10,MANGALORE,BELGAUM,51,68,BELGAUM-MANGALORE,119,All
2017,11,MANGALORE,BELGAUM,44,47,BELGAUM-MANGALORE,91,All
2017,12,MANGALORE,BELGAUM,32,26,BELGAUM-MANGALORE,58,All
2018,1,MANGALORE,BELGAUM,62,41,BELGAUM-MANGALORE,103,All
2018,2,MANGALORE,BELGAUM,29,46,BELGAUM-MANGALORE,75,All
2018,3,MANGALORE,BELGAUM,54,40,BELGAUM-MANGALORE,94,All
2018,4,MANGALORE,BELGAUM,32,53,BELGAUM-MANGALORE,85,All
2018,5,MANGALORE,BELGAUM,11,20,BELGAUM-MANGALORE,31,All
2015,4,MANGALORE,CHENNAI,635,705,CHENNAI-MANGALORE,1340,All
2015,5,MANGALORE,CHENNAI,881,809,CHENNAI-MANGALORE,1690,All
2015,6,MANGALORE,CHENNAI,432,596,CHENNAI-MANGALORE,1028,All
2015,7,MANGALORE,CHENNAI,588,549,CHENNAI-MANGALORE,1137,All
2015,8,MANGALORE,CHENNAI,520,610,CHENNAI-MANGALORE,1130,All
2015,9,MANGALORE,CHENNAI,499,517,CHENNAI-MANGALORE,1016,All
2015,10,MANGALORE,CHENNAI,534,547,CHENNAI-MANGALORE,1081,All
2015,11,MANGALORE,CHENNAI,588,613,CHENNAI-MANGALORE,1201,All
2015,12,MANGALORE,CHENNAI,329,434,CHENNAI-MANGALORE,763,All
2016,1,MANGALORE,CHENNAI,519,613,CHENNAI-MANGALORE,1132,All
2016,2,MANGALORE,CHENNAI,429,449,CHENNAI-MANGALORE,878,All
2016,3,MANGALORE,CHENNAI,523,477,CHENNAI-MANGALORE,1000,All
2016,4,MANGALORE,CHENNAI,448,0,CHENNAI-MANGALORE,448,All
2016,5,MANGALORE,CHENNAI,509,0,CHENNAI-MANGALORE,509,All
2016,6,MANGALORE,CHENNAI,443,0,CHENNAI-MANGALORE,443,All
2016,7,MANGALORE,CHENNAI,416,0,CHENNAI-MANGALORE,416,All
2016,8,MANGALORE,CHENNAI,448,0,CHENNAI-MANGALORE,448,All
2016,9,MANGALORE,CHENNAI,474,0,CHENNAI-MANGALORE,474,All
2016,10,MANGALORE,CHENNAI,492,0,CHENNAI-MANGALORE,492,All
2016,11,MANGALORE,CHENNAI,608,0,CHENNAI-MANGALORE,608,All
2016,12,MANGALORE,CHENNAI,676,0,CHENNAI-MANGALORE,676,All
2017,1,MANGALORE,CHENNAI,653,0,CHENNAI-MANGALORE,653,All
2017,2,MANGALORE,CHENNAI,574,0,CHENNAI-MANGALORE,574,All
2017,3,MANGALORE,CHENNAI,551,0,CHENNAI-MANGALORE,551,All
2017,4,MANGALORE,CHENNAI,546,0,CHENNAI-MANGALORE,546,All
2017,5,MANGALORE,CHENNAI,409,459,CHENNAI-MANGALORE,868,All
2017,6,MANGALORE,CHENNAI,289,279,CHENNAI-MANGALORE,568,All
2017,7,MANGALORE,CHENNAI,268,282,CHENNAI-MANGALORE,550,All
2017,8,MANGALORE,CHENNAI,337,375,CHENNAI-MANGALORE,712,All
2017,9,MANGALORE,CHENNAI,342,420,CHENNAI-MANGALORE,762,All
2017,10,MANGALORE,CHENNAI,225,253,CHENNAI-MANGALORE,478,All
2017,11,MANGALORE,CHENNAI,505,232,CHENNAI-MANGALORE,737,All
2017,12,MANGALORE,CHENNAI,1255,1021,CHENNAI-MANGALORE,2276,All
2018,1,MANGALORE,CHENNAI,2163,1995,CHENNAI-MANGALORE,4158,All
2018,2,MANGALORE,CHENNAI,2159,1952,CHENNAI-MANGALORE,4111,All
2018,3,MANGALORE,CHENNAI,3282,3377,CHENNAI-MANGALORE,6659,All
2018,4,MANGALORE,CHENNAI,2256,2178,CHENNAI-MANGALORE,4434,All
2018,5,MANGALORE,CHENNAI,4208,4232,CHENNAI-MANGALORE,8440,All
2018,6,MANGALORE,CHENNAI,4204,3884,CHENNAI-MANGALORE,8088,All
2018,7,MANGALORE,CHENNAI,5783,6001,CHENNAI-MANGALORE,11784,All
2018,8,MANGALORE,CHENNAI,5599,5371,CHENNAI-MANGALORE,10970,All
2018,9,MANGALORE,CHENNAI,4980,5207,CHENNAI-MANGALORE,10187,All
2018,10,MANGALORE,CHENNAI,5646,5726,CHENNAI-MANGALORE,11372,All
2018,11,MANGALORE,CHENNAI,5042,5454,CHENNAI-MANGALORE,10496,All
2018,12,MANGALORE,CHENNAI,5885,6194,CHENNAI-MANGALORE,12079,All
2019,1,MANGALORE,CHENNAI,4392,3954,CHENNAI-MANGALORE,8346,All
2019,2,MANGALORE,CHENNAI,3760,3682,CHENNAI-MANGALORE,7442,All
2019,3,MANGALORE,CHENNAI,3926,3747,CHENNAI-MANGALORE,7673,All
2019,4,MANGALORE,CHENNAI,3890,3934,CHENNAI-MANGALORE,7824,All
2018,6,MANGALORE,MADURAI,0,31,MADURAI-MANGALORE,31,All
2018,7,MANGALORE,MADURAI,0,40,MADURAI-MANGALORE,40,All
2018,8,MANGALORE,MADURAI,0,4,MADURAI-MANGALORE,4,All
2019,5,MANGALORE,MUMBAI,20888,20908,MANGALORE-MUMBAI,41796,All
2019,6,MANGALORE,MUMBAI,18959,18724,MANGALORE-MUMBAI,37683,All
2019,7,MANGALORE,MUMBAI,17863,19248,MANGALORE-MUMBAI,37111,All
2019,8,MANGALORE,MUMBAI,20066,19361,MANGALORE-MUMBAI,39427,All
2019,9,MANGALORE,MUMBAI,18439,17525,MANGALORE-MUMBAI,35964,All
2019,10,MANGALORE,MUMBAI,18960,19834,MANGALORE-MUMBAI,38794,All
2019,11,MANGALORE,MUMBAI,18573,18882,MANGALORE-MUMBAI,37455,All
2019,12,MANGALORE,MUMBAI,18815,19727,MANGALORE-MUMBAI,38542,All
2020,1,MANGALORE,MUMBAI,19104,19721,MANGALORE-MUMBAI,38825,All
2020,2,MANGALORE,MUMBAI,20912,20869,MANGALORE-MUMBAI,41781,All
2020,3,MANGALORE,MUMBAI,16096,13505,MANGALORE-MUMBAI,29601,All
2020,7,MANGALORE,MUMBAI,392,290,MANGALORE-MUMBAI,682,All
2020,8,MANGALORE,MUMBAI,1857,2351,MANGALORE-MUMBAI,4208,All
2020,9,MANGALORE,MUMBAI,4013,4553,MANGALORE-MUMBAI,8566,All
2020,10,MANGALORE,MUMBAI,7181,8337,MANGALORE-MUMBAI,15518,All
2020,11,MANGALORE,MUMBAI,11029,12186,MANGALORE-MUMBAI,23215,All
2020,12,MANGALORE,MUMBAI,20791,19625,MANGALORE-MUMBAI,40416,All
2021,1,MANGALORE,MUMBAI,17816,17232,MANGALORE-MUMBAI,35048,All
2021,2,MANGALORE,MUMBAI,17484,19146,MANGALORE-MUMBAI,36630,All
2021,3,MANGALORE,MUMBAI,12114,11104,MANGALORE-MUMBAI,23218,All
2021,4,MANGALORE,MUMBAI,9149,10255,MANGALORE-MUMBAI,19404,All
2021,6,MANGALORE,MUMBAI,4632,3674,MANGALORE-MUMBAI,8306,All
2021,7,MANGALORE,MUMBAI,6937,7709,MANGALORE-MUMBAI,14646,All
2021,8,MANGALORE,MUMBAI,11037,11492,MANGALORE-MUMBAI,22529,All
2021,9,MANGALORE,MUMBAI,12093,11646,MANGALORE-MUMBAI,23739,All
2021,10,MANGALORE,MUMBAI,16185,18106,MANGALORE-MUMBAI,34291,All
2021,11,MANGALORE,MUMBAI,17843,19632,MANGALORE-MUMBAI,37475,All
2021,12,MANGALORE,MUMBAI,21711,24499,MANGALORE-MUMBAI,46210,All
2022,1,MANGALORE,MUMBAI,16951,14090,MANGALORE-MUMBAI,31041,All
2022,2,MANGALORE,MUMBAI,17314,19455,MANGALORE-MUMBAI,36769,All
2022,3,MANGALORE,MUMBAI,20712,23090,MANGALORE-MUMBAI,43802,All
2022,4,MANGALORE,MUMBAI,22634,24670,MANGALORE-MUMBAI,47304,All
2022,5,MANGALORE,MUMBAI,27594,27882,MANGALORE-MUMBAI,55476,All
2022,6,MANGALORE,MUMBAI,19308,18560,MANGALORE-MUMBAI,37868,All
2022,7,MANGALORE,MUMBAI,16045,20265,MANGALORE-MUMBAI,36310,All
2022,8,MANGALORE,MUMBAI,22210,21689,MANGALORE-MUMBAI,43899,All
2022,9,MANGALORE,MUMBAI,23748,20514,MANGALORE-MUMBAI,44262,All
2022,10,MANGALORE,MUMBAI,22656,24749,MANGALORE-MUMBAI,47405,All
2022,11,MANGALORE,MUMBAI,15271,15149,MANGALORE-MUMBAI,30420,All
2022,12,MANGALORE,MUMBAI,19844,19741,MANGALORE-MUMBAI,39585,All
2023,11,MANGALORE,MUMBAI,27616,29273,MANGALORE-MUMBAI,56889,All
2023,12,MANGALORE,MUMBAI,29956,32615,MANGALORE-MUMBAI,62571,All
2024,1,MANGALORE,MUMBAI,30015,30291,MANGALORE-MUMBAI,60306,All
2024,2,MANGALORE,MUMBAI,26223,26509,MANGALORE-MUMBAI,52732,All
2024,3,MANGALORE,MUMBAI,25064,25276,MANGALORE-MUMBAI,50340,All
2024,4,MANGALORE,MUMBAI,26773,27107,MANGALORE-MUMBAI,53880,All
2024,6,MANGALORE,MUMBAI,23116,24921,MANGALORE-MUMBAI,48037,All
2024,7,MANGALORE,MUMBAI,23698,28154,MANGALORE-MUMBAI,51852,All
2024,8,MANGALORE,MUMBAI,28183,27047,MANGALORE-MUMBAI,55230,All
2024,9,MANGALORE,MUMBAI,26437,24590,MANGALORE-MUMBAI,51027,All
2024,10,MANGALORE,MUMBAI,25502,25989,MANGALORE-MUMBAI,51491,All
2024,11,MANGALORE,MUMBAI,26716,26710,MANGALORE-MUMBAI,53426,All
2024,12,MANGALORE,MUMBAI,27407,28666,MANGALORE-MUMBAI,56073,All
2025,1,MANGALORE,MUMBAI,28255,28295,MANGALORE-MUMBAI,56550,All
2025,2,MANGALORE,MUMBAI,23890,24749,MANGALORE-MUMBAI,48639,All
2025,3,MANGALORE,MUMBAI,24573,24384,MANGALORE-MUMBAI,48957,All
2020,12,MANGALORE,MYSORE,184,261,MANGALORE-MYSORE,445,All
2021,1,MANGALORE,MYSORE,328,326,MANGALORE-MYSORE,654,All
2021,2,MANGALORE,MYSORE,270,265,MANGALORE-MYSORE,535,All
2021,3,MANGALORE,MYSORE,139,147,MANGALORE-MYSORE,286,All
2021,4,MANGALORE,MYSORE,89,124,MANGALORE-MYSORE,213,All
2018,2,MANGALORE,NAGPUR,39,0,MANGALORE-NAGPUR,39,All
2018,3,MANGALORE,NAGPUR,29,9,MANGALORE-NAGPUR,38,All
2018,4,MANGALORE,NAGPUR,70,13,MANGALORE-NAGPUR,83,All
2018,5,MANGALORE,NAGPUR,60,73,MANGALORE-NAGPUR,133,All
2018,6,MANGALORE,NAGPUR,21,0,MANGALORE-NAGPUR,21,All
2018,7,MANGALORE,NAGPUR,67,0,MANGALORE-NAGPUR,67,All
2018,8,MANGALORE,NAGPUR,87,0,MANGALORE-NAGPUR,87,All
2018,9,MANGALORE,NAGPUR,63,14,MANGALORE-NAGPUR,77,All
2018,10,MANGALORE,NAGPUR,60,23,MANGALORE-NAGPUR,83,All
2018,11,MANGALORE,NAGPUR,94,0,MANGALORE-NAGPUR,94,All
2018,12,MANGALORE,NAGPUR,57,0,MANGALORE-NAGPUR,57,All
2019,1,MANGALORE,NAGPUR,53,0,MANGALORE-NAGPUR,53,All
2019,2,MANGALORE,NAGPUR,43,0,MANGALORE-NAGPUR,43,All
2019,3,MANGALORE,NAGPUR,36,0,MANGALORE-NAGPUR,36,All
2019,4,MANGALORE,NAGPUR,77,0,MANGALORE-NAGPUR,77,All
2019,5,MANGALORE,NAGPUR,62,0,MANGALORE-NAGPUR,62,All
2017,6,MANGALORE,PATNA,3,1,MANGALORE-PATNA,4,All
2017,7,MANGALORE,PATNA,60,61,MANGALORE-PATNA,121,All
2017,8,MANGALORE,PATNA,68,79,MANGALORE-PATNA,147,All
2017,9,MANGALORE,PATNA,65,97,MANGALORE-PATNA,162,All
2017,10,MANGALORE,PATNA,75,57,MANGALORE-PATNA,132,All
2017,11,MANGALORE,PATNA,58,121,MANGALORE-PATNA,179,All
2018,2,MANGALORE,PATNA,45,30,MANGALORE-PATNA,75,All
2018,3,MANGALORE,PATNA,123,145,MANGALORE-PATNA,268,All
2018,4,MANGALORE,PATNA,196,128,MANGALORE-PATNA,324,All
2018,5,MANGALORE,PATNA,268,123,MANGALORE-PATNA,391,All
2018,6,MANGALORE,PATNA,188,207,MANGALORE-PATNA,395,All
2018,7,MANGALORE,PATNA,124,309,MANGALORE-PATNA,433,All
2018,8,MANGALORE,PATNA,192,168,MANGALORE-PATNA,360,All
2018,9,MANGALORE,PATNA,190,100,MANGALORE-PATNA,290,All
2018,10,MANGALORE,PATNA,224,118,MANGALORE-PATNA,342,All
2023,3,MANGALORE,PATNA,13,0,MANGALORE-PATNA,13,All
2023,4,MANGALORE,PATNA,66,0,MANGALORE-PATNA,66,All
2023,5,MANGALORE,PATNA,123,0,MANGALORE-PATNA,123,All
2023,6,MANGALORE,PATNA,142,110,MANGALORE-PATNA,252,All
2023,7,MANGALORE,PATNA,69,290,MANGALORE-PATNA,359,All
2023,8,MANGALORE,PATNA,86,145,MANGALORE-PATNA,231,All
2023,9,MANGALORE,PATNA,97,93,MANGALORE-PATNA,190,All
2023,10,MANGALORE,PATNA,47,104,MANGALORE-PATNA,151,All
2019,10,MANGALORE,PUNE,5,19,MANGALORE-PUNE,24,All
2019,11,MANGALORE,PUNE,134,202,MANGALORE-PUNE,336,All
2019,12,MANGALORE,PUNE,308,269,MANGALORE-PUNE,577,All
2020,1,MANGALORE,PUNE,195,228,MANGALORE-PUNE,423,All
2020,2,MANGALORE,PUNE,171,216,MANGALORE-PUNE,387,All
2020,3,MANGALORE,PUNE,172,191,MANGALORE-PUNE,363,All
2022,3,MANGALORE,PUNE,160,218,MANGALORE-PUNE,378,All
2022,4,MANGALORE,PUNE,1311,1675,MANGALORE-PUNE,2986,All
2022,5,MANGALORE,PUNE,1704,1971,MANGALORE-PUNE,3675,All
2022,6,MANGALORE,PUNE,1298,1221,MANGALORE-PUNE,2519,All
2022,7,MANGALORE,PUNE,958,1053,MANGALORE-PUNE,2011,All
2022,8,MANGALORE,PUNE,62,0,MANGALORE-PUNE,62,All
2022,10,MANGALORE,PUNE,986,1342,MANGALORE-PUNE,2328,All
2022,11,MANGALORE,PUNE,1152,841,MANGALORE-PUNE,1993,All
2022,12,MANGALORE,PUNE,1594,1787,MANGALORE-PUNE,3381,All
2023,1,MANGALORE,PUNE,1639,1273,MANGALORE-PUNE,2912,All
2023,2,MANGALORE,PUNE,1382,1391,MANGALORE-PUNE,2773,All
2023,3,MANGALORE,PUNE,1533,1369,MANGALORE-PUNE,2902,All
2023,4,MANGALORE,PUNE,1992,1873,MANGALORE-PUNE,3865,All
2023,5,MANGALORE,PUNE,2673,2778,MANGALORE-PUNE,5451,All
2023,6,MANGALORE,PUNE,1919,1744,MANGALORE-PUNE,3663,All
2023,7,MANGALORE,PUNE,2028,2314,MANGALORE-PUNE,4342,All
2023,8,MANGALORE,PUNE,2226,2251,MANGALORE-PUNE,4477,All
2023,9,MANGALORE,PUNE,3250,2976,MANGALORE-PUNE,6226,All
2023,10,MANGALORE,PUNE,2827,2480,MANGALORE-PUNE,5307,All
2023,11,MANGALORE,PUNE,1046,896,MANGALORE-PUNE,1942,All
2023,12,MANGALORE,PUNE,1828,1891,MANGALORE-PUNE,3719,All
2024,1,MANGALORE,PUNE,1710,1654,MANGALORE-PUNE,3364,All
2024,2,MANGALORE,PUNE,1645,1577,MANGALORE-PUNE,3222,All
2024,3,MANGALORE,PUNE,1571,1575,MANGALORE-PUNE,3146,All
2024,4,MANGALORE,PUNE,2004,1974,MANGALORE-PUNE,3978,All
2024,6,MANGALORE,PUNE,2084,1811,MANGALORE-PUNE,3895,All
2024,7,MANGALORE,PUNE,1690,1967,MANGALORE-PUNE,3657,All
2024,8,MANGALORE,PUNE,1959,1915,MANGALORE-PUNE,3874,All
2024,9,MANGALORE,PUNE,2039,1994,MANGALORE-PUNE,4033,All
2024,10,MANGALORE,PUNE,1482,1431,MANGALORE-PUNE,2913,All
2025,1,MANGALORE,PUNE,902,878,MANGALORE-PUNE,1780,All
2025,2,MANGALORE,PUNE,805,783,MANGALORE-PUNE,1588,All
2025,3,MANGALORE,PUNE,563,585,MANGALORE-PUNE,1148,All
2022,3,MANGALORE,RAIPUR,35,0,MANGALORE-RAIPUR,35,All
2023,1,MANGALORE,RAIPUR,0,55,MANGALORE-RAIPUR,55,All
2024,11,MANGALORE,RAJAHMUNDRY,0,4,MANGALORE-RAJAHMUNDRY,4,All
2024,12,MANGALORE,RAJAHMUNDRY,0,1,MANGALORE-RAJAHMUNDRY,1,All
2025,3,MANGALORE,RAJAHMUNDRY,0,3,MANGALORE-RAJAHMUNDRY,3,All
2022,10,MANGALORE,RANCHI,2,0,MANGALORE-RANCHI,2,All
2022,11,MANGALORE,RANCHI,116,45,MANGALORE-RANCHI,161,All
2022,12,MANGALORE,RANCHI,114,62,MANGALORE-RANCHI,176,All
2023,1,MANGALORE,RANCHI,79,77,MANGALORE-RANCHI,156,All
2023,2,MANGALORE,RANCHI,56,47,MANGALORE-RANCHI,103,All
2023,3,MANGALORE,RANCHI,59,33,MANGALORE-RANCHI,92,All
2023,4,MANGALORE,RANCHI,58,40,MANGALORE-RANCHI,98,All
2023,5,MANGALORE,RANCHI,64,23,MANGALORE-RANCHI,87,All
2023,6,MANGALORE,RANCHI,120,18,MANGALORE-RANCHI,138,All
2023,7,MANGALORE,RANCHI,26,21,MANGALORE-RANCHI,47,All
2023,8,MANGALORE,RANCHI,55,16,MANGALORE-RANCHI,71,All
2023,9,MANGALORE,RANCHI,12,2,MANGALORE-RANCHI,14,All
2024,4,MANGALORE,TIRUCHIRAPALLY,41,18,MANGALORE-TIRUCHIRAPALLY,59,All
2019,8,MANGALORE,TRIVANDRUM,0,4,MANGALORE-TRIVANDRUM,4,All
2022,5,MANGALORE,TRIVANDRUM,0,1,MANGALORE-TRIVANDRUM,1,All
2019,5,MANGALORE,VADODARA,0,87,MANGALORE-VADODARA,87,All
2019,6,MANGALORE,VADODARA,0,90,MANGALORE-VADODARA,90,All
2019,7,MANGALORE,VADODARA,0,97,MANGALORE-VADODARA,97,All
2019,8,MANGALORE,VADODARA,0,192,MANGALORE-VADODARA,192,All
2019,9,MANGALORE,VADODARA,0,131,MANGALORE-VADODARA,131,All
2019,10,MANGALORE,VADODARA,0,208,MANGALORE-VADODARA,208,All
2019,11,MANGALORE,VADODARA,0,170,MANGALORE-VADODARA,170,All
2019,12,MANGALORE,VADODARA,0,106,MANGALORE-VADODARA,106,All
2020,1,MANGALORE,VADODARA,0,138,MANGALORE-VADODARA,138,All
2020,2,MANGALORE,VADODARA,0,12,MANGALORE-VADODARA,12,All
2017,6,MANGALORE,VARANASI,10,0,MANGALORE-VARANASI,10,All
2017,7,MANGALORE,VARANASI,29,0,MANGALORE-VARANASI,29,All
2017,8,MANGALORE,VARANASI,53,0,MANGALORE-VARANASI,53,All
2017,9,MANGALORE,VARANASI,60,0,MANGALORE-VARANASI,60,All
2017,10,MANGALORE,VARANASI,49,0,MANGALORE-VARANASI,49,All
2017,11,MANGALORE,VARANASI,81,0,MANGALORE-VARANASI,81,All
2018,2,MANGALORE,VARANASI,30,0,MANGALORE-VARANASI,30,All
2018,3,MANGALORE,VARANASI,78,0,MANGALORE-VARANASI,78,All
2018,4,MANGALORE,VARANASI,71,0,MANGALORE-VARANASI,71,All
2018,5,MANGALORE,VARANASI,170,0,MANGALORE-VARANASI,170,All
2018,6,MANGALORE,VARANASI,120,0,MANGALORE-VARANASI,120,All
2018,7,MANGALORE,VARANASI,107,0,MANGALORE-VARANASI,107,All
2018,8,MANGALORE,VARANASI,109,0,MANGALORE-VARANASI,109,All
2018,9,MANGALORE,VARANASI,181,0,MANGALORE-VARANASI,181,All
2018,10,MANGALORE,VARANASI,172,0,MANGALORE-VARANASI,172,All
2018,11,MANGALORE,VARANASI,133,0,MANGALORE-VARANASI,133,All
2018,12,MANGALORE,VARANASI,91,0,MANGALORE-VARANASI,91,All
2019,1,MANGALORE,VARANASI,133,0,MANGALORE-VARANASI,133,All
2019,2,MANGALORE,VARANASI,42,0,MANGALORE-VARANASI,42,All
2019,3,MANGALORE,VARANASI,227,0,MANGALORE-VARANASI,227,All
2019,4,MANGALORE,VARANASI,136,0,MANGALORE-VARANASI,136,All
2019,5,MANGALORE,VARANASI,133,0,MANGALORE-VARANASI,133,All
2019,6,MANGALORE,VARANASI,119,0,MANGALORE-VARANASI,119,All
2019,8,MANGALORE,VARANASI,98,0,MANGALORE-VARANASI,98,All
2017,7,MANGALORE,VIJAYAWADA,0,144,MANGALORE-VIJAYAWADA,144,All
2017,8,MANGALORE,VIJAYAWADA,0,79,MANGALORE-VIJAYAWADA,79,All
2015,7,MANGALORE,VISAKHAPATNAM,28,18,MANGALORE-VISAKHAPATNAM,46,All
2015,8,MANGALORE,VISAKHAPATNAM,18,25,MANGALORE-VISAKHAPATNAM,43,All
2015,9,MANGALORE,VISAKHAPATNAM,28,43,MANGALORE-VISAKHAPATNAM,71,All
2015,10,MANGALORE,VISAKHAPATNAM,0,40,MANGALORE-VISAKHAPATNAM,40,All
2023,2,"MOPA, GOA",AHMEDABAD,5084,5714,"AHMEDABAD-MOPA, GOA",10798,All
2023,2,"MOPA, GOA",BENGALURU,25850,24581,"BENGALURU-MOPA, GOA",50431,All
2023,2,"MOPA, GOA",CHANDIGARH,9545,9307,"CHANDIGARH-MOPA, GOA",18852,All
2023,2,"MOPA, GOA",CHENNAI,3439,3580,"CHENNAI-MOPA, GOA",7019,All
2023,2,"MOPA, GOA",DELHI,20013,18702,"DELHI-MOPA, GOA",38715,All
2023,2,"MOPA, GOA",HYDERABAD,13730,13548,"HYDERABAD-MOPA, GOA",27278,All
2023,2,"MOPA, GOA",JAIPUR,9428,8491,"JAIPUR-MOPA, GOA",17919,All
2023,2,"MOPA, GOA",KOCHI,0,879,"KOCHI-MOPA, GOA",879,All
2023,2,"MOPA, GOA",KOLKATA,1742,1525,"KOLKATA-MOPA, GOA",3267,All
2023,2,"MOPA, GOA",MUMBAI,19974,19697,"MOPA, GOA-MUMBAI",39671,All
2023,2,"MOPA, GOA",NAGPUR,4219,4558,"MOPA, GOA-NAGPUR",8777,All
2023,2,"MOPA, GOA",PUNE,4812,4327,"MOPA, GOA-PUNE",9139,All
2015,11,MUMBAI,AGARTALA,0,2,AGARTALA-MUMBAI,2,All
2015,12,MUMBAI,AGARTALA,0,1,AGARTALA-MUMBAI,1,All
2016,2,MUMBAI,AGARTALA,14,0,AGARTALA-MUMBAI,14,All
2016,3,MUMBAI,AGARTALA,31,88,AGARTALA-MUMBAI,119,All
2016,4,MUMBAI,AGARTALA,230,407,AGARTALA-MUMBAI,637,All
2016,5,MUMBAI,AGARTALA,223,491,AGARTALA-MUMBAI,714,All
2016,6,MUMBAI,AGARTALA,381,657,AGARTALA-MUMBAI,1038,All
2016,7,MUMBAI,AGARTALA,359,488,AGARTALA-MUMBAI,847,All
2016,8,MUMBAI,AGARTALA,418,539,AGARTALA-MUMBAI,957,All
2016,9,MUMBAI,AGARTALA,460,571,AGARTALA-MUMBAI,1031,All
2016,10,MUMBAI,AGARTALA,513,804,AGARTALA-MUMBAI,1317,All
2016,11,MUMBAI,AGARTALA,326,325,AGARTALA-MUMBAI,651,All
2016,12,MUMBAI,AGARTALA,137,181,AGARTALA-MUMBAI,318,All
2017,1,MUMBAI,AGARTALA,137,45,AGARTALA-MUMBAI,182,All
2017,2,MUMBAI,AGARTALA,22,12,AGARTALA-MUMBAI,34,All
2017,3,MUMBAI,AGARTALA,24,50,AGARTALA-MUMBAI,74,All
2017,4,MUMBAI,AGARTALA,20,0,AGARTALA-MUMBAI,20,All
2018,3,MUMBAI,AGARTALA,0,1,AGARTALA-MUMBAI,1,All
2018,4,MUMBAI,AGARTALA,0,1,AGARTALA-MUMBAI,1,All
2018,6,MUMBAI,AGARTALA,178,0,AGARTALA-MUMBAI,178,All
2018,7,MUMBAI,AGARTALA,134,0,AGARTALA-MUMBAI,134,All
2018,8,MUMBAI,AGARTALA,242,0,AGARTALA-MUMBAI,242,All
2018,9,MUMBAI,AGARTALA,308,0,AGARTALA-MUMBAI,308,All
2018,10,MUMBAI,AGARTALA,620,0,AGARTALA-MUMBAI,620,All
2018,11,MUMBAI,AGARTALA,507,0,AGARTALA-MUMBAI,507,All
2018,12,MUMBAI,AGARTALA,614,0,AGARTALA-MUMBAI,614,All
2015,4,MUMBAI,ALLAHABAD,532,104,ALLAHABAD-MUMBAI,636,All
2015,5,MUMBAI,ALLAHABAD,491,204,ALLAHABAD-MUMBAI,695,All
2015,6,MUMBAI,ALLAHABAD,375,254,ALLAHABAD-MUMBAI,629,All
2015,7,MUMBAI,ALLAHABAD,429,140,ALLAHABAD-MUMBAI,569,All
2015,8,MUMBAI,ALLAHABAD,330,144,ALLAHABAD-MUMBAI,474,All
2015,9,MUMBAI,ALLAHABAD,444,173,ALLAHABAD-MUMBAI,617,All
2015,10,MUMBAI,ALLAHABAD,434,129,ALLAHABAD-MUMBAI,563,All
2019,4,MUMBAI,ALLAHABAD,1911,1634,ALLAHABAD-MUMBAI,3545,All
2015,4,MUMBAI,AURANGABAD,7131,7781,AURANGABAD-MUMBAI,14912,All
2015,5,MUMBAI,AURANGABAD,7117,7588,AURANGABAD-MUMBAI,14705,All
2015,6,MUMBAI,AURANGABAD,6393,6345,AURANGABAD-MUMBAI,12738,All
2015,7,MUMBAI,AURANGABAD,6724,7013,AURANGABAD-MUMBAI,13737,All
2015,8,MUMBAI,AURANGABAD,6589,7474,AURANGABAD-MUMBAI,14063,All
2015,9,MUMBAI,AURANGABAD,6412,7128,AURANGABAD-MUMBAI,13540,All
2015,10,MUMBAI,AURANGABAD,4191,9312,AURANGABAD-MUMBAI,13503,All
2015,11,MUMBAI,AURANGABAD,7533,7296,AURANGABAD-MUMBAI,14829,All
2015,12,MUMBAI,AURANGABAD,8094,7844,AURANGABAD-MUMBAI,15938,All
2016,1,MUMBAI,AURANGABAD,7615,7939,AURANGABAD-MUMBAI,15554,All
2016,2,MUMBAI,AURANGABAD,7314,7550,AURANGABAD-MUMBAI,14864,All
2016,3,MUMBAI,AURANGABAD,6928,7229,AURANGABAD-MUMBAI,14157,All
2016,4,MUMBAI,AURANGABAD,6516,7243,AURANGABAD-MUMBAI,13759,All
2016,5,MUMBAI,AURANGABAD,7260,7579,AURANGABAD-MUMBAI,14839,All
2016,6,MUMBAI,AURANGABAD,7478,7660,AURANGABAD-MUMBAI,15138,All
2016,7,MUMBAI,AURANGABAD,8616,8885,AURANGABAD-MUMBAI,17501,All
2016,8,MUMBAI,AURANGABAD,8501,9045,AURANGABAD-MUMBAI,17546,All
2016,9,MUMBAI,AURANGABAD,7948,8864,AURANGABAD-MUMBAI,16812,All
2016,10,MUMBAI,AURANGABAD,8249,7993,AURANGABAD-MUMBAI,16242,All
2016,11,MUMBAI,AURANGABAD,7338,7860,AURANGABAD-MUMBAI,15198,All
2016,12,MUMBAI,AURANGABAD,9136,9357,AURANGABAD-MUMBAI,18493,All
2017,1,MUMBAI,AURANGABAD,8890,9635,AURANGABAD-MUMBAI,18525,All
2017,2,MUMBAI,AURANGABAD,8347,8834,AURANGABAD-MUMBAI,17181,All
2017,3,MUMBAI,AURANGABAD,8114,9031,AURANGABAD-MUMBAI,17145,All
2017,4,MUMBAI,AURANGABAD,7234,8356,AURANGABAD-MUMBAI,15590,All
2017,5,MUMBAI,AURANGABAD,7170,7886,AURANGABAD-MUMBAI,15056,All
2017,6,MUMBAI,AURANGABAD,7234,7523,AURANGABAD-MUMBAI,14757,All
2017,7,MUMBAI,AURANGABAD,8078,9297,AURANGABAD-MUMBAI,17375,All
2017,8,MUMBAI,AURANGABAD,8058,9093,AURANGABAD-MUMBAI,17151,All
2017,9,MUMBAI,AURANGABAD,7299,8491,AURANGABAD-MUMBAI,15790,All
2017,10,MUMBAI,AURANGABAD,7937,8680,AURANGABAD-MUMBAI,16617,All
2017,11,MUMBAI,AURANGABAD,9174,10105,AURANGABAD-MUMBAI,19279,All
2017,12,MUMBAI,AURANGABAD,10048,10821,AURANGABAD-MUMBAI,20869,All
2018,1,MUMBAI,AURANGABAD,9917,11379,AURANGABAD-MUMBAI,21296,All
2018,2,MUMBAI,AURANGABAD,9460,10123,AURANGABAD-MUMBAI,19583,All
2018,3,MUMBAI,AURANGABAD,9551,10445,AURANGABAD-MUMBAI,19996,All
2018,4,MUMBAI,AURANGABAD,7324,8995,AURANGABAD-MUMBAI,16319,All
2018,5,MUMBAI,AURANGABAD,7671,8982,AURANGABAD-MUMBAI,16653,All
2018,6,MUMBAI,AURANGABAD,7486,7827,AURANGABAD-MUMBAI,15313,All
2018,7,MUMBAI,AURANGABAD,7497,8409,AURANGABAD-MUMBAI,15906,All
2018,8,MUMBAI,AURANGABAD,7707,9471,AURANGABAD-MUMBAI,17178,All
2018,9,MUMBAI,AURANGABAD,7981,9549,AURANGABAD-MUMBAI,17530,All
2018,10,MUMBAI,AURANGABAD,8637,9477,AURANGABAD-MUMBAI,18114,All
2018,11,MUMBAI,AURANGABAD,9425,9800,AURANGABAD-MUMBAI,19225,All
2018,12,MUMBAI,AURANGABAD,10402,11138,AURANGABAD-MUMBAI,21540,All
2019,1,MUMBAI,AURANGABAD,9881,11225,AURANGABAD-MUMBAI,21106,All
2019,2,MUMBAI,AURANGABAD,7833,8645,AURANGABAD-MUMBAI,16478,All
2019,3,MUMBAI,AURANGABAD,6035,6733,AURANGABAD-MUMBAI,12768,All
2019,4,MUMBAI,AURANGABAD,3196,3294,AURANGABAD-MUMBAI,6490,All
2024,1,MUMBAI,Ayodhya International Airport ,3236,2890,Ayodhya International Airport -MUMBAI,6126,All
2024,2,MUMBAI,Ayodhya International Airport ,10246,10395,Ayodhya International Airport -MUMBAI,20641,All
2024,3,MUMBAI,Ayodhya International Airport ,10472,10512,Ayodhya International Airport -MUMBAI,20984,All
2024,4,MUMBAI,Ayodhya International Airport ,10955,9648,Ayodhya International Airport -MUMBAI,20603,All
2024,6,MUMBAI,Ayodhya International Airport ,12480,13229,Ayodhya International Airport -MUMBAI,25709,All
2024,7,MUMBAI,Ayodhya International Airport ,10294,10554,Ayodhya International Airport -MUMBAI,20848,All
2024,8,MUMBAI,Ayodhya International Airport ,6133,7007,Ayodhya International Airport -MUMBAI,13140,All
2024,9,MUMBAI,Ayodhya International Airport ,9666,9652,Ayodhya International Airport -MUMBAI,19318,All
2024,10,MUMBAI,Ayodhya International Airport ,9890,7433,Ayodhya International Airport -MUMBAI,17323,All
2024,11,MUMBAI,Ayodhya International Airport ,7991,7922,Ayodhya International Airport -MUMBAI,15913,All
2024,12,MUMBAI,Ayodhya International Airport ,8848,10264,Ayodhya International Airport -MUMBAI,19112,All
2025,1,MUMBAI,Ayodhya International Airport ,13690,13567,Ayodhya International Airport -MUMBAI,27257,All
2025,2,MUMBAI,Ayodhya International Airport ,14655,14284,Ayodhya International Airport -MUMBAI,28939,All
2025,3,MUMBAI,Ayodhya International Airport ,15513,14831,Ayodhya International Airport -MUMBAI,30344,All
2015,4,MUMBAI,BAGDOGRA,4469,4063,BAGDOGRA-MUMBAI,8532,All
2015,5,MUMBAI,BAGDOGRA,6038,5805,BAGDOGRA-MUMBAI,11843,All
2015,6,MUMBAI,BAGDOGRA,3141,4260,BAGDOGRA-MUMBAI,7401,All
2015,7,MUMBAI,BAGDOGRA,2039,1700,BAGDOGRA-MUMBAI,3739,All
2015,8,MUMBAI,BAGDOGRA,2383,1931,BAGDOGRA-MUMBAI,4314,All
2015,9,MUMBAI,BAGDOGRA,3176,1978,BAGDOGRA-MUMBAI,5154,All
2015,10,MUMBAI,BAGDOGRA,2912,1756,BAGDOGRA-MUMBAI,4668,All
2015,11,MUMBAI,BAGDOGRA,3025,2914,BAGDOGRA-MUMBAI,5939,All
2015,12,MUMBAI,BAGDOGRA,1712,2028,BAGDOGRA-MUMBAI,3740,All
2016,1,MUMBAI,BAGDOGRA,1037,1281,BAGDOGRA-MUMBAI,2318,All
2016,2,MUMBAI,BAGDOGRA,1196,1009,BAGDOGRA-MUMBAI,2205,All
2016,3,MUMBAI,BAGDOGRA,2160,1715,BAGDOGRA-MUMBAI,3875,All
2016,4,MUMBAI,BAGDOGRA,2163,1547,BAGDOGRA-MUMBAI,3710,All
2016,5,MUMBAI,BAGDOGRA,3465,2664,BAGDOGRA-MUMBAI,6129,All
2016,6,MUMBAI,BAGDOGRA,2019,2229,BAGDOGRA-MUMBAI,4248,All
2016,7,MUMBAI,BAGDOGRA,752,558,BAGDOGRA-MUMBAI,1310,All
2016,8,MUMBAI,BAGDOGRA,642,481,BAGDOGRA-MUMBAI,1123,All
2016,9,MUMBAI,BAGDOGRA,997,680,BAGDOGRA-MUMBAI,1677,All
2016,10,MUMBAI,BAGDOGRA,1596,817,BAGDOGRA-MUMBAI,2413,All
2016,11,MUMBAI,BAGDOGRA,2289,2257,BAGDOGRA-MUMBAI,4546,All
2016,12,MUMBAI,BAGDOGRA,2425,2552,BAGDOGRA-MUMBAI,4977,All
2017,1,MUMBAI,BAGDOGRA,1851,2282,BAGDOGRA-MUMBAI,4133,All
2017,2,MUMBAI,BAGDOGRA,2269,1986,BAGDOGRA-MUMBAI,4255,All
2017,3,MUMBAI,BAGDOGRA,3298,3005,BAGDOGRA-MUMBAI,6303,All
2017,4,MUMBAI,BAGDOGRA,7843,6430,BAGDOGRA-MUMBAI,14273,All
2017,5,MUMBAI,BAGDOGRA,9713,8989,BAGDOGRA-MUMBAI,18702,All
2017,6,MUMBAI,BAGDOGRA,6642,7452,BAGDOGRA-MUMBAI,14094,All
2017,7,MUMBAI,BAGDOGRA,1635,1834,BAGDOGRA-MUMBAI,3469,All
2017,8,MUMBAI,BAGDOGRA,1329,1040,BAGDOGRA-MUMBAI,2369,All
2017,9,MUMBAI,BAGDOGRA,1960,1393,BAGDOGRA-MUMBAI,3353,All
2017,10,MUMBAI,BAGDOGRA,3785,2904,BAGDOGRA-MUMBAI,6689,All
2017,11,MUMBAI,BAGDOGRA,4635,4635,BAGDOGRA-MUMBAI,9270,All
2017,12,MUMBAI,BAGDOGRA,4980,4549,BAGDOGRA-MUMBAI,9529,All
2018,1,MUMBAI,BAGDOGRA,4453,4414,BAGDOGRA-MUMBAI,8867,All
2018,2,MUMBAI,BAGDOGRA,4657,4091,BAGDOGRA-MUMBAI,8748,All
2018,3,MUMBAI,BAGDOGRA,5605,5731,BAGDOGRA-MUMBAI,11336,All
2018,4,MUMBAI,BAGDOGRA,10512,8956,BAGDOGRA-MUMBAI,19468,All
2018,5,MUMBAI,BAGDOGRA,13509,13438,BAGDOGRA-MUMBAI,26947,All
2018,6,MUMBAI,BAGDOGRA,10475,11997,BAGDOGRA-MUMBAI,22472,All
2018,7,MUMBAI,BAGDOGRA,4672,5605,BAGDOGRA-MUMBAI,10277,All
2018,8,MUMBAI,BAGDOGRA,5801,4403,BAGDOGRA-MUMBAI,10204,All
2018,9,MUMBAI,BAGDOGRA,7467,6671,BAGDOGRA-MUMBAI,14138,All
2018,10,MUMBAI,BAGDOGRA,11807,10296,BAGDOGRA-MUMBAI,22103,All
2018,11,MUMBAI,BAGDOGRA,11976,11612,BAGDOGRA-MUMBAI,23588,All
2018,12,MUMBAI,BAGDOGRA,11136,11303,BAGDOGRA-MUMBAI,22439,All
2019,1,MUMBAI,BAGDOGRA,10094,9958,BAGDOGRA-MUMBAI,20052,All
2019,2,MUMBAI,BAGDOGRA,7151,6385,BAGDOGRA-MUMBAI,13536,All
2019,3,MUMBAI,BAGDOGRA,6874,6612,BAGDOGRA-MUMBAI,13486,All
2019,4,MUMBAI,BAGDOGRA,6573,7012,BAGDOGRA-MUMBAI,13585,All
2015,4,MUMBAI,BELGAUM,1988,1962,BELGAUM-MUMBAI,3950,All
2015,5,MUMBAI,BELGAUM,2102,2104,BELGAUM-MUMBAI,4206,All
2015,6,MUMBAI,BELGAUM,1990,1898,BELGAUM-MUMBAI,3888,All
2015,7,MUMBAI,BELGAUM,2281,2186,BELGAUM-MUMBAI,4467,All
2015,8,MUMBAI,BELGAUM,2193,2280,BELGAUM-MUMBAI,4473,All
2015,9,MUMBAI,BELGAUM,2209,2051,BELGAUM-MUMBAI,4260,All
2015,10,MUMBAI,BELGAUM,2224,2198,BELGAUM-MUMBAI,4422,All
2015,11,MUMBAI,BELGAUM,1966,1992,BELGAUM-MUMBAI,3958,All
2015,12,MUMBAI,BELGAUM,2229,2208,BELGAUM-MUMBAI,4437,All
2016,1,MUMBAI,BELGAUM,2197,2235,BELGAUM-MUMBAI,4432,All
2016,2,MUMBAI,BELGAUM,2083,2009,BELGAUM-MUMBAI,4092,All
2016,3,MUMBAI,BELGAUM,2134,2129,BELGAUM-MUMBAI,4263,All
2016,4,MUMBAI,BELGAUM,2041,2104,BELGAUM-MUMBAI,4145,All
2016,5,MUMBAI,BELGAUM,2219,2201,BELGAUM-MUMBAI,4420,All
2016,6,MUMBAI,BELGAUM,2056,2078,BELGAUM-MUMBAI,4134,All
2016,7,MUMBAI,BELGAUM,2123,2136,BELGAUM-MUMBAI,4259,All
2016,8,MUMBAI,BELGAUM,2217,2227,BELGAUM-MUMBAI,4444,All
2016,9,MUMBAI,BELGAUM,2211,2211,BELGAUM-MUMBAI,4422,All
2016,10,MUMBAI,BELGAUM,2254,1989,BELGAUM-MUMBAI,4243,All
2016,11,MUMBAI,BELGAUM,1414,1526,BELGAUM-MUMBAI,2940,All
2016,12,MUMBAI,BELGAUM,2185,2205,BELGAUM-MUMBAI,4390,All
2017,1,MUMBAI,BELGAUM,2188,2211,BELGAUM-MUMBAI,4399,All
2017,2,MUMBAI,BELGAUM,2070,2042,BELGAUM-MUMBAI,4112,All
2017,3,MUMBAI,BELGAUM,2017,2086,BELGAUM-MUMBAI,4103,All
2017,4,MUMBAI,BELGAUM,2073,1932,BELGAUM-MUMBAI,4005,All
2017,5,MUMBAI,BELGAUM,2168,2064,BELGAUM-MUMBAI,4232,All
2017,6,MUMBAI,BELGAUM,1988,1927,BELGAUM-MUMBAI,3915,All
2017,7,MUMBAI,BELGAUM,2085,2099,BELGAUM-MUMBAI,4184,All
2017,8,MUMBAI,BELGAUM,2218,2162,BELGAUM-MUMBAI,4380,All
2017,9,MUMBAI,BELGAUM,1948,2047,BELGAUM-MUMBAI,3995,All
2017,10,MUMBAI,BELGAUM,2101,2087,BELGAUM-MUMBAI,4188,All
2017,11,MUMBAI,BELGAUM,2134,2113,BELGAUM-MUMBAI,4247,All
2017,12,MUMBAI,BELGAUM,2084,2030,BELGAUM-MUMBAI,4114,All
2018,1,MUMBAI,BELGAUM,1955,2092,BELGAUM-MUMBAI,4047,All
2018,2,MUMBAI,BELGAUM,1919,1959,BELGAUM-MUMBAI,3878,All
2018,3,MUMBAI,BELGAUM,2037,2101,BELGAUM-MUMBAI,4138,All
2018,4,MUMBAI,BELGAUM,1906,1912,BELGAUM-MUMBAI,3818,All
2018,5,MUMBAI,BELGAUM,898,854,BELGAUM-MUMBAI,1752,All
2015,4,MUMBAI,CHANDIGARH,29510,27816,CHANDIGARH-MUMBAI,57326,All
2015,5,MUMBAI,CHANDIGARH,34040,33638,CHANDIGARH-MUMBAI,67678,All
2015,6,MUMBAI,CHANDIGARH,26055,29971,CHANDIGARH-MUMBAI,56026,All
2015,7,MUMBAI,CHANDIGARH,24720,23408,CHANDIGARH-MUMBAI,48128,All
2015,8,MUMBAI,CHANDIGARH,24261,24483,CHANDIGARH-MUMBAI,48744,All
2015,9,MUMBAI,CHANDIGARH,28112,27267,CHANDIGARH-MUMBAI,55379,All
2015,10,MUMBAI,CHANDIGARH,28278,34410,CHANDIGARH-MUMBAI,62688,All
2015,11,MUMBAI,CHANDIGARH,28156,27089,CHANDIGARH-MUMBAI,55245,All
2015,12,MUMBAI,CHANDIGARH,27030,28586,CHANDIGARH-MUMBAI,55616,All
2016,1,MUMBAI,CHANDIGARH,23552,23935,CHANDIGARH-MUMBAI,47487,All
2016,2,MUMBAI,CHANDIGARH,27202,26227,CHANDIGARH-MUMBAI,53429,All
2016,3,MUMBAI,CHANDIGARH,30052,28670,CHANDIGARH-MUMBAI,58722,All
2016,4,MUMBAI,CHANDIGARH,26151,25291,CHANDIGARH-MUMBAI,51442,All
2016,5,MUMBAI,CHANDIGARH,30408,28766,CHANDIGARH-MUMBAI,59174,All
2016,6,MUMBAI,CHANDIGARH,27023,28748,CHANDIGARH-MUMBAI,55771,All
2016,7,MUMBAI,CHANDIGARH,28180,28310,CHANDIGARH-MUMBAI,56490,All
2016,8,MUMBAI,CHANDIGARH,28556,28343,CHANDIGARH-MUMBAI,56899,All
2016,9,MUMBAI,CHANDIGARH,28468,27730,CHANDIGARH-MUMBAI,56198,All
2016,10,MUMBAI,CHANDIGARH,30984,25285,CHANDIGARH-MUMBAI,56269,All
2016,11,MUMBAI,CHANDIGARH,26686,28324,CHANDIGARH-MUMBAI,55010,All
2016,12,MUMBAI,CHANDIGARH,24287,25531,CHANDIGARH-MUMBAI,49818,All
2017,1,MUMBAI,CHANDIGARH,24094,24057,CHANDIGARH-MUMBAI,48151,All
2017,2,MUMBAI,CHANDIGARH,29827,28183,CHANDIGARH-MUMBAI,58010,All
2017,3,MUMBAI,CHANDIGARH,32342,32152,CHANDIGARH-MUMBAI,64494,All
2017,4,MUMBAI,CHANDIGARH,33033,28921,CHANDIGARH-MUMBAI,61954,All
2017,5,MUMBAI,CHANDIGARH,35252,34684,CHANDIGARH-MUMBAI,69936,All
2017,6,MUMBAI,CHANDIGARH,31536,32155,CHANDIGARH-MUMBAI,63691,All
2017,7,MUMBAI,CHANDIGARH,26919,25851,CHANDIGARH-MUMBAI,52770,All
2017,8,MUMBAI,CHANDIGARH,25184,24605,CHANDIGARH-MUMBAI,49789,All
2017,9,MUMBAI,CHANDIGARH,27900,24725,CHANDIGARH-MUMBAI,52625,All
2017,10,MUMBAI,CHANDIGARH,21843,20229,CHANDIGARH-MUMBAI,42072,All
2017,11,MUMBAI,CHANDIGARH,21872,22591,CHANDIGARH-MUMBAI,44463,All
2017,12,MUMBAI,CHANDIGARH,19091,18792,CHANDIGARH-MUMBAI,37883,All
2018,1,MUMBAI,CHANDIGARH,19873,19714,CHANDIGARH-MUMBAI,39587,All
2018,2,MUMBAI,CHANDIGARH,8543,8142,CHANDIGARH-MUMBAI,16685,All
2018,3,MUMBAI,CHANDIGARH,24463,24126,CHANDIGARH-MUMBAI,48589,All
2018,4,MUMBAI,CHANDIGARH,24365,22274,CHANDIGARH-MUMBAI,46639,All
2018,5,MUMBAI,CHANDIGARH,8782,7882,CHANDIGARH-MUMBAI,16664,All
2018,6,MUMBAI,CHANDIGARH,19727,20182,CHANDIGARH-MUMBAI,39909,All
2018,7,MUMBAI,CHANDIGARH,23253,21587,CHANDIGARH-MUMBAI,44840,All
2018,8,MUMBAI,CHANDIGARH,23620,21753,CHANDIGARH-MUMBAI,45373,All
2018,9,MUMBAI,CHANDIGARH,24207,23169,CHANDIGARH-MUMBAI,47376,All
2018,10,MUMBAI,CHANDIGARH,25316,22685,CHANDIGARH-MUMBAI,48001,All
2018,11,MUMBAI,CHANDIGARH,24580,23708,CHANDIGARH-MUMBAI,48288,All
2018,12,MUMBAI,CHANDIGARH,25182,25131,CHANDIGARH-MUMBAI,50313,All
2019,1,MUMBAI,CHANDIGARH,25744,24468,CHANDIGARH-MUMBAI,50212,All
2019,2,MUMBAI,CHANDIGARH,20866,20821,CHANDIGARH-MUMBAI,41687,All
2019,3,MUMBAI,CHANDIGARH,21334,21366,CHANDIGARH-MUMBAI,42700,All
2019,4,MUMBAI,CHANDIGARH,22207,20655,CHANDIGARH-MUMBAI,42862,All
2023,1,MUMBAI,CHANDIGARH,34372,33384,CHANDIGARH-MUMBAI,67756,All
2023,2,MUMBAI,CHANDIGARH,33579,31600,CHANDIGARH-MUMBAI,65179,All
2023,3,MUMBAI,CHANDIGARH,36744,35813,CHANDIGARH-MUMBAI,72557,All
2023,4,MUMBAI,CHANDIGARH,39781,36525,CHANDIGARH-MUMBAI,76306,All
2023,5,MUMBAI,CHANDIGARH,36443,36661,CHANDIGARH-MUMBAI,73104,All
2023,6,MUMBAI,CHANDIGARH,34727,35578,CHANDIGARH-MUMBAI,70305,All
2023,7,MUMBAI,CHANDIGARH,26412,25529,CHANDIGARH-MUMBAI,51941,All
2023,8,MUMBAI,CHANDIGARH,30752,26785,CHANDIGARH-MUMBAI,57537,All
2023,9,MUMBAI,CHANDIGARH,37313,34905,CHANDIGARH-MUMBAI,72218,All
2023,10,MUMBAI,CHANDIGARH,37755,32181,CHANDIGARH-MUMBAI,69936,All
2015,4,MUMBAI,CHENNAI,77832,82273,CHENNAI-MUMBAI,160105,All
2015,5,MUMBAI,CHENNAI,86634,81427,CHENNAI-MUMBAI,168061,All
2015,6,MUMBAI,CHENNAI,77840,74824,CHENNAI-MUMBAI,152664,All
2015,7,MUMBAI,CHENNAI,86685,83907,CHENNAI-MUMBAI,170592,All
2015,8,MUMBAI,CHENNAI,85666,89985,CHENNAI-MUMBAI,175651,All
2015,9,MUMBAI,CHENNAI,81500,88600,CHENNAI-MUMBAI,170100,All
2015,10,MUMBAI,CHENNAI,73916,81255,CHENNAI-MUMBAI,155171,All
2015,11,MUMBAI,CHENNAI,81087,83339,CHENNAI-MUMBAI,164426,All
2015,12,MUMBAI,CHENNAI,67738,64387,CHENNAI-MUMBAI,132125,All
2016,1,MUMBAI,CHENNAI,95523,90998,CHENNAI-MUMBAI,186521,All
2016,2,MUMBAI,CHENNAI,89917,90740,CHENNAI-MUMBAI,180657,All
2016,3,MUMBAI,CHENNAI,87787,89902,CHENNAI-MUMBAI,177689,All
2016,4,MUMBAI,CHENNAI,83865,86825,CHENNAI-MUMBAI,170690,All
2016,5,MUMBAI,CHENNAI,96828,89975,CHENNAI-MUMBAI,186803,All
2016,6,MUMBAI,CHENNAI,89318,85413,CHENNAI-MUMBAI,174731,All
2016,7,MUMBAI,CHENNAI,99773,95145,CHENNAI-MUMBAI,194918,All
2016,8,MUMBAI,CHENNAI,94619,99814,CHENNAI-MUMBAI,194433,All
2016,9,MUMBAI,CHENNAI,91710,99265,CHENNAI-MUMBAI,190975,All
2016,10,MUMBAI,CHENNAI,93126,86267,CHENNAI-MUMBAI,179393,All
2016,11,MUMBAI,CHENNAI,82830,90769,CHENNAI-MUMBAI,173599,All
2016,12,MUMBAI,CHENNAI,91923,90058,CHENNAI-MUMBAI,181981,All
2017,1,MUMBAI,CHENNAI,101037,97004,CHENNAI-MUMBAI,198041,All
2017,2,MUMBAI,CHENNAI,88729,90731,CHENNAI-MUMBAI,179460,All
2017,3,MUMBAI,CHENNAI,87704,89692,CHENNAI-MUMBAI,177396,All
2017,4,MUMBAI,CHENNAI,86993,89037,CHENNAI-MUMBAI,176030,All
2017,5,MUMBAI,CHENNAI,101859,91517,CHENNAI-MUMBAI,193376,All
2017,6,MUMBAI,CHENNAI,94015,89788,CHENNAI-MUMBAI,183803,All
2017,7,MUMBAI,CHENNAI,106648,98548,CHENNAI-MUMBAI,205196,All
2017,8,MUMBAI,CHENNAI,101223,104132,CHENNAI-MUMBAI,205355,All
2017,9,MUMBAI,CHENNAI,92575,105233,CHENNAI-MUMBAI,197808,All
2017,10,MUMBAI,CHENNAI,101774,95309,CHENNAI-MUMBAI,197083,All
2017,11,MUMBAI,CHENNAI,99484,105619,CHENNAI-MUMBAI,205103,All
2017,12,MUMBAI,CHENNAI,105846,106060,CHENNAI-MUMBAI,211906,All
2018,1,MUMBAI,CHENNAI,110451,108739,CHENNAI-MUMBAI,219190,All
2018,2,MUMBAI,CHENNAI,100216,99049,CHENNAI-MUMBAI,199265,All
2018,3,MUMBAI,CHENNAI,101230,100383,CHENNAI-MUMBAI,201613,All
2018,4,MUMBAI,CHENNAI,94984,96356,CHENNAI-MUMBAI,191340,All
2018,5,MUMBAI,CHENNAI,101791,93149,CHENNAI-MUMBAI,194940,All
2018,6,MUMBAI,CHENNAI,95536,90740,CHENNAI-MUMBAI,186276,All
2018,7,MUMBAI,CHENNAI,101004,98601,CHENNAI-MUMBAI,199605,All
2018,8,MUMBAI,CHENNAI,99506,101055,CHENNAI-MUMBAI,200561,All
2018,9,MUMBAI,CHENNAI,89979,96756,CHENNAI-MUMBAI,186735,All
2018,10,MUMBAI,CHENNAI,87193,87284,CHENNAI-MUMBAI,174477,All
2018,11,MUMBAI,CHENNAI,88983,88709,CHENNAI-MUMBAI,177692,All
2018,12,MUMBAI,CHENNAI,98332,97720,CHENNAI-MUMBAI,196052,All
2019,1,MUMBAI,CHENNAI,98971,94931,CHENNAI-MUMBAI,193902,All
2019,2,MUMBAI,CHENNAI,85120,84737,CHENNAI-MUMBAI,169857,All
2019,3,MUMBAI,CHENNAI,83905,81454,CHENNAI-MUMBAI,165359,All
2019,4,MUMBAI,CHENNAI,70789,69919,CHENNAI-MUMBAI,140708,All
2023,1,MUMBAI,CHENNAI,109941,107770,CHENNAI-MUMBAI,217711,All
2023,2,MUMBAI,CHENNAI,102400,102169,CHENNAI-MUMBAI,204569,All
2023,3,MUMBAI,CHENNAI,102169,103318,CHENNAI-MUMBAI,205487,All
2023,4,MUMBAI,CHENNAI,97776,98636,CHENNAI-MUMBAI,196412,All
2023,5,MUMBAI,CHENNAI,110986,103841,CHENNAI-MUMBAI,214827,All
2023,6,MUMBAI,CHENNAI,98064,95050,CHENNAI-MUMBAI,193114,All
2023,7,MUMBAI,CHENNAI,99457,95745,CHENNAI-MUMBAI,195202,All
2023,8,MUMBAI,CHENNAI,105613,108351,CHENNAI-MUMBAI,213964,All
2023,9,MUMBAI,CHENNAI,98837,104940,CHENNAI-MUMBAI,203777,All
2023,10,MUMBAI,CHENNAI,94577,95649,CHENNAI-MUMBAI,190226,All
2015,9,MUMBAI,COCHIN,10738,13119,COCHIN-MUMBAI,23857,All
2015,10,MUMBAI,COCHIN,9252,8489,COCHIN-MUMBAI,17741,All
2015,11,MUMBAI,COCHIN,11612,10892,COCHIN-MUMBAI,22504,All
2015,12,MUMBAI,COCHIN,0,10939,COCHIN-MUMBAI,10939,All
2016,1,MUMBAI,COCHIN,0,12989,COCHIN-MUMBAI,12989,All
2015,4,MUMBAI,COIMBATORE,14684,14893,COIMBATORE-MUMBAI,29577,All
2015,5,MUMBAI,COIMBATORE,15813,15502,COIMBATORE-MUMBAI,31315,All
2015,6,MUMBAI,COIMBATORE,12959,13707,COIMBATORE-MUMBAI,26666,All
2015,7,MUMBAI,COIMBATORE,13811,12973,COIMBATORE-MUMBAI,26784,All
2015,8,MUMBAI,COIMBATORE,14632,14696,COIMBATORE-MUMBAI,29328,All
2015,9,MUMBAI,COIMBATORE,14458,15342,COIMBATORE-MUMBAI,29800,All
2015,10,MUMBAI,COIMBATORE,32026,12780,COIMBATORE-MUMBAI,44806,All
2015,11,MUMBAI,COIMBATORE,15460,15843,COIMBATORE-MUMBAI,31303,All
2015,12,MUMBAI,COIMBATORE,18194,18610,COIMBATORE-MUMBAI,36804,All
2016,1,MUMBAI,COIMBATORE,16840,16750,COIMBATORE-MUMBAI,33590,All
2016,2,MUMBAI,COIMBATORE,15121,15720,COIMBATORE-MUMBAI,30841,All
2016,3,MUMBAI,COIMBATORE,15227,16157,COIMBATORE-MUMBAI,31384,All
2016,4,MUMBAI,COIMBATORE,18051,18276,COIMBATORE-MUMBAI,36327,All
2016,5,MUMBAI,COIMBATORE,23454,21698,COIMBATORE-MUMBAI,45152,All
2016,6,MUMBAI,COIMBATORE,18506,19995,COIMBATORE-MUMBAI,38501,All
2016,7,MUMBAI,COIMBATORE,21904,20009,COIMBATORE-MUMBAI,41913,All
2016,8,MUMBAI,COIMBATORE,19876,21404,COIMBATORE-MUMBAI,41280,All
2016,9,MUMBAI,COIMBATORE,19512,20908,COIMBATORE-MUMBAI,40420,All
2016,10,MUMBAI,COIMBATORE,19730,18007,COIMBATORE-MUMBAI,37737,All
2016,11,MUMBAI,COIMBATORE,16943,19639,COIMBATORE-MUMBAI,36582,All
2016,12,MUMBAI,COIMBATORE,22420,21260,COIMBATORE-MUMBAI,43680,All
2017,1,MUMBAI,COIMBATORE,20929,21737,COIMBATORE-MUMBAI,42666,All
2017,2,MUMBAI,COIMBATORE,17922,18421,COIMBATORE-MUMBAI,36343,All
2017,3,MUMBAI,COIMBATORE,16918,18147,COIMBATORE-MUMBAI,35065,All
2017,4,MUMBAI,COIMBATORE,19237,19028,COIMBATORE-MUMBAI,38265,All
2017,5,MUMBAI,COIMBATORE,22691,21415,COIMBATORE-MUMBAI,44106,All
2017,6,MUMBAI,COIMBATORE,20177,20535,COIMBATORE-MUMBAI,40712,All
2017,7,MUMBAI,COIMBATORE,20991,20301,COIMBATORE-MUMBAI,41292,All
2017,8,MUMBAI,COIMBATORE,20620,20234,COIMBATORE-MUMBAI,40854,All
2017,9,MUMBAI,COIMBATORE,18865,20863,COIMBATORE-MUMBAI,39728,All
2017,10,MUMBAI,COIMBATORE,20540,19189,COIMBATORE-MUMBAI,39729,All
2017,11,MUMBAI,COIMBATORE,18074,20066,COIMBATORE-MUMBAI,38140,All
2017,12,MUMBAI,COIMBATORE,20336,19704,COIMBATORE-MUMBAI,40040,All
2018,1,MUMBAI,COIMBATORE,20291,20154,COIMBATORE-MUMBAI,40445,All
2018,2,MUMBAI,COIMBATORE,20287,19826,COIMBATORE-MUMBAI,40113,All
2018,3,MUMBAI,COIMBATORE,23821,24019,COIMBATORE-MUMBAI,47840,All
2018,4,MUMBAI,COIMBATORE,24120,24780,COIMBATORE-MUMBAI,48900,All
2018,5,MUMBAI,COIMBATORE,27500,25084,COIMBATORE-MUMBAI,52584,All
2018,6,MUMBAI,COIMBATORE,22146,23407,COIMBATORE-MUMBAI,45553,All
2018,7,MUMBAI,COIMBATORE,23950,23209,COIMBATORE-MUMBAI,47159,All
2018,8,MUMBAI,COIMBATORE,24549,25869,COIMBATORE-MUMBAI,50418,All
2018,9,MUMBAI,COIMBATORE,21972,24649,COIMBATORE-MUMBAI,46621,All
2018,10,MUMBAI,COIMBATORE,19991,18810,COIMBATORE-MUMBAI,38801,All
2018,11,MUMBAI,COIMBATORE,19666,20279,COIMBATORE-MUMBAI,39945,All
2018,12,MUMBAI,COIMBATORE,21555,21010,COIMBATORE-MUMBAI,42565,All
2019,1,MUMBAI,COIMBATORE,21012,20934,COIMBATORE-MUMBAI,41946,All
2019,2,MUMBAI,COIMBATORE,17828,18547,COIMBATORE-MUMBAI,36375,All
2019,3,MUMBAI,COIMBATORE,13047,14745,COIMBATORE-MUMBAI,27792,All
2019,4,MUMBAI,COIMBATORE,13932,14212,COIMBATORE-MUMBAI,28144,All
2023,1,MUMBAI,COIMBATORE,14809,14448,COIMBATORE-MUMBAI,29257,All
2023,2,MUMBAI,COIMBATORE,13901,13650,COIMBATORE-MUMBAI,27551,All
2023,3,MUMBAI,COIMBATORE,15239,14314,COIMBATORE-MUMBAI,29553,All
2023,4,MUMBAI,COIMBATORE,15884,15412,COIMBATORE-MUMBAI,31296,All
2023,5,MUMBAI,COIMBATORE,24376,21546,COIMBATORE-MUMBAI,45922,All
2023,6,MUMBAI,COIMBATORE,20342,19109,COIMBATORE-MUMBAI,39451,All
2023,7,MUMBAI,COIMBATORE,20120,18218,COIMBATORE-MUMBAI,38338,All
2023,8,MUMBAI,COIMBATORE,19900,20369,COIMBATORE-MUMBAI,40269,All
2023,9,MUMBAI,COIMBATORE,18479,18702,COIMBATORE-MUMBAI,37181,All
2023,10,MUMBAI,COIMBATORE,19125,18621,COIMBATORE-MUMBAI,37746,All
2019,1,MUMBAI,DABOLIM,106866,108899,DABOLIM-MUMBAI,215765,All
2019,2,MUMBAI,DABOLIM,82728,87039,DABOLIM-MUMBAI,169767,All
2019,3,MUMBAI,DABOLIM,79078,87941,DABOLIM-MUMBAI,167019,All
2019,4,MUMBAI,DABOLIM,83337,80384,DABOLIM-MUMBAI,163721,All
2023,1,MUMBAI,DABOLIM,118240,124604,DABOLIM-MUMBAI,242844,All
2023,2,MUMBAI,DABOLIM,107836,109797,DABOLIM-MUMBAI,217633,All
2023,3,MUMBAI,DABOLIM,111189,114636,DABOLIM-MUMBAI,225825,All
2023,4,MUMBAI,DABOLIM,101240,100695,DABOLIM-MUMBAI,201935,All
2023,5,MUMBAI,DABOLIM,82847,82859,DABOLIM-MUMBAI,165706,All
2023,6,MUMBAI,DABOLIM,59695,61715,DABOLIM-MUMBAI,121410,All
2023,7,MUMBAI,DABOLIM,57676,59756,DABOLIM-MUMBAI,117432,All
2023,8,MUMBAI,DABOLIM,64237,64106,DABOLIM-MUMBAI,128343,All
2023,9,MUMBAI,DABOLIM,62159,59005,DABOLIM-MUMBAI,121164,All
2023,10,MUMBAI,DABOLIM,57258,59662,DABOLIM-MUMBAI,116920,All
2020,11,MUMBAI,DARBHANGA,4097,3875,DARBHANGA-MUMBAI,7972,All
2020,12,MUMBAI,DARBHANGA,3973,4625,DARBHANGA-MUMBAI,8598,All
2021,1,MUMBAI,DARBHANGA,2234,2896,DARBHANGA-MUMBAI,5130,All
2021,2,MUMBAI,DARBHANGA,4690,4598,DARBHANGA-MUMBAI,9288,All
2023,1,MUMBAI,DARBHANGA,4968,4703,DARBHANGA-MUMBAI,9671,All
2023,2,MUMBAI,DARBHANGA,5069,4762,DARBHANGA-MUMBAI,9831,All
2023,3,MUMBAI,DARBHANGA,5136,5618,DARBHANGA-MUMBAI,10754,All
2023,4,MUMBAI,DARBHANGA,5397,5350,DARBHANGA-MUMBAI,10747,All
2023,5,MUMBAI,DARBHANGA,5085,5085,DARBHANGA-MUMBAI,10170,All
2023,6,MUMBAI,DARBHANGA,4674,4674,DARBHANGA-MUMBAI,9348,All
2023,7,MUMBAI,DARBHANGA,2063,2241,DARBHANGA-MUMBAI,4304,All
2023,8,MUMBAI,DARBHANGA,3290,3304,DARBHANGA-MUMBAI,6594,All
2023,9,MUMBAI,DARBHANGA,4427,4119,DARBHANGA-MUMBAI,8546,All
2023,10,MUMBAI,DARBHANGA,4882,4052,DARBHANGA-MUMBAI,8934,All
2015,4,MUMBAI,DEHRA DUN,1640,1479,DEHRA DUN-MUMBAI,3119,All
2015,5,MUMBAI,DEHRA DUN,1910,1734,DEHRA DUN-MUMBAI,3644,All
2015,6,MUMBAI,DEHRA DUN,1286,1431,DEHRA DUN-MUMBAI,2717,All
2015,7,MUMBAI,DEHRA DUN,1039,990,DEHRA DUN-MUMBAI,2029,All
2015,8,MUMBAI,DEHRA DUN,904,1039,DEHRA DUN-MUMBAI,1943,All
2015,9,MUMBAI,DEHRA DUN,892,909,DEHRA DUN-MUMBAI,1801,All
2015,10,MUMBAI,DEHRA DUN,995,970,DEHRA DUN-MUMBAI,1965,All
2015,11,MUMBAI,DEHRA DUN,1213,1350,DEHRA DUN-MUMBAI,2563,All
2015,12,MUMBAI,DEHRA DUN,1170,1241,DEHRA DUN-MUMBAI,2411,All
2016,1,MUMBAI,DEHRA DUN,1192,1149,DEHRA DUN-MUMBAI,2341,All
2016,2,MUMBAI,DEHRA DUN,1152,1072,DEHRA DUN-MUMBAI,2224,All
2016,3,MUMBAI,DEHRA DUN,2113,2075,DEHRA DUN-MUMBAI,4188,All
2016,4,MUMBAI,DEHRA DUN,5039,3990,DEHRA DUN-MUMBAI,9029,All
2016,5,MUMBAI,DEHRA DUN,5967,5578,DEHRA DUN-MUMBAI,11545,All
2016,6,MUMBAI,DEHRA DUN,5360,5086,DEHRA DUN-MUMBAI,10446,All
2016,7,MUMBAI,DEHRA DUN,4736,4203,DEHRA DUN-MUMBAI,8939,All
2016,8,MUMBAI,DEHRA DUN,3907,3692,DEHRA DUN-MUMBAI,7599,All
2016,9,MUMBAI,DEHRA DUN,4063,3609,DEHRA DUN-MUMBAI,7672,All
2016,10,MUMBAI,DEHRA DUN,5010,4291,DEHRA DUN-MUMBAI,9301,All
2016,11,MUMBAI,DEHRA DUN,5093,4998,DEHRA DUN-MUMBAI,10091,All
2016,12,MUMBAI,DEHRA DUN,5752,5860,DEHRA DUN-MUMBAI,11612,All
2017,1,MUMBAI,DEHRA DUN,6024,5712,DEHRA DUN-MUMBAI,11736,All
2017,2,MUMBAI,DEHRA DUN,5603,5303,DEHRA DUN-MUMBAI,10906,All
2017,3,MUMBAI,DEHRA DUN,5878,5765,DEHRA DUN-MUMBAI,11643,All
2017,4,MUMBAI,DEHRA DUN,5342,5256,DEHRA DUN-MUMBAI,10598,All
2017,5,MUMBAI,DEHRA DUN,5647,5522,DEHRA DUN-MUMBAI,11169,All
2017,6,MUMBAI,DEHRA DUN,5424,5689,DEHRA DUN-MUMBAI,11113,All
2017,7,MUMBAI,DEHRA DUN,4540,4447,DEHRA DUN-MUMBAI,8987,All
2017,8,MUMBAI,DEHRA DUN,4456,4525,DEHRA DUN-MUMBAI,8981,All
2017,9,MUMBAI,DEHRA DUN,4910,4518,DEHRA DUN-MUMBAI,9428,All
2017,10,MUMBAI,DEHRA DUN,5329,5244,DEHRA DUN-MUMBAI,10573,All
2017,11,MUMBAI,DEHRA DUN,5414,5426,DEHRA DUN-MUMBAI,10840,All
2017,12,MUMBAI,DEHRA DUN,5644,5523,DEHRA DUN-MUMBAI,11167,All
2018,1,MUMBAI,DEHRA DUN,5078,5747,DEHRA DUN-MUMBAI,10825,All
2018,2,MUMBAI,DEHRA DUN,7424,7420,DEHRA DUN-MUMBAI,14844,All
2018,3,MUMBAI,DEHRA DUN,5232,6101,DEHRA DUN-MUMBAI,11333,All
2018,4,MUMBAI,DEHRA DUN,5317,5059,DEHRA DUN-MUMBAI,10376,All
2018,5,MUMBAI,DEHRA DUN,7672,8321,DEHRA DUN-MUMBAI,15993,All
2018,6,MUMBAI,DEHRA DUN,5112,5718,DEHRA DUN-MUMBAI,10830,All
2018,7,MUMBAI,DEHRA DUN,5216,4892,DEHRA DUN-MUMBAI,10108,All
2018,8,MUMBAI,DEHRA DUN,4637,4568,DEHRA DUN-MUMBAI,9205,All
2018,9,MUMBAI,DEHRA DUN,6186,5804,DEHRA DUN-MUMBAI,11990,All
2018,10,MUMBAI,DEHRA DUN,7687,7282,DEHRA DUN-MUMBAI,14969,All
2018,11,MUMBAI,DEHRA DUN,8396,9050,DEHRA DUN-MUMBAI,17446,All
2018,12,MUMBAI,DEHRA DUN,6534,6515,DEHRA DUN-MUMBAI,13049,All
2019,1,MUMBAI,DEHRA DUN,4820,6005,DEHRA DUN-MUMBAI,10825,All
2019,2,MUMBAI,DEHRA DUN,6196,6732,DEHRA DUN-MUMBAI,12928,All
2019,3,MUMBAI,DEHRA DUN,6246,7114,DEHRA DUN-MUMBAI,13360,All
2019,4,MUMBAI,DEHRA DUN,5385,6098,DEHRA DUN-MUMBAI,11483,All
2023,2,MUMBAI,DEHRA DUN,13789,12683,DEHRA DUN-MUMBAI,26472,All
2023,3,MUMBAI,DEHRA DUN,14869,14734,DEHRA DUN-MUMBAI,29603,All
2023,4,MUMBAI,DEHRA DUN,14661,14093,DEHRA DUN-MUMBAI,28754,All
2023,5,MUMBAI,DEHRA DUN,16643,17240,DEHRA DUN-MUMBAI,33883,All
2015,4,MUMBAI,DELHI,255579,231679,DELHI-MUMBAI,487258,All
2015,5,MUMBAI,DELHI,264917,270727,DELHI-MUMBAI,535644,All
2015,6,MUMBAI,DELHI,214142,248419,DELHI-MUMBAI,462561,All
2015,7,MUMBAI,DELHI,235638,234464,DELHI-MUMBAI,470102,All
2015,8,MUMBAI,DELHI,235092,236913,DELHI-MUMBAI,472005,All
2015,9,MUMBAI,DELHI,237101,233553,DELHI-MUMBAI,470654,All
2015,10,MUMBAI,DELHI,202977,192797,DELHI-MUMBAI,395774,All
2015,11,MUMBAI,DELHI,271141,262826,DELHI-MUMBAI,533967,All
2015,12,MUMBAI,DELHI,268100,304904,DELHI-MUMBAI,573004,All
2016,1,MUMBAI,DELHI,276940,260425,DELHI-MUMBAI,537365,All
2016,2,MUMBAI,DELHI,270826,268047,DELHI-MUMBAI,538873,All
2016,3,MUMBAI,DELHI,280107,281229,DELHI-MUMBAI,561336,All
2016,4,MUMBAI,DELHI,281929,257481,DELHI-MUMBAI,539410,All
2016,5,MUMBAI,DELHI,284930,298834,DELHI-MUMBAI,583764,All
2016,6,MUMBAI,DELHI,233621,270782,DELHI-MUMBAI,504403,All
2016,7,MUMBAI,DELHI,272758,274486,DELHI-MUMBAI,547244,All
2016,8,MUMBAI,DELHI,269910,275326,DELHI-MUMBAI,545236,All
2016,9,MUMBAI,DELHI,272434,272187,DELHI-MUMBAI,544621,All
2016,10,MUMBAI,DELHI,288071,249092,DELHI-MUMBAI,537163,All
2016,11,MUMBAI,DELHI,270215,305551,DELHI-MUMBAI,575766,All
2016,12,MUMBAI,DELHI,289716,324571,DELHI-MUMBAI,614287,All
2017,1,MUMBAI,DELHI,308473,299965,DELHI-MUMBAI,608438,All
2017,2,MUMBAI,DELHI,279899,273722,DELHI-MUMBAI,553621,All
2017,3,MUMBAI,DELHI,287242,292065,DELHI-MUMBAI,579307,All
2017,4,MUMBAI,DELHI,295682,263738,DELHI-MUMBAI,559420,All
2017,5,MUMBAI,DELHI,309060,325674,DELHI-MUMBAI,634734,All
2017,6,MUMBAI,DELHI,265967,291750,DELHI-MUMBAI,557717,All
2017,7,MUMBAI,DELHI,273521,276127,DELHI-MUMBAI,549648,All
2017,8,MUMBAI,DELHI,282696,280469,DELHI-MUMBAI,563165,All
2017,9,MUMBAI,DELHI,271363,268473,DELHI-MUMBAI,539836,All
2017,10,MUMBAI,DELHI,302225,284048,DELHI-MUMBAI,586273,All
2017,11,MUMBAI,DELHI,300516,301837,DELHI-MUMBAI,602353,All
2017,12,MUMBAI,DELHI,303190,325800,DELHI-MUMBAI,628990,All
2018,1,MUMBAI,DELHI,320155,313283,DELHI-MUMBAI,633438,All
2018,2,MUMBAI,DELHI,305382,299904,DELHI-MUMBAI,605286,All
2018,3,MUMBAI,DELHI,325175,332520,DELHI-MUMBAI,657695,All
2018,4,MUMBAI,DELHI,323263,294304,DELHI-MUMBAI,617567,All
2018,5,MUMBAI,DELHI,308711,328088,DELHI-MUMBAI,636799,All
2018,6,MUMBAI,DELHI,280798,297612,DELHI-MUMBAI,578410,All
2018,7,MUMBAI,DELHI,296867,300401,DELHI-MUMBAI,597268,All
2018,8,MUMBAI,DELHI,308538,303035,DELHI-MUMBAI,611573,All
2018,9,MUMBAI,DELHI,294090,295823,DELHI-MUMBAI,589913,All
2018,10,MUMBAI,DELHI,293009,271469,DELHI-MUMBAI,564478,All
2018,11,MUMBAI,DELHI,279056,274394,DELHI-MUMBAI,553450,All
2018,12,MUMBAI,DELHI,288433,311187,DELHI-MUMBAI,599620,All
2019,1,MUMBAI,DELHI,299458,286152,DELHI-MUMBAI,585610,All
2019,2,MUMBAI,DELHI,274592,266533,DELHI-MUMBAI,541125,All
2019,3,MUMBAI,DELHI,287058,286156,DELHI-MUMBAI,573214,All
2019,4,MUMBAI,DELHI,273951,249828,DELHI-MUMBAI,523779,All
2023,1,MUMBAI,DELHI,249392,245843,DELHI-MUMBAI,495235,All
2023,2,MUMBAI,DELHI,264525,256563,DELHI-MUMBAI,521088,All
2023,3,MUMBAI,DELHI,260603,272879,DELHI-MUMBAI,533482,All
2023,4,MUMBAI,DELHI,279827,265591,DELHI-MUMBAI,545418,All
2023,5,MUMBAI,DELHI,274757,277243,DELHI-MUMBAI,552000,All
2023,6,MUMBAI,DELHI,243112,264260,DELHI-MUMBAI,507372,All
2023,7,MUMBAI,DELHI,225877,234722,DELHI-MUMBAI,460599,All
2023,8,MUMBAI,DELHI,253806,255324,DELHI-MUMBAI,509130,All
2023,9,MUMBAI,DELHI,250465,254808,DELHI-MUMBAI,505273,All
2023,10,MUMBAI,DELHI,275931,260769,DELHI-MUMBAI,536700,All
2023,1,MUMBAI,DIBRUGARH,146,217,DIBRUGARH-MUMBAI,363,All
2023,2,MUMBAI,DIBRUGARH,164,188,DIBRUGARH-MUMBAI,352,All
2023,3,MUMBAI,DIBRUGARH,161,155,DIBRUGARH-MUMBAI,316,All
2023,1,MUMBAI,DIMAPUR,306,205,DIMAPUR-MUMBAI,511,All
2023,2,MUMBAI,DIMAPUR,124,121,DIMAPUR-MUMBAI,245,All
2023,3,MUMBAI,DIMAPUR,58,107,DIMAPUR-MUMBAI,165,All
2015,4,MUMBAI,DIU,1077,955,DIU-MUMBAI,2032,All
2015,5,MUMBAI,DIU,1177,1025,DIU-MUMBAI,2202,All
2015,6,MUMBAI,DIU,616,621,DIU-MUMBAI,1237,All
2015,7,MUMBAI,DIU,846,512,DIU-MUMBAI,1358,All
2015,8,MUMBAI,DIU,956,1049,DIU-MUMBAI,2005,All
2015,9,MUMBAI,DIU,816,831,DIU-MUMBAI,1647,All
2015,10,MUMBAI,DIU,1104,1012,DIU-MUMBAI,2116,All
2015,11,MUMBAI,DIU,1443,1174,DIU-MUMBAI,2617,All
2015,12,MUMBAI,DIU,1922,1748,DIU-MUMBAI,3670,All
2016,1,MUMBAI,DIU,1534,1504,DIU-MUMBAI,3038,All
2016,2,MUMBAI,DIU,1654,1578,DIU-MUMBAI,3232,All
2016,3,MUMBAI,DIU,1467,1250,DIU-MUMBAI,2717,All
2016,4,MUMBAI,DIU,780,838,DIU-MUMBAI,1618,All
2016,5,MUMBAI,DIU,793,841,DIU-MUMBAI,1634,All
2016,6,MUMBAI,DIU,608,678,DIU-MUMBAI,1286,All
2016,7,MUMBAI,DIU,568,549,DIU-MUMBAI,1117,All
2016,8,MUMBAI,DIU,538,612,DIU-MUMBAI,1150,All
2016,9,MUMBAI,DIU,617,534,DIU-MUMBAI,1151,All
2016,10,MUMBAI,DIU,679,618,DIU-MUMBAI,1297,All
2016,11,MUMBAI,DIU,463,479,DIU-MUMBAI,942,All
2016,12,MUMBAI,DIU,1010,947,DIU-MUMBAI,1957,All
2017,1,MUMBAI,DIU,931,901,DIU-MUMBAI,1832,All
2017,2,MUMBAI,DIU,850,882,DIU-MUMBAI,1732,All
2017,3,MUMBAI,DIU,760,670,DIU-MUMBAI,1430,All
2017,4,MUMBAI,DIU,744,718,DIU-MUMBAI,1462,All
2017,5,MUMBAI,DIU,831,795,DIU-MUMBAI,1626,All
2017,6,MUMBAI,DIU,692,617,DIU-MUMBAI,1309,All
2017,7,MUMBAI,DIU,618,527,DIU-MUMBAI,1145,All
2017,8,MUMBAI,DIU,711,731,DIU-MUMBAI,1442,All
2017,9,MUMBAI,DIU,705,545,DIU-MUMBAI,1250,All
2017,10,MUMBAI,DIU,950,896,DIU-MUMBAI,1846,All
2017,11,MUMBAI,DIU,929,854,DIU-MUMBAI,1783,All
2017,12,MUMBAI,DIU,972,942,DIU-MUMBAI,1914,All
2018,1,MUMBAI,DIU,957,911,DIU-MUMBAI,1868,All
2018,2,MUMBAI,DIU,937,710,DIU-MUMBAI,1647,All
2018,3,MUMBAI,DIU,873,775,DIU-MUMBAI,1648,All
2018,4,MUMBAI,DIU,807,721,DIU-MUMBAI,1528,All
2018,5,MUMBAI,DIU,944,901,DIU-MUMBAI,1845,All
2018,6,MUMBAI,DIU,848,633,DIU-MUMBAI,1481,All
2018,7,MUMBAI,DIU,777,477,DIU-MUMBAI,1254,All
2018,8,MUMBAI,DIU,778,836,DIU-MUMBAI,1614,All
2018,9,MUMBAI,DIU,838,790,DIU-MUMBAI,1628,All
2018,10,MUMBAI,DIU,777,740,DIU-MUMBAI,1517,All
2018,11,MUMBAI,DIU,897,866,DIU-MUMBAI,1763,All
2018,12,MUMBAI,DIU,1044,952,DIU-MUMBAI,1996,All
2019,1,MUMBAI,DIU,841,695,DIU-MUMBAI,1536,All
2019,2,MUMBAI,DIU,598,568,DIU-MUMBAI,1166,All
2019,3,MUMBAI,DIU,668,674,DIU-MUMBAI,1342,All
2019,4,MUMBAI,DIU,805,738,DIU-MUMBAI,1543,All
2023,1,MUMBAI,DIU,1763,1844,DIU-MUMBAI,3607,All
2023,2,MUMBAI,DIU,1625,1735,DIU-MUMBAI,3360,All
2023,3,MUMBAI,DIU,1606,1707,DIU-MUMBAI,3313,All
2023,4,MUMBAI,DIU,1422,1400,DIU-MUMBAI,2822,All
2023,5,MUMBAI,DIU,1718,1747,DIU-MUMBAI,3465,All
2023,6,MUMBAI,DIU,842,862,DIU-MUMBAI,1704,All
2023,7,MUMBAI,DIU,474,500,DIU-MUMBAI,974,All
2023,8,MUMBAI,DIU,1204,1234,DIU-MUMBAI,2438,All
2023,9,MUMBAI,DIU,1202,1147,DIU-MUMBAI,2349,All
2023,10,MUMBAI,DIU,1580,1696,DIU-MUMBAI,3276,All
2023,1,MUMBAI,DURGAPUR,4357,4110,DURGAPUR-MUMBAI,8467,All
2023,2,MUMBAI,DURGAPUR,3904,3970,DURGAPUR-MUMBAI,7874,All
2023,3,MUMBAI,DURGAPUR,3775,3693,DURGAPUR-MUMBAI,7468,All
2023,4,MUMBAI,DURGAPUR,5490,4697,DURGAPUR-MUMBAI,10187,All
2023,5,MUMBAI,DURGAPUR,5631,5455,DURGAPUR-MUMBAI,11086,All
2023,6,MUMBAI,DURGAPUR,1817,1687,DURGAPUR-MUMBAI,3504,All
2023,7,MUMBAI,DURGAPUR,7164,9931,DURGAPUR-MUMBAI,17095,All
2023,8,MUMBAI,DURGAPUR,7276,9580,DURGAPUR-MUMBAI,16856,All
2023,9,MUMBAI,DURGAPUR,6843,7220,DURGAPUR-MUMBAI,14063,All
2023,10,MUMBAI,DURGAPUR,9005,6029,DURGAPUR-MUMBAI,15034,All
2023,1,MUMBAI,DehraDun,14219,13626,DehraDun-MUMBAI,27845,All
2023,6,MUMBAI,DehraDun,14493,15007,DehraDun-MUMBAI,29500,All
2023,7,MUMBAI,DehraDun,11751,11827,DehraDun-MUMBAI,23578,All
2023,8,MUMBAI,DehraDun,10881,10251,DehraDun-MUMBAI,21132,All
2023,9,MUMBAI,DehraDun,16815,14875,DehraDun-MUMBAI,31690,All
2023,10,MUMBAI,DehraDun,15990,15176,DehraDun-MUMBAI,31166,All
2023,1,MUMBAI,GAYA,179,200,GAYA-MUMBAI,379,All
2023,2,MUMBAI,GAYA,408,251,GAYA-MUMBAI,659,All
2023,3,MUMBAI,GAYA,422,352,GAYA-MUMBAI,774,All
2015,4,MUMBAI,GOA,78071,81802,GOA-MUMBAI,159873,All
2015,5,MUMBAI,GOA,69865,69169,GOA-MUMBAI,139034,All
2015,6,MUMBAI,GOA,66926,73047,GOA-MUMBAI,139973,All
2015,7,MUMBAI,GOA,86495,86291,GOA-MUMBAI,172786,All
2015,8,MUMBAI,GOA,83982,91595,GOA-MUMBAI,175577,All
2015,9,MUMBAI,GOA,95627,93368,GOA-MUMBAI,188995,All
2015,10,MUMBAI,GOA,78308,78228,GOA-MUMBAI,156536,All
2015,11,MUMBAI,GOA,96078,97325,GOA-MUMBAI,193403,All
2015,12,MUMBAI,GOA,108310,100832,GOA-MUMBAI,209142,All
2016,1,MUMBAI,GOA,102316,110285,GOA-MUMBAI,212601,All
2016,2,MUMBAI,GOA,98353,104093,GOA-MUMBAI,202446,All
2016,3,MUMBAI,GOA,98434,103951,GOA-MUMBAI,202385,All
2016,4,MUMBAI,GOA,95326,100562,GOA-MUMBAI,195888,All
2016,5,MUMBAI,GOA,107951,107596,GOA-MUMBAI,215547,All
2016,6,MUMBAI,GOA,87339,100810,GOA-MUMBAI,188149,All
2016,7,MUMBAI,GOA,105096,105376,GOA-MUMBAI,210472,All
2016,8,MUMBAI,GOA,104686,107069,GOA-MUMBAI,211755,All
2016,9,MUMBAI,GOA,107248,107358,GOA-MUMBAI,214606,All
2016,10,MUMBAI,GOA,95760,92384,GOA-MUMBAI,188144,All
2016,11,MUMBAI,GOA,97855,100956,GOA-MUMBAI,198811,All
2016,12,MUMBAI,GOA,116959,107699,GOA-MUMBAI,224658,All
2017,1,MUMBAI,GOA,112207,119639,GOA-MUMBAI,231846,All
2017,2,MUMBAI,GOA,104468,107835,GOA-MUMBAI,212303,All
2017,3,MUMBAI,GOA,103347,113628,GOA-MUMBAI,216975,All
2017,4,MUMBAI,GOA,97642,99742,GOA-MUMBAI,197384,All
2017,5,MUMBAI,GOA,105807,108349,GOA-MUMBAI,214156,All
2017,6,MUMBAI,GOA,90787,101495,GOA-MUMBAI,192282,All
2017,7,MUMBAI,GOA,95128,99179,GOA-MUMBAI,194307,All
2017,8,MUMBAI,GOA,101873,99806,GOA-MUMBAI,201679,All
2017,9,MUMBAI,GOA,95935,98586,GOA-MUMBAI,194521,All
2017,10,MUMBAI,GOA,107926,106056,GOA-MUMBAI,213982,All
2017,11,MUMBAI,GOA,110180,109541,GOA-MUMBAI,219721,All
2017,12,MUMBAI,GOA,110272,102959,GOA-MUMBAI,213231,All
2018,1,MUMBAI,GOA,111749,113884,GOA-MUMBAI,225633,All
2018,2,MUMBAI,GOA,102323,103503,GOA-MUMBAI,205826,All
2018,3,MUMBAI,GOA,110665,111872,GOA-MUMBAI,222537,All
2018,4,MUMBAI,GOA,101129,102133,GOA-MUMBAI,203262,All
2018,5,MUMBAI,GOA,106219,102549,GOA-MUMBAI,208768,All
2018,6,MUMBAI,GOA,92872,98647,GOA-MUMBAI,191519,All
2018,7,MUMBAI,GOA,94389,96358,GOA-MUMBAI,190747,All
2018,8,MUMBAI,GOA,101328,98891,GOA-MUMBAI,200219,All
2018,9,MUMBAI,GOA,103190,100211,GOA-MUMBAI,203401,All
2018,10,MUMBAI,GOA,99426,96649,GOA-MUMBAI,196075,All
2018,11,MUMBAI,GOA,109917,104343,GOA-MUMBAI,214260,All
2018,12,MUMBAI,GOA,111841,105814,GOA-MUMBAI,217655,All
2019,3,MUMBAI,GORAKHPUR,179,182,GORAKHPUR-MUMBAI,361,All
2019,4,MUMBAI,GORAKHPUR,5489,5162,GORAKHPUR-MUMBAI,10651,All
2023,1,MUMBAI,GORAKHPUR,9170,7635,GORAKHPUR-MUMBAI,16805,All
2023,2,MUMBAI,GORAKHPUR,8510,7963,GORAKHPUR-MUMBAI,16473,All
2023,3,MUMBAI,GORAKHPUR,9940,9690,GORAKHPUR-MUMBAI,19630,All
2023,4,MUMBAI,GORAKHPUR,8088,7764,GORAKHPUR-MUMBAI,15852,All
2023,5,MUMBAI,GORAKHPUR,10246,9932,GORAKHPUR-MUMBAI,20178,All
2023,6,MUMBAI,GORAKHPUR,9723,9845,GORAKHPUR-MUMBAI,19568,All
2023,7,MUMBAI,GORAKHPUR,5443,5585,GORAKHPUR-MUMBAI,11028,All
2023,8,MUMBAI,GORAKHPUR,7426,7775,GORAKHPUR-MUMBAI,15201,All
2023,9,MUMBAI,GORAKHPUR,9231,9179,GORAKHPUR-MUMBAI,18410,All
2023,10,MUMBAI,GORAKHPUR,8289,7952,GORAKHPUR-MUMBAI,16241,All
2015,4,MUMBAI,GUWAHATI,7781,6980,GUWAHATI-MUMBAI,14761,All
2015,5,MUMBAI,GUWAHATI,8298,7876,GUWAHATI-MUMBAI,16174,All
2015,6,MUMBAI,GUWAHATI,6255,7281,GUWAHATI-MUMBAI,13536,All
2015,7,MUMBAI,GUWAHATI,7098,7314,GUWAHATI-MUMBAI,14412,All
2015,8,MUMBAI,GUWAHATI,5713,6583,GUWAHATI-MUMBAI,12296,All
2015,9,MUMBAI,GUWAHATI,6367,6040,GUWAHATI-MUMBAI,12407,All
2015,10,MUMBAI,GUWAHATI,7681,6902,GUWAHATI-MUMBAI,14583,All
2015,11,MUMBAI,GUWAHATI,7363,7464,GUWAHATI-MUMBAI,14827,All
2015,12,MUMBAI,GUWAHATI,9287,8568,GUWAHATI-MUMBAI,17855,All
2016,1,MUMBAI,GUWAHATI,7797,7580,GUWAHATI-MUMBAI,15377,All
2016,2,MUMBAI,GUWAHATI,6850,6918,GUWAHATI-MUMBAI,13768,All
2016,3,MUMBAI,GUWAHATI,7164,7280,GUWAHATI-MUMBAI,14444,All
2016,4,MUMBAI,GUWAHATI,7309,6861,GUWAHATI-MUMBAI,14170,All
2016,5,MUMBAI,GUWAHATI,6997,7395,GUWAHATI-MUMBAI,14392,All
2016,6,MUMBAI,GUWAHATI,6548,7683,GUWAHATI-MUMBAI,14231,All
2016,7,MUMBAI,GUWAHATI,7180,7783,GUWAHATI-MUMBAI,14963,All
2016,8,MUMBAI,GUWAHATI,6081,6828,GUWAHATI-MUMBAI,12909,All
2016,9,MUMBAI,GUWAHATI,6940,6288,GUWAHATI-MUMBAI,13228,All
2016,10,MUMBAI,GUWAHATI,8356,8124,GUWAHATI-MUMBAI,16480,All
2016,11,MUMBAI,GUWAHATI,8101,8149,GUWAHATI-MUMBAI,16250,All
2016,12,MUMBAI,GUWAHATI,8170,8371,GUWAHATI-MUMBAI,16541,All
2017,1,MUMBAI,GUWAHATI,8416,7798,GUWAHATI-MUMBAI,16214,All
2017,2,MUMBAI,GUWAHATI,6820,6729,GUWAHATI-MUMBAI,13549,All
2017,3,MUMBAI,GUWAHATI,6896,7588,GUWAHATI-MUMBAI,14484,All
2017,4,MUMBAI,GUWAHATI,7241,7348,GUWAHATI-MUMBAI,14589,All
2017,5,MUMBAI,GUWAHATI,6989,7265,GUWAHATI-MUMBAI,14254,All
2017,6,MUMBAI,GUWAHATI,6853,7342,GUWAHATI-MUMBAI,14195,All
2017,7,MUMBAI,GUWAHATI,7751,9516,GUWAHATI-MUMBAI,17267,All
2017,8,MUMBAI,GUWAHATI,7573,8339,GUWAHATI-MUMBAI,15912,All
2017,9,MUMBAI,GUWAHATI,8899,9321,GUWAHATI-MUMBAI,18220,All
2017,10,MUMBAI,GUWAHATI,8599,8708,GUWAHATI-MUMBAI,17307,All
2017,11,MUMBAI,GUWAHATI,9272,10171,GUWAHATI-MUMBAI,19443,All
2017,12,MUMBAI,GUWAHATI,9864,5900,GUWAHATI-MUMBAI,15764,All
2018,1,MUMBAI,GUWAHATI,9948,5640,GUWAHATI-MUMBAI,15588,All
2018,2,MUMBAI,GUWAHATI,8812,6673,GUWAHATI-MUMBAI,15485,All
2018,3,MUMBAI,GUWAHATI,9295,9008,GUWAHATI-MUMBAI,18303,All
2018,4,MUMBAI,GUWAHATI,12374,11477,GUWAHATI-MUMBAI,23851,All
2018,5,MUMBAI,GUWAHATI,12426,12122,GUWAHATI-MUMBAI,24548,All
2018,6,MUMBAI,GUWAHATI,10779,11967,GUWAHATI-MUMBAI,22746,All
2018,7,MUMBAI,GUWAHATI,11757,12965,GUWAHATI-MUMBAI,24722,All
2018,8,MUMBAI,GUWAHATI,9555,8631,GUWAHATI-MUMBAI,18186,All
2018,9,MUMBAI,GUWAHATI,10455,10400,GUWAHATI-MUMBAI,20855,All
2018,10,MUMBAI,GUWAHATI,14008,12669,GUWAHATI-MUMBAI,26677,All
2018,11,MUMBAI,GUWAHATI,13335,14034,GUWAHATI-MUMBAI,27369,All
2018,12,MUMBAI,GUWAHATI,15923,16520,GUWAHATI-MUMBAI,32443,All
2019,1,MUMBAI,GUWAHATI,15470,14835,GUWAHATI-MUMBAI,30305,All
2019,2,MUMBAI,GUWAHATI,12486,12079,GUWAHATI-MUMBAI,24565,All
2019,3,MUMBAI,GUWAHATI,9695,9857,GUWAHATI-MUMBAI,19552,All
2019,4,MUMBAI,GUWAHATI,9040,8445,GUWAHATI-MUMBAI,17485,All
2023,1,MUMBAI,GUWAHATI,14124,14494,GUWAHATI-MUMBAI,28618,All
2023,2,MUMBAI,GUWAHATI,11425,11346,GUWAHATI-MUMBAI,22771,All
2023,3,MUMBAI,GUWAHATI,15826,15023,GUWAHATI-MUMBAI,30849,All
2023,4,MUMBAI,GUWAHATI,17137,14472,GUWAHATI-MUMBAI,31609,All
2023,5,MUMBAI,GUWAHATI,17222,17245,GUWAHATI-MUMBAI,34467,All
2023,6,MUMBAI,GUWAHATI,18436,19009,GUWAHATI-MUMBAI,37445,All
2023,7,MUMBAI,GUWAHATI,20516,21007,GUWAHATI-MUMBAI,41523,All
2023,8,MUMBAI,GUWAHATI,16075,17018,GUWAHATI-MUMBAI,33093,All
2023,9,MUMBAI,GUWAHATI,16347,15105,GUWAHATI-MUMBAI,31452,All
2023,10,MUMBAI,GUWAHATI,16777,15069,GUWAHATI-MUMBAI,31846,All
2015,4,MUMBAI,GWALIOR,303,439,GWALIOR-MUMBAI,742,All
2015,5,MUMBAI,GWALIOR,234,371,GWALIOR-MUMBAI,605,All
2015,6,MUMBAI,GWALIOR,232,418,GWALIOR-MUMBAI,650,All
2015,7,MUMBAI,GWALIOR,249,268,GWALIOR-MUMBAI,517,All
2015,8,MUMBAI,GWALIOR,195,300,GWALIOR-MUMBAI,495,All
2015,9,MUMBAI,GWALIOR,233,355,GWALIOR-MUMBAI,588,All
2015,10,MUMBAI,GWALIOR,183,555,GWALIOR-MUMBAI,738,All
2015,12,MUMBAI,GWALIOR,115,155,GWALIOR-MUMBAI,270,All
2016,1,MUMBAI,GWALIOR,575,607,GWALIOR-MUMBAI,1182,All
2016,2,MUMBAI,GWALIOR,525,503,GWALIOR-MUMBAI,1028,All
2016,3,MUMBAI,GWALIOR,613,591,GWALIOR-MUMBAI,1204,All
2016,4,MUMBAI,GWALIOR,756,644,GWALIOR-MUMBAI,1400,All
2016,5,MUMBAI,GWALIOR,606,609,GWALIOR-MUMBAI,1215,All
2016,6,MUMBAI,GWALIOR,609,587,GWALIOR-MUMBAI,1196,All
2016,7,MUMBAI,GWALIOR,749,750,GWALIOR-MUMBAI,1499,All
2016,8,MUMBAI,GWALIOR,584,557,GWALIOR-MUMBAI,1141,All
2016,9,MUMBAI,GWALIOR,529,524,GWALIOR-MUMBAI,1053,All
2016,10,MUMBAI,GWALIOR,746,631,GWALIOR-MUMBAI,1377,All
2016,11,MUMBAI,GWALIOR,751,746,GWALIOR-MUMBAI,1497,All
2016,12,MUMBAI,GWALIOR,531,563,GWALIOR-MUMBAI,1094,All
2017,1,MUMBAI,GWALIOR,686,642,GWALIOR-MUMBAI,1328,All
2017,2,MUMBAI,GWALIOR,713,681,GWALIOR-MUMBAI,1394,All
2017,3,MUMBAI,GWALIOR,851,791,GWALIOR-MUMBAI,1642,All
2017,4,MUMBAI,GWALIOR,779,670,GWALIOR-MUMBAI,1449,All
2017,5,MUMBAI,GWALIOR,816,727,GWALIOR-MUMBAI,1543,All
2018,5,MUMBAI,GWALIOR,272,262,GWALIOR-MUMBAI,534,All
2018,6,MUMBAI,GWALIOR,314,196,GWALIOR-MUMBAI,510,All
2018,7,MUMBAI,GWALIOR,296,213,GWALIOR-MUMBAI,509,All
2018,8,MUMBAI,GWALIOR,276,246,GWALIOR-MUMBAI,522,All
2018,9,MUMBAI,GWALIOR,199,212,GWALIOR-MUMBAI,411,All
2019,1,MUMBAI,GWALIOR,246,235,GWALIOR-MUMBAI,481,All
2019,3,MUMBAI,GWALIOR,29,245,GWALIOR-MUMBAI,274,All
2019,4,MUMBAI,GWALIOR,250,223,GWALIOR-MUMBAI,473,All
2023,1,MUMBAI,GWALIOR,3889,3815,GWALIOR-MUMBAI,7704,All
2023,2,MUMBAI,GWALIOR,3492,3325,GWALIOR-MUMBAI,6817,All
2023,3,MUMBAI,GWALIOR,3663,3771,GWALIOR-MUMBAI,7434,All
2023,4,MUMBAI,GWALIOR,4058,3641,GWALIOR-MUMBAI,7699,All
2023,5,MUMBAI,GWALIOR,4418,4568,GWALIOR-MUMBAI,8986,All
2023,6,MUMBAI,GWALIOR,3098,3335,GWALIOR-MUMBAI,6433,All
2023,7,MUMBAI,GWALIOR,3040,3058,GWALIOR-MUMBAI,6098,All
2023,8,MUMBAI,GWALIOR,3546,3105,GWALIOR-MUMBAI,6651,All
2023,9,MUMBAI,GWALIOR,3955,4098,GWALIOR-MUMBAI,8053,All
2023,10,MUMBAI,GWALIOR,4138,3684,GWALIOR-MUMBAI,7822,All
2025,3,MUMBAI,HINDON AIRPORT,1278,1288,HINDON AIRPORT-MUMBAI,2566,All
2017,12,MUMBAI,HUBLI,568,438,HUBLI-MUMBAI,1006,All
2018,1,MUMBAI,HUBLI,1002,1109,HUBLI-MUMBAI,2111,All
2018,2,MUMBAI,HUBLI,962,949,HUBLI-MUMBAI,1911,All
2018,3,MUMBAI,HUBLI,1006,1013,HUBLI-MUMBAI,2019,All
2018,4,MUMBAI,HUBLI,758,717,HUBLI-MUMBAI,1475,All
2018,5,MUMBAI,HUBLI,1971,1886,HUBLI-MUMBAI,3857,All
2018,6,MUMBAI,HUBLI,2526,2568,HUBLI-MUMBAI,5094,All
2018,7,MUMBAI,HUBLI,2701,2642,HUBLI-MUMBAI,5343,All
2018,8,MUMBAI,HUBLI,2768,2913,HUBLI-MUMBAI,5681,All
2018,9,MUMBAI,HUBLI,2712,2859,HUBLI-MUMBAI,5571,All
2018,10,MUMBAI,HUBLI,2784,2882,HUBLI-MUMBAI,5666,All
2018,11,MUMBAI,HUBLI,2765,2703,HUBLI-MUMBAI,5468,All
2018,12,MUMBAI,HUBLI,2983,2830,HUBLI-MUMBAI,5813,All
2019,1,MUMBAI,HUBLI,2950,3175,HUBLI-MUMBAI,6125,All
2019,2,MUMBAI,HUBLI,1800,1889,HUBLI-MUMBAI,3689,All
2019,3,MUMBAI,HUBLI,1621,1631,HUBLI-MUMBAI,3252,All
2019,4,MUMBAI,HUBLI,2758,2715,HUBLI-MUMBAI,5473,All
2023,1,MUMBAI,HUBLI,2215,2133,HUBLI-MUMBAI,4348,All
2023,2,MUMBAI,HUBLI,1760,1824,HUBLI-MUMBAI,3584,All
2023,3,MUMBAI,HUBLI,1869,1901,HUBLI-MUMBAI,3770,All
2023,4,MUMBAI,HUBLI,2056,1999,HUBLI-MUMBAI,4055,All
2023,5,MUMBAI,HUBLI,2231,2172,HUBLI-MUMBAI,4403,All
2023,6,MUMBAI,HUBLI,2163,2165,HUBLI-MUMBAI,4328,All
2023,7,MUMBAI,HUBLI,2184,2199,HUBLI-MUMBAI,4383,All
2023,8,MUMBAI,HUBLI,2234,2219,HUBLI-MUMBAI,4453,All
2023,9,MUMBAI,HUBLI,2101,2112,HUBLI-MUMBAI,4213,All
2023,10,MUMBAI,HUBLI,2217,2232,HUBLI-MUMBAI,4449,All
2015,4,MUMBAI,HYDERABAD,72220,77376,HYDERABAD-MUMBAI,149596,All
2015,5,MUMBAI,HYDERABAD,81038,79627,HYDERABAD-MUMBAI,160665,All
2015,6,MUMBAI,HYDERABAD,76647,72458,HYDERABAD-MUMBAI,149105,All
2015,7,MUMBAI,HYDERABAD,83474,75183,HYDERABAD-MUMBAI,158657,All
2015,8,MUMBAI,HYDERABAD,73786,86903,HYDERABAD-MUMBAI,160689,All
2015,9,MUMBAI,HYDERABAD,70526,76488,HYDERABAD-MUMBAI,147014,All
2015,10,MUMBAI,HYDERABAD,66500,66484,HYDERABAD-MUMBAI,132984,All
2015,11,MUMBAI,HYDERABAD,78308,78839,HYDERABAD-MUMBAI,157147,All
2015,12,MUMBAI,HYDERABAD,89479,86979,HYDERABAD-MUMBAI,176458,All
2016,1,MUMBAI,HYDERABAD,80966,83613,HYDERABAD-MUMBAI,164579,All
2016,2,MUMBAI,HYDERABAD,76344,76189,HYDERABAD-MUMBAI,152533,All
2016,3,MUMBAI,HYDERABAD,77590,77254,HYDERABAD-MUMBAI,154844,All
2016,4,MUMBAI,HYDERABAD,79481,79902,HYDERABAD-MUMBAI,159383,All
2016,5,MUMBAI,HYDERABAD,85493,82543,HYDERABAD-MUMBAI,168036,All
2016,6,MUMBAI,HYDERABAD,83324,73758,HYDERABAD-MUMBAI,157082,All
2016,7,MUMBAI,HYDERABAD,97805,85863,HYDERABAD-MUMBAI,183668,All
2016,8,MUMBAI,HYDERABAD,93945,98847,HYDERABAD-MUMBAI,192792,All
2016,9,MUMBAI,HYDERABAD,83897,93361,HYDERABAD-MUMBAI,177258,All
2016,10,MUMBAI,HYDERABAD,90466,78596,HYDERABAD-MUMBAI,169062,All
2016,11,MUMBAI,HYDERABAD,79903,87558,HYDERABAD-MUMBAI,167461,All
2016,12,MUMBAI,HYDERABAD,94902,91599,HYDERABAD-MUMBAI,186501,All
2017,1,MUMBAI,HYDERABAD,89918,89739,HYDERABAD-MUMBAI,179657,All
2017,2,MUMBAI,HYDERABAD,78993,77278,HYDERABAD-MUMBAI,156271,All
2017,3,MUMBAI,HYDERABAD,76686,77499,HYDERABAD-MUMBAI,154185,All
2017,4,MUMBAI,HYDERABAD,84543,84667,HYDERABAD-MUMBAI,169210,All
2017,5,MUMBAI,HYDERABAD,97056,90864,HYDERABAD-MUMBAI,187920,All
2017,6,MUMBAI,HYDERABAD,93425,84031,HYDERABAD-MUMBAI,177456,All
2017,7,MUMBAI,HYDERABAD,98349,89568,HYDERABAD-MUMBAI,187917,All
2017,8,MUMBAI,HYDERABAD,96315,97172,HYDERABAD-MUMBAI,193487,All
2017,9,MUMBAI,HYDERABAD,89049,97518,HYDERABAD-MUMBAI,186567,All
2017,10,MUMBAI,HYDERABAD,100719,94694,HYDERABAD-MUMBAI,195413,All
2017,11,MUMBAI,HYDERABAD,98827,99163,HYDERABAD-MUMBAI,197990,All
2017,12,MUMBAI,HYDERABAD,103772,102196,HYDERABAD-MUMBAI,205968,All
2018,1,MUMBAI,HYDERABAD,103622,104388,HYDERABAD-MUMBAI,208010,All
2018,2,MUMBAI,HYDERABAD,98744,95503,HYDERABAD-MUMBAI,194247,All
2018,3,MUMBAI,HYDERABAD,104456,101763,HYDERABAD-MUMBAI,206219,All
2018,4,MUMBAI,HYDERABAD,98101,100005,HYDERABAD-MUMBAI,198106,All
2018,5,MUMBAI,HYDERABAD,100995,97027,HYDERABAD-MUMBAI,198022,All
2018,6,MUMBAI,HYDERABAD,99967,89577,HYDERABAD-MUMBAI,189544,All
2018,7,MUMBAI,HYDERABAD,102215,100042,HYDERABAD-MUMBAI,202257,All
2018,8,MUMBAI,HYDERABAD,95246,95773,HYDERABAD-MUMBAI,191019,All
2018,9,MUMBAI,HYDERABAD,85341,88112,HYDERABAD-MUMBAI,173453,All
2018,10,MUMBAI,HYDERABAD,89677,83572,HYDERABAD-MUMBAI,173249,All
2018,11,MUMBAI,HYDERABAD,86985,82606,HYDERABAD-MUMBAI,169591,All
2018,12,MUMBAI,HYDERABAD,93730,92591,HYDERABAD-MUMBAI,186321,All
2019,1,MUMBAI,HYDERABAD,87630,89326,HYDERABAD-MUMBAI,176956,All
2019,2,MUMBAI,HYDERABAD,82842,80422,HYDERABAD-MUMBAI,163264,All
2019,3,MUMBAI,HYDERABAD,82007,79733,HYDERABAD-MUMBAI,161740,All
2019,4,MUMBAI,HYDERABAD,80663,77511,HYDERABAD-MUMBAI,158174,All
2023,1,MUMBAI,HYDERABAD,77640,79018,HYDERABAD-MUMBAI,156658,All
2023,2,MUMBAI,HYDERABAD,72534,71655,HYDERABAD-MUMBAI,144189,All
2023,3,MUMBAI,HYDERABAD,75488,74347,HYDERABAD-MUMBAI,149835,All
2023,4,MUMBAI,HYDERABAD,74470,73328,HYDERABAD-MUMBAI,147798,All
2023,5,MUMBAI,HYDERABAD,88379,80612,HYDERABAD-MUMBAI,168991,All
2023,6,MUMBAI,HYDERABAD,95828,88041,HYDERABAD-MUMBAI,183869,All
2023,7,MUMBAI,HYDERABAD,93581,90167,HYDERABAD-MUMBAI,183748,All
2023,8,MUMBAI,HYDERABAD,94516,97773,HYDERABAD-MUMBAI,192289,All
2023,9,MUMBAI,HYDERABAD,94015,96245,HYDERABAD-MUMBAI,190260,All
2023,10,MUMBAI,HYDERABAD,88376,84979,HYDERABAD-MUMBAI,173355,All
2023,2,MUMBAI,"Hollongi Airport, Itanagar",202,133,"Hollongi Airport, Itanagar-MUMBAI",335,All
2023,3,MUMBAI,"Hollongi Airport, Itanagar",138,168,"Hollongi Airport, Itanagar-MUMBAI",306,All
2023,4,MUMBAI,"Hollongi Airport, Itanagar",155,195,"Hollongi Airport, Itanagar-MUMBAI",350,All
2023,5,MUMBAI,"Hollongi Airport, Itanagar",94,77,"Hollongi Airport, Itanagar-MUMBAI",171,All
2018,3,MUMBAI,IMPHAL,20,42,IMPHAL-MUMBAI,62,All
2018,4,MUMBAI,IMPHAL,384,244,IMPHAL-MUMBAI,628,All
2018,5,MUMBAI,IMPHAL,324,222,IMPHAL-MUMBAI,546,All
2018,6,MUMBAI,IMPHAL,260,267,IMPHAL-MUMBAI,527,All
2018,7,MUMBAI,IMPHAL,175,220,IMPHAL-MUMBAI,395,All
2018,8,MUMBAI,IMPHAL,244,282,IMPHAL-MUMBAI,526,All
2018,9,MUMBAI,IMPHAL,338,379,IMPHAL-MUMBAI,717,All
2018,10,MUMBAI,IMPHAL,509,437,IMPHAL-MUMBAI,946,All
2018,11,MUMBAI,IMPHAL,590,560,IMPHAL-MUMBAI,1150,All
2018,12,MUMBAI,IMPHAL,697,690,IMPHAL-MUMBAI,1387,All
2019,1,MUMBAI,IMPHAL,477,565,IMPHAL-MUMBAI,1042,All
2019,2,MUMBAI,IMPHAL,151,155,IMPHAL-MUMBAI,306,All
2023,1,MUMBAI,IMPHAL,843,1296,IMPHAL-MUMBAI,2139,All
2023,2,MUMBAI,IMPHAL,500,847,IMPHAL-MUMBAI,1347,All
2023,3,MUMBAI,IMPHAL,879,756,IMPHAL-MUMBAI,1635,All
2023,4,MUMBAI,IMPHAL,651,702,IMPHAL-MUMBAI,1353,All
2023,5,MUMBAI,IMPHAL,217,424,IMPHAL-MUMBAI,641,All
2023,6,MUMBAI,IMPHAL,143,486,IMPHAL-MUMBAI,629,All
2023,7,MUMBAI,IMPHAL,87,279,IMPHAL-MUMBAI,366,All
2023,8,MUMBAI,IMPHAL,47,117,IMPHAL-MUMBAI,164,All
2023,9,MUMBAI,IMPHAL,71,168,IMPHAL-MUMBAI,239,All
2023,10,MUMBAI,IMPHAL,129,256,IMPHAL-MUMBAI,385,All
2015,4,MUMBAI,INDORE,33224,34265,INDORE-MUMBAI,67489,All
2015,5,MUMBAI,INDORE,29085,33713,INDORE-MUMBAI,62798,All
2015,6,MUMBAI,INDORE,27825,31148,INDORE-MUMBAI,58973,All
2015,7,MUMBAI,INDORE,25174,25530,INDORE-MUMBAI,50704,All
2015,8,MUMBAI,INDORE,30502,31455,INDORE-MUMBAI,61957,All
2015,9,MUMBAI,INDORE,29659,33165,INDORE-MUMBAI,62824,All
2015,10,MUMBAI,INDORE,27875,34285,INDORE-MUMBAI,62160,All
2015,11,MUMBAI,INDORE,27288,27421,INDORE-MUMBAI,54709,All
2015,12,MUMBAI,INDORE,31801,33381,INDORE-MUMBAI,65182,All
2016,1,MUMBAI,INDORE,30643,32555,INDORE-MUMBAI,63198,All
2016,2,MUMBAI,INDORE,29928,32028,INDORE-MUMBAI,61956,All
2016,3,MUMBAI,INDORE,29475,31576,INDORE-MUMBAI,61051,All
2016,4,MUMBAI,INDORE,27521,27900,INDORE-MUMBAI,55421,All
2016,5,MUMBAI,INDORE,27413,29559,INDORE-MUMBAI,56972,All
2016,6,MUMBAI,INDORE,23336,23976,INDORE-MUMBAI,47312,All
2016,7,MUMBAI,INDORE,24417,25775,INDORE-MUMBAI,50192,All
2016,8,MUMBAI,INDORE,23878,26098,INDORE-MUMBAI,49976,All
2016,9,MUMBAI,INDORE,22620,24276,INDORE-MUMBAI,46896,All
2016,10,MUMBAI,INDORE,25366,21885,INDORE-MUMBAI,47251,All
2016,11,MUMBAI,INDORE,22909,26369,INDORE-MUMBAI,49278,All
2016,12,MUMBAI,INDORE,28652,30078,INDORE-MUMBAI,58730,All
2017,1,MUMBAI,INDORE,28280,29646,INDORE-MUMBAI,57926,All
2017,2,MUMBAI,INDORE,25029,26530,INDORE-MUMBAI,51559,All
2017,3,MUMBAI,INDORE,27505,28902,INDORE-MUMBAI,56407,All
2017,4,MUMBAI,INDORE,27466,27882,INDORE-MUMBAI,55348,All
2017,5,MUMBAI,INDORE,27717,30526,INDORE-MUMBAI,58243,All
2017,6,MUMBAI,INDORE,30529,29823,INDORE-MUMBAI,60352,All
2017,7,MUMBAI,INDORE,29147,31166,INDORE-MUMBAI,60313,All
2017,8,MUMBAI,INDORE,30862,30704,INDORE-MUMBAI,61566,All
2017,9,MUMBAI,INDORE,26505,28423,INDORE-MUMBAI,54928,All
2017,10,MUMBAI,INDORE,28463,27070,INDORE-MUMBAI,55533,All
2017,11,MUMBAI,INDORE,30113,30028,INDORE-MUMBAI,60141,All
2017,12,MUMBAI,INDORE,30359,31915,INDORE-MUMBAI,62274,All
2018,1,MUMBAI,INDORE,30359,30483,INDORE-MUMBAI,60842,All
2018,2,MUMBAI,INDORE,28825,28461,INDORE-MUMBAI,57286,All
2018,3,MUMBAI,INDORE,34254,33832,INDORE-MUMBAI,68086,All
2018,4,MUMBAI,INDORE,31850,30557,INDORE-MUMBAI,62407,All
2018,5,MUMBAI,INDORE,25425,29114,INDORE-MUMBAI,54539,All
2018,6,MUMBAI,INDORE,27332,26730,INDORE-MUMBAI,54062,All
2018,7,MUMBAI,INDORE,30828,31493,INDORE-MUMBAI,62321,All
2018,8,MUMBAI,INDORE,27101,28274,INDORE-MUMBAI,55375,All
2018,9,MUMBAI,INDORE,29508,28811,INDORE-MUMBAI,58319,All
2018,10,MUMBAI,INDORE,27472,25754,INDORE-MUMBAI,53226,All
2018,11,MUMBAI,INDORE,27251,25884,INDORE-MUMBAI,53135,All
2018,12,MUMBAI,INDORE,32442,30178,INDORE-MUMBAI,62620,All
2019,1,MUMBAI,INDORE,29875,29525,INDORE-MUMBAI,59400,All
2019,2,MUMBAI,INDORE,25844,25361,INDORE-MUMBAI,51205,All
2019,3,MUMBAI,INDORE,20347,21183,INDORE-MUMBAI,41530,All
2019,4,MUMBAI,INDORE,20558,19822,INDORE-MUMBAI,40380,All
2023,1,MUMBAI,INDORE,27793,30053,INDORE-MUMBAI,57846,All
2023,2,MUMBAI,INDORE,25871,25599,INDORE-MUMBAI,51470,All
2023,3,MUMBAI,INDORE,27214,27035,INDORE-MUMBAI,54249,All
2023,4,MUMBAI,INDORE,27337,25411,INDORE-MUMBAI,52748,All
2023,5,MUMBAI,INDORE,32822,32531,INDORE-MUMBAI,65353,All
2023,6,MUMBAI,INDORE,32156,32722,INDORE-MUMBAI,64878,All
2023,7,MUMBAI,INDORE,31050,31817,INDORE-MUMBAI,62867,All
2023,8,MUMBAI,INDORE,33140,31436,INDORE-MUMBAI,64576,All
2023,9,MUMBAI,INDORE,29952,31062,INDORE-MUMBAI,61014,All
2023,10,MUMBAI,INDORE,26974,24573,INDORE-MUMBAI,51547,All
2023,1,MUMBAI,Itanagar,220,212,Itanagar-MUMBAI,432,All
2023,6,MUMBAI,Itanagar,116,129,Itanagar-MUMBAI,245,All
2023,7,MUMBAI,Itanagar,77,94,Itanagar-MUMBAI,171,All
2023,8,MUMBAI,Itanagar,46,70,Itanagar-MUMBAI,116,All
2023,9,MUMBAI,Itanagar,63,57,Itanagar-MUMBAI,120,All
2023,10,MUMBAI,Itanagar,96,100,Itanagar-MUMBAI,196,All
2015,4,MUMBAI,JABALPUR,2222,2133,JABALPUR-MUMBAI,4355,All
2015,5,MUMBAI,JABALPUR,2224,2138,JABALPUR-MUMBAI,4362,All
2015,6,MUMBAI,JABALPUR,2112,2190,JABALPUR-MUMBAI,4302,All
2015,7,MUMBAI,JABALPUR,4186,4278,JABALPUR-MUMBAI,8464,All
2015,8,MUMBAI,JABALPUR,4163,4057,JABALPUR-MUMBAI,8220,All
2015,9,MUMBAI,JABALPUR,3994,3939,JABALPUR-MUMBAI,7933,All
2015,10,MUMBAI,JABALPUR,3865,3760,JABALPUR-MUMBAI,7625,All
2015,11,MUMBAI,JABALPUR,3694,3578,JABALPUR-MUMBAI,7272,All
2015,12,MUMBAI,JABALPUR,463,491,JABALPUR-MUMBAI,954,All
2016,2,MUMBAI,JABALPUR,1662,1620,JABALPUR-MUMBAI,3282,All
2016,3,MUMBAI,JABALPUR,2032,2032,JABALPUR-MUMBAI,4064,All
2016,4,MUMBAI,JABALPUR,2223,2128,JABALPUR-MUMBAI,4351,All
2016,5,MUMBAI,JABALPUR,2214,2212,JABALPUR-MUMBAI,4426,All
2016,6,MUMBAI,JABALPUR,2099,2136,JABALPUR-MUMBAI,4235,All
2016,7,MUMBAI,JABALPUR,2134,2130,JABALPUR-MUMBAI,4264,All
2016,8,MUMBAI,JABALPUR,2207,2169,JABALPUR-MUMBAI,4376,All
2016,9,MUMBAI,JABALPUR,2192,2199,JABALPUR-MUMBAI,4391,All
2016,10,MUMBAI,JABALPUR,2267,2013,JABALPUR-MUMBAI,4280,All
2016,11,MUMBAI,JABALPUR,1650,1651,JABALPUR-MUMBAI,3301,All
2016,12,MUMBAI,JABALPUR,2273,2276,JABALPUR-MUMBAI,4549,All
2017,1,MUMBAI,JABALPUR,2152,2285,JABALPUR-MUMBAI,4437,All
2017,2,MUMBAI,JABALPUR,2057,2043,JABALPUR-MUMBAI,4100,All
2017,3,MUMBAI,JABALPUR,2184,2115,JABALPUR-MUMBAI,4299,All
2017,4,MUMBAI,JABALPUR,2127,2065,JABALPUR-MUMBAI,4192,All
2017,5,MUMBAI,JABALPUR,2197,2152,JABALPUR-MUMBAI,4349,All
2017,6,MUMBAI,JABALPUR,2032,2177,JABALPUR-MUMBAI,4209,All
2017,7,MUMBAI,JABALPUR,2208,2248,JABALPUR-MUMBAI,4456,All
2017,8,MUMBAI,JABALPUR,2271,2254,JABALPUR-MUMBAI,4525,All
2017,9,MUMBAI,JABALPUR,2257,2224,JABALPUR-MUMBAI,4481,All
2017,10,MUMBAI,JABALPUR,2252,2185,JABALPUR-MUMBAI,4437,All
2017,11,MUMBAI,JABALPUR,2188,2204,JABALPUR-MUMBAI,4392,All
2017,12,MUMBAI,JABALPUR,2093,2158,JABALPUR-MUMBAI,4251,All
2018,1,MUMBAI,JABALPUR,2138,2134,JABALPUR-MUMBAI,4272,All
2018,2,MUMBAI,JABALPUR,2076,2045,JABALPUR-MUMBAI,4121,All
2018,3,MUMBAI,JABALPUR,2162,2222,JABALPUR-MUMBAI,4384,All
2018,4,MUMBAI,JABALPUR,2094,1931,JABALPUR-MUMBAI,4025,All
2018,5,MUMBAI,JABALPUR,2204,2288,JABALPUR-MUMBAI,4492,All
2018,6,MUMBAI,JABALPUR,2004,2041,JABALPUR-MUMBAI,4045,All
2018,7,MUMBAI,JABALPUR,2169,2174,JABALPUR-MUMBAI,4343,All
2018,8,MUMBAI,JABALPUR,2278,2289,JABALPUR-MUMBAI,4567,All
2018,9,MUMBAI,JABALPUR,2204,2208,JABALPUR-MUMBAI,4412,All
2018,10,MUMBAI,JABALPUR,2212,2178,JABALPUR-MUMBAI,4390,All
2018,11,MUMBAI,JABALPUR,2120,2123,JABALPUR-MUMBAI,4243,All
2018,12,MUMBAI,JABALPUR,2248,2282,JABALPUR-MUMBAI,4530,All
2019,1,MUMBAI,JABALPUR,2286,2271,JABALPUR-MUMBAI,4557,All
2019,2,MUMBAI,JABALPUR,1509,1508,JABALPUR-MUMBAI,3017,All
2019,3,MUMBAI,JABALPUR,1471,1546,JABALPUR-MUMBAI,3017,All
2019,4,MUMBAI,JABALPUR,2458,2248,JABALPUR-MUMBAI,4706,All
2023,1,MUMBAI,JABALPUR,4791,4967,JABALPUR-MUMBAI,9758,All
2023,2,MUMBAI,JABALPUR,5427,5219,JABALPUR-MUMBAI,10646,All
2023,3,MUMBAI,JABALPUR,2038,2085,JABALPUR-MUMBAI,4123,All
2023,4,MUMBAI,JABALPUR,2306,2173,JABALPUR-MUMBAI,4479,All
2023,5,MUMBAI,JABALPUR,2260,2188,JABALPUR-MUMBAI,4448,All
2023,6,MUMBAI,JABALPUR,2160,2270,JABALPUR-MUMBAI,4430,All
2023,7,MUMBAI,JABALPUR,2291,2321,JABALPUR-MUMBAI,4612,All
2023,8,MUMBAI,JABALPUR,2355,2377,JABALPUR-MUMBAI,4732,All
2023,9,MUMBAI,JABALPUR,2087,2007,JABALPUR-MUMBAI,4094,All
2023,10,MUMBAI,JABALPUR,2203,2076,JABALPUR-MUMBAI,4279,All
2015,4,MUMBAI,JAIPUR,30364,27754,JAIPUR-MUMBAI,58118,All
2015,5,MUMBAI,JAIPUR,28365,32722,JAIPUR-MUMBAI,61087,All
2015,6,MUMBAI,JAIPUR,26281,27031,JAIPUR-MUMBAI,53312,All
2015,7,MUMBAI,JAIPUR,27616,25939,JAIPUR-MUMBAI,53555,All
2015,8,MUMBAI,JAIPUR,29769,30204,JAIPUR-MUMBAI,59973,All
2015,9,MUMBAI,JAIPUR,32261,32220,JAIPUR-MUMBAI,64481,All
2015,10,MUMBAI,JAIPUR,32862,30807,JAIPUR-MUMBAI,63669,All
2015,11,MUMBAI,JAIPUR,39461,36963,JAIPUR-MUMBAI,76424,All
2015,12,MUMBAI,JAIPUR,41028,43190,JAIPUR-MUMBAI,84218,All
2016,1,MUMBAI,JAIPUR,39341,38786,JAIPUR-MUMBAI,78127,All
2016,2,MUMBAI,JAIPUR,38011,38496,JAIPUR-MUMBAI,76507,All
2016,3,MUMBAI,JAIPUR,39860,40021,JAIPUR-MUMBAI,79881,All
2016,4,MUMBAI,JAIPUR,40630,37745,JAIPUR-MUMBAI,78375,All
2016,5,MUMBAI,JAIPUR,39078,44559,JAIPUR-MUMBAI,83637,All
2016,6,MUMBAI,JAIPUR,39558,41749,JAIPUR-MUMBAI,81307,All
2016,7,MUMBAI,JAIPUR,48041,47743,JAIPUR-MUMBAI,95784,All
2016,8,MUMBAI,JAIPUR,47132,48121,JAIPUR-MUMBAI,95253,All
2016,9,MUMBAI,JAIPUR,45160,45509,JAIPUR-MUMBAI,90669,All
2016,10,MUMBAI,JAIPUR,43852,39306,JAIPUR-MUMBAI,83158,All
2016,11,MUMBAI,JAIPUR,42903,43265,JAIPUR-MUMBAI,86168,All
2016,12,MUMBAI,JAIPUR,47678,49618,JAIPUR-MUMBAI,97296,All
2017,1,MUMBAI,JAIPUR,49371,49253,JAIPUR-MUMBAI,98624,All
2017,2,MUMBAI,JAIPUR,39506,39662,JAIPUR-MUMBAI,79168,All
2017,3,MUMBAI,JAIPUR,39954,42135,JAIPUR-MUMBAI,82089,All
2017,4,MUMBAI,JAIPUR,43238,40231,JAIPUR-MUMBAI,83469,All
2017,5,MUMBAI,JAIPUR,40604,46211,JAIPUR-MUMBAI,86815,All
2017,6,MUMBAI,JAIPUR,39380,41939,JAIPUR-MUMBAI,81319,All
2017,7,MUMBAI,JAIPUR,39747,41781,JAIPUR-MUMBAI,81528,All
2017,8,MUMBAI,JAIPUR,41769,42845,JAIPUR-MUMBAI,84614,All
2017,9,MUMBAI,JAIPUR,39350,38921,JAIPUR-MUMBAI,78271,All
2017,10,MUMBAI,JAIPUR,45018,40566,JAIPUR-MUMBAI,85584,All
2017,11,MUMBAI,JAIPUR,42756,42821,JAIPUR-MUMBAI,85577,All
2017,12,MUMBAI,JAIPUR,44289,46589,JAIPUR-MUMBAI,90878,All
2018,1,MUMBAI,JAIPUR,44874,44747,JAIPUR-MUMBAI,89621,All
2018,2,MUMBAI,JAIPUR,44206,42193,JAIPUR-MUMBAI,86399,All
2018,3,MUMBAI,JAIPUR,36800,37757,JAIPUR-MUMBAI,74557,All
2018,4,MUMBAI,JAIPUR,44029,41745,JAIPUR-MUMBAI,85774,All
2018,5,MUMBAI,JAIPUR,41908,45634,JAIPUR-MUMBAI,87542,All
2018,6,MUMBAI,JAIPUR,42901,43189,JAIPUR-MUMBAI,86090,All
2018,7,MUMBAI,JAIPUR,45473,45079,JAIPUR-MUMBAI,90552,All
2018,8,MUMBAI,JAIPUR,44285,42826,JAIPUR-MUMBAI,87111,All
2018,9,MUMBAI,JAIPUR,40717,40885,JAIPUR-MUMBAI,81602,All
2018,10,MUMBAI,JAIPUR,42344,38588,JAIPUR-MUMBAI,80932,All
2018,11,MUMBAI,JAIPUR,39682,38814,JAIPUR-MUMBAI,78496,All
2018,12,MUMBAI,JAIPUR,42675,43633,JAIPUR-MUMBAI,86308,All
2019,1,MUMBAI,JAIPUR,42120,42522,JAIPUR-MUMBAI,84642,All
2019,2,MUMBAI,JAIPUR,34670,33614,JAIPUR-MUMBAI,68284,All
2019,3,MUMBAI,JAIPUR,27643,27352,JAIPUR-MUMBAI,54995,All
2019,4,MUMBAI,JAIPUR,26513,26991,JAIPUR-MUMBAI,53504,All
2023,1,MUMBAI,JAIPUR,62409,59300,JAIPUR-MUMBAI,121709,All
2023,2,MUMBAI,JAIPUR,59480,59437,JAIPUR-MUMBAI,118917,All
2023,3,MUMBAI,JAIPUR,56854,57465,JAIPUR-MUMBAI,114319,All
2023,4,MUMBAI,JAIPUR,48148,45137,JAIPUR-MUMBAI,93285,All
2023,5,MUMBAI,JAIPUR,48087,49985,JAIPUR-MUMBAI,98072,All
2023,6,MUMBAI,JAIPUR,48980,48884,JAIPUR-MUMBAI,97864,All
2023,7,MUMBAI,JAIPUR,50421,48940,JAIPUR-MUMBAI,99361,All
2023,8,MUMBAI,JAIPUR,57168,54401,JAIPUR-MUMBAI,111569,All
2023,9,MUMBAI,JAIPUR,53793,52074,JAIPUR-MUMBAI,105867,All
2023,10,MUMBAI,JAIPUR,50995,46422,JAIPUR-MUMBAI,97417,All
2017,12,MUMBAI,JAISALMER,8,12,JAISALMER-MUMBAI,20,All
2018,10,MUMBAI,JAISALMER,285,199,JAISALMER-MUMBAI,484,All
2018,11,MUMBAI,JAISALMER,3898,3652,JAISALMER-MUMBAI,7550,All
2018,12,MUMBAI,JAISALMER,4080,3726,JAISALMER-MUMBAI,7806,All
2019,1,MUMBAI,JAISALMER,4339,4195,JAISALMER-MUMBAI,8534,All
2019,2,MUMBAI,JAISALMER,2382,2312,JAISALMER-MUMBAI,4694,All
2019,3,MUMBAI,JAISALMER,1583,1272,JAISALMER-MUMBAI,2855,All
2023,1,MUMBAI,JAISALMER,3420,4097,JAISALMER-MUMBAI,7517,All
2023,2,MUMBAI,JAISALMER,3209,3588,JAISALMER-MUMBAI,6797,All
2023,10,MUMBAI,JAISALMER,154,220,JAISALMER-MUMBAI,374,All
2017,12,MUMBAI,JALGAON,36,42,JALGAON-MUMBAI,78,All
2018,1,MUMBAI,JALGAON,104,108,JALGAON-MUMBAI,212,All
2018,2,MUMBAI,JALGAON,104,107,JALGAON-MUMBAI,211,All
2018,3,MUMBAI,JALGAON,16,29,JALGAON-MUMBAI,45,All
2018,4,MUMBAI,JALGAON,106,80,JALGAON-MUMBAI,186,All
2018,5,MUMBAI,JALGAON,236,285,JALGAON-MUMBAI,521,All
2018,6,MUMBAI,JALGAON,114,155,JALGAON-MUMBAI,269,All
2018,7,MUMBAI,JALGAON,7,4,JALGAON-MUMBAI,11,All
2018,8,MUMBAI,JALGAON,174,171,JALGAON-MUMBAI,345,All
2018,9,MUMBAI,JALGAON,121,142,JALGAON-MUMBAI,263,All
2015,4,MUMBAI,JAMMU,3741,5011,JAMMU-MUMBAI,8752,All
2015,5,MUMBAI,JAMMU,3748,5454,JAMMU-MUMBAI,9202,All
2015,6,MUMBAI,JAMMU,3352,4884,JAMMU-MUMBAI,8236,All
2015,7,MUMBAI,JAMMU,2680,5170,JAMMU-MUMBAI,7850,All
2015,8,MUMBAI,JAMMU,2645,4434,JAMMU-MUMBAI,7079,All
2015,9,MUMBAI,JAMMU,3545,4982,JAMMU-MUMBAI,8527,All
2015,10,MUMBAI,JAMMU,4738,4588,JAMMU-MUMBAI,9326,All
2015,11,MUMBAI,JAMMU,7964,3006,JAMMU-MUMBAI,10970,All
2015,12,MUMBAI,JAMMU,8136,3314,JAMMU-MUMBAI,11450,All
2016,1,MUMBAI,JAMMU,7494,2722,JAMMU-MUMBAI,10216,All
2016,2,MUMBAI,JAMMU,8232,1526,JAMMU-MUMBAI,9758,All
2016,3,MUMBAI,JAMMU,8143,996,JAMMU-MUMBAI,9139,All
2016,4,MUMBAI,JAMMU,6466,971,JAMMU-MUMBAI,7437,All
2016,5,MUMBAI,JAMMU,7936,563,JAMMU-MUMBAI,8499,All
2016,6,MUMBAI,JAMMU,6510,664,JAMMU-MUMBAI,7174,All
2016,7,MUMBAI,JAMMU,6172,587,JAMMU-MUMBAI,6759,All
2016,8,MUMBAI,JAMMU,4260,1266,JAMMU-MUMBAI,5526,All
2016,9,MUMBAI,JAMMU,4435,1016,JAMMU-MUMBAI,5451,All
2016,10,MUMBAI,JAMMU,6581,1826,JAMMU-MUMBAI,8407,All
2016,11,MUMBAI,JAMMU,7471,4147,JAMMU-MUMBAI,11618,All
2016,12,MUMBAI,JAMMU,8569,2866,JAMMU-MUMBAI,11435,All
2017,1,MUMBAI,JAMMU,8509,2652,JAMMU-MUMBAI,11161,All
2017,2,MUMBAI,JAMMU,6276,1819,JAMMU-MUMBAI,8095,All
2017,3,MUMBAI,JAMMU,7215,1685,JAMMU-MUMBAI,8900,All
2017,4,MUMBAI,JAMMU,7540,1622,JAMMU-MUMBAI,9162,All
2017,5,MUMBAI,JAMMU,7370,1919,JAMMU-MUMBAI,9289,All
2017,6,MUMBAI,JAMMU,6941,1992,JAMMU-MUMBAI,8933,All
2017,7,MUMBAI,JAMMU,6831,1425,JAMMU-MUMBAI,8256,All
2017,8,MUMBAI,JAMMU,6526,1670,JAMMU-MUMBAI,8196,All
2017,9,MUMBAI,JAMMU,7822,1351,JAMMU-MUMBAI,9173,All
2017,10,MUMBAI,JAMMU,8506,1770,JAMMU-MUMBAI,10276,All
2017,11,MUMBAI,JAMMU,8659,2148,JAMMU-MUMBAI,10807,All
2017,12,MUMBAI,JAMMU,8652,2671,JAMMU-MUMBAI,11323,All
2018,1,MUMBAI,JAMMU,8492,2354,JAMMU-MUMBAI,10846,All
2018,2,MUMBAI,JAMMU,8432,1926,JAMMU-MUMBAI,10358,All
2018,3,MUMBAI,JAMMU,8982,1433,JAMMU-MUMBAI,10415,All
2018,4,MUMBAI,JAMMU,7923,799,JAMMU-MUMBAI,8722,All
2018,5,MUMBAI,JAMMU,7708,1069,JAMMU-MUMBAI,8777,All
2018,6,MUMBAI,JAMMU,6611,1039,JAMMU-MUMBAI,7650,All
2018,7,MUMBAI,JAMMU,7799,952,JAMMU-MUMBAI,8751,All
2018,8,MUMBAI,JAMMU,7917,1257,JAMMU-MUMBAI,9174,All
2018,9,MUMBAI,JAMMU,8261,1568,JAMMU-MUMBAI,9829,All
2018,10,MUMBAI,JAMMU,9231,1652,JAMMU-MUMBAI,10883,All
2018,11,MUMBAI,JAMMU,9015,2565,JAMMU-MUMBAI,11580,All
2018,12,MUMBAI,JAMMU,8678,2508,JAMMU-MUMBAI,11186,All
2019,1,MUMBAI,JAMMU,8702,2328,JAMMU-MUMBAI,11030,All
2019,2,MUMBAI,JAMMU,7812,2124,JAMMU-MUMBAI,9936,All
2019,3,MUMBAI,JAMMU,8251,2015,JAMMU-MUMBAI,10266,All
2019,4,MUMBAI,JAMMU,7808,1261,JAMMU-MUMBAI,9069,All
2023,1,MUMBAI,JAMMU,8025,2089,JAMMU-MUMBAI,10114,All
2023,2,MUMBAI,JAMMU,7318,2588,JAMMU-MUMBAI,9906,All
2023,3,MUMBAI,JAMMU,7733,2866,JAMMU-MUMBAI,10599,All
2023,4,MUMBAI,JAMMU,7409,3445,JAMMU-MUMBAI,10854,All
2023,5,MUMBAI,JAMMU,880,184,JAMMU-MUMBAI,1064,All
2023,6,MUMBAI,JAMMU,4535,4487,JAMMU-MUMBAI,9022,All
2023,7,MUMBAI,JAMMU,4892,4856,JAMMU-MUMBAI,9748,All
2023,8,MUMBAI,JAMMU,4307,4027,JAMMU-MUMBAI,8334,All
2023,9,MUMBAI,JAMMU,5971,5036,JAMMU-MUMBAI,11007,All
2023,10,MUMBAI,JAMMU,5913,5069,JAMMU-MUMBAI,10982,All
2015,4,MUMBAI,JAMNAGAR,2926,2955,JAMNAGAR-MUMBAI,5881,All
2015,5,MUMBAI,JAMNAGAR,4152,4318,JAMNAGAR-MUMBAI,8470,All
2015,6,MUMBAI,JAMNAGAR,3389,3031,JAMNAGAR-MUMBAI,6420,All
2015,7,MUMBAI,JAMNAGAR,2887,2818,JAMNAGAR-MUMBAI,5705,All
2015,8,MUMBAI,JAMNAGAR,2927,3020,JAMNAGAR-MUMBAI,5947,All
2015,9,MUMBAI,JAMNAGAR,2867,2926,JAMNAGAR-MUMBAI,5793,All
2015,10,MUMBAI,JAMNAGAR,11,327,JAMNAGAR-MUMBAI,338,All
2015,11,MUMBAI,JAMNAGAR,4001,3886,JAMNAGAR-MUMBAI,7887,All
2015,12,MUMBAI,JAMNAGAR,4224,4240,JAMNAGAR-MUMBAI,8464,All
2016,1,MUMBAI,JAMNAGAR,4096,4052,JAMNAGAR-MUMBAI,8148,All
2016,2,MUMBAI,JAMNAGAR,3616,3552,JAMNAGAR-MUMBAI,7168,All
2016,3,MUMBAI,JAMNAGAR,3450,3248,JAMNAGAR-MUMBAI,6698,All
2016,4,MUMBAI,JAMNAGAR,4260,4022,JAMNAGAR-MUMBAI,8282,All
2016,5,MUMBAI,JAMNAGAR,4302,4394,JAMNAGAR-MUMBAI,8696,All
2016,6,MUMBAI,JAMNAGAR,3839,3659,JAMNAGAR-MUMBAI,7498,All
2016,7,MUMBAI,JAMNAGAR,4241,4088,JAMNAGAR-MUMBAI,8329,All
2016,8,MUMBAI,JAMNAGAR,4194,3990,JAMNAGAR-MUMBAI,8184,All
2016,9,MUMBAI,JAMNAGAR,3516,3639,JAMNAGAR-MUMBAI,7155,All
2016,10,MUMBAI,JAMNAGAR,3178,3231,JAMNAGAR-MUMBAI,6409,All
2016,11,MUMBAI,JAMNAGAR,2494,2143,JAMNAGAR-MUMBAI,4637,All
2016,12,MUMBAI,JAMNAGAR,3182,3018,JAMNAGAR-MUMBAI,6200,All
2017,1,MUMBAI,JAMNAGAR,3000,2829,JAMNAGAR-MUMBAI,5829,All
2017,2,MUMBAI,JAMNAGAR,2416,2304,JAMNAGAR-MUMBAI,4720,All
2017,3,MUMBAI,JAMNAGAR,2570,2351,JAMNAGAR-MUMBAI,4921,All
2017,4,MUMBAI,JAMNAGAR,2685,2468,JAMNAGAR-MUMBAI,5153,All
2017,5,MUMBAI,JAMNAGAR,3236,3056,JAMNAGAR-MUMBAI,6292,All
2017,6,MUMBAI,JAMNAGAR,2919,2587,JAMNAGAR-MUMBAI,5506,All
2017,7,MUMBAI,JAMNAGAR,2734,2438,JAMNAGAR-MUMBAI,5172,All
2017,8,MUMBAI,JAMNAGAR,2594,2601,JAMNAGAR-MUMBAI,5195,All
2017,9,MUMBAI,JAMNAGAR,2537,2374,JAMNAGAR-MUMBAI,4911,All
2017,10,MUMBAI,JAMNAGAR,2927,2821,JAMNAGAR-MUMBAI,5748,All
2017,11,MUMBAI,JAMNAGAR,3259,3021,JAMNAGAR-MUMBAI,6280,All
2017,12,MUMBAI,JAMNAGAR,3274,3250,JAMNAGAR-MUMBAI,6524,All
2018,1,MUMBAI,JAMNAGAR,3431,3296,JAMNAGAR-MUMBAI,6727,All
2018,2,MUMBAI,JAMNAGAR,3257,3126,JAMNAGAR-MUMBAI,6383,All
2018,3,MUMBAI,JAMNAGAR,3431,3334,JAMNAGAR-MUMBAI,6765,All
2018,4,MUMBAI,JAMNAGAR,3063,3018,JAMNAGAR-MUMBAI,6081,All
2018,5,MUMBAI,JAMNAGAR,3354,3232,JAMNAGAR-MUMBAI,6586,All
2018,6,MUMBAI,JAMNAGAR,3217,2997,JAMNAGAR-MUMBAI,6214,All
2018,7,MUMBAI,JAMNAGAR,3510,3360,JAMNAGAR-MUMBAI,6870,All
2018,8,MUMBAI,JAMNAGAR,3440,3505,JAMNAGAR-MUMBAI,6945,All
2018,9,MUMBAI,JAMNAGAR,3394,3234,JAMNAGAR-MUMBAI,6628,All
2018,10,MUMBAI,JAMNAGAR,3508,3273,JAMNAGAR-MUMBAI,6781,All
2018,11,MUMBAI,JAMNAGAR,3646,3329,JAMNAGAR-MUMBAI,6975,All
2018,12,MUMBAI,JAMNAGAR,3779,3599,JAMNAGAR-MUMBAI,7378,All
2019,1,MUMBAI,JAMNAGAR,3743,3497,JAMNAGAR-MUMBAI,7240,All
2019,2,MUMBAI,JAMNAGAR,2199,2178,JAMNAGAR-MUMBAI,4377,All
2019,3,MUMBAI,JAMNAGAR,2205,2231,JAMNAGAR-MUMBAI,4436,All
2019,4,MUMBAI,JAMNAGAR,3488,3098,JAMNAGAR-MUMBAI,6586,All
2023,1,MUMBAI,JAMNAGAR,5338,5396,JAMNAGAR-MUMBAI,10734,All
2023,2,MUMBAI,JAMNAGAR,4477,4582,JAMNAGAR-MUMBAI,9059,All
2023,3,MUMBAI,JAMNAGAR,4576,4384,JAMNAGAR-MUMBAI,8960,All
2023,4,MUMBAI,JAMNAGAR,4221,3974,JAMNAGAR-MUMBAI,8195,All
2023,5,MUMBAI,JAMNAGAR,4726,4488,JAMNAGAR-MUMBAI,9214,All
2023,6,MUMBAI,JAMNAGAR,3941,3085,JAMNAGAR-MUMBAI,7026,All
2023,7,MUMBAI,JAMNAGAR,4473,3781,JAMNAGAR-MUMBAI,8254,All
2023,8,MUMBAI,JAMNAGAR,4392,3681,JAMNAGAR-MUMBAI,8073,All
2023,9,MUMBAI,JAMNAGAR,4764,4208,JAMNAGAR-MUMBAI,8972,All
2023,10,MUMBAI,JAMNAGAR,4812,4319,JAMNAGAR-MUMBAI,9131,All
2023,1,MUMBAI,JHARSUGUDA,756,672,JHARSUGUDA-MUMBAI,1428,All
2015,4,MUMBAI,JODHPUR,6800,5479,JODHPUR-MUMBAI,12279,All
2015,5,MUMBAI,JODHPUR,6404,6625,JODHPUR-MUMBAI,13029,All
2015,6,MUMBAI,JODHPUR,6136,5862,JODHPUR-MUMBAI,11998,All
2015,7,MUMBAI,JODHPUR,6791,6516,JODHPUR-MUMBAI,13307,All
2015,8,MUMBAI,JODHPUR,6973,6945,JODHPUR-MUMBAI,13918,All
2015,9,MUMBAI,JODHPUR,6737,6684,JODHPUR-MUMBAI,13421,All
2015,10,MUMBAI,JODHPUR,3991,9491,JODHPUR-MUMBAI,13482,All
2015,11,MUMBAI,JODHPUR,7531,7032,JODHPUR-MUMBAI,14563,All
2015,12,MUMBAI,JODHPUR,7575,7691,JODHPUR-MUMBAI,15266,All
2016,1,MUMBAI,JODHPUR,7426,7633,JODHPUR-MUMBAI,15059,All
2016,2,MUMBAI,JODHPUR,7671,7291,JODHPUR-MUMBAI,14962,All
2016,3,MUMBAI,JODHPUR,6669,6306,JODHPUR-MUMBAI,12975,All
2016,4,MUMBAI,JODHPUR,6806,5934,JODHPUR-MUMBAI,12740,All
2016,5,MUMBAI,JODHPUR,6671,7026,JODHPUR-MUMBAI,13697,All
2016,6,MUMBAI,JODHPUR,6997,6969,JODHPUR-MUMBAI,13966,All
2016,7,MUMBAI,JODHPUR,7268,7254,JODHPUR-MUMBAI,14522,All
2016,8,MUMBAI,JODHPUR,6672,6378,JODHPUR-MUMBAI,13050,All
2016,9,MUMBAI,JODHPUR,6731,6617,JODHPUR-MUMBAI,13348,All
2016,10,MUMBAI,JODHPUR,6257,5441,JODHPUR-MUMBAI,11698,All
2016,11,MUMBAI,JODHPUR,6316,6664,JODHPUR-MUMBAI,12980,All
2016,12,MUMBAI,JODHPUR,8214,8375,JODHPUR-MUMBAI,16589,All
2017,1,MUMBAI,JODHPUR,8669,8501,JODHPUR-MUMBAI,17170,All
2017,2,MUMBAI,JODHPUR,7902,7692,JODHPUR-MUMBAI,15594,All
2017,3,MUMBAI,JODHPUR,8232,8018,JODHPUR-MUMBAI,16250,All
2017,4,MUMBAI,JODHPUR,9021,7963,JODHPUR-MUMBAI,16984,All
2017,5,MUMBAI,JODHPUR,9388,9997,JODHPUR-MUMBAI,19385,All
2017,6,MUMBAI,JODHPUR,9447,9380,JODHPUR-MUMBAI,18827,All
2017,7,MUMBAI,JODHPUR,9262,9093,JODHPUR-MUMBAI,18355,All
2017,8,MUMBAI,JODHPUR,9147,8700,JODHPUR-MUMBAI,17847,All
2017,9,MUMBAI,JODHPUR,8466,8129,JODHPUR-MUMBAI,16595,All
2017,10,MUMBAI,JODHPUR,9216,8377,JODHPUR-MUMBAI,17593,All
2017,11,MUMBAI,JODHPUR,8586,8665,JODHPUR-MUMBAI,17251,All
2017,12,MUMBAI,JODHPUR,9442,9259,JODHPUR-MUMBAI,18701,All
2018,1,MUMBAI,JODHPUR,9261,8705,JODHPUR-MUMBAI,17966,All
2018,2,MUMBAI,JODHPUR,9114,8302,JODHPUR-MUMBAI,17416,All
2018,3,MUMBAI,JODHPUR,10291,9697,JODHPUR-MUMBAI,19988,All
2018,4,MUMBAI,JODHPUR,9254,8386,JODHPUR-MUMBAI,17640,All
2018,5,MUMBAI,JODHPUR,7966,9499,JODHPUR-MUMBAI,17465,All
2018,6,MUMBAI,JODHPUR,9146,8397,JODHPUR-MUMBAI,17543,All
2018,7,MUMBAI,JODHPUR,8859,8153,JODHPUR-MUMBAI,17012,All
2018,8,MUMBAI,JODHPUR,8806,8165,JODHPUR-MUMBAI,16971,All
2018,9,MUMBAI,JODHPUR,8748,8336,JODHPUR-MUMBAI,17084,All
2018,10,MUMBAI,JODHPUR,9123,8535,JODHPUR-MUMBAI,17658,All
2018,11,MUMBAI,JODHPUR,8401,7541,JODHPUR-MUMBAI,15942,All
2018,12,MUMBAI,JODHPUR,8788,8848,JODHPUR-MUMBAI,17636,All
2019,1,MUMBAI,JODHPUR,9003,8726,JODHPUR-MUMBAI,17729,All
2019,2,MUMBAI,JODHPUR,7116,7427,JODHPUR-MUMBAI,14543,All
2019,3,MUMBAI,JODHPUR,6765,6743,JODHPUR-MUMBAI,13508,All
2019,4,MUMBAI,JODHPUR,4641,4311,JODHPUR-MUMBAI,8952,All
2023,1,MUMBAI,JODHPUR,18911,18424,JODHPUR-MUMBAI,37335,All
2023,2,MUMBAI,JODHPUR,18642,19014,JODHPUR-MUMBAI,37656,All
2023,3,MUMBAI,JODHPUR,15196,14823,JODHPUR-MUMBAI,30019,All
2023,4,MUMBAI,JODHPUR,10571,8932,JODHPUR-MUMBAI,19503,All
2023,5,MUMBAI,JODHPUR,10283,10328,JODHPUR-MUMBAI,20611,All
2023,6,MUMBAI,JODHPUR,9917,9604,JODHPUR-MUMBAI,19521,All
2023,7,MUMBAI,JODHPUR,9316,8178,JODHPUR-MUMBAI,17494,All
2023,8,MUMBAI,JODHPUR,9767,9111,JODHPUR-MUMBAI,18878,All
2023,9,MUMBAI,JODHPUR,10047,9264,JODHPUR-MUMBAI,19311,All
2023,10,MUMBAI,JODHPUR,9529,8957,JODHPUR-MUMBAI,18486,All
2018,3,MUMBAI,JORHAT,71,53,JORHAT-MUMBAI,124,All
2018,4,MUMBAI,JORHAT,465,323,JORHAT-MUMBAI,788,All
2018,5,MUMBAI,JORHAT,511,407,JORHAT-MUMBAI,918,All
2018,6,MUMBAI,JORHAT,425,462,JORHAT-MUMBAI,887,All
2018,7,MUMBAI,JORHAT,362,368,JORHAT-MUMBAI,730,All
2018,8,MUMBAI,JORHAT,369,305,JORHAT-MUMBAI,674,All
2018,9,MUMBAI,JORHAT,319,243,JORHAT-MUMBAI,562,All
2018,10,MUMBAI,JORHAT,343,274,JORHAT-MUMBAI,617,All
2018,11,MUMBAI,JORHAT,348,278,JORHAT-MUMBAI,626,All
2018,12,MUMBAI,JORHAT,461,299,JORHAT-MUMBAI,760,All
2019,1,MUMBAI,JORHAT,465,436,JORHAT-MUMBAI,901,All
2019,2,MUMBAI,JORHAT,100,153,JORHAT-MUMBAI,253,All
2017,7,MUMBAI,KANDLA,1549,1553,KANDLA-MUMBAI,3102,All
2017,8,MUMBAI,KANDLA,2071,2060,KANDLA-MUMBAI,4131,All
2017,9,MUMBAI,KANDLA,2254,2169,KANDLA-MUMBAI,4423,All
2017,10,MUMBAI,KANDLA,2316,2304,KANDLA-MUMBAI,4620,All
2017,11,MUMBAI,KANDLA,2272,2218,KANDLA-MUMBAI,4490,All
2017,12,MUMBAI,KANDLA,2398,2343,KANDLA-MUMBAI,4741,All
2018,1,MUMBAI,KANDLA,2409,2411,KANDLA-MUMBAI,4820,All
2018,2,MUMBAI,KANDLA,2169,2166,KANDLA-MUMBAI,4335,All
2018,3,MUMBAI,KANDLA,2408,2370,KANDLA-MUMBAI,4778,All
2018,4,MUMBAI,KANDLA,2146,2076,KANDLA-MUMBAI,4222,All
2018,5,MUMBAI,KANDLA,2372,2120,KANDLA-MUMBAI,4492,All
2018,6,MUMBAI,KANDLA,2254,2098,KANDLA-MUMBAI,4352,All
2018,7,MUMBAI,KANDLA,2371,2325,KANDLA-MUMBAI,4696,All
2018,8,MUMBAI,KANDLA,2099,2078,KANDLA-MUMBAI,4177,All
2018,9,MUMBAI,KANDLA,2199,2138,KANDLA-MUMBAI,4337,All
2018,10,MUMBAI,KANDLA,2201,2153,KANDLA-MUMBAI,4354,All
2018,11,MUMBAI,KANDLA,2339,2314,KANDLA-MUMBAI,4653,All
2018,12,MUMBAI,KANDLA,2382,2387,KANDLA-MUMBAI,4769,All
2019,1,MUMBAI,KANDLA,2227,2247,KANDLA-MUMBAI,4474,All
2019,2,MUMBAI,KANDLA,1326,1321,KANDLA-MUMBAI,2647,All
2019,3,MUMBAI,KANDLA,1480,1460,KANDLA-MUMBAI,2940,All
2019,4,MUMBAI,KANDLA,2335,2206,KANDLA-MUMBAI,4541,All
2023,1,MUMBAI,KANDLA,2597,2579,KANDLA-MUMBAI,5176,All
2023,2,MUMBAI,KANDLA,2276,2210,KANDLA-MUMBAI,4486,All
2023,3,MUMBAI,KANDLA,2268,2158,KANDLA-MUMBAI,4426,All
2023,4,MUMBAI,KANDLA,2253,2173,KANDLA-MUMBAI,4426,All
2023,5,MUMBAI,KANDLA,2164,2178,KANDLA-MUMBAI,4342,All
2023,6,MUMBAI,KANDLA,1742,1614,KANDLA-MUMBAI,3356,All
2023,7,MUMBAI,KANDLA,1982,1807,KANDLA-MUMBAI,3789,All
2023,8,MUMBAI,KANDLA,2043,1868,KANDLA-MUMBAI,3911,All
2023,9,MUMBAI,KANDLA,2255,2128,KANDLA-MUMBAI,4383,All
2023,10,MUMBAI,KANDLA,1752,1612,KANDLA-MUMBAI,3364,All
2019,1,MUMBAI,KANNUR,2915,3052,KANNUR-MUMBAI,5967,All
2019,2,MUMBAI,KANNUR,4332,4442,KANNUR-MUMBAI,8774,All
2019,3,MUMBAI,KANNUR,4923,5355,KANNUR-MUMBAI,10278,All
2019,4,MUMBAI,KANNUR,10787,10153,KANNUR-MUMBAI,20940,All
2023,1,MUMBAI,KANNUR,5054,5436,KANNUR-MUMBAI,10490,All
2023,2,MUMBAI,KANNUR,4821,5045,KANNUR-MUMBAI,9866,All
2023,3,MUMBAI,KANNUR,4815,5115,KANNUR-MUMBAI,9930,All
2023,4,MUMBAI,KANNUR,5349,5311,KANNUR-MUMBAI,10660,All
2023,5,MUMBAI,KANNUR,341,343,KANNUR-MUMBAI,684,All
2023,7,MUMBAI,KANNUR,5244,4448,KANNUR-MUMBAI,9692,All
2023,8,MUMBAI,KANNUR,5030,6189,KANNUR-MUMBAI,11219,All
2023,9,MUMBAI,KANNUR,3815,5621,KANNUR-MUMBAI,9436,All
2023,10,MUMBAI,KANNUR,3341,4164,KANNUR-MUMBAI,7505,All
2018,10,MUMBAI,KANPUR,3763,3264,KANPUR-MUMBAI,7027,All
2018,11,MUMBAI,KANPUR,5254,4632,KANPUR-MUMBAI,9886,All
2018,12,MUMBAI,KANPUR,5392,5322,KANPUR-MUMBAI,10714,All
2019,1,MUMBAI,KANPUR,5540,5342,KANPUR-MUMBAI,10882,All
2019,2,MUMBAI,KANPUR,3254,3149,KANPUR-MUMBAI,6403,All
2019,3,MUMBAI,KANPUR,3339,3169,KANPUR-MUMBAI,6508,All
2019,4,MUMBAI,KANPUR,5640,5321,KANPUR-MUMBAI,10961,All
2023,1,MUMBAI,KANPUR,3345,2888,KANPUR-MUMBAI,6233,All
2023,2,MUMBAI,KANPUR,6239,5448,KANPUR-MUMBAI,11687,All
2023,3,MUMBAI,KANPUR,6460,6712,KANPUR-MUMBAI,13172,All
2023,4,MUMBAI,KANPUR,5397,4283,KANPUR-MUMBAI,9680,All
2023,5,MUMBAI,KANPUR,5258,4962,KANPUR-MUMBAI,10220,All
2023,6,MUMBAI,KANPUR,4763,4988,KANPUR-MUMBAI,9751,All
2023,7,MUMBAI,KANPUR,4286,4821,KANPUR-MUMBAI,9107,All
2023,8,MUMBAI,KANPUR,4694,4972,KANPUR-MUMBAI,9666,All
2023,9,MUMBAI,KANPUR,4107,4280,KANPUR-MUMBAI,8387,All
2023,10,MUMBAI,KANPUR,4283,3643,KANPUR-MUMBAI,7926,All
2023,1,MUMBAI,KESHOD,564,484,KESHOD-MUMBAI,1048,All
2023,2,MUMBAI,KESHOD,583,617,KESHOD-MUMBAI,1200,All
2023,3,MUMBAI,KESHOD,699,681,KESHOD-MUMBAI,1380,All
2023,4,MUMBAI,KESHOD,754,713,KESHOD-MUMBAI,1467,All
2023,5,MUMBAI,KESHOD,721,771,KESHOD-MUMBAI,1492,All
2023,6,MUMBAI,KESHOD,446,468,KESHOD-MUMBAI,914,All
2023,7,MUMBAI,KESHOD,210,208,KESHOD-MUMBAI,418,All
2023,8,MUMBAI,KESHOD,651,582,KESHOD-MUMBAI,1233,All
2023,9,MUMBAI,KESHOD,412,419,KESHOD-MUMBAI,831,All
2023,10,MUMBAI,KESHOD,718,597,KESHOD-MUMBAI,1315,All
2015,4,MUMBAI,KOCHI,43058,41232,KOCHI-MUMBAI,84290,All
2015,5,MUMBAI,KOCHI,50562,44199,KOCHI-MUMBAI,94761,All
2015,6,MUMBAI,KOCHI,35971,37923,KOCHI-MUMBAI,73894,All
2015,7,MUMBAI,KOCHI,44830,39097,KOCHI-MUMBAI,83927,All
2015,8,MUMBAI,KOCHI,44016,47311,KOCHI-MUMBAI,91327,All
2015,9,MUMBAI,KOCHI,27834,32646,KOCHI-MUMBAI,60480,All
2015,10,MUMBAI,KOCHI,33643,26624,KOCHI-MUMBAI,60267,All
2015,11,MUMBAI,KOCHI,34975,35839,KOCHI-MUMBAI,70814,All
2015,12,MUMBAI,KOCHI,55801,38451,KOCHI-MUMBAI,94252,All
2016,1,MUMBAI,KOCHI,49912,39938,KOCHI-MUMBAI,89850,All
2016,2,MUMBAI,KOCHI,44145,45689,KOCHI-MUMBAI,89834,All
2016,3,MUMBAI,KOCHI,46000,45906,KOCHI-MUMBAI,91906,All
2016,4,MUMBAI,KOCHI,50527,51298,KOCHI-MUMBAI,101825,All
2016,5,MUMBAI,KOCHI,60594,56852,KOCHI-MUMBAI,117446,All
2016,6,MUMBAI,KOCHI,45904,47789,KOCHI-MUMBAI,93693,All
2016,7,MUMBAI,KOCHI,59188,52184,KOCHI-MUMBAI,111372,All
2016,8,MUMBAI,KOCHI,57042,59623,KOCHI-MUMBAI,116665,All
2016,9,MUMBAI,KOCHI,54279,58542,KOCHI-MUMBAI,112821,All
2016,10,MUMBAI,KOCHI,52661,48232,KOCHI-MUMBAI,100893,All
2016,11,MUMBAI,KOCHI,47872,51839,KOCHI-MUMBAI,99711,All
2016,12,MUMBAI,KOCHI,60590,57056,KOCHI-MUMBAI,117646,All
2017,1,MUMBAI,KOCHI,59614,59920,KOCHI-MUMBAI,119534,All
2017,2,MUMBAI,KOCHI,48434,50469,KOCHI-MUMBAI,98903,All
2017,3,MUMBAI,KOCHI,43035,45273,KOCHI-MUMBAI,88308,All
2017,4,MUMBAI,KOCHI,49680,45794,KOCHI-MUMBAI,95474,All
2017,5,MUMBAI,KOCHI,57145,50708,KOCHI-MUMBAI,107853,All
2017,6,MUMBAI,KOCHI,47604,46445,KOCHI-MUMBAI,94049,All
2017,7,MUMBAI,KOCHI,53435,45316,KOCHI-MUMBAI,98751,All
2017,8,MUMBAI,KOCHI,52745,51270,KOCHI-MUMBAI,104015,All
2017,9,MUMBAI,KOCHI,47250,52962,KOCHI-MUMBAI,100212,All
2017,10,MUMBAI,KOCHI,53202,50410,KOCHI-MUMBAI,103612,All
2017,11,MUMBAI,KOCHI,53482,54634,KOCHI-MUMBAI,108116,All
2017,12,MUMBAI,KOCHI,60924,57972,KOCHI-MUMBAI,118896,All
2018,1,MUMBAI,KOCHI,59653,61377,KOCHI-MUMBAI,121030,All
2018,2,MUMBAI,KOCHI,52053,54078,KOCHI-MUMBAI,106131,All
2018,3,MUMBAI,KOCHI,57573,59045,KOCHI-MUMBAI,116618,All
2018,4,MUMBAI,KOCHI,60138,61436,KOCHI-MUMBAI,121574,All
2018,5,MUMBAI,KOCHI,62680,57804,KOCHI-MUMBAI,120484,All
2018,6,MUMBAI,KOCHI,50183,51970,KOCHI-MUMBAI,102153,All
2018,7,MUMBAI,KOCHI,59744,53857,KOCHI-MUMBAI,113601,All
2018,8,MUMBAI,KOCHI,30050,30180,KOCHI-MUMBAI,60230,All
2018,9,MUMBAI,KOCHI,48925,59159,KOCHI-MUMBAI,108084,All
2018,10,MUMBAI,KOCHI,44563,47574,KOCHI-MUMBAI,92137,All
2018,11,MUMBAI,KOCHI,50597,52141,KOCHI-MUMBAI,102738,All
2018,12,MUMBAI,KOCHI,56458,54258,KOCHI-MUMBAI,110716,All
2019,1,MUMBAI,KOCHI,53041,56176,KOCHI-MUMBAI,109217,All
2019,2,MUMBAI,KOCHI,46421,48443,KOCHI-MUMBAI,94864,All
2019,3,MUMBAI,KOCHI,42579,43141,KOCHI-MUMBAI,85720,All
2019,4,MUMBAI,KOCHI,42551,40259,KOCHI-MUMBAI,82810,All
2023,1,MUMBAI,KOCHI,35524,36950,KOCHI-MUMBAI,72474,All
2023,2,MUMBAI,KOCHI,34035,34075,KOCHI-MUMBAI,68110,All
2023,3,MUMBAI,KOCHI,33870,35108,KOCHI-MUMBAI,68978,All
2023,4,MUMBAI,KOCHI,42111,44796,KOCHI-MUMBAI,86907,All
2023,5,MUMBAI,KOCHI,43786,41885,KOCHI-MUMBAI,85671,All
2023,6,MUMBAI,KOCHI,45604,42906,KOCHI-MUMBAI,88510,All
2023,7,MUMBAI,KOCHI,42870,39514,KOCHI-MUMBAI,82384,All
2023,8,MUMBAI,KOCHI,41367,43056,KOCHI-MUMBAI,84423,All
2023,9,MUMBAI,KOCHI,42412,46288,KOCHI-MUMBAI,88700,All
2023,10,MUMBAI,KOCHI,36391,41576,KOCHI-MUMBAI,77967,All
2018,4,MUMBAI,KOLHAPUR,78,85,KOLHAPUR-MUMBAI,163,All
2018,5,MUMBAI,KOLHAPUR,212,238,KOLHAPUR-MUMBAI,450,All
2018,6,MUMBAI,KOLHAPUR,119,124,KOLHAPUR-MUMBAI,243,All
2018,7,MUMBAI,KOLHAPUR,8,14,KOLHAPUR-MUMBAI,22,All
2018,8,MUMBAI,KOLHAPUR,161,171,KOLHAPUR-MUMBAI,332,All
2018,9,MUMBAI,KOLHAPUR,138,124,KOLHAPUR-MUMBAI,262,All
2023,1,MUMBAI,KOLHAPUR,505,413,KOLHAPUR-MUMBAI,918,All
2023,2,MUMBAI,KOLHAPUR,486,433,KOLHAPUR-MUMBAI,919,All
2023,3,MUMBAI,KOLHAPUR,517,474,KOLHAPUR-MUMBAI,991,All
2023,4,MUMBAI,KOLHAPUR,636,597,KOLHAPUR-MUMBAI,1233,All
2023,5,MUMBAI,KOLHAPUR,722,710,KOLHAPUR-MUMBAI,1432,All
2023,6,MUMBAI,KOLHAPUR,695,597,KOLHAPUR-MUMBAI,1292,All
2023,7,MUMBAI,KOLHAPUR,690,680,KOLHAPUR-MUMBAI,1370,All
2023,8,MUMBAI,KOLHAPUR,707,715,KOLHAPUR-MUMBAI,1422,All
2023,9,MUMBAI,KOLHAPUR,658,630,KOLHAPUR-MUMBAI,1288,All
2023,10,MUMBAI,KOLHAPUR,1210,1141,KOLHAPUR-MUMBAI,2351,All
2015,4,MUMBAI,KOLKATA,68359,57219,KOLKATA-MUMBAI,125578,All
2015,5,MUMBAI,KOLKATA,72187,69072,KOLKATA-MUMBAI,141259,All
2015,6,MUMBAI,KOLKATA,59351,66193,KOLKATA-MUMBAI,125544,All
2015,7,MUMBAI,KOLKATA,62312,59607,KOLKATA-MUMBAI,121919,All
2015,8,MUMBAI,KOLKATA,62162,63001,KOLKATA-MUMBAI,125163,All
2015,9,MUMBAI,KOLKATA,64929,57655,KOLKATA-MUMBAI,122584,All
2015,10,MUMBAI,KOLKATA,71276,62072,KOLKATA-MUMBAI,133348,All
2015,11,MUMBAI,KOLKATA,70616,64672,KOLKATA-MUMBAI,135288,All
2015,12,MUMBAI,KOLKATA,72649,73071,KOLKATA-MUMBAI,145720,All
2016,1,MUMBAI,KOLKATA,69851,68028,KOLKATA-MUMBAI,137879,All
2016,2,MUMBAI,KOLKATA,64464,62769,KOLKATA-MUMBAI,127233,All
2016,3,MUMBAI,KOLKATA,67009,63629,KOLKATA-MUMBAI,130638,All
2016,4,MUMBAI,KOLKATA,72204,61352,KOLKATA-MUMBAI,133556,All
2016,5,MUMBAI,KOLKATA,74028,72659,KOLKATA-MUMBAI,146687,All
2016,6,MUMBAI,KOLKATA,62459,66492,KOLKATA-MUMBAI,128951,All
2016,7,MUMBAI,KOLKATA,67603,66492,KOLKATA-MUMBAI,134095,All
2016,8,MUMBAI,KOLKATA,66744,64301,KOLKATA-MUMBAI,131045,All
2016,9,MUMBAI,KOLKATA,70650,62334,KOLKATA-MUMBAI,132984,All
2016,10,MUMBAI,KOLKATA,77241,63421,KOLKATA-MUMBAI,140662,All
2016,11,MUMBAI,KOLKATA,69861,72046,KOLKATA-MUMBAI,141907,All
2016,12,MUMBAI,KOLKATA,77596,76442,KOLKATA-MUMBAI,154038,All
2017,1,MUMBAI,KOLKATA,79993,77717,KOLKATA-MUMBAI,157710,All
2017,2,MUMBAI,KOLKATA,70201,68933,KOLKATA-MUMBAI,139134,All
2017,3,MUMBAI,KOLKATA,70934,70767,KOLKATA-MUMBAI,141701,All
2017,4,MUMBAI,KOLKATA,74929,66091,KOLKATA-MUMBAI,141020,All
2017,5,MUMBAI,KOLKATA,81914,82374,KOLKATA-MUMBAI,164288,All
2017,6,MUMBAI,KOLKATA,73242,76319,KOLKATA-MUMBAI,149561,All
2017,7,MUMBAI,KOLKATA,66583,71923,KOLKATA-MUMBAI,138506,All
2017,8,MUMBAI,KOLKATA,78096,70833,KOLKATA-MUMBAI,148929,All
2017,9,MUMBAI,KOLKATA,75521,70805,KOLKATA-MUMBAI,146326,All
2017,10,MUMBAI,KOLKATA,87859,76466,KOLKATA-MUMBAI,164325,All
2017,11,MUMBAI,KOLKATA,85157,82333,KOLKATA-MUMBAI,167490,All
2017,12,MUMBAI,KOLKATA,92303,91462,KOLKATA-MUMBAI,183765,All
2018,1,MUMBAI,KOLKATA,91022,88494,KOLKATA-MUMBAI,179516,All
2018,2,MUMBAI,KOLKATA,83225,79419,KOLKATA-MUMBAI,162644,All
2018,3,MUMBAI,KOLKATA,86014,82042,KOLKATA-MUMBAI,168056,All
2018,4,MUMBAI,KOLKATA,89241,78112,KOLKATA-MUMBAI,167353,All
2018,5,MUMBAI,KOLKATA,85043,84349,KOLKATA-MUMBAI,169392,All
2018,6,MUMBAI,KOLKATA,80893,77261,KOLKATA-MUMBAI,158154,All
2018,7,MUMBAI,KOLKATA,79286,79146,KOLKATA-MUMBAI,158432,All
2018,8,MUMBAI,KOLKATA,85671,76190,KOLKATA-MUMBAI,161861,All
2018,9,MUMBAI,KOLKATA,77948,73246,KOLKATA-MUMBAI,151194,All
2018,10,MUMBAI,KOLKATA,85293,74960,KOLKATA-MUMBAI,160253,All
2018,11,MUMBAI,KOLKATA,86059,79280,KOLKATA-MUMBAI,165339,All
2018,12,MUMBAI,KOLKATA,89215,87045,KOLKATA-MUMBAI,176260,All
2019,1,MUMBAI,KOLKATA,93259,84904,KOLKATA-MUMBAI,178163,All
2019,2,MUMBAI,KOLKATA,77663,74159,KOLKATA-MUMBAI,151822,All
2019,3,MUMBAI,KOLKATA,72176,69536,KOLKATA-MUMBAI,141712,All
2019,4,MUMBAI,KOLKATA,72429,65030,KOLKATA-MUMBAI,137459,All
2023,1,MUMBAI,KOLKATA,74836,72950,KOLKATA-MUMBAI,147786,All
2023,2,MUMBAI,KOLKATA,69728,67422,KOLKATA-MUMBAI,137150,All
2023,3,MUMBAI,KOLKATA,70510,68131,KOLKATA-MUMBAI,138641,All
2023,4,MUMBAI,KOLKATA,67755,61401,KOLKATA-MUMBAI,129156,All
2023,5,MUMBAI,KOLKATA,73250,72569,KOLKATA-MUMBAI,145819,All
2023,6,MUMBAI,KOLKATA,70561,67797,KOLKATA-MUMBAI,138358,All
2023,7,MUMBAI,KOLKATA,67484,71945,KOLKATA-MUMBAI,139429,All
2023,8,MUMBAI,KOLKATA,72636,73910,KOLKATA-MUMBAI,146546,All
2023,9,MUMBAI,KOLKATA,72101,69745,KOLKATA-MUMBAI,141846,All
2023,10,MUMBAI,KOLKATA,81255,72670,KOLKATA-MUMBAI,153925,All
2015,4,MUMBAI,KOZHIKODE,8918,8305,KOZHIKODE-MUMBAI,17223,All
2015,5,MUMBAI,KOZHIKODE,10099,9080,KOZHIKODE-MUMBAI,19179,All
2015,6,MUMBAI,KOZHIKODE,8570,6958,KOZHIKODE-MUMBAI,15528,All
2015,7,MUMBAI,KOZHIKODE,9783,6987,KOZHIKODE-MUMBAI,16770,All
2015,8,MUMBAI,KOZHIKODE,8548,9667,KOZHIKODE-MUMBAI,18215,All
2015,9,MUMBAI,KOZHIKODE,6289,7106,KOZHIKODE-MUMBAI,13395,All
2015,10,MUMBAI,KOZHIKODE,6460,6677,KOZHIKODE-MUMBAI,13137,All
2015,11,MUMBAI,KOZHIKODE,10131,9674,KOZHIKODE-MUMBAI,19805,All
2015,12,MUMBAI,KOZHIKODE,11071,9639,KOZHIKODE-MUMBAI,20710,All
2016,1,MUMBAI,KOZHIKODE,9973,9768,KOZHIKODE-MUMBAI,19741,All
2016,2,MUMBAI,KOZHIKODE,8494,7942,KOZHIKODE-MUMBAI,16436,All
2016,3,MUMBAI,KOZHIKODE,9688,9665,KOZHIKODE-MUMBAI,19353,All
2016,4,MUMBAI,KOZHIKODE,11628,12104,KOZHIKODE-MUMBAI,23732,All
2016,5,MUMBAI,KOZHIKODE,13637,12183,KOZHIKODE-MUMBAI,25820,All
2016,6,MUMBAI,KOZHIKODE,11903,9663,KOZHIKODE-MUMBAI,21566,All
2016,7,MUMBAI,KOZHIKODE,13497,10767,KOZHIKODE-MUMBAI,24264,All
2016,8,MUMBAI,KOZHIKODE,11933,13033,KOZHIKODE-MUMBAI,24966,All
2016,9,MUMBAI,KOZHIKODE,11267,12591,KOZHIKODE-MUMBAI,23858,All
2016,10,MUMBAI,KOZHIKODE,10657,10214,KOZHIKODE-MUMBAI,20871,All
2016,11,MUMBAI,KOZHIKODE,10176,10003,KOZHIKODE-MUMBAI,20179,All
2016,12,MUMBAI,KOZHIKODE,12916,11381,KOZHIKODE-MUMBAI,24297,All
2017,1,MUMBAI,KOZHIKODE,12476,12848,KOZHIKODE-MUMBAI,25324,All
2017,2,MUMBAI,KOZHIKODE,9821,10169,KOZHIKODE-MUMBAI,19990,All
2017,3,MUMBAI,KOZHIKODE,9862,10834,KOZHIKODE-MUMBAI,20696,All
2017,4,MUMBAI,KOZHIKODE,11580,12139,KOZHIKODE-MUMBAI,23719,All
2017,5,MUMBAI,KOZHIKODE,14239,13361,KOZHIKODE-MUMBAI,27600,All
2017,6,MUMBAI,KOZHIKODE,12276,10086,KOZHIKODE-MUMBAI,22362,All
2017,7,MUMBAI,KOZHIKODE,15672,12284,KOZHIKODE-MUMBAI,27956,All
2017,8,MUMBAI,KOZHIKODE,15367,14724,KOZHIKODE-MUMBAI,30091,All
2017,9,MUMBAI,KOZHIKODE,11591,15263,KOZHIKODE-MUMBAI,26854,All
2017,10,MUMBAI,KOZHIKODE,12119,11458,KOZHIKODE-MUMBAI,23577,All
2017,11,MUMBAI,KOZHIKODE,11472,12398,KOZHIKODE-MUMBAI,23870,All
2017,12,MUMBAI,KOZHIKODE,12797,12447,KOZHIKODE-MUMBAI,25244,All
2018,1,MUMBAI,KOZHIKODE,11917,12987,KOZHIKODE-MUMBAI,24904,All
2018,2,MUMBAI,KOZHIKODE,11224,11782,KOZHIKODE-MUMBAI,23006,All
2018,3,MUMBAI,KOZHIKODE,12073,12875,KOZHIKODE-MUMBAI,24948,All
2018,4,MUMBAI,KOZHIKODE,12282,12278,KOZHIKODE-MUMBAI,24560,All
2018,5,MUMBAI,KOZHIKODE,13334,12077,KOZHIKODE-MUMBAI,25411,All
2018,6,MUMBAI,KOZHIKODE,10421,9133,KOZHIKODE-MUMBAI,19554,All
2018,7,MUMBAI,KOZHIKODE,14205,11742,KOZHIKODE-MUMBAI,25947,All
2018,8,MUMBAI,KOZHIKODE,15127,15212,KOZHIKODE-MUMBAI,30339,All
2018,9,MUMBAI,KOZHIKODE,9877,13379,KOZHIKODE-MUMBAI,23256,All
2018,10,MUMBAI,KOZHIKODE,9694,10760,KOZHIKODE-MUMBAI,20454,All
2018,11,MUMBAI,KOZHIKODE,9905,9830,KOZHIKODE-MUMBAI,19735,All
2018,12,MUMBAI,KOZHIKODE,12202,10174,KOZHIKODE-MUMBAI,22376,All
2019,1,MUMBAI,KOZHIKODE,9569,10735,KOZHIKODE-MUMBAI,20304,All
2019,2,MUMBAI,KOZHIKODE,7811,6783,KOZHIKODE-MUMBAI,14594,All
2019,3,MUMBAI,KOZHIKODE,6708,6023,KOZHIKODE-MUMBAI,12731,All
2019,4,MUMBAI,KOZHIKODE,8233,8222,KOZHIKODE-MUMBAI,16455,All
2023,1,MUMBAI,KOZHIKODE,9329,8814,KOZHIKODE-MUMBAI,18143,All
2023,2,MUMBAI,KOZHIKODE,8645,8729,KOZHIKODE-MUMBAI,17374,All
2023,3,MUMBAI,KOZHIKODE,8098,9475,KOZHIKODE-MUMBAI,17573,All
2023,4,MUMBAI,KOZHIKODE,9105,9249,KOZHIKODE-MUMBAI,18354,All
2023,5,MUMBAI,KOZHIKODE,11352,10350,KOZHIKODE-MUMBAI,21702,All
2023,6,MUMBAI,KOZHIKODE,7807,9059,KOZHIKODE-MUMBAI,16866,All
2023,7,MUMBAI,KOZHIKODE,10823,7095,KOZHIKODE-MUMBAI,17918,All
2023,8,MUMBAI,KOZHIKODE,10374,10583,KOZHIKODE-MUMBAI,20957,All
2023,9,MUMBAI,KOZHIKODE,7510,9303,KOZHIKODE-MUMBAI,16813,All
2023,10,MUMBAI,KOZHIKODE,7608,8617,KOZHIKODE-MUMBAI,16225,All
2016,4,MUMBAI,LEH,2896,0,LEH-MUMBAI,2896,All
2016,5,MUMBAI,LEH,5322,0,LEH-MUMBAI,5322,All
2016,6,MUMBAI,LEH,3557,0,LEH-MUMBAI,3557,All
2016,7,MUMBAI,LEH,4189,0,LEH-MUMBAI,4189,All
2016,8,MUMBAI,LEH,3605,0,LEH-MUMBAI,3605,All
2016,9,MUMBAI,LEH,2697,0,LEH-MUMBAI,2697,All
2017,5,MUMBAI,LEH,5420,0,LEH-MUMBAI,5420,All
2017,6,MUMBAI,LEH,4389,0,LEH-MUMBAI,4389,All
2017,7,MUMBAI,LEH,3834,0,LEH-MUMBAI,3834,All
2017,8,MUMBAI,LEH,3108,0,LEH-MUMBAI,3108,All
2017,9,MUMBAI,LEH,2960,0,LEH-MUMBAI,2960,All
2018,5,MUMBAI,LEH,5243,0,LEH-MUMBAI,5243,All
2018,6,MUMBAI,LEH,4807,0,LEH-MUMBAI,4807,All
2018,7,MUMBAI,LEH,5069,0,LEH-MUMBAI,5069,All
2018,8,MUMBAI,LEH,4397,0,LEH-MUMBAI,4397,All
2018,9,MUMBAI,LEH,3742,0,LEH-MUMBAI,3742,All
2023,3,MUMBAI,LEH,1431,10,LEH-MUMBAI,1441,All
2023,4,MUMBAI,LEH,5864,118,LEH-MUMBAI,5982,All
2023,5,MUMBAI,LEH,3672,2962,LEH-MUMBAI,6634,All
2023,6,MUMBAI,LEH,4061,4272,LEH-MUMBAI,8333,All
2023,7,MUMBAI,LEH,3108,3408,LEH-MUMBAI,6516,All
2023,8,MUMBAI,LEH,2256,3283,LEH-MUMBAI,5539,All
2023,9,MUMBAI,LEH,1850,2469,LEH-MUMBAI,4319,All
2015,4,MUMBAI,LUCKNOW,30039,24317,LUCKNOW-MUMBAI,54356,All
2015,5,MUMBAI,LUCKNOW,30825,28173,LUCKNOW-MUMBAI,58998,All
2015,6,MUMBAI,LUCKNOW,27250,30128,LUCKNOW-MUMBAI,57378,All
2015,7,MUMBAI,LUCKNOW,27848,27081,LUCKNOW-MUMBAI,54929,All
2015,8,MUMBAI,LUCKNOW,28198,26312,LUCKNOW-MUMBAI,54510,All
2015,9,MUMBAI,LUCKNOW,27332,23105,LUCKNOW-MUMBAI,50437,All
2015,10,MUMBAI,LUCKNOW,28272,22538,LUCKNOW-MUMBAI,50810,All
2015,11,MUMBAI,LUCKNOW,29220,24108,LUCKNOW-MUMBAI,53328,All
2015,12,MUMBAI,LUCKNOW,27107,30401,LUCKNOW-MUMBAI,57508,All
2016,1,MUMBAI,LUCKNOW,28295,27325,LUCKNOW-MUMBAI,55620,All
2016,2,MUMBAI,LUCKNOW,26993,24548,LUCKNOW-MUMBAI,51541,All
2016,3,MUMBAI,LUCKNOW,30178,25980,LUCKNOW-MUMBAI,56158,All
2016,4,MUMBAI,LUCKNOW,27774,24439,LUCKNOW-MUMBAI,52213,All
2016,5,MUMBAI,LUCKNOW,27712,27358,LUCKNOW-MUMBAI,55070,All
2016,6,MUMBAI,LUCKNOW,25710,25121,LUCKNOW-MUMBAI,50831,All
2016,7,MUMBAI,LUCKNOW,26812,25513,LUCKNOW-MUMBAI,52325,All
2016,8,MUMBAI,LUCKNOW,27791,25346,LUCKNOW-MUMBAI,53137,All
2016,9,MUMBAI,LUCKNOW,27923,25629,LUCKNOW-MUMBAI,53552,All
2016,10,MUMBAI,LUCKNOW,28304,23932,LUCKNOW-MUMBAI,52236,All
2016,11,MUMBAI,LUCKNOW,25017,26233,LUCKNOW-MUMBAI,51250,All
2016,12,MUMBAI,LUCKNOW,31034,30747,LUCKNOW-MUMBAI,61781,All
2017,1,MUMBAI,LUCKNOW,30767,27197,LUCKNOW-MUMBAI,57964,All
2017,2,MUMBAI,LUCKNOW,27274,24655,LUCKNOW-MUMBAI,51929,All
2017,3,MUMBAI,LUCKNOW,28030,27788,LUCKNOW-MUMBAI,55818,All
2017,4,MUMBAI,LUCKNOW,30695,26245,LUCKNOW-MUMBAI,56940,All
2017,5,MUMBAI,LUCKNOW,29928,29141,LUCKNOW-MUMBAI,59069,All
2017,6,MUMBAI,LUCKNOW,28632,28672,LUCKNOW-MUMBAI,57304,All
2017,7,MUMBAI,LUCKNOW,27186,27725,LUCKNOW-MUMBAI,54911,All
2017,8,MUMBAI,LUCKNOW,28778,27572,LUCKNOW-MUMBAI,56350,All
2017,9,MUMBAI,LUCKNOW,28195,26150,LUCKNOW-MUMBAI,54345,All
2017,10,MUMBAI,LUCKNOW,32411,27327,LUCKNOW-MUMBAI,59738,All
2017,11,MUMBAI,LUCKNOW,31436,30090,LUCKNOW-MUMBAI,61526,All
2017,12,MUMBAI,LUCKNOW,31807,32020,LUCKNOW-MUMBAI,63827,All
2018,1,MUMBAI,LUCKNOW,32484,30016,LUCKNOW-MUMBAI,62500,All
2018,2,MUMBAI,LUCKNOW,32616,29547,LUCKNOW-MUMBAI,62163,All
2018,3,MUMBAI,LUCKNOW,31822,30206,LUCKNOW-MUMBAI,62028,All
2018,4,MUMBAI,LUCKNOW,34137,28411,LUCKNOW-MUMBAI,62548,All
2018,5,MUMBAI,LUCKNOW,36017,36245,LUCKNOW-MUMBAI,72262,All
2018,6,MUMBAI,LUCKNOW,30937,29449,LUCKNOW-MUMBAI,60386,All
2018,7,MUMBAI,LUCKNOW,33428,33167,LUCKNOW-MUMBAI,66595,All
2018,8,MUMBAI,LUCKNOW,32654,30008,LUCKNOW-MUMBAI,62662,All
2018,9,MUMBAI,LUCKNOW,33472,32400,LUCKNOW-MUMBAI,65872,All
2018,10,MUMBAI,LUCKNOW,33840,28017,LUCKNOW-MUMBAI,61857,All
2018,11,MUMBAI,LUCKNOW,30565,26681,LUCKNOW-MUMBAI,57246,All
2018,12,MUMBAI,LUCKNOW,31857,34461,LUCKNOW-MUMBAI,66318,All
2019,1,MUMBAI,LUCKNOW,34544,28685,LUCKNOW-MUMBAI,63229,All
2019,2,MUMBAI,LUCKNOW,28001,26850,LUCKNOW-MUMBAI,54851,All
2019,3,MUMBAI,LUCKNOW,25087,24655,LUCKNOW-MUMBAI,49742,All
2019,4,MUMBAI,LUCKNOW,27065,22096,LUCKNOW-MUMBAI,49161,All
2023,1,MUMBAI,LUCKNOW,49250,43961,LUCKNOW-MUMBAI,93211,All
2023,2,MUMBAI,LUCKNOW,45808,41980,LUCKNOW-MUMBAI,87788,All
2023,3,MUMBAI,LUCKNOW,40843,40854,LUCKNOW-MUMBAI,81697,All
2023,4,MUMBAI,LUCKNOW,37194,30854,LUCKNOW-MUMBAI,68048,All
2023,5,MUMBAI,LUCKNOW,32235,30602,LUCKNOW-MUMBAI,62837,All
2023,6,MUMBAI,LUCKNOW,34967,36878,LUCKNOW-MUMBAI,71845,All
2023,7,MUMBAI,LUCKNOW,39012,41074,LUCKNOW-MUMBAI,80086,All
2023,8,MUMBAI,LUCKNOW,45068,44178,LUCKNOW-MUMBAI,89246,All
2023,9,MUMBAI,LUCKNOW,42875,40039,LUCKNOW-MUMBAI,82914,All
2023,10,MUMBAI,LUCKNOW,47394,36750,LUCKNOW-MUMBAI,84144,All
2015,4,MUMBAI,MADURAI,1317,1368,MADURAI-MUMBAI,2685,All
2015,5,MUMBAI,MADURAI,1409,1368,MADURAI-MUMBAI,2777,All
2015,6,MUMBAI,MADURAI,1306,1220,MADURAI-MUMBAI,2526,All
2015,7,MUMBAI,MADURAI,1491,1307,MADURAI-MUMBAI,2798,All
2015,8,MUMBAI,MADURAI,1637,1628,MADURAI-MUMBAI,3265,All
2015,9,MUMBAI,MADURAI,1384,1595,MADURAI-MUMBAI,2979,All
2015,10,MUMBAI,MADURAI,3600,2037,MADURAI-MUMBAI,5637,All
2015,11,MUMBAI,MADURAI,2234,2058,MADURAI-MUMBAI,4292,All
2015,12,MUMBAI,MADURAI,2910,2237,MADURAI-MUMBAI,5147,All
2016,1,MUMBAI,MADURAI,2786,2326,MADURAI-MUMBAI,5112,All
2016,2,MUMBAI,MADURAI,2373,1983,MADURAI-MUMBAI,4356,All
2016,3,MUMBAI,MADURAI,2633,2360,MADURAI-MUMBAI,4993,All
2016,4,MUMBAI,MADURAI,2538,2208,MADURAI-MUMBAI,4746,All
2016,5,MUMBAI,MADURAI,3306,2865,MADURAI-MUMBAI,6171,All
2016,6,MUMBAI,MADURAI,2593,2366,MADURAI-MUMBAI,4959,All
2016,7,MUMBAI,MADURAI,2854,2342,MADURAI-MUMBAI,5196,All
2016,8,MUMBAI,MADURAI,2970,2610,MADURAI-MUMBAI,5580,All
2016,9,MUMBAI,MADURAI,2548,2419,MADURAI-MUMBAI,4967,All
2016,10,MUMBAI,MADURAI,2799,2575,MADURAI-MUMBAI,5374,All
2016,11,MUMBAI,MADURAI,2808,3106,MADURAI-MUMBAI,5914,All
2016,12,MUMBAI,MADURAI,2702,2339,MADURAI-MUMBAI,5041,All
2017,1,MUMBAI,MADURAI,2614,2434,MADURAI-MUMBAI,5048,All
2017,2,MUMBAI,MADURAI,2223,2024,MADURAI-MUMBAI,4247,All
2017,3,MUMBAI,MADURAI,2571,2496,MADURAI-MUMBAI,5067,All
2017,4,MUMBAI,MADURAI,4892,4424,MADURAI-MUMBAI,9316,All
2017,5,MUMBAI,MADURAI,6360,5542,MADURAI-MUMBAI,11902,All
2017,6,MUMBAI,MADURAI,5427,5556,MADURAI-MUMBAI,10983,All
2017,7,MUMBAI,MADURAI,5309,5335,MADURAI-MUMBAI,10644,All
2017,8,MUMBAI,MADURAI,5577,5440,MADURAI-MUMBAI,11017,All
2017,9,MUMBAI,MADURAI,4872,5241,MADURAI-MUMBAI,10113,All
2017,10,MUMBAI,MADURAI,5025,4767,MADURAI-MUMBAI,9792,All
2017,11,MUMBAI,MADURAI,5110,5054,MADURAI-MUMBAI,10164,All
2017,12,MUMBAI,MADURAI,6586,5868,MADURAI-MUMBAI,12454,All
2018,1,MUMBAI,MADURAI,6446,6301,MADURAI-MUMBAI,12747,All
2018,2,MUMBAI,MADURAI,5547,5609,MADURAI-MUMBAI,11156,All
2018,3,MUMBAI,MADURAI,6420,5961,MADURAI-MUMBAI,12381,All
2018,4,MUMBAI,MADURAI,6803,6914,MADURAI-MUMBAI,13717,All
2018,5,MUMBAI,MADURAI,8553,7318,MADURAI-MUMBAI,15871,All
2018,6,MUMBAI,MADURAI,6257,6990,MADURAI-MUMBAI,13247,All
2018,7,MUMBAI,MADURAI,6437,6161,MADURAI-MUMBAI,12598,All
2018,8,MUMBAI,MADURAI,8032,7723,MADURAI-MUMBAI,15755,All
2018,9,MUMBAI,MADURAI,5756,6052,MADURAI-MUMBAI,11808,All
2018,10,MUMBAI,MADURAI,5959,5924,MADURAI-MUMBAI,11883,All
2018,11,MUMBAI,MADURAI,6231,6210,MADURAI-MUMBAI,12441,All
2018,12,MUMBAI,MADURAI,6752,6285,MADURAI-MUMBAI,13037,All
2019,1,MUMBAI,MADURAI,5709,5588,MADURAI-MUMBAI,11297,All
2019,2,MUMBAI,MADURAI,3043,2879,MADURAI-MUMBAI,5922,All
2019,3,MUMBAI,MADURAI,2335,2205,MADURAI-MUMBAI,4540,All
2019,4,MUMBAI,MADURAI,2396,2172,MADURAI-MUMBAI,4568,All
2023,1,MUMBAI,MADURAI,12647,12114,MADURAI-MUMBAI,24761,All
2023,2,MUMBAI,MADURAI,11260,11737,MADURAI-MUMBAI,22997,All
2023,3,MUMBAI,MADURAI,11137,11128,MADURAI-MUMBAI,22265,All
2023,4,MUMBAI,MADURAI,11169,10610,MADURAI-MUMBAI,21779,All
2023,5,MUMBAI,MADURAI,8589,8074,MADURAI-MUMBAI,16663,All
2023,6,MUMBAI,MADURAI,8175,7388,MADURAI-MUMBAI,15563,All
2023,7,MUMBAI,MADURAI,7909,6748,MADURAI-MUMBAI,14657,All
2023,8,MUMBAI,MADURAI,7788,8178,MADURAI-MUMBAI,15966,All
2023,9,MUMBAI,MADURAI,7412,7190,MADURAI-MUMBAI,14602,All
2023,10,MUMBAI,MADURAI,6918,6156,MADURAI-MUMBAI,13074,All
2015,4,MUMBAI,MANGALORE,23143,21606,MANGALORE-MUMBAI,44749,All
2015,5,MUMBAI,MANGALORE,22567,22605,MANGALORE-MUMBAI,45172,All
2015,6,MUMBAI,MANGALORE,19221,19830,MANGALORE-MUMBAI,39051,All
2015,7,MUMBAI,MANGALORE,23412,18641,MANGALORE-MUMBAI,42053,All
2015,8,MUMBAI,MANGALORE,20856,21711,MANGALORE-MUMBAI,42567,All
2015,9,MUMBAI,MANGALORE,20827,22700,MANGALORE-MUMBAI,43527,All
2015,10,MUMBAI,MANGALORE,21863,21649,MANGALORE-MUMBAI,43512,All
2015,11,MUMBAI,MANGALORE,20575,19438,MANGALORE-MUMBAI,40013,All
2015,12,MUMBAI,MANGALORE,22285,20216,MANGALORE-MUMBAI,42501,All
2016,1,MUMBAI,MANGALORE,21719,21343,MANGALORE-MUMBAI,43062,All
2016,2,MUMBAI,MANGALORE,19816,19263,MANGALORE-MUMBAI,39079,All
2016,3,MUMBAI,MANGALORE,21553,21156,MANGALORE-MUMBAI,42709,All
2016,4,MUMBAI,MANGALORE,25572,23655,MANGALORE-MUMBAI,49227,All
2016,5,MUMBAI,MANGALORE,25815,25505,MANGALORE-MUMBAI,51320,All
2016,6,MUMBAI,MANGALORE,24236,22087,MANGALORE-MUMBAI,46323,All
2016,7,MUMBAI,MANGALORE,27664,24238,MANGALORE-MUMBAI,51902,All
2016,8,MUMBAI,MANGALORE,24758,24561,MANGALORE-MUMBAI,49319,All
2016,9,MUMBAI,MANGALORE,22713,23370,MANGALORE-MUMBAI,46083,All
2016,10,MUMBAI,MANGALORE,24119,22052,MANGALORE-MUMBAI,46171,All
2016,11,MUMBAI,MANGALORE,20293,22012,MANGALORE-MUMBAI,42305,All
2016,12,MUMBAI,MANGALORE,26494,25390,MANGALORE-MUMBAI,51884,All
2017,1,MUMBAI,MANGALORE,26148,26368,MANGALORE-MUMBAI,52516,All
2017,2,MUMBAI,MANGALORE,21874,22344,MANGALORE-MUMBAI,44218,All
2017,3,MUMBAI,MANGALORE,22460,22308,MANGALORE-MUMBAI,44768,All
2017,4,MUMBAI,MANGALORE,26590,25428,MANGALORE-MUMBAI,52018,All
2017,5,MUMBAI,MANGALORE,33116,33122,MANGALORE-MUMBAI,66238,All
2017,6,MUMBAI,MANGALORE,27076,26933,MANGALORE-MUMBAI,54009,All
2017,7,MUMBAI,MANGALORE,29947,26725,MANGALORE-MUMBAI,56672,All
2017,8,MUMBAI,MANGALORE,28449,29052,MANGALORE-MUMBAI,57501,All
2017,9,MUMBAI,MANGALORE,22980,29494,MANGALORE-MUMBAI,52474,All
2017,10,MUMBAI,MANGALORE,32896,32032,MANGALORE-MUMBAI,64928,All
2017,11,MUMBAI,MANGALORE,35317,34742,MANGALORE-MUMBAI,70059,All
2017,12,MUMBAI,MANGALORE,37553,36098,MANGALORE-MUMBAI,73651,All
2018,1,MUMBAI,MANGALORE,35574,35371,MANGALORE-MUMBAI,70945,All
2018,2,MUMBAI,MANGALORE,31017,30969,MANGALORE-MUMBAI,61986,All
2018,3,MUMBAI,MANGALORE,33909,32537,MANGALORE-MUMBAI,66446,All
2018,4,MUMBAI,MANGALORE,31710,30896,MANGALORE-MUMBAI,62606,All
2018,5,MUMBAI,MANGALORE,32666,32718,MANGALORE-MUMBAI,65384,All
2018,6,MUMBAI,MANGALORE,28554,28572,MANGALORE-MUMBAI,57126,All
2018,7,MUMBAI,MANGALORE,25075,23911,MANGALORE-MUMBAI,48986,All
2018,8,MUMBAI,MANGALORE,24815,24431,MANGALORE-MUMBAI,49246,All
2018,9,MUMBAI,MANGALORE,21076,22912,MANGALORE-MUMBAI,43988,All
2018,10,MUMBAI,MANGALORE,24788,25806,MANGALORE-MUMBAI,50594,All
2018,11,MUMBAI,MANGALORE,25041,24197,MANGALORE-MUMBAI,49238,All
2018,12,MUMBAI,MANGALORE,27816,26627,MANGALORE-MUMBAI,54443,All
2019,1,MUMBAI,MANGALORE,26438,27560,MANGALORE-MUMBAI,53998,All
2019,2,MUMBAI,MANGALORE,20154,19937,MANGALORE-MUMBAI,40091,All
2019,3,MUMBAI,MANGALORE,16323,16374,MANGALORE-MUMBAI,32697,All
2019,4,MUMBAI,MANGALORE,15609,15438,MANGALORE-MUMBAI,31047,All
2023,1,MUMBAI,MANGALORE,20825,21073,MANGALORE-MUMBAI,41898,All
2023,2,MUMBAI,MANGALORE,17390,17706,MANGALORE-MUMBAI,35096,All
2023,3,MUMBAI,MANGALORE,18226,18444,MANGALORE-MUMBAI,36670,All
2023,4,MUMBAI,MANGALORE,16515,16505,MANGALORE-MUMBAI,33020,All
2023,5,MUMBAI,MANGALORE,18545,17949,MANGALORE-MUMBAI,36494,All
2023,6,MUMBAI,MANGALORE,24307,22017,MANGALORE-MUMBAI,46324,All
2023,7,MUMBAI,MANGALORE,27279,23467,MANGALORE-MUMBAI,50746,All
2023,8,MUMBAI,MANGALORE,25769,28200,MANGALORE-MUMBAI,53969,All
2023,9,MUMBAI,MANGALORE,24025,26434,MANGALORE-MUMBAI,50459,All
2023,10,MUMBAI,MANGALORE,23004,25627,MANGALORE-MUMBAI,48631,All
2023,1,MUMBAI,Malvan,986,968,Malvan-MUMBAI,1954,All
2023,6,MUMBAI,Malvan,611,739,Malvan-MUMBAI,1350,All
2023,7,MUMBAI,Malvan,212,239,Malvan-MUMBAI,451,All
2023,8,MUMBAI,Malvan,510,401,Malvan-MUMBAI,911,All
2023,9,MUMBAI,Malvan,811,513,Malvan-MUMBAI,1324,All
2023,10,MUMBAI,Malvan,672,756,Malvan-MUMBAI,1428,All
2015,4,MUMBAI,NAGPUR,27508,27491,MUMBAI-NAGPUR,54999,All
2015,5,MUMBAI,NAGPUR,27213,29164,MUMBAI-NAGPUR,56377,All
2015,6,MUMBAI,NAGPUR,26135,27465,MUMBAI-NAGPUR,53600,All
2015,7,MUMBAI,NAGPUR,25985,26730,MUMBAI-NAGPUR,52715,All
2015,8,MUMBAI,NAGPUR,25883,27398,MUMBAI-NAGPUR,53281,All
2015,9,MUMBAI,NAGPUR,24704,26441,MUMBAI-NAGPUR,51145,All
2015,10,MUMBAI,NAGPUR,23069,22576,MUMBAI-NAGPUR,45645,All
2015,11,MUMBAI,NAGPUR,28608,28169,MUMBAI-NAGPUR,56777,All
2015,12,MUMBAI,NAGPUR,31441,32064,MUMBAI-NAGPUR,63505,All
2016,1,MUMBAI,NAGPUR,29901,31848,MUMBAI-NAGPUR,61749,All
2016,2,MUMBAI,NAGPUR,27221,28886,MUMBAI-NAGPUR,56107,All
2016,3,MUMBAI,NAGPUR,28337,29553,MUMBAI-NAGPUR,57890,All
2016,4,MUMBAI,NAGPUR,28456,28515,MUMBAI-NAGPUR,56971,All
2016,5,MUMBAI,NAGPUR,29422,31253,MUMBAI-NAGPUR,60675,All
2016,6,MUMBAI,NAGPUR,28113,28551,MUMBAI-NAGPUR,56664,All
2016,7,MUMBAI,NAGPUR,28585,29187,MUMBAI-NAGPUR,57772,All
2016,8,MUMBAI,NAGPUR,28487,29422,MUMBAI-NAGPUR,57909,All
2016,9,MUMBAI,NAGPUR,26874,28464,MUMBAI-NAGPUR,55338,All
2016,10,MUMBAI,NAGPUR,28410,26242,MUMBAI-NAGPUR,54652,All
2016,11,MUMBAI,NAGPUR,29760,33588,MUMBAI-NAGPUR,63348,All
2016,12,MUMBAI,NAGPUR,35598,36494,MUMBAI-NAGPUR,72092,All
2017,1,MUMBAI,NAGPUR,33459,35866,MUMBAI-NAGPUR,69325,All
2017,2,MUMBAI,NAGPUR,28356,30329,MUMBAI-NAGPUR,58685,All
2017,3,MUMBAI,NAGPUR,30671,32183,MUMBAI-NAGPUR,62854,All
2017,4,MUMBAI,NAGPUR,29859,30156,MUMBAI-NAGPUR,60015,All
2017,5,MUMBAI,NAGPUR,32276,33010,MUMBAI-NAGPUR,65286,All
2017,6,MUMBAI,NAGPUR,31145,31197,MUMBAI-NAGPUR,62342,All
2017,7,MUMBAI,NAGPUR,29425,30585,MUMBAI-NAGPUR,60010,All
2017,8,MUMBAI,NAGPUR,29901,29879,MUMBAI-NAGPUR,59780,All
2017,9,MUMBAI,NAGPUR,27475,28411,MUMBAI-NAGPUR,55886,All
2017,10,MUMBAI,NAGPUR,28364,29054,MUMBAI-NAGPUR,57418,All
2017,11,MUMBAI,NAGPUR,30230,31038,MUMBAI-NAGPUR,61268,All
2017,12,MUMBAI,NAGPUR,36127,40817,MUMBAI-NAGPUR,76944,All
2018,1,MUMBAI,NAGPUR,36296,39764,MUMBAI-NAGPUR,76060,All
2018,2,MUMBAI,NAGPUR,31336,32847,MUMBAI-NAGPUR,64183,All
2018,3,MUMBAI,NAGPUR,31264,31358,MUMBAI-NAGPUR,62622,All
2018,4,MUMBAI,NAGPUR,31363,30773,MUMBAI-NAGPUR,62136,All
2018,5,MUMBAI,NAGPUR,31883,33070,MUMBAI-NAGPUR,64953,All
2018,6,MUMBAI,NAGPUR,30604,30677,MUMBAI-NAGPUR,61281,All
2018,7,MUMBAI,NAGPUR,31512,32328,MUMBAI-NAGPUR,63840,All
2018,8,MUMBAI,NAGPUR,34427,34083,MUMBAI-NAGPUR,68510,All
2018,9,MUMBAI,NAGPUR,33459,34018,MUMBAI-NAGPUR,67477,All
2018,10,MUMBAI,NAGPUR,33018,31456,MUMBAI-NAGPUR,64474,All
2018,11,MUMBAI,NAGPUR,32490,32048,MUMBAI-NAGPUR,64538,All
2018,12,MUMBAI,NAGPUR,36351,35957,MUMBAI-NAGPUR,72308,All
2019,1,MUMBAI,NAGPUR,35315,36556,MUMBAI-NAGPUR,71871,All
2019,2,MUMBAI,NAGPUR,29616,31545,MUMBAI-NAGPUR,61161,All
2019,3,MUMBAI,NAGPUR,24628,25901,MUMBAI-NAGPUR,50529,All
2019,4,MUMBAI,NAGPUR,25809,24368,MUMBAI-NAGPUR,50177,All
2019,5,MUMBAI,NAGPUR,37832,37201,MUMBAI-NAGPUR,75033,All
2019,6,MUMBAI,NAGPUR,38646,39488,MUMBAI-NAGPUR,78134,All
2019,7,MUMBAI,NAGPUR,35128,34188,MUMBAI-NAGPUR,69316,All
2019,8,MUMBAI,NAGPUR,36661,35357,MUMBAI-NAGPUR,72018,All
2019,9,MUMBAI,NAGPUR,34434,34262,MUMBAI-NAGPUR,68696,All
2019,10,MUMBAI,NAGPUR,36982,31035,MUMBAI-NAGPUR,68017,All
2019,11,MUMBAI,NAGPUR,36967,38388,MUMBAI-NAGPUR,75355,All
2019,12,MUMBAI,NAGPUR,39298,39684,MUMBAI-NAGPUR,78982,All
2020,1,MUMBAI,NAGPUR,38481,38555,MUMBAI-NAGPUR,77036,All
2020,2,MUMBAI,NAGPUR,36872,36724,MUMBAI-NAGPUR,73596,All
2020,3,MUMBAI,NAGPUR,22362,18587,MUMBAI-NAGPUR,40949,All
2020,5,MUMBAI,NAGPUR,1141,293,MUMBAI-NAGPUR,1434,All
2020,6,MUMBAI,NAGPUR,3993,3194,MUMBAI-NAGPUR,7187,All
2020,7,MUMBAI,NAGPUR,6322,4226,MUMBAI-NAGPUR,10548,All
2020,8,MUMBAI,NAGPUR,8345,7898,MUMBAI-NAGPUR,16243,All
2020,9,MUMBAI,NAGPUR,10452,13436,MUMBAI-NAGPUR,23888,All
2020,10,MUMBAI,NAGPUR,16180,16461,MUMBAI-NAGPUR,32641,All
2020,11,MUMBAI,NAGPUR,25065,24027,MUMBAI-NAGPUR,49092,All
2020,12,MUMBAI,NAGPUR,33559,23983,MUMBAI-NAGPUR,57542,All
2021,1,MUMBAI,NAGPUR,25265,29233,MUMBAI-NAGPUR,54498,All
2021,2,MUMBAI,NAGPUR,24591,27156,MUMBAI-NAGPUR,51747,All
2021,3,MUMBAI,NAGPUR,16882,18572,MUMBAI-NAGPUR,35454,All
2021,4,MUMBAI,NAGPUR,10693,9378,MUMBAI-NAGPUR,20071,All
2021,6,MUMBAI,NAGPUR,15263,16166,MUMBAI-NAGPUR,31429,All
2021,7,MUMBAI,NAGPUR,20655,20580,MUMBAI-NAGPUR,41235,All
2021,8,MUMBAI,NAGPUR,26307,27340,MUMBAI-NAGPUR,53647,All
2021,9,MUMBAI,NAGPUR,25649,26618,MUMBAI-NAGPUR,52267,All
2021,10,MUMBAI,NAGPUR,33982,30693,MUMBAI-NAGPUR,64675,All
2021,11,MUMBAI,NAGPUR,36746,39512,MUMBAI-NAGPUR,76258,All
2021,12,MUMBAI,NAGPUR,35183,36212,MUMBAI-NAGPUR,71395,All
2022,1,MUMBAI,NAGPUR,19331,21193,MUMBAI-NAGPUR,40524,All
2022,2,MUMBAI,NAGPUR,24232,24853,MUMBAI-NAGPUR,49085,All
2022,3,MUMBAI,NAGPUR,35609,36950,MUMBAI-NAGPUR,72559,All
2022,4,MUMBAI,NAGPUR,29969,32223,MUMBAI-NAGPUR,62192,All
2022,5,MUMBAI,NAGPUR,30726,35137,MUMBAI-NAGPUR,65863,All
2022,6,MUMBAI,NAGPUR,27370,31021,MUMBAI-NAGPUR,58391,All
2022,7,MUMBAI,NAGPUR,24737,26379,MUMBAI-NAGPUR,51116,All
2022,8,MUMBAI,NAGPUR,29337,31259,MUMBAI-NAGPUR,60596,All
2022,9,MUMBAI,NAGPUR,29573,32680,MUMBAI-NAGPUR,62253,All
2022,10,MUMBAI,NAGPUR,30154,27280,MUMBAI-NAGPUR,57434,All
2022,11,MUMBAI,NAGPUR,30970,34296,MUMBAI-NAGPUR,65266,All
2022,12,MUMBAI,NAGPUR,32919,33185,MUMBAI-NAGPUR,66104,All
2023,1,MUMBAI,NAGPUR,34617,35829,MUMBAI-NAGPUR,70446,All
2023,2,MUMBAI,NAGPUR,33542,33899,MUMBAI-NAGPUR,67441,All
2023,3,MUMBAI,NAGPUR,35084,34759,MUMBAI-NAGPUR,69843,All
2023,4,MUMBAI,NAGPUR,35819,35242,MUMBAI-NAGPUR,71061,All
2023,5,MUMBAI,NAGPUR,33432,34612,MUMBAI-NAGPUR,68044,All
2023,6,MUMBAI,NAGPUR,34650,34645,MUMBAI-NAGPUR,69295,All
2023,7,MUMBAI,NAGPUR,31422,32457,MUMBAI-NAGPUR,63879,All
2023,8,MUMBAI,NAGPUR,30764,31738,MUMBAI-NAGPUR,62502,All
2023,9,MUMBAI,NAGPUR,29168,29332,MUMBAI-NAGPUR,58500,All
2023,10,MUMBAI,NAGPUR,27790,26766,MUMBAI-NAGPUR,54556,All
2023,11,MUMBAI,NAGPUR,28795,27279,MUMBAI-NAGPUR,56074,All
2023,12,MUMBAI,NAGPUR,25570,26431,MUMBAI-NAGPUR,52001,All
2024,1,MUMBAI,NAGPUR,27323,27955,MUMBAI-NAGPUR,55278,All
2024,2,MUMBAI,NAGPUR,26352,26272,MUMBAI-NAGPUR,52624,All
2024,3,MUMBAI,NAGPUR,27919,27948,MUMBAI-NAGPUR,55867,All
2024,4,MUMBAI,NAGPUR,25916,25388,MUMBAI-NAGPUR,51304,All
2024,6,MUMBAI,NAGPUR,26494,26434,MUMBAI-NAGPUR,52928,All
2024,7,MUMBAI,NAGPUR,28441,27745,MUMBAI-NAGPUR,56186,All
2024,8,MUMBAI,NAGPUR,27778,28007,MUMBAI-NAGPUR,55785,All
2024,9,MUMBAI,NAGPUR,28341,28566,MUMBAI-NAGPUR,56907,All
2024,10,MUMBAI,NAGPUR,30927,28238,MUMBAI-NAGPUR,59165,All
2024,11,MUMBAI,NAGPUR,29590,30583,MUMBAI-NAGPUR,60173,All
2024,12,MUMBAI,NAGPUR,32035,32670,MUMBAI-NAGPUR,64705,All
2025,1,MUMBAI,NAGPUR,31479,31675,MUMBAI-NAGPUR,63154,All
2025,2,MUMBAI,NAGPUR,29368,29126,MUMBAI-NAGPUR,58494,All
2025,3,MUMBAI,NAGPUR,28859,28440,MUMBAI-NAGPUR,57299,All
2017,11,MUMBAI,NANDED,760,801,MUMBAI-NANDED,1561,All
2017,12,MUMBAI,NANDED,1728,1715,MUMBAI-NANDED,3443,All
2018,1,MUMBAI,NANDED,1788,1881,MUMBAI-NANDED,3669,All
2018,2,MUMBAI,NANDED,1739,1723,MUMBAI-NANDED,3462,All
2018,3,MUMBAI,NANDED,1765,1784,MUMBAI-NANDED,3549,All
2018,4,MUMBAI,NANDED,1701,1750,MUMBAI-NANDED,3451,All
2018,5,MUMBAI,NANDED,1928,1980,MUMBAI-NANDED,3908,All
2018,6,MUMBAI,NANDED,1793,1868,MUMBAI-NANDED,3661,All
2018,7,MUMBAI,NANDED,1513,1649,MUMBAI-NANDED,3162,All
2018,8,MUMBAI,NANDED,1788,1854,MUMBAI-NANDED,3642,All
2018,9,MUMBAI,NANDED,1724,1823,MUMBAI-NANDED,3547,All
2018,10,MUMBAI,NANDED,1739,1772,MUMBAI-NANDED,3511,All
2018,11,MUMBAI,NANDED,1783,1813,MUMBAI-NANDED,3596,All
2018,12,MUMBAI,NANDED,1848,1864,MUMBAI-NANDED,3712,All
2019,1,MUMBAI,NANDED,1679,1897,MUMBAI-NANDED,3576,All
2019,2,MUMBAI,NANDED,1032,1112,MUMBAI-NANDED,2144,All
2019,3,MUMBAI,NANDED,1106,1082,MUMBAI-NANDED,2188,All
2019,4,MUMBAI,NANDED,1691,1680,MUMBAI-NANDED,3371,All
2019,5,MUMBAI,NANDED,1847,1839,MUMBAI-NANDED,3686,All
2019,6,MUMBAI,NANDED,1602,1783,MUMBAI-NANDED,3385,All
2019,7,MUMBAI,NANDED,1605,1624,MUMBAI-NANDED,3229,All
2019,8,MUMBAI,NANDED,1616,1658,MUMBAI-NANDED,3274,All
2019,9,MUMBAI,NANDED,1071,1148,MUMBAI-NANDED,2219,All
2019,10,MUMBAI,NANDED,1591,1385,MUMBAI-NANDED,2976,All
2019,11,MUMBAI,NANDED,1665,1887,MUMBAI-NANDED,3552,All
2019,12,MUMBAI,NANDED,1980,1968,MUMBAI-NANDED,3948,All
2020,1,MUMBAI,NANDED,1762,1959,MUMBAI-NANDED,3721,All
2020,2,MUMBAI,NANDED,1785,1868,MUMBAI-NANDED,3653,All
2020,3,MUMBAI,NANDED,1382,1264,MUMBAI-NANDED,2646,All
2020,6,MUMBAI,NANDED,152,155,MUMBAI-NANDED,307,All
2020,7,MUMBAI,NANDED,357,344,MUMBAI-NANDED,701,All
2020,8,MUMBAI,NANDED,417,432,MUMBAI-NANDED,849,All
2020,9,MUMBAI,NANDED,439,514,MUMBAI-NANDED,953,All
2020,10,MUMBAI,NANDED,744,739,MUMBAI-NANDED,1483,All
2020,11,MUMBAI,NANDED,611,569,MUMBAI-NANDED,1180,All
2020,12,MUMBAI,NANDED,739,783,MUMBAI-NANDED,1522,All
2021,1,MUMBAI,NANDED,634,657,MUMBAI-NANDED,1291,All
2021,2,MUMBAI,NANDED,795,776,MUMBAI-NANDED,1571,All
2021,3,MUMBAI,NANDED,507,617,MUMBAI-NANDED,1124,All
2021,4,MUMBAI,NANDED,320,232,MUMBAI-NANDED,552,All
2021,6,MUMBAI,NANDED,412,419,MUMBAI-NANDED,831,All
2021,7,MUMBAI,NANDED,271,275,MUMBAI-NANDED,546,All
2021,8,MUMBAI,NANDED,716,789,MUMBAI-NANDED,1505,All
2021,9,MUMBAI,NANDED,242,248,MUMBAI-NANDED,490,All
2021,10,MUMBAI,NANDED,388,350,MUMBAI-NANDED,738,All
2021,11,MUMBAI,NANDED,161,164,MUMBAI-NANDED,325,All
2021,12,MUMBAI,NANDED,264,242,MUMBAI-NANDED,506,All
2022,1,MUMBAI,NANDED,234,236,MUMBAI-NANDED,470,All
2022,2,MUMBAI,NANDED,562,403,MUMBAI-NANDED,965,All
2022,3,MUMBAI,NANDED,272,266,MUMBAI-NANDED,538,All
2017,12,MUMBAI,NASIK,41,26,MUMBAI-NASIK,67,All
2018,1,MUMBAI,NASIK,190,169,MUMBAI-NASIK,359,All
2018,2,MUMBAI,NASIK,134,129,MUMBAI-NASIK,263,All
2018,3,MUMBAI,NASIK,42,58,MUMBAI-NASIK,100,All
2018,4,MUMBAI,NASIK,62,57,MUMBAI-NASIK,119,All
2018,5,MUMBAI,NASIK,92,98,MUMBAI-NASIK,190,All
2018,6,MUMBAI,NASIK,26,35,MUMBAI-NASIK,61,All
2018,7,MUMBAI,NASIK,13,12,MUMBAI-NASIK,25,All
2018,8,MUMBAI,NASIK,247,233,MUMBAI-NASIK,480,All
2018,9,MUMBAI,NASIK,89,102,MUMBAI-NASIK,191,All
2020,8,MUMBAI,NASIK,1,0,MUMBAI-NASIK,1,All
2020,12,MUMBAI,NASIK,3,0,MUMBAI-NASIK,3,All
2015,4,MUMBAI,PATNA,9654,3268,MUMBAI-PATNA,12922,All
2015,5,MUMBAI,PATNA,11185,5656,MUMBAI-PATNA,16841,All
2015,6,MUMBAI,PATNA,6984,5152,MUMBAI-PATNA,12136,All
2015,7,MUMBAI,PATNA,6884,3551,MUMBAI-PATNA,10435,All
2015,8,MUMBAI,PATNA,6736,3578,MUMBAI-PATNA,10314,All
2015,9,MUMBAI,PATNA,8530,3746,MUMBAI-PATNA,12276,All
2015,10,MUMBAI,PATNA,8978,3908,MUMBAI-PATNA,12886,All
2015,11,MUMBAI,PATNA,11525,4901,MUMBAI-PATNA,16426,All
2015,12,MUMBAI,PATNA,9787,4468,MUMBAI-PATNA,14255,All
2016,1,MUMBAI,PATNA,9900,3012,MUMBAI-PATNA,12912,All
2016,2,MUMBAI,PATNA,9860,3604,MUMBAI-PATNA,13464,All
2016,3,MUMBAI,PATNA,10378,4627,MUMBAI-PATNA,15005,All
2016,4,MUMBAI,PATNA,12689,6332,MUMBAI-PATNA,19021,All
2016,5,MUMBAI,PATNA,10816,7388,MUMBAI-PATNA,18204,All
2016,6,MUMBAI,PATNA,9352,6056,MUMBAI-PATNA,15408,All
2016,7,MUMBAI,PATNA,9448,4907,MUMBAI-PATNA,14355,All
2016,8,MUMBAI,PATNA,7937,4154,MUMBAI-PATNA,12091,All
2016,9,MUMBAI,PATNA,8560,2914,MUMBAI-PATNA,11474,All
2016,10,MUMBAI,PATNA,10068,2770,MUMBAI-PATNA,12838,All
2016,11,MUMBAI,PATNA,9455,3908,MUMBAI-PATNA,13363,All
2016,12,MUMBAI,PATNA,11059,3984,MUMBAI-PATNA,15043,All
2017,1,MUMBAI,PATNA,11646,3666,MUMBAI-PATNA,15312,All
2017,2,MUMBAI,PATNA,10771,4257,MUMBAI-PATNA,15028,All
2017,3,MUMBAI,PATNA,11309,4701,MUMBAI-PATNA,16010,All
2017,4,MUMBAI,PATNA,12469,3903,MUMBAI-PATNA,16372,All
2017,5,MUMBAI,PATNA,12449,5409,MUMBAI-PATNA,17858,All
2017,6,MUMBAI,PATNA,11541,5750,MUMBAI-PATNA,17291,All
2017,7,MUMBAI,PATNA,14441,7134,MUMBAI-PATNA,21575,All
2017,8,MUMBAI,PATNA,15955,7107,MUMBAI-PATNA,23062,All
2017,9,MUMBAI,PATNA,16027,6814,MUMBAI-PATNA,22841,All
2017,10,MUMBAI,PATNA,21157,10436,MUMBAI-PATNA,31593,All
2017,11,MUMBAI,PATNA,19564,12078,MUMBAI-PATNA,31642,All
2017,12,MUMBAI,PATNA,12949,3833,MUMBAI-PATNA,16782,All
2018,1,MUMBAI,PATNA,13884,3173,MUMBAI-PATNA,17057,All
2018,2,MUMBAI,PATNA,18959,8846,MUMBAI-PATNA,27805,All
2018,3,MUMBAI,PATNA,19010,11368,MUMBAI-PATNA,30378,All
2018,4,MUMBAI,PATNA,18957,10679,MUMBAI-PATNA,29636,All
2018,5,MUMBAI,PATNA,19548,16033,MUMBAI-PATNA,35581,All
2018,6,MUMBAI,PATNA,17060,14241,MUMBAI-PATNA,31301,All
2018,7,MUMBAI,PATNA,15593,13621,MUMBAI-PATNA,29214,All
2018,8,MUMBAI,PATNA,16900,12222,MUMBAI-PATNA,29122,All
2018,9,MUMBAI,PATNA,16562,12582,MUMBAI-PATNA,29144,All
2018,10,MUMBAI,PATNA,19513,12088,MUMBAI-PATNA,31601,All
2018,11,MUMBAI,PATNA,19320,16332,MUMBAI-PATNA,35652,All
2018,12,MUMBAI,PATNA,19581,15449,MUMBAI-PATNA,35030,All
2019,1,MUMBAI,PATNA,20547,14896,MUMBAI-PATNA,35443,All
2019,2,MUMBAI,PATNA,17960,11546,MUMBAI-PATNA,29506,All
2019,3,MUMBAI,PATNA,17630,10935,MUMBAI-PATNA,28565,All
2019,4,MUMBAI,PATNA,19656,14217,MUMBAI-PATNA,33873,All
2019,5,MUMBAI,PATNA,27476,22001,MUMBAI-PATNA,49477,All
2019,6,MUMBAI,PATNA,29325,27609,MUMBAI-PATNA,56934,All
2019,7,MUMBAI,PATNA,23097,24410,MUMBAI-PATNA,47507,All
2019,8,MUMBAI,PATNA,27392,21376,MUMBAI-PATNA,48768,All
2019,9,MUMBAI,PATNA,21626,16188,MUMBAI-PATNA,37814,All
2019,10,MUMBAI,PATNA,32052,18957,MUMBAI-PATNA,51009,All
2019,11,MUMBAI,PATNA,33040,29789,MUMBAI-PATNA,62829,All
2019,12,MUMBAI,PATNA,27746,24945,MUMBAI-PATNA,52691,All
2020,1,MUMBAI,PATNA,28441,20456,MUMBAI-PATNA,48897,All
2020,2,MUMBAI,PATNA,27940,20619,MUMBAI-PATNA,48559,All
2020,3,MUMBAI,PATNA,24298,15377,MUMBAI-PATNA,39675,All
2020,5,MUMBAI,PATNA,2436,619,MUMBAI-PATNA,3055,All
2020,6,MUMBAI,PATNA,14608,4731,MUMBAI-PATNA,19339,All
2020,7,MUMBAI,PATNA,11546,7283,MUMBAI-PATNA,18829,All
2020,8,MUMBAI,PATNA,6727,16118,MUMBAI-PATNA,22845,All
2020,9,MUMBAI,PATNA,8359,17663,MUMBAI-PATNA,26022,All
2020,10,MUMBAI,PATNA,14122,23132,MUMBAI-PATNA,37254,All
2020,11,MUMBAI,PATNA,25306,23878,MUMBAI-PATNA,49184,All
2020,12,MUMBAI,PATNA,14834,26272,MUMBAI-PATNA,41106,All
2021,1,MUMBAI,PATNA,15192,30255,MUMBAI-PATNA,45447,All
2021,2,MUMBAI,PATNA,15874,20586,MUMBAI-PATNA,36460,All
2021,3,MUMBAI,PATNA,16446,13868,MUMBAI-PATNA,30314,All
2021,4,MUMBAI,PATNA,19523,9627,MUMBAI-PATNA,29150,All
2021,6,MUMBAI,PATNA,5961,11206,MUMBAI-PATNA,17167,All
2021,7,MUMBAI,PATNA,8911,11211,MUMBAI-PATNA,20122,All
2021,8,MUMBAI,PATNA,8974,11169,MUMBAI-PATNA,20143,All
2021,9,MUMBAI,PATNA,9346,9589,MUMBAI-PATNA,18935,All
2021,10,MUMBAI,PATNA,18267,11993,MUMBAI-PATNA,30260,All
2021,11,MUMBAI,PATNA,24986,23280,MUMBAI-PATNA,48266,All
2021,12,MUMBAI,PATNA,14982,23378,MUMBAI-PATNA,38360,All
2022,1,MUMBAI,PATNA,10953,8705,MUMBAI-PATNA,19658,All
2022,2,MUMBAI,PATNA,13805,14001,MUMBAI-PATNA,27806,All
2022,3,MUMBAI,PATNA,17374,17056,MUMBAI-PATNA,34430,All
2022,4,MUMBAI,PATNA,22040,15905,MUMBAI-PATNA,37945,All
2022,5,MUMBAI,PATNA,22932,25088,MUMBAI-PATNA,48020,All
2022,6,MUMBAI,PATNA,15580,24350,MUMBAI-PATNA,39930,All
2022,7,MUMBAI,PATNA,14541,16616,MUMBAI-PATNA,31157,All
2022,8,MUMBAI,PATNA,15625,17932,MUMBAI-PATNA,33557,All
2022,9,MUMBAI,PATNA,20654,19048,MUMBAI-PATNA,39702,All
2022,10,MUMBAI,PATNA,25211,17516,MUMBAI-PATNA,42727,All
2022,11,MUMBAI,PATNA,21068,24062,MUMBAI-PATNA,45130,All
2022,12,MUMBAI,PATNA,20511,22516,MUMBAI-PATNA,43027,All
2023,1,MUMBAI,PATNA,20876,18420,MUMBAI-PATNA,39296,All
2023,2,MUMBAI,PATNA,20946,19107,MUMBAI-PATNA,40053,All
2023,3,MUMBAI,PATNA,22595,22069,MUMBAI-PATNA,44664,All
2023,4,MUMBAI,PATNA,20136,16763,MUMBAI-PATNA,36899,All
2023,5,MUMBAI,PATNA,15720,15375,MUMBAI-PATNA,31095,All
2023,6,MUMBAI,PATNA,14351,14543,MUMBAI-PATNA,28894,All
2023,7,MUMBAI,PATNA,13750,14332,MUMBAI-PATNA,28082,All
2023,8,MUMBAI,PATNA,14314,14336,MUMBAI-PATNA,28650,All
2023,9,MUMBAI,PATNA,15447,15893,MUMBAI-PATNA,31340,All
2023,10,MUMBAI,PATNA,16409,15225,MUMBAI-PATNA,31634,All
2023,11,MUMBAI,PATNA,20251,16590,MUMBAI-PATNA,36841,All
2023,12,MUMBAI,PATNA,17163,17206,MUMBAI-PATNA,34369,All
2024,1,MUMBAI,PATNA,14576,14047,MUMBAI-PATNA,28623,All
2024,2,MUMBAI,PATNA,14667,13703,MUMBAI-PATNA,28370,All
2024,3,MUMBAI,PATNA,15797,14340,MUMBAI-PATNA,30137,All
2024,4,MUMBAI,PATNA,15186,13780,MUMBAI-PATNA,28966,All
2024,6,MUMBAI,PATNA,14853,14751,MUMBAI-PATNA,29604,All
2024,7,MUMBAI,PATNA,13734,14454,MUMBAI-PATNA,28188,All
2024,8,MUMBAI,PATNA,14131,14660,MUMBAI-PATNA,28791,All
2024,9,MUMBAI,PATNA,14582,14113,MUMBAI-PATNA,28695,All
2024,10,MUMBAI,PATNA,16827,12254,MUMBAI-PATNA,29081,All
2024,11,MUMBAI,PATNA,18440,17173,MUMBAI-PATNA,35613,All
2024,12,MUMBAI,PATNA,15465,15625,MUMBAI-PATNA,31090,All
2025,1,MUMBAI,PATNA,14984,15007,MUMBAI-PATNA,29991,All
2025,2,MUMBAI,PATNA,14584,14113,MUMBAI-PATNA,28697,All
2025,3,MUMBAI,PATNA,20776,18659,MUMBAI-PATNA,39435,All
2015,4,MUMBAI,PORBANDAR,624,591,MUMBAI-PORBANDAR,1215,All
2015,5,MUMBAI,PORBANDAR,477,611,MUMBAI-PORBANDAR,1088,All
2015,6,MUMBAI,PORBANDAR,607,441,MUMBAI-PORBANDAR,1048,All
2015,7,MUMBAI,PORBANDAR,647,535,MUMBAI-PORBANDAR,1182,All
2015,8,MUMBAI,PORBANDAR,532,589,MUMBAI-PORBANDAR,1121,All
2015,9,MUMBAI,PORBANDAR,627,623,MUMBAI-PORBANDAR,1250,All
2015,10,MUMBAI,PORBANDAR,632,710,MUMBAI-PORBANDAR,1342,All
2015,11,MUMBAI,PORBANDAR,706,710,MUMBAI-PORBANDAR,1416,All
2015,12,MUMBAI,PORBANDAR,642,803,MUMBAI-PORBANDAR,1445,All
2016,1,MUMBAI,PORBANDAR,814,939,MUMBAI-PORBANDAR,1753,All
2016,2,MUMBAI,PORBANDAR,626,789,MUMBAI-PORBANDAR,1415,All
2016,3,MUMBAI,PORBANDAR,567,750,MUMBAI-PORBANDAR,1317,All
2017,7,MUMBAI,PORBANDAR,1624,1422,MUMBAI-PORBANDAR,3046,All
2017,8,MUMBAI,PORBANDAR,2153,2060,MUMBAI-PORBANDAR,4213,All
2017,9,MUMBAI,PORBANDAR,2050,1936,MUMBAI-PORBANDAR,3986,All
2017,10,MUMBAI,PORBANDAR,2294,2154,MUMBAI-PORBANDAR,4448,All
2017,11,MUMBAI,PORBANDAR,2299,2189,MUMBAI-PORBANDAR,4488,All
2017,12,MUMBAI,PORBANDAR,2389,2320,MUMBAI-PORBANDAR,4709,All
2018,1,MUMBAI,PORBANDAR,2412,2383,MUMBAI-PORBANDAR,4795,All
2018,2,MUMBAI,PORBANDAR,2158,2104,MUMBAI-PORBANDAR,4262,All
2018,3,MUMBAI,PORBANDAR,2294,2271,MUMBAI-PORBANDAR,4565,All
2018,4,MUMBAI,PORBANDAR,2069,2013,MUMBAI-PORBANDAR,4082,All
2018,5,MUMBAI,PORBANDAR,2371,2326,MUMBAI-PORBANDAR,4697,All
2018,6,MUMBAI,PORBANDAR,2223,1963,MUMBAI-PORBANDAR,4186,All
2018,7,MUMBAI,PORBANDAR,2273,2063,MUMBAI-PORBANDAR,4336,All
2018,8,MUMBAI,PORBANDAR,2194,2010,MUMBAI-PORBANDAR,4204,All
2018,9,MUMBAI,PORBANDAR,2237,2020,MUMBAI-PORBANDAR,4257,All
2018,10,MUMBAI,PORBANDAR,2211,2000,MUMBAI-PORBANDAR,4211,All
2018,11,MUMBAI,PORBANDAR,2312,2284,MUMBAI-PORBANDAR,4596,All
2018,12,MUMBAI,PORBANDAR,2392,2370,MUMBAI-PORBANDAR,4762,All
2019,1,MUMBAI,PORBANDAR,2375,2244,MUMBAI-PORBANDAR,4619,All
2019,2,MUMBAI,PORBANDAR,1392,1383,MUMBAI-PORBANDAR,2775,All
2019,3,MUMBAI,PORBANDAR,1411,1373,MUMBAI-PORBANDAR,2784,All
2019,4,MUMBAI,PORBANDAR,2275,2094,MUMBAI-PORBANDAR,4369,All
2019,5,MUMBAI,PORBANDAR,2213,2025,MUMBAI-PORBANDAR,4238,All
2019,6,MUMBAI,PORBANDAR,2060,1739,MUMBAI-PORBANDAR,3799,All
2019,7,MUMBAI,PORBANDAR,2375,2120,MUMBAI-PORBANDAR,4495,All
2019,8,MUMBAI,PORBANDAR,2242,1916,MUMBAI-PORBANDAR,4158,All
2019,9,MUMBAI,PORBANDAR,1933,1721,MUMBAI-PORBANDAR,3654,All
2019,10,MUMBAI,PORBANDAR,2352,2045,MUMBAI-PORBANDAR,4397,All
2019,11,MUMBAI,PORBANDAR,2325,2163,MUMBAI-PORBANDAR,4488,All
2019,12,MUMBAI,PORBANDAR,2295,2156,MUMBAI-PORBANDAR,4451,All
2020,1,MUMBAI,PORBANDAR,2397,2296,MUMBAI-PORBANDAR,4693,All
2020,2,MUMBAI,PORBANDAR,2259,2239,MUMBAI-PORBANDAR,4498,All
2020,3,MUMBAI,PORBANDAR,1558,1328,MUMBAI-PORBANDAR,2886,All
2020,9,MUMBAI,PORBANDAR,58,28,MUMBAI-PORBANDAR,86,All
2021,1,MUMBAI,PORBANDAR,351,293,MUMBAI-PORBANDAR,644,All
2021,2,MUMBAI,PORBANDAR,1092,901,MUMBAI-PORBANDAR,1993,All
2021,3,MUMBAI,PORBANDAR,65,43,MUMBAI-PORBANDAR,108,All
2021,4,MUMBAI,PORBANDAR,72,41,MUMBAI-PORBANDAR,113,All
2022,3,MUMBAI,PORBANDAR,229,201,MUMBAI-PORBANDAR,430,All
2022,4,MUMBAI,PORBANDAR,1847,1649,MUMBAI-PORBANDAR,3496,All
2022,5,MUMBAI,PORBANDAR,2124,1842,MUMBAI-PORBANDAR,3966,All
2022,6,MUMBAI,PORBANDAR,1748,1318,MUMBAI-PORBANDAR,3066,All
2022,7,MUMBAI,PORBANDAR,1437,1121,MUMBAI-PORBANDAR,2558,All
2022,8,MUMBAI,PORBANDAR,957,785,MUMBAI-PORBANDAR,1742,All
2025,3,MUMBAI,PORBANDAR,38,17,MUMBAI-PORBANDAR,55,All
2016,10,MUMBAI,PORT BLAIR,1884,1270,MUMBAI-PORT BLAIR,3154,All
2016,11,MUMBAI,PORT BLAIR,3584,4048,MUMBAI-PORT BLAIR,7632,All
2016,12,MUMBAI,PORT BLAIR,4247,3948,MUMBAI-PORT BLAIR,8195,All
2017,1,MUMBAI,PORT BLAIR,3704,3873,MUMBAI-PORT BLAIR,7577,All
2017,2,MUMBAI,PORT BLAIR,2026,2215,MUMBAI-PORT BLAIR,4241,All
2017,3,MUMBAI,PORT BLAIR,1701,1781,MUMBAI-PORT BLAIR,3482,All
2017,10,MUMBAI,PORT BLAIR,3331,3285,MUMBAI-PORT BLAIR,6616,All
2017,11,MUMBAI,PORT BLAIR,2474,2304,MUMBAI-PORT BLAIR,4778,All
2017,12,MUMBAI,PORT BLAIR,4358,3828,MUMBAI-PORT BLAIR,8186,All
2018,1,MUMBAI,PORT BLAIR,4476,4564,MUMBAI-PORT BLAIR,9040,All
2018,2,MUMBAI,PORT BLAIR,2630,2320,MUMBAI-PORT BLAIR,4950,All
2018,3,MUMBAI,PORT BLAIR,384,570,MUMBAI-PORT BLAIR,954,All
2018,10,MUMBAI,PORT BLAIR,2842,2927,MUMBAI-PORT BLAIR,5769,All
2018,11,MUMBAI,PORT BLAIR,5344,5007,MUMBAI-PORT BLAIR,10351,All
2018,12,MUMBAI,PORT BLAIR,5282,5069,MUMBAI-PORT BLAIR,10351,All
2019,1,MUMBAI,PORT BLAIR,4446,4431,MUMBAI-PORT BLAIR,8877,All
2019,2,MUMBAI,PORT BLAIR,2358,2407,MUMBAI-PORT BLAIR,4765,All
2019,10,MUMBAI,PORT BLAIR,3964,3197,MUMBAI-PORT BLAIR,7161,All
2019,11,MUMBAI,PORT BLAIR,4242,4099,MUMBAI-PORT BLAIR,8341,All
2019,12,MUMBAI,PORT BLAIR,5114,4871,MUMBAI-PORT BLAIR,9985,All
2020,1,MUMBAI,PORT BLAIR,4266,3988,MUMBAI-PORT BLAIR,8254,All
2020,2,MUMBAI,PORT BLAIR,4287,4715,MUMBAI-PORT BLAIR,9002,All
2020,12,MUMBAI,PORT BLAIR,2519,4390,MUMBAI-PORT BLAIR,6909,All
2021,1,MUMBAI,PORT BLAIR,939,0,MUMBAI-PORT BLAIR,939,All
2021,2,MUMBAI,PORT BLAIR,1165,27,MUMBAI-PORT BLAIR,1192,All
2021,3,MUMBAI,PORT BLAIR,1794,234,MUMBAI-PORT BLAIR,2028,All
2021,4,MUMBAI,PORT BLAIR,1176,1293,MUMBAI-PORT BLAIR,2469,All
2021,10,MUMBAI,PORT BLAIR,13,0,MUMBAI-PORT BLAIR,13,All
2021,11,MUMBAI,PORT BLAIR,471,0,MUMBAI-PORT BLAIR,471,All
2021,12,MUMBAI,PORT BLAIR,577,0,MUMBAI-PORT BLAIR,577,All
2022,1,MUMBAI,PORT BLAIR,287,0,MUMBAI-PORT BLAIR,287,All
2022,2,MUMBAI,PORT BLAIR,410,0,MUMBAI-PORT BLAIR,410,All
2022,3,MUMBAI,PORT BLAIR,134,0,MUMBAI-PORT BLAIR,134,All
2022,4,MUMBAI,PORT BLAIR,74,0,MUMBAI-PORT BLAIR,74,All
2022,5,MUMBAI,PORT BLAIR,72,15,MUMBAI-PORT BLAIR,87,All
2022,7,MUMBAI,PORT BLAIR,6,0,MUMBAI-PORT BLAIR,6,All
2022,8,MUMBAI,PORT BLAIR,25,0,MUMBAI-PORT BLAIR,25,All
2022,9,MUMBAI,PORT BLAIR,82,0,MUMBAI-PORT BLAIR,82,All
2022,10,MUMBAI,PORT BLAIR,396,375,MUMBAI-PORT BLAIR,771,All
2022,11,MUMBAI,PORT BLAIR,3329,3170,MUMBAI-PORT BLAIR,6499,All
2022,12,MUMBAI,PORT BLAIR,4811,3957,MUMBAI-PORT BLAIR,8768,All
2023,1,MUMBAI,PORT BLAIR,3773,3590,MUMBAI-PORT BLAIR,7363,All
2023,2,MUMBAI,PORT BLAIR,3487,2973,MUMBAI-PORT BLAIR,6460,All
2023,3,MUMBAI,PORT BLAIR,2732,2539,MUMBAI-PORT BLAIR,5271,All
2023,4,MUMBAI,PORT BLAIR,452,0,MUMBAI-PORT BLAIR,452,All
2023,5,MUMBAI,PORT BLAIR,661,0,MUMBAI-PORT BLAIR,661,All
2023,6,MUMBAI,PORT BLAIR,38,0,MUMBAI-PORT BLAIR,38,All
2023,8,MUMBAI,PORT BLAIR,90,0,MUMBAI-PORT BLAIR,90,All
2023,9,MUMBAI,PORT BLAIR,78,0,MUMBAI-PORT BLAIR,78,All
2023,10,MUMBAI,PORT BLAIR,4351,4312,MUMBAI-PORT BLAIR,8663,All
2023,11,MUMBAI,PORT BLAIR,4964,4776,MUMBAI-PORT BLAIR,9740,All
2023,12,MUMBAI,PORT BLAIR,5057,5032,MUMBAI-PORT BLAIR,10089,All
2024,1,MUMBAI,PORT BLAIR,4926,5008,MUMBAI-PORT BLAIR,9934,All
2024,2,MUMBAI,PORT BLAIR,4573,4677,MUMBAI-PORT BLAIR,9250,All
2024,3,MUMBAI,PORT BLAIR,4962,5008,MUMBAI-PORT BLAIR,9970,All
2024,4,MUMBAI,PORT BLAIR,4361,4710,MUMBAI-PORT BLAIR,9071,All
2024,10,MUMBAI,PORT BLAIR,4508,4061,MUMBAI-PORT BLAIR,8569,All
2024,11,MUMBAI,PORT BLAIR,5387,5550,MUMBAI-PORT BLAIR,10937,All
2024,12,MUMBAI,PORT BLAIR,8040,7901,MUMBAI-PORT BLAIR,15941,All
2025,1,MUMBAI,PORT BLAIR,7538,7464,MUMBAI-PORT BLAIR,15002,All
2025,2,MUMBAI,PORT BLAIR,4724,4769,MUMBAI-PORT BLAIR,9493,All
2025,3,MUMBAI,PORT BLAIR,4782,4997,MUMBAI-PORT BLAIR,9779,All
2015,4,MUMBAI,PUNE,2308,3384,MUMBAI-PUNE,5692,All
2015,5,MUMBAI,PUNE,2056,2306,MUMBAI-PUNE,4362,All
2015,6,MUMBAI,PUNE,2269,2690,MUMBAI-PUNE,4959,All
2015,7,MUMBAI,PUNE,2960,3275,MUMBAI-PUNE,6235,All
2015,8,MUMBAI,PUNE,2982,3495,MUMBAI-PUNE,6477,All
2015,9,MUMBAI,PUNE,2516,2901,MUMBAI-PUNE,5417,All
2015,10,MUMBAI,PUNE,2152,2738,MUMBAI-PUNE,4890,All
2015,11,MUMBAI,PUNE,1822,2333,MUMBAI-PUNE,4155,All
2015,12,MUMBAI,PUNE,1977,2622,MUMBAI-PUNE,4599,All
2016,1,MUMBAI,PUNE,1794,2406,MUMBAI-PUNE,4200,All
2016,2,MUMBAI,PUNE,1880,2350,MUMBAI-PUNE,4230,All
2016,3,MUMBAI,PUNE,1826,2657,MUMBAI-PUNE,4483,All
2016,4,MUMBAI,PUNE,1805,2656,MUMBAI-PUNE,4461,All
2016,5,MUMBAI,PUNE,1875,2353,MUMBAI-PUNE,4228,All
2016,6,MUMBAI,PUNE,2128,2439,MUMBAI-PUNE,4567,All
2016,7,MUMBAI,PUNE,2248,2859,MUMBAI-PUNE,5107,All
2016,8,MUMBAI,PUNE,1986,2811,MUMBAI-PUNE,4797,All
2016,9,MUMBAI,PUNE,2134,2640,MUMBAI-PUNE,4774,All
2016,10,MUMBAI,PUNE,2033,2451,MUMBAI-PUNE,4484,All
2016,11,MUMBAI,PUNE,1958,2415,MUMBAI-PUNE,4373,All
2016,12,MUMBAI,PUNE,1612,2622,MUMBAI-PUNE,4234,All
2017,1,MUMBAI,PUNE,1640,2264,MUMBAI-PUNE,3904,All
2017,2,MUMBAI,PUNE,1653,2279,MUMBAI-PUNE,3932,All
2017,3,MUMBAI,PUNE,1610,2457,MUMBAI-PUNE,4067,All
2017,4,MUMBAI,PUNE,1371,2390,MUMBAI-PUNE,3761,All
2017,5,MUMBAI,PUNE,1486,2346,MUMBAI-PUNE,3832,All
2017,6,MUMBAI,PUNE,1870,2284,MUMBAI-PUNE,4154,All
2017,7,MUMBAI,PUNE,2224,2915,MUMBAI-PUNE,5139,All
2017,8,MUMBAI,PUNE,2386,3090,MUMBAI-PUNE,5476,All
2017,9,MUMBAI,PUNE,2118,3076,MUMBAI-PUNE,5194,All
2017,10,MUMBAI,PUNE,2115,2767,MUMBAI-PUNE,4882,All
2017,11,MUMBAI,PUNE,2739,3020,MUMBAI-PUNE,5759,All
2017,12,MUMBAI,PUNE,2851,3206,MUMBAI-PUNE,6057,All
2018,1,MUMBAI,PUNE,2657,3163,MUMBAI-PUNE,5820,All
2018,2,MUMBAI,PUNE,2578,2935,MUMBAI-PUNE,5513,All
2018,3,MUMBAI,PUNE,2638,3319,MUMBAI-PUNE,5957,All
2018,4,MUMBAI,PUNE,2561,3328,MUMBAI-PUNE,5889,All
2018,5,MUMBAI,PUNE,2580,2923,MUMBAI-PUNE,5503,All
2018,6,MUMBAI,PUNE,2387,2717,MUMBAI-PUNE,5104,All
2018,7,MUMBAI,PUNE,2961,3473,MUMBAI-PUNE,6434,All
2018,8,MUMBAI,PUNE,2506,3204,MUMBAI-PUNE,5710,All
2018,9,MUMBAI,PUNE,2235,2872,MUMBAI-PUNE,5107,All
2018,10,MUMBAI,PUNE,2375,2530,MUMBAI-PUNE,4905,All
2018,11,MUMBAI,PUNE,2224,2622,MUMBAI-PUNE,4846,All
2018,12,MUMBAI,PUNE,2601,2712,MUMBAI-PUNE,5313,All
2019,1,MUMBAI,PUNE,2787,2923,MUMBAI-PUNE,5710,All
2019,2,MUMBAI,PUNE,2894,3180,MUMBAI-PUNE,6074,All
2019,3,MUMBAI,PUNE,3207,3528,MUMBAI-PUNE,6735,All
2019,8,MUMBAI,PUNE,0,16,MUMBAI-PUNE,16,All
2020,2,MUMBAI,PUNE,3,15,MUMBAI-PUNE,18,All
2020,3,MUMBAI,PUNE,19,0,MUMBAI-PUNE,19,All
2020,5,MUMBAI,PUNE,0,0,MUMBAI-PUNE,0,All
2020,7,MUMBAI,PUNE,135,4,MUMBAI-PUNE,139,All
2020,9,MUMBAI,PUNE,0,174,MUMBAI-PUNE,174,All
2020,10,MUMBAI,PUNE,0,420,MUMBAI-PUNE,420,All
2020,11,MUMBAI,PUNE,0,173,MUMBAI-PUNE,173,All
2020,12,MUMBAI,PUNE,65,183,MUMBAI-PUNE,248,All
2021,1,MUMBAI,PUNE,171,52,MUMBAI-PUNE,223,All
2021,2,MUMBAI,PUNE,0,44,MUMBAI-PUNE,44,All
2021,3,MUMBAI,PUNE,213,249,MUMBAI-PUNE,462,All
2021,4,MUMBAI,PUNE,20,51,MUMBAI-PUNE,71,All
2021,6,MUMBAI,PUNE,25,144,MUMBAI-PUNE,169,All
2021,7,MUMBAI,PUNE,277,249,MUMBAI-PUNE,526,All
2021,8,MUMBAI,PUNE,37,114,MUMBAI-PUNE,151,All
2021,9,MUMBAI,PUNE,42,0,MUMBAI-PUNE,42,All
2021,10,MUMBAI,PUNE,104,0,MUMBAI-PUNE,104,All
2021,11,MUMBAI,PUNE,121,71,MUMBAI-PUNE,192,All
2021,12,MUMBAI,PUNE,136,16,MUMBAI-PUNE,152,All
2022,1,MUMBAI,PUNE,0,1,MUMBAI-PUNE,1,All
2022,2,MUMBAI,PUNE,14,25,MUMBAI-PUNE,39,All
2022,3,MUMBAI,PUNE,427,215,MUMBAI-PUNE,642,All
2022,4,MUMBAI,PUNE,80,52,MUMBAI-PUNE,132,All
2022,6,MUMBAI,PUNE,80,52,MUMBAI-PUNE,132,All
2022,7,MUMBAI,PUNE,14,24,MUMBAI-PUNE,38,All
2022,9,MUMBAI,PUNE,80,52,MUMBAI-PUNE,132,All
2022,11,MUMBAI,PUNE,178,0,MUMBAI-PUNE,178,All
2023,3,MUMBAI,PUNE,446,296,MUMBAI-PUNE,742,All
2023,4,MUMBAI,PUNE,1696,2127,MUMBAI-PUNE,3823,All
2023,5,MUMBAI,PUNE,2061,2186,MUMBAI-PUNE,4247,All
2023,6,MUMBAI,PUNE,1493,1785,MUMBAI-PUNE,3278,All
2023,7,MUMBAI,PUNE,2248,2152,MUMBAI-PUNE,4400,All
2023,8,MUMBAI,PUNE,2130,1915,MUMBAI-PUNE,4045,All
2023,9,MUMBAI,PUNE,1516,1663,MUMBAI-PUNE,3179,All
2023,10,MUMBAI,PUNE,1568,1471,MUMBAI-PUNE,3039,All
2023,11,MUMBAI,PUNE,2191,1870,MUMBAI-PUNE,4061,All
2023,12,MUMBAI,PUNE,2709,2372,MUMBAI-PUNE,5081,All
2024,1,MUMBAI,PUNE,2179,2386,MUMBAI-PUNE,4565,All
2024,2,MUMBAI,PUNE,2272,2148,MUMBAI-PUNE,4420,All
2024,3,MUMBAI,PUNE,2281,2294,MUMBAI-PUNE,4575,All
2024,4,MUMBAI,PUNE,2502,2551,MUMBAI-PUNE,5053,All
2024,6,MUMBAI,PUNE,858,814,MUMBAI-PUNE,1672,All
2025,1,MUMBAI,PUNE,0,14,MUMBAI-PUNE,14,All
2015,4,MUMBAI,RAIPUR,20761,18370,MUMBAI-RAIPUR,39131,All
2015,5,MUMBAI,RAIPUR,20220,19390,MUMBAI-RAIPUR,39610,All
2015,6,MUMBAI,RAIPUR,18058,18850,MUMBAI-RAIPUR,36908,All
2015,7,MUMBAI,RAIPUR,15754,15644,MUMBAI-RAIPUR,31398,All
2015,8,MUMBAI,RAIPUR,16642,17237,MUMBAI-RAIPUR,33879,All
2015,9,MUMBAI,RAIPUR,16854,16580,MUMBAI-RAIPUR,33434,All
2015,10,MUMBAI,RAIPUR,19151,23601,MUMBAI-RAIPUR,42752,All
2015,11,MUMBAI,RAIPUR,19501,17619,MUMBAI-RAIPUR,37120,All
2015,12,MUMBAI,RAIPUR,20340,20529,MUMBAI-RAIPUR,40869,All
2016,1,MUMBAI,RAIPUR,19220,18997,MUMBAI-RAIPUR,38217,All
2016,2,MUMBAI,RAIPUR,17553,17529,MUMBAI-RAIPUR,35082,All
2016,3,MUMBAI,RAIPUR,17807,16504,MUMBAI-RAIPUR,34311,All
2016,4,MUMBAI,RAIPUR,17536,15811,MUMBAI-RAIPUR,33347,All
2016,5,MUMBAI,RAIPUR,18978,18500,MUMBAI-RAIPUR,37478,All
2016,6,MUMBAI,RAIPUR,17549,16740,MUMBAI-RAIPUR,34289,All
2016,7,MUMBAI,RAIPUR,17435,16282,MUMBAI-RAIPUR,33717,All
2016,8,MUMBAI,RAIPUR,16275,15519,MUMBAI-RAIPUR,31794,All
2016,9,MUMBAI,RAIPUR,16111,15076,MUMBAI-RAIPUR,31187,All
2016,10,MUMBAI,RAIPUR,19077,14509,MUMBAI-RAIPUR,33586,All
2016,11,MUMBAI,RAIPUR,16749,17535,MUMBAI-RAIPUR,34284,All
2016,12,MUMBAI,RAIPUR,20413,19069,MUMBAI-RAIPUR,39482,All
2017,1,MUMBAI,RAIPUR,19895,18452,MUMBAI-RAIPUR,38347,All
2017,2,MUMBAI,RAIPUR,17396,16053,MUMBAI-RAIPUR,33449,All
2017,3,MUMBAI,RAIPUR,17076,15227,MUMBAI-RAIPUR,32303,All
2017,4,MUMBAI,RAIPUR,12523,11624,MUMBAI-RAIPUR,24147,All
2017,5,MUMBAI,RAIPUR,13441,12041,MUMBAI-RAIPUR,25482,All
2017,6,MUMBAI,RAIPUR,12921,12006,MUMBAI-RAIPUR,24927,All
2017,7,MUMBAI,RAIPUR,17887,17656,MUMBAI-RAIPUR,35543,All
2017,8,MUMBAI,RAIPUR,18593,17525,MUMBAI-RAIPUR,36118,All
2017,9,MUMBAI,RAIPUR,17078,17297,MUMBAI-RAIPUR,34375,All
2017,10,MUMBAI,RAIPUR,19281,16451,MUMBAI-RAIPUR,35732,All
2017,11,MUMBAI,RAIPUR,19174,17676,MUMBAI-RAIPUR,36850,All
2017,12,MUMBAI,RAIPUR,20043,18521,MUMBAI-RAIPUR,38564,All
2018,1,MUMBAI,RAIPUR,20110,17932,MUMBAI-RAIPUR,38042,All
2018,2,MUMBAI,RAIPUR,19647,16883,MUMBAI-RAIPUR,36530,All
2018,3,MUMBAI,RAIPUR,19985,18092,MUMBAI-RAIPUR,38077,All
2018,4,MUMBAI,RAIPUR,21174,18133,MUMBAI-RAIPUR,39307,All
2018,5,MUMBAI,RAIPUR,20281,19971,MUMBAI-RAIPUR,40252,All
2018,6,MUMBAI,RAIPUR,20606,18546,MUMBAI-RAIPUR,39152,All
2018,7,MUMBAI,RAIPUR,20609,19820,MUMBAI-RAIPUR,40429,All
2018,8,MUMBAI,RAIPUR,20068,18252,MUMBAI-RAIPUR,38320,All
2018,9,MUMBAI,RAIPUR,19001,17921,MUMBAI-RAIPUR,36922,All
2018,10,MUMBAI,RAIPUR,21114,17380,MUMBAI-RAIPUR,38494,All
2018,11,MUMBAI,RAIPUR,17569,18250,MUMBAI-RAIPUR,35819,All
2018,12,MUMBAI,RAIPUR,22490,20038,MUMBAI-RAIPUR,42528,All
2019,1,MUMBAI,RAIPUR,21781,19532,MUMBAI-RAIPUR,41313,All
2019,2,MUMBAI,RAIPUR,13173,11456,MUMBAI-RAIPUR,24629,All
2019,3,MUMBAI,RAIPUR,11076,10061,MUMBAI-RAIPUR,21137,All
2019,4,MUMBAI,RAIPUR,12550,11213,MUMBAI-RAIPUR,23763,All
2019,5,MUMBAI,RAIPUR,13290,12189,MUMBAI-RAIPUR,25479,All
2019,6,MUMBAI,RAIPUR,12909,11890,MUMBAI-RAIPUR,24799,All
2019,7,MUMBAI,RAIPUR,11098,11122,MUMBAI-RAIPUR,22220,All
2019,8,MUMBAI,RAIPUR,12163,11294,MUMBAI-RAIPUR,23457,All
2019,9,MUMBAI,RAIPUR,11397,10469,MUMBAI-RAIPUR,21866,All
2019,10,MUMBAI,RAIPUR,14851,11981,MUMBAI-RAIPUR,26832,All
2019,11,MUMBAI,RAIPUR,14502,14966,MUMBAI-RAIPUR,29468,All
2019,12,MUMBAI,RAIPUR,15940,15268,MUMBAI-RAIPUR,31208,All
2020,1,MUMBAI,RAIPUR,15658,14625,MUMBAI-RAIPUR,30283,All
2020,2,MUMBAI,RAIPUR,14678,13941,MUMBAI-RAIPUR,28619,All
2020,3,MUMBAI,RAIPUR,10947,7807,MUMBAI-RAIPUR,18754,All
2020,6,MUMBAI,RAIPUR,612,195,MUMBAI-RAIPUR,807,All
2020,7,MUMBAI,RAIPUR,1892,1244,MUMBAI-RAIPUR,3136,All
2020,8,MUMBAI,RAIPUR,2179,2920,MUMBAI-RAIPUR,5099,All
2020,9,MUMBAI,RAIPUR,2514,4626,MUMBAI-RAIPUR,7140,All
2020,10,MUMBAI,RAIPUR,5218,7814,MUMBAI-RAIPUR,13032,All
2020,11,MUMBAI,RAIPUR,9597,9791,MUMBAI-RAIPUR,19388,All
2020,12,MUMBAI,RAIPUR,13204,13877,MUMBAI-RAIPUR,27081,All
2021,1,MUMBAI,RAIPUR,13332,14479,MUMBAI-RAIPUR,27811,All
2021,2,MUMBAI,RAIPUR,14109,13929,MUMBAI-RAIPUR,28038,All
2021,3,MUMBAI,RAIPUR,10305,10268,MUMBAI-RAIPUR,20573,All
2021,4,MUMBAI,RAIPUR,5007,2628,MUMBAI-RAIPUR,7635,All
2021,6,MUMBAI,RAIPUR,6217,4946,MUMBAI-RAIPUR,11163,All
2021,7,MUMBAI,RAIPUR,8994,8905,MUMBAI-RAIPUR,17899,All
2021,8,MUMBAI,RAIPUR,11884,11422,MUMBAI-RAIPUR,23306,All
2021,9,MUMBAI,RAIPUR,11503,10623,MUMBAI-RAIPUR,22126,All
2021,10,MUMBAI,RAIPUR,17737,11524,MUMBAI-RAIPUR,29261,All
2021,11,MUMBAI,RAIPUR,16014,15896,MUMBAI-RAIPUR,31910,All
2021,12,MUMBAI,RAIPUR,15961,15724,MUMBAI-RAIPUR,31685,All
2022,1,MUMBAI,RAIPUR,8169,6447,MUMBAI-RAIPUR,14616,All
2022,2,MUMBAI,RAIPUR,9524,8903,MUMBAI-RAIPUR,18427,All
2022,3,MUMBAI,RAIPUR,16038,15513,MUMBAI-RAIPUR,31551,All
2022,4,MUMBAI,RAIPUR,15555,16075,MUMBAI-RAIPUR,31630,All
2022,5,MUMBAI,RAIPUR,15534,17245,MUMBAI-RAIPUR,32779,All
2022,6,MUMBAI,RAIPUR,14024,16261,MUMBAI-RAIPUR,30285,All
2022,7,MUMBAI,RAIPUR,13109,13343,MUMBAI-RAIPUR,26452,All
2022,8,MUMBAI,RAIPUR,15540,15863,MUMBAI-RAIPUR,31403,All
2022,9,MUMBAI,RAIPUR,16471,16621,MUMBAI-RAIPUR,33092,All
2022,10,MUMBAI,RAIPUR,17550,14631,MUMBAI-RAIPUR,32181,All
2022,11,MUMBAI,RAIPUR,17224,19089,MUMBAI-RAIPUR,36313,All
2022,12,MUMBAI,RAIPUR,20892,19476,MUMBAI-RAIPUR,40368,All
2023,1,MUMBAI,RAIPUR,19859,18132,MUMBAI-RAIPUR,37991,All
2023,2,MUMBAI,RAIPUR,15885,14805,MUMBAI-RAIPUR,30690,All
2023,3,MUMBAI,RAIPUR,15867,15465,MUMBAI-RAIPUR,31332,All
2023,4,MUMBAI,RAIPUR,16213,15279,MUMBAI-RAIPUR,31492,All
2023,5,MUMBAI,RAIPUR,17937,17573,MUMBAI-RAIPUR,35510,All
2023,6,MUMBAI,RAIPUR,17693,17609,MUMBAI-RAIPUR,35302,All
2023,7,MUMBAI,RAIPUR,16718,17298,MUMBAI-RAIPUR,34016,All
2023,8,MUMBAI,RAIPUR,17327,17055,MUMBAI-RAIPUR,34382,All
2023,9,MUMBAI,RAIPUR,16626,16467,MUMBAI-RAIPUR,33093,All
2023,10,MUMBAI,RAIPUR,17231,15908,MUMBAI-RAIPUR,33139,All
2023,11,MUMBAI,RAIPUR,15089,13907,MUMBAI-RAIPUR,28996,All
2023,12,MUMBAI,RAIPUR,16746,17141,MUMBAI-RAIPUR,33887,All
2024,1,MUMBAI,RAIPUR,17048,17236,MUMBAI-RAIPUR,34284,All
2024,2,MUMBAI,RAIPUR,14595,14704,MUMBAI-RAIPUR,29299,All
2024,3,MUMBAI,RAIPUR,15843,15516,MUMBAI-RAIPUR,31359,All
2024,4,MUMBAI,RAIPUR,16420,15189,MUMBAI-RAIPUR,31609,All
2024,6,MUMBAI,RAIPUR,15088,14965,MUMBAI-RAIPUR,30053,All
2024,7,MUMBAI,RAIPUR,15115,15844,MUMBAI-RAIPUR,30959,All
2024,8,MUMBAI,RAIPUR,15411,15958,MUMBAI-RAIPUR,31369,All
2024,9,MUMBAI,RAIPUR,14524,14843,MUMBAI-RAIPUR,29367,All
2024,10,MUMBAI,RAIPUR,16210,12421,MUMBAI-RAIPUR,28631,All
2024,11,MUMBAI,RAIPUR,14564,16966,MUMBAI-RAIPUR,31530,All
2024,12,MUMBAI,RAIPUR,16275,16611,MUMBAI-RAIPUR,32886,All
2025,1,MUMBAI,RAIPUR,15951,16350,MUMBAI-RAIPUR,32301,All
2025,2,MUMBAI,RAIPUR,15106,14895,MUMBAI-RAIPUR,30001,All
2025,3,MUMBAI,RAIPUR,14718,15130,MUMBAI-RAIPUR,29848,All
2024,12,MUMBAI,RAJAHMUNDRY,4375,3773,MUMBAI-RAJAHMUNDRY,8148,All
2025,1,MUMBAI,RAJAHMUNDRY,4315,4524,MUMBAI-RAJAHMUNDRY,8839,All
2025,2,MUMBAI,RAJAHMUNDRY,1947,1916,MUMBAI-RAJAHMUNDRY,3863,All
2025,3,MUMBAI,RAJAHMUNDRY,3629,3486,MUMBAI-RAJAHMUNDRY,7115,All
2015,4,MUMBAI,RAJKOT,16634,15690,MUMBAI-RAJKOT,32324,All
2015,5,MUMBAI,RAJKOT,15380,15176,MUMBAI-RAJKOT,30556,All
2015,6,MUMBAI,RAJKOT,14236,13489,MUMBAI-RAJKOT,27725,All
2015,7,MUMBAI,RAJKOT,14326,13826,MUMBAI-RAJKOT,28152,All
2015,8,MUMBAI,RAJKOT,13326,14501,MUMBAI-RAJKOT,27827,All
2015,9,MUMBAI,RAJKOT,14066,13881,MUMBAI-RAJKOT,27947,All
2015,10,MUMBAI,RAJKOT,11943,13428,MUMBAI-RAJKOT,25371,All
2015,11,MUMBAI,RAJKOT,16604,14324,MUMBAI-RAJKOT,30928,All
2015,12,MUMBAI,RAJKOT,17147,16377,MUMBAI-RAJKOT,33524,All
2016,1,MUMBAI,RAJKOT,17125,16545,MUMBAI-RAJKOT,33670,All
2016,2,MUMBAI,RAJKOT,16151,16657,MUMBAI-RAJKOT,32808,All
2016,3,MUMBAI,RAJKOT,13016,14256,MUMBAI-RAJKOT,27272,All
2016,4,MUMBAI,RAJKOT,12925,11897,MUMBAI-RAJKOT,24822,All
2016,5,MUMBAI,RAJKOT,14580,14006,MUMBAI-RAJKOT,28586,All
2016,6,MUMBAI,RAJKOT,14405,11902,MUMBAI-RAJKOT,26307,All
2016,7,MUMBAI,RAJKOT,16650,14226,MUMBAI-RAJKOT,30876,All
2016,8,MUMBAI,RAJKOT,16783,15683,MUMBAI-RAJKOT,32466,All
2016,9,MUMBAI,RAJKOT,16569,15290,MUMBAI-RAJKOT,31859,All
2016,10,MUMBAI,RAJKOT,16327,14828,MUMBAI-RAJKOT,31155,All
2016,11,MUMBAI,RAJKOT,14842,13471,MUMBAI-RAJKOT,28313,All
2016,12,MUMBAI,RAJKOT,17121,16942,MUMBAI-RAJKOT,34063,All
2017,1,MUMBAI,RAJKOT,17828,17178,MUMBAI-RAJKOT,35006,All
2017,2,MUMBAI,RAJKOT,16088,16516,MUMBAI-RAJKOT,32604,All
2017,3,MUMBAI,RAJKOT,15574,16212,MUMBAI-RAJKOT,31786,All
2017,4,MUMBAI,RAJKOT,13190,12596,MUMBAI-RAJKOT,25786,All
2017,5,MUMBAI,RAJKOT,12395,12844,MUMBAI-RAJKOT,25239,All
2017,6,MUMBAI,RAJKOT,10787,10107,MUMBAI-RAJKOT,20894,All
2017,7,MUMBAI,RAJKOT,12679,12009,MUMBAI-RAJKOT,24688,All
2017,8,MUMBAI,RAJKOT,11516,12318,MUMBAI-RAJKOT,23834,All
2017,9,MUMBAI,RAJKOT,10814,10212,MUMBAI-RAJKOT,21026,All
2017,10,MUMBAI,RAJKOT,11970,11467,MUMBAI-RAJKOT,23437,All
2017,11,MUMBAI,RAJKOT,12451,10904,MUMBAI-RAJKOT,23355,All
2017,12,MUMBAI,RAJKOT,13239,13023,MUMBAI-RAJKOT,26262,All
2018,1,MUMBAI,RAJKOT,13912,13709,MUMBAI-RAJKOT,27621,All
2018,2,MUMBAI,RAJKOT,13092,12859,MUMBAI-RAJKOT,25951,All
2018,3,MUMBAI,RAJKOT,12892,13362,MUMBAI-RAJKOT,26254,All
2018,4,MUMBAI,RAJKOT,11927,11210,MUMBAI-RAJKOT,23137,All
2018,5,MUMBAI,RAJKOT,11293,11585,MUMBAI-RAJKOT,22878,All
2018,6,MUMBAI,RAJKOT,12080,10745,MUMBAI-RAJKOT,22825,All
2018,7,MUMBAI,RAJKOT,11715,10886,MUMBAI-RAJKOT,22601,All
2018,8,MUMBAI,RAJKOT,10417,12227,MUMBAI-RAJKOT,22644,All
2018,9,MUMBAI,RAJKOT,10179,11385,MUMBAI-RAJKOT,21564,All
2018,10,MUMBAI,RAJKOT,11702,11536,MUMBAI-RAJKOT,23238,All
2018,11,MUMBAI,RAJKOT,10794,10484,MUMBAI-RAJKOT,21278,All
2018,12,MUMBAI,RAJKOT,11048,10661,MUMBAI-RAJKOT,21709,All
2019,1,MUMBAI,RAJKOT,11148,10698,MUMBAI-RAJKOT,21846,All
2019,2,MUMBAI,RAJKOT,8915,8817,MUMBAI-RAJKOT,17732,All
2019,3,MUMBAI,RAJKOT,7158,7293,MUMBAI-RAJKOT,14451,All
2019,4,MUMBAI,RAJKOT,3200,3201,MUMBAI-RAJKOT,6401,All
2019,5,MUMBAI,RAJKOT,3503,3600,MUMBAI-RAJKOT,7103,All
2019,6,MUMBAI,RAJKOT,3252,3140,MUMBAI-RAJKOT,6392,All
2019,7,MUMBAI,RAJKOT,1580,1533,MUMBAI-RAJKOT,3113,All
2019,8,MUMBAI,RAJKOT,2109,2113,MUMBAI-RAJKOT,4222,All
2019,9,MUMBAI,RAJKOT,2378,2284,MUMBAI-RAJKOT,4662,All
2019,10,MUMBAI,RAJKOT,4694,4799,MUMBAI-RAJKOT,9493,All
2019,11,MUMBAI,RAJKOT,8406,7684,MUMBAI-RAJKOT,16090,All
2019,12,MUMBAI,RAJKOT,8455,8192,MUMBAI-RAJKOT,16647,All
2020,1,MUMBAI,RAJKOT,8291,8074,MUMBAI-RAJKOT,16365,All
2020,2,MUMBAI,RAJKOT,7869,7741,MUMBAI-RAJKOT,15610,All
2020,3,MUMBAI,RAJKOT,5421,4971,MUMBAI-RAJKOT,10392,All
2020,5,MUMBAI,RAJKOT,311,155,MUMBAI-RAJKOT,466,All
2020,6,MUMBAI,RAJKOT,296,190,MUMBAI-RAJKOT,486,All
2020,7,MUMBAI,RAJKOT,676,521,MUMBAI-RAJKOT,1197,All
2020,8,MUMBAI,RAJKOT,1175,1136,MUMBAI-RAJKOT,2311,All
2020,9,MUMBAI,RAJKOT,2307,2312,MUMBAI-RAJKOT,4619,All
2020,10,MUMBAI,RAJKOT,3613,3656,MUMBAI-RAJKOT,7269,All
2020,11,MUMBAI,RAJKOT,5124,4960,MUMBAI-RAJKOT,10084,All
2020,12,MUMBAI,RAJKOT,4807,4757,MUMBAI-RAJKOT,9564,All
2021,1,MUMBAI,RAJKOT,5555,5468,MUMBAI-RAJKOT,11023,All
2021,2,MUMBAI,RAJKOT,5941,5858,MUMBAI-RAJKOT,11799,All
2021,3,MUMBAI,RAJKOT,6688,6274,MUMBAI-RAJKOT,12962,All
2021,4,MUMBAI,RAJKOT,3058,2638,MUMBAI-RAJKOT,5696,All
2021,6,MUMBAI,RAJKOT,1917,1947,MUMBAI-RAJKOT,3864,All
2021,7,MUMBAI,RAJKOT,4671,4435,MUMBAI-RAJKOT,9106,All
2021,8,MUMBAI,RAJKOT,7558,8030,MUMBAI-RAJKOT,15588,All
2021,9,MUMBAI,RAJKOT,9564,8005,MUMBAI-RAJKOT,17569,All
2021,10,MUMBAI,RAJKOT,11225,10959,MUMBAI-RAJKOT,22184,All
2021,11,MUMBAI,RAJKOT,16020,15548,MUMBAI-RAJKOT,31568,All
2021,12,MUMBAI,RAJKOT,15813,15415,MUMBAI-RAJKOT,31228,All
2022,1,MUMBAI,RAJKOT,7464,7724,MUMBAI-RAJKOT,15188,All
2022,2,MUMBAI,RAJKOT,8667,8420,MUMBAI-RAJKOT,17087,All
2022,3,MUMBAI,RAJKOT,13744,13569,MUMBAI-RAJKOT,27313,All
2022,4,MUMBAI,RAJKOT,12738,12009,MUMBAI-RAJKOT,24747,All
2022,5,MUMBAI,RAJKOT,13850,14173,MUMBAI-RAJKOT,28023,All
2022,6,MUMBAI,RAJKOT,13269,11331,MUMBAI-RAJKOT,24600,All
2022,7,MUMBAI,RAJKOT,12303,11500,MUMBAI-RAJKOT,23803,All
2022,8,MUMBAI,RAJKOT,13146,13858,MUMBAI-RAJKOT,27004,All
2022,9,MUMBAI,RAJKOT,14336,13577,MUMBAI-RAJKOT,27913,All
2022,10,MUMBAI,RAJKOT,13880,13983,MUMBAI-RAJKOT,27863,All
2022,11,MUMBAI,RAJKOT,13994,13834,MUMBAI-RAJKOT,27828,All
2022,12,MUMBAI,RAJKOT,13224,12930,MUMBAI-RAJKOT,26154,All
2023,1,MUMBAI,RAJKOT,15649,15250,MUMBAI-RAJKOT,30899,All
2023,2,MUMBAI,RAJKOT,13021,12900,MUMBAI-RAJKOT,25921,All
2023,3,MUMBAI,RAJKOT,14334,14186,MUMBAI-RAJKOT,28520,All
2023,4,MUMBAI,RAJKOT,15358,15153,MUMBAI-RAJKOT,30511,All
2023,5,MUMBAI,RAJKOT,23174,23140,MUMBAI-RAJKOT,46314,All
2023,6,MUMBAI,RAJKOT,20596,19042,MUMBAI-RAJKOT,39638,All
2023,7,MUMBAI,RAJKOT,22568,21577,MUMBAI-RAJKOT,44145,All
2023,8,MUMBAI,RAJKOT,23043,23049,MUMBAI-RAJKOT,46092,All
2023,9,MUMBAI,RAJKOT,5597,5910,MUMBAI-RAJKOT,11507,All
2015,4,MUMBAI,RANCHI,3248,5862,MUMBAI-RANCHI,9110,All
2015,5,MUMBAI,RANCHI,3364,9266,MUMBAI-RANCHI,12630,All
2015,6,MUMBAI,RANCHI,3026,8518,MUMBAI-RANCHI,11544,All
2015,7,MUMBAI,RANCHI,2274,6362,MUMBAI-RANCHI,8636,All
2015,8,MUMBAI,RANCHI,2534,5774,MUMBAI-RANCHI,8308,All
2015,9,MUMBAI,RANCHI,2987,6465,MUMBAI-RANCHI,9452,All
2015,10,MUMBAI,RANCHI,6120,13434,MUMBAI-RANCHI,19554,All
2015,11,MUMBAI,RANCHI,1749,7486,MUMBAI-RANCHI,9235,All
2015,12,MUMBAI,RANCHI,2767,8586,MUMBAI-RANCHI,11353,All
2016,1,MUMBAI,RANCHI,2982,8614,MUMBAI-RANCHI,11596,All
2016,2,MUMBAI,RANCHI,2455,7716,MUMBAI-RANCHI,10171,All
2016,3,MUMBAI,RANCHI,2523,8191,MUMBAI-RANCHI,10714,All
2016,4,MUMBAI,RANCHI,2397,7363,MUMBAI-RANCHI,9760,All
2016,5,MUMBAI,RANCHI,2859,7991,MUMBAI-RANCHI,10850,All
2016,6,MUMBAI,RANCHI,2953,7877,MUMBAI-RANCHI,10830,All
2016,7,MUMBAI,RANCHI,3259,8743,MUMBAI-RANCHI,12002,All
2016,8,MUMBAI,RANCHI,3578,8213,MUMBAI-RANCHI,11791,All
2016,9,MUMBAI,RANCHI,3361,8926,MUMBAI-RANCHI,12287,All
2016,10,MUMBAI,RANCHI,2791,8261,MUMBAI-RANCHI,11052,All
2016,11,MUMBAI,RANCHI,1541,7781,MUMBAI-RANCHI,9322,All
2016,12,MUMBAI,RANCHI,1999,8640,MUMBAI-RANCHI,10639,All
2017,1,MUMBAI,RANCHI,1875,8222,MUMBAI-RANCHI,10097,All
2017,2,MUMBAI,RANCHI,1703,7329,MUMBAI-RANCHI,9032,All
2017,3,MUMBAI,RANCHI,1508,8013,MUMBAI-RANCHI,9521,All
2017,4,MUMBAI,RANCHI,1263,7897,MUMBAI-RANCHI,9160,All
2017,5,MUMBAI,RANCHI,1240,8658,MUMBAI-RANCHI,9898,All
2017,6,MUMBAI,RANCHI,1520,8016,MUMBAI-RANCHI,9536,All
2017,7,MUMBAI,RANCHI,1984,8702,MUMBAI-RANCHI,10686,All
2017,8,MUMBAI,RANCHI,1568,8659,MUMBAI-RANCHI,10227,All
2017,9,MUMBAI,RANCHI,1245,8210,MUMBAI-RANCHI,9455,All
2017,10,MUMBAI,RANCHI,1559,8188,MUMBAI-RANCHI,9747,All
2017,11,MUMBAI,RANCHI,1981,9832,MUMBAI-RANCHI,11813,All
2017,12,MUMBAI,RANCHI,2339,9866,MUMBAI-RANCHI,12205,All
2018,1,MUMBAI,RANCHI,2031,9542,MUMBAI-RANCHI,11573,All
2018,2,MUMBAI,RANCHI,2119,9343,MUMBAI-RANCHI,11462,All
2018,3,MUMBAI,RANCHI,2739,10441,MUMBAI-RANCHI,13180,All
2018,4,MUMBAI,RANCHI,6403,10479,MUMBAI-RANCHI,16882,All
2018,5,MUMBAI,RANCHI,6348,10065,MUMBAI-RANCHI,16413,All
2018,6,MUMBAI,RANCHI,6244,9202,MUMBAI-RANCHI,15446,All
2018,7,MUMBAI,RANCHI,6385,9417,MUMBAI-RANCHI,15802,All
2018,8,MUMBAI,RANCHI,6708,8691,MUMBAI-RANCHI,15399,All
2018,9,MUMBAI,RANCHI,7235,9355,MUMBAI-RANCHI,16590,All
2018,10,MUMBAI,RANCHI,8374,8929,MUMBAI-RANCHI,17303,All
2018,11,MUMBAI,RANCHI,7200,9145,MUMBAI-RANCHI,16345,All
2018,12,MUMBAI,RANCHI,8032,11095,MUMBAI-RANCHI,19127,All
2019,1,MUMBAI,RANCHI,8167,9281,MUMBAI-RANCHI,17448,All
2019,2,MUMBAI,RANCHI,5136,9143,MUMBAI-RANCHI,14279,All
2019,3,MUMBAI,RANCHI,5576,9711,MUMBAI-RANCHI,15287,All
2019,4,MUMBAI,RANCHI,7854,9409,MUMBAI-RANCHI,17263,All
2019,5,MUMBAI,RANCHI,16769,18492,MUMBAI-RANCHI,35261,All
2019,6,MUMBAI,RANCHI,16156,20020,MUMBAI-RANCHI,36176,All
2019,7,MUMBAI,RANCHI,13103,17103,MUMBAI-RANCHI,30206,All
2019,8,MUMBAI,RANCHI,15072,16320,MUMBAI-RANCHI,31392,All
2019,9,MUMBAI,RANCHI,15770,15599,MUMBAI-RANCHI,31369,All
2019,10,MUMBAI,RANCHI,17247,15288,MUMBAI-RANCHI,32535,All
2019,11,MUMBAI,RANCHI,15894,18842,MUMBAI-RANCHI,34736,All
2019,12,MUMBAI,RANCHI,16050,19075,MUMBAI-RANCHI,35125,All
2020,1,MUMBAI,RANCHI,15394,17012,MUMBAI-RANCHI,32406,All
2020,2,MUMBAI,RANCHI,14837,15762,MUMBAI-RANCHI,30599,All
2020,3,MUMBAI,RANCHI,11744,9599,MUMBAI-RANCHI,21343,All
2020,5,MUMBAI,RANCHI,575,54,MUMBAI-RANCHI,629,All
2020,6,MUMBAI,RANCHI,7563,4197,MUMBAI-RANCHI,11760,All
2020,7,MUMBAI,RANCHI,7339,7072,MUMBAI-RANCHI,14411,All
2020,8,MUMBAI,RANCHI,5707,12445,MUMBAI-RANCHI,18152,All
2020,9,MUMBAI,RANCHI,6478,14574,MUMBAI-RANCHI,21052,All
2020,10,MUMBAI,RANCHI,12127,16729,MUMBAI-RANCHI,28856,All
2020,11,MUMBAI,RANCHI,15116,16050,MUMBAI-RANCHI,31166,All
2020,12,MUMBAI,RANCHI,13420,18216,MUMBAI-RANCHI,31636,All
2021,1,MUMBAI,RANCHI,12223,21309,MUMBAI-RANCHI,33532,All
2021,2,MUMBAI,RANCHI,13289,17460,MUMBAI-RANCHI,30749,All
2021,3,MUMBAI,RANCHI,14673,12544,MUMBAI-RANCHI,27217,All
2021,4,MUMBAI,RANCHI,16548,6519,MUMBAI-RANCHI,23067,All
2021,6,MUMBAI,RANCHI,4840,8827,MUMBAI-RANCHI,13667,All
2021,7,MUMBAI,RANCHI,7362,8967,MUMBAI-RANCHI,16329,All
2021,8,MUMBAI,RANCHI,9045,12468,MUMBAI-RANCHI,21513,All
2021,9,MUMBAI,RANCHI,8841,11130,MUMBAI-RANCHI,19971,All
2021,10,MUMBAI,RANCHI,15741,16262,MUMBAI-RANCHI,32003,All
2021,11,MUMBAI,RANCHI,14338,15126,MUMBAI-RANCHI,29464,All
2021,12,MUMBAI,RANCHI,13364,17165,MUMBAI-RANCHI,30529,All
2022,1,MUMBAI,RANCHI,7605,9907,MUMBAI-RANCHI,17512,All
2022,2,MUMBAI,RANCHI,10646,12630,MUMBAI-RANCHI,23276,All
2022,3,MUMBAI,RANCHI,13507,15753,MUMBAI-RANCHI,29260,All
2022,4,MUMBAI,RANCHI,13996,14699,MUMBAI-RANCHI,28695,All
2022,5,MUMBAI,RANCHI,14100,17405,MUMBAI-RANCHI,31505,All
2022,6,MUMBAI,RANCHI,11634,15121,MUMBAI-RANCHI,26755,All
2022,7,MUMBAI,RANCHI,11797,13117,MUMBAI-RANCHI,24914,All
2022,8,MUMBAI,RANCHI,11394,13450,MUMBAI-RANCHI,24844,All
2022,9,MUMBAI,RANCHI,12954,12170,MUMBAI-RANCHI,25124,All
2022,10,MUMBAI,RANCHI,16741,13288,MUMBAI-RANCHI,30029,All
2022,11,MUMBAI,RANCHI,13230,17631,MUMBAI-RANCHI,30861,All
2022,12,MUMBAI,RANCHI,15638,16638,MUMBAI-RANCHI,32276,All
2023,1,MUMBAI,RANCHI,14708,14810,MUMBAI-RANCHI,29518,All
2023,2,MUMBAI,RANCHI,13122,12347,MUMBAI-RANCHI,25469,All
2023,3,MUMBAI,RANCHI,12507,12159,MUMBAI-RANCHI,24666,All
2023,4,MUMBAI,RANCHI,15468,12734,MUMBAI-RANCHI,28202,All
2023,5,MUMBAI,RANCHI,12407,12405,MUMBAI-RANCHI,24812,All
2023,6,MUMBAI,RANCHI,17264,16487,MUMBAI-RANCHI,33751,All
2023,7,MUMBAI,RANCHI,12095,13294,MUMBAI-RANCHI,25389,All
2023,8,MUMBAI,RANCHI,12322,12571,MUMBAI-RANCHI,24893,All
2023,9,MUMBAI,RANCHI,11952,12223,MUMBAI-RANCHI,24175,All
2023,10,MUMBAI,RANCHI,18418,14121,MUMBAI-RANCHI,32539,All
2023,11,MUMBAI,RANCHI,9986,9136,MUMBAI-RANCHI,19122,All
2023,12,MUMBAI,RANCHI,9995,9829,MUMBAI-RANCHI,19824,All
2024,1,MUMBAI,RANCHI,10471,9527,MUMBAI-RANCHI,19998,All
2024,2,MUMBAI,RANCHI,9187,8995,MUMBAI-RANCHI,18182,All
2024,3,MUMBAI,RANCHI,10862,10103,MUMBAI-RANCHI,20965,All
2024,4,MUMBAI,RANCHI,9667,9039,MUMBAI-RANCHI,18706,All
2024,6,MUMBAI,RANCHI,9909,9695,MUMBAI-RANCHI,19604,All
2024,7,MUMBAI,RANCHI,10261,10953,MUMBAI-RANCHI,21214,All
2024,8,MUMBAI,RANCHI,10678,11162,MUMBAI-RANCHI,21840,All
2024,9,MUMBAI,RANCHI,10476,10089,MUMBAI-RANCHI,20565,All
2024,10,MUMBAI,RANCHI,11295,9522,MUMBAI-RANCHI,20817,All
2024,11,MUMBAI,RANCHI,9678,9577,MUMBAI-RANCHI,19255,All
2024,12,MUMBAI,RANCHI,9881,10056,MUMBAI-RANCHI,19937,All
2025,1,MUMBAI,RANCHI,10183,10054,MUMBAI-RANCHI,20237,All
2025,2,MUMBAI,RANCHI,9222,8849,MUMBAI-RANCHI,18071,All
2025,3,MUMBAI,RANCHI,9893,9050,MUMBAI-RANCHI,18943,All
2023,11,MUMBAI,Rajkot International Airport,22824,22320,MUMBAI-Rajkot International Airport,45144,All
2023,12,MUMBAI,Rajkot International Airport,26598,25555,MUMBAI-Rajkot International Airport,52153,All
2024,1,MUMBAI,Rajkot International Airport,26464,25496,MUMBAI-Rajkot International Airport,51960,All
2024,2,MUMBAI,Rajkot International Airport,25558,24583,MUMBAI-Rajkot International Airport,50141,All
2024,3,MUMBAI,Rajkot International Airport,22187,23434,MUMBAI-Rajkot International Airport,45621,All
2024,4,MUMBAI,Rajkot International Airport,21463,20139,MUMBAI-Rajkot International Airport,41602,All
2024,6,MUMBAI,Rajkot International Airport,22085,20129,MUMBAI-Rajkot International Airport,42214,All
2024,7,MUMBAI,Rajkot International Airport,21256,19906,MUMBAI-Rajkot International Airport,41162,All
2024,8,MUMBAI,Rajkot International Airport,22485,21815,MUMBAI-Rajkot International Airport,44300,All
2024,9,MUMBAI,Rajkot International Airport,23812,21375,MUMBAI-Rajkot International Airport,45187,All
2024,10,MUMBAI,Rajkot International Airport,22997,20519,MUMBAI-Rajkot International Airport,43516,All
2024,11,MUMBAI,Rajkot International Airport,26128,25272,MUMBAI-Rajkot International Airport,51400,All
2024,12,MUMBAI,Rajkot International Airport,27736,26232,MUMBAI-Rajkot International Airport,53968,All
2025,1,MUMBAI,Rajkot International Airport,26595,26405,MUMBAI-Rajkot International Airport,53000,All
2025,2,MUMBAI,Rajkot International Airport,22452,22054,MUMBAI-Rajkot International Airport,44506,All
2025,3,MUMBAI,Rajkot International Airport,22681,23250,MUMBAI-Rajkot International Airport,45931,All
2017,10,MUMBAI,SHIRDI,1126,1083,MUMBAI-SHIRDI,2209,All
2017,11,MUMBAI,SHIRDI,1658,1668,MUMBAI-SHIRDI,3326,All
2017,12,MUMBAI,SHIRDI,1702,1660,MUMBAI-SHIRDI,3362,All
2018,1,MUMBAI,SHIRDI,1624,1735,MUMBAI-SHIRDI,3359,All
2018,2,MUMBAI,SHIRDI,1495,1434,MUMBAI-SHIRDI,2929,All
2018,3,MUMBAI,SHIRDI,1637,1591,MUMBAI-SHIRDI,3228,All
2018,4,MUMBAI,SHIRDI,1423,1349,MUMBAI-SHIRDI,2772,All
2018,5,MUMBAI,SHIRDI,1270,1214,MUMBAI-SHIRDI,2484,All
2018,6,MUMBAI,SHIRDI,1244,1147,MUMBAI-SHIRDI,2391,All
2018,7,MUMBAI,SHIRDI,1703,1642,MUMBAI-SHIRDI,3345,All
2018,8,MUMBAI,SHIRDI,1403,1370,MUMBAI-SHIRDI,2773,All
2018,9,MUMBAI,SHIRDI,1527,1461,MUMBAI-SHIRDI,2988,All
2018,10,MUMBAI,SHIRDI,1101,1023,MUMBAI-SHIRDI,2124,All
2018,11,MUMBAI,SHIRDI,1015,912,MUMBAI-SHIRDI,1927,All
2018,12,MUMBAI,SHIRDI,1277,1206,MUMBAI-SHIRDI,2483,All
2019,1,MUMBAI,SHIRDI,839,903,MUMBAI-SHIRDI,1742,All
2019,2,MUMBAI,SHIRDI,337,359,MUMBAI-SHIRDI,696,All
2019,3,MUMBAI,SHIRDI,300,282,MUMBAI-SHIRDI,582,All
2019,4,MUMBAI,SHIRDI,655,573,MUMBAI-SHIRDI,1228,All
2019,5,MUMBAI,SHIRDI,1044,1023,MUMBAI-SHIRDI,2067,All
2019,6,MUMBAI,SHIRDI,1141,1154,MUMBAI-SHIRDI,2295,All
2019,7,MUMBAI,SHIRDI,980,973,MUMBAI-SHIRDI,1953,All
2019,8,MUMBAI,SHIRDI,1077,1155,MUMBAI-SHIRDI,2232,All
2019,9,MUMBAI,SHIRDI,1004,1112,MUMBAI-SHIRDI,2116,All
2019,10,MUMBAI,SHIRDI,940,945,MUMBAI-SHIRDI,1885,All
2019,11,MUMBAI,SHIRDI,300,445,MUMBAI-SHIRDI,745,All
2019,12,MUMBAI,SHIRDI,694,711,MUMBAI-SHIRDI,1405,All
2020,1,MUMBAI,SHIRDI,1049,1077,MUMBAI-SHIRDI,2126,All
2020,2,MUMBAI,SHIRDI,870,973,MUMBAI-SHIRDI,1843,All
2020,3,MUMBAI,SHIRDI,374,411,MUMBAI-SHIRDI,785,All
2024,11,MUMBAI,SHIRDI,4,1,MUMBAI-SHIRDI,5,All
2018,10,MUMBAI,SILCHAR,3,0,MUMBAI-SILCHAR,3,All
2018,11,MUMBAI,SILCHAR,11,0,MUMBAI-SILCHAR,11,All
2018,12,MUMBAI,SILCHAR,17,0,MUMBAI-SILCHAR,17,All
2019,1,MUMBAI,SILCHAR,3,0,MUMBAI-SILCHAR,3,All
2021,3,MUMBAI,SILCHAR,44,34,MUMBAI-SILCHAR,78,All
2021,4,MUMBAI,SILCHAR,439,270,MUMBAI-SILCHAR,709,All
2022,1,MUMBAI,SILCHAR,98,0,MUMBAI-SILCHAR,98,All
2022,2,MUMBAI,SILCHAR,60,0,MUMBAI-SILCHAR,60,All
2022,3,MUMBAI,SILCHAR,17,63,MUMBAI-SILCHAR,80,All
2022,4,MUMBAI,SILCHAR,37,95,MUMBAI-SILCHAR,132,All
2022,5,MUMBAI,SILCHAR,49,267,MUMBAI-SILCHAR,316,All
2022,6,MUMBAI,SILCHAR,48,353,MUMBAI-SILCHAR,401,All
2022,7,MUMBAI,SILCHAR,37,56,MUMBAI-SILCHAR,93,All
2022,8,MUMBAI,SILCHAR,13,17,MUMBAI-SILCHAR,30,All
2022,9,MUMBAI,SILCHAR,35,17,MUMBAI-SILCHAR,52,All
2022,10,MUMBAI,SILCHAR,84,100,MUMBAI-SILCHAR,184,All
2022,11,MUMBAI,SILCHAR,16,0,MUMBAI-SILCHAR,16,All
2022,12,MUMBAI,SILCHAR,8,0,MUMBAI-SILCHAR,8,All
2023,3,MUMBAI,SILCHAR,201,342,MUMBAI-SILCHAR,543,All
2023,4,MUMBAI,SILCHAR,182,361,MUMBAI-SILCHAR,543,All
2023,5,MUMBAI,SILCHAR,106,276,MUMBAI-SILCHAR,382,All
2023,6,MUMBAI,SILCHAR,68,218,MUMBAI-SILCHAR,286,All
2023,7,MUMBAI,SILCHAR,42,177,MUMBAI-SILCHAR,219,All
2023,8,MUMBAI,SILCHAR,73,91,MUMBAI-SILCHAR,164,All
2023,9,MUMBAI,SILCHAR,64,50,MUMBAI-SILCHAR,114,All
2023,10,MUMBAI,SILCHAR,145,166,MUMBAI-SILCHAR,311,All
2015,4,MUMBAI,SRINAGAR,9462,6473,MUMBAI-SRINAGAR,15935,All
2015,5,MUMBAI,SRINAGAR,14917,10627,MUMBAI-SRINAGAR,25544,All
2015,6,MUMBAI,SRINAGAR,10063,9961,MUMBAI-SRINAGAR,20024,All
2015,7,MUMBAI,SRINAGAR,11790,8206,MUMBAI-SRINAGAR,19996,All
2015,8,MUMBAI,SRINAGAR,7995,6521,MUMBAI-SRINAGAR,14516,All
2015,9,MUMBAI,SRINAGAR,8083,5419,MUMBAI-SRINAGAR,13502,All
2015,10,MUMBAI,SRINAGAR,19262,19841,MUMBAI-SRINAGAR,39103,All
2015,11,MUMBAI,SRINAGAR,5060,9506,MUMBAI-SRINAGAR,14566,All
2015,12,MUMBAI,SRINAGAR,5113,11035,MUMBAI-SRINAGAR,16148,All
2016,1,MUMBAI,SRINAGAR,4481,9882,MUMBAI-SRINAGAR,14363,All
2016,2,MUMBAI,SRINAGAR,5052,10347,MUMBAI-SRINAGAR,15399,All
2016,3,MUMBAI,SRINAGAR,6781,12587,MUMBAI-SRINAGAR,19368,All
2016,4,MUMBAI,SRINAGAR,9331,15638,MUMBAI-SRINAGAR,24969,All
2016,5,MUMBAI,SRINAGAR,9713,19794,MUMBAI-SRINAGAR,29507,All
2016,6,MUMBAI,SRINAGAR,6799,16547,MUMBAI-SRINAGAR,23346,All
2016,7,MUMBAI,SRINAGAR,3472,13683,MUMBAI-SRINAGAR,17155,All
2016,8,MUMBAI,SRINAGAR,1352,8901,MUMBAI-SRINAGAR,10253,All
2016,9,MUMBAI,SRINAGAR,994,6989,MUMBAI-SRINAGAR,7983,All
2016,10,MUMBAI,SRINAGAR,969,4496,MUMBAI-SRINAGAR,5465,All
2016,11,MUMBAI,SRINAGAR,399,4181,MUMBAI-SRINAGAR,4580,All
2016,12,MUMBAI,SRINAGAR,626,7444,MUMBAI-SRINAGAR,8070,All
2017,1,MUMBAI,SRINAGAR,510,6645,MUMBAI-SRINAGAR,7155,All
2017,2,MUMBAI,SRINAGAR,435,5110,MUMBAI-SRINAGAR,5545,All
2017,3,MUMBAI,SRINAGAR,630,5683,MUMBAI-SRINAGAR,6313,All
2017,4,MUMBAI,SRINAGAR,2613,7673,MUMBAI-SRINAGAR,10286,All
2017,5,MUMBAI,SRINAGAR,3931,15224,MUMBAI-SRINAGAR,19155,All
2017,6,MUMBAI,SRINAGAR,2360,12328,MUMBAI-SRINAGAR,14688,All
2017,7,MUMBAI,SRINAGAR,3180,15018,MUMBAI-SRINAGAR,18198,All
2017,8,MUMBAI,SRINAGAR,920,11323,MUMBAI-SRINAGAR,12243,All
2017,9,MUMBAI,SRINAGAR,845,12481,MUMBAI-SRINAGAR,13326,All
2017,10,MUMBAI,SRINAGAR,997,8578,MUMBAI-SRINAGAR,9575,All
2017,11,MUMBAI,SRINAGAR,1080,8782,MUMBAI-SRINAGAR,9862,All
2017,12,MUMBAI,SRINAGAR,1810,8784,MUMBAI-SRINAGAR,10594,All
2018,1,MUMBAI,SRINAGAR,1750,8427,MUMBAI-SRINAGAR,10177,All
2018,2,MUMBAI,SRINAGAR,1766,7727,MUMBAI-SRINAGAR,9493,All
2018,3,MUMBAI,SRINAGAR,2127,9445,MUMBAI-SRINAGAR,11572,All
2018,4,MUMBAI,SRINAGAR,2131,9093,MUMBAI-SRINAGAR,11224,All
2018,5,MUMBAI,SRINAGAR,2914,15551,MUMBAI-SRINAGAR,18465,All
2018,6,MUMBAI,SRINAGAR,2352,13689,MUMBAI-SRINAGAR,16041,All
2018,7,MUMBAI,SRINAGAR,2055,15219,MUMBAI-SRINAGAR,17274,All
2018,8,MUMBAI,SRINAGAR,880,13097,MUMBAI-SRINAGAR,13977,All
2018,9,MUMBAI,SRINAGAR,364,12824,MUMBAI-SRINAGAR,13188,All
2018,10,MUMBAI,SRINAGAR,711,9172,MUMBAI-SRINAGAR,9883,All
2018,11,MUMBAI,SRINAGAR,1456,8473,MUMBAI-SRINAGAR,9929,All
2018,12,MUMBAI,SRINAGAR,1999,9062,MUMBAI-SRINAGAR,11061,All
2019,1,MUMBAI,SRINAGAR,1333,7468,MUMBAI-SRINAGAR,8801,All
2019,2,MUMBAI,SRINAGAR,1171,6629,MUMBAI-SRINAGAR,7800,All
2019,3,MUMBAI,SRINAGAR,1166,5224,MUMBAI-SRINAGAR,6390,All
2019,4,MUMBAI,SRINAGAR,1711,8389,MUMBAI-SRINAGAR,10100,All
2019,5,MUMBAI,SRINAGAR,6209,14041,MUMBAI-SRINAGAR,20250,All
2019,6,MUMBAI,SRINAGAR,6720,14932,MUMBAI-SRINAGAR,21652,All
2019,7,MUMBAI,SRINAGAR,6450,15424,MUMBAI-SRINAGAR,21874,All
2019,8,MUMBAI,SRINAGAR,2586,11422,MUMBAI-SRINAGAR,14008,All
2019,9,MUMBAI,SRINAGAR,1790,11530,MUMBAI-SRINAGAR,13320,All
2019,10,MUMBAI,SRINAGAR,4869,9156,MUMBAI-SRINAGAR,14025,All
2019,11,MUMBAI,SRINAGAR,3213,8483,MUMBAI-SRINAGAR,11696,All
2019,12,MUMBAI,SRINAGAR,1582,7043,MUMBAI-SRINAGAR,8625,All
2020,1,MUMBAI,SRINAGAR,1156,8050,MUMBAI-SRINAGAR,9206,All
2020,2,MUMBAI,SRINAGAR,2881,9226,MUMBAI-SRINAGAR,12107,All
2020,3,MUMBAI,SRINAGAR,4080,5599,MUMBAI-SRINAGAR,9679,All
2020,6,MUMBAI,SRINAGAR,274,260,MUMBAI-SRINAGAR,534,All
2020,7,MUMBAI,SRINAGAR,258,930,MUMBAI-SRINAGAR,1188,All
2020,8,MUMBAI,SRINAGAR,0,413,MUMBAI-SRINAGAR,413,All
2020,9,MUMBAI,SRINAGAR,139,204,MUMBAI-SRINAGAR,343,All
2020,10,MUMBAI,SRINAGAR,485,1050,MUMBAI-SRINAGAR,1535,All
2020,11,MUMBAI,SRINAGAR,3103,5603,MUMBAI-SRINAGAR,8706,All
2020,12,MUMBAI,SRINAGAR,9344,1201,MUMBAI-SRINAGAR,10545,All
2021,1,MUMBAI,SRINAGAR,5669,9171,MUMBAI-SRINAGAR,14840,All
2021,2,MUMBAI,SRINAGAR,9892,9262,MUMBAI-SRINAGAR,19154,All
2021,3,MUMBAI,SRINAGAR,12692,10571,MUMBAI-SRINAGAR,23263,All
2021,4,MUMBAI,SRINAGAR,8735,11153,MUMBAI-SRINAGAR,19888,All
2021,6,MUMBAI,SRINAGAR,763,4251,MUMBAI-SRINAGAR,5014,All
2021,7,MUMBAI,SRINAGAR,3329,8657,MUMBAI-SRINAGAR,11986,All
2021,8,MUMBAI,SRINAGAR,3884,10094,MUMBAI-SRINAGAR,13978,All
2021,9,MUMBAI,SRINAGAR,5041,9708,MUMBAI-SRINAGAR,14749,All
2021,10,MUMBAI,SRINAGAR,5460,12176,MUMBAI-SRINAGAR,17636,All
2021,11,MUMBAI,SRINAGAR,6674,13997,MUMBAI-SRINAGAR,20671,All
2021,12,MUMBAI,SRINAGAR,8388,14463,MUMBAI-SRINAGAR,22851,All
2022,1,MUMBAI,SRINAGAR,6887,11162,MUMBAI-SRINAGAR,18049,All
2022,2,MUMBAI,SRINAGAR,7388,10996,MUMBAI-SRINAGAR,18384,All
2022,3,MUMBAI,SRINAGAR,10437,15414,MUMBAI-SRINAGAR,25851,All
2022,4,MUMBAI,SRINAGAR,18550,27095,MUMBAI-SRINAGAR,45645,All
2022,5,MUMBAI,SRINAGAR,27365,36791,MUMBAI-SRINAGAR,64156,All
2022,6,MUMBAI,SRINAGAR,19087,30762,MUMBAI-SRINAGAR,49849,All
2022,7,MUMBAI,SRINAGAR,16443,25252,MUMBAI-SRINAGAR,41695,All
2022,8,MUMBAI,SRINAGAR,9915,18864,MUMBAI-SRINAGAR,28779,All
2022,9,MUMBAI,SRINAGAR,9292,15861,MUMBAI-SRINAGAR,25153,All
2022,10,MUMBAI,SRINAGAR,10924,14668,MUMBAI-SRINAGAR,25592,All
2022,11,MUMBAI,SRINAGAR,5576,12494,MUMBAI-SRINAGAR,18070,All
2022,12,MUMBAI,SRINAGAR,7159,13229,MUMBAI-SRINAGAR,20388,All
2023,1,MUMBAI,SRINAGAR,6924,12663,MUMBAI-SRINAGAR,19587,All
2023,2,MUMBAI,SRINAGAR,7958,12256,MUMBAI-SRINAGAR,20214,All
2023,3,MUMBAI,SRINAGAR,9940,15195,MUMBAI-SRINAGAR,25135,All
2023,4,MUMBAI,SRINAGAR,13086,21751,MUMBAI-SRINAGAR,34837,All
2023,5,MUMBAI,SRINAGAR,16143,16875,MUMBAI-SRINAGAR,33018,All
2023,6,MUMBAI,SRINAGAR,16227,16001,MUMBAI-SRINAGAR,32228,All
2023,7,MUMBAI,SRINAGAR,14939,17022,MUMBAI-SRINAGAR,31961,All
2023,8,MUMBAI,SRINAGAR,11341,12848,MUMBAI-SRINAGAR,24189,All
2023,9,MUMBAI,SRINAGAR,17264,16771,MUMBAI-SRINAGAR,34035,All
2023,10,MUMBAI,SRINAGAR,13834,13120,MUMBAI-SRINAGAR,26954,All
2023,11,MUMBAI,SRINAGAR,7753,8553,MUMBAI-SRINAGAR,16306,All
2023,12,MUMBAI,SRINAGAR,7365,8226,MUMBAI-SRINAGAR,15591,All
2024,1,MUMBAI,SRINAGAR,7367,7780,MUMBAI-SRINAGAR,15147,All
2024,2,MUMBAI,SRINAGAR,12587,11234,MUMBAI-SRINAGAR,23821,All
2024,3,MUMBAI,SRINAGAR,22419,20022,MUMBAI-SRINAGAR,42441,All
2024,4,MUMBAI,SRINAGAR,27043,25249,MUMBAI-SRINAGAR,52292,All
2024,6,MUMBAI,SRINAGAR,22331,23193,MUMBAI-SRINAGAR,45524,All
2024,7,MUMBAI,SRINAGAR,17485,19045,MUMBAI-SRINAGAR,36530,All
2024,8,MUMBAI,SRINAGAR,12196,14727,MUMBAI-SRINAGAR,26923,All
2024,9,MUMBAI,SRINAGAR,12336,13327,MUMBAI-SRINAGAR,25663,All
2024,10,MUMBAI,SRINAGAR,14028,14251,MUMBAI-SRINAGAR,28279,All
2024,11,MUMBAI,SRINAGAR,12889,14428,MUMBAI-SRINAGAR,27317,All
2024,12,MUMBAI,SRINAGAR,14021,14796,MUMBAI-SRINAGAR,28817,All
2025,1,MUMBAI,SRINAGAR,12736,13090,MUMBAI-SRINAGAR,25826,All
2025,2,MUMBAI,SRINAGAR,12610,12239,MUMBAI-SRINAGAR,24849,All
2025,3,MUMBAI,SRINAGAR,15548,14739,MUMBAI-SRINAGAR,30287,All
2015,9,MUMBAI,SURAT,3,0,MUMBAI-SURAT,3,All
2015,12,MUMBAI,SURAT,56,96,MUMBAI-SURAT,152,All
2016,1,MUMBAI,SURAT,312,542,MUMBAI-SURAT,854,All
2016,2,MUMBAI,SURAT,242,405,MUMBAI-SURAT,647,All
2016,3,MUMBAI,SURAT,353,411,MUMBAI-SURAT,764,All
2016,4,MUMBAI,SURAT,337,556,MUMBAI-SURAT,893,All
2016,5,MUMBAI,SURAT,325,645,MUMBAI-SURAT,970,All
2016,6,MUMBAI,SURAT,327,490,MUMBAI-SURAT,817,All
2016,7,MUMBAI,SURAT,362,695,MUMBAI-SURAT,1057,All
2016,8,MUMBAI,SURAT,429,711,MUMBAI-SURAT,1140,All
2016,9,MUMBAI,SURAT,363,605,MUMBAI-SURAT,968,All
2016,10,MUMBAI,SURAT,365,579,MUMBAI-SURAT,944,All
2016,11,MUMBAI,SURAT,417,616,MUMBAI-SURAT,1033,All
2016,12,MUMBAI,SURAT,407,661,MUMBAI-SURAT,1068,All
2017,1,MUMBAI,SURAT,394,688,MUMBAI-SURAT,1082,All
2017,2,MUMBAI,SURAT,432,635,MUMBAI-SURAT,1067,All
2017,3,MUMBAI,SURAT,445,599,MUMBAI-SURAT,1044,All
2017,4,MUMBAI,SURAT,601,719,MUMBAI-SURAT,1320,All
2017,5,MUMBAI,SURAT,635,830,MUMBAI-SURAT,1465,All
2017,6,MUMBAI,SURAT,702,800,MUMBAI-SURAT,1502,All
2017,7,MUMBAI,SURAT,2066,2313,MUMBAI-SURAT,4379,All
2017,8,MUMBAI,SURAT,2676,2789,MUMBAI-SURAT,5465,All
2017,9,MUMBAI,SURAT,2499,2824,MUMBAI-SURAT,5323,All
2017,10,MUMBAI,SURAT,2635,2935,MUMBAI-SURAT,5570,All
2017,11,MUMBAI,SURAT,2867,2916,MUMBAI-SURAT,5783,All
2017,12,MUMBAI,SURAT,2766,2732,MUMBAI-SURAT,5498,All
2018,1,MUMBAI,SURAT,3013,2977,MUMBAI-SURAT,5990,All
2018,2,MUMBAI,SURAT,2745,2356,MUMBAI-SURAT,5101,All
2018,3,MUMBAI,SURAT,2894,2177,MUMBAI-SURAT,5071,All
2018,4,MUMBAI,SURAT,2760,2511,MUMBAI-SURAT,5271,All
2018,5,MUMBAI,SURAT,2700,2817,MUMBAI-SURAT,5517,All
2018,6,MUMBAI,SURAT,2688,2604,MUMBAI-SURAT,5292,All
2018,7,MUMBAI,SURAT,3018,2839,MUMBAI-SURAT,5857,All
2018,8,MUMBAI,SURAT,3450,4514,MUMBAI-SURAT,7964,All
2018,9,MUMBAI,SURAT,5013,6536,MUMBAI-SURAT,11549,All
2018,10,MUMBAI,SURAT,4459,5003,MUMBAI-SURAT,9462,All
2018,11,MUMBAI,SURAT,4180,5128,MUMBAI-SURAT,9308,All
2018,12,MUMBAI,SURAT,4738,5974,MUMBAI-SURAT,10712,All
2019,1,MUMBAI,SURAT,3147,3340,MUMBAI-SURAT,6487,All
2019,2,MUMBAI,SURAT,1898,1585,MUMBAI-SURAT,3483,All
2019,3,MUMBAI,SURAT,1863,1305,MUMBAI-SURAT,3168,All
2019,4,MUMBAI,SURAT,2658,2046,MUMBAI-SURAT,4704,All
2019,5,MUMBAI,SURAT,2773,2797,MUMBAI-SURAT,5570,All
2019,6,MUMBAI,SURAT,2584,2459,MUMBAI-SURAT,5043,All
2019,7,MUMBAI,SURAT,2605,2569,MUMBAI-SURAT,5174,All
2019,8,MUMBAI,SURAT,2811,2568,MUMBAI-SURAT,5379,All
2019,9,MUMBAI,SURAT,2853,2425,MUMBAI-SURAT,5278,All
2019,10,MUMBAI,SURAT,2562,2280,MUMBAI-SURAT,4842,All
2019,11,MUMBAI,SURAT,2246,1869,MUMBAI-SURAT,4115,All
2019,12,MUMBAI,SURAT,2302,1939,MUMBAI-SURAT,4241,All
2020,1,MUMBAI,SURAT,2298,2020,MUMBAI-SURAT,4318,All
2020,2,MUMBAI,SURAT,2007,1829,MUMBAI-SURAT,3836,All
2020,3,MUMBAI,SURAT,1221,942,MUMBAI-SURAT,2163,All
2020,5,MUMBAI,SURAT,0,0,MUMBAI-SURAT,0,All
2020,6,MUMBAI,SURAT,0,0,MUMBAI-SURAT,0,All
2021,1,MUMBAI,SURAT,138,52,MUMBAI-SURAT,190,All
2021,2,MUMBAI,SURAT,116,54,MUMBAI-SURAT,170,All
2021,3,MUMBAI,SURAT,230,118,MUMBAI-SURAT,348,All
2021,4,MUMBAI,SURAT,786,866,MUMBAI-SURAT,1652,All
2021,6,MUMBAI,SURAT,0,105,MUMBAI-SURAT,105,All
2021,10,MUMBAI,SURAT,118,176,MUMBAI-SURAT,294,All
2021,11,MUMBAI,SURAT,50,57,MUMBAI-SURAT,107,All
2021,12,MUMBAI,SURAT,1486,1340,MUMBAI-SURAT,2826,All
2022,1,MUMBAI,SURAT,1403,1316,MUMBAI-SURAT,2719,All
2022,2,MUMBAI,SURAT,1304,1553,MUMBAI-SURAT,2857,All
2022,3,MUMBAI,SURAT,1568,1536,MUMBAI-SURAT,3104,All
2022,4,MUMBAI,SURAT,1773,1681,MUMBAI-SURAT,3454,All
2022,5,MUMBAI,SURAT,1941,1977,MUMBAI-SURAT,3918,All
2022,6,MUMBAI,SURAT,1412,1400,MUMBAI-SURAT,2812,All
2022,7,MUMBAI,SURAT,1598,1771,MUMBAI-SURAT,3369,All
2022,8,MUMBAI,SURAT,1623,1783,MUMBAI-SURAT,3406,All
2022,9,MUMBAI,SURAT,1405,1478,MUMBAI-SURAT,2883,All
2023,2,MUMBAI,SURAT,180,0,MUMBAI-SURAT,180,All
2023,9,MUMBAI,SURAT,0,382,MUMBAI-SURAT,382,All
2021,10,MUMBAI,Sindhudurg Airport,1232,1275,MUMBAI-Sindhudurg Airport,2507,All
2021,11,MUMBAI,Sindhudurg Airport,1782,1721,MUMBAI-Sindhudurg Airport,3503,All
2021,12,MUMBAI,Sindhudurg Airport,1751,1715,MUMBAI-Sindhudurg Airport,3466,All
2022,1,MUMBAI,Sindhudurg Airport,1367,1349,MUMBAI-Sindhudurg Airport,2716,All
2022,2,MUMBAI,Sindhudurg Airport,1511,1376,MUMBAI-Sindhudurg Airport,2887,All
2022,3,MUMBAI,Sindhudurg Airport,1782,1722,MUMBAI-Sindhudurg Airport,3504,All
2022,4,MUMBAI,Sindhudurg Airport,1782,1721,MUMBAI-Sindhudurg Airport,3503,All
2022,5,MUMBAI,Sindhudurg Airport,1751,1715,MUMBAI-Sindhudurg Airport,3466,All
2022,6,MUMBAI,Sindhudurg Airport,1782,1721,MUMBAI-Sindhudurg Airport,3503,All
2022,7,MUMBAI,Sindhudurg Airport,1511,1376,MUMBAI-Sindhudurg Airport,2887,All
2022,8,MUMBAI,Sindhudurg Airport,1751,1715,MUMBAI-Sindhudurg Airport,3466,All
2022,9,MUMBAI,Sindhudurg Airport,1782,1721,MUMBAI-Sindhudurg Airport,3503,All
2022,10,MUMBAI,Sindhudurg Airport,1505,1451,MUMBAI-Sindhudurg Airport,2956,All
2022,11,MUMBAI,Sindhudurg Airport,1418,1431,MUMBAI-Sindhudurg Airport,2849,All
2022,12,MUMBAI,Sindhudurg Airport,1134,1133,MUMBAI-Sindhudurg Airport,2267,All
2023,2,MUMBAI,Sindhudurg Airport,804,790,MUMBAI-Sindhudurg Airport,1594,All
2023,3,MUMBAI,Sindhudurg Airport,804,745,MUMBAI-Sindhudurg Airport,1549,All
2023,4,MUMBAI,Sindhudurg Airport,876,672,MUMBAI-Sindhudurg Airport,1548,All
2023,5,MUMBAI,Sindhudurg Airport,1050,1027,MUMBAI-Sindhudurg Airport,2077,All
2018,3,MUMBAI,TIRUCHIRAPALLY,650,595,MUMBAI-TIRUCHIRAPALLY,1245,All
2018,4,MUMBAI,TIRUCHIRAPALLY,3212,3094,MUMBAI-TIRUCHIRAPALLY,6306,All
2018,5,MUMBAI,TIRUCHIRAPALLY,3314,2849,MUMBAI-TIRUCHIRAPALLY,6163,All
2018,6,MUMBAI,TIRUCHIRAPALLY,2715,2655,MUMBAI-TIRUCHIRAPALLY,5370,All
2018,7,MUMBAI,TIRUCHIRAPALLY,3423,2937,MUMBAI-TIRUCHIRAPALLY,6360,All
2018,8,MUMBAI,TIRUCHIRAPALLY,2999,3011,MUMBAI-TIRUCHIRAPALLY,6010,All
2018,9,MUMBAI,TIRUCHIRAPALLY,3311,3745,MUMBAI-TIRUCHIRAPALLY,7056,All
2018,10,MUMBAI,TIRUCHIRAPALLY,2714,2415,MUMBAI-TIRUCHIRAPALLY,5129,All
2020,7,MUMBAI,TIRUCHIRAPALLY,270,0,MUMBAI-TIRUCHIRAPALLY,270,All
2020,8,MUMBAI,TIRUCHIRAPALLY,523,364,MUMBAI-TIRUCHIRAPALLY,887,All
2020,9,MUMBAI,TIRUCHIRAPALLY,1351,779,MUMBAI-TIRUCHIRAPALLY,2130,All
2020,10,MUMBAI,TIRUCHIRAPALLY,1137,758,MUMBAI-TIRUCHIRAPALLY,1895,All
2023,11,MUMBAI,TIRUCHIRAPALLY,2838,2765,MUMBAI-TIRUCHIRAPALLY,5603,All
2023,12,MUMBAI,TIRUCHIRAPALLY,4174,3690,MUMBAI-TIRUCHIRAPALLY,7864,All
2024,1,MUMBAI,TIRUCHIRAPALLY,5047,4188,MUMBAI-TIRUCHIRAPALLY,9235,All
2024,2,MUMBAI,TIRUCHIRAPALLY,3557,2840,MUMBAI-TIRUCHIRAPALLY,6397,All
2024,3,MUMBAI,TIRUCHIRAPALLY,2586,2144,MUMBAI-TIRUCHIRAPALLY,4730,All
2024,4,MUMBAI,TIRUCHIRAPALLY,2067,2026,MUMBAI-TIRUCHIRAPALLY,4093,All
2024,6,MUMBAI,TIRUCHIRAPALLY,2190,2084,MUMBAI-TIRUCHIRAPALLY,4274,All
2024,7,MUMBAI,TIRUCHIRAPALLY,2063,1773,MUMBAI-TIRUCHIRAPALLY,3836,All
2024,8,MUMBAI,TIRUCHIRAPALLY,2670,2459,MUMBAI-TIRUCHIRAPALLY,5129,All
2024,9,MUMBAI,TIRUCHIRAPALLY,2316,2270,MUMBAI-TIRUCHIRAPALLY,4586,All
2024,10,MUMBAI,TIRUCHIRAPALLY,2298,1865,MUMBAI-TIRUCHIRAPALLY,4163,All
2024,11,MUMBAI,TIRUCHIRAPALLY,2775,2812,MUMBAI-TIRUCHIRAPALLY,5587,All
2024,12,MUMBAI,TIRUCHIRAPALLY,2262,1909,MUMBAI-TIRUCHIRAPALLY,4171,All
2025,1,MUMBAI,TIRUCHIRAPALLY,2309,1979,MUMBAI-TIRUCHIRAPALLY,4288,All
2025,2,MUMBAI,TIRUCHIRAPALLY,2116,1987,MUMBAI-TIRUCHIRAPALLY,4103,All
2025,3,MUMBAI,TIRUCHIRAPALLY,2968,2404,MUMBAI-TIRUCHIRAPALLY,5372,All
2015,12,MUMBAI,TIRUPATI,0,180,MUMBAI-TIRUPATI,180,All
2017,7,MUMBAI,TIRUPATI,1375,1081,MUMBAI-TIRUPATI,2456,All
2017,8,MUMBAI,TIRUPATI,549,561,MUMBAI-TIRUPATI,1110,All
2017,9,MUMBAI,TIRUPATI,367,412,MUMBAI-TIRUPATI,779,All
2017,10,MUMBAI,TIRUPATI,1380,1071,MUMBAI-TIRUPATI,2451,All
2017,11,MUMBAI,TIRUPATI,1047,967,MUMBAI-TIRUPATI,2014,All
2017,12,MUMBAI,TIRUPATI,1606,1206,MUMBAI-TIRUPATI,2812,All
2018,1,MUMBAI,TIRUPATI,1683,976,MUMBAI-TIRUPATI,2659,All
2018,2,MUMBAI,TIRUPATI,1369,929,MUMBAI-TIRUPATI,2298,All
2018,3,MUMBAI,TIRUPATI,1712,1173,MUMBAI-TIRUPATI,2885,All
2018,4,MUMBAI,TIRUPATI,904,725,MUMBAI-TIRUPATI,1629,All
2018,5,MUMBAI,TIRUPATI,1390,893,MUMBAI-TIRUPATI,2283,All
2018,6,MUMBAI,TIRUPATI,1512,928,MUMBAI-TIRUPATI,2440,All
2018,7,MUMBAI,TIRUPATI,2175,1674,MUMBAI-TIRUPATI,3849,All
2018,8,MUMBAI,TIRUPATI,2517,1715,MUMBAI-TIRUPATI,4232,All
2018,9,MUMBAI,TIRUPATI,2540,2053,MUMBAI-TIRUPATI,4593,All
2018,10,MUMBAI,TIRUPATI,1669,1344,MUMBAI-TIRUPATI,3013,All
2018,11,MUMBAI,TIRUPATI,2104,1447,MUMBAI-TIRUPATI,3551,All
2018,12,MUMBAI,TIRUPATI,1718,1480,MUMBAI-TIRUPATI,3198,All
2019,1,MUMBAI,TIRUPATI,2204,1547,MUMBAI-TIRUPATI,3751,All
2019,2,MUMBAI,TIRUPATI,1441,1619,MUMBAI-TIRUPATI,3060,All
2019,3,MUMBAI,TIRUPATI,1506,1604,MUMBAI-TIRUPATI,3110,All
2019,4,MUMBAI,TIRUPATI,1540,1090,MUMBAI-TIRUPATI,2630,All
2019,5,MUMBAI,TIRUPATI,2245,1598,MUMBAI-TIRUPATI,3843,All
2019,6,MUMBAI,TIRUPATI,3750,3669,MUMBAI-TIRUPATI,7419,All
2019,7,MUMBAI,TIRUPATI,4128,3997,MUMBAI-TIRUPATI,8125,All
2019,8,MUMBAI,TIRUPATI,3876,3646,MUMBAI-TIRUPATI,7522,All
2019,9,MUMBAI,TIRUPATI,2818,2946,MUMBAI-TIRUPATI,5764,All
2019,10,MUMBAI,TIRUPATI,3010,2441,MUMBAI-TIRUPATI,5451,All
2019,11,MUMBAI,TIRUPATI,2246,1996,MUMBAI-TIRUPATI,4242,All
2019,12,MUMBAI,TIRUPATI,2419,1877,MUMBAI-TIRUPATI,4296,All
2020,1,MUMBAI,TIRUPATI,1919,1773,MUMBAI-TIRUPATI,3692,All
2020,2,MUMBAI,TIRUPATI,2072,1544,MUMBAI-TIRUPATI,3616,All
2020,3,MUMBAI,TIRUPATI,1518,1537,MUMBAI-TIRUPATI,3055,All
2020,6,MUMBAI,TIRUPATI,20,6,MUMBAI-TIRUPATI,26,All
2020,7,MUMBAI,TIRUPATI,260,105,MUMBAI-TIRUPATI,365,All
2020,8,MUMBAI,TIRUPATI,563,326,MUMBAI-TIRUPATI,889,All
2020,9,MUMBAI,TIRUPATI,721,730,MUMBAI-TIRUPATI,1451,All
2020,10,MUMBAI,TIRUPATI,928,1027,MUMBAI-TIRUPATI,1955,All
2020,11,MUMBAI,TIRUPATI,1152,1015,MUMBAI-TIRUPATI,2167,All
2020,12,MUMBAI,TIRUPATI,1294,1184,MUMBAI-TIRUPATI,2478,All
2021,1,MUMBAI,TIRUPATI,2107,2102,MUMBAI-TIRUPATI,4209,All
2021,2,MUMBAI,TIRUPATI,2388,2447,MUMBAI-TIRUPATI,4835,All
2021,3,MUMBAI,TIRUPATI,2236,2046,MUMBAI-TIRUPATI,4282,All
2021,4,MUMBAI,TIRUPATI,877,650,MUMBAI-TIRUPATI,1527,All
2021,7,MUMBAI,TIRUPATI,851,692,MUMBAI-TIRUPATI,1543,All
2021,8,MUMBAI,TIRUPATI,3558,2871,MUMBAI-TIRUPATI,6429,All
2021,9,MUMBAI,TIRUPATI,3065,2489,MUMBAI-TIRUPATI,5554,All
2021,10,MUMBAI,TIRUPATI,2969,2574,MUMBAI-TIRUPATI,5543,All
2021,11,MUMBAI,TIRUPATI,1808,1730,MUMBAI-TIRUPATI,3538,All
2021,12,MUMBAI,TIRUPATI,3628,2427,MUMBAI-TIRUPATI,6055,All
2022,1,MUMBAI,TIRUPATI,1692,1413,MUMBAI-TIRUPATI,3105,All
2022,2,MUMBAI,TIRUPATI,1006,700,MUMBAI-TIRUPATI,1706,All
2022,3,MUMBAI,TIRUPATI,1896,1788,MUMBAI-TIRUPATI,3684,All
2022,4,MUMBAI,TIRUPATI,1634,1487,MUMBAI-TIRUPATI,3121,All
2022,5,MUMBAI,TIRUPATI,3537,3461,MUMBAI-TIRUPATI,6998,All
2022,6,MUMBAI,TIRUPATI,2375,2480,MUMBAI-TIRUPATI,4855,All
2022,7,MUMBAI,TIRUPATI,1157,1384,MUMBAI-TIRUPATI,2541,All
2022,8,MUMBAI,TIRUPATI,1117,877,MUMBAI-TIRUPATI,1994,All
2022,9,MUMBAI,TIRUPATI,1105,1006,MUMBAI-TIRUPATI,2111,All
2022,10,MUMBAI,TIRUPATI,1204,789,MUMBAI-TIRUPATI,1993,All
2022,11,MUMBAI,TIRUPATI,3069,2820,MUMBAI-TIRUPATI,5889,All
2022,12,MUMBAI,TIRUPATI,3086,3009,MUMBAI-TIRUPATI,6095,All
2023,1,MUMBAI,TIRUPATI,3017,2787,MUMBAI-TIRUPATI,5804,All
2023,2,MUMBAI,TIRUPATI,2511,2434,MUMBAI-TIRUPATI,4945,All
2023,3,MUMBAI,TIRUPATI,2445,2306,MUMBAI-TIRUPATI,4751,All
2023,4,MUMBAI,TIRUPATI,2711,2568,MUMBAI-TIRUPATI,5279,All
2023,5,MUMBAI,TIRUPATI,2847,2587,MUMBAI-TIRUPATI,5434,All
2023,6,MUMBAI,TIRUPATI,2636,2353,MUMBAI-TIRUPATI,4989,All
2023,7,MUMBAI,TIRUPATI,2526,1911,MUMBAI-TIRUPATI,4437,All
2023,8,MUMBAI,TIRUPATI,2687,2330,MUMBAI-TIRUPATI,5017,All
2023,9,MUMBAI,TIRUPATI,2365,2310,MUMBAI-TIRUPATI,4675,All
2023,10,MUMBAI,TIRUPATI,1630,1743,MUMBAI-TIRUPATI,3373,All
2024,12,MUMBAI,TIRUPATI,5077,4497,MUMBAI-TIRUPATI,9574,All
2025,1,MUMBAI,TIRUPATI,4870,4252,MUMBAI-TIRUPATI,9122,All
2025,2,MUMBAI,TIRUPATI,4394,3899,MUMBAI-TIRUPATI,8293,All
2025,3,MUMBAI,TIRUPATI,5174,4493,MUMBAI-TIRUPATI,9667,All
2015,4,MUMBAI,TRIVANDRUM,11185,10867,MUMBAI-TRIVANDRUM,22052,All
2015,5,MUMBAI,TRIVANDRUM,12675,12320,MUMBAI-TRIVANDRUM,24995,All
2015,6,MUMBAI,TRIVANDRUM,9722,10715,MUMBAI-TRIVANDRUM,20437,All
2015,7,MUMBAI,TRIVANDRUM,11587,10510,MUMBAI-TRIVANDRUM,22097,All
2015,8,MUMBAI,TRIVANDRUM,11552,11999,MUMBAI-TRIVANDRUM,23551,All
2015,9,MUMBAI,TRIVANDRUM,8972,11833,MUMBAI-TRIVANDRUM,20805,All
2015,10,MUMBAI,TRIVANDRUM,12773,21450,MUMBAI-TRIVANDRUM,34223,All
2015,11,MUMBAI,TRIVANDRUM,11996,12455,MUMBAI-TRIVANDRUM,24451,All
2015,12,MUMBAI,TRIVANDRUM,13317,12652,MUMBAI-TRIVANDRUM,25969,All
2016,1,MUMBAI,TRIVANDRUM,11500,12589,MUMBAI-TRIVANDRUM,24089,All
2016,2,MUMBAI,TRIVANDRUM,10101,11466,MUMBAI-TRIVANDRUM,21567,All
2016,3,MUMBAI,TRIVANDRUM,9957,10981,MUMBAI-TRIVANDRUM,20938,All
2016,4,MUMBAI,TRIVANDRUM,11840,12375,MUMBAI-TRIVANDRUM,24215,All
2016,5,MUMBAI,TRIVANDRUM,14495,13442,MUMBAI-TRIVANDRUM,27937,All
2016,6,MUMBAI,TRIVANDRUM,12360,11770,MUMBAI-TRIVANDRUM,24130,All
2016,7,MUMBAI,TRIVANDRUM,13962,12808,MUMBAI-TRIVANDRUM,26770,All
2016,8,MUMBAI,TRIVANDRUM,12606,13822,MUMBAI-TRIVANDRUM,26428,All
2016,9,MUMBAI,TRIVANDRUM,13207,15978,MUMBAI-TRIVANDRUM,29185,All
2016,10,MUMBAI,TRIVANDRUM,14845,14416,MUMBAI-TRIVANDRUM,29261,All
2016,11,MUMBAI,TRIVANDRUM,14510,16357,MUMBAI-TRIVANDRUM,30867,All
2016,12,MUMBAI,TRIVANDRUM,18203,18133,MUMBAI-TRIVANDRUM,36336,All
2017,1,MUMBAI,TRIVANDRUM,14010,13985,MUMBAI-TRIVANDRUM,27995,All
2017,2,MUMBAI,TRIVANDRUM,12657,13405,MUMBAI-TRIVANDRUM,26062,All
2017,3,MUMBAI,TRIVANDRUM,11941,13083,MUMBAI-TRIVANDRUM,25024,All
2017,4,MUMBAI,TRIVANDRUM,13160,13722,MUMBAI-TRIVANDRUM,26882,All
2017,5,MUMBAI,TRIVANDRUM,15098,14183,MUMBAI-TRIVANDRUM,29281,All
2017,6,MUMBAI,TRIVANDRUM,12467,12715,MUMBAI-TRIVANDRUM,25182,All
2017,7,MUMBAI,TRIVANDRUM,14574,12515,MUMBAI-TRIVANDRUM,27089,All
2017,8,MUMBAI,TRIVANDRUM,14003,13233,MUMBAI-TRIVANDRUM,27236,All
2017,9,MUMBAI,TRIVANDRUM,11331,12897,MUMBAI-TRIVANDRUM,24228,All
2017,10,MUMBAI,TRIVANDRUM,13048,12525,MUMBAI-TRIVANDRUM,25573,All
2017,11,MUMBAI,TRIVANDRUM,13287,13631,MUMBAI-TRIVANDRUM,26918,All
2017,12,MUMBAI,TRIVANDRUM,15086,14056,MUMBAI-TRIVANDRUM,29142,All
2018,1,MUMBAI,TRIVANDRUM,14295,13972,MUMBAI-TRIVANDRUM,28267,All
2018,2,MUMBAI,TRIVANDRUM,12598,12306,MUMBAI-TRIVANDRUM,24904,All
2018,3,MUMBAI,TRIVANDRUM,13364,12767,MUMBAI-TRIVANDRUM,26131,All
2018,4,MUMBAI,TRIVANDRUM,12832,11740,MUMBAI-TRIVANDRUM,24572,All
2018,5,MUMBAI,TRIVANDRUM,14636,11421,MUMBAI-TRIVANDRUM,26057,All
2018,6,MUMBAI,TRIVANDRUM,10415,10457,MUMBAI-TRIVANDRUM,20872,All
2018,7,MUMBAI,TRIVANDRUM,13781,11001,MUMBAI-TRIVANDRUM,24782,All
2018,8,MUMBAI,TRIVANDRUM,20614,20854,MUMBAI-TRIVANDRUM,41468,All
2018,9,MUMBAI,TRIVANDRUM,10885,12728,MUMBAI-TRIVANDRUM,23613,All
2018,10,MUMBAI,TRIVANDRUM,9832,9016,MUMBAI-TRIVANDRUM,18848,All
2018,11,MUMBAI,TRIVANDRUM,12505,12072,MUMBAI-TRIVANDRUM,24577,All
2018,12,MUMBAI,TRIVANDRUM,12928,11914,MUMBAI-TRIVANDRUM,24842,All
2019,1,MUMBAI,TRIVANDRUM,11862,12211,MUMBAI-TRIVANDRUM,24073,All
2019,2,MUMBAI,TRIVANDRUM,10517,11083,MUMBAI-TRIVANDRUM,21600,All
2019,3,MUMBAI,TRIVANDRUM,8258,8427,MUMBAI-TRIVANDRUM,16685,All
2019,4,MUMBAI,TRIVANDRUM,8883,7613,MUMBAI-TRIVANDRUM,16496,All
2019,5,MUMBAI,TRIVANDRUM,11350,9153,MUMBAI-TRIVANDRUM,20503,All
2019,6,MUMBAI,TRIVANDRUM,11644,11790,MUMBAI-TRIVANDRUM,23434,All
2019,7,MUMBAI,TRIVANDRUM,12616,11085,MUMBAI-TRIVANDRUM,23701,All
2019,8,MUMBAI,TRIVANDRUM,12791,12839,MUMBAI-TRIVANDRUM,25630,All
2019,9,MUMBAI,TRIVANDRUM,11852,12716,MUMBAI-TRIVANDRUM,24568,All
2019,10,MUMBAI,TRIVANDRUM,13337,11427,MUMBAI-TRIVANDRUM,24764,All
2019,11,MUMBAI,TRIVANDRUM,14545,16479,MUMBAI-TRIVANDRUM,31024,All
2019,12,MUMBAI,TRIVANDRUM,17905,16034,MUMBAI-TRIVANDRUM,33939,All
2020,1,MUMBAI,TRIVANDRUM,17062,18241,MUMBAI-TRIVANDRUM,35303,All
2020,2,MUMBAI,TRIVANDRUM,11974,12846,MUMBAI-TRIVANDRUM,24820,All
2020,3,MUMBAI,TRIVANDRUM,5505,6063,MUMBAI-TRIVANDRUM,11568,All
2020,6,MUMBAI,TRIVANDRUM,724,304,MUMBAI-TRIVANDRUM,1028,All
2020,7,MUMBAI,TRIVANDRUM,610,0,MUMBAI-TRIVANDRUM,610,All
2020,8,MUMBAI,TRIVANDRUM,0,0,MUMBAI-TRIVANDRUM,0,All
2020,9,MUMBAI,TRIVANDRUM,1202,986,MUMBAI-TRIVANDRUM,2188,All
2020,10,MUMBAI,TRIVANDRUM,2428,1602,MUMBAI-TRIVANDRUM,4030,All
2020,11,MUMBAI,TRIVANDRUM,5211,3972,MUMBAI-TRIVANDRUM,9183,All
2020,12,MUMBAI,TRIVANDRUM,5279,4348,MUMBAI-TRIVANDRUM,9627,All
2021,1,MUMBAI,TRIVANDRUM,4671,4041,MUMBAI-TRIVANDRUM,8712,All
2021,2,MUMBAI,TRIVANDRUM,4465,4504,MUMBAI-TRIVANDRUM,8969,All
2021,3,MUMBAI,TRIVANDRUM,4180,3795,MUMBAI-TRIVANDRUM,7975,All
2021,4,MUMBAI,TRIVANDRUM,3960,2910,MUMBAI-TRIVANDRUM,6870,All
2021,6,MUMBAI,TRIVANDRUM,1594,1822,MUMBAI-TRIVANDRUM,3416,All
2021,7,MUMBAI,TRIVANDRUM,3212,3779,MUMBAI-TRIVANDRUM,6991,All
2021,8,MUMBAI,TRIVANDRUM,4229,5485,MUMBAI-TRIVANDRUM,9714,All
2021,9,MUMBAI,TRIVANDRUM,3952,6099,MUMBAI-TRIVANDRUM,10051,All
2021,10,MUMBAI,TRIVANDRUM,5973,6373,MUMBAI-TRIVANDRUM,12346,All
2021,11,MUMBAI,TRIVANDRUM,6243,7967,MUMBAI-TRIVANDRUM,14210,All
2021,12,MUMBAI,TRIVANDRUM,8032,8116,MUMBAI-TRIVANDRUM,16148,All
2022,1,MUMBAI,TRIVANDRUM,4692,6661,MUMBAI-TRIVANDRUM,11353,All
2022,2,MUMBAI,TRIVANDRUM,5480,6761,MUMBAI-TRIVANDRUM,12241,All
2022,3,MUMBAI,TRIVANDRUM,7008,8407,MUMBAI-TRIVANDRUM,15415,All
2022,4,MUMBAI,TRIVANDRUM,8933,9830,MUMBAI-TRIVANDRUM,18763,All
2022,5,MUMBAI,TRIVANDRUM,11011,10660,MUMBAI-TRIVANDRUM,21671,All
2022,6,MUMBAI,TRIVANDRUM,10961,10190,MUMBAI-TRIVANDRUM,21151,All
2022,7,MUMBAI,TRIVANDRUM,11635,9482,MUMBAI-TRIVANDRUM,21117,All
2022,8,MUMBAI,TRIVANDRUM,12911,14756,MUMBAI-TRIVANDRUM,27667,All
2022,9,MUMBAI,TRIVANDRUM,12994,15870,MUMBAI-TRIVANDRUM,28864,All
2022,10,MUMBAI,TRIVANDRUM,13744,13677,MUMBAI-TRIVANDRUM,27421,All
2022,11,MUMBAI,TRIVANDRUM,12119,14559,MUMBAI-TRIVANDRUM,26678,All
2022,12,MUMBAI,TRIVANDRUM,16180,14398,MUMBAI-TRIVANDRUM,30578,All
2023,1,MUMBAI,TRIVANDRUM,13726,14887,MUMBAI-TRIVANDRUM,28613,All
2023,2,MUMBAI,TRIVANDRUM,12353,13803,MUMBAI-TRIVANDRUM,26156,All
2023,3,MUMBAI,TRIVANDRUM,13155,13959,MUMBAI-TRIVANDRUM,27114,All
2023,4,MUMBAI,TRIVANDRUM,15619,15248,MUMBAI-TRIVANDRUM,30867,All
2023,5,MUMBAI,TRIVANDRUM,19255,17700,MUMBAI-TRIVANDRUM,36955,All
2023,6,MUMBAI,TRIVANDRUM,24165,21522,MUMBAI-TRIVANDRUM,45687,All
2023,7,MUMBAI,TRIVANDRUM,25209,21859,MUMBAI-TRIVANDRUM,47068,All
2023,8,MUMBAI,TRIVANDRUM,24408,26438,MUMBAI-TRIVANDRUM,50846,All
2023,9,MUMBAI,TRIVANDRUM,22983,28498,MUMBAI-TRIVANDRUM,51481,All
2023,10,MUMBAI,TRIVANDRUM,21571,25068,MUMBAI-TRIVANDRUM,46639,All
2023,11,MUMBAI,TRIVANDRUM,24645,24361,MUMBAI-TRIVANDRUM,49006,All
2023,12,MUMBAI,TRIVANDRUM,28500,26092,MUMBAI-TRIVANDRUM,54592,All
2024,1,MUMBAI,TRIVANDRUM,24687,27669,MUMBAI-TRIVANDRUM,52356,All
2024,2,MUMBAI,TRIVANDRUM,19543,21047,MUMBAI-TRIVANDRUM,40590,All
2024,3,MUMBAI,TRIVANDRUM,17243,17501,MUMBAI-TRIVANDRUM,34744,All
2024,4,MUMBAI,TRIVANDRUM,22222,23004,MUMBAI-TRIVANDRUM,45226,All
2024,6,MUMBAI,TRIVANDRUM,20742,21424,MUMBAI-TRIVANDRUM,42166,All
2024,7,MUMBAI,TRIVANDRUM,18610,15929,MUMBAI-TRIVANDRUM,34539,All
2024,8,MUMBAI,TRIVANDRUM,17074,19538,MUMBAI-TRIVANDRUM,36612,All
2024,9,MUMBAI,TRIVANDRUM,16696,20453,MUMBAI-TRIVANDRUM,37149,All
2024,10,MUMBAI,TRIVANDRUM,15187,16149,MUMBAI-TRIVANDRUM,31336,All
2024,11,MUMBAI,TRIVANDRUM,14522,15585,MUMBAI-TRIVANDRUM,30107,All
2024,12,MUMBAI,TRIVANDRUM,16639,15601,MUMBAI-TRIVANDRUM,32240,All
2025,1,MUMBAI,TRIVANDRUM,15822,16372,MUMBAI-TRIVANDRUM,32194,All
2025,2,MUMBAI,TRIVANDRUM,13726,14008,MUMBAI-TRIVANDRUM,27734,All
2025,3,MUMBAI,TRIVANDRUM,14251,14666,MUMBAI-TRIVANDRUM,28917,All
2015,4,MUMBAI,UDAIPUR,12289,10707,MUMBAI-UDAIPUR,22996,All
2015,5,MUMBAI,UDAIPUR,10319,10156,MUMBAI-UDAIPUR,20475,All
2015,6,MUMBAI,UDAIPUR,9436,9216,MUMBAI-UDAIPUR,18652,All
2015,7,MUMBAI,UDAIPUR,11205,10403,MUMBAI-UDAIPUR,21608,All
2015,8,MUMBAI,UDAIPUR,11226,11273,MUMBAI-UDAIPUR,22499,All
2015,9,MUMBAI,UDAIPUR,10667,10502,MUMBAI-UDAIPUR,21169,All
2015,10,MUMBAI,UDAIPUR,11584,10899,MUMBAI-UDAIPUR,22483,All
2015,11,MUMBAI,UDAIPUR,20448,19170,MUMBAI-UDAIPUR,39618,All
2015,12,MUMBAI,UDAIPUR,21827,22530,MUMBAI-UDAIPUR,44357,All
2016,1,MUMBAI,UDAIPUR,21868,22164,MUMBAI-UDAIPUR,44032,All
2016,2,MUMBAI,UDAIPUR,21085,21238,MUMBAI-UDAIPUR,42323,All
2016,3,MUMBAI,UDAIPUR,20347,21475,MUMBAI-UDAIPUR,41822,All
2016,4,MUMBAI,UDAIPUR,22606,21978,MUMBAI-UDAIPUR,44584,All
2016,5,MUMBAI,UDAIPUR,22746,26035,MUMBAI-UDAIPUR,48781,All
2016,6,MUMBAI,UDAIPUR,20194,21217,MUMBAI-UDAIPUR,41411,All
2016,7,MUMBAI,UDAIPUR,21423,20839,MUMBAI-UDAIPUR,42262,All
2016,8,MUMBAI,UDAIPUR,20118,20612,MUMBAI-UDAIPUR,40730,All
2016,9,MUMBAI,UDAIPUR,20791,20412,MUMBAI-UDAIPUR,41203,All
2016,10,MUMBAI,UDAIPUR,23700,21268,MUMBAI-UDAIPUR,44968,All
2016,11,MUMBAI,UDAIPUR,23061,24775,MUMBAI-UDAIPUR,47836,All
2016,12,MUMBAI,UDAIPUR,27843,28713,MUMBAI-UDAIPUR,56556,All
2017,1,MUMBAI,UDAIPUR,28064,27906,MUMBAI-UDAIPUR,55970,All
2017,2,MUMBAI,UDAIPUR,21649,20872,MUMBAI-UDAIPUR,42521,All
2017,3,MUMBAI,UDAIPUR,20394,22071,MUMBAI-UDAIPUR,42465,All
2017,4,MUMBAI,UDAIPUR,21771,18481,MUMBAI-UDAIPUR,40252,All
2017,5,MUMBAI,UDAIPUR,20149,22210,MUMBAI-UDAIPUR,42359,All
2017,6,MUMBAI,UDAIPUR,20336,20284,MUMBAI-UDAIPUR,40620,All
2017,7,MUMBAI,UDAIPUR,18973,20551,MUMBAI-UDAIPUR,39524,All
2017,8,MUMBAI,UDAIPUR,20667,21623,MUMBAI-UDAIPUR,42290,All
2017,9,MUMBAI,UDAIPUR,20067,19599,MUMBAI-UDAIPUR,39666,All
2017,10,MUMBAI,UDAIPUR,22129,21760,MUMBAI-UDAIPUR,43889,All
2017,11,MUMBAI,UDAIPUR,27162,27592,MUMBAI-UDAIPUR,54754,All
2017,12,MUMBAI,UDAIPUR,28209,29605,MUMBAI-UDAIPUR,57814,All
2018,1,MUMBAI,UDAIPUR,28906,28779,MUMBAI-UDAIPUR,57685,All
2018,2,MUMBAI,UDAIPUR,27260,26853,MUMBAI-UDAIPUR,54113,All
2018,3,MUMBAI,UDAIPUR,24911,25417,MUMBAI-UDAIPUR,50328,All
2018,4,MUMBAI,UDAIPUR,23980,21600,MUMBAI-UDAIPUR,45580,All
2018,5,MUMBAI,UDAIPUR,18802,22609,MUMBAI-UDAIPUR,41411,All
2018,6,MUMBAI,UDAIPUR,21058,21411,MUMBAI-UDAIPUR,42469,All
2018,7,MUMBAI,UDAIPUR,24438,24068,MUMBAI-UDAIPUR,48506,All
2018,8,MUMBAI,UDAIPUR,22494,22480,MUMBAI-UDAIPUR,44974,All
2018,9,MUMBAI,UDAIPUR,21887,21887,MUMBAI-UDAIPUR,43774,All
2018,10,MUMBAI,UDAIPUR,22194,21820,MUMBAI-UDAIPUR,44014,All
2018,11,MUMBAI,UDAIPUR,26128,25185,MUMBAI-UDAIPUR,51313,All
2018,12,MUMBAI,UDAIPUR,27536,28296,MUMBAI-UDAIPUR,55832,All
2019,1,MUMBAI,UDAIPUR,26551,26985,MUMBAI-UDAIPUR,53536,All
2019,2,MUMBAI,UDAIPUR,20903,22557,MUMBAI-UDAIPUR,43460,All
2019,3,MUMBAI,UDAIPUR,16396,18607,MUMBAI-UDAIPUR,35003,All
2019,4,MUMBAI,UDAIPUR,13389,12809,MUMBAI-UDAIPUR,26198,All
2019,5,MUMBAI,UDAIPUR,11832,13125,MUMBAI-UDAIPUR,24957,All
2019,6,MUMBAI,UDAIPUR,12705,13536,MUMBAI-UDAIPUR,26241,All
2019,7,MUMBAI,UDAIPUR,14337,14219,MUMBAI-UDAIPUR,28556,All
2019,8,MUMBAI,UDAIPUR,14924,14661,MUMBAI-UDAIPUR,29585,All
2019,9,MUMBAI,UDAIPUR,14554,13912,MUMBAI-UDAIPUR,28466,All
2019,10,MUMBAI,UDAIPUR,18103,15555,MUMBAI-UDAIPUR,33658,All
2019,11,MUMBAI,UDAIPUR,21991,23618,MUMBAI-UDAIPUR,45609,All
2019,12,MUMBAI,UDAIPUR,23660,24190,MUMBAI-UDAIPUR,47850,All
2020,1,MUMBAI,UDAIPUR,24532,24609,MUMBAI-UDAIPUR,49141,All
2020,2,MUMBAI,UDAIPUR,23991,24070,MUMBAI-UDAIPUR,48061,All
2020,3,MUMBAI,UDAIPUR,13421,13322,MUMBAI-UDAIPUR,26743,All
2020,6,MUMBAI,UDAIPUR,417,231,MUMBAI-UDAIPUR,648,All
2020,7,MUMBAI,UDAIPUR,2267,933,MUMBAI-UDAIPUR,3200,All
2020,8,MUMBAI,UDAIPUR,2217,2216,MUMBAI-UDAIPUR,4433,All
2020,9,MUMBAI,UDAIPUR,3699,3552,MUMBAI-UDAIPUR,7251,All
2020,10,MUMBAI,UDAIPUR,5974,5446,MUMBAI-UDAIPUR,11420,All
2020,11,MUMBAI,UDAIPUR,12923,10733,MUMBAI-UDAIPUR,23656,All
2020,12,MUMBAI,UDAIPUR,11413,11261,MUMBAI-UDAIPUR,22674,All
2021,1,MUMBAI,UDAIPUR,12137,11375,MUMBAI-UDAIPUR,23512,All
2021,2,MUMBAI,UDAIPUR,13287,12549,MUMBAI-UDAIPUR,25836,All
2021,3,MUMBAI,UDAIPUR,10026,9904,MUMBAI-UDAIPUR,19930,All
2021,4,MUMBAI,UDAIPUR,7528,4325,MUMBAI-UDAIPUR,11853,All
2021,6,MUMBAI,UDAIPUR,3550,4210,MUMBAI-UDAIPUR,7760,All
2021,7,MUMBAI,UDAIPUR,8872,9216,MUMBAI-UDAIPUR,18088,All
2021,8,MUMBAI,UDAIPUR,11809,12403,MUMBAI-UDAIPUR,24212,All
2021,9,MUMBAI,UDAIPUR,14111,14393,MUMBAI-UDAIPUR,28504,All
2021,10,MUMBAI,UDAIPUR,19032,17771,MUMBAI-UDAIPUR,36803,All
2021,11,MUMBAI,UDAIPUR,23464,21748,MUMBAI-UDAIPUR,45212,All
2021,12,MUMBAI,UDAIPUR,26491,27540,MUMBAI-UDAIPUR,54031,All
2022,1,MUMBAI,UDAIPUR,15871,17778,MUMBAI-UDAIPUR,33649,All
2022,2,MUMBAI,UDAIPUR,22371,21482,MUMBAI-UDAIPUR,43853,All
2022,3,MUMBAI,UDAIPUR,23015,23068,MUMBAI-UDAIPUR,46083,All
2022,4,MUMBAI,UDAIPUR,16607,15867,MUMBAI-UDAIPUR,32474,All
2022,5,MUMBAI,UDAIPUR,16048,17252,MUMBAI-UDAIPUR,33300,All
2022,6,MUMBAI,UDAIPUR,15754,16132,MUMBAI-UDAIPUR,31886,All
2022,7,MUMBAI,UDAIPUR,17483,17787,MUMBAI-UDAIPUR,35270,All
2022,8,MUMBAI,UDAIPUR,18764,19841,MUMBAI-UDAIPUR,38605,All
2022,9,MUMBAI,UDAIPUR,20247,19778,MUMBAI-UDAIPUR,40025,All
2022,10,MUMBAI,UDAIPUR,21163,19060,MUMBAI-UDAIPUR,40223,All
2022,11,MUMBAI,UDAIPUR,25627,26829,MUMBAI-UDAIPUR,52456,All
2022,12,MUMBAI,UDAIPUR,30950,31520,MUMBAI-UDAIPUR,62470,All
2023,1,MUMBAI,UDAIPUR,28283,28845,MUMBAI-UDAIPUR,57128,All
2023,2,MUMBAI,UDAIPUR,28843,29314,MUMBAI-UDAIPUR,58157,All
2023,3,MUMBAI,UDAIPUR,22815,24233,MUMBAI-UDAIPUR,47048,All
2023,4,MUMBAI,UDAIPUR,19278,17420,MUMBAI-UDAIPUR,36698,All
2023,5,MUMBAI,UDAIPUR,19729,20619,MUMBAI-UDAIPUR,40348,All
2023,6,MUMBAI,UDAIPUR,19428,19067,MUMBAI-UDAIPUR,38495,All
2023,7,MUMBAI,UDAIPUR,20142,19005,MUMBAI-UDAIPUR,39147,All
2023,8,MUMBAI,UDAIPUR,22531,21640,MUMBAI-UDAIPUR,44171,All
2023,9,MUMBAI,UDAIPUR,22842,21962,MUMBAI-UDAIPUR,44804,All
2023,10,MUMBAI,UDAIPUR,22677,21687,MUMBAI-UDAIPUR,44364,All
2023,11,MUMBAI,UDAIPUR,23683,20589,MUMBAI-UDAIPUR,44272,All
2023,12,MUMBAI,UDAIPUR,23325,23847,MUMBAI-UDAIPUR,47172,All
2024,1,MUMBAI,UDAIPUR,24880,24351,MUMBAI-UDAIPUR,49231,All
2024,2,MUMBAI,UDAIPUR,24149,23667,MUMBAI-UDAIPUR,47816,All
2024,3,MUMBAI,UDAIPUR,24008,24492,MUMBAI-UDAIPUR,48500,All
2024,4,MUMBAI,UDAIPUR,22920,21106,MUMBAI-UDAIPUR,44026,All
2024,6,MUMBAI,UDAIPUR,20718,20705,MUMBAI-UDAIPUR,41423,All
2024,7,MUMBAI,UDAIPUR,23575,22502,MUMBAI-UDAIPUR,46077,All
2024,8,MUMBAI,UDAIPUR,24535,23496,MUMBAI-UDAIPUR,48031,All
2024,9,MUMBAI,UDAIPUR,24272,22323,MUMBAI-UDAIPUR,46595,All
2024,10,MUMBAI,UDAIPUR,25436,20532,MUMBAI-UDAIPUR,45968,All
2024,11,MUMBAI,UDAIPUR,22956,23164,MUMBAI-UDAIPUR,46120,All
2024,12,MUMBAI,UDAIPUR,23569,22456,MUMBAI-UDAIPUR,46025,All
2025,1,MUMBAI,UDAIPUR,26113,25133,MUMBAI-UDAIPUR,51246,All
2025,2,MUMBAI,UDAIPUR,23256,22530,MUMBAI-UDAIPUR,45786,All
2025,3,MUMBAI,UDAIPUR,24529,23667,MUMBAI-UDAIPUR,48196,All
2019,5,MUMBAI,VADODARA,11688,15280,MUMBAI-VADODARA,26968,All
2019,6,MUMBAI,VADODARA,12266,14439,MUMBAI-VADODARA,26705,All
2019,7,MUMBAI,VADODARA,12014,13432,MUMBAI-VADODARA,25446,All
2019,8,MUMBAI,VADODARA,12686,14314,MUMBAI-VADODARA,27000,All
2019,9,MUMBAI,VADODARA,12497,14056,MUMBAI-VADODARA,26553,All
2019,10,MUMBAI,VADODARA,12663,14015,MUMBAI-VADODARA,26678,All
2019,11,MUMBAI,VADODARA,15274,15180,MUMBAI-VADODARA,30454,All
2019,12,MUMBAI,VADODARA,15282,15821,MUMBAI-VADODARA,31103,All
2020,1,MUMBAI,VADODARA,15627,16055,MUMBAI-VADODARA,31682,All
2020,2,MUMBAI,VADODARA,13833,15164,MUMBAI-VADODARA,28997,All
2020,3,MUMBAI,VADODARA,5632,6201,MUMBAI-VADODARA,11833,All
2020,8,MUMBAI,VADODARA,405,228,MUMBAI-VADODARA,633,All
2020,9,MUMBAI,VADODARA,1681,1294,MUMBAI-VADODARA,2975,All
2020,10,MUMBAI,VADODARA,2212,1613,MUMBAI-VADODARA,3825,All
2020,11,MUMBAI,VADODARA,4188,3692,MUMBAI-VADODARA,7880,All
2020,12,MUMBAI,VADODARA,4088,3047,MUMBAI-VADODARA,7135,All
2021,1,MUMBAI,VADODARA,4757,3892,MUMBAI-VADODARA,8649,All
2021,2,MUMBAI,VADODARA,5472,4924,MUMBAI-VADODARA,10396,All
2021,3,MUMBAI,VADODARA,4928,4265,MUMBAI-VADODARA,9193,All
2021,4,MUMBAI,VADODARA,2195,2015,MUMBAI-VADODARA,4210,All
2021,6,MUMBAI,VADODARA,1331,1190,MUMBAI-VADODARA,2521,All
2021,7,MUMBAI,VADODARA,3849,3785,MUMBAI-VADODARA,7634,All
2021,8,MUMBAI,VADODARA,4863,5039,MUMBAI-VADODARA,9902,All
2021,9,MUMBAI,VADODARA,5903,7219,MUMBAI-VADODARA,13122,All
2021,10,MUMBAI,VADODARA,7969,8790,MUMBAI-VADODARA,16759,All
2021,11,MUMBAI,VADODARA,10243,10273,MUMBAI-VADODARA,20516,All
2021,12,MUMBAI,VADODARA,11190,11130,MUMBAI-VADODARA,22320,All
2022,1,MUMBAI,VADODARA,5268,4899,MUMBAI-VADODARA,10167,All
2022,2,MUMBAI,VADODARA,7939,8058,MUMBAI-VADODARA,15997,All
2022,3,MUMBAI,VADODARA,12186,12293,MUMBAI-VADODARA,24479,All
2022,4,MUMBAI,VADODARA,15361,16309,MUMBAI-VADODARA,31670,All
2022,5,MUMBAI,VADODARA,15628,17622,MUMBAI-VADODARA,33250,All
2022,6,MUMBAI,VADODARA,15669,15975,MUMBAI-VADODARA,31644,All
2022,7,MUMBAI,VADODARA,15279,16500,MUMBAI-VADODARA,31779,All
2022,8,MUMBAI,VADODARA,16514,17811,MUMBAI-VADODARA,34325,All
2022,9,MUMBAI,VADODARA,15476,15776,MUMBAI-VADODARA,31252,All
2022,10,MUMBAI,VADODARA,13694,15287,MUMBAI-VADODARA,28981,All
2022,11,MUMBAI,VADODARA,10426,11176,MUMBAI-VADODARA,21602,All
2022,12,MUMBAI,VADODARA,9739,10058,MUMBAI-VADODARA,19797,All
2023,1,MUMBAI,VADODARA,11240,11776,MUMBAI-VADODARA,23016,All
2023,2,MUMBAI,VADODARA,9625,10338,MUMBAI-VADODARA,19963,All
2023,3,MUMBAI,VADODARA,9375,10208,MUMBAI-VADODARA,19583,All
2023,4,MUMBAI,VADODARA,9978,11068,MUMBAI-VADODARA,21046,All
2023,5,MUMBAI,VADODARA,19983,23903,MUMBAI-VADODARA,43886,All
2023,6,MUMBAI,VADODARA,19325,18734,MUMBAI-VADODARA,38059,All
2023,7,MUMBAI,VADODARA,18772,19689,MUMBAI-VADODARA,38461,All
2023,8,MUMBAI,VADODARA,20540,22944,MUMBAI-VADODARA,43484,All
2023,9,MUMBAI,VADODARA,21099,23161,MUMBAI-VADODARA,44260,All
2023,10,MUMBAI,VADODARA,19827,20253,MUMBAI-VADODARA,40080,All
2023,11,MUMBAI,VADODARA,19335,19234,MUMBAI-VADODARA,38569,All
2023,12,MUMBAI,VADODARA,19282,20196,MUMBAI-VADODARA,39478,All
2024,1,MUMBAI,VADODARA,19461,20560,MUMBAI-VADODARA,40021,All
2024,2,MUMBAI,VADODARA,19204,21297,MUMBAI-VADODARA,40501,All
2024,3,MUMBAI,VADODARA,16838,19533,MUMBAI-VADODARA,36371,All
2024,4,MUMBAI,VADODARA,13021,14210,MUMBAI-VADODARA,27231,All
2024,6,MUMBAI,VADODARA,12643,13793,MUMBAI-VADODARA,26436,All
2024,7,MUMBAI,VADODARA,12132,13418,MUMBAI-VADODARA,25550,All
2024,8,MUMBAI,VADODARA,13608,15079,MUMBAI-VADODARA,28687,All
2024,9,MUMBAI,VADODARA,13733,15303,MUMBAI-VADODARA,29036,All
2024,10,MUMBAI,VADODARA,14670,14925,MUMBAI-VADODARA,29595,All
2024,11,MUMBAI,VADODARA,13930,14933,MUMBAI-VADODARA,28863,All
2024,12,MUMBAI,VADODARA,14504,15422,MUMBAI-VADODARA,29926,All
2025,1,MUMBAI,VADODARA,14817,15702,MUMBAI-VADODARA,30519,All
2025,2,MUMBAI,VADODARA,12947,13644,MUMBAI-VADODARA,26591,All
2025,3,MUMBAI,VADODARA,12225,15194,MUMBAI-VADODARA,27419,All
2015,4,MUMBAI,VARANASI,10111,7534,MUMBAI-VARANASI,17645,All
2015,5,MUMBAI,VARANASI,11564,10373,MUMBAI-VARANASI,21937,All
2015,6,MUMBAI,VARANASI,7764,10604,MUMBAI-VARANASI,18368,All
2015,7,MUMBAI,VARANASI,7714,7987,MUMBAI-VARANASI,15701,All
2015,8,MUMBAI,VARANASI,7518,7634,MUMBAI-VARANASI,15152,All
2015,9,MUMBAI,VARANASI,10880,9352,MUMBAI-VARANASI,20232,All
2015,10,MUMBAI,VARANASI,14860,12965,MUMBAI-VARANASI,27825,All
2015,11,MUMBAI,VARANASI,20028,15494,MUMBAI-VARANASI,35522,All
2015,12,MUMBAI,VARANASI,16012,17497,MUMBAI-VARANASI,33509,All
2016,1,MUMBAI,VARANASI,14116,12603,MUMBAI-VARANASI,26719,All
2016,2,MUMBAI,VARANASI,15613,13930,MUMBAI-VARANASI,29543,All
2016,3,MUMBAI,VARANASI,16829,14996,MUMBAI-VARANASI,31825,All
2016,4,MUMBAI,VARANASI,19744,14527,MUMBAI-VARANASI,34271,All
2016,5,MUMBAI,VARANASI,17672,18288,MUMBAI-VARANASI,35960,All
2016,6,MUMBAI,VARANASI,15563,16857,MUMBAI-VARANASI,32420,All
2016,7,MUMBAI,VARANASI,17045,15882,MUMBAI-VARANASI,32927,All
2016,8,MUMBAI,VARANASI,17183,16225,MUMBAI-VARANASI,33408,All
2016,9,MUMBAI,VARANASI,18041,16631,MUMBAI-VARANASI,34672,All
2016,10,MUMBAI,VARANASI,19122,16284,MUMBAI-VARANASI,35406,All
2016,11,MUMBAI,VARANASI,17793,16500,MUMBAI-VARANASI,34293,All
2016,12,MUMBAI,VARANASI,14830,18928,MUMBAI-VARANASI,33758,All
2017,1,MUMBAI,VARANASI,15663,18142,MUMBAI-VARANASI,33805,All
2017,2,MUMBAI,VARANASI,15501,16241,MUMBAI-VARANASI,31742,All
2017,3,MUMBAI,VARANASI,15271,14847,MUMBAI-VARANASI,30118,All
2017,4,MUMBAI,VARANASI,14403,12875,MUMBAI-VARANASI,27278,All
2017,5,MUMBAI,VARANASI,15609,14608,MUMBAI-VARANASI,30217,All
2017,6,MUMBAI,VARANASI,18042,20077,MUMBAI-VARANASI,38119,All
2017,7,MUMBAI,VARANASI,17934,18775,MUMBAI-VARANASI,36709,All
2017,8,MUMBAI,VARANASI,18531,18456,MUMBAI-VARANASI,36987,All
2017,9,MUMBAI,VARANASI,19172,17910,MUMBAI-VARANASI,37082,All
2017,10,MUMBAI,VARANASI,19649,18284,MUMBAI-VARANASI,37933,All
2017,11,MUMBAI,VARANASI,18715,18385,MUMBAI-VARANASI,37100,All
2017,12,MUMBAI,VARANASI,14992,15357,MUMBAI-VARANASI,30349,All
2018,1,MUMBAI,VARANASI,15468,14415,MUMBAI-VARANASI,29883,All
2018,2,MUMBAI,VARANASI,19501,17043,MUMBAI-VARANASI,36544,All
2018,3,MUMBAI,VARANASI,20746,20192,MUMBAI-VARANASI,40938,All
2018,4,MUMBAI,VARANASI,22147,17172,MUMBAI-VARANASI,39319,All
2018,5,MUMBAI,VARANASI,22713,25190,MUMBAI-VARANASI,47903,All
2018,6,MUMBAI,VARANASI,20781,21601,MUMBAI-VARANASI,42382,All
2018,7,MUMBAI,VARANASI,20833,21865,MUMBAI-VARANASI,42698,All
2018,8,MUMBAI,VARANASI,21054,19775,MUMBAI-VARANASI,40829,All
2018,9,MUMBAI,VARANASI,21021,20363,MUMBAI-VARANASI,41384,All
2018,10,MUMBAI,VARANASI,23274,18524,MUMBAI-VARANASI,41798,All
2018,11,MUMBAI,VARANASI,23440,21415,MUMBAI-VARANASI,44855,All
2018,12,MUMBAI,VARANASI,18870,18923,MUMBAI-VARANASI,37793,All
2019,1,MUMBAI,VARANASI,20478,17973,MUMBAI-VARANASI,38451,All
2019,2,MUMBAI,VARANASI,17562,18120,MUMBAI-VARANASI,35682,All
2019,3,MUMBAI,VARANASI,17424,18332,MUMBAI-VARANASI,35756,All
2019,4,MUMBAI,VARANASI,22502,18370,MUMBAI-VARANASI,40872,All
2019,5,MUMBAI,VARANASI,26170,23847,MUMBAI-VARANASI,50017,All
2019,6,MUMBAI,VARANASI,20975,25024,MUMBAI-VARANASI,45999,All
2019,7,MUMBAI,VARANASI,24164,23745,MUMBAI-VARANASI,47909,All
2019,8,MUMBAI,VARANASI,25581,23638,MUMBAI-VARANASI,49219,All
2019,9,MUMBAI,VARANASI,26645,23859,MUMBAI-VARANASI,50504,All
2019,10,MUMBAI,VARANASI,27546,17349,MUMBAI-VARANASI,44895,All
2019,11,MUMBAI,VARANASI,29904,29234,MUMBAI-VARANASI,59138,All
2019,12,MUMBAI,VARANASI,26016,28820,MUMBAI-VARANASI,54836,All
2020,1,MUMBAI,VARANASI,28332,24734,MUMBAI-VARANASI,53066,All
2020,2,MUMBAI,VARANASI,30143,28112,MUMBAI-VARANASI,58255,All
2020,3,MUMBAI,VARANASI,23047,18895,MUMBAI-VARANASI,41942,All
2020,5,MUMBAI,VARANASI,2207,651,MUMBAI-VARANASI,2858,All
2020,6,MUMBAI,VARANASI,15509,5823,MUMBAI-VARANASI,21332,All
2020,7,MUMBAI,VARANASI,22266,9242,MUMBAI-VARANASI,31508,All
2020,8,MUMBAI,VARANASI,13261,20720,MUMBAI-VARANASI,33981,All
2020,9,MUMBAI,VARANASI,12633,25618,MUMBAI-VARANASI,38251,All
2020,10,MUMBAI,VARANASI,22506,33639,MUMBAI-VARANASI,56145,All
2020,11,MUMBAI,VARANASI,43722,30515,MUMBAI-VARANASI,74237,All
2020,12,MUMBAI,VARANASI,26829,37216,MUMBAI-VARANASI,64045,All
2021,1,MUMBAI,VARANASI,23755,33742,MUMBAI-VARANASI,57497,All
2021,2,MUMBAI,VARANASI,29344,22436,MUMBAI-VARANASI,51780,All
2021,3,MUMBAI,VARANASI,32273,19970,MUMBAI-VARANASI,52243,All
2021,4,MUMBAI,VARANASI,30997,13321,MUMBAI-VARANASI,44318,All
2021,6,MUMBAI,VARANASI,12187,19893,MUMBAI-VARANASI,32080,All
2021,7,MUMBAI,VARANASI,14390,13108,MUMBAI-VARANASI,27498,All
2021,8,MUMBAI,VARANASI,20276,16541,MUMBAI-VARANASI,36817,All
2021,9,MUMBAI,VARANASI,17148,13009,MUMBAI-VARANASI,30157,All
2021,10,MUMBAI,VARANASI,27408,15728,MUMBAI-VARANASI,43136,All
2021,11,MUMBAI,VARANASI,33690,28940,MUMBAI-VARANASI,62630,All
2021,12,MUMBAI,VARANASI,23014,29212,MUMBAI-VARANASI,52226,All
2022,1,MUMBAI,VARANASI,17953,14547,MUMBAI-VARANASI,32500,All
2022,2,MUMBAI,VARANASI,24355,22476,MUMBAI-VARANASI,46831,All
2022,3,MUMBAI,VARANASI,27872,26511,MUMBAI-VARANASI,54383,All
2022,4,MUMBAI,VARANASI,29701,22829,MUMBAI-VARANASI,52530,All
2022,5,MUMBAI,VARANASI,32505,30878,MUMBAI-VARANASI,63383,All
2022,6,MUMBAI,VARANASI,22605,28942,MUMBAI-VARANASI,51547,All
2022,7,MUMBAI,VARANASI,19364,17817,MUMBAI-VARANASI,37181,All
2022,8,MUMBAI,VARANASI,19904,20559,MUMBAI-VARANASI,40463,All
2022,9,MUMBAI,VARANASI,23170,19865,MUMBAI-VARANASI,43035,All
2022,10,MUMBAI,VARANASI,30667,21911,MUMBAI-VARANASI,52578,All
2022,11,MUMBAI,VARANASI,29274,28848,MUMBAI-VARANASI,58122,All
2022,12,MUMBAI,VARANASI,26485,28483,MUMBAI-VARANASI,54968,All
2023,1,MUMBAI,VARANASI,27028,25102,MUMBAI-VARANASI,52130,All
2023,2,MUMBAI,VARANASI,28429,27055,MUMBAI-VARANASI,55484,All
2023,3,MUMBAI,VARANASI,26075,25361,MUMBAI-VARANASI,51436,All
2023,4,MUMBAI,VARANASI,29812,26507,MUMBAI-VARANASI,56319,All
2023,5,MUMBAI,VARANASI,25884,25213,MUMBAI-VARANASI,51097,All
2023,6,MUMBAI,VARANASI,30184,30448,MUMBAI-VARANASI,60632,All
2023,7,MUMBAI,VARANASI,27244,29742,MUMBAI-VARANASI,56986,All
2023,8,MUMBAI,VARANASI,30610,30721,MUMBAI-VARANASI,61331,All
2023,9,MUMBAI,VARANASI,32908,32467,MUMBAI-VARANASI,65375,All
2023,10,MUMBAI,VARANASI,33457,28841,MUMBAI-VARANASI,62298,All
2023,11,MUMBAI,VARANASI,32577,26587,MUMBAI-VARANASI,59164,All
2023,12,MUMBAI,VARANASI,31820,32536,MUMBAI-VARANASI,64356,All
2024,1,MUMBAI,VARANASI,28185,28082,MUMBAI-VARANASI,56267,All
2024,2,MUMBAI,VARANASI,29713,27744,MUMBAI-VARANASI,57457,All
2024,3,MUMBAI,VARANASI,31406,28366,MUMBAI-VARANASI,59772,All
2024,4,MUMBAI,VARANASI,32289,27346,MUMBAI-VARANASI,59635,All
2024,6,MUMBAI,VARANASI,31621,32565,MUMBAI-VARANASI,64186,All
2024,7,MUMBAI,VARANASI,25568,27791,MUMBAI-VARANASI,53359,All
2024,8,MUMBAI,VARANASI,26146,29193,MUMBAI-VARANASI,55339,All
2024,9,MUMBAI,VARANASI,27859,28049,MUMBAI-VARANASI,55908,All
2024,10,MUMBAI,VARANASI,35578,27910,MUMBAI-VARANASI,63488,All
2024,11,MUMBAI,VARANASI,41707,39740,MUMBAI-VARANASI,81447,All
2024,12,MUMBAI,VARANASI,37184,39927,MUMBAI-VARANASI,77111,All
2025,1,MUMBAI,VARANASI,39168,39174,MUMBAI-VARANASI,78342,All
2025,2,MUMBAI,VARANASI,38030,37617,MUMBAI-VARANASI,75647,All
2025,3,MUMBAI,VARANASI,46108,44408,MUMBAI-VARANASI,90516,All
2023,12,MUMBAI,VIDYANAGAR,93,89,MUMBAI-VIDYANAGAR,182,All
2018,1,MUMBAI,VIJAYAWADA,538,636,MUMBAI-VIJAYAWADA,1174,All
2018,2,MUMBAI,VIJAYAWADA,1420,1276,MUMBAI-VIJAYAWADA,2696,All
2018,3,MUMBAI,VIJAYAWADA,1732,1605,MUMBAI-VIJAYAWADA,3337,All
2018,4,MUMBAI,VIJAYAWADA,1613,1541,MUMBAI-VIJAYAWADA,3154,All
2018,5,MUMBAI,VIJAYAWADA,1621,1572,MUMBAI-VIJAYAWADA,3193,All
2018,6,MUMBAI,VIJAYAWADA,1346,1101,MUMBAI-VIJAYAWADA,2447,All
2018,7,MUMBAI,VIJAYAWADA,1231,1065,MUMBAI-VIJAYAWADA,2296,All
2018,8,MUMBAI,VIJAYAWADA,1424,1255,MUMBAI-VIJAYAWADA,2679,All
2018,9,MUMBAI,VIJAYAWADA,1509,1395,MUMBAI-VIJAYAWADA,2904,All
2018,10,MUMBAI,VIJAYAWADA,1602,1262,MUMBAI-VIJAYAWADA,2864,All
2018,11,MUMBAI,VIJAYAWADA,1440,1362,MUMBAI-VIJAYAWADA,2802,All
2018,12,MUMBAI,VIJAYAWADA,1748,1257,MUMBAI-VIJAYAWADA,3005,All
2019,1,MUMBAI,VIJAYAWADA,1694,1501,MUMBAI-VIJAYAWADA,3195,All
2019,2,MUMBAI,VIJAYAWADA,904,670,MUMBAI-VIJAYAWADA,1574,All
2019,3,MUMBAI,VIJAYAWADA,498,311,MUMBAI-VIJAYAWADA,809,All
2019,4,MUMBAI,VIJAYAWADA,1737,1386,MUMBAI-VIJAYAWADA,3123,All
2019,5,MUMBAI,VIJAYAWADA,2016,1950,MUMBAI-VIJAYAWADA,3966,All
2019,6,MUMBAI,VIJAYAWADA,3487,3418,MUMBAI-VIJAYAWADA,6905,All
2019,7,MUMBAI,VIJAYAWADA,3937,3617,MUMBAI-VIJAYAWADA,7554,All
2019,8,MUMBAI,VIJAYAWADA,3292,3220,MUMBAI-VIJAYAWADA,6512,All
2019,9,MUMBAI,VIJAYAWADA,2874,3246,MUMBAI-VIJAYAWADA,6120,All
2019,10,MUMBAI,VIJAYAWADA,4290,3689,MUMBAI-VIJAYAWADA,7979,All
2019,11,MUMBAI,VIJAYAWADA,1470,1628,MUMBAI-VIJAYAWADA,3098,All
2019,12,MUMBAI,VIJAYAWADA,1554,1424,MUMBAI-VIJAYAWADA,2978,All
2020,1,MUMBAI,VIJAYAWADA,1345,1248,MUMBAI-VIJAYAWADA,2593,All
2020,2,MUMBAI,VIJAYAWADA,1461,1275,MUMBAI-VIJAYAWADA,2736,All
2020,3,MUMBAI,VIJAYAWADA,858,579,MUMBAI-VIJAYAWADA,1437,All
2020,5,MUMBAI,VIJAYAWADA,143,0,MUMBAI-VIJAYAWADA,143,All
2020,6,MUMBAI,VIJAYAWADA,20,0,MUMBAI-VIJAYAWADA,20,All
2020,7,MUMBAI,VIJAYAWADA,246,0,MUMBAI-VIJAYAWADA,246,All
2020,10,MUMBAI,VIJAYAWADA,0,0,MUMBAI-VIJAYAWADA,0,All
2020,11,MUMBAI,VIJAYAWADA,0,0,MUMBAI-VIJAYAWADA,0,All
2020,12,MUMBAI,VIJAYAWADA,0,0,MUMBAI-VIJAYAWADA,0,All
2021,1,MUMBAI,VIJAYAWADA,955,1164,MUMBAI-VIJAYAWADA,2119,All
2021,2,MUMBAI,VIJAYAWADA,1484,1491,MUMBAI-VIJAYAWADA,2975,All
2021,3,MUMBAI,VIJAYAWADA,1234,1178,MUMBAI-VIJAYAWADA,2412,All
2021,10,MUMBAI,VIJAYAWADA,0,0,MUMBAI-VIJAYAWADA,0,All
2022,4,MUMBAI,VIJAYAWADA,30,0,MUMBAI-VIJAYAWADA,30,All
2024,6,MUMBAI,VIJAYAWADA,1834,1874,MUMBAI-VIJAYAWADA,3708,All
2024,7,MUMBAI,VIJAYAWADA,3973,3806,MUMBAI-VIJAYAWADA,7779,All
2024,8,MUMBAI,VIJAYAWADA,5579,6895,MUMBAI-VIJAYAWADA,12474,All
2024,9,MUMBAI,VIJAYAWADA,6071,6582,MUMBAI-VIJAYAWADA,12653,All
2024,10,MUMBAI,VIJAYAWADA,8711,7351,MUMBAI-VIJAYAWADA,16062,All
2024,11,MUMBAI,VIJAYAWADA,7803,8784,MUMBAI-VIJAYAWADA,16587,All
2024,12,MUMBAI,VIJAYAWADA,9355,8128,MUMBAI-VIJAYAWADA,17483,All
2025,1,MUMBAI,VIJAYAWADA,8849,8978,MUMBAI-VIJAYAWADA,17827,All
2025,2,MUMBAI,VIJAYAWADA,7695,7334,MUMBAI-VIJAYAWADA,15029,All
2025,3,MUMBAI,VIJAYAWADA,7442,7584,MUMBAI-VIJAYAWADA,15026,All
2015,4,MUMBAI,VISAKHAPATNAM,4327,5170,MUMBAI-VISAKHAPATNAM,9497,All
2015,5,MUMBAI,VISAKHAPATNAM,4827,6189,MUMBAI-VISAKHAPATNAM,11016,All
2015,6,MUMBAI,VISAKHAPATNAM,4222,5440,MUMBAI-VISAKHAPATNAM,9662,All
2015,7,MUMBAI,VISAKHAPATNAM,6041,6311,MUMBAI-VISAKHAPATNAM,12352,All
2015,8,MUMBAI,VISAKHAPATNAM,5455,6028,MUMBAI-VISAKHAPATNAM,11483,All
2015,9,MUMBAI,VISAKHAPATNAM,5289,5858,MUMBAI-VISAKHAPATNAM,11147,All
2015,10,MUMBAI,VISAKHAPATNAM,8263,5883,MUMBAI-VISAKHAPATNAM,14146,All
2015,11,MUMBAI,VISAKHAPATNAM,6202,7136,MUMBAI-VISAKHAPATNAM,13338,All
2015,12,MUMBAI,VISAKHAPATNAM,8553,8399,MUMBAI-VISAKHAPATNAM,16952,All
2016,1,MUMBAI,VISAKHAPATNAM,8733,9158,MUMBAI-VISAKHAPATNAM,17891,All
2016,2,MUMBAI,VISAKHAPATNAM,7971,8205,MUMBAI-VISAKHAPATNAM,16176,All
2016,3,MUMBAI,VISAKHAPATNAM,7759,8306,MUMBAI-VISAKHAPATNAM,16065,All
2016,4,MUMBAI,VISAKHAPATNAM,8279,8841,MUMBAI-VISAKHAPATNAM,17120,All
2016,5,MUMBAI,VISAKHAPATNAM,8291,9486,MUMBAI-VISAKHAPATNAM,17777,All
2016,6,MUMBAI,VISAKHAPATNAM,7943,7948,MUMBAI-VISAKHAPATNAM,15891,All
2016,7,MUMBAI,VISAKHAPATNAM,7879,7823,MUMBAI-VISAKHAPATNAM,15702,All
2016,8,MUMBAI,VISAKHAPATNAM,8105,8815,MUMBAI-VISAKHAPATNAM,16920,All
2016,9,MUMBAI,VISAKHAPATNAM,6797,8277,MUMBAI-VISAKHAPATNAM,15074,All
2016,10,MUMBAI,VISAKHAPATNAM,7869,7590,MUMBAI-VISAKHAPATNAM,15459,All
2016,11,MUMBAI,VISAKHAPATNAM,6284,7156,MUMBAI-VISAKHAPATNAM,13440,All
2016,12,MUMBAI,VISAKHAPATNAM,9349,9388,MUMBAI-VISAKHAPATNAM,18737,All
2017,1,MUMBAI,VISAKHAPATNAM,9739,9919,MUMBAI-VISAKHAPATNAM,19658,All
2017,2,MUMBAI,VISAKHAPATNAM,7887,7761,MUMBAI-VISAKHAPATNAM,15648,All
2017,3,MUMBAI,VISAKHAPATNAM,9208,8793,MUMBAI-VISAKHAPATNAM,18001,All
2017,4,MUMBAI,VISAKHAPATNAM,12898,12214,MUMBAI-VISAKHAPATNAM,25112,All
2017,5,MUMBAI,VISAKHAPATNAM,13218,13939,MUMBAI-VISAKHAPATNAM,27157,All
2017,6,MUMBAI,VISAKHAPATNAM,10393,10637,MUMBAI-VISAKHAPATNAM,21030,All
2017,7,MUMBAI,VISAKHAPATNAM,8221,9291,MUMBAI-VISAKHAPATNAM,17512,All
2017,8,MUMBAI,VISAKHAPATNAM,7817,10126,MUMBAI-VISAKHAPATNAM,17943,All
2017,9,MUMBAI,VISAKHAPATNAM,7173,8989,MUMBAI-VISAKHAPATNAM,16162,All
2017,10,MUMBAI,VISAKHAPATNAM,7620,8260,MUMBAI-VISAKHAPATNAM,15880,All
2017,11,MUMBAI,VISAKHAPATNAM,7586,9131,MUMBAI-VISAKHAPATNAM,16717,All
2017,12,MUMBAI,VISAKHAPATNAM,8096,8829,MUMBAI-VISAKHAPATNAM,16925,All
2018,1,MUMBAI,VISAKHAPATNAM,8173,9532,MUMBAI-VISAKHAPATNAM,17705,All
2018,2,MUMBAI,VISAKHAPATNAM,7894,8830,MUMBAI-VISAKHAPATNAM,16724,All
2018,3,MUMBAI,VISAKHAPATNAM,7925,9465,MUMBAI-VISAKHAPATNAM,17390,All
2018,4,MUMBAI,VISAKHAPATNAM,8162,8272,MUMBAI-VISAKHAPATNAM,16434,All
2018,5,MUMBAI,VISAKHAPATNAM,8293,8643,MUMBAI-VISAKHAPATNAM,16936,All
2018,6,MUMBAI,VISAKHAPATNAM,7244,7404,MUMBAI-VISAKHAPATNAM,14648,All
2018,7,MUMBAI,VISAKHAPATNAM,6915,7324,MUMBAI-VISAKHAPATNAM,14239,All
2018,8,MUMBAI,VISAKHAPATNAM,8188,8468,MUMBAI-VISAKHAPATNAM,16656,All
2018,9,MUMBAI,VISAKHAPATNAM,8368,9180,MUMBAI-VISAKHAPATNAM,17548,All
2018,10,MUMBAI,VISAKHAPATNAM,10177,10219,MUMBAI-VISAKHAPATNAM,20396,All
2018,11,MUMBAI,VISAKHAPATNAM,7618,8244,MUMBAI-VISAKHAPATNAM,15862,All
2018,12,MUMBAI,VISAKHAPATNAM,8392,8629,MUMBAI-VISAKHAPATNAM,17021,All
2019,1,MUMBAI,VISAKHAPATNAM,8967,9083,MUMBAI-VISAKHAPATNAM,18050,All
2019,2,MUMBAI,VISAKHAPATNAM,5220,5332,MUMBAI-VISAKHAPATNAM,10552,All
2019,3,MUMBAI,VISAKHAPATNAM,4387,4784,MUMBAI-VISAKHAPATNAM,9171,All
2019,4,MUMBAI,VISAKHAPATNAM,4816,5687,MUMBAI-VISAKHAPATNAM,10503,All
2019,5,MUMBAI,VISAKHAPATNAM,5433,6143,MUMBAI-VISAKHAPATNAM,11576,All
2019,6,MUMBAI,VISAKHAPATNAM,6592,7035,MUMBAI-VISAKHAPATNAM,13627,All
2019,7,MUMBAI,VISAKHAPATNAM,5199,5690,MUMBAI-VISAKHAPATNAM,10889,All
2019,8,MUMBAI,VISAKHAPATNAM,5507,6359,MUMBAI-VISAKHAPATNAM,11866,All
2019,9,MUMBAI,VISAKHAPATNAM,4912,5790,MUMBAI-VISAKHAPATNAM,10702,All
2019,10,MUMBAI,VISAKHAPATNAM,6660,6617,MUMBAI-VISAKHAPATNAM,13277,All
2019,11,MUMBAI,VISAKHAPATNAM,4821,5802,MUMBAI-VISAKHAPATNAM,10623,All
2019,12,MUMBAI,VISAKHAPATNAM,5634,5323,MUMBAI-VISAKHAPATNAM,10957,All
2020,1,MUMBAI,VISAKHAPATNAM,5915,6200,MUMBAI-VISAKHAPATNAM,12115,All
2020,2,MUMBAI,VISAKHAPATNAM,5952,6148,MUMBAI-VISAKHAPATNAM,12100,All
2020,3,MUMBAI,VISAKHAPATNAM,4253,3447,MUMBAI-VISAKHAPATNAM,7700,All
2020,5,MUMBAI,VISAKHAPATNAM,166,0,MUMBAI-VISAKHAPATNAM,166,All
2020,6,MUMBAI,VISAKHAPATNAM,46,49,MUMBAI-VISAKHAPATNAM,95,All
2020,7,MUMBAI,VISAKHAPATNAM,832,494,MUMBAI-VISAKHAPATNAM,1326,All
2020,8,MUMBAI,VISAKHAPATNAM,1056,1357,MUMBAI-VISAKHAPATNAM,2413,All
2020,9,MUMBAI,VISAKHAPATNAM,1857,2413,MUMBAI-VISAKHAPATNAM,4270,All
2020,10,MUMBAI,VISAKHAPATNAM,2816,3081,MUMBAI-VISAKHAPATNAM,5897,All
2020,11,MUMBAI,VISAKHAPATNAM,3662,3826,MUMBAI-VISAKHAPATNAM,7488,All
2020,12,MUMBAI,VISAKHAPATNAM,4536,3993,MUMBAI-VISAKHAPATNAM,8529,All
2021,1,MUMBAI,VISAKHAPATNAM,4300,4512,MUMBAI-VISAKHAPATNAM,8812,All
2021,2,MUMBAI,VISAKHAPATNAM,3528,3848,MUMBAI-VISAKHAPATNAM,7376,All
2021,3,MUMBAI,VISAKHAPATNAM,3787,3820,MUMBAI-VISAKHAPATNAM,7607,All
2021,4,MUMBAI,VISAKHAPATNAM,3490,2943,MUMBAI-VISAKHAPATNAM,6433,All
2021,6,MUMBAI,VISAKHAPATNAM,1577,2326,MUMBAI-VISAKHAPATNAM,3903,All
2021,7,MUMBAI,VISAKHAPATNAM,2325,2879,MUMBAI-VISAKHAPATNAM,5204,All
2021,8,MUMBAI,VISAKHAPATNAM,2690,3789,MUMBAI-VISAKHAPATNAM,6479,All
2021,9,MUMBAI,VISAKHAPATNAM,2259,3602,MUMBAI-VISAKHAPATNAM,5861,All
2021,10,MUMBAI,VISAKHAPATNAM,2570,4067,MUMBAI-VISAKHAPATNAM,6637,All
2021,11,MUMBAI,VISAKHAPATNAM,5305,6820,MUMBAI-VISAKHAPATNAM,12125,All
2021,12,MUMBAI,VISAKHAPATNAM,6586,7599,MUMBAI-VISAKHAPATNAM,14185,All
2022,1,MUMBAI,VISAKHAPATNAM,4195,4900,MUMBAI-VISAKHAPATNAM,9095,All
2022,2,MUMBAI,VISAKHAPATNAM,5063,6414,MUMBAI-VISAKHAPATNAM,11477,All
2022,3,MUMBAI,VISAKHAPATNAM,5591,6702,MUMBAI-VISAKHAPATNAM,12293,All
2022,4,MUMBAI,VISAKHAPATNAM,6036,6780,MUMBAI-VISAKHAPATNAM,12816,All
2022,5,MUMBAI,VISAKHAPATNAM,6852,7400,MUMBAI-VISAKHAPATNAM,14252,All
2022,6,MUMBAI,VISAKHAPATNAM,6834,7282,MUMBAI-VISAKHAPATNAM,14116,All
2022,7,MUMBAI,VISAKHAPATNAM,7001,6895,MUMBAI-VISAKHAPATNAM,13896,All
2022,8,MUMBAI,VISAKHAPATNAM,6763,8649,MUMBAI-VISAKHAPATNAM,15412,All
2022,9,MUMBAI,VISAKHAPATNAM,4608,5859,MUMBAI-VISAKHAPATNAM,10467,All
2022,10,MUMBAI,VISAKHAPATNAM,4633,4987,MUMBAI-VISAKHAPATNAM,9620,All
2022,11,MUMBAI,VISAKHAPATNAM,6534,7716,MUMBAI-VISAKHAPATNAM,14250,All
2022,12,MUMBAI,VISAKHAPATNAM,7815,8399,MUMBAI-VISAKHAPATNAM,16214,All
2023,1,MUMBAI,VISAKHAPATNAM,7647,8386,MUMBAI-VISAKHAPATNAM,16033,All
2023,2,MUMBAI,VISAKHAPATNAM,7988,9156,MUMBAI-VISAKHAPATNAM,17144,All
2023,3,MUMBAI,VISAKHAPATNAM,9195,10100,MUMBAI-VISAKHAPATNAM,19295,All
2023,4,MUMBAI,VISAKHAPATNAM,10816,11171,MUMBAI-VISAKHAPATNAM,21987,All
2023,5,MUMBAI,VISAKHAPATNAM,15898,15426,MUMBAI-VISAKHAPATNAM,31324,All
2023,6,MUMBAI,VISAKHAPATNAM,10834,10836,MUMBAI-VISAKHAPATNAM,21670,All
2023,7,MUMBAI,VISAKHAPATNAM,10100,10862,MUMBAI-VISAKHAPATNAM,20962,All
2023,8,MUMBAI,VISAKHAPATNAM,10486,10811,MUMBAI-VISAKHAPATNAM,21297,All
2023,9,MUMBAI,VISAKHAPATNAM,9329,10213,MUMBAI-VISAKHAPATNAM,19542,All
2023,10,MUMBAI,VISAKHAPATNAM,10512,10478,MUMBAI-VISAKHAPATNAM,20990,All
2023,11,MUMBAI,VISAKHAPATNAM,9143,8824,MUMBAI-VISAKHAPATNAM,17967,All
2023,12,MUMBAI,VISAKHAPATNAM,9593,9725,MUMBAI-VISAKHAPATNAM,19318,All
2024,1,MUMBAI,VISAKHAPATNAM,9418,9749,MUMBAI-VISAKHAPATNAM,19167,All
2024,2,MUMBAI,VISAKHAPATNAM,8830,8567,MUMBAI-VISAKHAPATNAM,17397,All
2024,3,MUMBAI,VISAKHAPATNAM,9416,9662,MUMBAI-VISAKHAPATNAM,19078,All
2024,4,MUMBAI,VISAKHAPATNAM,8712,8915,MUMBAI-VISAKHAPATNAM,17627,All
2024,6,MUMBAI,VISAKHAPATNAM,9335,8544,MUMBAI-VISAKHAPATNAM,17879,All
2024,7,MUMBAI,VISAKHAPATNAM,8697,8569,MUMBAI-VISAKHAPATNAM,17266,All
2024,8,MUMBAI,VISAKHAPATNAM,9291,9542,MUMBAI-VISAKHAPATNAM,18833,All
2024,9,MUMBAI,VISAKHAPATNAM,8732,8932,MUMBAI-VISAKHAPATNAM,17664,All
2024,10,MUMBAI,VISAKHAPATNAM,10399,9057,MUMBAI-VISAKHAPATNAM,19456,All
2024,11,MUMBAI,VISAKHAPATNAM,10217,11031,MUMBAI-VISAKHAPATNAM,21248,All
2024,12,MUMBAI,VISAKHAPATNAM,11419,11170,MUMBAI-VISAKHAPATNAM,22589,All
2025,1,MUMBAI,VISAKHAPATNAM,10847,10716,MUMBAI-VISAKHAPATNAM,21563,All
2025,2,MUMBAI,VISAKHAPATNAM,10185,9960,MUMBAI-VISAKHAPATNAM,20145,All
2025,3,MUMBAI,VISAKHAPATNAM,9559,9393,MUMBAI-VISAKHAPATNAM,18952,All
2019,6,MYSORE,VIJAYAWADA,78,96,MYSORE-VIJAYAWADA,174,All
2019,7,MYSORE,VIJAYAWADA,52,61,MYSORE-VIJAYAWADA,113,All
2019,6,MYSORE,VISAKHAPATNAM,38,65,MYSORE-VISAKHAPATNAM,103,All
2019,7,MYSORE,VISAKHAPATNAM,41,45,MYSORE-VISAKHAPATNAM,86,All
2023,11,Malvan,MUMBAI,632,678,Malvan-MUMBAI,1310,All
2023,12,Malvan,MUMBAI,652,726,Malvan-MUMBAI,1378,All
2024,1,Malvan,MUMBAI,818,761,Malvan-MUMBAI,1579,All
2024,2,Malvan,MUMBAI,825,846,Malvan-MUMBAI,1671,All
2024,3,Malvan,MUMBAI,922,868,Malvan-MUMBAI,1790,All
2024,4,Malvan,MUMBAI,910,977,Malvan-MUMBAI,1887,All
2024,6,Malvan,MUMBAI,475,360,Malvan-MUMBAI,835,All
2024,7,Malvan,MUMBAI,306,270,Malvan-MUMBAI,576,All
2024,8,Malvan,MUMBAI,515,591,Malvan-MUMBAI,1106,All
2024,9,Malvan,MUMBAI,1022,1165,Malvan-MUMBAI,2187,All
2024,10,Malvan,MUMBAI,389,413,Malvan-MUMBAI,802,All
2024,8,Malvan,PUNE,19,26,Malvan-PUNE,45,All
2024,9,Malvan,PUNE,224,326,Malvan-PUNE,550,All
2024,10,Malvan,PUNE,147,218,Malvan-PUNE,365,All
2024,11,Malvan,PUNE,248,310,Malvan-PUNE,558,All
2024,12,Malvan,PUNE,220,417,Malvan-PUNE,637,All
2025,1,Malvan,PUNE,141,227,Malvan-PUNE,368,All
2023,3,"Mopa, Goa",AHMEDABAD,9327,10041,"AHMEDABAD-Mopa, Goa",19368,All
2023,4,"Mopa, Goa",AHMEDABAD,17563,17904,"AHMEDABAD-Mopa, Goa",35467,All
2023,5,"Mopa, Goa",AHMEDABAD,15684,16068,"AHMEDABAD-Mopa, Goa",31752,All
2023,3,"Mopa, Goa",AMRITSAR,789,779,"AMRITSAR-Mopa, Goa",1568,All
2023,4,"Mopa, Goa",AMRITSAR,3953,4151,"AMRITSAR-Mopa, Goa",8104,All
2023,5,"Mopa, Goa",AMRITSAR,3385,4710,"AMRITSAR-Mopa, Goa",8095,All
2023,3,"Mopa, Goa",BENGALURU,32441,32788,"BENGALURU-Mopa, Goa",65229,All
2023,4,"Mopa, Goa",BENGALURU,34560,34434,"BENGALURU-Mopa, Goa",68994,All
2023,5,"Mopa, Goa",BENGALURU,38699,32698,"BENGALURU-Mopa, Goa",71397,All
2023,5,"Mopa, Goa",BHOPAL,586,611,"BHOPAL-Mopa, Goa",1197,All
2023,3,"Mopa, Goa",BHUBANESWAR,385,345,"BHUBANESWAR-Mopa, Goa",730,All
2023,4,"Mopa, Goa",BHUBANESWAR,2283,1803,"BHUBANESWAR-Mopa, Goa",4086,All
2023,5,"Mopa, Goa",BHUBANESWAR,2525,2404,"BHUBANESWAR-Mopa, Goa",4929,All
2023,3,"Mopa, Goa",CHANDIGARH,9513,9512,"CHANDIGARH-Mopa, Goa",19025,All
2023,4,"Mopa, Goa",CHANDIGARH,4556,4121,"CHANDIGARH-Mopa, Goa",8677,All
2023,5,"Mopa, Goa",CHANDIGARH,180,1627,"CHANDIGARH-Mopa, Goa",1807,All
2023,3,"Mopa, Goa",CHENNAI,3421,3568,"CHENNAI-Mopa, Goa",6989,All
2023,4,"Mopa, Goa",CHENNAI,3609,4517,"CHENNAI-Mopa, Goa",8126,All
2023,5,"Mopa, Goa",CHENNAI,4836,4340,"CHENNAI-Mopa, Goa",9176,All
2023,3,"Mopa, Goa",COIMBATORE,287,276,"COIMBATORE-Mopa, Goa",563,All
2023,4,"Mopa, Goa",COIMBATORE,2110,1948,"COIMBATORE-Mopa, Goa",4058,All
2023,5,"Mopa, Goa",COIMBATORE,2842,2655,"COIMBATORE-Mopa, Goa",5497,All
2023,5,"Mopa, Goa",DEHRA DUN,595,757,"DEHRA DUN-Mopa, Goa",1352,All
2023,3,"Mopa, Goa",DELHI,22071,20638,"DELHI-Mopa, Goa",42709,All
2023,4,"Mopa, Goa",DELHI,21674,17829,"DELHI-Mopa, Goa",39503,All
2023,5,"Mopa, Goa",DELHI,19208,515,"DELHI-Mopa, Goa",19723,All
2023,3,"Mopa, Goa",GUWAHATI,35,15,"GUWAHATI-Mopa, Goa",50,All
2023,4,"Mopa, Goa",GUWAHATI,271,245,"GUWAHATI-Mopa, Goa",516,All
2023,5,"Mopa, Goa",GUWAHATI,101,18630,"GUWAHATI-Mopa, Goa",18731,All
2023,3,"Mopa, Goa",HYDERABAD,16696,16318,"HYDERABAD-Mopa, Goa",33014,All
2023,4,"Mopa, Goa",HYDERABAD,14375,14117,"HYDERABAD-Mopa, Goa",28492,All
2023,5,"Mopa, Goa",HYDERABAD,10763,162,"HYDERABAD-Mopa, Goa",10925,All
2023,3,"Mopa, Goa",JAIPUR,10130,9892,"JAIPUR-Mopa, Goa",20022,All
2023,4,"Mopa, Goa",JAIPUR,11181,9557,"JAIPUR-Mopa, Goa",20738,All
2023,5,"Mopa, Goa",JAIPUR,7001,1834,"JAIPUR-Mopa, Goa",8835,All
2023,3,"Mopa, Goa",KOLKATA,2374,2060,"KOLKATA-Mopa, Goa",4434,All
2023,4,"Mopa, Goa",KOLKATA,2277,1911,"KOLKATA-Mopa, Goa",4188,All
2023,5,"Mopa, Goa",KOLKATA,2298,2051,"KOLKATA-Mopa, Goa",4349,All
2023,3,"Mopa, Goa",LUCKNOW,100,151,"LUCKNOW-Mopa, Goa",251,All
2023,4,"Mopa, Goa",LUCKNOW,3530,2166,"LUCKNOW-Mopa, Goa",5696,All
2023,5,"Mopa, Goa",LUCKNOW,3898,6622,"LUCKNOW-Mopa, Goa",10520,All
2023,3,"Mopa, Goa",MUMBAI,24637,25030,"Mopa, Goa-MUMBAI",49667,All
2023,4,"Mopa, Goa",MUMBAI,27599,32680,"Mopa, Goa-MUMBAI",60279,All
2023,5,"Mopa, Goa",MUMBAI,38140,44157,"Mopa, Goa-MUMBAI",82297,All
2023,3,"Mopa, Goa",NAGPUR,4792,5262,"Mopa, Goa-NAGPUR",10054,All
2023,4,"Mopa, Goa",NAGPUR,9588,9073,"Mopa, Goa-NAGPUR",18661,All
2023,5,"Mopa, Goa",NAGPUR,5408,4935,"Mopa, Goa-NAGPUR",10343,All
2023,3,"Mopa, Goa",NASIK,863,941,"Mopa, Goa-NASIK",1804,All
2023,4,"Mopa, Goa",NASIK,1636,1606,"Mopa, Goa-NASIK",3242,All
2023,5,"Mopa, Goa",NASIK,1632,10556,"Mopa, Goa-NASIK",12188,All
2023,5,"Mopa, Goa",PATNA,823,5064,"Mopa, Goa-PATNA",5887,All
2023,3,"Mopa, Goa",PUNE,4548,4431,"Mopa, Goa-PUNE",8979,All
2023,4,"Mopa, Goa",PUNE,4611,4205,"Mopa, Goa-PUNE",8816,All
2023,5,"Mopa, Goa",PUNE,5020,797,"Mopa, Goa-PUNE",5817,All
2023,5,"Mopa, Goa",RAIPUR,592,5244,"Mopa, Goa-RAIPUR",5836,All
2023,3,"Mopa, Goa",RAJKOT,288,302,"Mopa, Goa-RAJKOT",590,All
2023,4,"Mopa, Goa",RAJKOT,1779,1786,"Mopa, Goa-RAJKOT",3565,All
2023,5,"Mopa, Goa",RAJKOT,1951,1964,"Mopa, Goa-RAJKOT",3915,All
2023,3,"Mopa, Goa",RANCHI,344,363,"Mopa, Goa-RANCHI",707,All
2023,4,"Mopa, Goa",RANCHI,1965,1512,"Mopa, Goa-RANCHI",3477,All
2023,5,"Mopa, Goa",RANCHI,1882,186,"Mopa, Goa-RANCHI",2068,All
2023,5,"Mopa, Goa",VADODARA,676,702,"Mopa, Goa-VADODARA",1378,All
2023,3,"Mopa, Goa",VARANASI,179,177,"Mopa, Goa-VARANASI",356,All
2023,4,"Mopa, Goa",VARANASI,1810,1359,"Mopa, Goa-VARANASI",3169,All
2023,5,"Mopa, Goa",VARANASI,1933,1653,"Mopa, Goa-VARANASI",3586,All
2023,3,"Mopa, Goa",VISAKHAPATNAM,140,187,"Mopa, Goa-VISAKHAPATNAM",327,All
2023,4,"Mopa, Goa",VISAKHAPATNAM,1435,1612,"Mopa, Goa-VISAKHAPATNAM",3047,All
2023,5,"Mopa, Goa",VISAKHAPATNAM,1782,1735,"Mopa, Goa-VISAKHAPATNAM",3517,All
2024,6,NAGPUR,NANDED,89,117,NAGPUR-NANDED,206,All
2024,7,NAGPUR,NANDED,480,556,NAGPUR-NANDED,1036,All
2024,8,NAGPUR,NANDED,611,689,NAGPUR-NANDED,1300,All
2024,9,NAGPUR,NANDED,123,156,NAGPUR-NANDED,279,All
2023,3,NAGPUR,NASIK,865,846,NAGPUR-NASIK,1711,All
2023,4,NAGPUR,NASIK,1440,1736,NAGPUR-NASIK,3176,All
2023,5,NAGPUR,NASIK,1580,1527,NAGPUR-NASIK,3107,All
2023,6,NAGPUR,NASIK,1695,1801,NAGPUR-NASIK,3496,All
2023,7,NAGPUR,NASIK,1375,1593,NAGPUR-NASIK,2968,All
2023,8,NAGPUR,NASIK,1584,1637,NAGPUR-NASIK,3221,All
2023,9,NAGPUR,NASIK,1542,1492,NAGPUR-NASIK,3034,All
2023,10,NAGPUR,NASIK,1424,1568,NAGPUR-NASIK,2992,All
2023,11,NAGPUR,NASIK,1718,1841,NAGPUR-NASIK,3559,All
2023,12,NAGPUR,NASIK,2206,1995,NAGPUR-NASIK,4201,All
2024,1,NAGPUR,NASIK,1894,1583,NAGPUR-NASIK,3477,All
2024,2,NAGPUR,NASIK,1879,1551,NAGPUR-NASIK,3430,All
2024,3,NAGPUR,NASIK,1547,1303,NAGPUR-NASIK,2850,All
2024,4,NAGPUR,NASIK,1543,1505,NAGPUR-NASIK,3048,All
2024,6,NAGPUR,NASIK,1259,1309,NAGPUR-NASIK,2568,All
2024,7,NAGPUR,NASIK,760,822,NAGPUR-NASIK,1582,All
2024,8,NAGPUR,NASIK,691,766,NAGPUR-NASIK,1457,All
2024,9,NAGPUR,NASIK,644,715,NAGPUR-NASIK,1359,All
2024,10,NAGPUR,NASIK,516,517,NAGPUR-NASIK,1033,All
2024,11,NAGPUR,NASIK,619,553,NAGPUR-NASIK,1172,All
2024,12,NAGPUR,NASIK,632,745,NAGPUR-NASIK,1377,All
2025,1,NAGPUR,NASIK,747,780,NAGPUR-NASIK,1527,All
2025,2,NAGPUR,NASIK,671,728,NAGPUR-NASIK,1399,All
2025,3,NAGPUR,NASIK,541,653,NAGPUR-NASIK,1194,All
2024,8,NAGPUR,PATNA,119,0,NAGPUR-PATNA,119,All
2015,4,NAGPUR,PUNE,8556,8738,NAGPUR-PUNE,17294,All
2015,5,NAGPUR,PUNE,11403,10009,NAGPUR-PUNE,21412,All
2015,6,NAGPUR,PUNE,9778,9339,NAGPUR-PUNE,19117,All
2015,7,NAGPUR,PUNE,9034,8858,NAGPUR-PUNE,17892,All
2015,8,NAGPUR,PUNE,10528,10472,NAGPUR-PUNE,21000,All
2015,9,NAGPUR,PUNE,10622,10763,NAGPUR-PUNE,21385,All
2015,10,NAGPUR,PUNE,10938,11740,NAGPUR-PUNE,22678,All
2015,11,NAGPUR,PUNE,11352,12384,NAGPUR-PUNE,23736,All
2015,12,NAGPUR,PUNE,13049,13255,NAGPUR-PUNE,26304,All
2016,1,NAGPUR,PUNE,12715,11670,NAGPUR-PUNE,24385,All
2016,2,NAGPUR,PUNE,11453,11274,NAGPUR-PUNE,22727,All
2016,3,NAGPUR,PUNE,11415,11186,NAGPUR-PUNE,22601,All
2016,4,NAGPUR,PUNE,11107,10551,NAGPUR-PUNE,21658,All
2016,5,NAGPUR,PUNE,10720,10572,NAGPUR-PUNE,21292,All
2016,6,NAGPUR,PUNE,10558,10923,NAGPUR-PUNE,21481,All
2016,7,NAGPUR,PUNE,11941,11559,NAGPUR-PUNE,23500,All
2016,8,NAGPUR,PUNE,11973,12055,NAGPUR-PUNE,24028,All
2016,9,NAGPUR,PUNE,10908,10907,NAGPUR-PUNE,21815,All
2016,10,NAGPUR,PUNE,10713,11684,NAGPUR-PUNE,22397,All
2016,11,NAGPUR,PUNE,13168,12443,NAGPUR-PUNE,25611,All
2016,12,NAGPUR,PUNE,13898,14013,NAGPUR-PUNE,27911,All
2017,1,NAGPUR,PUNE,13690,13358,NAGPUR-PUNE,27048,All
2017,2,NAGPUR,PUNE,12368,11893,NAGPUR-PUNE,24261,All
2017,3,NAGPUR,PUNE,13165,11882,NAGPUR-PUNE,25047,All
2017,4,NAGPUR,PUNE,12672,12408,NAGPUR-PUNE,25080,All
2017,5,NAGPUR,PUNE,13442,13646,NAGPUR-PUNE,27088,All
2017,6,NAGPUR,PUNE,13183,13333,NAGPUR-PUNE,26516,All
2017,7,NAGPUR,PUNE,12695,11826,NAGPUR-PUNE,24521,All
2017,8,NAGPUR,PUNE,13532,13891,NAGPUR-PUNE,27423,All
2017,9,NAGPUR,PUNE,12250,12264,NAGPUR-PUNE,24514,All
2017,10,NAGPUR,PUNE,12732,13098,NAGPUR-PUNE,25830,All
2017,11,NAGPUR,PUNE,13989,13871,NAGPUR-PUNE,27860,All
2017,12,NAGPUR,PUNE,14265,14299,NAGPUR-PUNE,28564,All
2018,1,NAGPUR,PUNE,13207,13548,NAGPUR-PUNE,26755,All
2018,2,NAGPUR,PUNE,12634,12732,NAGPUR-PUNE,25366,All
2018,3,NAGPUR,PUNE,15820,15134,NAGPUR-PUNE,30954,All
2018,4,NAGPUR,PUNE,14660,14085,NAGPUR-PUNE,28745,All
2018,5,NAGPUR,PUNE,13841,13343,NAGPUR-PUNE,27184,All
2018,6,NAGPUR,PUNE,12925,12752,NAGPUR-PUNE,25677,All
2018,7,NAGPUR,PUNE,14370,13837,NAGPUR-PUNE,28207,All
2018,8,NAGPUR,PUNE,13683,13571,NAGPUR-PUNE,27254,All
2018,9,NAGPUR,PUNE,13659,13466,NAGPUR-PUNE,27125,All
2018,10,NAGPUR,PUNE,13401,13966,NAGPUR-PUNE,27367,All
2018,11,NAGPUR,PUNE,13141,13465,NAGPUR-PUNE,26606,All
2018,12,NAGPUR,PUNE,14490,14691,NAGPUR-PUNE,29181,All
2019,1,NAGPUR,PUNE,17741,17522,NAGPUR-PUNE,35263,All
2019,2,NAGPUR,PUNE,17323,17131,NAGPUR-PUNE,34454,All
2019,3,NAGPUR,PUNE,17986,17653,NAGPUR-PUNE,35639,All
2019,4,NAGPUR,PUNE,17249,17455,NAGPUR-PUNE,34704,All
2019,5,NAGPUR,PUNE,18237,17987,NAGPUR-PUNE,36224,All
2019,6,NAGPUR,PUNE,17379,17007,NAGPUR-PUNE,34386,All
2019,7,NAGPUR,PUNE,17843,16859,NAGPUR-PUNE,34702,All
2019,8,NAGPUR,PUNE,17144,17585,NAGPUR-PUNE,34729,All
2019,9,NAGPUR,PUNE,17251,17079,NAGPUR-PUNE,34330,All
2019,10,NAGPUR,PUNE,16177,17800,NAGPUR-PUNE,33977,All
2019,11,NAGPUR,PUNE,19289,18883,NAGPUR-PUNE,38172,All
2019,12,NAGPUR,PUNE,20218,20521,NAGPUR-PUNE,40739,All
2020,1,NAGPUR,PUNE,19807,19590,NAGPUR-PUNE,39397,All
2020,2,NAGPUR,PUNE,18298,18272,NAGPUR-PUNE,36570,All
2020,3,NAGPUR,PUNE,10276,13598,NAGPUR-PUNE,23874,All
2020,6,NAGPUR,PUNE,2887,3806,NAGPUR-PUNE,6693,All
2020,7,NAGPUR,PUNE,2645,4040,NAGPUR-PUNE,6685,All
2020,8,NAGPUR,PUNE,4992,4982,NAGPUR-PUNE,9974,All
2020,9,NAGPUR,PUNE,5597,4844,NAGPUR-PUNE,10441,All
2020,10,NAGPUR,PUNE,6046,5989,NAGPUR-PUNE,12035,All
2020,11,NAGPUR,PUNE,5804,5996,NAGPUR-PUNE,11800,All
2020,12,NAGPUR,PUNE,10112,10468,NAGPUR-PUNE,20580,All
2021,1,NAGPUR,PUNE,14363,12669,NAGPUR-PUNE,27032,All
2021,2,NAGPUR,PUNE,12180,11556,NAGPUR-PUNE,23736,All
2021,3,NAGPUR,PUNE,7832,7789,NAGPUR-PUNE,15621,All
2021,4,NAGPUR,PUNE,4433,5476,NAGPUR-PUNE,9909,All
2021,6,NAGPUR,PUNE,9047,7680,NAGPUR-PUNE,16727,All
2021,7,NAGPUR,PUNE,11360,9253,NAGPUR-PUNE,20613,All
2021,8,NAGPUR,PUNE,14630,13183,NAGPUR-PUNE,27813,All
2021,9,NAGPUR,PUNE,14957,13354,NAGPUR-PUNE,28311,All
2021,10,NAGPUR,PUNE,8198,9296,NAGPUR-PUNE,17494,All
2021,11,NAGPUR,PUNE,22598,19235,NAGPUR-PUNE,41833,All
2021,12,NAGPUR,PUNE,20916,19036,NAGPUR-PUNE,39952,All
2022,1,NAGPUR,PUNE,11841,11151,NAGPUR-PUNE,22992,All
2022,2,NAGPUR,PUNE,14936,13170,NAGPUR-PUNE,28106,All
2022,3,NAGPUR,PUNE,16924,15449,NAGPUR-PUNE,32373,All
2022,4,NAGPUR,PUNE,15964,14406,NAGPUR-PUNE,30370,All
2022,5,NAGPUR,PUNE,18392,15950,NAGPUR-PUNE,34342,All
2022,6,NAGPUR,PUNE,15035,12532,NAGPUR-PUNE,27567,All
2022,7,NAGPUR,PUNE,13643,11613,NAGPUR-PUNE,25256,All
2022,8,NAGPUR,PUNE,13752,13098,NAGPUR-PUNE,26850,All
2022,9,NAGPUR,PUNE,13574,11683,NAGPUR-PUNE,25257,All
2022,10,NAGPUR,PUNE,15893,17939,NAGPUR-PUNE,33832,All
2022,11,NAGPUR,PUNE,19250,16897,NAGPUR-PUNE,36147,All
2022,12,NAGPUR,PUNE,21533,21966,NAGPUR-PUNE,43499,All
2023,1,NAGPUR,PUNE,20910,19629,NAGPUR-PUNE,40539,All
2023,2,NAGPUR,PUNE,21372,21429,NAGPUR-PUNE,42801,All
2023,3,NAGPUR,PUNE,22680,22979,NAGPUR-PUNE,45659,All
2023,4,NAGPUR,PUNE,22956,24349,NAGPUR-PUNE,47305,All
2023,5,NAGPUR,PUNE,17821,17868,NAGPUR-PUNE,35689,All
2023,6,NAGPUR,PUNE,17536,18085,NAGPUR-PUNE,35621,All
2023,7,NAGPUR,PUNE,20138,19359,NAGPUR-PUNE,39497,All
2023,8,NAGPUR,PUNE,19701,20905,NAGPUR-PUNE,40606,All
2023,9,NAGPUR,PUNE,17481,18387,NAGPUR-PUNE,35868,All
2023,10,NAGPUR,PUNE,16010,17533,NAGPUR-PUNE,33543,All
2023,11,NAGPUR,PUNE,13259,13164,NAGPUR-PUNE,26423,All
2023,12,NAGPUR,PUNE,15448,14328,NAGPUR-PUNE,29776,All
2024,1,NAGPUR,PUNE,15342,14657,NAGPUR-PUNE,29999,All
2024,2,NAGPUR,PUNE,14212,13506,NAGPUR-PUNE,27718,All
2024,3,NAGPUR,PUNE,15634,14856,NAGPUR-PUNE,30490,All
2024,4,NAGPUR,PUNE,14228,13965,NAGPUR-PUNE,28193,All
2024,6,NAGPUR,PUNE,15383,15075,NAGPUR-PUNE,30458,All
2024,7,NAGPUR,PUNE,15455,15148,NAGPUR-PUNE,30603,All
2024,8,NAGPUR,PUNE,15034,14992,NAGPUR-PUNE,30026,All
2024,9,NAGPUR,PUNE,15601,15543,NAGPUR-PUNE,31144,All
2024,10,NAGPUR,PUNE,13105,15232,NAGPUR-PUNE,28337,All
2024,11,NAGPUR,PUNE,11483,11629,NAGPUR-PUNE,23112,All
2024,12,NAGPUR,PUNE,11679,12027,NAGPUR-PUNE,23706,All
2025,1,NAGPUR,PUNE,11664,12158,NAGPUR-PUNE,23822,All
2025,2,NAGPUR,PUNE,10585,11012,NAGPUR-PUNE,21597,All
2025,3,NAGPUR,PUNE,10686,11514,NAGPUR-PUNE,22200,All
2015,4,NAGPUR,RAIPUR,227,0,NAGPUR-RAIPUR,227,All
2015,5,NAGPUR,RAIPUR,184,0,NAGPUR-RAIPUR,184,All
2015,6,NAGPUR,RAIPUR,173,0,NAGPUR-RAIPUR,173,All
2015,7,NAGPUR,RAIPUR,237,0,NAGPUR-RAIPUR,237,All
2015,8,NAGPUR,RAIPUR,217,0,NAGPUR-RAIPUR,217,All
2015,9,NAGPUR,RAIPUR,379,0,NAGPUR-RAIPUR,379,All
2015,10,NAGPUR,RAIPUR,3101,0,NAGPUR-RAIPUR,3101,All
2015,11,NAGPUR,RAIPUR,291,0,NAGPUR-RAIPUR,291,All
2015,12,NAGPUR,RAIPUR,334,0,NAGPUR-RAIPUR,334,All
2016,1,NAGPUR,RAIPUR,333,0,NAGPUR-RAIPUR,333,All
2016,2,NAGPUR,RAIPUR,276,0,NAGPUR-RAIPUR,276,All
2016,3,NAGPUR,RAIPUR,207,0,NAGPUR-RAIPUR,207,All
2016,4,NAGPUR,RAIPUR,259,10,NAGPUR-RAIPUR,269,All
2016,5,NAGPUR,RAIPUR,0,90,NAGPUR-RAIPUR,90,All
2016,6,NAGPUR,RAIPUR,0,43,NAGPUR-RAIPUR,43,All
2016,7,NAGPUR,RAIPUR,33,5,NAGPUR-RAIPUR,38,All
2016,8,NAGPUR,RAIPUR,37,0,NAGPUR-RAIPUR,37,All
2016,9,NAGPUR,RAIPUR,39,0,NAGPUR-RAIPUR,39,All
2016,10,NAGPUR,RAIPUR,53,0,NAGPUR-RAIPUR,53,All
2017,2,NAGPUR,RAIPUR,145,0,NAGPUR-RAIPUR,145,All
2017,3,NAGPUR,RAIPUR,7,0,NAGPUR-RAIPUR,7,All
2017,6,NAGPUR,RAIPUR,0,35,NAGPUR-RAIPUR,35,All
2017,7,NAGPUR,RAIPUR,0,47,NAGPUR-RAIPUR,47,All
2017,8,NAGPUR,RAIPUR,0,53,NAGPUR-RAIPUR,53,All
2017,9,NAGPUR,RAIPUR,0,64,NAGPUR-RAIPUR,64,All
2017,10,NAGPUR,RAIPUR,0,42,NAGPUR-RAIPUR,42,All
2017,11,NAGPUR,RAIPUR,0,75,NAGPUR-RAIPUR,75,All
2017,12,NAGPUR,RAIPUR,0,49,NAGPUR-RAIPUR,49,All
2018,1,NAGPUR,RAIPUR,0,81,NAGPUR-RAIPUR,81,All
2018,2,NAGPUR,RAIPUR,0,72,NAGPUR-RAIPUR,72,All
2018,3,NAGPUR,RAIPUR,0,114,NAGPUR-RAIPUR,114,All
2018,4,NAGPUR,RAIPUR,0,135,NAGPUR-RAIPUR,135,All
2018,5,NAGPUR,RAIPUR,0,88,NAGPUR-RAIPUR,88,All
2018,6,NAGPUR,RAIPUR,0,60,NAGPUR-RAIPUR,60,All
2018,7,NAGPUR,RAIPUR,0,118,NAGPUR-RAIPUR,118,All
2018,8,NAGPUR,RAIPUR,0,98,NAGPUR-RAIPUR,98,All
2018,9,NAGPUR,RAIPUR,0,67,NAGPUR-RAIPUR,67,All
2018,10,NAGPUR,RAIPUR,0,79,NAGPUR-RAIPUR,79,All
2018,11,NAGPUR,RAIPUR,0,178,NAGPUR-RAIPUR,178,All
2018,12,NAGPUR,RAIPUR,0,101,NAGPUR-RAIPUR,101,All
2019,1,NAGPUR,RAIPUR,0,108,NAGPUR-RAIPUR,108,All
2019,2,NAGPUR,RAIPUR,0,80,NAGPUR-RAIPUR,80,All
2019,3,NAGPUR,RAIPUR,0,81,NAGPUR-RAIPUR,81,All
2019,4,NAGPUR,RAIPUR,0,78,NAGPUR-RAIPUR,78,All
2019,5,NAGPUR,RAIPUR,0,86,NAGPUR-RAIPUR,86,All
2019,6,NAGPUR,RAIPUR,2,63,NAGPUR-RAIPUR,65,All
2019,7,NAGPUR,RAIPUR,0,51,NAGPUR-RAIPUR,51,All
2019,8,NAGPUR,RAIPUR,0,60,NAGPUR-RAIPUR,60,All
2019,9,NAGPUR,RAIPUR,0,77,NAGPUR-RAIPUR,77,All
2019,10,NAGPUR,RAIPUR,3,55,NAGPUR-RAIPUR,58,All
2019,11,NAGPUR,RAIPUR,0,87,NAGPUR-RAIPUR,87,All
2019,12,NAGPUR,RAIPUR,52,110,NAGPUR-RAIPUR,162,All
2020,1,NAGPUR,RAIPUR,96,50,NAGPUR-RAIPUR,146,All
2020,2,NAGPUR,RAIPUR,139,115,NAGPUR-RAIPUR,254,All
2020,3,NAGPUR,RAIPUR,308,57,NAGPUR-RAIPUR,365,All
2021,3,NAGPUR,RAIPUR,2,0,NAGPUR-RAIPUR,2,All
2021,4,NAGPUR,RAIPUR,46,16,NAGPUR-RAIPUR,62,All
2021,6,NAGPUR,RAIPUR,85,56,NAGPUR-RAIPUR,141,All
2021,7,NAGPUR,RAIPUR,63,63,NAGPUR-RAIPUR,126,All
2021,8,NAGPUR,RAIPUR,90,63,NAGPUR-RAIPUR,153,All
2021,9,NAGPUR,RAIPUR,47,62,NAGPUR-RAIPUR,109,All
2021,10,NAGPUR,RAIPUR,71,46,NAGPUR-RAIPUR,117,All
2021,11,NAGPUR,RAIPUR,135,107,NAGPUR-RAIPUR,242,All
2021,12,NAGPUR,RAIPUR,140,73,NAGPUR-RAIPUR,213,All
2022,1,NAGPUR,RAIPUR,47,26,NAGPUR-RAIPUR,73,All
2022,2,NAGPUR,RAIPUR,105,100,NAGPUR-RAIPUR,205,All
2022,3,NAGPUR,RAIPUR,113,78,NAGPUR-RAIPUR,191,All
2022,5,NAGPUR,RAIPUR,168,0,NAGPUR-RAIPUR,168,All
2023,2,NAGPUR,RAIPUR,208,0,NAGPUR-RAIPUR,208,All
2023,5,NAGPUR,RAIPUR,59,0,NAGPUR-RAIPUR,59,All
2024,8,NAGPUR,RAIPUR,123,0,NAGPUR-RAIPUR,123,All
2024,12,NAGPUR,RAIPUR,0,1,NAGPUR-RAIPUR,1,All
2025,1,NAGPUR,RAIPUR,307,0,NAGPUR-RAIPUR,307,All
2018,8,NAGPUR,RAJAHMUNDRY,3,0,NAGPUR-RAJAHMUNDRY,3,All
2018,9,NAGPUR,RAJAHMUNDRY,2,0,NAGPUR-RAJAHMUNDRY,2,All
2019,10,NAGPUR,RANCHI,6,0,NAGPUR-RANCHI,6,All
2019,11,NAGPUR,RANCHI,27,0,NAGPUR-RANCHI,27,All
2019,12,NAGPUR,RANCHI,47,0,NAGPUR-RANCHI,47,All
2020,1,NAGPUR,RANCHI,8,0,NAGPUR-RANCHI,8,All
2020,2,NAGPUR,RANCHI,21,0,NAGPUR-RANCHI,21,All
2020,3,NAGPUR,RANCHI,17,0,NAGPUR-RANCHI,17,All
2023,8,NAGPUR,RANCHI,159,0,NAGPUR-RANCHI,159,All
2021,2,NAGPUR,SHIRDI,18,8,NAGPUR-SHIRDI,26,All
2015,4,NAGPUR,SRINAGAR,189,125,NAGPUR-SRINAGAR,314,All
2015,5,NAGPUR,SRINAGAR,227,250,NAGPUR-SRINAGAR,477,All
2015,6,NAGPUR,SRINAGAR,250,276,NAGPUR-SRINAGAR,526,All
2015,7,NAGPUR,SRINAGAR,200,169,NAGPUR-SRINAGAR,369,All
2015,8,NAGPUR,SRINAGAR,174,201,NAGPUR-SRINAGAR,375,All
2015,9,NAGPUR,SRINAGAR,105,206,NAGPUR-SRINAGAR,311,All
2015,10,NAGPUR,SRINAGAR,172,134,NAGPUR-SRINAGAR,306,All
2015,11,NAGPUR,SRINAGAR,248,184,NAGPUR-SRINAGAR,432,All
2015,12,NAGPUR,SRINAGAR,215,228,NAGPUR-SRINAGAR,443,All
2016,1,NAGPUR,SRINAGAR,252,260,NAGPUR-SRINAGAR,512,All
2016,2,NAGPUR,SRINAGAR,157,242,NAGPUR-SRINAGAR,399,All
2016,3,NAGPUR,SRINAGAR,154,186,NAGPUR-SRINAGAR,340,All
2016,4,NAGPUR,SRINAGAR,121,137,NAGPUR-SRINAGAR,258,All
2016,5,NAGPUR,SRINAGAR,54,36,NAGPUR-SRINAGAR,90,All
2016,6,NAGPUR,SRINAGAR,25,24,NAGPUR-SRINAGAR,49,All
2016,7,NAGPUR,SRINAGAR,2,6,NAGPUR-SRINAGAR,8,All
2016,8,NAGPUR,SRINAGAR,4,1,NAGPUR-SRINAGAR,5,All
2024,3,NAGPUR,TIRUPATI,12,0,NAGPUR-TIRUPATI,12,All
2024,4,NAGPUR,TIRUPATI,59,124,NAGPUR-TIRUPATI,183,All
2024,6,NAGPUR,TIRUPATI,142,102,NAGPUR-TIRUPATI,244,All
2024,7,NAGPUR,TIRUPATI,108,101,NAGPUR-TIRUPATI,209,All
2024,8,NAGPUR,TIRUPATI,74,98,NAGPUR-TIRUPATI,172,All
2024,9,NAGPUR,TIRUPATI,94,108,NAGPUR-TIRUPATI,202,All
2024,10,NAGPUR,TIRUPATI,92,107,NAGPUR-TIRUPATI,199,All
2023,3,NAGPUR,TRIVANDRUM,7,12,NAGPUR-TRIVANDRUM,19,All
2023,4,NAGPUR,TRIVANDRUM,44,30,NAGPUR-TRIVANDRUM,74,All
2023,5,NAGPUR,TRIVANDRUM,86,47,NAGPUR-TRIVANDRUM,133,All
2023,6,NAGPUR,TRIVANDRUM,74,78,NAGPUR-TRIVANDRUM,152,All
2023,7,NAGPUR,TRIVANDRUM,45,69,NAGPUR-TRIVANDRUM,114,All
2023,8,NAGPUR,TRIVANDRUM,86,101,NAGPUR-TRIVANDRUM,187,All
2023,9,NAGPUR,TRIVANDRUM,52,65,NAGPUR-TRIVANDRUM,117,All
2023,10,NAGPUR,TRIVANDRUM,68,111,NAGPUR-TRIVANDRUM,179,All
2019,11,NAGPUR,VADODARA,0,5,NAGPUR-VADODARA,5,All
2021,3,NAGPUR,VARANASI,59,92,NAGPUR-VARANASI,151,All
2022,4,NAGPUR,VARANASI,0,28,NAGPUR-VARANASI,28,All
2019,7,NAGPUR,VISAKHAPATNAM,0,0,NAGPUR-VISAKHAPATNAM,0,All
2020,5,NAGPUR,VISAKHAPATNAM,5,0,NAGPUR-VISAKHAPATNAM,5,All
2024,3,NANDED,HINDON AIRPORT,73,74,HINDON AIRPORT-NANDED,147,All
2024,4,NANDED,HINDON AIRPORT,2171,2174,HINDON AIRPORT-NANDED,4345,All
2024,6,NANDED,HINDON AIRPORT,1912,2111,HINDON AIRPORT-NANDED,4023,All
2024,7,NANDED,HINDON AIRPORT,1743,1968,HINDON AIRPORT-NANDED,3711,All
2024,8,NANDED,HINDON AIRPORT,1728,1739,HINDON AIRPORT-NANDED,3467,All
2024,9,NANDED,HINDON AIRPORT,1164,1137,HINDON AIRPORT-NANDED,2301,All
2024,10,NANDED,HINDON AIRPORT,2023,2080,HINDON AIRPORT-NANDED,4103,All
2024,11,NANDED,HINDON AIRPORT,2040,2104,HINDON AIRPORT-NANDED,4144,All
2024,12,NANDED,HINDON AIRPORT,2008,2163,HINDON AIRPORT-NANDED,4171,All
2025,1,NANDED,HINDON AIRPORT,1879,1927,HINDON AIRPORT-NANDED,3806,All
2025,2,NANDED,HINDON AIRPORT,2009,2018,HINDON AIRPORT-NANDED,4027,All
2025,3,NANDED,HINDON AIRPORT,2179,2222,HINDON AIRPORT-NANDED,4401,All
2024,6,NANDED,PUNE,134,136,NANDED-PUNE,270,All
2024,7,NANDED,PUNE,978,1027,NANDED-PUNE,2005,All
2024,8,NANDED,PUNE,1070,1146,NANDED-PUNE,2216,All
2024,9,NANDED,PUNE,194,275,NANDED-PUNE,469,All
2024,10,NANDED,PUNE,779,935,NANDED-PUNE,1714,All
2024,11,NANDED,PUNE,1441,1247,NANDED-PUNE,2688,All
2024,12,NANDED,PUNE,1451,1421,NANDED-PUNE,2872,All
2025,1,NANDED,PUNE,1294,1259,NANDED-PUNE,2553,All
2025,2,NANDED,PUNE,1403,1345,NANDED-PUNE,2748,All
2025,3,NANDED,PUNE,1527,1483,NANDED-PUNE,3010,All
2017,12,NASIK,PUNE,61,46,NASIK-PUNE,107,All
2018,1,NASIK,PUNE,267,233,NASIK-PUNE,500,All
2018,2,NASIK,PUNE,234,219,NASIK-PUNE,453,All
2018,3,NASIK,PUNE,75,82,NASIK-PUNE,157,All
2018,8,NASIK,PUNE,94,123,NASIK-PUNE,217,All
2018,9,NASIK,PUNE,50,69,NASIK-PUNE,119,All
2018,10,NASIK,PUNE,3,5,NASIK-PUNE,8,All
2019,10,NASIK,PUNE,218,162,NASIK-PUNE,380,All
2019,11,NASIK,PUNE,1120,938,NASIK-PUNE,2058,All
2019,12,NASIK,PUNE,1416,1394,NASIK-PUNE,2810,All
2020,1,NASIK,PUNE,1231,1163,NASIK-PUNE,2394,All
2020,2,NASIK,PUNE,1295,1177,NASIK-PUNE,2472,All
2020,3,NASIK,PUNE,694,628,NASIK-PUNE,1322,All
2020,6,NASIK,PUNE,480,145,NASIK-PUNE,625,All
2020,7,NASIK,PUNE,516,270,NASIK-PUNE,786,All
2020,8,NASIK,PUNE,305,354,NASIK-PUNE,659,All
2020,9,NASIK,PUNE,207,234,NASIK-PUNE,441,All
2020,10,NASIK,PUNE,259,253,NASIK-PUNE,512,All
2020,11,NASIK,PUNE,353,387,NASIK-PUNE,740,All
2020,12,NASIK,PUNE,445,451,NASIK-PUNE,896,All
2021,1,NASIK,PUNE,595,649,NASIK-PUNE,1244,All
2021,2,NASIK,PUNE,516,650,NASIK-PUNE,1166,All
2021,3,NASIK,PUNE,534,574,NASIK-PUNE,1108,All
2021,4,NASIK,PUNE,95,86,NASIK-PUNE,181,All
2021,7,NASIK,PUNE,343,321,NASIK-PUNE,664,All
2021,8,NASIK,PUNE,755,648,NASIK-PUNE,1403,All
2021,9,NASIK,PUNE,836,759,NASIK-PUNE,1595,All
2021,10,NASIK,PUNE,464,489,NASIK-PUNE,953,All
2021,11,NASIK,PUNE,1026,976,NASIK-PUNE,2002,All
2021,12,NASIK,PUNE,850,835,NASIK-PUNE,1685,All
2022,1,NASIK,PUNE,374,423,NASIK-PUNE,797,All
2022,2,NASIK,PUNE,567,538,NASIK-PUNE,1105,All
2022,3,NASIK,PUNE,734,725,NASIK-PUNE,1459,All
2022,4,NASIK,PUNE,1026,976,NASIK-PUNE,2002,All
2022,5,NASIK,PUNE,850,835,NASIK-PUNE,1685,All
2022,6,NASIK,PUNE,1026,976,NASIK-PUNE,2002,All
2022,7,NASIK,PUNE,567,538,NASIK-PUNE,1105,All
2022,8,NASIK,PUNE,850,835,NASIK-PUNE,1685,All
2022,9,NASIK,PUNE,1026,976,NASIK-PUNE,2002,All
2022,10,NASIK,PUNE,816,959,NASIK-PUNE,1775,All
2022,10,NASIK,TIRUPATI,204,208,NASIK-TIRUPATI,412,All
2024,2,PANTNAGAR,PITHORAGARH,12,15,PANTNAGAR-PITHORAGARH,27,All
2024,3,PANTNAGAR,PITHORAGARH,63,73,PANTNAGAR-PITHORAGARH,136,All
2024,4,PANTNAGAR,PITHORAGARH,131,105,PANTNAGAR-PITHORAGARH,236,All
2024,6,PANTNAGAR,PITHORAGARH,159,139,PANTNAGAR-PITHORAGARH,298,All
2024,7,PANTNAGAR,PITHORAGARH,30,46,PANTNAGAR-PITHORAGARH,76,All
2024,8,PANTNAGAR,PITHORAGARH,118,139,PANTNAGAR-PITHORAGARH,257,All
2024,9,PANTNAGAR,PITHORAGARH,112,98,PANTNAGAR-PITHORAGARH,210,All
2024,10,PANTNAGAR,PITHORAGARH,169,154,PANTNAGAR-PITHORAGARH,323,All
2024,11,PANTNAGAR,PITHORAGARH,154,177,PANTNAGAR-PITHORAGARH,331,All
2024,12,PANTNAGAR,PITHORAGARH,82,96,PANTNAGAR-PITHORAGARH,178,All
2025,1,PANTNAGAR,PITHORAGARH,45,50,PANTNAGAR-PITHORAGARH,95,All
2025,2,PANTNAGAR,PITHORAGARH,25,25,PANTNAGAR-PITHORAGARH,50,All
2025,3,PANTNAGAR,PITHORAGARH,93,79,PANTNAGAR-PITHORAGARH,172,All
2024,3,PANTNAGAR,VARANASI,50,47,PANTNAGAR-VARANASI,97,All
2024,4,PANTNAGAR,VARANASI,462,248,PANTNAGAR-VARANASI,710,All
2024,6,PANTNAGAR,VARANASI,450,474,PANTNAGAR-VARANASI,924,All
2024,7,PANTNAGAR,VARANASI,264,281,PANTNAGAR-VARANASI,545,All
2024,8,PANTNAGAR,VARANASI,268,283,PANTNAGAR-VARANASI,551,All
2024,9,PANTNAGAR,VARANASI,168,179,PANTNAGAR-VARANASI,347,All
2023,12,PASIGHAT,SHILLONG,3,0,PASIGHAT-SHILLONG,3,All
2024,11,PASIGHAT,SHILLONG,37,36,PASIGHAT-SHILLONG,73,All
2024,12,PASIGHAT,SHILLONG,54,52,PASIGHAT-SHILLONG,106,All
2025,1,PASIGHAT,SHILLONG,25,14,PASIGHAT-SHILLONG,39,All
2019,12,PASIGHAT,TEZPUR,0,2,PASIGHAT-TEZPUR,2,All
2020,6,PASIGHAT,TEZPUR,3,0,PASIGHAT-TEZPUR,3,All
2020,10,PASIGHAT,TEZPUR,6,0,PASIGHAT-TEZPUR,6,All
2020,11,PASIGHAT,TEZPUR,6,0,PASIGHAT-TEZPUR,6,All
2020,12,PASIGHAT,TEZPUR,2,0,PASIGHAT-TEZPUR,2,All
2021,1,PASIGHAT,TEZPUR,5,0,PASIGHAT-TEZPUR,5,All
2021,2,PASIGHAT,TEZPUR,8,0,PASIGHAT-TEZPUR,8,All
2021,3,PASIGHAT,TEZPUR,14,0,PASIGHAT-TEZPUR,14,All
2021,4,PASIGHAT,TEZPUR,4,0,PASIGHAT-TEZPUR,4,All
2021,6,PASIGHAT,TEZPUR,2,0,PASIGHAT-TEZPUR,2,All
2021,7,PASIGHAT,TEZPUR,4,0,PASIGHAT-TEZPUR,4,All
2021,8,PASIGHAT,TEZPUR,3,0,PASIGHAT-TEZPUR,3,All
2021,9,PASIGHAT,TEZPUR,13,0,PASIGHAT-TEZPUR,13,All
2021,10,PASIGHAT,TEZPUR,28,2,PASIGHAT-TEZPUR,30,All
2021,11,PASIGHAT,TEZPUR,27,5,PASIGHAT-TEZPUR,32,All
2021,12,PASIGHAT,TEZPUR,12,3,PASIGHAT-TEZPUR,15,All
2022,1,PASIGHAT,TEZPUR,3,5,PASIGHAT-TEZPUR,8,All
2022,2,PASIGHAT,TEZPUR,20,1,PASIGHAT-TEZPUR,21,All
2022,3,PASIGHAT,TEZPUR,6,2,PASIGHAT-TEZPUR,8,All
2022,4,PASIGHAT,TEZPUR,27,5,PASIGHAT-TEZPUR,32,All
2022,5,PASIGHAT,TEZPUR,12,3,PASIGHAT-TEZPUR,15,All
2022,6,PASIGHAT,TEZPUR,27,5,PASIGHAT-TEZPUR,32,All
2022,7,PASIGHAT,TEZPUR,20,1,PASIGHAT-TEZPUR,21,All
2022,8,PASIGHAT,TEZPUR,12,3,PASIGHAT-TEZPUR,15,All
2022,9,PASIGHAT,TEZPUR,27,5,PASIGHAT-TEZPUR,32,All
2022,10,PASIGHAT,TEZPUR,10,10,PASIGHAT-TEZPUR,20,All
2022,11,PASIGHAT,TEZPUR,30,12,PASIGHAT-TEZPUR,42,All
2022,12,PASIGHAT,TEZPUR,22,16,PASIGHAT-TEZPUR,38,All
2023,1,PASIGHAT,TEZPUR,35,161,PASIGHAT-TEZPUR,196,All
2023,2,PASIGHAT,TEZPUR,5,1,PASIGHAT-TEZPUR,6,All
2023,3,PASIGHAT,TEZPUR,11,7,PASIGHAT-TEZPUR,18,All
2023,4,PASIGHAT,TEZPUR,177,163,PASIGHAT-TEZPUR,340,All
2023,5,PASIGHAT,TEZPUR,99,103,PASIGHAT-TEZPUR,202,All
2023,6,PASIGHAT,TEZPUR,78,40,PASIGHAT-TEZPUR,118,All
2023,7,PASIGHAT,TEZPUR,50,39,PASIGHAT-TEZPUR,89,All
2023,8,PASIGHAT,TEZPUR,37,20,PASIGHAT-TEZPUR,57,All
2023,9,PASIGHAT,TEZPUR,89,75,PASIGHAT-TEZPUR,164,All
2024,2,PATNA,Ayodhya International Airport ,892,769,Ayodhya International Airport -PATNA,1661,All
2018,3,PATNA,PUNE,394,643,PATNA-PUNE,1037,All
2018,4,PATNA,PUNE,1976,3773,PATNA-PUNE,5749,All
2018,5,PATNA,PUNE,2302,2591,PATNA-PUNE,4893,All
2018,6,PATNA,PUNE,2148,3232,PATNA-PUNE,5380,All
2018,7,PATNA,PUNE,4663,3395,PATNA-PUNE,8058,All
2018,8,PATNA,PUNE,4113,4363,PATNA-PUNE,8476,All
2018,9,PATNA,PUNE,3834,3913,PATNA-PUNE,7747,All
2018,10,PATNA,PUNE,4064,4732,PATNA-PUNE,8796,All
2018,11,PATNA,PUNE,4281,4762,PATNA-PUNE,9043,All
2018,12,PATNA,PUNE,2858,2914,PATNA-PUNE,5772,All
2019,6,PATNA,PUNE,0,603,PATNA-PUNE,603,All
2019,7,PATNA,PUNE,0,250,PATNA-PUNE,250,All
2019,8,PATNA,PUNE,0,596,PATNA-PUNE,596,All
2019,9,PATNA,PUNE,0,382,PATNA-PUNE,382,All
2019,10,PATNA,PUNE,0,531,PATNA-PUNE,531,All
2019,11,PATNA,PUNE,0,510,PATNA-PUNE,510,All
2019,12,PATNA,PUNE,0,781,PATNA-PUNE,781,All
2020,1,PATNA,PUNE,0,631,PATNA-PUNE,631,All
2020,2,PATNA,PUNE,0,421,PATNA-PUNE,421,All
2020,3,PATNA,PUNE,0,636,PATNA-PUNE,636,All
2020,11,PATNA,PUNE,830,874,PATNA-PUNE,1704,All
2020,12,PATNA,PUNE,3238,2494,PATNA-PUNE,5732,All
2021,1,PATNA,PUNE,4803,3732,PATNA-PUNE,8535,All
2021,2,PATNA,PUNE,4119,4040,PATNA-PUNE,8159,All
2021,3,PATNA,PUNE,3384,4841,PATNA-PUNE,8225,All
2021,4,PATNA,PUNE,2445,6472,PATNA-PUNE,8917,All
2021,6,PATNA,PUNE,3608,2213,PATNA-PUNE,5821,All
2021,7,PATNA,PUNE,4019,3255,PATNA-PUNE,7274,All
2021,8,PATNA,PUNE,4415,3771,PATNA-PUNE,8186,All
2021,9,PATNA,PUNE,3547,3124,PATNA-PUNE,6671,All
2021,10,PATNA,PUNE,2483,3081,PATNA-PUNE,5564,All
2021,11,PATNA,PUNE,6864,7904,PATNA-PUNE,14768,All
2021,12,PATNA,PUNE,5194,4529,PATNA-PUNE,9723,All
2022,1,PATNA,PUNE,2182,2601,PATNA-PUNE,4783,All
2022,2,PATNA,PUNE,3178,3098,PATNA-PUNE,6276,All
2022,3,PATNA,PUNE,4142,3987,PATNA-PUNE,8129,All
2022,4,PATNA,PUNE,6671,6891,PATNA-PUNE,13562,All
2022,5,PATNA,PUNE,8970,8631,PATNA-PUNE,17601,All
2022,6,PATNA,PUNE,8214,6185,PATNA-PUNE,14399,All
2022,7,PATNA,PUNE,4832,4159,PATNA-PUNE,8991,All
2022,8,PATNA,PUNE,5270,4345,PATNA-PUNE,9615,All
2022,9,PATNA,PUNE,4692,4213,PATNA-PUNE,8905,All
2022,10,PATNA,PUNE,5545,5036,PATNA-PUNE,10581,All
2022,11,PATNA,PUNE,9195,7506,PATNA-PUNE,16701,All
2022,12,PATNA,PUNE,9172,7841,PATNA-PUNE,17013,All
2023,1,PATNA,PUNE,7553,7087,PATNA-PUNE,14640,All
2023,2,PATNA,PUNE,7046,7230,PATNA-PUNE,14276,All
2023,3,PATNA,PUNE,7372,7666,PATNA-PUNE,15038,All
2023,4,PATNA,PUNE,4640,4970,PATNA-PUNE,9610,All
2023,5,PATNA,PUNE,5254,5434,PATNA-PUNE,10688,All
2023,6,PATNA,PUNE,5209,5073,PATNA-PUNE,10282,All
2023,7,PATNA,PUNE,5151,4934,PATNA-PUNE,10085,All
2023,8,PATNA,PUNE,4984,5313,PATNA-PUNE,10297,All
2023,9,PATNA,PUNE,4457,4748,PATNA-PUNE,9205,All
2023,10,PATNA,PUNE,4171,5196,PATNA-PUNE,9367,All
2023,11,PATNA,PUNE,4180,5101,PATNA-PUNE,9281,All
2023,12,PATNA,PUNE,5678,5199,PATNA-PUNE,10877,All
2024,1,PATNA,PUNE,5404,5133,PATNA-PUNE,10537,All
2024,2,PATNA,PUNE,4996,5131,PATNA-PUNE,10127,All
2024,3,PATNA,PUNE,5077,5070,PATNA-PUNE,10147,All
2024,4,PATNA,PUNE,4980,5399,PATNA-PUNE,10379,All
2024,6,PATNA,PUNE,5339,5211,PATNA-PUNE,10550,All
2024,7,PATNA,PUNE,5491,4927,PATNA-PUNE,10418,All
2024,8,PATNA,PUNE,5217,5276,PATNA-PUNE,10493,All
2024,9,PATNA,PUNE,4686,5212,PATNA-PUNE,9898,All
2024,10,PATNA,PUNE,4043,5488,PATNA-PUNE,9531,All
2024,11,PATNA,PUNE,5260,5349,PATNA-PUNE,10609,All
2024,12,PATNA,PUNE,5320,5374,PATNA-PUNE,10694,All
2025,1,PATNA,PUNE,5281,5252,PATNA-PUNE,10533,All
2025,2,PATNA,PUNE,4497,4930,PATNA-PUNE,9427,All
2025,3,PATNA,PUNE,4813,5192,PATNA-PUNE,10005,All
2016,11,PATNA,RAIPUR,168,229,PATNA-RAIPUR,397,All
2016,12,PATNA,RAIPUR,632,620,PATNA-RAIPUR,1252,All
2017,1,PATNA,RAIPUR,666,704,PATNA-RAIPUR,1370,All
2017,2,PATNA,RAIPUR,605,622,PATNA-RAIPUR,1227,All
2017,3,PATNA,RAIPUR,321,546,PATNA-RAIPUR,867,All
2017,4,PATNA,RAIPUR,0,612,PATNA-RAIPUR,612,All
2017,5,PATNA,RAIPUR,0,561,PATNA-RAIPUR,561,All
2017,6,PATNA,RAIPUR,0,402,PATNA-RAIPUR,402,All
2017,7,PATNA,RAIPUR,446,506,PATNA-RAIPUR,952,All
2017,8,PATNA,RAIPUR,384,461,PATNA-RAIPUR,845,All
2017,9,PATNA,RAIPUR,364,401,PATNA-RAIPUR,765,All
2017,10,PATNA,RAIPUR,438,539,PATNA-RAIPUR,977,All
2017,11,PATNA,RAIPUR,592,492,PATNA-RAIPUR,1084,All
2017,12,PATNA,RAIPUR,429,420,PATNA-RAIPUR,849,All
2018,1,PATNA,RAIPUR,403,391,PATNA-RAIPUR,794,All
2018,2,PATNA,RAIPUR,463,445,PATNA-RAIPUR,908,All
2018,3,PATNA,RAIPUR,391,455,PATNA-RAIPUR,846,All
2018,4,PATNA,RAIPUR,494,554,PATNA-RAIPUR,1048,All
2018,5,PATNA,RAIPUR,446,521,PATNA-RAIPUR,967,All
2018,6,PATNA,RAIPUR,551,650,PATNA-RAIPUR,1201,All
2018,7,PATNA,RAIPUR,461,460,PATNA-RAIPUR,921,All
2018,8,PATNA,RAIPUR,595,492,PATNA-RAIPUR,1087,All
2018,9,PATNA,RAIPUR,467,401,PATNA-RAIPUR,868,All
2018,10,PATNA,RAIPUR,540,502,PATNA-RAIPUR,1042,All
2018,11,PATNA,RAIPUR,709,675,PATNA-RAIPUR,1384,All
2018,12,PATNA,RAIPUR,671,515,PATNA-RAIPUR,1186,All
2019,1,PATNA,RAIPUR,773,646,PATNA-RAIPUR,1419,All
2019,2,PATNA,RAIPUR,708,615,PATNA-RAIPUR,1323,All
2019,3,PATNA,RAIPUR,616,557,PATNA-RAIPUR,1173,All
2019,4,PATNA,RAIPUR,617,451,PATNA-RAIPUR,1068,All
2019,5,PATNA,RAIPUR,706,446,PATNA-RAIPUR,1152,All
2019,6,PATNA,RAIPUR,628,349,PATNA-RAIPUR,977,All
2019,7,PATNA,RAIPUR,674,346,PATNA-RAIPUR,1020,All
2019,8,PATNA,RAIPUR,757,515,PATNA-RAIPUR,1272,All
2019,9,PATNA,RAIPUR,538,445,PATNA-RAIPUR,983,All
2019,10,PATNA,RAIPUR,626,422,PATNA-RAIPUR,1048,All
2019,11,PATNA,RAIPUR,517,532,PATNA-RAIPUR,1049,All
2019,12,PATNA,RAIPUR,523,723,PATNA-RAIPUR,1246,All
2020,1,PATNA,RAIPUR,583,769,PATNA-RAIPUR,1352,All
2020,2,PATNA,RAIPUR,555,634,PATNA-RAIPUR,1189,All
2020,3,PATNA,RAIPUR,488,470,PATNA-RAIPUR,958,All
2020,8,PATNA,RAIPUR,0,37,PATNA-RAIPUR,37,All
2020,9,PATNA,RAIPUR,0,490,PATNA-RAIPUR,490,All
2020,10,PATNA,RAIPUR,0,475,PATNA-RAIPUR,475,All
2019,5,PATNA,RANCHI,4419,3887,PATNA-RANCHI,8306,All
2019,6,PATNA,RANCHI,5197,3728,PATNA-RANCHI,8925,All
2019,7,PATNA,RANCHI,4248,3505,PATNA-RANCHI,7753,All
2019,8,PATNA,RANCHI,4044,3471,PATNA-RANCHI,7515,All
2019,9,PATNA,RANCHI,3972,3407,PATNA-RANCHI,7379,All
2019,10,PATNA,RANCHI,4255,3393,PATNA-RANCHI,7648,All
2019,11,PATNA,RANCHI,4046,4041,PATNA-RANCHI,8087,All
2019,12,PATNA,RANCHI,3855,3645,PATNA-RANCHI,7500,All
2020,1,PATNA,RANCHI,3858,3972,PATNA-RANCHI,7830,All
2020,2,PATNA,RANCHI,4018,4174,PATNA-RANCHI,8192,All
2020,3,PATNA,RANCHI,2858,2472,PATNA-RANCHI,5330,All
2020,7,PATNA,RANCHI,35,0,PATNA-RANCHI,35,All
2021,2,PATNA,RANCHI,226,88,PATNA-RANCHI,314,All
2021,3,PATNA,RANCHI,256,775,PATNA-RANCHI,1031,All
2021,4,PATNA,RANCHI,166,564,PATNA-RANCHI,730,All
2021,6,PATNA,RANCHI,1688,1652,PATNA-RANCHI,3340,All
2021,7,PATNA,RANCHI,3455,3774,PATNA-RANCHI,7229,All
2021,8,PATNA,RANCHI,2775,3150,PATNA-RANCHI,5925,All
2021,9,PATNA,RANCHI,3249,3264,PATNA-RANCHI,6513,All
2021,10,PATNA,RANCHI,2988,2638,PATNA-RANCHI,5626,All
2021,11,PATNA,RANCHI,3936,4460,PATNA-RANCHI,8396,All
2021,12,PATNA,RANCHI,4549,4154,PATNA-RANCHI,8703,All
2022,1,PATNA,RANCHI,2428,1477,PATNA-RANCHI,3905,All
2022,2,PATNA,RANCHI,2122,2264,PATNA-RANCHI,4386,All
2022,3,PATNA,RANCHI,2757,3119,PATNA-RANCHI,5876,All
2022,4,PATNA,RANCHI,3320,3389,PATNA-RANCHI,6709,All
2022,5,PATNA,RANCHI,3493,3776,PATNA-RANCHI,7269,All
2022,6,PATNA,RANCHI,3887,4032,PATNA-RANCHI,7919,All
2022,7,PATNA,RANCHI,4226,3694,PATNA-RANCHI,7920,All
2022,8,PATNA,RANCHI,4016,3402,PATNA-RANCHI,7418,All
2022,9,PATNA,RANCHI,3687,3394,PATNA-RANCHI,7081,All
2022,10,PATNA,RANCHI,3382,3993,PATNA-RANCHI,7375,All
2022,11,PATNA,RANCHI,4165,3880,PATNA-RANCHI,8045,All
2022,12,PATNA,RANCHI,3345,3503,PATNA-RANCHI,6848,All
2023,1,PATNA,RANCHI,2956,3268,PATNA-RANCHI,6224,All
2023,2,PATNA,RANCHI,3388,3277,PATNA-RANCHI,6665,All
2023,3,PATNA,RANCHI,3299,2965,PATNA-RANCHI,6264,All
2023,4,PATNA,RANCHI,3387,3677,PATNA-RANCHI,7064,All
2023,5,PATNA,RANCHI,3713,3590,PATNA-RANCHI,7303,All
2023,6,PATNA,RANCHI,4383,3627,PATNA-RANCHI,8010,All
2023,7,PATNA,RANCHI,4137,2917,PATNA-RANCHI,7054,All
2023,8,PATNA,RANCHI,3662,2984,PATNA-RANCHI,6646,All
2023,9,PATNA,RANCHI,4205,3577,PATNA-RANCHI,7782,All
2023,10,PATNA,RANCHI,4159,3223,PATNA-RANCHI,7382,All
2023,11,PATNA,RANCHI,3195,3548,PATNA-RANCHI,6743,All
2023,12,PATNA,RANCHI,3580,3323,PATNA-RANCHI,6903,All
2024,1,PATNA,RANCHI,1886,1895,PATNA-RANCHI,3781,All
2024,2,PATNA,RANCHI,3492,3361,PATNA-RANCHI,6853,All
2024,3,PATNA,RANCHI,3840,3603,PATNA-RANCHI,7443,All
2024,4,PATNA,RANCHI,3295,3862,PATNA-RANCHI,7157,All
2024,6,PATNA,RANCHI,3490,2990,PATNA-RANCHI,6480,All
2024,7,PATNA,RANCHI,3344,2860,PATNA-RANCHI,6204,All
2024,8,PATNA,RANCHI,2612,2486,PATNA-RANCHI,5098,All
2024,9,PATNA,RANCHI,2437,2258,PATNA-RANCHI,4695,All
2024,10,PATNA,RANCHI,2980,2947,PATNA-RANCHI,5927,All
2024,11,PATNA,RANCHI,3123,3482,PATNA-RANCHI,6605,All
2024,12,PATNA,RANCHI,2954,2725,PATNA-RANCHI,5679,All
2025,1,PATNA,RANCHI,2315,2623,PATNA-RANCHI,4938,All
2025,2,PATNA,RANCHI,2923,3103,PATNA-RANCHI,6026,All
2025,3,PATNA,RANCHI,3037,2788,PATNA-RANCHI,5825,All
2018,3,PATNA,SRINAGAR,0,13,PATNA-SRINAGAR,13,All
2018,4,PATNA,SRINAGAR,0,57,PATNA-SRINAGAR,57,All
2018,5,PATNA,SRINAGAR,0,33,PATNA-SRINAGAR,33,All
2018,6,PATNA,SRINAGAR,0,26,PATNA-SRINAGAR,26,All
2018,7,PATNA,SRINAGAR,0,1,PATNA-SRINAGAR,1,All
2018,9,PATNA,SRINAGAR,0,1,PATNA-SRINAGAR,1,All
2018,10,PATNA,SRINAGAR,0,4,PATNA-SRINAGAR,4,All
2021,1,PATNA,SRINAGAR,0,10,PATNA-SRINAGAR,10,All
2021,2,PATNA,SRINAGAR,0,7,PATNA-SRINAGAR,7,All
2021,4,PATNA,SRINAGAR,0,14,PATNA-SRINAGAR,14,All
2021,11,PATNA,SRINAGAR,0,395,PATNA-SRINAGAR,395,All
2021,12,PATNA,SRINAGAR,0,158,PATNA-SRINAGAR,158,All
2022,10,PATNA,SRINAGAR,0,10,PATNA-SRINAGAR,10,All
2022,11,PATNA,SRINAGAR,0,44,PATNA-SRINAGAR,44,All
2022,12,PATNA,SRINAGAR,0,29,PATNA-SRINAGAR,29,All
2017,7,PATNA,SURAT,201,235,PATNA-SURAT,436,All
2017,8,PATNA,SURAT,201,324,PATNA-SURAT,525,All
2017,9,PATNA,SURAT,137,203,PATNA-SURAT,340,All
2017,10,PATNA,SURAT,176,323,PATNA-SURAT,499,All
2017,11,PATNA,SURAT,325,276,PATNA-SURAT,601,All
2018,2,PATNA,SURAT,200,278,PATNA-SURAT,478,All
2018,3,PATNA,SURAT,363,543,PATNA-SURAT,906,All
2018,4,PATNA,SURAT,365,615,PATNA-SURAT,980,All
2018,5,PATNA,SURAT,398,516,PATNA-SURAT,914,All
2018,6,PATNA,SURAT,533,660,PATNA-SURAT,1193,All
2019,3,PATNA,SURAT,17,35,PATNA-SURAT,52,All
2019,4,PATNA,SURAT,275,714,PATNA-SURAT,989,All
2019,5,PATNA,SURAT,370,723,PATNA-SURAT,1093,All
2019,6,PATNA,SURAT,488,688,PATNA-SURAT,1176,All
2019,7,PATNA,SURAT,425,459,PATNA-SURAT,884,All
2019,8,PATNA,SURAT,177,207,PATNA-SURAT,384,All
2019,9,PATNA,SURAT,60,16,PATNA-SURAT,76,All
2019,10,PATNA,SURAT,313,607,PATNA-SURAT,920,All
2019,11,PATNA,SURAT,567,757,PATNA-SURAT,1324,All
2019,12,PATNA,SURAT,818,729,PATNA-SURAT,1547,All
2020,1,PATNA,SURAT,515,623,PATNA-SURAT,1138,All
2020,2,PATNA,SURAT,576,686,PATNA-SURAT,1262,All
2020,3,PATNA,SURAT,438,625,PATNA-SURAT,1063,All
2021,1,PATNA,SURAT,0,952,PATNA-SURAT,952,All
2021,2,PATNA,SURAT,339,1798,PATNA-SURAT,2137,All
2021,3,PATNA,SURAT,1271,2928,PATNA-SURAT,4199,All
2021,7,PATNA,SURAT,1118,949,PATNA-SURAT,2067,All
2021,8,PATNA,SURAT,2054,2016,PATNA-SURAT,4070,All
2021,9,PATNA,SURAT,964,931,PATNA-SURAT,1895,All
2021,10,PATNA,SURAT,899,991,PATNA-SURAT,1890,All
2018,11,PATNA,TRIVANDRUM,1,0,PATNA-TRIVANDRUM,1,All
2021,10,PATNA,TRIVANDRUM,8,0,PATNA-TRIVANDRUM,8,All
2021,11,PATNA,TRIVANDRUM,14,0,PATNA-TRIVANDRUM,14,All
2022,10,PATNA,TRIVANDRUM,3,0,PATNA-TRIVANDRUM,3,All
2022,11,PATNA,TRIVANDRUM,76,0,PATNA-TRIVANDRUM,76,All
2023,3,PATNA,TRIVANDRUM,25,0,PATNA-TRIVANDRUM,25,All
2023,4,PATNA,TRIVANDRUM,90,0,PATNA-TRIVANDRUM,90,All
2023,5,PATNA,TRIVANDRUM,95,0,PATNA-TRIVANDRUM,95,All
2019,5,PATNA,UDAIPUR,0,8,PATNA-UDAIPUR,8,All
2019,6,PATNA,UDAIPUR,0,65,PATNA-UDAIPUR,65,All
2019,7,PATNA,UDAIPUR,0,55,PATNA-UDAIPUR,55,All
2019,8,PATNA,UDAIPUR,0,93,PATNA-UDAIPUR,93,All
2019,9,PATNA,UDAIPUR,0,97,PATNA-UDAIPUR,97,All
2019,10,PATNA,UDAIPUR,0,125,PATNA-UDAIPUR,125,All
2019,11,PATNA,UDAIPUR,0,162,PATNA-UDAIPUR,162,All
2019,12,PATNA,UDAIPUR,0,207,PATNA-UDAIPUR,207,All
2020,1,PATNA,UDAIPUR,0,242,PATNA-UDAIPUR,242,All
2020,2,PATNA,UDAIPUR,0,100,PATNA-UDAIPUR,100,All
2020,3,PATNA,UDAIPUR,0,53,PATNA-UDAIPUR,53,All
2021,11,PATNA,UDAIPUR,146,161,PATNA-UDAIPUR,307,All
2017,12,PATNA,VARANASI,0,166,PATNA-VARANASI,166,All
2018,2,PATNA,VARANASI,462,0,PATNA-VARANASI,462,All
2018,3,PATNA,VARANASI,575,0,PATNA-VARANASI,575,All
2018,4,PATNA,VARANASI,690,0,PATNA-VARANASI,690,All
2018,5,PATNA,VARANASI,895,0,PATNA-VARANASI,895,All
2018,6,PATNA,VARANASI,1104,0,PATNA-VARANASI,1104,All
2018,7,PATNA,VARANASI,1095,0,PATNA-VARANASI,1095,All
2018,8,PATNA,VARANASI,447,0,PATNA-VARANASI,447,All
2018,9,PATNA,VARANASI,389,0,PATNA-VARANASI,389,All
2018,10,PATNA,VARANASI,570,0,PATNA-VARANASI,570,All
2018,11,PATNA,VARANASI,1257,0,PATNA-VARANASI,1257,All
2019,12,PATNA,VARANASI,140,0,PATNA-VARANASI,140,All
2020,7,PATNA,VARANASI,7,1,PATNA-VARANASI,8,All
2020,8,PATNA,VARANASI,361,73,PATNA-VARANASI,434,All
2020,9,PATNA,VARANASI,981,391,PATNA-VARANASI,1372,All
2020,10,PATNA,VARANASI,942,699,PATNA-VARANASI,1641,All
2020,11,PATNA,VARANASI,569,917,PATNA-VARANASI,1486,All
2020,12,PATNA,VARANASI,835,972,PATNA-VARANASI,1807,All
2021,1,PATNA,VARANASI,657,2421,PATNA-VARANASI,3078,All
2021,2,PATNA,VARANASI,620,3172,PATNA-VARANASI,3792,All
2021,3,PATNA,VARANASI,581,1352,PATNA-VARANASI,1933,All
2021,4,PATNA,VARANASI,247,587,PATNA-VARANASI,834,All
2021,6,PATNA,VARANASI,98,97,PATNA-VARANASI,195,All
2021,7,PATNA,VARANASI,179,77,PATNA-VARANASI,256,All
2021,8,PATNA,VARANASI,95,255,PATNA-VARANASI,350,All
2021,9,PATNA,VARANASI,177,0,PATNA-VARANASI,177,All
2021,10,PATNA,VARANASI,0,167,PATNA-VARANASI,167,All
2022,1,PATNA,VARANASI,0,241,PATNA-VARANASI,241,All
2022,2,PATNA,VARANASI,100,0,PATNA-VARANASI,100,All
2022,3,PATNA,VARANASI,27,16,PATNA-VARANASI,43,All
2022,4,PATNA,VARANASI,605,754,PATNA-VARANASI,1359,All
2022,5,PATNA,VARANASI,565,628,PATNA-VARANASI,1193,All
2022,6,PATNA,VARANASI,706,786,PATNA-VARANASI,1492,All
2022,7,PATNA,VARANASI,153,105,PATNA-VARANASI,258,All
2022,8,PATNA,VARANASI,105,79,PATNA-VARANASI,184,All
2022,10,PATNA,VARANASI,1,0,PATNA-VARANASI,1,All
2022,11,PATNA,VARANASI,0,107,PATNA-VARANASI,107,All
2023,2,PATNA,VARANASI,215,0,PATNA-VARANASI,215,All
2024,6,PATNA,VARANASI,0,24,PATNA-VARANASI,24,All
2018,10,PATNA,VISAKHAPATNAM,0,6,PATNA-VISAKHAPATNAM,6,All
2018,11,PATNA,VISAKHAPATNAM,0,28,PATNA-VISAKHAPATNAM,28,All
2020,2,PATNA,VISAKHAPATNAM,0,215,PATNA-VISAKHAPATNAM,215,All
2020,3,PATNA,VISAKHAPATNAM,0,377,PATNA-VISAKHAPATNAM,377,All
2019,10,PITHORAGARH,GHAZIABAD,124,109,GHAZIABAD-PITHORAGARH,233,All
2019,11,PITHORAGARH,GHAZIABAD,40,40,GHAZIABAD-PITHORAGARH,80,All
2019,12,PITHORAGARH,GHAZIABAD,175,175,GHAZIABAD-PITHORAGARH,350,All
2020,3,PITHORAGARH,GHAZIABAD,68,69,GHAZIABAD-PITHORAGARH,137,All
2019,1,PITHORAGARH,PANTNAGAR,78,70,PANTNAGAR-PITHORAGARH,148,All
2019,2,PITHORAGARH,PANTNAGAR,35,26,PANTNAGAR-PITHORAGARH,61,All
2019,1,PONDICHERRY,VIJAYAWADA,0,30,PONDICHERRY-VIJAYAWADA,30,All
2019,2,PONDICHERRY,VIJAYAWADA,0,65,PONDICHERRY-VIJAYAWADA,65,All
2019,3,PONDICHERRY,VIJAYAWADA,0,21,PONDICHERRY-VIJAYAWADA,21,All
2019,4,PONDICHERRY,VIJAYAWADA,0,41,PONDICHERRY-VIJAYAWADA,41,All
2019,5,PONDICHERRY,VIJAYAWADA,0,62,PONDICHERRY-VIJAYAWADA,62,All
2019,6,PONDICHERRY,VIJAYAWADA,0,35,PONDICHERRY-VIJAYAWADA,35,All
2019,7,PONDICHERRY,VIJAYAWADA,0,24,PONDICHERRY-VIJAYAWADA,24,All
2019,9,PONDICHERRY,VIJAYAWADA,0,13,PONDICHERRY-VIJAYAWADA,13,All
2019,10,PONDICHERRY,VIJAYAWADA,0,27,PONDICHERRY-VIJAYAWADA,27,All
2019,11,PONDICHERRY,VIJAYAWADA,0,64,PONDICHERRY-VIJAYAWADA,64,All
2019,12,PONDICHERRY,VIJAYAWADA,0,74,PONDICHERRY-VIJAYAWADA,74,All
2020,1,PONDICHERRY,VIJAYAWADA,0,42,PONDICHERRY-VIJAYAWADA,42,All
2020,2,PONDICHERRY,VIJAYAWADA,0,62,PONDICHERRY-VIJAYAWADA,62,All
2020,3,PONDICHERRY,VIJAYAWADA,0,64,PONDICHERRY-VIJAYAWADA,64,All
2015,4,PORT BLAIR,CHENNAI,20103,16444,CHENNAI-PORT BLAIR,36547,All
2015,5,PORT BLAIR,CHENNAI,20665,19234,CHENNAI-PORT BLAIR,39899,All
2015,6,PORT BLAIR,CHENNAI,14821,18231,CHENNAI-PORT BLAIR,33052,All
2015,7,PORT BLAIR,CHENNAI,14371,14763,CHENNAI-PORT BLAIR,29134,All
2015,8,PORT BLAIR,CHENNAI,16240,15351,CHENNAI-PORT BLAIR,31591,All
2015,9,PORT BLAIR,CHENNAI,17252,18239,CHENNAI-PORT BLAIR,35491,All
2015,10,PORT BLAIR,CHENNAI,18147,14886,CHENNAI-PORT BLAIR,33033,All
2015,11,PORT BLAIR,CHENNAI,17774,17636,CHENNAI-PORT BLAIR,35410,All
2015,12,PORT BLAIR,CHENNAI,14489,15949,CHENNAI-PORT BLAIR,30438,All
2016,1,PORT BLAIR,CHENNAI,19760,18284,CHENNAI-PORT BLAIR,38044,All
2016,2,PORT BLAIR,CHENNAI,18029,18051,CHENNAI-PORT BLAIR,36080,All
2016,3,PORT BLAIR,CHENNAI,20902,19384,CHENNAI-PORT BLAIR,40286,All
2016,4,PORT BLAIR,CHENNAI,19785,17704,CHENNAI-PORT BLAIR,37489,All
2016,5,PORT BLAIR,CHENNAI,22670,20942,CHENNAI-PORT BLAIR,43612,All
2016,6,PORT BLAIR,CHENNAI,17925,20003,CHENNAI-PORT BLAIR,37928,All
2016,7,PORT BLAIR,CHENNAI,15327,15583,CHENNAI-PORT BLAIR,30910,All
2016,8,PORT BLAIR,CHENNAI,15899,15042,CHENNAI-PORT BLAIR,30941,All
2016,9,PORT BLAIR,CHENNAI,15155,14801,CHENNAI-PORT BLAIR,29956,All
2016,10,PORT BLAIR,CHENNAI,20485,22397,CHENNAI-PORT BLAIR,42882,All
2016,11,PORT BLAIR,CHENNAI,24764,25099,CHENNAI-PORT BLAIR,49863,All
2016,12,PORT BLAIR,CHENNAI,24260,25634,CHENNAI-PORT BLAIR,49894,All
2017,1,PORT BLAIR,CHENNAI,27458,25758,CHENNAI-PORT BLAIR,53216,All
2017,2,PORT BLAIR,CHENNAI,23297,23933,CHENNAI-PORT BLAIR,47230,All
2017,3,PORT BLAIR,CHENNAI,24293,22028,CHENNAI-PORT BLAIR,46321,All
2017,4,PORT BLAIR,CHENNAI,26670,24824,CHENNAI-PORT BLAIR,51494,All
2017,5,PORT BLAIR,CHENNAI,30037,28260,CHENNAI-PORT BLAIR,58297,All
2017,6,PORT BLAIR,CHENNAI,22944,26669,CHENNAI-PORT BLAIR,49613,All
2017,7,PORT BLAIR,CHENNAI,17016,18902,CHENNAI-PORT BLAIR,35918,All
2017,8,PORT BLAIR,CHENNAI,20171,19468,CHENNAI-PORT BLAIR,39639,All
2017,9,PORT BLAIR,CHENNAI,22667,26170,CHENNAI-PORT BLAIR,48837,All
2017,10,PORT BLAIR,CHENNAI,27144,27232,CHENNAI-PORT BLAIR,54376,All
2017,11,PORT BLAIR,CHENNAI,26077,25888,CHENNAI-PORT BLAIR,51965,All
2017,12,PORT BLAIR,CHENNAI,27978,28627,CHENNAI-PORT BLAIR,56605,All
2018,1,PORT BLAIR,CHENNAI,28018,26211,CHENNAI-PORT BLAIR,54229,All
2018,2,PORT BLAIR,CHENNAI,24019,23193,CHENNAI-PORT BLAIR,47212,All
2018,3,PORT BLAIR,CHENNAI,29593,28320,CHENNAI-PORT BLAIR,57913,All
2018,4,PORT BLAIR,CHENNAI,31879,27850,CHENNAI-PORT BLAIR,59729,All
2018,5,PORT BLAIR,CHENNAI,34357,31954,CHENNAI-PORT BLAIR,66311,All
2018,6,PORT BLAIR,CHENNAI,27913,30485,CHENNAI-PORT BLAIR,58398,All
2018,7,PORT BLAIR,CHENNAI,21480,21443,CHENNAI-PORT BLAIR,42923,All
2018,8,PORT BLAIR,CHENNAI,23398,22839,CHENNAI-PORT BLAIR,46237,All
2018,9,PORT BLAIR,CHENNAI,23951,25492,CHENNAI-PORT BLAIR,49443,All
2018,10,PORT BLAIR,CHENNAI,26326,25516,CHENNAI-PORT BLAIR,51842,All
2018,11,PORT BLAIR,CHENNAI,27167,27595,CHENNAI-PORT BLAIR,54762,All
2018,12,PORT BLAIR,CHENNAI,28937,30082,CHENNAI-PORT BLAIR,59019,All
2019,1,PORT BLAIR,CHENNAI,29649,26061,CHENNAI-PORT BLAIR,55710,All
2019,2,PORT BLAIR,CHENNAI,22736,22153,CHENNAI-PORT BLAIR,44889,All
2019,3,PORT BLAIR,CHENNAI,23156,22617,CHENNAI-PORT BLAIR,45773,All
2019,4,PORT BLAIR,CHENNAI,28569,26861,CHENNAI-PORT BLAIR,55430,All
2018,9,PORT BLAIR,JAIPUR,17,0,JAIPUR-PORT BLAIR,17,All
2022,12,PORT BLAIR,PUNE,21,0,PORT BLAIR-PUNE,21,All
2019,4,PORT BLAIR,RAIPUR,22,0,PORT BLAIR-RAIPUR,22,All
2025,3,PORT BLAIR,RANCHI,2,0,PORT BLAIR-RANCHI,2,All
2019,5,PORT BLAIR,VADODARA,0,331,PORT BLAIR-VADODARA,331,All
2015,4,PORT BLAIR,VISAKHAPATNAM,507,171,PORT BLAIR-VISAKHAPATNAM,678,All
2015,5,PORT BLAIR,VISAKHAPATNAM,618,526,PORT BLAIR-VISAKHAPATNAM,1144,All
2015,6,PORT BLAIR,VISAKHAPATNAM,614,748,PORT BLAIR-VISAKHAPATNAM,1362,All
2015,7,PORT BLAIR,VISAKHAPATNAM,644,673,PORT BLAIR-VISAKHAPATNAM,1317,All
2015,8,PORT BLAIR,VISAKHAPATNAM,476,393,PORT BLAIR-VISAKHAPATNAM,869,All
2015,9,PORT BLAIR,VISAKHAPATNAM,345,357,PORT BLAIR-VISAKHAPATNAM,702,All
2015,10,PORT BLAIR,VISAKHAPATNAM,3202,10721,PORT BLAIR-VISAKHAPATNAM,13923,All
2015,11,PORT BLAIR,VISAKHAPATNAM,660,659,PORT BLAIR-VISAKHAPATNAM,1319,All
2015,12,PORT BLAIR,VISAKHAPATNAM,681,622,PORT BLAIR-VISAKHAPATNAM,1303,All
2016,1,PORT BLAIR,VISAKHAPATNAM,591,621,PORT BLAIR-VISAKHAPATNAM,1212,All
2016,2,PORT BLAIR,VISAKHAPATNAM,654,627,PORT BLAIR-VISAKHAPATNAM,1281,All
2016,3,PORT BLAIR,VISAKHAPATNAM,508,515,PORT BLAIR-VISAKHAPATNAM,1023,All
2016,4,PORT BLAIR,VISAKHAPATNAM,833,691,PORT BLAIR-VISAKHAPATNAM,1524,All
2016,5,PORT BLAIR,VISAKHAPATNAM,867,725,PORT BLAIR-VISAKHAPATNAM,1592,All
2016,6,PORT BLAIR,VISAKHAPATNAM,721,694,PORT BLAIR-VISAKHAPATNAM,1415,All
2016,7,PORT BLAIR,VISAKHAPATNAM,663,714,PORT BLAIR-VISAKHAPATNAM,1377,All
2016,8,PORT BLAIR,VISAKHAPATNAM,620,587,PORT BLAIR-VISAKHAPATNAM,1207,All
2016,9,PORT BLAIR,VISAKHAPATNAM,657,658,PORT BLAIR-VISAKHAPATNAM,1315,All
2016,10,PORT BLAIR,VISAKHAPATNAM,736,646,PORT BLAIR-VISAKHAPATNAM,1382,All
2016,11,PORT BLAIR,VISAKHAPATNAM,561,529,PORT BLAIR-VISAKHAPATNAM,1090,All
2016,12,PORT BLAIR,VISAKHAPATNAM,693,624,PORT BLAIR-VISAKHAPATNAM,1317,All
2017,1,PORT BLAIR,VISAKHAPATNAM,789,699,PORT BLAIR-VISAKHAPATNAM,1488,All
2017,2,PORT BLAIR,VISAKHAPATNAM,686,576,PORT BLAIR-VISAKHAPATNAM,1262,All
2017,3,PORT BLAIR,VISAKHAPATNAM,642,609,PORT BLAIR-VISAKHAPATNAM,1251,All
2017,4,PORT BLAIR,VISAKHAPATNAM,680,575,PORT BLAIR-VISAKHAPATNAM,1255,All
2017,5,PORT BLAIR,VISAKHAPATNAM,979,855,PORT BLAIR-VISAKHAPATNAM,1834,All
2017,6,PORT BLAIR,VISAKHAPATNAM,752,1005,PORT BLAIR-VISAKHAPATNAM,1757,All
2017,7,PORT BLAIR,VISAKHAPATNAM,726,814,PORT BLAIR-VISAKHAPATNAM,1540,All
2017,8,PORT BLAIR,VISAKHAPATNAM,689,652,PORT BLAIR-VISAKHAPATNAM,1341,All
2017,9,PORT BLAIR,VISAKHAPATNAM,524,583,PORT BLAIR-VISAKHAPATNAM,1107,All
2017,10,PORT BLAIR,VISAKHAPATNAM,578,572,PORT BLAIR-VISAKHAPATNAM,1150,All
2017,11,PORT BLAIR,VISAKHAPATNAM,485,453,PORT BLAIR-VISAKHAPATNAM,938,All
2017,12,PORT BLAIR,VISAKHAPATNAM,520,538,PORT BLAIR-VISAKHAPATNAM,1058,All
2018,1,PORT BLAIR,VISAKHAPATNAM,1218,1086,PORT BLAIR-VISAKHAPATNAM,2304,All
2018,2,PORT BLAIR,VISAKHAPATNAM,1132,945,PORT BLAIR-VISAKHAPATNAM,2077,All
2018,3,PORT BLAIR,VISAKHAPATNAM,1189,987,PORT BLAIR-VISAKHAPATNAM,2176,All
2018,4,PORT BLAIR,VISAKHAPATNAM,1383,1045,PORT BLAIR-VISAKHAPATNAM,2428,All
2018,5,PORT BLAIR,VISAKHAPATNAM,1565,1265,PORT BLAIR-VISAKHAPATNAM,2830,All
2018,6,PORT BLAIR,VISAKHAPATNAM,1347,1376,PORT BLAIR-VISAKHAPATNAM,2723,All
2018,7,PORT BLAIR,VISAKHAPATNAM,1063,1564,PORT BLAIR-VISAKHAPATNAM,2627,All
2018,8,PORT BLAIR,VISAKHAPATNAM,1324,1224,PORT BLAIR-VISAKHAPATNAM,2548,All
2018,9,PORT BLAIR,VISAKHAPATNAM,956,1000,PORT BLAIR-VISAKHAPATNAM,1956,All
2018,10,PORT BLAIR,VISAKHAPATNAM,1164,999,PORT BLAIR-VISAKHAPATNAM,2163,All
2018,11,PORT BLAIR,VISAKHAPATNAM,959,859,PORT BLAIR-VISAKHAPATNAM,1818,All
2018,12,PORT BLAIR,VISAKHAPATNAM,991,881,PORT BLAIR-VISAKHAPATNAM,1872,All
2019,1,PORT BLAIR,VISAKHAPATNAM,1038,1056,PORT BLAIR-VISAKHAPATNAM,2094,All
2019,2,PORT BLAIR,VISAKHAPATNAM,1094,1011,PORT BLAIR-VISAKHAPATNAM,2105,All
2019,3,PORT BLAIR,VISAKHAPATNAM,1436,1197,PORT BLAIR-VISAKHAPATNAM,2633,All
2019,4,PORT BLAIR,VISAKHAPATNAM,1461,1185,PORT BLAIR-VISAKHAPATNAM,2646,All
2019,5,PORT BLAIR,VISAKHAPATNAM,1559,1379,PORT BLAIR-VISAKHAPATNAM,2938,All
2019,6,PORT BLAIR,VISAKHAPATNAM,1155,1182,PORT BLAIR-VISAKHAPATNAM,2337,All
2019,7,PORT BLAIR,VISAKHAPATNAM,771,1414,PORT BLAIR-VISAKHAPATNAM,2185,All
2019,8,PORT BLAIR,VISAKHAPATNAM,732,844,PORT BLAIR-VISAKHAPATNAM,1576,All
2019,9,PORT BLAIR,VISAKHAPATNAM,712,953,PORT BLAIR-VISAKHAPATNAM,1665,All
2019,10,PORT BLAIR,VISAKHAPATNAM,922,847,PORT BLAIR-VISAKHAPATNAM,1769,All
2019,11,PORT BLAIR,VISAKHAPATNAM,947,1026,PORT BLAIR-VISAKHAPATNAM,1973,All
2019,12,PORT BLAIR,VISAKHAPATNAM,1139,828,PORT BLAIR-VISAKHAPATNAM,1967,All
2020,1,PORT BLAIR,VISAKHAPATNAM,1121,1014,PORT BLAIR-VISAKHAPATNAM,2135,All
2020,2,PORT BLAIR,VISAKHAPATNAM,1068,959,PORT BLAIR-VISAKHAPATNAM,2027,All
2020,3,PORT BLAIR,VISAKHAPATNAM,667,670,PORT BLAIR-VISAKHAPATNAM,1337,All
2021,3,PORT BLAIR,VISAKHAPATNAM,358,169,PORT BLAIR-VISAKHAPATNAM,527,All
2021,4,PORT BLAIR,VISAKHAPATNAM,1767,595,PORT BLAIR-VISAKHAPATNAM,2362,All
2021,6,PORT BLAIR,VISAKHAPATNAM,774,496,PORT BLAIR-VISAKHAPATNAM,1270,All
2021,7,PORT BLAIR,VISAKHAPATNAM,875,470,PORT BLAIR-VISAKHAPATNAM,1345,All
2021,8,PORT BLAIR,VISAKHAPATNAM,816,904,PORT BLAIR-VISAKHAPATNAM,1720,All
2021,9,PORT BLAIR,VISAKHAPATNAM,926,1094,PORT BLAIR-VISAKHAPATNAM,2020,All
2021,10,PORT BLAIR,VISAKHAPATNAM,633,879,PORT BLAIR-VISAKHAPATNAM,1512,All
2021,11,PORT BLAIR,VISAKHAPATNAM,1382,1249,PORT BLAIR-VISAKHAPATNAM,2631,All
2021,12,PORT BLAIR,VISAKHAPATNAM,1420,944,PORT BLAIR-VISAKHAPATNAM,2364,All
2022,1,PORT BLAIR,VISAKHAPATNAM,1510,1424,PORT BLAIR-VISAKHAPATNAM,2934,All
2022,2,PORT BLAIR,VISAKHAPATNAM,1696,1414,PORT BLAIR-VISAKHAPATNAM,3110,All
2022,3,PORT BLAIR,VISAKHAPATNAM,777,837,PORT BLAIR-VISAKHAPATNAM,1614,All
2022,4,PORT BLAIR,VISAKHAPATNAM,1385,1144,PORT BLAIR-VISAKHAPATNAM,2529,All
2022,5,PORT BLAIR,VISAKHAPATNAM,1156,1305,PORT BLAIR-VISAKHAPATNAM,2461,All
2022,6,PORT BLAIR,VISAKHAPATNAM,1912,2994,PORT BLAIR-VISAKHAPATNAM,4906,All
2022,7,PORT BLAIR,VISAKHAPATNAM,1290,1985,PORT BLAIR-VISAKHAPATNAM,3275,All
2022,8,PORT BLAIR,VISAKHAPATNAM,1462,1605,PORT BLAIR-VISAKHAPATNAM,3067,All
2022,9,PORT BLAIR,VISAKHAPATNAM,1161,1539,PORT BLAIR-VISAKHAPATNAM,2700,All
2022,10,PORT BLAIR,VISAKHAPATNAM,1263,1252,PORT BLAIR-VISAKHAPATNAM,2515,All
2022,11,PORT BLAIR,VISAKHAPATNAM,691,977,PORT BLAIR-VISAKHAPATNAM,1668,All
2022,12,PORT BLAIR,VISAKHAPATNAM,736,979,PORT BLAIR-VISAKHAPATNAM,1715,All
2023,1,PORT BLAIR,VISAKHAPATNAM,899,1174,PORT BLAIR-VISAKHAPATNAM,2073,All
2023,2,PORT BLAIR,VISAKHAPATNAM,642,919,PORT BLAIR-VISAKHAPATNAM,1561,All
2023,3,PORT BLAIR,VISAKHAPATNAM,674,1226,PORT BLAIR-VISAKHAPATNAM,1900,All
2023,4,PORT BLAIR,VISAKHAPATNAM,1329,1202,PORT BLAIR-VISAKHAPATNAM,2531,All
2023,5,PORT BLAIR,VISAKHAPATNAM,705,1526,PORT BLAIR-VISAKHAPATNAM,2231,All
2023,6,PORT BLAIR,VISAKHAPATNAM,1065,2862,PORT BLAIR-VISAKHAPATNAM,3927,All
2023,7,PORT BLAIR,VISAKHAPATNAM,1076,1386,PORT BLAIR-VISAKHAPATNAM,2462,All
2023,8,PORT BLAIR,VISAKHAPATNAM,1221,1431,PORT BLAIR-VISAKHAPATNAM,2652,All
2023,9,PORT BLAIR,VISAKHAPATNAM,1082,1176,PORT BLAIR-VISAKHAPATNAM,2258,All
2023,10,PORT BLAIR,VISAKHAPATNAM,942,1140,PORT BLAIR-VISAKHAPATNAM,2082,All
2023,11,PORT BLAIR,VISAKHAPATNAM,1025,1186,PORT BLAIR-VISAKHAPATNAM,2211,All
2023,12,PORT BLAIR,VISAKHAPATNAM,1301,1281,PORT BLAIR-VISAKHAPATNAM,2582,All
2024,1,PORT BLAIR,VISAKHAPATNAM,1108,803,PORT BLAIR-VISAKHAPATNAM,1911,All
2024,2,PORT BLAIR,VISAKHAPATNAM,1102,774,PORT BLAIR-VISAKHAPATNAM,1876,All
2024,3,PORT BLAIR,VISAKHAPATNAM,1300,630,PORT BLAIR-VISAKHAPATNAM,1930,All
2024,4,PORT BLAIR,VISAKHAPATNAM,2038,1398,PORT BLAIR-VISAKHAPATNAM,3436,All
2024,6,PORT BLAIR,VISAKHAPATNAM,1354,1343,PORT BLAIR-VISAKHAPATNAM,2697,All
2024,7,PORT BLAIR,VISAKHAPATNAM,1199,1530,PORT BLAIR-VISAKHAPATNAM,2729,All
2024,8,PORT BLAIR,VISAKHAPATNAM,1528,1583,PORT BLAIR-VISAKHAPATNAM,3111,All
2024,9,PORT BLAIR,VISAKHAPATNAM,1289,1240,PORT BLAIR-VISAKHAPATNAM,2529,All
2024,10,PORT BLAIR,VISAKHAPATNAM,1520,1657,PORT BLAIR-VISAKHAPATNAM,3177,All
2024,11,PORT BLAIR,VISAKHAPATNAM,1383,1310,PORT BLAIR-VISAKHAPATNAM,2693,All
2024,12,PORT BLAIR,VISAKHAPATNAM,1615,1408,PORT BLAIR-VISAKHAPATNAM,3023,All
2025,1,PORT BLAIR,VISAKHAPATNAM,1033,858,PORT BLAIR-VISAKHAPATNAM,1891,All
2025,2,PORT BLAIR,VISAKHAPATNAM,762,505,PORT BLAIR-VISAKHAPATNAM,1267,All
2025,3,PORT BLAIR,VISAKHAPATNAM,1355,1568,PORT BLAIR-VISAKHAPATNAM,2923,All
2025,2,PRAYAGRAJ,BENGALURU,27539,27924,BENGALURU-PRAYAGRAJ,55463,All
2025,3,PRAYAGRAJ,BENGALURU,3120,3161,BENGALURU-PRAYAGRAJ,6281,All
2025,3,PRAYAGRAJ,BHOPAL,194,170,BHOPAL-PRAYAGRAJ,364,All
2025,2,PRAYAGRAJ,BHUBANESWAR,4772,4845,BHUBANESWAR-PRAYAGRAJ,9617,All
2025,3,PRAYAGRAJ,BHUBANESWAR,983,962,BHUBANESWAR-PRAYAGRAJ,1945,All
2025,2,PRAYAGRAJ,BILASPUR,502,502,BILASPUR-PRAYAGRAJ,1004,All
2025,3,PRAYAGRAJ,BILASPUR,455,514,BILASPUR-PRAYAGRAJ,969,All
2025,2,PRAYAGRAJ,CHANDIGARH,1427,1545,CHANDIGARH-PRAYAGRAJ,2972,All
2025,2,PRAYAGRAJ,CHENNAI,2633,3154,CHENNAI-PRAYAGRAJ,5787,All
2025,2,PRAYAGRAJ,DELHI,71007,71668,DELHI-PRAYAGRAJ,142675,All
2025,3,PRAYAGRAJ,DELHI,6641,6793,DELHI-PRAYAGRAJ,13434,All
2025,2,PRAYAGRAJ,DehraDun,269,173,DehraDun-PRAYAGRAJ,442,All
2025,2,PRAYAGRAJ,GORAKHPUR,38,0,GORAKHPUR-PRAYAGRAJ,38,All
2025,2,PRAYAGRAJ,GUWAHATI,2702,2420,GUWAHATI-PRAYAGRAJ,5122,All
2025,2,PRAYAGRAJ,HYDERABAD,22004,22394,HYDERABAD-PRAYAGRAJ,44398,All
2025,3,PRAYAGRAJ,HYDERABAD,2171,2211,HYDERABAD-PRAYAGRAJ,4382,All
2025,2,PRAYAGRAJ,INDORE,1438,1548,INDORE-PRAYAGRAJ,2986,All
2025,3,PRAYAGRAJ,INDORE,5,29,INDORE-PRAYAGRAJ,34,All
2025,2,PRAYAGRAJ,JAIPUR,5275,5352,JAIPUR-PRAYAGRAJ,10627,All
2025,2,PRAYAGRAJ,KOLKATA,16122,15654,KOLKATA-PRAYAGRAJ,31776,All
2025,2,PRAYAGRAJ,LUCKNOW,1188,1152,LUCKNOW-PRAYAGRAJ,2340,All
2025,2,PRAYAGRAJ,MUMBAI,45652,47068,MUMBAI-PRAYAGRAJ,92720,All
2025,3,PRAYAGRAJ,MUMBAI,12209,12548,MUMBAI-PRAYAGRAJ,24757,All
2025,2,PRAYAGRAJ,PUNE,2298,2308,PRAYAGRAJ-PUNE,4606,All
2025,2,PRAYAGRAJ,RAIPUR,2035,2019,PRAYAGRAJ-RAIPUR,4054,All
2025,3,PRAYAGRAJ,RAIPUR,1888,1960,PRAYAGRAJ-RAIPUR,3848,All
2025,1,PRAYAGRAJ ,BENGALURU,8187,9042,BENGALURU-PRAYAGRAJ ,17229,All
2025,1,PRAYAGRAJ ,BHUBANESWAR,1126,1156,BHUBANESWAR-PRAYAGRAJ ,2282,All
2025,1,PRAYAGRAJ ,BILASPUR,522,581,BILASPUR-PRAYAGRAJ ,1103,All
2025,1,PRAYAGRAJ ,CHANDIGARH,111,184,CHANDIGARH-PRAYAGRAJ ,295,All
2025,1,PRAYAGRAJ ,DELHI,18207,19068,DELHI-PRAYAGRAJ ,37275,All
2025,1,PRAYAGRAJ ,DehraDun,175,108,DehraDun-PRAYAGRAJ ,283,All
2025,1,PRAYAGRAJ ,GORAKHPUR,31,27,GORAKHPUR-PRAYAGRAJ ,58,All
2025,1,PRAYAGRAJ ,GUWAHATI,54,61,GUWAHATI-PRAYAGRAJ ,115,All
2025,1,PRAYAGRAJ ,HYDERABAD,2479,2560,HYDERABAD-PRAYAGRAJ ,5039,All
2025,1,PRAYAGRAJ ,INDORE,249,299,INDORE-PRAYAGRAJ ,548,All
2025,1,PRAYAGRAJ ,JAIPUR,1242,1633,JAIPUR-PRAYAGRAJ ,2875,All
2025,1,PRAYAGRAJ ,KOLKATA,2563,3109,KOLKATA-PRAYAGRAJ ,5672,All
2025,1,PRAYAGRAJ ,LUCKNOW,1244,1211,LUCKNOW-PRAYAGRAJ ,2455,All
2025,1,PRAYAGRAJ ,MUMBAI,16428,16845,MUMBAI-PRAYAGRAJ ,33273,All
2025,1,PRAYAGRAJ ,RAIPUR,2015,2056,PRAYAGRAJ -RAIPUR,4071,All
2017,8,PUDUCHERRY,VIJAYAWADA,0,6,PUDUCHERRY-VIJAYAWADA,6,All
2017,9,PUDUCHERRY,VIJAYAWADA,0,10,PUDUCHERRY-VIJAYAWADA,10,All
2017,10,PUDUCHERRY,VIJAYAWADA,0,21,PUDUCHERRY-VIJAYAWADA,21,All
2017,11,PUDUCHERRY,VIJAYAWADA,0,8,PUDUCHERRY-VIJAYAWADA,8,All
2017,12,PUDUCHERRY,VIJAYAWADA,0,9,PUDUCHERRY-VIJAYAWADA,9,All
2018,1,PUDUCHERRY,VIJAYAWADA,0,12,PUDUCHERRY-VIJAYAWADA,12,All
2018,2,PUDUCHERRY,VIJAYAWADA,0,17,PUDUCHERRY-VIJAYAWADA,17,All
2018,3,PUDUCHERRY,VIJAYAWADA,0,9,PUDUCHERRY-VIJAYAWADA,9,All
2018,4,PUDUCHERRY,VIJAYAWADA,0,20,PUDUCHERRY-VIJAYAWADA,20,All
2018,5,PUDUCHERRY,VIJAYAWADA,0,32,PUDUCHERRY-VIJAYAWADA,32,All
2018,6,PUDUCHERRY,VIJAYAWADA,0,68,PUDUCHERRY-VIJAYAWADA,68,All
2018,7,PUDUCHERRY,VIJAYAWADA,0,17,PUDUCHERRY-VIJAYAWADA,17,All
2018,8,PUDUCHERRY,VIJAYAWADA,0,60,PUDUCHERRY-VIJAYAWADA,60,All
2018,9,PUDUCHERRY,VIJAYAWADA,0,20,PUDUCHERRY-VIJAYAWADA,20,All
2018,10,PUDUCHERRY,VIJAYAWADA,0,39,PUDUCHERRY-VIJAYAWADA,39,All
2018,11,PUDUCHERRY,VIJAYAWADA,0,30,PUDUCHERRY-VIJAYAWADA,30,All
2018,12,PUDUCHERRY,VIJAYAWADA,0,28,PUDUCHERRY-VIJAYAWADA,28,All
2020,12,PUNE,DARBHANGA,10,0,DARBHANGA-PUNE,10,All
2021,1,PUNE,DARBHANGA,78,0,DARBHANGA-PUNE,78,All
2021,2,PUNE,DARBHANGA,394,0,DARBHANGA-PUNE,394,All
2016,5,PUNE,RAIPUR,323,0,PUNE-RAIPUR,323,All
2016,6,PUNE,RAIPUR,286,0,PUNE-RAIPUR,286,All
2016,7,PUNE,RAIPUR,284,0,PUNE-RAIPUR,284,All
2016,8,PUNE,RAIPUR,395,382,PUNE-RAIPUR,777,All
2016,9,PUNE,RAIPUR,371,385,PUNE-RAIPUR,756,All
2016,10,PUNE,RAIPUR,881,0,PUNE-RAIPUR,881,All
2016,11,PUNE,RAIPUR,668,416,PUNE-RAIPUR,1084,All
2016,12,PUNE,RAIPUR,372,455,PUNE-RAIPUR,827,All
2017,1,PUNE,RAIPUR,380,380,PUNE-RAIPUR,760,All
2017,2,PUNE,RAIPUR,637,438,PUNE-RAIPUR,1075,All
2017,3,PUNE,RAIPUR,347,351,PUNE-RAIPUR,698,All
2018,3,PUNE,RAIPUR,104,107,PUNE-RAIPUR,211,All
2018,4,PUNE,RAIPUR,668,550,PUNE-RAIPUR,1218,All
2018,5,PUNE,RAIPUR,427,502,PUNE-RAIPUR,929,All
2018,6,PUNE,RAIPUR,441,479,PUNE-RAIPUR,920,All
2018,7,PUNE,RAIPUR,297,371,PUNE-RAIPUR,668,All
2018,8,PUNE,RAIPUR,745,847,PUNE-RAIPUR,1592,All
2018,11,PUNE,RAIPUR,422,388,PUNE-RAIPUR,810,All
2020,9,PUNE,RAIPUR,0,17,PUNE-RAIPUR,17,All
2021,9,PUNE,RAIPUR,716,975,PUNE-RAIPUR,1691,All
2021,10,PUNE,RAIPUR,993,1046,PUNE-RAIPUR,2039,All
2021,11,PUNE,RAIPUR,1800,1573,PUNE-RAIPUR,3373,All
2021,12,PUNE,RAIPUR,1335,1434,PUNE-RAIPUR,2769,All
2022,1,PUNE,RAIPUR,1313,1067,PUNE-RAIPUR,2380,All
2022,2,PUNE,RAIPUR,1283,1428,PUNE-RAIPUR,2711,All
2022,3,PUNE,RAIPUR,1621,1597,PUNE-RAIPUR,3218,All
2022,4,PUNE,RAIPUR,2460,2141,PUNE-RAIPUR,4601,All
2022,5,PUNE,RAIPUR,2610,2495,PUNE-RAIPUR,5105,All
2022,6,PUNE,RAIPUR,2251,2230,PUNE-RAIPUR,4481,All
2022,7,PUNE,RAIPUR,1987,2020,PUNE-RAIPUR,4007,All
2022,8,PUNE,RAIPUR,2182,2135,PUNE-RAIPUR,4317,All
2022,9,PUNE,RAIPUR,1859,2120,PUNE-RAIPUR,3979,All
2022,10,PUNE,RAIPUR,2135,2000,PUNE-RAIPUR,4135,All
2022,11,PUNE,RAIPUR,1575,1902,PUNE-RAIPUR,3477,All
2022,12,PUNE,RAIPUR,1867,2018,PUNE-RAIPUR,3885,All
2023,1,PUNE,RAIPUR,1851,2026,PUNE-RAIPUR,3877,All
2023,2,PUNE,RAIPUR,1898,1947,PUNE-RAIPUR,3845,All
2023,3,PUNE,RAIPUR,2023,2133,PUNE-RAIPUR,4156,All
2023,4,PUNE,RAIPUR,1915,1864,PUNE-RAIPUR,3779,All
2023,5,PUNE,RAIPUR,2274,2263,PUNE-RAIPUR,4537,All
2023,6,PUNE,RAIPUR,2131,2152,PUNE-RAIPUR,4283,All
2023,7,PUNE,RAIPUR,2033,2014,PUNE-RAIPUR,4047,All
2023,8,PUNE,RAIPUR,2119,2035,PUNE-RAIPUR,4154,All
2023,9,PUNE,RAIPUR,2202,2150,PUNE-RAIPUR,4352,All
2023,10,PUNE,RAIPUR,2149,2177,PUNE-RAIPUR,4326,All
2023,11,PUNE,RAIPUR,2178,2174,PUNE-RAIPUR,4352,All
2023,12,PUNE,RAIPUR,2236,2231,PUNE-RAIPUR,4467,All
2024,1,PUNE,RAIPUR,2430,2330,PUNE-RAIPUR,4760,All
2024,2,PUNE,RAIPUR,1996,2013,PUNE-RAIPUR,4009,All
2024,3,PUNE,RAIPUR,2067,2061,PUNE-RAIPUR,4128,All
2024,4,PUNE,RAIPUR,2238,2139,PUNE-RAIPUR,4377,All
2024,6,PUNE,RAIPUR,2030,1864,PUNE-RAIPUR,3894,All
2024,7,PUNE,RAIPUR,2346,2383,PUNE-RAIPUR,4729,All
2024,8,PUNE,RAIPUR,2141,2113,PUNE-RAIPUR,4254,All
2024,9,PUNE,RAIPUR,2197,2181,PUNE-RAIPUR,4378,All
2024,10,PUNE,RAIPUR,2701,2116,PUNE-RAIPUR,4817,All
2024,11,PUNE,RAIPUR,4611,5039,PUNE-RAIPUR,9650,All
2024,12,PUNE,RAIPUR,5216,5088,PUNE-RAIPUR,10304,All
2025,1,PUNE,RAIPUR,4767,5203,PUNE-RAIPUR,9970,All
2025,2,PUNE,RAIPUR,4763,4652,PUNE-RAIPUR,9415,All
2025,3,PUNE,RAIPUR,4895,4867,PUNE-RAIPUR,9762,All
2017,11,PUNE,RAJKOT,0,26,PUNE-RAJKOT,26,All
2023,7,PUNE,RAJKOT,1772,1722,PUNE-RAJKOT,3494,All
2023,8,PUNE,RAJKOT,1998,1945,PUNE-RAJKOT,3943,All
2023,9,PUNE,RAJKOT,228,233,PUNE-RAJKOT,461,All
2019,10,PUNE,RANCHI,89,0,PUNE-RANCHI,89,All
2019,11,PUNE,RANCHI,337,0,PUNE-RANCHI,337,All
2019,12,PUNE,RANCHI,473,0,PUNE-RANCHI,473,All
2020,1,PUNE,RANCHI,634,0,PUNE-RANCHI,634,All
2020,2,PUNE,RANCHI,469,0,PUNE-RANCHI,469,All
2020,3,PUNE,RANCHI,475,0,PUNE-RANCHI,475,All
2021,8,PUNE,RANCHI,549,600,PUNE-RANCHI,1149,All
2021,9,PUNE,RANCHI,1904,1969,PUNE-RANCHI,3873,All
2021,10,PUNE,RANCHI,2461,1982,PUNE-RANCHI,4443,All
2021,11,PUNE,RANCHI,2018,1879,PUNE-RANCHI,3897,All
2022,3,PUNE,RANCHI,667,832,PUNE-RANCHI,1499,All
2022,4,PUNE,RANCHI,4820,4244,PUNE-RANCHI,9064,All
2022,5,PUNE,RANCHI,4762,5357,PUNE-RANCHI,10119,All
2022,6,PUNE,RANCHI,4581,5003,PUNE-RANCHI,9584,All
2022,7,PUNE,RANCHI,4649,4996,PUNE-RANCHI,9645,All
2022,8,PUNE,RANCHI,4486,4922,PUNE-RANCHI,9408,All
2022,9,PUNE,RANCHI,4206,4440,PUNE-RANCHI,8646,All
2022,10,PUNE,RANCHI,5154,4663,PUNE-RANCHI,9817,All
2022,11,PUNE,RANCHI,4732,5174,PUNE-RANCHI,9906,All
2022,12,PUNE,RANCHI,4511,4748,PUNE-RANCHI,9259,All
2023,1,PUNE,RANCHI,4312,4368,PUNE-RANCHI,8680,All
2023,2,PUNE,RANCHI,4474,4338,PUNE-RANCHI,8812,All
2023,3,PUNE,RANCHI,4530,4559,PUNE-RANCHI,9089,All
2023,4,PUNE,RANCHI,4777,4757,PUNE-RANCHI,9534,All
2023,5,PUNE,RANCHI,5171,5280,PUNE-RANCHI,10451,All
2023,6,PUNE,RANCHI,4823,5123,PUNE-RANCHI,9946,All
2023,7,PUNE,RANCHI,4438,4885,PUNE-RANCHI,9323,All
2023,8,PUNE,RANCHI,4652,4803,PUNE-RANCHI,9455,All
2023,9,PUNE,RANCHI,4762,4958,PUNE-RANCHI,9720,All
2023,10,PUNE,RANCHI,5301,4829,PUNE-RANCHI,10130,All
2023,11,PUNE,RANCHI,5140,4466,PUNE-RANCHI,9606,All
2023,12,PUNE,RANCHI,5285,5538,PUNE-RANCHI,10823,All
2024,1,PUNE,RANCHI,4855,4200,PUNE-RANCHI,9055,All
2024,2,PUNE,RANCHI,4941,4511,PUNE-RANCHI,9452,All
2024,3,PUNE,RANCHI,5275,4966,PUNE-RANCHI,10241,All
2024,4,PUNE,RANCHI,5270,4997,PUNE-RANCHI,10267,All
2024,6,PUNE,RANCHI,5103,5078,PUNE-RANCHI,10181,All
2024,7,PUNE,RANCHI,4884,5340,PUNE-RANCHI,10224,All
2024,8,PUNE,RANCHI,4877,5097,PUNE-RANCHI,9974,All
2024,9,PUNE,RANCHI,4737,4463,PUNE-RANCHI,9200,All
2024,10,PUNE,RANCHI,5538,4264,PUNE-RANCHI,9802,All
2024,11,PUNE,RANCHI,6326,6568,PUNE-RANCHI,12894,All
2024,12,PUNE,RANCHI,6492,6423,PUNE-RANCHI,12915,All
2025,1,PUNE,RANCHI,6561,6585,PUNE-RANCHI,13146,All
2025,2,PUNE,RANCHI,6198,5911,PUNE-RANCHI,12109,All
2025,3,PUNE,RANCHI,6261,5975,PUNE-RANCHI,12236,All
2023,11,PUNE,Rajkot International Airport,1398,1382,PUNE-Rajkot International Airport,2780,All
2023,12,PUNE,Rajkot International Airport,1824,1998,PUNE-Rajkot International Airport,3822,All
2024,1,PUNE,Rajkot International Airport,1861,1936,PUNE-Rajkot International Airport,3797,All
2024,2,PUNE,Rajkot International Airport,1982,2077,PUNE-Rajkot International Airport,4059,All
2024,3,PUNE,Rajkot International Airport,1676,1834,PUNE-Rajkot International Airport,3510,All
2024,4,PUNE,Rajkot International Airport,1804,1512,PUNE-Rajkot International Airport,3316,All
2024,6,PUNE,Rajkot International Airport,1777,1715,PUNE-Rajkot International Airport,3492,All
2024,7,PUNE,Rajkot International Airport,1676,1773,PUNE-Rajkot International Airport,3449,All
2024,8,PUNE,Rajkot International Airport,1767,1671,PUNE-Rajkot International Airport,3438,All
2024,9,PUNE,Rajkot International Airport,1982,1759,PUNE-Rajkot International Airport,3741,All
2024,10,PUNE,Rajkot International Airport,2218,1953,PUNE-Rajkot International Airport,4171,All
2024,11,PUNE,Rajkot International Airport,1947,1901,PUNE-Rajkot International Airport,3848,All
2024,12,PUNE,Rajkot International Airport,2237,2207,PUNE-Rajkot International Airport,4444,All
2025,1,PUNE,Rajkot International Airport,2126,2100,PUNE-Rajkot International Airport,4226,All
2025,2,PUNE,Rajkot International Airport,1909,1920,PUNE-Rajkot International Airport,3829,All
2025,3,PUNE,Rajkot International Airport,1987,1946,PUNE-Rajkot International Airport,3933,All
2015,10,PUNE,SRINAGAR,8,21,PUNE-SRINAGAR,29,All
2015,11,PUNE,SRINAGAR,112,86,PUNE-SRINAGAR,198,All
2015,12,PUNE,SRINAGAR,105,102,PUNE-SRINAGAR,207,All
2016,1,PUNE,SRINAGAR,64,37,PUNE-SRINAGAR,101,All
2016,2,PUNE,SRINAGAR,105,71,PUNE-SRINAGAR,176,All
2016,3,PUNE,SRINAGAR,150,88,PUNE-SRINAGAR,238,All
2016,4,PUNE,SRINAGAR,400,308,PUNE-SRINAGAR,708,All
2016,5,PUNE,SRINAGAR,461,419,PUNE-SRINAGAR,880,All
2016,6,PUNE,SRINAGAR,161,197,PUNE-SRINAGAR,358,All
2016,7,PUNE,SRINAGAR,8,17,PUNE-SRINAGAR,25,All
2016,8,PUNE,SRINAGAR,34,53,PUNE-SRINAGAR,87,All
2016,9,PUNE,SRINAGAR,45,0,PUNE-SRINAGAR,45,All
2016,10,PUNE,SRINAGAR,64,0,PUNE-SRINAGAR,64,All
2016,11,PUNE,SRINAGAR,19,0,PUNE-SRINAGAR,19,All
2017,3,PUNE,SRINAGAR,7,0,PUNE-SRINAGAR,7,All
2017,4,PUNE,SRINAGAR,172,0,PUNE-SRINAGAR,172,All
2017,5,PUNE,SRINAGAR,208,0,PUNE-SRINAGAR,208,All
2017,6,PUNE,SRINAGAR,112,0,PUNE-SRINAGAR,112,All
2017,7,PUNE,SRINAGAR,289,0,PUNE-SRINAGAR,289,All
2017,8,PUNE,SRINAGAR,398,0,PUNE-SRINAGAR,398,All
2017,9,PUNE,SRINAGAR,314,0,PUNE-SRINAGAR,314,All
2017,10,PUNE,SRINAGAR,154,0,PUNE-SRINAGAR,154,All
2017,11,PUNE,SRINAGAR,174,0,PUNE-SRINAGAR,174,All
2017,12,PUNE,SRINAGAR,187,0,PUNE-SRINAGAR,187,All
2018,1,PUNE,SRINAGAR,152,0,PUNE-SRINAGAR,152,All
2018,2,PUNE,SRINAGAR,201,0,PUNE-SRINAGAR,201,All
2018,3,PUNE,SRINAGAR,56,0,PUNE-SRINAGAR,56,All
2024,4,PUNE,SRINAGAR,700,0,PUNE-SRINAGAR,700,All
2024,6,PUNE,SRINAGAR,58,0,PUNE-SRINAGAR,58,All
2024,7,PUNE,SRINAGAR,22,0,PUNE-SRINAGAR,22,All
2024,9,PUNE,SRINAGAR,1,0,PUNE-SRINAGAR,1,All
2024,10,PUNE,SRINAGAR,1,2,PUNE-SRINAGAR,3,All
2024,11,PUNE,SRINAGAR,10,14,PUNE-SRINAGAR,24,All
2024,12,PUNE,SRINAGAR,30,69,PUNE-SRINAGAR,99,All
2025,1,PUNE,SRINAGAR,24,42,PUNE-SRINAGAR,66,All
2025,2,PUNE,SRINAGAR,69,9,PUNE-SRINAGAR,78,All
2025,3,PUNE,SRINAGAR,192,2,PUNE-SRINAGAR,194,All
2020,2,PUNE,SURAT,156,0,PUNE-SURAT,156,All
2021,7,PUNE,SURAT,260,259,PUNE-SURAT,519,All
2021,8,PUNE,SURAT,574,568,PUNE-SURAT,1142,All
2021,9,PUNE,SURAT,777,841,PUNE-SURAT,1618,All
2021,10,PUNE,SURAT,458,483,PUNE-SURAT,941,All
2022,4,PUNE,SURAT,919,817,PUNE-SURAT,1736,All
2022,5,PUNE,SURAT,1452,1643,PUNE-SURAT,3095,All
2022,6,PUNE,SURAT,974,1048,PUNE-SURAT,2022,All
2023,10,PUNE,SURAT,422,417,PUNE-SURAT,839,All
2023,11,PUNE,SURAT,1664,1514,PUNE-SURAT,3178,All
2023,12,PUNE,SURAT,2222,2215,PUNE-SURAT,4437,All
2024,1,PUNE,SURAT,2322,2315,PUNE-SURAT,4637,All
2024,3,PUNE,SURAT,106,132,PUNE-SURAT,238,All
2024,4,PUNE,SURAT,1510,1262,PUNE-SURAT,2772,All
2024,6,PUNE,SURAT,1798,1627,PUNE-SURAT,3425,All
2024,7,PUNE,SURAT,1628,1600,PUNE-SURAT,3228,All
2024,8,PUNE,SURAT,1767,1770,PUNE-SURAT,3537,All
2024,9,PUNE,SURAT,1700,1586,PUNE-SURAT,3286,All
2024,10,PUNE,SURAT,1981,1762,PUNE-SURAT,3743,All
2024,11,PUNE,SURAT,2005,1932,PUNE-SURAT,3937,All
2024,12,PUNE,SURAT,2358,2206,PUNE-SURAT,4564,All
2025,1,PUNE,SURAT,2036,2143,PUNE-SURAT,4179,All
2025,2,PUNE,SURAT,1975,1901,PUNE-SURAT,3876,All
2025,3,PUNE,SURAT,1948,1942,PUNE-SURAT,3890,All
2015,8,PUNE,TIRUPATI,50,0,PUNE-TIRUPATI,50,All
2015,9,PUNE,TIRUPATI,174,0,PUNE-TIRUPATI,174,All
2015,10,PUNE,TIRUPATI,112,0,PUNE-TIRUPATI,112,All
2015,11,PUNE,TIRUPATI,289,0,PUNE-TIRUPATI,289,All
2015,12,PUNE,TIRUPATI,379,0,PUNE-TIRUPATI,379,All
2016,1,PUNE,TIRUPATI,378,0,PUNE-TIRUPATI,378,All
2016,2,PUNE,TIRUPATI,527,0,PUNE-TIRUPATI,527,All
2016,3,PUNE,TIRUPATI,636,0,PUNE-TIRUPATI,636,All
2016,4,PUNE,TIRUPATI,113,0,PUNE-TIRUPATI,113,All
2019,3,PUNE,TIRUPATI,229,220,PUNE-TIRUPATI,449,All
2021,8,PUNE,TIRUPATI,205,162,PUNE-TIRUPATI,367,All
2021,9,PUNE,TIRUPATI,781,587,PUNE-TIRUPATI,1368,All
2021,10,PUNE,TIRUPATI,428,336,PUNE-TIRUPATI,764,All
2021,11,PUNE,TIRUPATI,1598,1532,PUNE-TIRUPATI,3130,All
2021,12,PUNE,TIRUPATI,1762,1579,PUNE-TIRUPATI,3341,All
2022,1,PUNE,TIRUPATI,826,829,PUNE-TIRUPATI,1655,All
2022,2,PUNE,TIRUPATI,706,848,PUNE-TIRUPATI,1554,All
2022,3,PUNE,TIRUPATI,142,168,PUNE-TIRUPATI,310,All
2022,4,PUNE,TIRUPATI,1319,1220,PUNE-TIRUPATI,2539,All
2022,5,PUNE,TIRUPATI,1331,1177,PUNE-TIRUPATI,2508,All
2022,6,PUNE,TIRUPATI,1095,1086,PUNE-TIRUPATI,2181,All
2022,7,PUNE,TIRUPATI,992,958,PUNE-TIRUPATI,1950,All
2022,8,PUNE,TIRUPATI,906,896,PUNE-TIRUPATI,1802,All
2022,9,PUNE,TIRUPATI,399,433,PUNE-TIRUPATI,832,All
2022,10,PUNE,TIRUPATI,608,481,PUNE-TIRUPATI,1089,All
2022,11,PUNE,TIRUPATI,731,832,PUNE-TIRUPATI,1563,All
2022,12,PUNE,TIRUPATI,934,902,PUNE-TIRUPATI,1836,All
2023,1,PUNE,TIRUPATI,1141,1208,PUNE-TIRUPATI,2349,All
2023,2,PUNE,TIRUPATI,988,1101,PUNE-TIRUPATI,2089,All
2023,3,PUNE,TIRUPATI,950,940,PUNE-TIRUPATI,1890,All
2016,3,PUNE,TRIVANDRUM,272,270,PUNE-TRIVANDRUM,542,All
2016,4,PUNE,TRIVANDRUM,438,371,PUNE-TRIVANDRUM,809,All
2016,5,PUNE,TRIVANDRUM,542,630,PUNE-TRIVANDRUM,1172,All
2016,6,PUNE,TRIVANDRUM,565,722,PUNE-TRIVANDRUM,1287,All
2016,7,PUNE,TRIVANDRUM,637,658,PUNE-TRIVANDRUM,1295,All
2016,8,PUNE,TRIVANDRUM,737,561,PUNE-TRIVANDRUM,1298,All
2016,9,PUNE,TRIVANDRUM,578,514,PUNE-TRIVANDRUM,1092,All
2016,10,PUNE,TRIVANDRUM,569,385,PUNE-TRIVANDRUM,954,All
2016,11,PUNE,TRIVANDRUM,488,695,PUNE-TRIVANDRUM,1183,All
2016,12,PUNE,TRIVANDRUM,242,225,PUNE-TRIVANDRUM,467,All
2017,1,PUNE,TRIVANDRUM,549,579,PUNE-TRIVANDRUM,1128,All
2017,2,PUNE,TRIVANDRUM,403,422,PUNE-TRIVANDRUM,825,All
2017,12,PUNE,TRIVANDRUM,0,253,PUNE-TRIVANDRUM,253,All
2018,1,PUNE,TRIVANDRUM,0,394,PUNE-TRIVANDRUM,394,All
2018,2,PUNE,TRIVANDRUM,0,619,PUNE-TRIVANDRUM,619,All
2018,3,PUNE,TRIVANDRUM,0,687,PUNE-TRIVANDRUM,687,All
2018,4,PUNE,TRIVANDRUM,0,679,PUNE-TRIVANDRUM,679,All
2018,5,PUNE,TRIVANDRUM,0,794,PUNE-TRIVANDRUM,794,All
2018,6,PUNE,TRIVANDRUM,0,542,PUNE-TRIVANDRUM,542,All
2018,7,PUNE,TRIVANDRUM,0,249,PUNE-TRIVANDRUM,249,All
2018,8,PUNE,TRIVANDRUM,20,552,PUNE-TRIVANDRUM,572,All
2018,9,PUNE,TRIVANDRUM,0,328,PUNE-TRIVANDRUM,328,All
2018,10,PUNE,TRIVANDRUM,0,416,PUNE-TRIVANDRUM,416,All
2018,11,PUNE,TRIVANDRUM,0,908,PUNE-TRIVANDRUM,908,All
2018,12,PUNE,TRIVANDRUM,0,651,PUNE-TRIVANDRUM,651,All
2021,8,PUNE,TRIVANDRUM,181,226,PUNE-TRIVANDRUM,407,All
2021,10,PUNE,TRIVANDRUM,11,0,PUNE-TRIVANDRUM,11,All
2021,11,PUNE,TRIVANDRUM,482,0,PUNE-TRIVANDRUM,482,All
2021,12,PUNE,TRIVANDRUM,2225,1688,PUNE-TRIVANDRUM,3913,All
2022,1,PUNE,TRIVANDRUM,1580,1491,PUNE-TRIVANDRUM,3071,All
2022,3,PUNE,TRIVANDRUM,325,333,PUNE-TRIVANDRUM,658,All
2022,4,PUNE,TRIVANDRUM,2659,2205,PUNE-TRIVANDRUM,4864,All
2022,5,PUNE,TRIVANDRUM,4309,3650,PUNE-TRIVANDRUM,7959,All
2022,10,PUNE,TRIVANDRUM,3313,3388,PUNE-TRIVANDRUM,6701,All
2022,11,PUNE,TRIVANDRUM,3295,3647,PUNE-TRIVANDRUM,6942,All
2022,12,PUNE,TRIVANDRUM,4728,4262,PUNE-TRIVANDRUM,8990,All
2023,1,PUNE,TRIVANDRUM,3454,4347,PUNE-TRIVANDRUM,7801,All
2023,2,PUNE,TRIVANDRUM,3864,3815,PUNE-TRIVANDRUM,7679,All
2023,3,PUNE,TRIVANDRUM,3702,3427,PUNE-TRIVANDRUM,7129,All
2023,4,PUNE,TRIVANDRUM,3875,3414,PUNE-TRIVANDRUM,7289,All
2023,5,PUNE,TRIVANDRUM,4844,4180,PUNE-TRIVANDRUM,9024,All
2023,6,PUNE,TRIVANDRUM,3473,3664,PUNE-TRIVANDRUM,7137,All
2023,7,PUNE,TRIVANDRUM,3801,3434,PUNE-TRIVANDRUM,7235,All
2023,8,PUNE,TRIVANDRUM,4297,4196,PUNE-TRIVANDRUM,8493,All
2023,9,PUNE,TRIVANDRUM,3732,4161,PUNE-TRIVANDRUM,7893,All
2023,10,PUNE,TRIVANDRUM,3713,3899,PUNE-TRIVANDRUM,7612,All
2023,11,PUNE,TRIVANDRUM,4486,4233,PUNE-TRIVANDRUM,8719,All
2023,12,PUNE,TRIVANDRUM,4590,4236,PUNE-TRIVANDRUM,8826,All
2024,1,PUNE,TRIVANDRUM,4119,4469,PUNE-TRIVANDRUM,8588,All
2024,2,PUNE,TRIVANDRUM,3285,4131,PUNE-TRIVANDRUM,7416,All
2024,3,PUNE,TRIVANDRUM,3797,4063,PUNE-TRIVANDRUM,7860,All
2024,10,PUNE,TRIVANDRUM,741,249,PUNE-TRIVANDRUM,990,All
2024,11,PUNE,TRIVANDRUM,2471,3791,PUNE-TRIVANDRUM,6262,All
2024,12,PUNE,TRIVANDRUM,2926,2952,PUNE-TRIVANDRUM,5878,All
2025,1,PUNE,TRIVANDRUM,2381,3156,PUNE-TRIVANDRUM,5537,All
2025,2,PUNE,TRIVANDRUM,2093,2607,PUNE-TRIVANDRUM,4700,All
2025,3,PUNE,TRIVANDRUM,1916,2029,PUNE-TRIVANDRUM,3945,All
2023,1,PUNE,VADODARA,17,0,PUNE-VADODARA,17,All
2023,7,PUNE,VADODARA,1495,1498,PUNE-VADODARA,2993,All
2023,8,PUNE,VADODARA,1465,1555,PUNE-VADODARA,3020,All
2023,9,PUNE,VADODARA,1516,1678,PUNE-VADODARA,3194,All
2023,10,PUNE,VADODARA,1756,1723,PUNE-VADODARA,3479,All
2023,11,PUNE,VADODARA,1211,1026,PUNE-VADODARA,2237,All
2023,12,PUNE,VADODARA,3139,3262,PUNE-VADODARA,6401,All
2024,1,PUNE,VADODARA,3317,3314,PUNE-VADODARA,6631,All
2024,2,PUNE,VADODARA,2885,2988,PUNE-VADODARA,5873,All
2024,3,PUNE,VADODARA,2774,2602,PUNE-VADODARA,5376,All
2024,4,PUNE,VADODARA,1992,1849,PUNE-VADODARA,3841,All
2024,6,PUNE,VADODARA,1670,1594,PUNE-VADODARA,3264,All
2024,7,PUNE,VADODARA,1905,1955,PUNE-VADODARA,3860,All
2024,8,PUNE,VADODARA,1674,1718,PUNE-VADODARA,3392,All
2024,9,PUNE,VADODARA,1828,1743,PUNE-VADODARA,3571,All
2024,10,PUNE,VADODARA,2232,2125,PUNE-VADODARA,4357,All
2024,11,PUNE,VADODARA,1985,2079,PUNE-VADODARA,4064,All
2024,12,PUNE,VADODARA,1986,2051,PUNE-VADODARA,4037,All
2025,1,PUNE,VADODARA,2104,2139,PUNE-VADODARA,4243,All
2025,2,PUNE,VADODARA,1788,1844,PUNE-VADODARA,3632,All
2025,3,PUNE,VADODARA,1753,1796,PUNE-VADODARA,3549,All
2021,1,PUNE,VARANASI,70,0,PUNE-VARANASI,70,All
2021,2,PUNE,VARANASI,8,0,PUNE-VARANASI,8,All
2021,3,PUNE,VARANASI,224,83,PUNE-VARANASI,307,All
2021,4,PUNE,VARANASI,706,332,PUNE-VARANASI,1038,All
2023,3,PUNE,VARANASI,274,104,PUNE-VARANASI,378,All
2023,4,PUNE,VARANASI,4273,3441,PUNE-VARANASI,7714,All
2023,5,PUNE,VARANASI,5246,4697,PUNE-VARANASI,9943,All
2023,6,PUNE,VARANASI,4530,4698,PUNE-VARANASI,9228,All
2023,7,PUNE,VARANASI,3908,4292,PUNE-VARANASI,8200,All
2023,8,PUNE,VARANASI,4488,4338,PUNE-VARANASI,8826,All
2023,9,PUNE,VARANASI,4406,4566,PUNE-VARANASI,8972,All
2023,10,PUNE,VARANASI,5624,4388,PUNE-VARANASI,10012,All
2023,11,PUNE,VARANASI,4377,3377,PUNE-VARANASI,7754,All
2024,2,PUNE,VARANASI,2284,1940,PUNE-VARANASI,4224,All
2024,3,PUNE,VARANASI,5242,4858,PUNE-VARANASI,10100,All
2024,4,PUNE,VARANASI,5215,4741,PUNE-VARANASI,9956,All
2024,6,PUNE,VARANASI,5103,5347,PUNE-VARANASI,10450,All
2024,7,PUNE,VARANASI,5033,5179,PUNE-VARANASI,10212,All
2024,8,PUNE,VARANASI,5227,5156,PUNE-VARANASI,10383,All
2024,9,PUNE,VARANASI,4982,4763,PUNE-VARANASI,9745,All
2024,10,PUNE,VARANASI,5522,4033,PUNE-VARANASI,9555,All
2024,11,PUNE,VARANASI,4539,4459,PUNE-VARANASI,8998,All
2024,12,PUNE,VARANASI,219,232,PUNE-VARANASI,451,All
2025,2,PUNE,VARANASI,2648,2696,PUNE-VARANASI,5344,All
2025,3,PUNE,VARANASI,6493,6266,PUNE-VARANASI,12759,All
2017,9,PUNE,VISAKHAPATNAM,0,63,PUNE-VISAKHAPATNAM,63,All
2017,10,PUNE,VISAKHAPATNAM,0,25,PUNE-VISAKHAPATNAM,25,All
2017,11,PUNE,VISAKHAPATNAM,0,49,PUNE-VISAKHAPATNAM,49,All
2017,12,PUNE,VISAKHAPATNAM,0,40,PUNE-VISAKHAPATNAM,40,All
2018,1,PUNE,VISAKHAPATNAM,0,74,PUNE-VISAKHAPATNAM,74,All
2018,2,PUNE,VISAKHAPATNAM,0,77,PUNE-VISAKHAPATNAM,77,All
2018,3,PUNE,VISAKHAPATNAM,0,63,PUNE-VISAKHAPATNAM,63,All
2018,4,PUNE,VISAKHAPATNAM,0,40,PUNE-VISAKHAPATNAM,40,All
2018,5,PUNE,VISAKHAPATNAM,0,43,PUNE-VISAKHAPATNAM,43,All
2018,6,PUNE,VISAKHAPATNAM,0,69,PUNE-VISAKHAPATNAM,69,All
2018,7,PUNE,VISAKHAPATNAM,0,49,PUNE-VISAKHAPATNAM,49,All
2018,8,PUNE,VISAKHAPATNAM,0,57,PUNE-VISAKHAPATNAM,57,All
2018,9,PUNE,VISAKHAPATNAM,0,45,PUNE-VISAKHAPATNAM,45,All
2018,10,PUNE,VISAKHAPATNAM,74,99,PUNE-VISAKHAPATNAM,173,All
2018,11,PUNE,VISAKHAPATNAM,0,37,PUNE-VISAKHAPATNAM,37,All
2018,12,PUNE,VISAKHAPATNAM,0,76,PUNE-VISAKHAPATNAM,76,All
2019,1,PUNE,VISAKHAPATNAM,0,37,PUNE-VISAKHAPATNAM,37,All
2019,3,PUNE,VISAKHAPATNAM,0,96,PUNE-VISAKHAPATNAM,96,All
2022,3,PUNE,VISAKHAPATNAM,88,65,PUNE-VISAKHAPATNAM,153,All
2022,4,PUNE,VISAKHAPATNAM,1270,1178,PUNE-VISAKHAPATNAM,2448,All
2022,5,PUNE,VISAKHAPATNAM,1396,1299,PUNE-VISAKHAPATNAM,2695,All
2022,10,PUNE,VISAKHAPATNAM,1190,728,PUNE-VISAKHAPATNAM,1918,All
2022,11,PUNE,VISAKHAPATNAM,490,622,PUNE-VISAKHAPATNAM,1112,All
2022,12,PUNE,VISAKHAPATNAM,996,1078,PUNE-VISAKHAPATNAM,2074,All
2023,1,PUNE,VISAKHAPATNAM,696,973,PUNE-VISAKHAPATNAM,1669,All
2023,2,PUNE,VISAKHAPATNAM,905,1033,PUNE-VISAKHAPATNAM,1938,All
2023,3,PUNE,VISAKHAPATNAM,877,967,PUNE-VISAKHAPATNAM,1844,All
2023,4,PUNE,VISAKHAPATNAM,1181,1023,PUNE-VISAKHAPATNAM,2204,All
2023,5,PUNE,VISAKHAPATNAM,1849,1799,PUNE-VISAKHAPATNAM,3648,All
2023,6,PUNE,VISAKHAPATNAM,1585,1600,PUNE-VISAKHAPATNAM,3185,All
2023,7,PUNE,VISAKHAPATNAM,1423,1494,PUNE-VISAKHAPATNAM,2917,All
2023,8,PUNE,VISAKHAPATNAM,1947,1742,PUNE-VISAKHAPATNAM,3689,All
2023,9,PUNE,VISAKHAPATNAM,1827,1999,PUNE-VISAKHAPATNAM,3826,All
2023,10,PUNE,VISAKHAPATNAM,2448,2509,PUNE-VISAKHAPATNAM,4957,All
2023,11,PUNE,VISAKHAPATNAM,904,1018,PUNE-VISAKHAPATNAM,1922,All
2023,12,PUNE,VISAKHAPATNAM,2013,1922,PUNE-VISAKHAPATNAM,3935,All
2024,1,PUNE,VISAKHAPATNAM,2158,2332,PUNE-VISAKHAPATNAM,4490,All
2024,2,PUNE,VISAKHAPATNAM,1911,1801,PUNE-VISAKHAPATNAM,3712,All
2024,3,PUNE,VISAKHAPATNAM,1710,1620,PUNE-VISAKHAPATNAM,3330,All
2024,4,PUNE,VISAKHAPATNAM,1509,1971,PUNE-VISAKHAPATNAM,3480,All
2024,6,PUNE,VISAKHAPATNAM,1543,1701,PUNE-VISAKHAPATNAM,3244,All
2024,7,PUNE,VISAKHAPATNAM,1620,1736,PUNE-VISAKHAPATNAM,3356,All
2024,8,PUNE,VISAKHAPATNAM,1715,1677,PUNE-VISAKHAPATNAM,3392,All
2024,9,PUNE,VISAKHAPATNAM,1305,1252,PUNE-VISAKHAPATNAM,2557,All
2024,10,PUNE,VISAKHAPATNAM,1814,1479,PUNE-VISAKHAPATNAM,3293,All
2024,12,RAIPUR,Ambikapur Airport,43,28,Ambikapur Airport-RAIPUR,71,All
2025,1,RAIPUR,Ambikapur Airport,81,77,Ambikapur Airport-RAIPUR,158,All
2025,2,RAIPUR,Ambikapur Airport,40,49,Ambikapur Airport-RAIPUR,89,All
2025,3,RAIPUR,Ambikapur Airport,50,52,Ambikapur Airport-RAIPUR,102,All
2019,5,RAIPUR,RANCHI,1476,1418,RAIPUR-RANCHI,2894,All
2019,6,RAIPUR,RANCHI,1190,1530,RAIPUR-RANCHI,2720,All
2019,7,RAIPUR,RANCHI,1174,1274,RAIPUR-RANCHI,2448,All
2019,8,RAIPUR,RANCHI,1160,1210,RAIPUR-RANCHI,2370,All
2019,9,RAIPUR,RANCHI,1151,1072,RAIPUR-RANCHI,2223,All
2019,10,RAIPUR,RANCHI,1240,1218,RAIPUR-RANCHI,2458,All
2019,11,RAIPUR,RANCHI,1054,1356,RAIPUR-RANCHI,2410,All
2019,12,RAIPUR,RANCHI,1145,1300,RAIPUR-RANCHI,2445,All
2020,1,RAIPUR,RANCHI,1097,1110,RAIPUR-RANCHI,2207,All
2020,2,RAIPUR,RANCHI,557,521,RAIPUR-RANCHI,1078,All
2020,3,RAIPUR,RANCHI,391,348,RAIPUR-RANCHI,739,All
2021,10,RAIPUR,RANCHI,0,6,RAIPUR-RANCHI,6,All
2024,2,RAIPUR,RANCHI,140,0,RAIPUR-RANCHI,140,All
2018,4,RAIPUR,SRINAGAR,52,0,RAIPUR-SRINAGAR,52,All
2018,5,RAIPUR,SRINAGAR,73,0,RAIPUR-SRINAGAR,73,All
2018,6,RAIPUR,SRINAGAR,7,0,RAIPUR-SRINAGAR,7,All
2018,7,RAIPUR,SRINAGAR,18,0,RAIPUR-SRINAGAR,18,All
2018,8,RAIPUR,SRINAGAR,74,0,RAIPUR-SRINAGAR,74,All
2018,9,RAIPUR,SRINAGAR,116,0,RAIPUR-SRINAGAR,116,All
2018,10,RAIPUR,SRINAGAR,158,0,RAIPUR-SRINAGAR,158,All
2018,11,RAIPUR,SRINAGAR,188,0,RAIPUR-SRINAGAR,188,All
2018,12,RAIPUR,SRINAGAR,141,0,RAIPUR-SRINAGAR,141,All
2019,1,RAIPUR,SRINAGAR,116,0,RAIPUR-SRINAGAR,116,All
2019,2,RAIPUR,SRINAGAR,43,0,RAIPUR-SRINAGAR,43,All
2019,3,RAIPUR,SRINAGAR,78,0,RAIPUR-SRINAGAR,78,All
2019,4,RAIPUR,SRINAGAR,48,0,RAIPUR-SRINAGAR,48,All
2019,5,RAIPUR,SRINAGAR,130,0,RAIPUR-SRINAGAR,130,All
2019,6,RAIPUR,SRINAGAR,170,0,RAIPUR-SRINAGAR,170,All
2019,7,RAIPUR,SRINAGAR,385,0,RAIPUR-SRINAGAR,385,All
2019,8,RAIPUR,SRINAGAR,63,0,RAIPUR-SRINAGAR,63,All
2019,9,RAIPUR,SRINAGAR,39,0,RAIPUR-SRINAGAR,39,All
2019,10,RAIPUR,SRINAGAR,83,0,RAIPUR-SRINAGAR,83,All
2019,11,RAIPUR,SRINAGAR,200,0,RAIPUR-SRINAGAR,200,All
2019,12,RAIPUR,SRINAGAR,169,0,RAIPUR-SRINAGAR,169,All
2020,1,RAIPUR,SRINAGAR,95,0,RAIPUR-SRINAGAR,95,All
2020,2,RAIPUR,SRINAGAR,60,0,RAIPUR-SRINAGAR,60,All
2020,3,RAIPUR,SRINAGAR,114,0,RAIPUR-SRINAGAR,114,All
2020,5,RAIPUR,SRINAGAR,16,0,RAIPUR-SRINAGAR,16,All
2020,6,RAIPUR,SRINAGAR,83,0,RAIPUR-SRINAGAR,83,All
2020,8,RAIPUR,SRINAGAR,0,2,RAIPUR-SRINAGAR,2,All
2020,9,RAIPUR,SRINAGAR,0,3,RAIPUR-SRINAGAR,3,All
2020,10,RAIPUR,SRINAGAR,0,3,RAIPUR-SRINAGAR,3,All
2022,3,RAIPUR,SRINAGAR,16,16,RAIPUR-SRINAGAR,32,All
2022,4,RAIPUR,SRINAGAR,517,410,RAIPUR-SRINAGAR,927,All
2022,5,RAIPUR,SRINAGAR,922,950,RAIPUR-SRINAGAR,1872,All
2022,6,RAIPUR,SRINAGAR,1218,1182,RAIPUR-SRINAGAR,2400,All
2022,7,RAIPUR,SRINAGAR,1005,956,RAIPUR-SRINAGAR,1961,All
2022,8,RAIPUR,SRINAGAR,299,522,RAIPUR-SRINAGAR,821,All
2022,9,RAIPUR,SRINAGAR,368,396,RAIPUR-SRINAGAR,764,All
2022,10,RAIPUR,SRINAGAR,560,498,RAIPUR-SRINAGAR,1058,All
2018,11,RAIPUR,TRIVANDRUM,17,19,RAIPUR-TRIVANDRUM,36,All
2019,6,RAIPUR,TRIVANDRUM,149,0,RAIPUR-TRIVANDRUM,149,All
2019,7,RAIPUR,TRIVANDRUM,215,0,RAIPUR-TRIVANDRUM,215,All
2019,8,RAIPUR,TRIVANDRUM,303,0,RAIPUR-TRIVANDRUM,303,All
2019,10,RAIPUR,TRIVANDRUM,380,0,RAIPUR-TRIVANDRUM,380,All
2021,12,RAIPUR,TRIVANDRUM,295,303,RAIPUR-TRIVANDRUM,598,All
2022,1,RAIPUR,TRIVANDRUM,104,156,RAIPUR-TRIVANDRUM,260,All
2022,3,RAIPUR,TRIVANDRUM,30,46,RAIPUR-TRIVANDRUM,76,All
2020,11,RAIPUR,UDAIPUR,45,0,RAIPUR-UDAIPUR,45,All
2021,11,RAIPUR,UDAIPUR,124,114,RAIPUR-UDAIPUR,238,All
2024,6,RAIPUR,Utkela,12,17,RAIPUR-Utkela,29,All
2024,7,RAIPUR,Utkela,7,9,RAIPUR-Utkela,16,All
2024,8,RAIPUR,Utkela,7,13,RAIPUR-Utkela,20,All
2024,9,RAIPUR,Utkela,8,9,RAIPUR-Utkela,17,All
2024,10,RAIPUR,Utkela,14,13,RAIPUR-Utkela,27,All
2024,11,RAIPUR,Utkela,8,9,RAIPUR-Utkela,17,All
2024,12,RAIPUR,Utkela,25,17,RAIPUR-Utkela,42,All
2025,1,RAIPUR,Utkela,13,12,RAIPUR-Utkela,25,All
2025,2,RAIPUR,Utkela,15,23,RAIPUR-Utkela,38,All
2025,3,RAIPUR,Utkela,14,10,RAIPUR-Utkela,24,All
2018,3,RAIPUR,VARANASI,0,36,RAIPUR-VARANASI,36,All
2019,2,RAIPUR,VARANASI,4,6,RAIPUR-VARANASI,10,All
2019,3,RAIPUR,VARANASI,31,16,RAIPUR-VARANASI,47,All
2023,2,RAIPUR,VARANASI,4,1,RAIPUR-VARANASI,5,All
2023,4,RAIPUR,VARANASI,0,157,RAIPUR-VARANASI,157,All
2023,6,RAIPUR,VARANASI,15,0,RAIPUR-VARANASI,15,All
2023,12,RAIPUR,VARANASI,170,0,RAIPUR-VARANASI,170,All
2015,4,RAIPUR,VISAKHAPATNAM,230,0,RAIPUR-VISAKHAPATNAM,230,All
2015,5,RAIPUR,VISAKHAPATNAM,312,0,RAIPUR-VISAKHAPATNAM,312,All
2015,6,RAIPUR,VISAKHAPATNAM,258,0,RAIPUR-VISAKHAPATNAM,258,All
2015,7,RAIPUR,VISAKHAPATNAM,272,0,RAIPUR-VISAKHAPATNAM,272,All
2015,8,RAIPUR,VISAKHAPATNAM,527,0,RAIPUR-VISAKHAPATNAM,527,All
2015,9,RAIPUR,VISAKHAPATNAM,582,0,RAIPUR-VISAKHAPATNAM,582,All
2015,10,RAIPUR,VISAKHAPATNAM,3456,0,RAIPUR-VISAKHAPATNAM,3456,All
2015,11,RAIPUR,VISAKHAPATNAM,370,0,RAIPUR-VISAKHAPATNAM,370,All
2015,12,RAIPUR,VISAKHAPATNAM,413,0,RAIPUR-VISAKHAPATNAM,413,All
2016,1,RAIPUR,VISAKHAPATNAM,390,0,RAIPUR-VISAKHAPATNAM,390,All
2016,2,RAIPUR,VISAKHAPATNAM,353,0,RAIPUR-VISAKHAPATNAM,353,All
2016,3,RAIPUR,VISAKHAPATNAM,339,0,RAIPUR-VISAKHAPATNAM,339,All
2016,4,RAIPUR,VISAKHAPATNAM,312,0,RAIPUR-VISAKHAPATNAM,312,All
2016,5,RAIPUR,VISAKHAPATNAM,272,0,RAIPUR-VISAKHAPATNAM,272,All
2016,6,RAIPUR,VISAKHAPATNAM,366,0,RAIPUR-VISAKHAPATNAM,366,All
2016,7,RAIPUR,VISAKHAPATNAM,482,0,RAIPUR-VISAKHAPATNAM,482,All
2016,8,RAIPUR,VISAKHAPATNAM,574,0,RAIPUR-VISAKHAPATNAM,574,All
2016,9,RAIPUR,VISAKHAPATNAM,392,0,RAIPUR-VISAKHAPATNAM,392,All
2016,10,RAIPUR,VISAKHAPATNAM,459,0,RAIPUR-VISAKHAPATNAM,459,All
2016,11,RAIPUR,VISAKHAPATNAM,609,0,RAIPUR-VISAKHAPATNAM,609,All
2016,12,RAIPUR,VISAKHAPATNAM,715,0,RAIPUR-VISAKHAPATNAM,715,All
2017,1,RAIPUR,VISAKHAPATNAM,733,0,RAIPUR-VISAKHAPATNAM,733,All
2017,2,RAIPUR,VISAKHAPATNAM,504,0,RAIPUR-VISAKHAPATNAM,504,All
2017,3,RAIPUR,VISAKHAPATNAM,428,0,RAIPUR-VISAKHAPATNAM,428,All
2017,4,RAIPUR,VISAKHAPATNAM,211,178,RAIPUR-VISAKHAPATNAM,389,All
2017,5,RAIPUR,VISAKHAPATNAM,302,274,RAIPUR-VISAKHAPATNAM,576,All
2017,7,RAIPUR,VISAKHAPATNAM,1276,0,RAIPUR-VISAKHAPATNAM,1276,All
2017,8,RAIPUR,VISAKHAPATNAM,1132,0,RAIPUR-VISAKHAPATNAM,1132,All
2017,9,RAIPUR,VISAKHAPATNAM,1088,0,RAIPUR-VISAKHAPATNAM,1088,All
2017,10,RAIPUR,VISAKHAPATNAM,710,0,RAIPUR-VISAKHAPATNAM,710,All
2017,11,RAIPUR,VISAKHAPATNAM,520,0,RAIPUR-VISAKHAPATNAM,520,All
2017,12,RAIPUR,VISAKHAPATNAM,875,0,RAIPUR-VISAKHAPATNAM,875,All
2018,1,RAIPUR,VISAKHAPATNAM,1032,0,RAIPUR-VISAKHAPATNAM,1032,All
2018,2,RAIPUR,VISAKHAPATNAM,1090,0,RAIPUR-VISAKHAPATNAM,1090,All
2018,3,RAIPUR,VISAKHAPATNAM,1283,0,RAIPUR-VISAKHAPATNAM,1283,All
2018,4,RAIPUR,VISAKHAPATNAM,996,0,RAIPUR-VISAKHAPATNAM,996,All
2018,5,RAIPUR,VISAKHAPATNAM,1232,0,RAIPUR-VISAKHAPATNAM,1232,All
2018,6,RAIPUR,VISAKHAPATNAM,1054,0,RAIPUR-VISAKHAPATNAM,1054,All
2018,7,RAIPUR,VISAKHAPATNAM,1171,0,RAIPUR-VISAKHAPATNAM,1171,All
2018,8,RAIPUR,VISAKHAPATNAM,1248,0,RAIPUR-VISAKHAPATNAM,1248,All
2018,9,RAIPUR,VISAKHAPATNAM,1122,0,RAIPUR-VISAKHAPATNAM,1122,All
2018,10,RAIPUR,VISAKHAPATNAM,897,0,RAIPUR-VISAKHAPATNAM,897,All
2018,11,RAIPUR,VISAKHAPATNAM,769,0,RAIPUR-VISAKHAPATNAM,769,All
2018,12,RAIPUR,VISAKHAPATNAM,965,0,RAIPUR-VISAKHAPATNAM,965,All
2019,1,RAIPUR,VISAKHAPATNAM,1000,0,RAIPUR-VISAKHAPATNAM,1000,All
2019,2,RAIPUR,VISAKHAPATNAM,856,0,RAIPUR-VISAKHAPATNAM,856,All
2019,3,RAIPUR,VISAKHAPATNAM,764,0,RAIPUR-VISAKHAPATNAM,764,All
2019,4,RAIPUR,VISAKHAPATNAM,577,0,RAIPUR-VISAKHAPATNAM,577,All
2019,5,RAIPUR,VISAKHAPATNAM,695,0,RAIPUR-VISAKHAPATNAM,695,All
2019,6,RAIPUR,VISAKHAPATNAM,730,0,RAIPUR-VISAKHAPATNAM,730,All
2019,7,RAIPUR,VISAKHAPATNAM,487,0,RAIPUR-VISAKHAPATNAM,487,All
2019,8,RAIPUR,VISAKHAPATNAM,619,0,RAIPUR-VISAKHAPATNAM,619,All
2019,9,RAIPUR,VISAKHAPATNAM,476,0,RAIPUR-VISAKHAPATNAM,476,All
2019,10,RAIPUR,VISAKHAPATNAM,754,0,RAIPUR-VISAKHAPATNAM,754,All
2019,11,RAIPUR,VISAKHAPATNAM,545,0,RAIPUR-VISAKHAPATNAM,545,All
2019,12,RAIPUR,VISAKHAPATNAM,801,0,RAIPUR-VISAKHAPATNAM,801,All
2020,1,RAIPUR,VISAKHAPATNAM,520,0,RAIPUR-VISAKHAPATNAM,520,All
2020,2,RAIPUR,VISAKHAPATNAM,669,0,RAIPUR-VISAKHAPATNAM,669,All
2020,3,RAIPUR,VISAKHAPATNAM,591,0,RAIPUR-VISAKHAPATNAM,591,All
2020,9,RAIPUR,VISAKHAPATNAM,0,2,RAIPUR-VISAKHAPATNAM,2,All
2020,11,RAIPUR,VISAKHAPATNAM,174,0,RAIPUR-VISAKHAPATNAM,174,All
2020,12,RAIPUR,VISAKHAPATNAM,369,0,RAIPUR-VISAKHAPATNAM,369,All
2021,1,RAIPUR,VISAKHAPATNAM,538,0,RAIPUR-VISAKHAPATNAM,538,All
2021,2,RAIPUR,VISAKHAPATNAM,434,0,RAIPUR-VISAKHAPATNAM,434,All
2021,3,RAIPUR,VISAKHAPATNAM,415,0,RAIPUR-VISAKHAPATNAM,415,All
2021,4,RAIPUR,VISAKHAPATNAM,346,0,RAIPUR-VISAKHAPATNAM,346,All
2021,6,RAIPUR,VISAKHAPATNAM,245,0,RAIPUR-VISAKHAPATNAM,245,All
2021,7,RAIPUR,VISAKHAPATNAM,402,0,RAIPUR-VISAKHAPATNAM,402,All
2021,8,RAIPUR,VISAKHAPATNAM,545,0,RAIPUR-VISAKHAPATNAM,545,All
2021,9,RAIPUR,VISAKHAPATNAM,462,0,RAIPUR-VISAKHAPATNAM,462,All
2021,10,RAIPUR,VISAKHAPATNAM,545,0,RAIPUR-VISAKHAPATNAM,545,All
2021,11,RAIPUR,VISAKHAPATNAM,683,0,RAIPUR-VISAKHAPATNAM,683,All
2021,12,RAIPUR,VISAKHAPATNAM,892,0,RAIPUR-VISAKHAPATNAM,892,All
2022,1,RAIPUR,VISAKHAPATNAM,418,0,RAIPUR-VISAKHAPATNAM,418,All
2022,2,RAIPUR,VISAKHAPATNAM,455,0,RAIPUR-VISAKHAPATNAM,455,All
2022,3,RAIPUR,VISAKHAPATNAM,921,0,RAIPUR-VISAKHAPATNAM,921,All
2022,4,RAIPUR,VISAKHAPATNAM,474,0,RAIPUR-VISAKHAPATNAM,474,All
2022,5,RAIPUR,VISAKHAPATNAM,433,0,RAIPUR-VISAKHAPATNAM,433,All
2022,6,RAIPUR,VISAKHAPATNAM,400,0,RAIPUR-VISAKHAPATNAM,400,All
2022,7,RAIPUR,VISAKHAPATNAM,402,0,RAIPUR-VISAKHAPATNAM,402,All
2022,8,RAIPUR,VISAKHAPATNAM,368,0,RAIPUR-VISAKHAPATNAM,368,All
2022,9,RAIPUR,VISAKHAPATNAM,375,0,RAIPUR-VISAKHAPATNAM,375,All
2022,10,RAIPUR,VISAKHAPATNAM,489,0,RAIPUR-VISAKHAPATNAM,489,All
2022,11,RAIPUR,VISAKHAPATNAM,574,0,RAIPUR-VISAKHAPATNAM,574,All
2022,12,RAIPUR,VISAKHAPATNAM,742,0,RAIPUR-VISAKHAPATNAM,742,All
2023,1,RAIPUR,VISAKHAPATNAM,680,0,RAIPUR-VISAKHAPATNAM,680,All
2023,2,RAIPUR,VISAKHAPATNAM,246,0,RAIPUR-VISAKHAPATNAM,246,All
2025,3,RAIPUR,VISAKHAPATNAM,29,56,RAIPUR-VISAKHAPATNAM,85,All
2025,3,RAJAHMUNDRY,TIRUCHIRAPALLY,8,1,RAJAHMUNDRY-TIRUCHIRAPALLY,9,All
2021,3,RAJAHMUNDRY,TIRUPATI,67,65,RAJAHMUNDRY-TIRUPATI,132,All
2021,4,RAJAHMUNDRY,TIRUPATI,287,259,RAJAHMUNDRY-TIRUPATI,546,All
2021,10,RAJAHMUNDRY,TIRUPATI,24,13,RAJAHMUNDRY-TIRUPATI,37,All
2021,11,RAJAHMUNDRY,TIRUPATI,716,794,RAJAHMUNDRY-TIRUPATI,1510,All
2021,12,RAJAHMUNDRY,TIRUPATI,1243,1386,RAJAHMUNDRY-TIRUPATI,2629,All
2022,1,RAJAHMUNDRY,TIRUPATI,651,698,RAJAHMUNDRY-TIRUPATI,1349,All
2022,3,RAJAHMUNDRY,TIRUPATI,75,68,RAJAHMUNDRY-TIRUPATI,143,All
2022,4,RAJAHMUNDRY,TIRUPATI,638,526,RAJAHMUNDRY-TIRUPATI,1164,All
2022,5,RAJAHMUNDRY,TIRUPATI,667,533,RAJAHMUNDRY-TIRUPATI,1200,All
2022,6,RAJAHMUNDRY,TIRUPATI,681,554,RAJAHMUNDRY-TIRUPATI,1235,All
2022,7,RAJAHMUNDRY,TIRUPATI,682,547,RAJAHMUNDRY-TIRUPATI,1229,All
2022,8,RAJAHMUNDRY,TIRUPATI,678,555,RAJAHMUNDRY-TIRUPATI,1233,All
2022,9,RAJAHMUNDRY,TIRUPATI,480,369,RAJAHMUNDRY-TIRUPATI,849,All
2022,10,RAJAHMUNDRY,TIRUPATI,424,406,RAJAHMUNDRY-TIRUPATI,830,All
2018,6,RAJAHMUNDRY,VIJAYAWADA,0,33,RAJAHMUNDRY-VIJAYAWADA,33,All
2019,10,RAJAHMUNDRY,VIJAYAWADA,0,68,RAJAHMUNDRY-VIJAYAWADA,68,All
2022,9,RAJAHMUNDRY,VIJAYAWADA,0,51,RAJAHMUNDRY-VIJAYAWADA,51,All
2023,3,RAJAHMUNDRY,VIJAYAWADA,4,0,RAJAHMUNDRY-VIJAYAWADA,4,All
2023,8,RAJAHMUNDRY,VIJAYAWADA,0,57,RAJAHMUNDRY-VIJAYAWADA,57,All
2025,2,RAJAHMUNDRY,VIJAYAWADA,69,0,RAJAHMUNDRY-VIJAYAWADA,69,All
2019,9,RAJAHMUNDRY,VISAKHAPATNAM,439,387,RAJAHMUNDRY-VISAKHAPATNAM,826,All
2019,10,RAJAHMUNDRY,VISAKHAPATNAM,1165,950,RAJAHMUNDRY-VISAKHAPATNAM,2115,All
2019,11,RAJAHMUNDRY,VISAKHAPATNAM,910,794,RAJAHMUNDRY-VISAKHAPATNAM,1704,All
2019,12,RAJAHMUNDRY,VISAKHAPATNAM,1219,1045,RAJAHMUNDRY-VISAKHAPATNAM,2264,All
2020,1,RAJAHMUNDRY,VISAKHAPATNAM,1077,916,RAJAHMUNDRY-VISAKHAPATNAM,1993,All
2020,2,RAJAHMUNDRY,VISAKHAPATNAM,907,585,RAJAHMUNDRY-VISAKHAPATNAM,1492,All
2020,3,RAJAHMUNDRY,VISAKHAPATNAM,519,508,RAJAHMUNDRY-VISAKHAPATNAM,1027,All
2021,3,RAJAHMUNDRY,VISAKHAPATNAM,32,37,RAJAHMUNDRY-VISAKHAPATNAM,69,All
2021,4,RAJAHMUNDRY,VISAKHAPATNAM,85,83,RAJAHMUNDRY-VISAKHAPATNAM,168,All
2021,10,RAJAHMUNDRY,VISAKHAPATNAM,21,14,RAJAHMUNDRY-VISAKHAPATNAM,35,All
2021,11,RAJAHMUNDRY,VISAKHAPATNAM,556,540,RAJAHMUNDRY-VISAKHAPATNAM,1096,All
2021,12,RAJAHMUNDRY,VISAKHAPATNAM,1340,758,RAJAHMUNDRY-VISAKHAPATNAM,2098,All
2022,1,RAJAHMUNDRY,VISAKHAPATNAM,694,447,RAJAHMUNDRY-VISAKHAPATNAM,1141,All
2022,2,RAJAHMUNDRY,VISAKHAPATNAM,341,364,RAJAHMUNDRY-VISAKHAPATNAM,705,All
2022,3,RAJAHMUNDRY,VISAKHAPATNAM,473,574,RAJAHMUNDRY-VISAKHAPATNAM,1047,All
2022,4,RAJAHMUNDRY,VISAKHAPATNAM,698,494,RAJAHMUNDRY-VISAKHAPATNAM,1192,All
2022,5,RAJAHMUNDRY,VISAKHAPATNAM,759,562,RAJAHMUNDRY-VISAKHAPATNAM,1321,All
2022,6,RAJAHMUNDRY,VISAKHAPATNAM,645,496,RAJAHMUNDRY-VISAKHAPATNAM,1141,All
2022,7,RAJAHMUNDRY,VISAKHAPATNAM,440,450,RAJAHMUNDRY-VISAKHAPATNAM,890,All
2022,8,RAJAHMUNDRY,VISAKHAPATNAM,542,447,RAJAHMUNDRY-VISAKHAPATNAM,989,All
2022,9,RAJAHMUNDRY,VISAKHAPATNAM,343,337,RAJAHMUNDRY-VISAKHAPATNAM,680,All
2022,10,RAJAHMUNDRY,VISAKHAPATNAM,491,359,RAJAHMUNDRY-VISAKHAPATNAM,850,All
2022,11,RAJAHMUNDRY,VISAKHAPATNAM,349,340,RAJAHMUNDRY-VISAKHAPATNAM,689,All
2022,12,RAJAHMUNDRY,VISAKHAPATNAM,629,622,RAJAHMUNDRY-VISAKHAPATNAM,1251,All
2023,1,RAJAHMUNDRY,VISAKHAPATNAM,598,664,RAJAHMUNDRY-VISAKHAPATNAM,1262,All
2023,2,RAJAHMUNDRY,VISAKHAPATNAM,665,613,RAJAHMUNDRY-VISAKHAPATNAM,1278,All
2023,3,RAJAHMUNDRY,VISAKHAPATNAM,618,482,RAJAHMUNDRY-VISAKHAPATNAM,1100,All
2023,4,RAJAHMUNDRY,VISAKHAPATNAM,409,407,RAJAHMUNDRY-VISAKHAPATNAM,816,All
2017,3,RAJKOT,SURAT,0,2,RAJKOT-SURAT,2,All
2020,7,RAJKOT,SURAT,11,0,RAJKOT-SURAT,11,All
2020,8,RAJKOT,SURAT,47,0,RAJKOT-SURAT,47,All
2020,9,RAJKOT,SURAT,26,0,RAJKOT-SURAT,26,All
2023,8,RAJKOT,UDAIPUR,315,556,RAJKOT-UDAIPUR,871,All
2023,9,RAJKOT,UDAIPUR,446,375,RAJKOT-UDAIPUR,821,All
2017,10,RANCHI,CHENNAI,34,0,CHENNAI-RANCHI,34,All
2017,11,RANCHI,CHENNAI,135,0,CHENNAI-RANCHI,135,All
2017,12,RANCHI,CHENNAI,43,92,CHENNAI-RANCHI,135,All
2018,1,RANCHI,CHENNAI,74,69,CHENNAI-RANCHI,143,All
2018,2,RANCHI,CHENNAI,64,87,CHENNAI-RANCHI,151,All
2018,3,RANCHI,CHENNAI,78,64,CHENNAI-RANCHI,142,All
2018,4,RANCHI,CHENNAI,48,0,CHENNAI-RANCHI,48,All
2018,5,RANCHI,CHENNAI,148,0,CHENNAI-RANCHI,148,All
2018,6,RANCHI,CHENNAI,106,0,CHENNAI-RANCHI,106,All
2018,7,RANCHI,CHENNAI,103,0,CHENNAI-RANCHI,103,All
2018,8,RANCHI,CHENNAI,101,0,CHENNAI-RANCHI,101,All
2018,9,RANCHI,CHENNAI,89,0,CHENNAI-RANCHI,89,All
2018,10,RANCHI,CHENNAI,123,0,CHENNAI-RANCHI,123,All
2015,5,RANCHI,NAGPUR,30,0,NAGPUR-RANCHI,30,All
2016,10,RANCHI,NAGPUR,0,1,NAGPUR-RANCHI,1,All
2016,11,RANCHI,NAGPUR,0,2,NAGPUR-RANCHI,2,All
2016,12,RANCHI,NAGPUR,0,1,NAGPUR-RANCHI,1,All
2017,5,RANCHI,NAGPUR,7,0,NAGPUR-RANCHI,7,All
2017,6,RANCHI,NAGPUR,42,36,NAGPUR-RANCHI,78,All
2017,7,RANCHI,NAGPUR,81,65,NAGPUR-RANCHI,146,All
2017,8,RANCHI,NAGPUR,27,48,NAGPUR-RANCHI,75,All
2017,9,RANCHI,NAGPUR,21,21,NAGPUR-RANCHI,42,All
2017,10,RANCHI,NAGPUR,0,24,NAGPUR-RANCHI,24,All
2017,11,RANCHI,NAGPUR,25,110,NAGPUR-RANCHI,135,All
2017,12,RANCHI,NAGPUR,0,22,NAGPUR-RANCHI,22,All
2018,1,RANCHI,NAGPUR,0,9,NAGPUR-RANCHI,9,All
2018,2,RANCHI,NAGPUR,0,17,NAGPUR-RANCHI,17,All
2018,3,RANCHI,NAGPUR,0,2,NAGPUR-RANCHI,2,All
2015,4,RANCHI,PATNA,1485,3800,PATNA-RANCHI,5285,All
2015,5,RANCHI,PATNA,1867,5614,PATNA-RANCHI,7481,All
2015,6,RANCHI,PATNA,1847,6340,PATNA-RANCHI,8187,All
2015,7,RANCHI,PATNA,1589,5134,PATNA-RANCHI,6723,All
2015,8,RANCHI,PATNA,1760,4416,PATNA-RANCHI,6176,All
2015,9,RANCHI,PATNA,1673,4913,PATNA-RANCHI,6586,All
2015,10,RANCHI,PATNA,1596,4971,PATNA-RANCHI,6567,All
2015,11,RANCHI,PATNA,1656,5734,PATNA-RANCHI,7390,All
2015,12,RANCHI,PATNA,1576,5363,PATNA-RANCHI,6939,All
2016,1,RANCHI,PATNA,1556,5168,PATNA-RANCHI,6724,All
2016,2,RANCHI,PATNA,1951,5576,PATNA-RANCHI,7527,All
2016,3,RANCHI,PATNA,2327,6708,PATNA-RANCHI,9035,All
2016,4,RANCHI,PATNA,2292,9548,PATNA-RANCHI,11840,All
2016,5,RANCHI,PATNA,2307,9406,PATNA-RANCHI,11713,All
2016,6,RANCHI,PATNA,2012,8872,PATNA-RANCHI,10884,All
2016,7,RANCHI,PATNA,2301,11012,PATNA-RANCHI,13313,All
2016,8,RANCHI,PATNA,2419,9725,PATNA-RANCHI,12144,All
2016,9,RANCHI,PATNA,1802,10327,PATNA-RANCHI,12129,All
2016,10,RANCHI,PATNA,2379,9649,PATNA-RANCHI,12028,All
2016,11,RANCHI,PATNA,3022,11069,PATNA-RANCHI,14091,All
2016,12,RANCHI,PATNA,3135,11273,PATNA-RANCHI,14408,All
2017,1,RANCHI,PATNA,2516,9726,PATNA-RANCHI,12242,All
2017,2,RANCHI,PATNA,2765,8832,PATNA-RANCHI,11597,All
2017,3,RANCHI,PATNA,2628,9153,PATNA-RANCHI,11781,All
2017,4,RANCHI,PATNA,2807,6437,PATNA-RANCHI,9244,All
2017,5,RANCHI,PATNA,2981,9225,PATNA-RANCHI,12206,All
2017,6,RANCHI,PATNA,2499,11487,PATNA-RANCHI,13986,All
2017,7,RANCHI,PATNA,2710,11770,PATNA-RANCHI,14480,All
2017,8,RANCHI,PATNA,3180,10694,PATNA-RANCHI,13874,All
2017,9,RANCHI,PATNA,2132,10902,PATNA-RANCHI,13034,All
2017,10,RANCHI,PATNA,2408,10349,PATNA-RANCHI,12757,All
2017,11,RANCHI,PATNA,3307,13218,PATNA-RANCHI,16525,All
2017,12,RANCHI,PATNA,3048,9025,PATNA-RANCHI,12073,All
2018,1,RANCHI,PATNA,2651,8386,PATNA-RANCHI,11037,All
2018,2,RANCHI,PATNA,2854,11047,PATNA-RANCHI,13901,All
2018,3,RANCHI,PATNA,2876,11303,PATNA-RANCHI,14179,All
2018,4,RANCHI,PATNA,3036,8635,PATNA-RANCHI,11671,All
2018,5,RANCHI,PATNA,3000,7554,PATNA-RANCHI,10554,All
2018,6,RANCHI,PATNA,3215,5229,PATNA-RANCHI,8444,All
2018,7,RANCHI,PATNA,2982,3886,PATNA-RANCHI,6868,All
2018,8,RANCHI,PATNA,2990,4232,PATNA-RANCHI,7222,All
2018,9,RANCHI,PATNA,2404,2595,PATNA-RANCHI,4999,All
2018,10,RANCHI,PATNA,2712,2990,PATNA-RANCHI,5702,All
2018,11,RANCHI,PATNA,2670,3858,PATNA-RANCHI,6528,All
2018,12,RANCHI,PATNA,3640,5289,PATNA-RANCHI,8929,All
2019,1,RANCHI,PATNA,3685,4837,PATNA-RANCHI,8522,All
2019,2,RANCHI,PATNA,4343,5753,PATNA-RANCHI,10096,All
2019,3,RANCHI,PATNA,4244,6076,PATNA-RANCHI,10320,All
2019,4,RANCHI,PATNA,3765,4485,PATNA-RANCHI,8250,All
2018,12,RANCHI,RAIPUR,0,2633,RAIPUR-RANCHI,2633,All
2019,1,RANCHI,RAIPUR,1275,1471,RAIPUR-RANCHI,2746,All
2019,2,RANCHI,RAIPUR,0,2776,RAIPUR-RANCHI,2776,All
2019,3,RANCHI,RAIPUR,1021,1189,RAIPUR-RANCHI,2210,All
2019,4,RANCHI,RAIPUR,1145,1420,RAIPUR-RANCHI,2565,All
2022,8,RANCHI,SHILLONG,0,43,RANCHI-SHILLONG,43,All
2023,4,RANCHI,SHILLONG,0,1,RANCHI-SHILLONG,1,All
2021,12,RANCHI,UDAIPUR,214,201,RANCHI-UDAIPUR,415,All
2023,7,RANCHI,VADODARA,17,0,RANCHI-VADODARA,17,All
2021,3,RANCHI,VARANASI,77,325,RANCHI-VARANASI,402,All
2021,4,RANCHI,VARANASI,322,158,RANCHI-VARANASI,480,All
2021,6,RANCHI,VARANASI,82,0,RANCHI-VARANASI,82,All
2021,7,RANCHI,VARANASI,63,136,RANCHI-VARANASI,199,All
2021,8,RANCHI,VARANASI,99,0,RANCHI-VARANASI,99,All
2021,9,RANCHI,VARANASI,101,229,RANCHI-VARANASI,330,All
2021,10,RANCHI,VARANASI,347,0,RANCHI-VARANASI,347,All
2022,4,RANCHI,VARANASI,79,82,RANCHI-VARANASI,161,All
2022,6,RANCHI,VARANASI,1675,0,RANCHI-VARANASI,1675,All
2022,10,RANCHI,VARANASI,0,159,RANCHI-VARANASI,159,All
2024,6,RANCHI,VARANASI,26,0,RANCHI-VARANASI,26,All
2022,11,RANCHI,VISAKHAPATNAM,12,23,RANCHI-VISAKHAPATNAM,35,All
2022,12,RANCHI,VISAKHAPATNAM,6,23,RANCHI-VISAKHAPATNAM,29,All
2023,1,RANCHI,VISAKHAPATNAM,11,22,RANCHI-VISAKHAPATNAM,33,All
2023,2,RANCHI,VISAKHAPATNAM,18,13,RANCHI-VISAKHAPATNAM,31,All
2023,3,RANCHI,VISAKHAPATNAM,9,21,RANCHI-VISAKHAPATNAM,30,All
2023,4,RANCHI,VISAKHAPATNAM,1,37,RANCHI-VISAKHAPATNAM,38,All
2023,5,RANCHI,VISAKHAPATNAM,6,7,RANCHI-VISAKHAPATNAM,13,All
2023,6,RANCHI,VISAKHAPATNAM,9,32,RANCHI-VISAKHAPATNAM,41,All
2023,7,RANCHI,VISAKHAPATNAM,16,26,RANCHI-VISAKHAPATNAM,42,All
2023,8,RANCHI,VISAKHAPATNAM,9,23,RANCHI-VISAKHAPATNAM,32,All
2023,9,RANCHI,VISAKHAPATNAM,1,2,RANCHI-VISAKHAPATNAM,3,All
2023,9,Rajkot International Airport,BENGALURU,3025,3193,BENGALURU-Rajkot International Airport,6218,All
2023,10,Rajkot International Airport,BENGALURU,4822,4899,BENGALURU-Rajkot International Airport,9721,All
2023,9,Rajkot International Airport,DELHI,6496,6974,DELHI-Rajkot International Airport,13470,All
2023,10,Rajkot International Airport,DELHI,10011,10313,DELHI-Rajkot International Airport,20324,All
2023,9,Rajkot International Airport,INDORE,1017,1142,INDORE-Rajkot International Airport,2159,All
2023,10,Rajkot International Airport,INDORE,1669,1407,INDORE-Rajkot International Airport,3076,All
2023,9,Rajkot International Airport,MUMBAI,14311,15518,MUMBAI-Rajkot International Airport,29829,All
2023,10,Rajkot International Airport,MUMBAI,20822,21290,MUMBAI-Rajkot International Airport,42112,All
2023,9,Rajkot International Airport,PUNE,958,1087,PUNE-Rajkot International Airport,2045,All
2023,10,Rajkot International Airport,PUNE,1575,1730,PUNE-Rajkot International Airport,3305,All
2023,9,Rajkot International Airport,UDAIPUR,776,841,Rajkot International Airport-UDAIPUR,1617,All
2023,10,Rajkot International Airport,UDAIPUR,869,1424,Rajkot International Airport-UDAIPUR,2293,All
2023,11,Rajkot International Airport,UDAIPUR,1300,1609,Rajkot International Airport-UDAIPUR,2909,All
2023,12,Rajkot International Airport,UDAIPUR,448,880,Rajkot International Airport-UDAIPUR,1328,All
2025,2,Rajkot International Airport,UDAIPUR,276,252,Rajkot International Airport-UDAIPUR,528,All
2021,3,SHILLONG,SILCHAR,2,1,SHILLONG-SILCHAR,3,All
2021,4,SHILLONG,SILCHAR,38,49,SHILLONG-SILCHAR,87,All
2021,7,SHILLONG,SILCHAR,45,19,SHILLONG-SILCHAR,64,All
2021,8,SHILLONG,SILCHAR,33,61,SHILLONG-SILCHAR,94,All
2021,9,SHILLONG,SILCHAR,176,151,SHILLONG-SILCHAR,327,All
2021,10,SHILLONG,SILCHAR,433,283,SHILLONG-SILCHAR,716,All
2021,11,SHILLONG,SILCHAR,281,320,SHILLONG-SILCHAR,601,All
2021,12,SHILLONG,SILCHAR,349,349,SHILLONG-SILCHAR,698,All
2022,1,SHILLONG,SILCHAR,221,191,SHILLONG-SILCHAR,412,All
2022,2,SHILLONG,SILCHAR,207,323,SHILLONG-SILCHAR,530,All
2022,3,SHILLONG,SILCHAR,360,545,SHILLONG-SILCHAR,905,All
2022,4,SHILLONG,SILCHAR,221,324,SHILLONG-SILCHAR,545,All
2022,5,SHILLONG,SILCHAR,380,498,SHILLONG-SILCHAR,878,All
2022,6,SHILLONG,SILCHAR,352,576,SHILLONG-SILCHAR,928,All
2022,7,SHILLONG,SILCHAR,615,739,SHILLONG-SILCHAR,1354,All
2022,8,SHILLONG,SILCHAR,260,350,SHILLONG-SILCHAR,610,All
2022,9,SHILLONG,SILCHAR,235,281,SHILLONG-SILCHAR,516,All
2022,10,SHILLONG,SILCHAR,307,416,SHILLONG-SILCHAR,723,All
2022,11,SHILLONG,SILCHAR,362,389,SHILLONG-SILCHAR,751,All
2022,12,SHILLONG,SILCHAR,432,389,SHILLONG-SILCHAR,821,All
2023,1,SHILLONG,SILCHAR,236,283,SHILLONG-SILCHAR,519,All
2023,2,SHILLONG,SILCHAR,170,317,SHILLONG-SILCHAR,487,All
2023,3,SHILLONG,SILCHAR,275,374,SHILLONG-SILCHAR,649,All
2023,4,SHILLONG,SILCHAR,367,451,SHILLONG-SILCHAR,818,All
2023,5,SHILLONG,SILCHAR,347,430,SHILLONG-SILCHAR,777,All
2023,6,SHILLONG,SILCHAR,347,379,SHILLONG-SILCHAR,726,All
2023,7,SHILLONG,SILCHAR,499,593,SHILLONG-SILCHAR,1092,All
2023,8,SHILLONG,SILCHAR,348,403,SHILLONG-SILCHAR,751,All
2023,9,SHILLONG,SILCHAR,356,502,SHILLONG-SILCHAR,858,All
2023,10,SHILLONG,SILCHAR,588,633,SHILLONG-SILCHAR,1221,All
2023,11,SHILLONG,SILCHAR,493,569,SHILLONG-SILCHAR,1062,All
2023,12,SHILLONG,SILCHAR,685,668,SHILLONG-SILCHAR,1353,All
2024,1,SHILLONG,SILCHAR,571,562,SHILLONG-SILCHAR,1133,All
2024,2,SHILLONG,SILCHAR,415,518,SHILLONG-SILCHAR,933,All
2024,3,SHILLONG,SILCHAR,386,530,SHILLONG-SILCHAR,916,All
2022,3,SHIRDI,TIRUPATI,99,107,SHIRDI-TIRUPATI,206,All
2022,4,SHIRDI,TIRUPATI,951,872,SHIRDI-TIRUPATI,1823,All
2022,5,SHIRDI,TIRUPATI,832,893,SHIRDI-TIRUPATI,1725,All
2022,6,SHIRDI,TIRUPATI,921,943,SHIRDI-TIRUPATI,1864,All
2022,7,SHIRDI,TIRUPATI,961,973,SHIRDI-TIRUPATI,1934,All
2022,8,SHIRDI,TIRUPATI,693,709,SHIRDI-TIRUPATI,1402,All
2022,9,SHIRDI,TIRUPATI,546,563,SHIRDI-TIRUPATI,1109,All
2022,10,SHIRDI,TIRUPATI,491,429,SHIRDI-TIRUPATI,920,All
2022,11,SHIRDI,TIRUPATI,426,477,SHIRDI-TIRUPATI,903,All
2022,12,SHIRDI,TIRUPATI,914,917,SHIRDI-TIRUPATI,1831,All
2023,1,SHIRDI,TIRUPATI,462,521,SHIRDI-TIRUPATI,983,All
2023,3,SHIRDI,TIRUPATI,68,49,SHIRDI-TIRUPATI,117,All
2023,4,SHIRDI,TIRUPATI,331,317,SHIRDI-TIRUPATI,648,All
2023,5,SHIRDI,TIRUPATI,359,297,SHIRDI-TIRUPATI,656,All
2023,6,SHIRDI,TIRUPATI,195,285,SHIRDI-TIRUPATI,480,All
2023,7,SHIRDI,TIRUPATI,179,268,SHIRDI-TIRUPATI,447,All
2023,8,SHIRDI,TIRUPATI,386,294,SHIRDI-TIRUPATI,680,All
2023,9,SHIRDI,TIRUPATI,523,417,SHIRDI-TIRUPATI,940,All
2023,10,SHIRDI,TIRUPATI,542,418,SHIRDI-TIRUPATI,960,All
2023,11,SHIRDI,TIRUPATI,616,451,SHIRDI-TIRUPATI,1067,All
2023,12,SHIRDI,TIRUPATI,533,400,SHIRDI-TIRUPATI,933,All
2024,1,SHIRDI,TIRUPATI,552,483,SHIRDI-TIRUPATI,1035,All
2024,2,SHIRDI,TIRUPATI,492,471,SHIRDI-TIRUPATI,963,All
2024,3,SHIRDI,TIRUPATI,451,360,SHIRDI-TIRUPATI,811,All
2024,4,SHIRDI,TIRUPATI,345,302,SHIRDI-TIRUPATI,647,All
2024,6,SHIRDI,TIRUPATI,332,238,SHIRDI-TIRUPATI,570,All
2024,7,SHIRDI,TIRUPATI,362,432,SHIRDI-TIRUPATI,794,All
2024,8,SHIRDI,TIRUPATI,717,646,SHIRDI-TIRUPATI,1363,All
2024,9,SHIRDI,TIRUPATI,776,677,SHIRDI-TIRUPATI,1453,All
2024,10,SHIRDI,TIRUPATI,551,458,SHIRDI-TIRUPATI,1009,All
2024,11,SHIRDI,TIRUPATI,733,533,SHIRDI-TIRUPATI,1266,All
2024,12,SHIRDI,TIRUPATI,612,439,SHIRDI-TIRUPATI,1051,All
2025,3,SHIRDI,TIRUPATI,471,323,SHIRDI-TIRUPATI,794,All
2019,10,SHIRDI,VIJAYAWADA,33,0,SHIRDI-VIJAYAWADA,33,All
2019,11,SHIRDI,VIJAYAWADA,72,0,SHIRDI-VIJAYAWADA,72,All
2019,12,SHIRDI,VIJAYAWADA,128,0,SHIRDI-VIJAYAWADA,128,All
2020,1,SHIRDI,VIJAYAWADA,326,0,SHIRDI-VIJAYAWADA,326,All
2020,2,SHIRDI,VIJAYAWADA,279,0,SHIRDI-VIJAYAWADA,279,All
2020,3,SHIRDI,VIJAYAWADA,129,0,SHIRDI-VIJAYAWADA,129,All
2023,3,SHIRDI,VIJAYAWADA,287,305,SHIRDI-VIJAYAWADA,592,All
2023,4,SHIRDI,VIJAYAWADA,1467,1541,SHIRDI-VIJAYAWADA,3008,All
2023,5,SHIRDI,VIJAYAWADA,1572,1636,SHIRDI-VIJAYAWADA,3208,All
2023,6,SHIRDI,VIJAYAWADA,1413,1536,SHIRDI-VIJAYAWADA,2949,All
2023,7,SHIRDI,VIJAYAWADA,1606,1598,SHIRDI-VIJAYAWADA,3204,All
2023,8,SHIRDI,VIJAYAWADA,1683,1918,SHIRDI-VIJAYAWADA,3601,All
2023,9,SHIRDI,VIJAYAWADA,1084,1403,SHIRDI-VIJAYAWADA,2487,All
2023,10,SHIRDI,VIJAYAWADA,1063,1326,SHIRDI-VIJAYAWADA,2389,All
2023,11,SHIRDI,VIJAYAWADA,1261,1223,SHIRDI-VIJAYAWADA,2484,All
2023,12,SHIRDI,VIJAYAWADA,1430,1478,SHIRDI-VIJAYAWADA,2908,All
2024,1,SHIRDI,VIJAYAWADA,1477,1641,SHIRDI-VIJAYAWADA,3118,All
2024,2,SHIRDI,VIJAYAWADA,1150,1115,SHIRDI-VIJAYAWADA,2265,All
2024,3,SHIRDI,VIJAYAWADA,1318,1414,SHIRDI-VIJAYAWADA,2732,All
2024,4,SHIRDI,VIJAYAWADA,1293,1378,SHIRDI-VIJAYAWADA,2671,All
2024,6,SHIRDI,VIJAYAWADA,1430,1528,SHIRDI-VIJAYAWADA,2958,All
2024,7,SHIRDI,VIJAYAWADA,1425,1454,SHIRDI-VIJAYAWADA,2879,All
2024,8,SHIRDI,VIJAYAWADA,1353,1394,SHIRDI-VIJAYAWADA,2747,All
2024,9,SHIRDI,VIJAYAWADA,1048,1206,SHIRDI-VIJAYAWADA,2254,All
2024,10,SHIRDI,VIJAYAWADA,1290,1290,SHIRDI-VIJAYAWADA,2580,All
2024,11,SHIRDI,VIJAYAWADA,1110,1322,SHIRDI-VIJAYAWADA,2432,All
2024,12,SHIRDI,VIJAYAWADA,1446,1486,SHIRDI-VIJAYAWADA,2932,All
2025,1,SHIRDI,VIJAYAWADA,1409,1544,SHIRDI-VIJAYAWADA,2953,All
2025,2,SHIRDI,VIJAYAWADA,1378,1369,SHIRDI-VIJAYAWADA,2747,All
2025,3,SHIRDI,VIJAYAWADA,1372,1487,SHIRDI-VIJAYAWADA,2859,All
2022,3,SHIRDI,VISAKHAPATNAM,8,0,SHIRDI-VISAKHAPATNAM,8,All
2022,4,SHIRDI,VISAKHAPATNAM,114,0,SHIRDI-VISAKHAPATNAM,114,All
2022,5,SHIRDI,VISAKHAPATNAM,137,0,SHIRDI-VISAKHAPATNAM,137,All
2022,6,SHIRDI,VISAKHAPATNAM,93,0,SHIRDI-VISAKHAPATNAM,93,All
2022,7,SHIRDI,VISAKHAPATNAM,68,0,SHIRDI-VISAKHAPATNAM,68,All
2022,8,SHIRDI,VISAKHAPATNAM,70,0,SHIRDI-VISAKHAPATNAM,70,All
2022,9,SHIRDI,VISAKHAPATNAM,25,0,SHIRDI-VISAKHAPATNAM,25,All
2022,11,SHIRDI,VISAKHAPATNAM,0,105,SHIRDI-VISAKHAPATNAM,105,All
2022,12,SHIRDI,VISAKHAPATNAM,0,103,SHIRDI-VISAKHAPATNAM,103,All
2023,1,SHIRDI,VISAKHAPATNAM,0,125,SHIRDI-VISAKHAPATNAM,125,All
2023,2,SHIRDI,VISAKHAPATNAM,0,127,SHIRDI-VISAKHAPATNAM,127,All
2023,3,SHIRDI,VISAKHAPATNAM,0,64,SHIRDI-VISAKHAPATNAM,64,All
2023,4,SHIRDI,VISAKHAPATNAM,0,55,SHIRDI-VISAKHAPATNAM,55,All
2023,5,SHIRDI,VISAKHAPATNAM,0,37,SHIRDI-VISAKHAPATNAM,37,All
2018,9,SILCHAR,PUNE,43,0,PUNE-SILCHAR,43,All
2018,10,SILCHAR,PUNE,70,0,PUNE-SILCHAR,70,All
2018,11,SILCHAR,PUNE,96,0,PUNE-SILCHAR,96,All
2015,4,SILCHAR,TEZPUR,158,280,SILCHAR-TEZPUR,438,All
2015,5,SILCHAR,TEZPUR,108,73,SILCHAR-TEZPUR,181,All
2015,6,SILCHAR,TEZPUR,67,235,SILCHAR-TEZPUR,302,All
2015,7,SILCHAR,TEZPUR,88,244,SILCHAR-TEZPUR,332,All
2015,8,SILCHAR,TEZPUR,89,153,SILCHAR-TEZPUR,242,All
2015,9,SILCHAR,TEZPUR,68,56,SILCHAR-TEZPUR,124,All
2015,10,SILCHAR,TEZPUR,125,100,SILCHAR-TEZPUR,225,All
2015,11,SILCHAR,TEZPUR,84,91,SILCHAR-TEZPUR,175,All
2015,12,SILCHAR,TEZPUR,76,75,SILCHAR-TEZPUR,151,All
2016,3,SILCHAR,TEZPUR,15,26,SILCHAR-TEZPUR,41,All
2016,4,SILCHAR,TEZPUR,0,489,SILCHAR-TEZPUR,489,All
2016,5,SILCHAR,TEZPUR,0,668,SILCHAR-TEZPUR,668,All
2016,6,SILCHAR,TEZPUR,0,711,SILCHAR-TEZPUR,711,All
2016,7,SILCHAR,TEZPUR,0,788,SILCHAR-TEZPUR,788,All
2016,8,SILCHAR,TEZPUR,184,181,SILCHAR-TEZPUR,365,All
2016,9,SILCHAR,TEZPUR,142,120,SILCHAR-TEZPUR,262,All
2016,10,SILCHAR,TEZPUR,0,657,SILCHAR-TEZPUR,657,All
2021,10,SILCHAR,VARANASI,77,0,SILCHAR-VARANASI,77,All
2019,10,SILCHAR,VISAKHAPATNAM,0,5,SILCHAR-VISAKHAPATNAM,5,All
2019,11,SILCHAR,VISAKHAPATNAM,0,53,SILCHAR-VISAKHAPATNAM,53,All
2019,12,SILCHAR,VISAKHAPATNAM,0,147,SILCHAR-VISAKHAPATNAM,147,All
2020,1,SILCHAR,VISAKHAPATNAM,0,185,SILCHAR-VISAKHAPATNAM,185,All
2020,2,SILCHAR,VISAKHAPATNAM,0,58,SILCHAR-VISAKHAPATNAM,58,All
2020,3,SILCHAR,VISAKHAPATNAM,0,65,SILCHAR-VISAKHAPATNAM,65,All
2020,12,SRINAGAR,SURAT,69,0,SRINAGAR-SURAT,69,All
2021,1,SRINAGAR,SURAT,25,0,SRINAGAR-SURAT,25,All
2018,4,SRINAGAR,UDAIPUR,3,0,SRINAGAR-UDAIPUR,3,All
2018,5,SRINAGAR,UDAIPUR,6,0,SRINAGAR-UDAIPUR,6,All
2018,6,SRINAGAR,UDAIPUR,55,0,SRINAGAR-UDAIPUR,55,All
2018,7,SRINAGAR,UDAIPUR,31,0,SRINAGAR-UDAIPUR,31,All
2018,8,SRINAGAR,UDAIPUR,48,0,SRINAGAR-UDAIPUR,48,All
2018,9,SRINAGAR,UDAIPUR,47,0,SRINAGAR-UDAIPUR,47,All
2018,10,SRINAGAR,UDAIPUR,58,0,SRINAGAR-UDAIPUR,58,All
2018,11,SRINAGAR,UDAIPUR,73,0,SRINAGAR-UDAIPUR,73,All
2018,12,SRINAGAR,UDAIPUR,49,0,SRINAGAR-UDAIPUR,49,All
2019,1,SRINAGAR,UDAIPUR,44,0,SRINAGAR-UDAIPUR,44,All
2019,2,SRINAGAR,UDAIPUR,24,0,SRINAGAR-UDAIPUR,24,All
2019,3,SRINAGAR,UDAIPUR,22,0,SRINAGAR-UDAIPUR,22,All
2019,4,SRINAGAR,UDAIPUR,41,0,SRINAGAR-UDAIPUR,41,All
2019,5,SRINAGAR,UDAIPUR,45,0,SRINAGAR-UDAIPUR,45,All
2019,6,SRINAGAR,UDAIPUR,118,0,SRINAGAR-UDAIPUR,118,All
2019,7,SRINAGAR,UDAIPUR,175,0,SRINAGAR-UDAIPUR,175,All
2019,8,SRINAGAR,UDAIPUR,60,0,SRINAGAR-UDAIPUR,60,All
2019,9,SRINAGAR,UDAIPUR,16,0,SRINAGAR-UDAIPUR,16,All
2019,10,SRINAGAR,UDAIPUR,13,0,SRINAGAR-UDAIPUR,13,All
2019,11,SRINAGAR,UDAIPUR,13,0,SRINAGAR-UDAIPUR,13,All
2019,12,SRINAGAR,UDAIPUR,7,0,SRINAGAR-UDAIPUR,7,All
2020,1,SRINAGAR,UDAIPUR,4,0,SRINAGAR-UDAIPUR,4,All
2020,2,SRINAGAR,UDAIPUR,16,0,SRINAGAR-UDAIPUR,16,All
2020,3,SRINAGAR,UDAIPUR,9,0,SRINAGAR-UDAIPUR,9,All
2022,12,SRINAGAR,VARANASI,8,0,SRINAGAR-VARANASI,8,All
2023,1,SRINAGAR,VARANASI,14,0,SRINAGAR-VARANASI,14,All
2023,2,SRINAGAR,VARANASI,37,0,SRINAGAR-VARANASI,37,All
2023,3,SRINAGAR,VARANASI,34,0,SRINAGAR-VARANASI,34,All
2023,10,SRINAGAR,VARANASI,16,0,SRINAGAR-VARANASI,16,All
2023,11,SRINAGAR,VARANASI,114,0,SRINAGAR-VARANASI,114,All
2023,12,SRINAGAR,VARANASI,24,0,SRINAGAR-VARANASI,24,All
2016,3,SRINAGAR,VISAKHAPATNAM,15,35,SRINAGAR-VISAKHAPATNAM,50,All
2016,4,SRINAGAR,VISAKHAPATNAM,183,162,SRINAGAR-VISAKHAPATNAM,345,All
2016,5,SRINAGAR,VISAKHAPATNAM,391,460,SRINAGAR-VISAKHAPATNAM,851,All
2016,6,SRINAGAR,VISAKHAPATNAM,115,68,SRINAGAR-VISAKHAPATNAM,183,All
2018,4,SRINAGAR,VISAKHAPATNAM,37,0,SRINAGAR-VISAKHAPATNAM,37,All
2018,5,SRINAGAR,VISAKHAPATNAM,71,0,SRINAGAR-VISAKHAPATNAM,71,All
2018,6,SRINAGAR,VISAKHAPATNAM,67,0,SRINAGAR-VISAKHAPATNAM,67,All
2018,7,SRINAGAR,VISAKHAPATNAM,88,0,SRINAGAR-VISAKHAPATNAM,88,All
2018,8,SRINAGAR,VISAKHAPATNAM,216,0,SRINAGAR-VISAKHAPATNAM,216,All
2018,9,SRINAGAR,VISAKHAPATNAM,272,0,SRINAGAR-VISAKHAPATNAM,272,All
2018,10,SRINAGAR,VISAKHAPATNAM,480,0,SRINAGAR-VISAKHAPATNAM,480,All
2018,11,SRINAGAR,VISAKHAPATNAM,387,0,SRINAGAR-VISAKHAPATNAM,387,All
2018,12,SRINAGAR,VISAKHAPATNAM,317,0,SRINAGAR-VISAKHAPATNAM,317,All
2019,1,SRINAGAR,VISAKHAPATNAM,273,0,SRINAGAR-VISAKHAPATNAM,273,All
2019,2,SRINAGAR,VISAKHAPATNAM,242,0,SRINAGAR-VISAKHAPATNAM,242,All
2019,3,SRINAGAR,VISAKHAPATNAM,117,0,SRINAGAR-VISAKHAPATNAM,117,All
2019,4,SRINAGAR,VISAKHAPATNAM,129,0,SRINAGAR-VISAKHAPATNAM,129,All
2019,5,SRINAGAR,VISAKHAPATNAM,194,0,SRINAGAR-VISAKHAPATNAM,194,All
2019,6,SRINAGAR,VISAKHAPATNAM,184,0,SRINAGAR-VISAKHAPATNAM,184,All
2019,7,SRINAGAR,VISAKHAPATNAM,341,0,SRINAGAR-VISAKHAPATNAM,341,All
2019,8,SRINAGAR,VISAKHAPATNAM,200,0,SRINAGAR-VISAKHAPATNAM,200,All
2019,9,SRINAGAR,VISAKHAPATNAM,75,0,SRINAGAR-VISAKHAPATNAM,75,All
2019,10,SRINAGAR,VISAKHAPATNAM,154,0,SRINAGAR-VISAKHAPATNAM,154,All
2019,11,SRINAGAR,VISAKHAPATNAM,145,0,SRINAGAR-VISAKHAPATNAM,145,All
2019,12,SRINAGAR,VISAKHAPATNAM,100,0,SRINAGAR-VISAKHAPATNAM,100,All
2020,1,SRINAGAR,VISAKHAPATNAM,170,0,SRINAGAR-VISAKHAPATNAM,170,All
2020,2,SRINAGAR,VISAKHAPATNAM,314,0,SRINAGAR-VISAKHAPATNAM,314,All
2020,3,SRINAGAR,VISAKHAPATNAM,184,0,SRINAGAR-VISAKHAPATNAM,184,All
2018,11,SURAT,UDAIPUR,41,34,SURAT-UDAIPUR,75,All
2018,12,SURAT,UDAIPUR,1201,1136,SURAT-UDAIPUR,2337,All
2019,1,SURAT,UDAIPUR,1381,1297,SURAT-UDAIPUR,2678,All
2019,2,SURAT,UDAIPUR,1239,1078,SURAT-UDAIPUR,2317,All
2019,3,SURAT,UDAIPUR,1134,923,SURAT-UDAIPUR,2057,All
2019,4,SURAT,UDAIPUR,486,330,SURAT-UDAIPUR,816,All
2019,5,SURAT,UDAIPUR,585,522,SURAT-UDAIPUR,1107,All
2019,6,SURAT,UDAIPUR,476,532,SURAT-UDAIPUR,1008,All
2019,7,SURAT,UDAIPUR,363,333,SURAT-UDAIPUR,696,All
2019,8,SURAT,UDAIPUR,424,365,SURAT-UDAIPUR,789,All
2019,9,SURAT,UDAIPUR,387,370,SURAT-UDAIPUR,757,All
2019,10,SURAT,UDAIPUR,555,366,SURAT-UDAIPUR,921,All
2019,11,SURAT,UDAIPUR,1126,1218,SURAT-UDAIPUR,2344,All
2019,12,SURAT,UDAIPUR,1357,1298,SURAT-UDAIPUR,2655,All
2020,1,SURAT,UDAIPUR,1331,1176,SURAT-UDAIPUR,2507,All
2020,2,SURAT,UDAIPUR,1214,1132,SURAT-UDAIPUR,2346,All
2020,3,SURAT,UDAIPUR,518,559,SURAT-UDAIPUR,1077,All
2021,2,SURAT,UDAIPUR,221,219,SURAT-UDAIPUR,440,All
2021,6,SURAT,UDAIPUR,0,1,SURAT-UDAIPUR,1,All
2021,10,SURAT,UDAIPUR,350,298,SURAT-UDAIPUR,648,All
2023,5,SURAT,UDAIPUR,16,0,SURAT-UDAIPUR,16,All
2023,8,SURAT,UDAIPUR,704,334,SURAT-UDAIPUR,1038,All
2023,9,SURAT,UDAIPUR,1563,817,SURAT-UDAIPUR,2380,All
2023,10,SURAT,UDAIPUR,1291,938,SURAT-UDAIPUR,2229,All
2023,11,SURAT,UDAIPUR,2030,1503,SURAT-UDAIPUR,3533,All
2023,12,SURAT,UDAIPUR,1898,1925,SURAT-UDAIPUR,3823,All
2024,1,SURAT,UDAIPUR,1952,1801,SURAT-UDAIPUR,3753,All
2024,2,SURAT,UDAIPUR,1926,1608,SURAT-UDAIPUR,3534,All
2024,3,SURAT,UDAIPUR,1688,1525,SURAT-UDAIPUR,3213,All
2019,6,SURAT,VADODARA,0,4,SURAT-VADODARA,4,All
2019,7,SURAT,VADODARA,1,4,SURAT-VADODARA,5,All
2019,10,SURAT,VADODARA,6,2,SURAT-VADODARA,8,All
2024,10,SURAT,VADODARA,143,0,SURAT-VADODARA,143,All
2018,11,SURAT,VARANASI,28,39,SURAT-VARANASI,67,All
2018,12,SURAT,VARANASI,622,848,SURAT-VARANASI,1470,All
2019,1,SURAT,VARANASI,593,544,SURAT-VARANASI,1137,All
2019,2,SURAT,VARANASI,601,769,SURAT-VARANASI,1370,All
2019,3,SURAT,VARANASI,582,656,SURAT-VARANASI,1238,All
2021,1,SURAT,VARANASI,960,0,SURAT-VARANASI,960,All
2021,2,SURAT,VARANASI,1892,0,SURAT-VARANASI,1892,All
2021,3,SURAT,VARANASI,2075,0,SURAT-VARANASI,2075,All
2020,5,SURAT,VIJAYAWADA,0,0,SURAT-VIJAYAWADA,0,All
2020,6,SURAT,VIJAYAWADA,0,0,SURAT-VIJAYAWADA,0,All
2019,2,SURAT,VISAKHAPATNAM,0,41,SURAT-VISAKHAPATNAM,41,All
2019,3,SURAT,VISAKHAPATNAM,0,43,SURAT-VISAKHAPATNAM,43,All
2020,2,SURAT,VISAKHAPATNAM,0,0,SURAT-VISAKHAPATNAM,0,All
2020,3,SURAT,VISAKHAPATNAM,0,0,SURAT-VISAKHAPATNAM,0,All
2020,5,SURAT,VISAKHAPATNAM,0,0,SURAT-VISAKHAPATNAM,0,All
2020,6,SURAT,VISAKHAPATNAM,0,0,SURAT-VISAKHAPATNAM,0,All
2023,8,Shivamogga Airport,BENGALURU,73,72,BENGALURU-Shivamogga Airport,145,All
2023,9,Shivamogga Airport,BENGALURU,1579,1584,BENGALURU-Shivamogga Airport,3163,All
2023,10,Shivamogga Airport,BENGALURU,1650,1626,BENGALURU-Shivamogga Airport,3276,All
2023,11,Shivamogga Airport,TIRUPATI,410,310,Shivamogga Airport-TIRUPATI,720,All
2023,12,Shivamogga Airport,TIRUPATI,964,602,Shivamogga Airport-TIRUPATI,1566,All
2024,1,Shivamogga Airport,TIRUPATI,698,375,Shivamogga Airport-TIRUPATI,1073,All
2024,2,Shivamogga Airport,TIRUPATI,987,579,Shivamogga Airport-TIRUPATI,1566,All
2024,3,Shivamogga Airport,TIRUPATI,738,548,Shivamogga Airport-TIRUPATI,1286,All
2024,4,Shivamogga Airport,TIRUPATI,837,539,Shivamogga Airport-TIRUPATI,1376,All
2024,6,Shivamogga Airport,TIRUPATI,692,450,Shivamogga Airport-TIRUPATI,1142,All
2024,7,Shivamogga Airport,TIRUPATI,710,400,Shivamogga Airport-TIRUPATI,1110,All
2024,8,Shivamogga Airport,TIRUPATI,251,120,Shivamogga Airport-TIRUPATI,371,All
2024,9,Shivamogga Airport,TIRUPATI,564,536,Shivamogga Airport-TIRUPATI,1100,All
2024,10,Shivamogga Airport,TIRUPATI,1020,1025,Shivamogga Airport-TIRUPATI,2045,All
2024,11,Shivamogga Airport,TIRUPATI,921,818,Shivamogga Airport-TIRUPATI,1739,All
2024,12,Shivamogga Airport,TIRUPATI,927,904,Shivamogga Airport-TIRUPATI,1831,All
2025,1,Shivamogga Airport,TIRUPATI,1301,1058,Shivamogga Airport-TIRUPATI,2359,All
2025,2,Shivamogga Airport,TIRUPATI,873,613,Shivamogga Airport-TIRUPATI,1486,All
2025,3,Shivamogga Airport,TIRUPATI,1060,878,Shivamogga Airport-TIRUPATI,1938,All
2022,3,TIRUCHIRAPALLY,TIRUPATI,67,49,TIRUCHIRAPALLY-TIRUPATI,116,All
2022,4,TIRUCHIRAPALLY,TIRUPATI,191,120,TIRUCHIRAPALLY-TIRUPATI,311,All
2022,5,TIRUCHIRAPALLY,TIRUPATI,4,9,TIRUCHIRAPALLY-TIRUPATI,13,All
2024,4,TIRUCHIRAPALLY,TRIVANDRUM,1,0,TIRUCHIRAPALLY-TRIVANDRUM,1,All
2019,6,TIRUCHIRAPALLY,TUTICORIN,0,4,TIRUCHIRAPALLY-TUTICORIN,4,All
2019,10,TIRUCHIRAPALLY,TUTICORIN,60,0,TIRUCHIRAPALLY-TUTICORIN,60,All
2021,2,TIRUCHIRAPALLY,VIJAYAWADA,0,0,TIRUCHIRAPALLY-VIJAYAWADA,0,All
2018,3,TIRUPATI,VARANASI,25,29,TIRUPATI-VARANASI,54,All
2018,4,TIRUPATI,VARANASI,113,229,TIRUPATI-VARANASI,342,All
2018,5,TIRUPATI,VARANASI,364,261,TIRUPATI-VARANASI,625,All
2018,6,TIRUPATI,VARANASI,356,317,TIRUPATI-VARANASI,673,All
2018,7,TIRUPATI,VARANASI,575,817,TIRUPATI-VARANASI,1392,All
2018,8,TIRUPATI,VARANASI,777,954,TIRUPATI-VARANASI,1731,All
2018,9,TIRUPATI,VARANASI,0,642,TIRUPATI-VARANASI,642,All
2018,10,TIRUPATI,VARANASI,60,352,TIRUPATI-VARANASI,412,All
2018,11,TIRUPATI,VARANASI,382,317,TIRUPATI-VARANASI,699,All
2019,2,TIRUPATI,VARANASI,169,145,TIRUPATI-VARANASI,314,All
2019,3,TIRUPATI,VARANASI,463,493,TIRUPATI-VARANASI,956,All
2019,4,TIRUPATI,VARANASI,364,282,TIRUPATI-VARANASI,646,All
2019,5,TIRUPATI,VARANASI,426,464,TIRUPATI-VARANASI,890,All
2019,6,TIRUPATI,VARANASI,326,381,TIRUPATI-VARANASI,707,All
2019,7,TIRUPATI,VARANASI,63,63,TIRUPATI-VARANASI,126,All
2016,4,TIRUPATI,VIJAYAWADA,166,193,TIRUPATI-VIJAYAWADA,359,All
2016,5,TIRUPATI,VIJAYAWADA,1421,1923,TIRUPATI-VIJAYAWADA,3344,All
2016,6,TIRUPATI,VIJAYAWADA,1305,1620,TIRUPATI-VIJAYAWADA,2925,All
2016,7,TIRUPATI,VIJAYAWADA,1425,1771,TIRUPATI-VIJAYAWADA,3196,All
2016,8,TIRUPATI,VIJAYAWADA,2092,2336,TIRUPATI-VIJAYAWADA,4428,All
2016,9,TIRUPATI,VIJAYAWADA,1524,1856,TIRUPATI-VIJAYAWADA,3380,All
2016,10,TIRUPATI,VIJAYAWADA,1380,1905,TIRUPATI-VIJAYAWADA,3285,All
2016,11,TIRUPATI,VIJAYAWADA,1984,2164,TIRUPATI-VIJAYAWADA,4148,All
2016,12,TIRUPATI,VIJAYAWADA,1035,1212,TIRUPATI-VIJAYAWADA,2247,All
2017,4,TIRUPATI,VIJAYAWADA,1249,547,TIRUPATI-VIJAYAWADA,1796,All
2017,5,TIRUPATI,VIJAYAWADA,580,695,TIRUPATI-VIJAYAWADA,1275,All
2017,6,TIRUPATI,VIJAYAWADA,639,696,TIRUPATI-VIJAYAWADA,1335,All
2017,7,TIRUPATI,VIJAYAWADA,785,915,TIRUPATI-VIJAYAWADA,1700,All
2017,8,TIRUPATI,VIJAYAWADA,757,817,TIRUPATI-VIJAYAWADA,1574,All
2017,9,TIRUPATI,VIJAYAWADA,684,704,TIRUPATI-VIJAYAWADA,1388,All
2017,10,TIRUPATI,VIJAYAWADA,760,775,TIRUPATI-VIJAYAWADA,1535,All
2017,11,TIRUPATI,VIJAYAWADA,814,794,TIRUPATI-VIJAYAWADA,1608,All
2017,12,TIRUPATI,VIJAYAWADA,878,915,TIRUPATI-VIJAYAWADA,1793,All
2018,1,TIRUPATI,VIJAYAWADA,879,894,TIRUPATI-VIJAYAWADA,1773,All
2018,2,TIRUPATI,VIJAYAWADA,761,809,TIRUPATI-VIJAYAWADA,1570,All
2018,3,TIRUPATI,VIJAYAWADA,916,936,TIRUPATI-VIJAYAWADA,1852,All
2018,4,TIRUPATI,VIJAYAWADA,1641,964,TIRUPATI-VIJAYAWADA,2605,All
2018,5,TIRUPATI,VIJAYAWADA,977,1016,TIRUPATI-VIJAYAWADA,1993,All
2018,6,TIRUPATI,VIJAYAWADA,1105,1024,TIRUPATI-VIJAYAWADA,2129,All
2018,7,TIRUPATI,VIJAYAWADA,1066,1077,TIRUPATI-VIJAYAWADA,2143,All
2018,8,TIRUPATI,VIJAYAWADA,749,931,TIRUPATI-VIJAYAWADA,1680,All
2018,9,TIRUPATI,VIJAYAWADA,650,770,TIRUPATI-VIJAYAWADA,1420,All
2018,11,TIRUPATI,VIJAYAWADA,2573,0,TIRUPATI-VIJAYAWADA,2573,All
2018,12,TIRUPATI,VIJAYAWADA,2721,0,TIRUPATI-VIJAYAWADA,2721,All
2019,1,TIRUPATI,VIJAYAWADA,986,958,TIRUPATI-VIJAYAWADA,1944,All
2019,2,TIRUPATI,VIJAYAWADA,1419,0,TIRUPATI-VIJAYAWADA,1419,All
2019,3,TIRUPATI,VIJAYAWADA,1559,1710,TIRUPATI-VIJAYAWADA,3269,All
2019,4,TIRUPATI,VIJAYAWADA,817,898,TIRUPATI-VIJAYAWADA,1715,All
2019,5,TIRUPATI,VIJAYAWADA,955,1144,TIRUPATI-VIJAYAWADA,2099,All
2019,6,TIRUPATI,VIJAYAWADA,819,987,TIRUPATI-VIJAYAWADA,1806,All
2019,7,TIRUPATI,VIJAYAWADA,627,664,TIRUPATI-VIJAYAWADA,1291,All
2019,10,TIRUPATI,VIJAYAWADA,77,106,TIRUPATI-VIJAYAWADA,183,All
2019,11,TIRUPATI,VIJAYAWADA,679,966,TIRUPATI-VIJAYAWADA,1645,All
2019,12,TIRUPATI,VIJAYAWADA,756,1050,TIRUPATI-VIJAYAWADA,1806,All
2020,1,TIRUPATI,VIJAYAWADA,537,886,TIRUPATI-VIJAYAWADA,1423,All
2020,2,TIRUPATI,VIJAYAWADA,623,907,TIRUPATI-VIJAYAWADA,1530,All
2020,3,TIRUPATI,VIJAYAWADA,464,604,TIRUPATI-VIJAYAWADA,1068,All
2020,8,TIRUPATI,VIJAYAWADA,1,0,TIRUPATI-VIJAYAWADA,1,All
2020,12,TIRUPATI,VIJAYAWADA,770,858,TIRUPATI-VIJAYAWADA,1628,All
2021,1,TIRUPATI,VIJAYAWADA,740,962,TIRUPATI-VIJAYAWADA,1702,All
2021,2,TIRUPATI,VIJAYAWADA,668,716,TIRUPATI-VIJAYAWADA,1384,All
2021,3,TIRUPATI,VIJAYAWADA,625,681,TIRUPATI-VIJAYAWADA,1306,All
2021,4,TIRUPATI,VIJAYAWADA,120,203,TIRUPATI-VIJAYAWADA,323,All
2021,10,TIRUPATI,VIJAYAWADA,29,34,TIRUPATI-VIJAYAWADA,63,All
2021,11,TIRUPATI,VIJAYAWADA,733,940,TIRUPATI-VIJAYAWADA,1673,All
2021,12,TIRUPATI,VIJAYAWADA,1128,1470,TIRUPATI-VIJAYAWADA,2598,All
2022,1,TIRUPATI,VIJAYAWADA,538,668,TIRUPATI-VIJAYAWADA,1206,All
2022,2,TIRUPATI,VIJAYAWADA,189,388,TIRUPATI-VIJAYAWADA,577,All
2022,3,TIRUPATI,VIJAYAWADA,1026,1494,TIRUPATI-VIJAYAWADA,2520,All
2022,4,TIRUPATI,VIJAYAWADA,756,867,TIRUPATI-VIJAYAWADA,1623,All
2022,5,TIRUPATI,VIJAYAWADA,657,867,TIRUPATI-VIJAYAWADA,1524,All
2022,6,TIRUPATI,VIJAYAWADA,841,1017,TIRUPATI-VIJAYAWADA,1858,All
2022,7,TIRUPATI,VIJAYAWADA,998,1086,TIRUPATI-VIJAYAWADA,2084,All
2022,8,TIRUPATI,VIJAYAWADA,1112,1064,TIRUPATI-VIJAYAWADA,2176,All
2022,9,TIRUPATI,VIJAYAWADA,861,900,TIRUPATI-VIJAYAWADA,1761,All
2022,10,TIRUPATI,VIJAYAWADA,936,769,TIRUPATI-VIJAYAWADA,1705,All
2022,11,TIRUPATI,VIJAYAWADA,1550,1522,TIRUPATI-VIJAYAWADA,3072,All
2022,12,TIRUPATI,VIJAYAWADA,1969,1806,TIRUPATI-VIJAYAWADA,3775,All
2023,1,TIRUPATI,VIJAYAWADA,1843,1793,TIRUPATI-VIJAYAWADA,3636,All
2023,2,TIRUPATI,VIJAYAWADA,1847,1859,TIRUPATI-VIJAYAWADA,3706,All
2023,3,TIRUPATI,VIJAYAWADA,1804,1938,TIRUPATI-VIJAYAWADA,3742,All
2023,4,TIRUPATI,VIJAYAWADA,1177,1496,TIRUPATI-VIJAYAWADA,2673,All
2023,5,TIRUPATI,VIJAYAWADA,1250,1627,TIRUPATI-VIJAYAWADA,2877,All
2023,6,TIRUPATI,VIJAYAWADA,1507,1695,TIRUPATI-VIJAYAWADA,3202,All
2023,7,TIRUPATI,VIJAYAWADA,1453,1774,TIRUPATI-VIJAYAWADA,3227,All
2023,8,TIRUPATI,VIJAYAWADA,1501,1610,TIRUPATI-VIJAYAWADA,3111,All
2023,9,TIRUPATI,VIJAYAWADA,1058,1211,TIRUPATI-VIJAYAWADA,2269,All
2023,10,TIRUPATI,VIJAYAWADA,1086,1168,TIRUPATI-VIJAYAWADA,2254,All
2023,11,TIRUPATI,VIJAYAWADA,870,1156,TIRUPATI-VIJAYAWADA,2026,All
2023,12,TIRUPATI,VIJAYAWADA,1057,1225,TIRUPATI-VIJAYAWADA,2282,All
2024,1,TIRUPATI,VIJAYAWADA,1084,1150,TIRUPATI-VIJAYAWADA,2234,All
2024,2,TIRUPATI,VIJAYAWADA,819,1189,TIRUPATI-VIJAYAWADA,2008,All
2024,3,TIRUPATI,VIJAYAWADA,777,1196,TIRUPATI-VIJAYAWADA,1973,All
2024,4,TIRUPATI,VIJAYAWADA,782,995,TIRUPATI-VIJAYAWADA,1777,All
2024,6,TIRUPATI,VIJAYAWADA,798,1115,TIRUPATI-VIJAYAWADA,1913,All
2024,7,TIRUPATI,VIJAYAWADA,831,1266,TIRUPATI-VIJAYAWADA,2097,All
2024,8,TIRUPATI,VIJAYAWADA,853,1148,TIRUPATI-VIJAYAWADA,2001,All
2024,9,TIRUPATI,VIJAYAWADA,580,785,TIRUPATI-VIJAYAWADA,1365,All
2024,10,TIRUPATI,VIJAYAWADA,547,763,TIRUPATI-VIJAYAWADA,1310,All
2024,11,TIRUPATI,VIJAYAWADA,742,1042,TIRUPATI-VIJAYAWADA,1784,All
2024,12,TIRUPATI,VIJAYAWADA,908,1432,TIRUPATI-VIJAYAWADA,2340,All
2025,1,TIRUPATI,VIJAYAWADA,842,1092,TIRUPATI-VIJAYAWADA,1934,All
2025,2,TIRUPATI,VIJAYAWADA,632,1079,TIRUPATI-VIJAYAWADA,1711,All
2025,3,TIRUPATI,VIJAYAWADA,762,1290,TIRUPATI-VIJAYAWADA,2052,All
2015,4,TIRUPATI,VISAKHAPATNAM,1219,1332,TIRUPATI-VISAKHAPATNAM,2551,All
2015,5,TIRUPATI,VISAKHAPATNAM,1357,1629,TIRUPATI-VISAKHAPATNAM,2986,All
2015,6,TIRUPATI,VISAKHAPATNAM,1424,1475,TIRUPATI-VISAKHAPATNAM,2899,All
2015,7,TIRUPATI,VISAKHAPATNAM,1559,1719,TIRUPATI-VISAKHAPATNAM,3278,All
2015,8,TIRUPATI,VISAKHAPATNAM,1354,1503,TIRUPATI-VISAKHAPATNAM,2857,All
2015,9,TIRUPATI,VISAKHAPATNAM,1053,1256,TIRUPATI-VISAKHAPATNAM,2309,All
2015,10,TIRUPATI,VISAKHAPATNAM,1080,1041,TIRUPATI-VISAKHAPATNAM,2121,All
2016,4,TIRUPATI,VISAKHAPATNAM,226,249,TIRUPATI-VISAKHAPATNAM,475,All
2016,5,TIRUPATI,VISAKHAPATNAM,935,1136,TIRUPATI-VISAKHAPATNAM,2071,All
2016,6,TIRUPATI,VISAKHAPATNAM,973,920,TIRUPATI-VISAKHAPATNAM,1893,All
2016,7,TIRUPATI,VISAKHAPATNAM,875,794,TIRUPATI-VISAKHAPATNAM,1669,All
2016,8,TIRUPATI,VISAKHAPATNAM,721,689,TIRUPATI-VISAKHAPATNAM,1410,All
2016,9,TIRUPATI,VISAKHAPATNAM,873,812,TIRUPATI-VISAKHAPATNAM,1685,All
2016,10,TIRUPATI,VISAKHAPATNAM,783,821,TIRUPATI-VISAKHAPATNAM,1604,All
2016,11,TIRUPATI,VISAKHAPATNAM,885,850,TIRUPATI-VISAKHAPATNAM,1735,All
2016,12,TIRUPATI,VISAKHAPATNAM,738,704,TIRUPATI-VISAKHAPATNAM,1442,All
2018,5,TIRUPATI,VISAKHAPATNAM,397,495,TIRUPATI-VISAKHAPATNAM,892,All
2018,6,TIRUPATI,VISAKHAPATNAM,360,477,TIRUPATI-VISAKHAPATNAM,837,All
2018,7,TIRUPATI,VISAKHAPATNAM,507,214,TIRUPATI-VISAKHAPATNAM,721,All
2018,8,TIRUPATI,VISAKHAPATNAM,554,605,TIRUPATI-VISAKHAPATNAM,1159,All
2018,9,TIRUPATI,VISAKHAPATNAM,543,567,TIRUPATI-VISAKHAPATNAM,1110,All
2018,10,TIRUPATI,VISAKHAPATNAM,2583,2448,TIRUPATI-VISAKHAPATNAM,5031,All
2019,1,TIRUPATI,VISAKHAPATNAM,551,589,TIRUPATI-VISAKHAPATNAM,1140,All
2019,3,TIRUPATI,VISAKHAPATNAM,455,520,TIRUPATI-VISAKHAPATNAM,975,All
2019,4,TIRUPATI,VISAKHAPATNAM,499,542,TIRUPATI-VISAKHAPATNAM,1041,All
2019,5,TIRUPATI,VISAKHAPATNAM,456,479,TIRUPATI-VISAKHAPATNAM,935,All
2019,6,TIRUPATI,VISAKHAPATNAM,405,449,TIRUPATI-VISAKHAPATNAM,854,All
2019,7,TIRUPATI,VISAKHAPATNAM,224,285,TIRUPATI-VISAKHAPATNAM,509,All
2020,6,TIRUPATI,VISAKHAPATNAM,7,0,TIRUPATI-VISAKHAPATNAM,7,All
2020,7,TIRUPATI,VISAKHAPATNAM,130,0,TIRUPATI-VISAKHAPATNAM,130,All
2020,8,TIRUPATI,VISAKHAPATNAM,348,0,TIRUPATI-VISAKHAPATNAM,348,All
2020,9,TIRUPATI,VISAKHAPATNAM,506,453,TIRUPATI-VISAKHAPATNAM,959,All
2020,10,TIRUPATI,VISAKHAPATNAM,786,815,TIRUPATI-VISAKHAPATNAM,1601,All
2020,11,TIRUPATI,VISAKHAPATNAM,619,758,TIRUPATI-VISAKHAPATNAM,1377,All
2020,12,TIRUPATI,VISAKHAPATNAM,1490,1699,TIRUPATI-VISAKHAPATNAM,3189,All
2021,1,TIRUPATI,VISAKHAPATNAM,1143,1362,TIRUPATI-VISAKHAPATNAM,2505,All
2021,2,TIRUPATI,VISAKHAPATNAM,1125,1309,TIRUPATI-VISAKHAPATNAM,2434,All
2021,3,TIRUPATI,VISAKHAPATNAM,1037,1255,TIRUPATI-VISAKHAPATNAM,2292,All
2021,12,TIRUPATI,VISAKHAPATNAM,924,1041,TIRUPATI-VISAKHAPATNAM,1965,All
2022,1,TIRUPATI,VISAKHAPATNAM,2190,2292,TIRUPATI-VISAKHAPATNAM,4482,All
2022,2,TIRUPATI,VISAKHAPATNAM,1762,2412,TIRUPATI-VISAKHAPATNAM,4174,All
2022,3,TIRUPATI,VISAKHAPATNAM,2650,2901,TIRUPATI-VISAKHAPATNAM,5551,All
2022,4,TIRUPATI,VISAKHAPATNAM,1773,1957,TIRUPATI-VISAKHAPATNAM,3730,All
2022,5,TIRUPATI,VISAKHAPATNAM,1664,2020,TIRUPATI-VISAKHAPATNAM,3684,All
2022,6,TIRUPATI,VISAKHAPATNAM,1916,2086,TIRUPATI-VISAKHAPATNAM,4002,All
2022,7,TIRUPATI,VISAKHAPATNAM,1912,2141,TIRUPATI-VISAKHAPATNAM,4053,All
2022,8,TIRUPATI,VISAKHAPATNAM,2120,2173,TIRUPATI-VISAKHAPATNAM,4293,All
2022,9,TIRUPATI,VISAKHAPATNAM,1399,1596,TIRUPATI-VISAKHAPATNAM,2995,All
2022,10,TIRUPATI,VISAKHAPATNAM,1515,1904,TIRUPATI-VISAKHAPATNAM,3419,All
2022,11,TIRUPATI,VISAKHAPATNAM,1525,2027,TIRUPATI-VISAKHAPATNAM,3552,All
2022,12,TIRUPATI,VISAKHAPATNAM,2172,1961,TIRUPATI-VISAKHAPATNAM,4133,All
2023,1,TIRUPATI,VISAKHAPATNAM,2009,1909,TIRUPATI-VISAKHAPATNAM,3918,All
2023,2,TIRUPATI,VISAKHAPATNAM,1861,1868,TIRUPATI-VISAKHAPATNAM,3729,All
2023,3,TIRUPATI,VISAKHAPATNAM,1992,2076,TIRUPATI-VISAKHAPATNAM,4068,All
2023,4,TIRUPATI,VISAKHAPATNAM,1711,1914,TIRUPATI-VISAKHAPATNAM,3625,All
2023,5,TIRUPATI,VISAKHAPATNAM,1908,2196,TIRUPATI-VISAKHAPATNAM,4104,All
2023,6,TIRUPATI,VISAKHAPATNAM,1991,2156,TIRUPATI-VISAKHAPATNAM,4147,All
2023,7,TIRUPATI,VISAKHAPATNAM,1885,2136,TIRUPATI-VISAKHAPATNAM,4021,All
2023,8,TIRUPATI,VISAKHAPATNAM,1973,2152,TIRUPATI-VISAKHAPATNAM,4125,All
2023,9,TIRUPATI,VISAKHAPATNAM,1524,1765,TIRUPATI-VISAKHAPATNAM,3289,All
2023,10,TIRUPATI,VISAKHAPATNAM,1872,1937,TIRUPATI-VISAKHAPATNAM,3809,All
2023,11,TIRUPATI,VISAKHAPATNAM,1734,1972,TIRUPATI-VISAKHAPATNAM,3706,All
2023,12,TIRUPATI,VISAKHAPATNAM,1546,1748,TIRUPATI-VISAKHAPATNAM,3294,All
2024,1,TIRUPATI,VISAKHAPATNAM,1467,1859,TIRUPATI-VISAKHAPATNAM,3326,All
2024,2,TIRUPATI,VISAKHAPATNAM,1705,1581,TIRUPATI-VISAKHAPATNAM,3286,All
2024,3,TIRUPATI,VISAKHAPATNAM,1934,1844,TIRUPATI-VISAKHAPATNAM,3778,All
2024,4,TIRUPATI,VISAKHAPATNAM,1539,1536,TIRUPATI-VISAKHAPATNAM,3075,All
2024,6,TIRUPATI,VISAKHAPATNAM,1513,1535,TIRUPATI-VISAKHAPATNAM,3048,All
2024,7,TIRUPATI,VISAKHAPATNAM,1808,1897,TIRUPATI-VISAKHAPATNAM,3705,All
2024,8,TIRUPATI,VISAKHAPATNAM,1936,1996,TIRUPATI-VISAKHAPATNAM,3932,All
2024,9,TIRUPATI,VISAKHAPATNAM,1905,1835,TIRUPATI-VISAKHAPATNAM,3740,All
2024,10,TIRUPATI,VISAKHAPATNAM,1939,1700,TIRUPATI-VISAKHAPATNAM,3639,All
2024,11,TIRUPATI,VISAKHAPATNAM,1525,1884,TIRUPATI-VISAKHAPATNAM,3409,All
2024,12,TIRUPATI,VISAKHAPATNAM,2097,2166,TIRUPATI-VISAKHAPATNAM,4263,All
2025,1,TIRUPATI,VISAKHAPATNAM,2002,2125,TIRUPATI-VISAKHAPATNAM,4127,All
2025,2,TIRUPATI,VISAKHAPATNAM,1124,1208,TIRUPATI-VISAKHAPATNAM,2332,All
2025,3,TIRUPATI,VISAKHAPATNAM,1891,1951,TIRUPATI-VISAKHAPATNAM,3842,All
2017,2,TRIVANDRUM,TIRUCHIRAPALLY,0,1,TIRUCHIRAPALLY-TRIVANDRUM,1,All
2022,12,TRIVANDRUM,TUTICORIN,37,0,TRIVANDRUM-TUTICORIN,37,All
2017,2,TRIVANDRUM,UDAIPUR,3,2,TRIVANDRUM-UDAIPUR,5,All
2017,3,TRIVANDRUM,UDAIPUR,15,14,TRIVANDRUM-UDAIPUR,29,All
2017,4,TRIVANDRUM,UDAIPUR,10,16,TRIVANDRUM-UDAIPUR,26,All
2017,5,TRIVANDRUM,UDAIPUR,3,19,TRIVANDRUM-UDAIPUR,22,All
2017,6,TRIVANDRUM,UDAIPUR,27,20,TRIVANDRUM-UDAIPUR,47,All
2017,7,TRIVANDRUM,UDAIPUR,15,19,TRIVANDRUM-UDAIPUR,34,All
2017,8,TRIVANDRUM,UDAIPUR,35,29,TRIVANDRUM-UDAIPUR,64,All
2017,9,TRIVANDRUM,UDAIPUR,38,32,TRIVANDRUM-UDAIPUR,70,All
2017,10,TRIVANDRUM,UDAIPUR,49,34,TRIVANDRUM-UDAIPUR,83,All
2017,11,TRIVANDRUM,UDAIPUR,23,11,TRIVANDRUM-UDAIPUR,34,All
2017,12,TRIVANDRUM,UDAIPUR,6,23,TRIVANDRUM-UDAIPUR,29,All
2018,1,TRIVANDRUM,UDAIPUR,13,9,TRIVANDRUM-UDAIPUR,22,All
2018,2,TRIVANDRUM,UDAIPUR,7,25,TRIVANDRUM-UDAIPUR,32,All
2018,3,TRIVANDRUM,UDAIPUR,9,29,TRIVANDRUM-UDAIPUR,38,All
2018,5,TRIVANDRUM,UDAIPUR,65,0,TRIVANDRUM-UDAIPUR,65,All
2018,6,TRIVANDRUM,UDAIPUR,152,0,TRIVANDRUM-UDAIPUR,152,All
2018,7,TRIVANDRUM,UDAIPUR,41,0,TRIVANDRUM-UDAIPUR,41,All
2018,8,TRIVANDRUM,UDAIPUR,25,0,TRIVANDRUM-UDAIPUR,25,All
2018,9,TRIVANDRUM,UDAIPUR,80,0,TRIVANDRUM-UDAIPUR,80,All
2018,10,TRIVANDRUM,UDAIPUR,83,0,TRIVANDRUM-UDAIPUR,83,All
2018,11,TRIVANDRUM,UDAIPUR,163,0,TRIVANDRUM-UDAIPUR,163,All
2018,12,TRIVANDRUM,UDAIPUR,105,0,TRIVANDRUM-UDAIPUR,105,All
2019,1,TRIVANDRUM,UDAIPUR,115,0,TRIVANDRUM-UDAIPUR,115,All
2019,2,TRIVANDRUM,UDAIPUR,9,0,TRIVANDRUM-UDAIPUR,9,All
2016,12,TRIVANDRUM,VARANASI,15,0,TRIVANDRUM-VARANASI,15,All
2017,1,TRIVANDRUM,VARANASI,73,0,TRIVANDRUM-VARANASI,73,All
2017,2,TRIVANDRUM,VARANASI,93,0,TRIVANDRUM-VARANASI,93,All
2018,3,TRIVANDRUM,VARANASI,179,173,TRIVANDRUM-VARANASI,352,All
2018,5,TRIVANDRUM,VARANASI,4,0,TRIVANDRUM-VARANASI,4,All
2018,6,TRIVANDRUM,VARANASI,21,0,TRIVANDRUM-VARANASI,21,All
2018,7,TRIVANDRUM,VARANASI,7,0,TRIVANDRUM-VARANASI,7,All
2018,8,TRIVANDRUM,VARANASI,11,0,TRIVANDRUM-VARANASI,11,All
2018,9,TRIVANDRUM,VARANASI,4,0,TRIVANDRUM-VARANASI,4,All
2018,10,TRIVANDRUM,VARANASI,44,0,TRIVANDRUM-VARANASI,44,All
2019,4,TRIVANDRUM,VARANASI,2,0,TRIVANDRUM-VARANASI,2,All
2019,5,TRIVANDRUM,VARANASI,4,0,TRIVANDRUM-VARANASI,4,All
2019,6,TRIVANDRUM,VARANASI,7,0,TRIVANDRUM-VARANASI,7,All
2019,7,TRIVANDRUM,VARANASI,1,0,TRIVANDRUM-VARANASI,1,All
2019,8,TRIVANDRUM,VARANASI,2,0,TRIVANDRUM-VARANASI,2,All
2019,9,TRIVANDRUM,VARANASI,10,0,TRIVANDRUM-VARANASI,10,All
2019,10,TRIVANDRUM,VARANASI,9,0,TRIVANDRUM-VARANASI,9,All
2020,6,TRIVANDRUM,VIJAYAWADA,26,0,TRIVANDRUM-VIJAYAWADA,26,All
2018,11,UDAIPUR,VARANASI,49,31,UDAIPUR-VARANASI,80,All
2018,12,UDAIPUR,VARANASI,1132,1130,UDAIPUR-VARANASI,2262,All
2019,1,UDAIPUR,VARANASI,1505,1243,UDAIPUR-VARANASI,2748,All
2019,2,UDAIPUR,VARANASI,1511,1316,UDAIPUR-VARANASI,2827,All
2019,3,UDAIPUR,VARANASI,1532,1202,UDAIPUR-VARANASI,2734,All
2021,8,UDAIPUR,VIJAYAWADA,160,157,UDAIPUR-VIJAYAWADA,317,All
2018,12,UDAIPUR,VISAKHAPATNAM,2,0,UDAIPUR-VISAKHAPATNAM,2,All
2019,1,UDAIPUR,VISAKHAPATNAM,2,0,UDAIPUR-VISAKHAPATNAM,2,All
2019,2,UDAIPUR,VISAKHAPATNAM,3,0,UDAIPUR-VISAKHAPATNAM,3,All
2019,3,UDAIPUR,VISAKHAPATNAM,16,0,UDAIPUR-VISAKHAPATNAM,16,All
2019,5,UDAIPUR,VISAKHAPATNAM,2,0,UDAIPUR-VISAKHAPATNAM,2,All
2019,6,UDAIPUR,VISAKHAPATNAM,1,0,UDAIPUR-VISAKHAPATNAM,1,All
2019,7,UDAIPUR,VISAKHAPATNAM,2,0,UDAIPUR-VISAKHAPATNAM,2,All
2019,9,UDAIPUR,VISAKHAPATNAM,11,0,UDAIPUR-VISAKHAPATNAM,11,All
2019,10,UDAIPUR,VISAKHAPATNAM,7,0,UDAIPUR-VISAKHAPATNAM,7,All
2019,11,UDAIPUR,VISAKHAPATNAM,2,0,UDAIPUR-VISAKHAPATNAM,2,All
2019,12,UDAIPUR,VISAKHAPATNAM,4,0,UDAIPUR-VISAKHAPATNAM,4,All
2020,1,UDAIPUR,VISAKHAPATNAM,15,0,UDAIPUR-VISAKHAPATNAM,15,All
2020,2,UDAIPUR,VISAKHAPATNAM,6,0,UDAIPUR-VISAKHAPATNAM,6,All
2020,3,UDAIPUR,VISAKHAPATNAM,8,0,UDAIPUR-VISAKHAPATNAM,8,All
2023,10,Utkela,BHUBANESWAR,65,49,BHUBANESWAR-Utkela,114,All
2015,4,VADODARA,BENGALURU,473,0,BENGALURU-VADODARA,473,All
2015,5,VADODARA,BENGALURU,513,0,BENGALURU-VADODARA,513,All
2015,6,VADODARA,BENGALURU,480,0,BENGALURU-VADODARA,480,All
2015,7,VADODARA,BENGALURU,486,0,BENGALURU-VADODARA,486,All
2015,8,VADODARA,BENGALURU,585,0,BENGALURU-VADODARA,585,All
2015,9,VADODARA,BENGALURU,523,0,BENGALURU-VADODARA,523,All
2015,10,VADODARA,BENGALURU,770,0,BENGALURU-VADODARA,770,All
2015,11,VADODARA,BENGALURU,829,0,BENGALURU-VADODARA,829,All
2015,12,VADODARA,BENGALURU,516,0,BENGALURU-VADODARA,516,All
2016,1,VADODARA,BENGALURU,633,0,BENGALURU-VADODARA,633,All
2016,2,VADODARA,BENGALURU,653,0,BENGALURU-VADODARA,653,All
2016,3,VADODARA,BENGALURU,592,0,BENGALURU-VADODARA,592,All
2016,4,VADODARA,BENGALURU,2665,2136,BENGALURU-VADODARA,4801,All
2016,5,VADODARA,BENGALURU,5530,3765,BENGALURU-VADODARA,9295,All
2016,6,VADODARA,BENGALURU,2769,2854,BENGALURU-VADODARA,5623,All
2016,7,VADODARA,BENGALURU,3589,3295,BENGALURU-VADODARA,6884,All
2016,8,VADODARA,BENGALURU,3756,3575,BENGALURU-VADODARA,7331,All
2016,9,VADODARA,BENGALURU,2724,2775,BENGALURU-VADODARA,5499,All
2016,10,VADODARA,BENGALURU,2413,2327,BENGALURU-VADODARA,4740,All
2016,11,VADODARA,BENGALURU,1046,621,BENGALURU-VADODARA,1667,All
2016,12,VADODARA,BENGALURU,923,472,BENGALURU-VADODARA,1395,All
2017,1,VADODARA,BENGALURU,1042,788,BENGALURU-VADODARA,1830,All
2017,2,VADODARA,BENGALURU,169,445,BENGALURU-VADODARA,614,All
2017,3,VADODARA,BENGALURU,0,492,BENGALURU-VADODARA,492,All
2017,4,VADODARA,BENGALURU,0,780,BENGALURU-VADODARA,780,All
2017,5,VADODARA,BENGALURU,634,551,BENGALURU-VADODARA,1185,All
2017,6,VADODARA,BENGALURU,611,558,BENGALURU-VADODARA,1169,All
2017,7,VADODARA,BENGALURU,852,712,BENGALURU-VADODARA,1564,All
2017,8,VADODARA,BENGALURU,650,517,BENGALURU-VADODARA,1167,All
2017,9,VADODARA,BENGALURU,103,115,BENGALURU-VADODARA,218,All
2018,6,VADODARA,BENGALURU,0,152,BENGALURU-VADODARA,152,All
2018,10,VADODARA,BENGALURU,475,516,BENGALURU-VADODARA,991,All
2018,11,VADODARA,BENGALURU,5213,7147,BENGALURU-VADODARA,12360,All
2018,12,VADODARA,BENGALURU,8434,8994,BENGALURU-VADODARA,17428,All
2019,1,VADODARA,BENGALURU,8843,9125,BENGALURU-VADODARA,17968,All
2019,2,VADODARA,BENGALURU,7598,8060,BENGALURU-VADODARA,15658,All
2019,3,VADODARA,BENGALURU,5068,7154,BENGALURU-VADODARA,12222,All
2019,4,VADODARA,BENGALURU,4664,5263,BENGALURU-VADODARA,9927,All
2015,4,VADODARA,CHENNAI,667,731,CHENNAI-VADODARA,1398,All
2015,5,VADODARA,CHENNAI,1106,1012,CHENNAI-VADODARA,2118,All
2015,6,VADODARA,CHENNAI,670,684,CHENNAI-VADODARA,1354,All
2015,7,VADODARA,CHENNAI,625,784,CHENNAI-VADODARA,1409,All
2015,8,VADODARA,CHENNAI,599,609,CHENNAI-VADODARA,1208,All
2015,9,VADODARA,CHENNAI,538,512,CHENNAI-VADODARA,1050,All
2015,10,VADODARA,CHENNAI,816,861,CHENNAI-VADODARA,1677,All
2015,11,VADODARA,CHENNAI,941,835,CHENNAI-VADODARA,1776,All
2015,12,VADODARA,CHENNAI,742,725,CHENNAI-VADODARA,1467,All
2016,1,VADODARA,CHENNAI,1029,979,CHENNAI-VADODARA,2008,All
2016,2,VADODARA,CHENNAI,698,717,CHENNAI-VADODARA,1415,All
2016,3,VADODARA,CHENNAI,742,635,CHENNAI-VADODARA,1377,All
2016,4,VADODARA,CHENNAI,760,661,CHENNAI-VADODARA,1421,All
2016,5,VADODARA,CHENNAI,907,774,CHENNAI-VADODARA,1681,All
2016,6,VADODARA,CHENNAI,613,619,CHENNAI-VADODARA,1232,All
2016,7,VADODARA,CHENNAI,667,745,CHENNAI-VADODARA,1412,All
2016,8,VADODARA,CHENNAI,632,709,CHENNAI-VADODARA,1341,All
2016,9,VADODARA,CHENNAI,366,421,CHENNAI-VADODARA,787,All
2016,10,VADODARA,CHENNAI,663,509,CHENNAI-VADODARA,1172,All
2016,11,VADODARA,CHENNAI,329,473,CHENNAI-VADODARA,802,All
2016,12,VADODARA,CHENNAI,420,505,CHENNAI-VADODARA,925,All
2017,1,VADODARA,CHENNAI,445,468,CHENNAI-VADODARA,913,All
2017,2,VADODARA,CHENNAI,326,471,CHENNAI-VADODARA,797,All
2017,3,VADODARA,CHENNAI,352,402,CHENNAI-VADODARA,754,All
2017,4,VADODARA,CHENNAI,320,331,CHENNAI-VADODARA,651,All
2017,5,VADODARA,CHENNAI,507,418,CHENNAI-VADODARA,925,All
2017,6,VADODARA,CHENNAI,545,499,CHENNAI-VADODARA,1044,All
2017,7,VADODARA,CHENNAI,514,561,CHENNAI-VADODARA,1075,All
2017,8,VADODARA,CHENNAI,324,540,CHENNAI-VADODARA,864,All
2017,9,VADODARA,CHENNAI,315,468,CHENNAI-VADODARA,783,All
2017,10,VADODARA,CHENNAI,496,579,CHENNAI-VADODARA,1075,All
2017,11,VADODARA,CHENNAI,285,447,CHENNAI-VADODARA,732,All
2017,12,VADODARA,CHENNAI,478,522,CHENNAI-VADODARA,1000,All
2018,1,VADODARA,CHENNAI,431,451,CHENNAI-VADODARA,882,All
2018,2,VADODARA,CHENNAI,370,459,CHENNAI-VADODARA,829,All
2018,3,VADODARA,CHENNAI,309,504,CHENNAI-VADODARA,813,All
2018,4,VADODARA,CHENNAI,365,798,CHENNAI-VADODARA,1163,All
2018,5,VADODARA,CHENNAI,403,717,CHENNAI-VADODARA,1120,All
2018,6,VADODARA,CHENNAI,286,737,CHENNAI-VADODARA,1023,All
2018,7,VADODARA,CHENNAI,241,555,CHENNAI-VADODARA,796,All
2018,8,VADODARA,CHENNAI,282,523,CHENNAI-VADODARA,805,All
2018,9,VADODARA,CHENNAI,238,531,CHENNAI-VADODARA,769,All
2018,10,VADODARA,CHENNAI,337,618,CHENNAI-VADODARA,955,All
2018,11,VADODARA,CHENNAI,260,643,CHENNAI-VADODARA,903,All
2018,12,VADODARA,CHENNAI,207,712,CHENNAI-VADODARA,919,All
2019,1,VADODARA,CHENNAI,332,179,CHENNAI-VADODARA,511,All
2019,2,VADODARA,CHENNAI,195,111,CHENNAI-VADODARA,306,All
2019,3,VADODARA,CHENNAI,0,8,CHENNAI-VADODARA,8,All
2019,4,VADODARA,CHENNAI,0,193,CHENNAI-VADODARA,193,All
2015,4,VADODARA,DELHI,13656,10427,DELHI-VADODARA,24083,All
2015,5,VADODARA,DELHI,20610,17724,DELHI-VADODARA,38334,All
2015,6,VADODARA,DELHI,14441,16322,DELHI-VADODARA,30763,All
2015,7,VADODARA,DELHI,13880,13643,DELHI-VADODARA,27523,All
2015,8,VADODARA,DELHI,13651,13899,DELHI-VADODARA,27550,All
2015,9,VADODARA,DELHI,13943,14183,DELHI-VADODARA,28126,All
2015,10,VADODARA,DELHI,13124,14117,DELHI-VADODARA,27241,All
2015,11,VADODARA,DELHI,17045,16939,DELHI-VADODARA,33984,All
2015,12,VADODARA,DELHI,17052,20069,DELHI-VADODARA,37121,All
2016,1,VADODARA,DELHI,17966,17245,DELHI-VADODARA,35211,All
2016,2,VADODARA,DELHI,16544,16504,DELHI-VADODARA,33048,All
2016,3,VADODARA,DELHI,17230,17556,DELHI-VADODARA,34786,All
2016,4,VADODARA,DELHI,16967,16505,DELHI-VADODARA,33472,All
2016,5,VADODARA,DELHI,17562,18692,DELHI-VADODARA,36254,All
2016,6,VADODARA,DELHI,13602,16642,DELHI-VADODARA,30244,All
2016,7,VADODARA,DELHI,14370,16113,DELHI-VADODARA,30483,All
2016,8,VADODARA,DELHI,14333,15652,DELHI-VADODARA,29985,All
2016,9,VADODARA,DELHI,14719,15515,DELHI-VADODARA,30234,All
2016,10,VADODARA,DELHI,18244,16056,DELHI-VADODARA,34300,All
2016,11,VADODARA,DELHI,16692,19915,DELHI-VADODARA,36607,All
2016,12,VADODARA,DELHI,16776,20084,DELHI-VADODARA,36860,All
2017,1,VADODARA,DELHI,18693,19107,DELHI-VADODARA,37800,All
2017,2,VADODARA,DELHI,17349,16474,DELHI-VADODARA,33823,All
2017,3,VADODARA,DELHI,16661,16734,DELHI-VADODARA,33395,All
2017,4,VADODARA,DELHI,16597,14009,DELHI-VADODARA,30606,All
2017,5,VADODARA,DELHI,20465,19441,DELHI-VADODARA,39906,All
2017,6,VADODARA,DELHI,13989,16754,DELHI-VADODARA,30743,All
2017,7,VADODARA,DELHI,10938,11599,DELHI-VADODARA,22537,All
2017,8,VADODARA,DELHI,13337,12905,DELHI-VADODARA,26242,All
2017,9,VADODARA,DELHI,11959,11875,DELHI-VADODARA,23834,All
2017,10,VADODARA,DELHI,18077,15573,DELHI-VADODARA,33650,All
2017,11,VADODARA,DELHI,15013,17170,DELHI-VADODARA,32183,All
2017,12,VADODARA,DELHI,16229,19218,DELHI-VADODARA,35447,All
2018,1,VADODARA,DELHI,18214,17474,DELHI-VADODARA,35688,All
2018,2,VADODARA,DELHI,17296,16435,DELHI-VADODARA,33731,All
2018,3,VADODARA,DELHI,18253,18408,DELHI-VADODARA,36661,All
2018,4,VADODARA,DELHI,19757,17857,DELHI-VADODARA,37614,All
2018,5,VADODARA,DELHI,19776,19628,DELHI-VADODARA,39404,All
2018,6,VADODARA,DELHI,17079,19625,DELHI-VADODARA,36704,All
2018,7,VADODARA,DELHI,18188,18372,DELHI-VADODARA,36560,All
2018,8,VADODARA,DELHI,16981,16811,DELHI-VADODARA,33792,All
2018,9,VADODARA,DELHI,15968,16341,DELHI-VADODARA,32309,All
2018,10,VADODARA,DELHI,16374,16794,DELHI-VADODARA,33168,All
2018,11,VADODARA,DELHI,19139,18705,DELHI-VADODARA,37844,All
2018,12,VADODARA,DELHI,18806,21074,DELHI-VADODARA,39880,All
2019,1,VADODARA,DELHI,21838,20222,DELHI-VADODARA,42060,All
2019,2,VADODARA,DELHI,23157,20649,DELHI-VADODARA,43806,All
2019,3,VADODARA,DELHI,20650,18819,DELHI-VADODARA,39469,All
2019,4,VADODARA,DELHI,17902,16399,DELHI-VADODARA,34301,All
2016,4,VADODARA,GOA,1176,1030,GOA-VADODARA,2206,All
2016,5,VADODARA,GOA,3328,3207,GOA-VADODARA,6535,All
2016,6,VADODARA,GOA,1546,1950,GOA-VADODARA,3496,All
2016,7,VADODARA,GOA,2171,2250,GOA-VADODARA,4421,All
2016,8,VADODARA,GOA,1921,2118,GOA-VADODARA,4039,All
2016,9,VADODARA,GOA,1151,1374,GOA-VADODARA,2525,All
2016,10,VADODARA,GOA,783,894,GOA-VADODARA,1677,All
2016,11,VADODARA,GOA,391,401,GOA-VADODARA,792,All
2016,12,VADODARA,GOA,262,271,GOA-VADODARA,533,All
2017,1,VADODARA,GOA,333,458,GOA-VADODARA,791,All
2017,2,VADODARA,GOA,304,347,GOA-VADODARA,651,All
2017,3,VADODARA,GOA,160,189,GOA-VADODARA,349,All
2015,4,VADODARA,HYDERABAD,575,444,HYDERABAD-VADODARA,1019,All
2015,5,VADODARA,HYDERABAD,780,531,HYDERABAD-VADODARA,1311,All
2015,6,VADODARA,HYDERABAD,560,485,HYDERABAD-VADODARA,1045,All
2015,7,VADODARA,HYDERABAD,373,423,HYDERABAD-VADODARA,796,All
2015,8,VADODARA,HYDERABAD,444,474,HYDERABAD-VADODARA,918,All
2015,9,VADODARA,HYDERABAD,476,533,HYDERABAD-VADODARA,1009,All
2015,10,VADODARA,HYDERABAD,863,519,HYDERABAD-VADODARA,1382,All
2015,11,VADODARA,HYDERABAD,1079,879,HYDERABAD-VADODARA,1958,All
2015,12,VADODARA,HYDERABAD,876,954,HYDERABAD-VADODARA,1830,All
2016,1,VADODARA,HYDERABAD,1092,1056,HYDERABAD-VADODARA,2148,All
2016,2,VADODARA,HYDERABAD,793,733,HYDERABAD-VADODARA,1526,All
2016,3,VADODARA,HYDERABAD,698,647,HYDERABAD-VADODARA,1345,All
2016,4,VADODARA,HYDERABAD,499,0,HYDERABAD-VADODARA,499,All
2016,5,VADODARA,HYDERABAD,548,374,HYDERABAD-VADODARA,922,All
2016,6,VADODARA,HYDERABAD,390,451,HYDERABAD-VADODARA,841,All
2016,7,VADODARA,HYDERABAD,315,381,HYDERABAD-VADODARA,696,All
2016,8,VADODARA,HYDERABAD,260,407,HYDERABAD-VADODARA,667,All
2016,9,VADODARA,HYDERABAD,294,306,HYDERABAD-VADODARA,600,All
2016,10,VADODARA,HYDERABAD,376,351,HYDERABAD-VADODARA,727,All
2016,11,VADODARA,HYDERABAD,322,383,HYDERABAD-VADODARA,705,All
2016,12,VADODARA,HYDERABAD,267,401,HYDERABAD-VADODARA,668,All
2017,1,VADODARA,HYDERABAD,323,413,HYDERABAD-VADODARA,736,All
2017,2,VADODARA,HYDERABAD,539,301,HYDERABAD-VADODARA,840,All
2017,3,VADODARA,HYDERABAD,471,227,HYDERABAD-VADODARA,698,All
2017,4,VADODARA,HYDERABAD,510,145,HYDERABAD-VADODARA,655,All
2017,5,VADODARA,HYDERABAD,432,318,HYDERABAD-VADODARA,750,All
2017,6,VADODARA,HYDERABAD,502,412,HYDERABAD-VADODARA,914,All
2017,7,VADODARA,HYDERABAD,433,503,HYDERABAD-VADODARA,936,All
2017,8,VADODARA,HYDERABAD,474,491,HYDERABAD-VADODARA,965,All
2017,9,VADODARA,HYDERABAD,528,537,HYDERABAD-VADODARA,1065,All
2017,10,VADODARA,HYDERABAD,580,535,HYDERABAD-VADODARA,1115,All
2017,11,VADODARA,HYDERABAD,451,477,HYDERABAD-VADODARA,928,All
2017,12,VADODARA,HYDERABAD,560,482,HYDERABAD-VADODARA,1042,All
2018,1,VADODARA,HYDERABAD,524,414,HYDERABAD-VADODARA,938,All
2018,2,VADODARA,HYDERABAD,452,387,HYDERABAD-VADODARA,839,All
2018,3,VADODARA,HYDERABAD,324,357,HYDERABAD-VADODARA,681,All
2018,4,VADODARA,HYDERABAD,303,378,HYDERABAD-VADODARA,681,All
2018,5,VADODARA,HYDERABAD,276,242,HYDERABAD-VADODARA,518,All
2018,6,VADODARA,HYDERABAD,301,351,HYDERABAD-VADODARA,652,All
2018,7,VADODARA,HYDERABAD,177,260,HYDERABAD-VADODARA,437,All
2018,8,VADODARA,HYDERABAD,0,208,HYDERABAD-VADODARA,208,All
2018,9,VADODARA,HYDERABAD,1790,1232,HYDERABAD-VADODARA,3022,All
2018,10,VADODARA,HYDERABAD,3834,2586,HYDERABAD-VADODARA,6420,All
2018,11,VADODARA,HYDERABAD,4613,3933,HYDERABAD-VADODARA,8546,All
2018,12,VADODARA,HYDERABAD,4807,4274,HYDERABAD-VADODARA,9081,All
2019,1,VADODARA,HYDERABAD,4901,4512,HYDERABAD-VADODARA,9413,All
2019,2,VADODARA,HYDERABAD,3757,2641,HYDERABAD-VADODARA,6398,All
2019,3,VADODARA,HYDERABAD,4880,2883,HYDERABAD-VADODARA,7763,All
2019,4,VADODARA,HYDERABAD,4442,3555,HYDERABAD-VADODARA,7997,All
2018,9,VADODARA,INDORE,701,699,INDORE-VADODARA,1400,All
2018,10,VADODARA,INDORE,650,710,INDORE-VADODARA,1360,All
2018,11,VADODARA,INDORE,859,757,INDORE-VADODARA,1616,All
2018,12,VADODARA,INDORE,899,889,INDORE-VADODARA,1788,All
2019,1,VADODARA,INDORE,1050,998,INDORE-VADODARA,2048,All
2019,2,VADODARA,INDORE,794,761,INDORE-VADODARA,1555,All
2019,3,VADODARA,INDORE,745,489,INDORE-VADODARA,1234,All
2018,3,VADODARA,JAIPUR,0,146,JAIPUR-VADODARA,146,All
2018,9,VADODARA,JAIPUR,868,815,JAIPUR-VADODARA,1683,All
2018,10,VADODARA,JAIPUR,781,578,JAIPUR-VADODARA,1359,All
2018,11,VADODARA,JAIPUR,1009,1011,JAIPUR-VADODARA,2020,All
2018,12,VADODARA,JAIPUR,1116,1045,JAIPUR-VADODARA,2161,All
2019,1,VADODARA,JAIPUR,1182,1147,JAIPUR-VADODARA,2329,All
2019,2,VADODARA,JAIPUR,1061,940,JAIPUR-VADODARA,2001,All
2019,3,VADODARA,JAIPUR,1130,974,JAIPUR-VADODARA,2104,All
2019,2,VADODARA,JODHPUR,49,0,JODHPUR-VADODARA,49,All
2017,11,VADODARA,KOCHI,15,0,KOCHI-VADODARA,15,All
2017,12,VADODARA,KOCHI,25,0,KOCHI-VADODARA,25,All
2018,1,VADODARA,KOCHI,44,0,KOCHI-VADODARA,44,All
2018,2,VADODARA,KOCHI,45,0,KOCHI-VADODARA,45,All
2018,3,VADODARA,KOCHI,39,0,KOCHI-VADODARA,39,All
2018,4,VADODARA,KOCHI,59,0,KOCHI-VADODARA,59,All
2018,5,VADODARA,KOCHI,46,0,KOCHI-VADODARA,46,All
2018,6,VADODARA,KOCHI,13,0,KOCHI-VADODARA,13,All
2018,7,VADODARA,KOCHI,10,0,KOCHI-VADODARA,10,All
2018,8,VADODARA,KOCHI,4,0,KOCHI-VADODARA,4,All
2018,9,VADODARA,KOCHI,18,0,KOCHI-VADODARA,18,All
2018,10,VADODARA,KOCHI,20,0,KOCHI-VADODARA,20,All
2018,11,VADODARA,KOCHI,35,0,KOCHI-VADODARA,35,All
2018,12,VADODARA,KOCHI,23,0,KOCHI-VADODARA,23,All
2019,1,VADODARA,KOCHI,24,0,KOCHI-VADODARA,24,All
2019,2,VADODARA,KOCHI,44,0,KOCHI-VADODARA,44,All
2019,3,VADODARA,KOCHI,24,0,KOCHI-VADODARA,24,All
2019,4,VADODARA,KOCHI,9,0,KOCHI-VADODARA,9,All
2015,4,VADODARA,KOLKATA,355,0,KOLKATA-VADODARA,355,All
2015,6,VADODARA,KOLKATA,388,0,KOLKATA-VADODARA,388,All
2015,7,VADODARA,KOLKATA,353,0,KOLKATA-VADODARA,353,All
2015,8,VADODARA,KOLKATA,286,0,KOLKATA-VADODARA,286,All
2015,9,VADODARA,KOLKATA,347,0,KOLKATA-VADODARA,347,All
2015,10,VADODARA,KOLKATA,523,0,KOLKATA-VADODARA,523,All
2015,11,VADODARA,KOLKATA,735,0,KOLKATA-VADODARA,735,All
2015,12,VADODARA,KOLKATA,688,0,KOLKATA-VADODARA,688,All
2016,1,VADODARA,KOLKATA,743,0,KOLKATA-VADODARA,743,All
2016,2,VADODARA,KOLKATA,723,0,KOLKATA-VADODARA,723,All
2016,3,VADODARA,KOLKATA,626,0,KOLKATA-VADODARA,626,All
2016,4,VADODARA,KOLKATA,1021,0,KOLKATA-VADODARA,1021,All
2016,5,VADODARA,KOLKATA,1124,0,KOLKATA-VADODARA,1124,All
2016,6,VADODARA,KOLKATA,928,0,KOLKATA-VADODARA,928,All
2016,7,VADODARA,KOLKATA,763,0,KOLKATA-VADODARA,763,All
2016,8,VADODARA,KOLKATA,890,0,KOLKATA-VADODARA,890,All
2016,9,VADODARA,KOLKATA,601,0,KOLKATA-VADODARA,601,All
2016,10,VADODARA,KOLKATA,637,0,KOLKATA-VADODARA,637,All
2016,11,VADODARA,KOLKATA,745,0,KOLKATA-VADODARA,745,All
2016,12,VADODARA,KOLKATA,717,0,KOLKATA-VADODARA,717,All
2017,1,VADODARA,KOLKATA,1027,0,KOLKATA-VADODARA,1027,All
2017,2,VADODARA,KOLKATA,636,0,KOLKATA-VADODARA,636,All
2017,3,VADODARA,KOLKATA,407,0,KOLKATA-VADODARA,407,All
2017,10,VADODARA,KOLKATA,3,13,KOLKATA-VADODARA,16,All
2017,11,VADODARA,KOLKATA,118,199,KOLKATA-VADODARA,317,All
2017,12,VADODARA,KOLKATA,286,184,KOLKATA-VADODARA,470,All
2018,1,VADODARA,KOLKATA,242,85,KOLKATA-VADODARA,327,All
2018,2,VADODARA,KOLKATA,162,130,KOLKATA-VADODARA,292,All
2018,3,VADODARA,KOLKATA,227,118,KOLKATA-VADODARA,345,All
2016,4,VADODARA,LUCKNOW,121,69,LUCKNOW-VADODARA,190,All
2016,5,VADODARA,LUCKNOW,379,224,LUCKNOW-VADODARA,603,All
2016,6,VADODARA,LUCKNOW,312,190,LUCKNOW-VADODARA,502,All
2016,7,VADODARA,LUCKNOW,325,203,LUCKNOW-VADODARA,528,All
2016,8,VADODARA,LUCKNOW,197,238,LUCKNOW-VADODARA,435,All
2016,9,VADODARA,LUCKNOW,128,98,LUCKNOW-VADODARA,226,All
2016,10,VADODARA,LUCKNOW,179,105,LUCKNOW-VADODARA,284,All
2016,11,VADODARA,LUCKNOW,125,101,LUCKNOW-VADODARA,226,All
2016,12,VADODARA,LUCKNOW,151,289,LUCKNOW-VADODARA,440,All
2017,1,VADODARA,LUCKNOW,276,197,LUCKNOW-VADODARA,473,All
2017,2,VADODARA,LUCKNOW,211,219,LUCKNOW-VADODARA,430,All
2017,3,VADODARA,LUCKNOW,208,147,LUCKNOW-VADODARA,355,All
2017,4,VADODARA,LUCKNOW,180,174,LUCKNOW-VADODARA,354,All
2017,5,VADODARA,LUCKNOW,0,194,LUCKNOW-VADODARA,194,All
2017,6,VADODARA,LUCKNOW,0,225,LUCKNOW-VADODARA,225,All
2017,7,VADODARA,LUCKNOW,399,286,LUCKNOW-VADODARA,685,All
2017,8,VADODARA,LUCKNOW,237,187,LUCKNOW-VADODARA,424,All
2017,9,VADODARA,LUCKNOW,292,258,LUCKNOW-VADODARA,550,All
2017,10,VADODARA,LUCKNOW,0,131,LUCKNOW-VADODARA,131,All
2017,11,VADODARA,LUCKNOW,0,146,LUCKNOW-VADODARA,146,All
2017,12,VADODARA,LUCKNOW,0,105,LUCKNOW-VADODARA,105,All
2018,1,VADODARA,LUCKNOW,0,164,LUCKNOW-VADODARA,164,All
2018,2,VADODARA,LUCKNOW,0,207,LUCKNOW-VADODARA,207,All
2018,3,VADODARA,LUCKNOW,0,108,LUCKNOW-VADODARA,108,All
2017,7,VADODARA,MANGALORE,74,0,MANGALORE-VADODARA,74,All
2017,8,VADODARA,MANGALORE,94,0,MANGALORE-VADODARA,94,All
2017,9,VADODARA,MANGALORE,95,0,MANGALORE-VADODARA,95,All
2017,10,VADODARA,MANGALORE,163,0,MANGALORE-VADODARA,163,All
2017,11,VADODARA,MANGALORE,84,0,MANGALORE-VADODARA,84,All
2017,12,VADODARA,MANGALORE,70,0,MANGALORE-VADODARA,70,All
2018,1,VADODARA,MANGALORE,109,0,MANGALORE-VADODARA,109,All
2018,2,VADODARA,MANGALORE,134,0,MANGALORE-VADODARA,134,All
2018,3,VADODARA,MANGALORE,100,0,MANGALORE-VADODARA,100,All
2018,4,VADODARA,MANGALORE,66,0,MANGALORE-VADODARA,66,All
2018,5,VADODARA,MANGALORE,141,0,MANGALORE-VADODARA,141,All
2018,6,VADODARA,MANGALORE,123,0,MANGALORE-VADODARA,123,All
2018,7,VADODARA,MANGALORE,84,0,MANGALORE-VADODARA,84,All
2018,8,VADODARA,MANGALORE,107,0,MANGALORE-VADODARA,107,All
2018,9,VADODARA,MANGALORE,95,0,MANGALORE-VADODARA,95,All
2018,10,VADODARA,MANGALORE,116,0,MANGALORE-VADODARA,116,All
2018,11,VADODARA,MANGALORE,230,0,MANGALORE-VADODARA,230,All
2018,12,VADODARA,MANGALORE,83,0,MANGALORE-VADODARA,83,All
2019,1,VADODARA,MANGALORE,149,0,MANGALORE-VADODARA,149,All
2019,2,VADODARA,MANGALORE,103,0,MANGALORE-VADODARA,103,All
2019,3,VADODARA,MANGALORE,109,0,MANGALORE-VADODARA,109,All
2019,4,VADODARA,MANGALORE,53,0,MANGALORE-VADODARA,53,All
2015,4,VADODARA,MUMBAI,18625,18843,MUMBAI-VADODARA,37468,All
2015,5,VADODARA,MUMBAI,21960,18147,MUMBAI-VADODARA,40107,All
2015,6,VADODARA,MUMBAI,17683,17306,MUMBAI-VADODARA,34989,All
2015,7,VADODARA,MUMBAI,19223,18181,MUMBAI-VADODARA,37404,All
2015,8,VADODARA,MUMBAI,20605,19241,MUMBAI-VADODARA,39846,All
2015,9,VADODARA,MUMBAI,21461,19257,MUMBAI-VADODARA,40718,All
2015,10,VADODARA,MUMBAI,19385,18809,MUMBAI-VADODARA,38194,All
2015,11,VADODARA,MUMBAI,21791,22537,MUMBAI-VADODARA,44328,All
2015,12,VADODARA,MUMBAI,23973,24568,MUMBAI-VADODARA,48541,All
2016,1,VADODARA,MUMBAI,23156,23137,MUMBAI-VADODARA,46293,All
2016,2,VADODARA,MUMBAI,23505,20608,MUMBAI-VADODARA,44113,All
2016,3,VADODARA,MUMBAI,22346,19514,MUMBAI-VADODARA,41860,All
2016,4,VADODARA,MUMBAI,22784,21090,MUMBAI-VADODARA,43874,All
2016,5,VADODARA,MUMBAI,26257,22831,MUMBAI-VADODARA,49088,All
2016,6,VADODARA,MUMBAI,23588,21110,MUMBAI-VADODARA,44698,All
2016,7,VADODARA,MUMBAI,25072,21699,MUMBAI-VADODARA,46771,All
2016,8,VADODARA,MUMBAI,25810,22203,MUMBAI-VADODARA,48013,All
2016,9,VADODARA,MUMBAI,24592,20716,MUMBAI-VADODARA,45308,All
2016,10,VADODARA,MUMBAI,22907,19990,MUMBAI-VADODARA,42897,All
2016,11,VADODARA,MUMBAI,23436,22643,MUMBAI-VADODARA,46079,All
2016,12,VADODARA,MUMBAI,27946,25941,MUMBAI-VADODARA,53887,All
2017,1,VADODARA,MUMBAI,28064,26540,MUMBAI-VADODARA,54604,All
2017,2,VADODARA,MUMBAI,25763,22629,MUMBAI-VADODARA,48392,All
2017,3,VADODARA,MUMBAI,25236,20912,MUMBAI-VADODARA,46148,All
2017,4,VADODARA,MUMBAI,22962,20825,MUMBAI-VADODARA,43787,All
2017,5,VADODARA,MUMBAI,26842,22553,MUMBAI-VADODARA,49395,All
2017,6,VADODARA,MUMBAI,22827,22558,MUMBAI-VADODARA,45385,All
2017,7,VADODARA,MUMBAI,25035,21401,MUMBAI-VADODARA,46436,All
2017,8,VADODARA,MUMBAI,25087,21072,MUMBAI-VADODARA,46159,All
2017,9,VADODARA,MUMBAI,22793,19953,MUMBAI-VADODARA,42746,All
2017,10,VADODARA,MUMBAI,25817,22962,MUMBAI-VADODARA,48779,All
2017,11,VADODARA,MUMBAI,26365,25352,MUMBAI-VADODARA,51717,All
2017,12,VADODARA,MUMBAI,26138,25103,MUMBAI-VADODARA,51241,All
2018,1,VADODARA,MUMBAI,27670,26548,MUMBAI-VADODARA,54218,All
2018,2,VADODARA,MUMBAI,25184,23893,MUMBAI-VADODARA,49077,All
2018,3,VADODARA,MUMBAI,28020,23002,MUMBAI-VADODARA,51022,All
2018,4,VADODARA,MUMBAI,25727,23227,MUMBAI-VADODARA,48954,All
2018,5,VADODARA,MUMBAI,27042,20888,MUMBAI-VADODARA,47930,All
2018,6,VADODARA,MUMBAI,22683,20806,MUMBAI-VADODARA,43489,All
2018,7,VADODARA,MUMBAI,23986,22364,MUMBAI-VADODARA,46350,All
2018,8,VADODARA,MUMBAI,22970,18992,MUMBAI-VADODARA,41962,All
2018,9,VADODARA,MUMBAI,24676,21300,MUMBAI-VADODARA,45976,All
2018,10,VADODARA,MUMBAI,23147,21970,MUMBAI-VADODARA,45117,All
2018,11,VADODARA,MUMBAI,21528,20802,MUMBAI-VADODARA,42330,All
2018,12,VADODARA,MUMBAI,22974,22523,MUMBAI-VADODARA,45497,All
2019,1,VADODARA,MUMBAI,23581,23412,MUMBAI-VADODARA,46993,All
2019,2,VADODARA,MUMBAI,20536,19243,MUMBAI-VADODARA,39779,All
2019,3,VADODARA,MUMBAI,15634,13720,MUMBAI-VADODARA,29354,All
2019,4,VADODARA,MUMBAI,12013,10695,MUMBAI-VADODARA,22708,All
2018,9,VADODARA,PORT BLAIR,4,0,PORT BLAIR-VADODARA,4,All
2018,10,VADODARA,PORT BLAIR,75,0,PORT BLAIR-VADODARA,75,All
2019,3,VADODARA,PORT BLAIR,2,0,PORT BLAIR-VADODARA,2,All
2019,4,VADODARA,PORT BLAIR,180,0,PORT BLAIR-VADODARA,180,All
2018,8,VADODARA,SURAT,5,0,SURAT-VADODARA,5,All
2018,9,VADODARA,SURAT,5,0,SURAT-VADODARA,5,All
2019,4,VADODARA,SURAT,1,0,SURAT-VADODARA,1,All
2017,6,VADODARA,VISAKHAPATNAM,0,8,VADODARA-VISAKHAPATNAM,8,All
2017,7,VADODARA,VISAKHAPATNAM,0,12,VADODARA-VISAKHAPATNAM,12,All
2017,8,VADODARA,VISAKHAPATNAM,0,7,VADODARA-VISAKHAPATNAM,7,All
2023,11,VARANASI,VIJAYAWADA,30,0,VARANASI-VIJAYAWADA,30,All
2019,10,VARANASI,VISAKHAPATNAM,0,88,VARANASI-VISAKHAPATNAM,88,All
2019,11,VARANASI,VISAKHAPATNAM,0,731,VARANASI-VISAKHAPATNAM,731,All
2019,12,VARANASI,VISAKHAPATNAM,0,883,VARANASI-VISAKHAPATNAM,883,All
2020,1,VARANASI,VISAKHAPATNAM,0,302,VARANASI-VISAKHAPATNAM,302,All
2020,2,VARANASI,VISAKHAPATNAM,0,137,VARANASI-VISAKHAPATNAM,137,All
2022,10,VARANASI,VISAKHAPATNAM,2,6,VARANASI-VISAKHAPATNAM,8,All
2022,11,VARANASI,VISAKHAPATNAM,177,165,VARANASI-VISAKHAPATNAM,342,All
2022,12,VARANASI,VISAKHAPATNAM,289,144,VARANASI-VISAKHAPATNAM,433,All
2023,1,VARANASI,VISAKHAPATNAM,434,194,VARANASI-VISAKHAPATNAM,628,All
2023,2,VARANASI,VISAKHAPATNAM,360,319,VARANASI-VISAKHAPATNAM,679,All
2023,3,VARANASI,VISAKHAPATNAM,376,273,VARANASI-VISAKHAPATNAM,649,All
2023,4,VARANASI,VISAKHAPATNAM,172,185,VARANASI-VISAKHAPATNAM,357,All
2023,5,VARANASI,VISAKHAPATNAM,175,159,VARANASI-VISAKHAPATNAM,334,All
2023,6,VARANASI,VISAKHAPATNAM,238,163,VARANASI-VISAKHAPATNAM,401,All
2023,7,VARANASI,VISAKHAPATNAM,298,96,VARANASI-VISAKHAPATNAM,394,All
2023,8,VARANASI,VISAKHAPATNAM,263,211,VARANASI-VISAKHAPATNAM,474,All
2023,9,VARANASI,VISAKHAPATNAM,242,378,VARANASI-VISAKHAPATNAM,620,All
2023,10,VARANASI,VISAKHAPATNAM,560,443,VARANASI-VISAKHAPATNAM,1003,All
2023,11,VARANASI,VISAKHAPATNAM,600,343,VARANASI-VISAKHAPATNAM,943,All
2023,12,VARANASI,VISAKHAPATNAM,374,233,VARANASI-VISAKHAPATNAM,607,All
2024,1,VARANASI,VISAKHAPATNAM,276,52,VARANASI-VISAKHAPATNAM,328,All
2024,2,VARANASI,VISAKHAPATNAM,510,376,VARANASI-VISAKHAPATNAM,886,All
2024,3,VARANASI,VISAKHAPATNAM,610,335,VARANASI-VISAKHAPATNAM,945,All
2024,10,VARANASI,VISAKHAPATNAM,117,46,VARANASI-VISAKHAPATNAM,163,All
2024,11,VARANASI,VISAKHAPATNAM,626,129,VARANASI-VISAKHAPATNAM,755,All
2024,12,VARANASI,VISAKHAPATNAM,237,16,VARANASI-VISAKHAPATNAM,253,All
2025,3,VARANASI,VISAKHAPATNAM,33,44,VARANASI-VISAKHAPATNAM,77,All
2017,2,VIJAYAWADA,VARANASI,475,302,VARANASI-VIJAYAWADA,777,All
2017,3,VIJAYAWADA,VARANASI,1075,980,VARANASI-VIJAYAWADA,2055,All
2017,4,VIJAYAWADA,VARANASI,980,865,VARANASI-VIJAYAWADA,1845,All
2015,4,VIJAYAWADA,VISAKHAPATNAM,344,245,VIJAYAWADA-VISAKHAPATNAM,589,All
2015,11,VIJAYAWADA,VISAKHAPATNAM,516,361,VIJAYAWADA-VISAKHAPATNAM,877,All
2015,12,VIJAYAWADA,VISAKHAPATNAM,532,421,VIJAYAWADA-VISAKHAPATNAM,953,All
2016,1,VIJAYAWADA,VISAKHAPATNAM,400,272,VIJAYAWADA-VISAKHAPATNAM,672,All
2016,2,VIJAYAWADA,VISAKHAPATNAM,467,404,VIJAYAWADA-VISAKHAPATNAM,871,All
2016,3,VIJAYAWADA,VISAKHAPATNAM,409,328,VIJAYAWADA-VISAKHAPATNAM,737,All
2016,4,VIJAYAWADA,VISAKHAPATNAM,204,1699,VIJAYAWADA-VISAKHAPATNAM,1903,All
2016,5,VIJAYAWADA,VISAKHAPATNAM,1294,2801,VIJAYAWADA-VISAKHAPATNAM,4095,All
2016,6,VIJAYAWADA,VISAKHAPATNAM,1132,2241,VIJAYAWADA-VISAKHAPATNAM,3373,All
2016,7,VIJAYAWADA,VISAKHAPATNAM,1295,2498,VIJAYAWADA-VISAKHAPATNAM,3793,All
2016,8,VIJAYAWADA,VISAKHAPATNAM,2357,2174,VIJAYAWADA-VISAKHAPATNAM,4531,All
2016,9,VIJAYAWADA,VISAKHAPATNAM,1505,1472,VIJAYAWADA-VISAKHAPATNAM,2977,All
2016,10,VIJAYAWADA,VISAKHAPATNAM,888,2554,VIJAYAWADA-VISAKHAPATNAM,3442,All
2016,11,VIJAYAWADA,VISAKHAPATNAM,1697,1743,VIJAYAWADA-VISAKHAPATNAM,3440,All
2016,12,VIJAYAWADA,VISAKHAPATNAM,1730,1526,VIJAYAWADA-VISAKHAPATNAM,3256,All
2017,1,VIJAYAWADA,VISAKHAPATNAM,936,840,VIJAYAWADA-VISAKHAPATNAM,1776,All
2017,2,VIJAYAWADA,VISAKHAPATNAM,730,674,VIJAYAWADA-VISAKHAPATNAM,1404,All
2017,3,VIJAYAWADA,VISAKHAPATNAM,836,674,VIJAYAWADA-VISAKHAPATNAM,1510,All
2017,4,VIJAYAWADA,VISAKHAPATNAM,881,1578,VIJAYAWADA-VISAKHAPATNAM,2459,All
2017,5,VIJAYAWADA,VISAKHAPATNAM,1827,1913,VIJAYAWADA-VISAKHAPATNAM,3740,All
2017,6,VIJAYAWADA,VISAKHAPATNAM,2748,2724,VIJAYAWADA-VISAKHAPATNAM,5472,All
2017,7,VIJAYAWADA,VISAKHAPATNAM,2633,2660,VIJAYAWADA-VISAKHAPATNAM,5293,All
2017,8,VIJAYAWADA,VISAKHAPATNAM,3263,3223,VIJAYAWADA-VISAKHAPATNAM,6486,All
2017,9,VIJAYAWADA,VISAKHAPATNAM,3164,3012,VIJAYAWADA-VISAKHAPATNAM,6176,All
2017,10,VIJAYAWADA,VISAKHAPATNAM,3253,3258,VIJAYAWADA-VISAKHAPATNAM,6511,All
2017,11,VIJAYAWADA,VISAKHAPATNAM,3289,3217,VIJAYAWADA-VISAKHAPATNAM,6506,All
2017,12,VIJAYAWADA,VISAKHAPATNAM,3503,3402,VIJAYAWADA-VISAKHAPATNAM,6905,All
2018,1,VIJAYAWADA,VISAKHAPATNAM,3773,3774,VIJAYAWADA-VISAKHAPATNAM,7547,All
2018,2,VIJAYAWADA,VISAKHAPATNAM,3488,3365,VIJAYAWADA-VISAKHAPATNAM,6853,All
2018,3,VIJAYAWADA,VISAKHAPATNAM,3727,3652,VIJAYAWADA-VISAKHAPATNAM,7379,All
2018,4,VIJAYAWADA,VISAKHAPATNAM,2871,3369,VIJAYAWADA-VISAKHAPATNAM,6240,All
2018,5,VIJAYAWADA,VISAKHAPATNAM,3090,2891,VIJAYAWADA-VISAKHAPATNAM,5981,All
2018,6,VIJAYAWADA,VISAKHAPATNAM,3086,2955,VIJAYAWADA-VISAKHAPATNAM,6041,All
2018,7,VIJAYAWADA,VISAKHAPATNAM,2735,3393,VIJAYAWADA-VISAKHAPATNAM,6128,All
2018,8,VIJAYAWADA,VISAKHAPATNAM,2793,2654,VIJAYAWADA-VISAKHAPATNAM,5447,All
2018,9,VIJAYAWADA,VISAKHAPATNAM,2545,2413,VIJAYAWADA-VISAKHAPATNAM,4958,All
2018,11,VIJAYAWADA,VISAKHAPATNAM,0,5126,VIJAYAWADA-VISAKHAPATNAM,5126,All
2018,12,VIJAYAWADA,VISAKHAPATNAM,0,5361,VIJAYAWADA-VISAKHAPATNAM,5361,All
2019,1,VIJAYAWADA,VISAKHAPATNAM,2381,2251,VIJAYAWADA-VISAKHAPATNAM,4632,All
2019,2,VIJAYAWADA,VISAKHAPATNAM,0,5369,VIJAYAWADA-VISAKHAPATNAM,5369,All
2019,3,VIJAYAWADA,VISAKHAPATNAM,2409,2176,VIJAYAWADA-VISAKHAPATNAM,4585,All
2019,4,VIJAYAWADA,VISAKHAPATNAM,2430,2016,VIJAYAWADA-VISAKHAPATNAM,4446,All
2019,5,VIJAYAWADA,VISAKHAPATNAM,2703,2527,VIJAYAWADA-VISAKHAPATNAM,5230,All
2019,6,VIJAYAWADA,VISAKHAPATNAM,2357,2244,VIJAYAWADA-VISAKHAPATNAM,4601,All
2019,7,VIJAYAWADA,VISAKHAPATNAM,1374,1393,VIJAYAWADA-VISAKHAPATNAM,2767,All
2019,10,VIJAYAWADA,VISAKHAPATNAM,1618,1516,VIJAYAWADA-VISAKHAPATNAM,3134,All
2019,11,VIJAYAWADA,VISAKHAPATNAM,3054,2810,VIJAYAWADA-VISAKHAPATNAM,5864,All
2019,12,VIJAYAWADA,VISAKHAPATNAM,3252,2992,VIJAYAWADA-VISAKHAPATNAM,6244,All
2020,1,VIJAYAWADA,VISAKHAPATNAM,2419,2196,VIJAYAWADA-VISAKHAPATNAM,4615,All
2020,2,VIJAYAWADA,VISAKHAPATNAM,2135,2057,VIJAYAWADA-VISAKHAPATNAM,4192,All
2020,3,VIJAYAWADA,VISAKHAPATNAM,1368,1259,VIJAYAWADA-VISAKHAPATNAM,2627,All
2020,5,VIJAYAWADA,VISAKHAPATNAM,0,0,VIJAYAWADA-VISAKHAPATNAM,0,All
2020,9,VIJAYAWADA,VISAKHAPATNAM,18,19,VIJAYAWADA-VISAKHAPATNAM,37,All
2020,10,VIJAYAWADA,VISAKHAPATNAM,0,12,VIJAYAWADA-VISAKHAPATNAM,12,All
2020,12,VIJAYAWADA,VISAKHAPATNAM,1621,1364,VIJAYAWADA-VISAKHAPATNAM,2985,All
2021,1,VIJAYAWADA,VISAKHAPATNAM,1468,1454,VIJAYAWADA-VISAKHAPATNAM,2922,All
2021,2,VIJAYAWADA,VISAKHAPATNAM,1141,1148,VIJAYAWADA-VISAKHAPATNAM,2289,All
2021,3,VIJAYAWADA,VISAKHAPATNAM,1429,1472,VIJAYAWADA-VISAKHAPATNAM,2901,All
2021,4,VIJAYAWADA,VISAKHAPATNAM,1284,1053,VIJAYAWADA-VISAKHAPATNAM,2337,All
2021,8,VIJAYAWADA,VISAKHAPATNAM,1053,997,VIJAYAWADA-VISAKHAPATNAM,2050,All
2021,9,VIJAYAWADA,VISAKHAPATNAM,1499,1324,VIJAYAWADA-VISAKHAPATNAM,2823,All
2021,10,VIJAYAWADA,VISAKHAPATNAM,1783,1648,VIJAYAWADA-VISAKHAPATNAM,3431,All
2021,11,VIJAYAWADA,VISAKHAPATNAM,1812,1796,VIJAYAWADA-VISAKHAPATNAM,3608,All
2021,12,VIJAYAWADA,VISAKHAPATNAM,1924,1872,VIJAYAWADA-VISAKHAPATNAM,3796,All
2022,1,VIJAYAWADA,VISAKHAPATNAM,1602,1290,VIJAYAWADA-VISAKHAPATNAM,2892,All
2022,2,VIJAYAWADA,VISAKHAPATNAM,1688,1584,VIJAYAWADA-VISAKHAPATNAM,3272,All
2022,3,VIJAYAWADA,VISAKHAPATNAM,1778,1708,VIJAYAWADA-VISAKHAPATNAM,3486,All
2022,4,VIJAYAWADA,VISAKHAPATNAM,2062,2032,VIJAYAWADA-VISAKHAPATNAM,4094,All
2022,5,VIJAYAWADA,VISAKHAPATNAM,1678,1701,VIJAYAWADA-VISAKHAPATNAM,3379,All
2022,6,VIJAYAWADA,VISAKHAPATNAM,1811,1801,VIJAYAWADA-VISAKHAPATNAM,3612,All
2022,7,VIJAYAWADA,VISAKHAPATNAM,1718,1851,VIJAYAWADA-VISAKHAPATNAM,3569,All
2022,8,VIJAYAWADA,VISAKHAPATNAM,1939,2003,VIJAYAWADA-VISAKHAPATNAM,3942,All
2022,9,VIJAYAWADA,VISAKHAPATNAM,1646,1726,VIJAYAWADA-VISAKHAPATNAM,3372,All
2022,10,VIJAYAWADA,VISAKHAPATNAM,2064,2034,VIJAYAWADA-VISAKHAPATNAM,4098,All
2022,11,VIJAYAWADA,VISAKHAPATNAM,1794,1835,VIJAYAWADA-VISAKHAPATNAM,3629,All
2022,12,VIJAYAWADA,VISAKHAPATNAM,1801,1696,VIJAYAWADA-VISAKHAPATNAM,3497,All
2023,1,VIJAYAWADA,VISAKHAPATNAM,1982,1900,VIJAYAWADA-VISAKHAPATNAM,3882,All
2023,2,VIJAYAWADA,VISAKHAPATNAM,1755,1640,VIJAYAWADA-VISAKHAPATNAM,3395,All
2023,3,VIJAYAWADA,VISAKHAPATNAM,1932,1910,VIJAYAWADA-VISAKHAPATNAM,3842,All
2023,4,VIJAYAWADA,VISAKHAPATNAM,2023,1861,VIJAYAWADA-VISAKHAPATNAM,3884,All
2023,5,VIJAYAWADA,VISAKHAPATNAM,2065,2145,VIJAYAWADA-VISAKHAPATNAM,4210,All
2023,6,VIJAYAWADA,VISAKHAPATNAM,2150,1958,VIJAYAWADA-VISAKHAPATNAM,4108,All
2023,7,VIJAYAWADA,VISAKHAPATNAM,1966,1844,VIJAYAWADA-VISAKHAPATNAM,3810,All
2023,8,VIJAYAWADA,VISAKHAPATNAM,1969,1739,VIJAYAWADA-VISAKHAPATNAM,3708,All
2023,9,VIJAYAWADA,VISAKHAPATNAM,1824,1796,VIJAYAWADA-VISAKHAPATNAM,3620,All
2023,10,VIJAYAWADA,VISAKHAPATNAM,1924,1808,VIJAYAWADA-VISAKHAPATNAM,3732,All
2023,11,VIJAYAWADA,VISAKHAPATNAM,1825,1635,VIJAYAWADA-VISAKHAPATNAM,3460,All
2023,12,VIJAYAWADA,VISAKHAPATNAM,1895,1536,VIJAYAWADA-VISAKHAPATNAM,3431,All
2024,1,VIJAYAWADA,VISAKHAPATNAM,1904,1584,VIJAYAWADA-VISAKHAPATNAM,3488,All
2024,2,VIJAYAWADA,VISAKHAPATNAM,1751,1564,VIJAYAWADA-VISAKHAPATNAM,3315,All
2024,3,VIJAYAWADA,VISAKHAPATNAM,1681,1621,VIJAYAWADA-VISAKHAPATNAM,3302,All
2024,4,VIJAYAWADA,VISAKHAPATNAM,1621,1420,VIJAYAWADA-VISAKHAPATNAM,3041,All
2024,6,VIJAYAWADA,VISAKHAPATNAM,1593,1748,VIJAYAWADA-VISAKHAPATNAM,3341,All
2024,7,VIJAYAWADA,VISAKHAPATNAM,1495,1582,VIJAYAWADA-VISAKHAPATNAM,3077,All
2024,8,VIJAYAWADA,VISAKHAPATNAM,1673,1681,VIJAYAWADA-VISAKHAPATNAM,3354,All
2024,9,VIJAYAWADA,VISAKHAPATNAM,1422,1338,VIJAYAWADA-VISAKHAPATNAM,2760,All
2024,10,VIJAYAWADA,VISAKHAPATNAM,2272,1724,VIJAYAWADA-VISAKHAPATNAM,3996,All
2024,11,VIJAYAWADA,VISAKHAPATNAM,5031,5055,VIJAYAWADA-VISAKHAPATNAM,10086,All
2024,12,VIJAYAWADA,VISAKHAPATNAM,6774,5961,VIJAYAWADA-VISAKHAPATNAM,12735,All
2025,1,VIJAYAWADA,VISAKHAPATNAM,6255,5986,VIJAYAWADA-VISAKHAPATNAM,12241,All
2025,2,VIJAYAWADA,VISAKHAPATNAM,5510,5304,VIJAYAWADA-VISAKHAPATNAM,10814,All
2025,3,VIJAYAWADA,VISAKHAPATNAM,6011,5003,VIJAYAWADA-VISAKHAPATNAM,11014,All
2022,11,ZIRO,DIBRUGARH,4,8,DIBRUGARH-ZIRO,12,All
2022,11,ZIRO,LILABARI,3,23,LILABARI-ZIRO,26,All
2022,10,Zero Airport,DIBRUGARH,4,1,DIBRUGARH-Zero Airport,5,All
