Year,Month,City1,City2,PaxToCity2,PaxFromCity2,Sector,Passengers,Airline
2024,3,ADAMPUR,HINDON AIRPORT,54,63,ADAMPUR-HINDON AIRPORT,117,All
2024,4,ADAMPUR,HINDON AIRPORT,1724,1559,ADAMPUR-HINDON AIRPORT,3283,All
2024,6,ADAMPUR,HINDON AIRPORT,1661,1424,ADAMPUR-HINDON AIRPORT,3085,All
2024,7,ADAMPUR,HINDON AIRPORT,1280,1214,ADAMPUR-HINDON AIRPORT,2494,All
2024,8,ADAMPUR,HINDON AIRPORT,1063,976,ADAMPUR-HINDON AIRPORT,2039,All
2024,9,ADAMPUR,HINDON AIRPORT,881,817,ADAMPUR-HINDON AIRPORT,1698,All
2024,10,ADAMPUR,HINDON AIRPORT,1561,1578,ADAMPUR-HINDON AIRPORT,3139,All
2024,11,ADAMPUR,HINDON AIRPORT,1670,1528,ADAMPUR-HINDON AIRPORT,3198,All
2024,12,ADAMPUR,HINDON AIRPORT,1709,2018,ADAMPUR-HINDON AIRPORT,3727,All
2025,1,ADAMPUR,HINDON AIRPORT,1431,1317,ADAMPUR-HINDON AIRPORT,2748,All
2025,2,ADAMPUR,HINDON AIRPORT,1686,1653,ADAMPUR-HINDON AIRPORT,3339,All
2025,3,ADAMPUR,HINDON AIRPORT,1902,1839,ADAMPUR-HINDON AIRPORT,3741,All
2024,1,AGARTALA,AHMEDABAD,359,147,AGARTALA-AHMEDABAD,506,All
2024,2,AGARTALA,AHMEDABAD,329,284,AGARTALA-AHMEDABAD,613,All
2024,3,AGARTALA,AHMEDABAD,297,244,AGARTALA-AHMEDABAD,541,All
2024,10,AGARTALA,AHMEDABAD,34,24,AGARTALA-AHMEDABAD,58,All
2024,11,AGARTALA,AHMEDABAD,172,155,AGARTALA-AHMEDABAD,327,All
2024,12,AGARTALA,AHMEDABAD,96,368,AGARTALA-AHMEDABAD,464,All
2025,3,AGARTALA,AHMEDABAD,108,167,AGARTALA-AHMEDABAD,275,All
2024,7,AGARTALA,AIZAWL,176,0,AGARTALA-AIZAWL,176,All
2024,1,AGARTALA,BENGALURU,4757,5866,AGARTALA-BENGALURU,10623,All
2024,2,AGARTALA,BENGALURU,3919,3978,AGARTALA-BENGALURU,7897,All
2024,3,AGARTALA,BENGALURU,5131,4971,AGARTALA-BENGALURU,10102,All
2024,4,AGARTALA,BENGALURU,3854,4099,AGARTALA-BENGALURU,7953,All
2024,6,AGARTALA,BENGALURU,5413,5022,AGARTALA-BENGALURU,10435,All
2024,7,AGARTALA,BENGALURU,6067,4734,AGARTALA-BENGALURU,10801,All
2024,8,AGARTALA,BENGALURU,4779,4193,AGARTALA-BENGALURU,8972,All
2024,9,AGARTALA,BENGALURU,3692,4454,AGARTALA-BENGALURU,8146,All
2024,10,AGARTALA,BENGALURU,4671,5171,AGARTALA-BENGALURU,9842,All
2024,11,AGARTALA,BENGALURU,4217,4292,AGARTALA-BENGALURU,8509,All
2024,12,AGARTALA,BENGALURU,4029,4297,AGARTALA-BENGALURU,8326,All
2025,1,AGARTALA,BENGALURU,3847,4392,AGARTALA-BENGALURU,8239,All
2025,2,AGARTALA,BENGALURU,3570,3599,AGARTALA-BENGALURU,7169,All
2025,3,AGARTALA,BENGALURU,3903,3978,AGARTALA-BENGALURU,7881,All
2024,6,AGARTALA,CHENNAI,931,501,AGARTALA-CHENNAI,1432,All
2024,7,AGARTALA,CHENNAI,461,176,AGARTALA-CHENNAI,637,All
2024,8,AGARTALA,CHENNAI,710,387,AGARTALA-CHENNAI,1097,All
2024,9,AGARTALA,CHENNAI,464,232,AGARTALA-CHENNAI,696,All
2024,10,AGARTALA,CHENNAI,461,284,AGARTALA-CHENNAI,745,All
2024,11,AGARTALA,CHENNAI,1177,732,AGARTALA-CHENNAI,1909,All
2024,12,AGARTALA,CHENNAI,1032,508,AGARTALA-CHENNAI,1540,All
2025,3,AGARTALA,CHENNAI,1085,523,AGARTALA-CHENNAI,1608,All
2024,1,AGARTALA,DELHI,6142,6425,AGARTALA-DELHI,12567,All
2024,2,AGARTALA,DELHI,5729,5809,AGARTALA-DELHI,11538,All
2024,3,AGARTALA,DELHI,5716,6271,AGARTALA-DELHI,11987,All
2024,4,AGARTALA,DELHI,4617,5055,AGARTALA-DELHI,9672,All
2024,6,AGARTALA,DELHI,4539,5144,AGARTALA-DELHI,9683,All
2024,7,AGARTALA,DELHI,5167,4878,AGARTALA-DELHI,10045,All
2024,8,AGARTALA,DELHI,4505,4594,AGARTALA-DELHI,9099,All
2024,9,AGARTALA,DELHI,3418,4143,AGARTALA-DELHI,7561,All
2024,10,AGARTALA,DELHI,4771,5184,AGARTALA-DELHI,9955,All
2024,11,AGARTALA,DELHI,5053,5145,AGARTALA-DELHI,10198,All
2024,12,AGARTALA,DELHI,4969,5340,AGARTALA-DELHI,10309,All
2025,1,AGARTALA,DELHI,4833,5203,AGARTALA-DELHI,10036,All
2025,2,AGARTALA,DELHI,5569,5879,AGARTALA-DELHI,11448,All
2025,3,AGARTALA,DELHI,6175,6862,AGARTALA-DELHI,13037,All
2024,1,AGARTALA,DIBRUGARH,65,0,AGARTALA-DIBRUGARH,65,All
2024,10,AGARTALA,DIBRUGARH,39,50,AGARTALA-DIBRUGARH,89,All
2024,11,AGARTALA,DIBRUGARH,535,506,AGARTALA-DIBRUGARH,1041,All
2024,12,AGARTALA,DIBRUGARH,443,424,AGARTALA-DIBRUGARH,867,All
2025,1,AGARTALA,DIBRUGARH,420,511,AGARTALA-DIBRUGARH,931,All
2025,2,AGARTALA,DIBRUGARH,497,374,AGARTALA-DIBRUGARH,871,All
2025,3,AGARTALA,DIBRUGARH,727,450,AGARTALA-DIBRUGARH,1177,All
2024,1,AGARTALA,GUWAHATI,9583,11031,AGARTALA-GUWAHATI,20614,All
2024,2,AGARTALA,GUWAHATI,8496,9217,AGARTALA-GUWAHATI,17713,All
2024,3,AGARTALA,GUWAHATI,9299,10314,AGARTALA-GUWAHATI,19613,All
2024,4,AGARTALA,GUWAHATI,9599,10251,AGARTALA-GUWAHATI,19850,All
2024,6,AGARTALA,GUWAHATI,9425,10536,AGARTALA-GUWAHATI,19961,All
2024,7,AGARTALA,GUWAHATI,9893,10666,AGARTALA-GUWAHATI,20559,All
2024,8,AGARTALA,GUWAHATI,8788,9820,AGARTALA-GUWAHATI,18608,All
2024,9,AGARTALA,GUWAHATI,11862,12611,AGARTALA-GUWAHATI,24473,All
2024,10,AGARTALA,GUWAHATI,12500,13341,AGARTALA-GUWAHATI,25841,All
2024,11,AGARTALA,GUWAHATI,13803,14306,AGARTALA-GUWAHATI,28109,All
2024,12,AGARTALA,GUWAHATI,15373,16464,AGARTALA-GUWAHATI,31837,All
2025,1,AGARTALA,GUWAHATI,14041,15957,AGARTALA-GUWAHATI,29998,All
2025,2,AGARTALA,GUWAHATI,13833,14167,AGARTALA-GUWAHATI,28000,All
2025,3,AGARTALA,GUWAHATI,13696,14154,AGARTALA-GUWAHATI,27850,All
2024,9,AGARTALA,HYDERABAD,604,789,AGARTALA-HYDERABAD,1393,All
2024,10,AGARTALA,HYDERABAD,2441,2899,AGARTALA-HYDERABAD,5340,All
2024,11,AGARTALA,HYDERABAD,2601,2826,AGARTALA-HYDERABAD,5427,All
2024,12,AGARTALA,HYDERABAD,2951,3047,AGARTALA-HYDERABAD,5998,All
2025,1,AGARTALA,HYDERABAD,2757,3103,AGARTALA-HYDERABAD,5860,All
2025,2,AGARTALA,HYDERABAD,2577,2606,AGARTALA-HYDERABAD,5183,All
2025,3,AGARTALA,HYDERABAD,2742,2959,AGARTALA-HYDERABAD,5701,All
2024,1,AGARTALA,IMPHAL,1386,2863,AGARTALA-IMPHAL,4249,All
2024,2,AGARTALA,IMPHAL,1382,1657,AGARTALA-IMPHAL,3039,All
2024,3,AGARTALA,IMPHAL,1485,2436,AGARTALA-IMPHAL,3921,All
2024,4,AGARTALA,IMPHAL,1186,1484,AGARTALA-IMPHAL,2670,All
2024,6,AGARTALA,IMPHAL,1557,2207,AGARTALA-IMPHAL,3764,All
2024,7,AGARTALA,IMPHAL,1375,1762,AGARTALA-IMPHAL,3137,All
2024,8,AGARTALA,IMPHAL,1258,1762,AGARTALA-IMPHAL,3020,All
2024,9,AGARTALA,IMPHAL,1326,1590,AGARTALA-IMPHAL,2916,All
2024,10,AGARTALA,IMPHAL,1951,2216,AGARTALA-IMPHAL,4167,All
2024,11,AGARTALA,IMPHAL,1218,1691,AGARTALA-IMPHAL,2909,All
2024,12,AGARTALA,IMPHAL,2118,1906,AGARTALA-IMPHAL,4024,All
2025,1,AGARTALA,IMPHAL,1880,2122,AGARTALA-IMPHAL,4002,All
2025,2,AGARTALA,IMPHAL,1245,1765,AGARTALA-IMPHAL,3010,All
2025,3,AGARTALA,IMPHAL,1851,1572,AGARTALA-IMPHAL,3423,All
2024,1,AGARTALA,KOLKATA,30666,32561,AGARTALA-KOLKATA,63227,All
2024,2,AGARTALA,KOLKATA,32045,32680,AGARTALA-KOLKATA,64725,All
2024,3,AGARTALA,KOLKATA,37092,36601,AGARTALA-KOLKATA,73693,All
2024,4,AGARTALA,KOLKATA,29983,31739,AGARTALA-KOLKATA,61722,All
2024,6,AGARTALA,KOLKATA,34136,34626,AGARTALA-KOLKATA,68762,All
2024,7,AGARTALA,KOLKATA,35004,33891,AGARTALA-KOLKATA,68895,All
2024,8,AGARTALA,KOLKATA,32172,34199,AGARTALA-KOLKATA,66371,All
2024,9,AGARTALA,KOLKATA,32595,35120,AGARTALA-KOLKATA,67715,All
2024,10,AGARTALA,KOLKATA,33339,33454,AGARTALA-KOLKATA,66793,All
2024,11,AGARTALA,KOLKATA,29721,30661,AGARTALA-KOLKATA,60382,All
2024,12,AGARTALA,KOLKATA,32054,32424,AGARTALA-KOLKATA,64478,All
2025,1,AGARTALA,KOLKATA,29428,29886,AGARTALA-KOLKATA,59314,All
2025,2,AGARTALA,KOLKATA,26757,27357,AGARTALA-KOLKATA,54114,All
2025,3,AGARTALA,KOLKATA,30230,30962,AGARTALA-KOLKATA,61192,All
2024,11,AGARTALA,RAIPUR,0,178,AGARTALA-RAIPUR,178,All
2024,1,AGARTALA,SHILLONG,393,420,AGARTALA-SHILLONG,813,All
2024,2,AGARTALA,SHILLONG,590,391,AGARTALA-SHILLONG,981,All
2024,3,AGARTALA,SHILLONG,607,544,AGARTALA-SHILLONG,1151,All
2024,8,AGARTALA,VISAKHAPATNAM,5,0,AGARTALA-VISAKHAPATNAM,5,All
2024,3,AGATTI ISLAND,BENGALURU,15,23,AGATTI ISLAND-BENGALURU,38,All
2024,4,AGATTI ISLAND,BENGALURU,786,978,AGATTI ISLAND-BENGALURU,1764,All
2024,6,AGATTI ISLAND,BENGALURU,266,157,AGATTI ISLAND-BENGALURU,423,All
2024,7,AGATTI ISLAND,BENGALURU,105,125,AGATTI ISLAND-BENGALURU,230,All
2024,8,AGATTI ISLAND,BENGALURU,410,365,AGATTI ISLAND-BENGALURU,775,All
2024,9,AGATTI ISLAND,BENGALURU,899,1336,AGATTI ISLAND-BENGALURU,2235,All
2024,10,AGATTI ISLAND,BENGALURU,1015,1486,AGATTI ISLAND-BENGALURU,2501,All
2024,11,AGATTI ISLAND,BENGALURU,580,917,AGATTI ISLAND-BENGALURU,1497,All
2024,12,AGATTI ISLAND,BENGALURU,663,1073,AGATTI ISLAND-BENGALURU,1736,All
2025,1,AGATTI ISLAND,BENGALURU,724,857,AGATTI ISLAND-BENGALURU,1581,All
2025,2,AGATTI ISLAND,BENGALURU,435,641,AGATTI ISLAND-BENGALURU,1076,All
2025,3,AGATTI ISLAND,BENGALURU,619,1092,AGATTI ISLAND-BENGALURU,1711,All
2024,4,AGATTI ISLAND,Goa,239,227,AGATTI ISLAND-Goa,466,All
2024,6,AGATTI ISLAND,Goa,228,195,AGATTI ISLAND-Goa,423,All
2024,7,AGATTI ISLAND,Goa,378,495,AGATTI ISLAND-Goa,873,All
2024,8,AGATTI ISLAND,Goa,187,443,AGATTI ISLAND-Goa,630,All
2024,9,AGATTI ISLAND,Goa,793,1243,AGATTI ISLAND-Goa,2036,All
2024,10,AGATTI ISLAND,Goa,1261,1264,AGATTI ISLAND-Goa,2525,All
2024,11,AGATTI ISLAND,Goa,1208,940,AGATTI ISLAND-Goa,2148,All
2024,12,AGATTI ISLAND,Goa,1299,1633,AGATTI ISLAND-Goa,2932,All
2025,1,AGATTI ISLAND,Goa,1381,1739,AGATTI ISLAND-Goa,3120,All
2025,2,AGATTI ISLAND,Goa,1181,1388,AGATTI ISLAND-Goa,2569,All
2025,3,AGATTI ISLAND,Goa,1134,1045,AGATTI ISLAND-Goa,2179,All
2024,1,AGATTI ISLAND,KOCHI,1765,2312,AGATTI ISLAND-KOCHI,4077,All
2024,2,AGATTI ISLAND,KOCHI,1981,2590,AGATTI ISLAND-KOCHI,4571,All
2024,3,AGATTI ISLAND,KOCHI,2117,2627,AGATTI ISLAND-KOCHI,4744,All
2024,4,AGATTI ISLAND,KOCHI,1727,2351,AGATTI ISLAND-KOCHI,4078,All
2024,6,AGATTI ISLAND,KOCHI,1179,1775,AGATTI ISLAND-KOCHI,2954,All
2024,7,AGATTI ISLAND,KOCHI,746,1001,AGATTI ISLAND-KOCHI,1747,All
2024,8,AGATTI ISLAND,KOCHI,880,1243,AGATTI ISLAND-KOCHI,2123,All
2024,9,AGATTI ISLAND,KOCHI,2310,3299,AGATTI ISLAND-KOCHI,5609,All
2024,10,AGATTI ISLAND,KOCHI,2822,3729,AGATTI ISLAND-KOCHI,6551,All
2024,11,AGATTI ISLAND,KOCHI,2888,3812,AGATTI ISLAND-KOCHI,6700,All
2024,12,AGATTI ISLAND,KOCHI,3094,4197,AGATTI ISLAND-KOCHI,7291,All
2025,1,AGATTI ISLAND,KOCHI,3124,4004,AGATTI ISLAND-KOCHI,7128,All
2025,2,AGATTI ISLAND,KOCHI,2987,3862,AGATTI ISLAND-KOCHI,6849,All
2025,3,AGATTI ISLAND,KOCHI,3041,3889,AGATTI ISLAND-KOCHI,6930,All
2024,6,AGATTI ISLAND,KOZHIKODE,107,155,AGATTI ISLAND-KOZHIKODE,262,All
2024,7,AGATTI ISLAND,KOZHIKODE,132,196,AGATTI ISLAND-KOZHIKODE,328,All
2024,8,AGATTI ISLAND,KOZHIKODE,165,176,AGATTI ISLAND-KOZHIKODE,341,All
2024,9,AGATTI ISLAND,KOZHIKODE,174,252,AGATTI ISLAND-KOZHIKODE,426,All
2024,10,AGATTI ISLAND,KOZHIKODE,111,229,AGATTI ISLAND-KOZHIKODE,340,All
2024,11,AGATTI ISLAND,KOZHIKODE,48,225,AGATTI ISLAND-KOZHIKODE,273,All
2024,12,AGATTI ISLAND,KOZHIKODE,53,145,AGATTI ISLAND-KOZHIKODE,198,All
2025,3,AGATTI ISLAND,KOZHIKODE,27,199,AGATTI ISLAND-KOZHIKODE,226,All
2024,1,AGRA,AHMEDABAD,1922,2016,AGRA-AHMEDABAD,3938,All
2024,2,AGRA,AHMEDABAD,1698,1951,AGRA-AHMEDABAD,3649,All
2024,3,AGRA,AHMEDABAD,1831,2039,AGRA-AHMEDABAD,3870,All
2025,1,AGRA,AHMEDABAD,1030,1080,AGRA-AHMEDABAD,2110,All
2025,2,AGRA,AHMEDABAD,1568,1683,AGRA-AHMEDABAD,3251,All
2025,3,AGRA,AHMEDABAD,1817,1879,AGRA-AHMEDABAD,3696,All
2024,1,AGRA,BENGALURU,2927,2952,AGRA-BENGALURU,5879,All
2024,2,AGRA,BENGALURU,2335,2547,AGRA-BENGALURU,4882,All
2024,3,AGRA,BENGALURU,2875,2829,AGRA-BENGALURU,5704,All
2024,4,AGRA,BENGALURU,2695,2762,AGRA-BENGALURU,5457,All
2024,6,AGRA,BENGALURU,2908,2746,AGRA-BENGALURU,5654,All
2024,7,AGRA,BENGALURU,3065,2986,AGRA-BENGALURU,6051,All
2024,8,AGRA,BENGALURU,2725,2700,AGRA-BENGALURU,5425,All
2024,9,AGRA,BENGALURU,2760,2890,AGRA-BENGALURU,5650,All
2024,10,AGRA,BENGALURU,2558,2842,AGRA-BENGALURU,5400,All
2024,11,AGRA,BENGALURU,2989,2700,AGRA-BENGALURU,5689,All
2024,12,AGRA,BENGALURU,2904,2997,AGRA-BENGALURU,5901,All
2025,1,AGRA,BENGALURU,2892,2997,AGRA-BENGALURU,5889,All
2025,2,AGRA,BENGALURU,1915,1916,AGRA-BENGALURU,3831,All
2025,3,AGRA,BENGALURU,2755,2879,AGRA-BENGALURU,5634,All
2024,1,AGRA,BHOPAL,196,259,AGRA-BHOPAL,455,All
2024,2,AGRA,BHOPAL,304,373,AGRA-BHOPAL,677,All
2024,3,AGRA,BHOPAL,332,421,AGRA-BHOPAL,753,All
2024,4,AGRA,DELHI,0,122,AGRA-DELHI,122,All
2024,2,AGRA,HYDERABAD,157,0,AGRA-HYDERABAD,157,All
2024,9,AGRA,HYDERABAD,95,159,AGRA-HYDERABAD,254,All
2024,10,AGRA,HYDERABAD,1768,2147,AGRA-HYDERABAD,3915,All
2024,11,AGRA,HYDERABAD,2295,1926,AGRA-HYDERABAD,4221,All
2024,12,AGRA,HYDERABAD,2218,1941,AGRA-HYDERABAD,4159,All
2025,1,AGRA,HYDERABAD,2053,1925,AGRA-HYDERABAD,3978,All
2025,2,AGRA,HYDERABAD,2008,2028,AGRA-HYDERABAD,4036,All
2025,3,AGRA,HYDERABAD,2025,2100,AGRA-HYDERABAD,4125,All
2024,1,AGRA,JAIPUR,1091,1041,AGRA-JAIPUR,2132,All
2024,2,AGRA,JAIPUR,1380,1537,AGRA-JAIPUR,2917,All
2024,3,AGRA,JAIPUR,1427,1910,AGRA-JAIPUR,3337,All
2025,2,AGRA,JAIPUR,0,9,AGRA-JAIPUR,9,All
2024,1,AGRA,LUCKNOW,777,636,AGRA-LUCKNOW,1413,All
2024,2,AGRA,LUCKNOW,1357,896,AGRA-LUCKNOW,2253,All
2024,3,AGRA,LUCKNOW,1625,1024,AGRA-LUCKNOW,2649,All
2024,4,AGRA,LUCKNOW,1035,696,AGRA-LUCKNOW,1731,All
2024,6,AGRA,LUCKNOW,1098,803,AGRA-LUCKNOW,1901,All
2024,7,AGRA,LUCKNOW,894,653,AGRA-LUCKNOW,1547,All
2024,8,AGRA,LUCKNOW,1232,830,AGRA-LUCKNOW,2062,All
2024,9,AGRA,LUCKNOW,1053,740,AGRA-LUCKNOW,1793,All
2024,1,AGRA,MUMBAI,2011,1985,AGRA-MUMBAI,3996,All
2024,2,AGRA,MUMBAI,2052,2058,AGRA-MUMBAI,4110,All
2024,3,AGRA,MUMBAI,2082,2064,AGRA-MUMBAI,4146,All
2024,4,AGRA,MUMBAI,2000,2169,AGRA-MUMBAI,4169,All
2024,6,AGRA,MUMBAI,2065,2020,AGRA-MUMBAI,4085,All
2024,7,AGRA,MUMBAI,1864,2143,AGRA-MUMBAI,4007,All
2024,8,AGRA,MUMBAI,2083,2242,AGRA-MUMBAI,4325,All
2024,9,AGRA,MUMBAI,1796,1963,AGRA-MUMBAI,3759,All
2024,10,AGRA,MUMBAI,1724,2243,AGRA-MUMBAI,3967,All
2024,11,AGRA,MUMBAI,2289,2088,AGRA-MUMBAI,4377,All
2024,12,AGRA,MUMBAI,2210,2192,AGRA-MUMBAI,4402,All
2025,1,AGRA,MUMBAI,2161,2194,AGRA-MUMBAI,4355,All
2025,2,AGRA,MUMBAI,2014,2113,AGRA-MUMBAI,4127,All
2025,3,AGRA,MUMBAI,2141,2190,AGRA-MUMBAI,4331,All
2024,1,AHMEDABAD,AMRITSAR,5359,5181,AHMEDABAD-AMRITSAR,10540,All
2024,2,AHMEDABAD,AMRITSAR,5177,5016,AHMEDABAD-AMRITSAR,10193,All
2024,3,AHMEDABAD,AMRITSAR,5591,5512,AHMEDABAD-AMRITSAR,11103,All
2024,4,AHMEDABAD,AMRITSAR,2902,2964,AHMEDABAD-AMRITSAR,5866,All
2024,6,AHMEDABAD,AMRITSAR,2988,3272,AHMEDABAD-AMRITSAR,6260,All
2024,7,AHMEDABAD,AMRITSAR,2475,2785,AHMEDABAD-AMRITSAR,5260,All
2024,8,AHMEDABAD,AMRITSAR,2686,2535,AHMEDABAD-AMRITSAR,5221,All
2024,9,AHMEDABAD,AMRITSAR,3395,3418,AHMEDABAD-AMRITSAR,6813,All
2024,10,AHMEDABAD,AMRITSAR,4471,3131,AHMEDABAD-AMRITSAR,7602,All
2024,11,AHMEDABAD,AMRITSAR,4487,4419,AHMEDABAD-AMRITSAR,8906,All
2024,12,AHMEDABAD,AMRITSAR,4493,4663,AHMEDABAD-AMRITSAR,9156,All
2025,1,AHMEDABAD,AMRITSAR,4800,4311,AHMEDABAD-AMRITSAR,9111,All
2025,2,AHMEDABAD,AMRITSAR,4309,3767,AHMEDABAD-AMRITSAR,8076,All
2025,3,AHMEDABAD,AMRITSAR,4510,4731,AHMEDABAD-AMRITSAR,9241,All
2024,3,AHMEDABAD,AURANGABAD,61,53,AHMEDABAD-AURANGABAD,114,All
2024,4,AHMEDABAD,AURANGABAD,1726,1428,AHMEDABAD-AURANGABAD,3154,All
2024,6,AHMEDABAD,AURANGABAD,1914,1436,AHMEDABAD-AURANGABAD,3350,All
2024,7,AHMEDABAD,AURANGABAD,1933,1444,AHMEDABAD-AURANGABAD,3377,All
2024,8,AHMEDABAD,AURANGABAD,1697,1525,AHMEDABAD-AURANGABAD,3222,All
2024,9,AHMEDABAD,AURANGABAD,1896,1756,AHMEDABAD-AURANGABAD,3652,All
2024,10,AHMEDABAD,AURANGABAD,1916,1625,AHMEDABAD-AURANGABAD,3541,All
2024,11,AHMEDABAD,AURANGABAD,1676,1723,AHMEDABAD-AURANGABAD,3399,All
2024,1,AHMEDABAD,Ayodhya International Airport ,1484,1309,AHMEDABAD-Ayodhya International Airport ,2793,All
2024,2,AHMEDABAD,Ayodhya International Airport ,7032,6531,AHMEDABAD-Ayodhya International Airport ,13563,All
2024,3,AHMEDABAD,Ayodhya International Airport ,7746,7426,AHMEDABAD-Ayodhya International Airport ,15172,All
2024,4,AHMEDABAD,Ayodhya International Airport ,6955,6177,AHMEDABAD-Ayodhya International Airport ,13132,All
2024,6,AHMEDABAD,Ayodhya International Airport ,6795,6911,AHMEDABAD-Ayodhya International Airport ,13706,All
2024,7,AHMEDABAD,Ayodhya International Airport ,5688,5861,AHMEDABAD-Ayodhya International Airport ,11549,All
2024,8,AHMEDABAD,Ayodhya International Airport ,6466,6285,AHMEDABAD-Ayodhya International Airport ,12751,All
2024,9,AHMEDABAD,Ayodhya International Airport ,5819,5864,AHMEDABAD-Ayodhya International Airport ,11683,All
2024,10,AHMEDABAD,Ayodhya International Airport ,3226,2062,AHMEDABAD-Ayodhya International Airport ,5288,All
2024,11,AHMEDABAD,Ayodhya International Airport ,6981,6721,AHMEDABAD-Ayodhya International Airport ,13702,All
2024,12,AHMEDABAD,Ayodhya International Airport ,6009,7116,AHMEDABAD-Ayodhya International Airport ,13125,All
2025,1,AHMEDABAD,Ayodhya International Airport ,7614,7371,AHMEDABAD-Ayodhya International Airport ,14985,All
2025,2,AHMEDABAD,Ayodhya International Airport ,7067,6929,AHMEDABAD-Ayodhya International Airport ,13996,All
2025,3,AHMEDABAD,Ayodhya International Airport ,10373,9255,AHMEDABAD-Ayodhya International Airport ,19628,All
2024,1,AHMEDABAD,BAGDOGRA,1204,1014,AHMEDABAD-BAGDOGRA,2218,All
2024,2,AHMEDABAD,BAGDOGRA,798,420,AHMEDABAD-BAGDOGRA,1218,All
2024,3,AHMEDABAD,BAGDOGRA,1094,673,AHMEDABAD-BAGDOGRA,1767,All
2024,4,AHMEDABAD,BAGDOGRA,5020,3785,AHMEDABAD-BAGDOGRA,8805,All
2024,6,AHMEDABAD,BAGDOGRA,3409,3616,AHMEDABAD-BAGDOGRA,7025,All
2024,7,AHMEDABAD,BAGDOGRA,509,427,AHMEDABAD-BAGDOGRA,936,All
2024,8,AHMEDABAD,BAGDOGRA,473,279,AHMEDABAD-BAGDOGRA,752,All
2024,9,AHMEDABAD,BAGDOGRA,720,636,AHMEDABAD-BAGDOGRA,1356,All
2024,10,AHMEDABAD,BAGDOGRA,1453,966,AHMEDABAD-BAGDOGRA,2419,All
2024,11,AHMEDABAD,BAGDOGRA,3902,3691,AHMEDABAD-BAGDOGRA,7593,All
2024,12,AHMEDABAD,BAGDOGRA,2661,2712,AHMEDABAD-BAGDOGRA,5373,All
2025,1,AHMEDABAD,BAGDOGRA,2204,2457,AHMEDABAD-BAGDOGRA,4661,All
2025,2,AHMEDABAD,BAGDOGRA,2162,2144,AHMEDABAD-BAGDOGRA,4306,All
2025,3,AHMEDABAD,BAGDOGRA,3663,3236,AHMEDABAD-BAGDOGRA,6899,All
2024,1,AHMEDABAD,BELGAUM,1140,1230,AHMEDABAD-BELGAUM,2370,All
2024,2,AHMEDABAD,BELGAUM,1216,1110,AHMEDABAD-BELGAUM,2326,All
2024,3,AHMEDABAD,BELGAUM,1125,1011,AHMEDABAD-BELGAUM,2136,All
2024,4,AHMEDABAD,BELGAUM,575,584,AHMEDABAD-BELGAUM,1159,All
2024,6,AHMEDABAD,BELGAUM,621,573,AHMEDABAD-BELGAUM,1194,All
2024,7,AHMEDABAD,BELGAUM,497,506,AHMEDABAD-BELGAUM,1003,All
2024,8,AHMEDABAD,BELGAUM,578,593,AHMEDABAD-BELGAUM,1171,All
2024,9,AHMEDABAD,BELGAUM,563,548,AHMEDABAD-BELGAUM,1111,All
2024,10,AHMEDABAD,BELGAUM,491,528,AHMEDABAD-BELGAUM,1019,All
2024,11,AHMEDABAD,BELGAUM,370,393,AHMEDABAD-BELGAUM,763,All
2024,12,AHMEDABAD,BELGAUM,137,133,AHMEDABAD-BELGAUM,270,All
2025,1,AHMEDABAD,BELGAUM,551,544,AHMEDABAD-BELGAUM,1095,All
2025,2,AHMEDABAD,BELGAUM,542,531,AHMEDABAD-BELGAUM,1073,All
2025,3,AHMEDABAD,BELGAUM,511,511,AHMEDABAD-BELGAUM,1022,All
2024,1,AHMEDABAD,BENGALURU,34025,33230,AHMEDABAD-BENGALURU,67255,All
2024,2,AHMEDABAD,BENGALURU,30321,29829,AHMEDABAD-BENGALURU,60150,All
2024,3,AHMEDABAD,BENGALURU,33622,35150,AHMEDABAD-BENGALURU,68772,All
2024,4,AHMEDABAD,BENGALURU,36287,41606,AHMEDABAD-BENGALURU,77893,All
2024,6,AHMEDABAD,BENGALURU,33554,33685,AHMEDABAD-BENGALURU,67239,All
2024,7,AHMEDABAD,BENGALURU,35490,36244,AHMEDABAD-BENGALURU,71734,All
2024,8,AHMEDABAD,BENGALURU,37083,40713,AHMEDABAD-BENGALURU,77796,All
2024,9,AHMEDABAD,BENGALURU,36518,39939,AHMEDABAD-BENGALURU,76457,All
2024,10,AHMEDABAD,BENGALURU,39880,43183,AHMEDABAD-BENGALURU,83063,All
2024,11,AHMEDABAD,BENGALURU,45675,45347,AHMEDABAD-BENGALURU,91022,All
2024,12,AHMEDABAD,BENGALURU,47073,45163,AHMEDABAD-BENGALURU,92236,All
2025,1,AHMEDABAD,BENGALURU,48818,46818,AHMEDABAD-BENGALURU,95636,All
2025,2,AHMEDABAD,BENGALURU,41223,41582,AHMEDABAD-BENGALURU,82805,All
2025,3,AHMEDABAD,BENGALURU,43663,42078,AHMEDABAD-BENGALURU,85741,All
2024,1,AHMEDABAD,BHOPAL,2267,2280,AHMEDABAD-BHOPAL,4547,All
2024,2,AHMEDABAD,BHOPAL,2074,2126,AHMEDABAD-BHOPAL,4200,All
2024,3,AHMEDABAD,BHOPAL,2723,2855,AHMEDABAD-BHOPAL,5578,All
2024,4,AHMEDABAD,BHOPAL,4133,3826,AHMEDABAD-BHOPAL,7959,All
2024,6,AHMEDABAD,BHOPAL,3759,3956,AHMEDABAD-BHOPAL,7715,All
2024,7,AHMEDABAD,BHOPAL,3558,3885,AHMEDABAD-BHOPAL,7443,All
2024,8,AHMEDABAD,BHOPAL,3850,4180,AHMEDABAD-BHOPAL,8030,All
2024,9,AHMEDABAD,BHOPAL,3812,3860,AHMEDABAD-BHOPAL,7672,All
2024,10,AHMEDABAD,BHOPAL,3964,3397,AHMEDABAD-BHOPAL,7361,All
2024,11,AHMEDABAD,BHOPAL,3832,4371,AHMEDABAD-BHOPAL,8203,All
2024,12,AHMEDABAD,BHOPAL,4146,4515,AHMEDABAD-BHOPAL,8661,All
2025,1,AHMEDABAD,BHOPAL,4251,4182,AHMEDABAD-BHOPAL,8433,All
2025,2,AHMEDABAD,BHOPAL,4041,4016,AHMEDABAD-BHOPAL,8057,All
2025,3,AHMEDABAD,BHOPAL,4069,3920,AHMEDABAD-BHOPAL,7989,All
2024,1,AHMEDABAD,BHUBANESWAR,2427,2394,AHMEDABAD-BHUBANESWAR,4821,All
2024,2,AHMEDABAD,BHUBANESWAR,2013,1997,AHMEDABAD-BHUBANESWAR,4010,All
2024,3,AHMEDABAD,BHUBANESWAR,2212,2140,AHMEDABAD-BHUBANESWAR,4352,All
2024,4,AHMEDABAD,BHUBANESWAR,2221,2187,AHMEDABAD-BHUBANESWAR,4408,All
2024,6,AHMEDABAD,BHUBANESWAR,2024,1976,AHMEDABAD-BHUBANESWAR,4000,All
2024,7,AHMEDABAD,BHUBANESWAR,2225,2269,AHMEDABAD-BHUBANESWAR,4494,All
2024,8,AHMEDABAD,BHUBANESWAR,2046,2021,AHMEDABAD-BHUBANESWAR,4067,All
2024,9,AHMEDABAD,BHUBANESWAR,3587,3406,AHMEDABAD-BHUBANESWAR,6993,All
2024,10,AHMEDABAD,BHUBANESWAR,5105,4594,AHMEDABAD-BHUBANESWAR,9699,All
2024,11,AHMEDABAD,BHUBANESWAR,5233,5343,AHMEDABAD-BHUBANESWAR,10576,All
2024,12,AHMEDABAD,BHUBANESWAR,5737,5691,AHMEDABAD-BHUBANESWAR,11428,All
2025,1,AHMEDABAD,BHUBANESWAR,5963,5868,AHMEDABAD-BHUBANESWAR,11831,All
2025,2,AHMEDABAD,BHUBANESWAR,5040,5015,AHMEDABAD-BHUBANESWAR,10055,All
2025,3,AHMEDABAD,BHUBANESWAR,6226,6047,AHMEDABAD-BHUBANESWAR,12273,All
2024,1,AHMEDABAD,BHUJ,1331,1398,AHMEDABAD-BHUJ,2729,All
2024,2,AHMEDABAD,BHUJ,1268,1327,AHMEDABAD-BHUJ,2595,All
2024,3,AHMEDABAD,BHUJ,1004,964,AHMEDABAD-BHUJ,1968,All
2024,4,AHMEDABAD,BHUJ,952,883,AHMEDABAD-BHUJ,1835,All
2024,6,AHMEDABAD,BHUJ,903,848,AHMEDABAD-BHUJ,1751,All
2024,7,AHMEDABAD,BHUJ,896,811,AHMEDABAD-BHUJ,1707,All
2024,8,AHMEDABAD,BHUJ,1132,967,AHMEDABAD-BHUJ,2099,All
2024,9,AHMEDABAD,BHUJ,1124,971,AHMEDABAD-BHUJ,2095,All
2024,10,AHMEDABAD,BHUJ,1164,1254,AHMEDABAD-BHUJ,2418,All
2024,11,AHMEDABAD,BHUJ,1564,1237,AHMEDABAD-BHUJ,2801,All
2024,12,AHMEDABAD,BHUJ,1850,1718,AHMEDABAD-BHUJ,3568,All
2025,1,AHMEDABAD,BHUJ,1797,1709,AHMEDABAD-BHUJ,3506,All
2025,2,AHMEDABAD,BHUJ,1633,1557,AHMEDABAD-BHUJ,3190,All
2025,3,AHMEDABAD,BHUJ,1336,1247,AHMEDABAD-BHUJ,2583,All
2024,1,AHMEDABAD,CHANDIGARH,4716,4535,AHMEDABAD-CHANDIGARH,9251,All
2024,2,AHMEDABAD,CHANDIGARH,7206,6218,AHMEDABAD-CHANDIGARH,13424,All
2024,3,AHMEDABAD,CHANDIGARH,7495,6812,AHMEDABAD-CHANDIGARH,14307,All
2024,4,AHMEDABAD,CHANDIGARH,9413,8341,AHMEDABAD-CHANDIGARH,17754,All
2024,6,AHMEDABAD,CHANDIGARH,8825,8727,AHMEDABAD-CHANDIGARH,17552,All
2024,7,AHMEDABAD,CHANDIGARH,7544,7526,AHMEDABAD-CHANDIGARH,15070,All
2024,8,AHMEDABAD,CHANDIGARH,7565,7014,AHMEDABAD-CHANDIGARH,14579,All
2024,9,AHMEDABAD,CHANDIGARH,7343,6640,AHMEDABAD-CHANDIGARH,13983,All
2024,10,AHMEDABAD,CHANDIGARH,9451,7397,AHMEDABAD-CHANDIGARH,16848,All
2024,11,AHMEDABAD,CHANDIGARH,10042,10206,AHMEDABAD-CHANDIGARH,20248,All
2024,12,AHMEDABAD,CHANDIGARH,10765,11237,AHMEDABAD-CHANDIGARH,22002,All
2025,1,AHMEDABAD,CHANDIGARH,9639,9555,AHMEDABAD-CHANDIGARH,19194,All
2025,2,AHMEDABAD,CHANDIGARH,10048,9458,AHMEDABAD-CHANDIGARH,19506,All
2025,3,AHMEDABAD,CHANDIGARH,11517,10949,AHMEDABAD-CHANDIGARH,22466,All
2024,1,AHMEDABAD,CHENNAI,19301,19523,AHMEDABAD-CHENNAI,38824,All
2024,2,AHMEDABAD,CHENNAI,19138,18379,AHMEDABAD-CHENNAI,37517,All
2024,3,AHMEDABAD,CHENNAI,20987,20958,AHMEDABAD-CHENNAI,41945,All
2024,4,AHMEDABAD,CHENNAI,16678,18270,AHMEDABAD-CHENNAI,34948,All
2024,6,AHMEDABAD,CHENNAI,16908,16540,AHMEDABAD-CHENNAI,33448,All
2024,7,AHMEDABAD,CHENNAI,18631,17979,AHMEDABAD-CHENNAI,36610,All
2024,8,AHMEDABAD,CHENNAI,17553,18102,AHMEDABAD-CHENNAI,35655,All
2024,9,AHMEDABAD,CHENNAI,16814,17855,AHMEDABAD-CHENNAI,34669,All
2024,10,AHMEDABAD,CHENNAI,20446,20260,AHMEDABAD-CHENNAI,40706,All
2024,11,AHMEDABAD,CHENNAI,17826,18682,AHMEDABAD-CHENNAI,36508,All
2024,12,AHMEDABAD,CHENNAI,22229,21912,AHMEDABAD-CHENNAI,44141,All
2025,1,AHMEDABAD,CHENNAI,21698,20800,AHMEDABAD-CHENNAI,42498,All
2025,2,AHMEDABAD,CHENNAI,18714,18500,AHMEDABAD-CHENNAI,37214,All
2025,3,AHMEDABAD,CHENNAI,17867,18125,AHMEDABAD-CHENNAI,35992,All
2024,1,AHMEDABAD,COIMBATORE,954,771,AHMEDABAD-COIMBATORE,1725,All
2024,2,AHMEDABAD,COIMBATORE,1200,813,AHMEDABAD-COIMBATORE,2013,All
2024,3,AHMEDABAD,COIMBATORE,1430,877,AHMEDABAD-COIMBATORE,2307,All
2024,4,AHMEDABAD,COIMBATORE,535,373,AHMEDABAD-COIMBATORE,908,All
2024,6,AHMEDABAD,COIMBATORE,837,605,AHMEDABAD-COIMBATORE,1442,All
2024,7,AHMEDABAD,COIMBATORE,541,427,AHMEDABAD-COIMBATORE,968,All
2024,8,AHMEDABAD,COIMBATORE,676,372,AHMEDABAD-COIMBATORE,1048,All
2024,9,AHMEDABAD,COIMBATORE,640,357,AHMEDABAD-COIMBATORE,997,All
2024,10,AHMEDABAD,COIMBATORE,963,680,AHMEDABAD-COIMBATORE,1643,All
2024,11,AHMEDABAD,COIMBATORE,1552,1162,AHMEDABAD-COIMBATORE,2714,All
2024,12,AHMEDABAD,COIMBATORE,1936,1618,AHMEDABAD-COIMBATORE,3554,All
2025,3,AHMEDABAD,COIMBATORE,1280,1196,AHMEDABAD-COIMBATORE,2476,All
2024,1,AHMEDABAD,DABOLIM,11304,10906,AHMEDABAD-DABOLIM,22210,All
2024,2,AHMEDABAD,DABOLIM,10678,10445,AHMEDABAD-DABOLIM,21123,All
2024,3,AHMEDABAD,DABOLIM,11183,10849,AHMEDABAD-DABOLIM,22032,All
2024,4,AHMEDABAD,DABOLIM,13049,14431,AHMEDABAD-DABOLIM,27480,All
2024,6,AHMEDABAD,DABOLIM,14820,15203,AHMEDABAD-DABOLIM,30023,All
2024,7,AHMEDABAD,DABOLIM,13596,13121,AHMEDABAD-DABOLIM,26717,All
2024,8,AHMEDABAD,DABOLIM,15159,13383,AHMEDABAD-DABOLIM,28542,All
2024,9,AHMEDABAD,DABOLIM,19989,18881,AHMEDABAD-DABOLIM,38870,All
2024,10,AHMEDABAD,DABOLIM,18371,19358,AHMEDABAD-DABOLIM,37729,All
2024,11,AHMEDABAD,DABOLIM,21191,20480,AHMEDABAD-DABOLIM,41671,All
2024,12,AHMEDABAD,DABOLIM,21814,20728,AHMEDABAD-DABOLIM,42542,All
2025,1,AHMEDABAD,DABOLIM,15798,15980,AHMEDABAD-DABOLIM,31778,All
2025,2,AHMEDABAD,DABOLIM,10001,9609,AHMEDABAD-DABOLIM,19610,All
2025,3,AHMEDABAD,DABOLIM,10692,10679,AHMEDABAD-DABOLIM,21371,All
2024,1,AHMEDABAD,DELHI,103380,101995,AHMEDABAD-DELHI,205375,All
2024,2,AHMEDABAD,DELHI,100290,96690,AHMEDABAD-DELHI,196980,All
2024,3,AHMEDABAD,DELHI,103625,100916,AHMEDABAD-DELHI,204541,All
2024,4,AHMEDABAD,DELHI,99232,89403,AHMEDABAD-DELHI,188635,All
2024,6,AHMEDABAD,DELHI,88880,107715,AHMEDABAD-DELHI,196595,All
2024,7,AHMEDABAD,DELHI,100492,105290,AHMEDABAD-DELHI,205782,All
2024,8,AHMEDABAD,DELHI,108574,109233,AHMEDABAD-DELHI,217807,All
2024,9,AHMEDABAD,DELHI,107966,108505,AHMEDABAD-DELHI,216471,All
2024,10,AHMEDABAD,DELHI,114835,102872,AHMEDABAD-DELHI,217707,All
2024,11,AHMEDABAD,DELHI,100450,110857,AHMEDABAD-DELHI,211307,All
2024,12,AHMEDABAD,DELHI,103569,116025,AHMEDABAD-DELHI,219594,All
2025,1,AHMEDABAD,DELHI,114735,114058,AHMEDABAD-DELHI,228793,All
2025,2,AHMEDABAD,DELHI,108007,103177,AHMEDABAD-DELHI,211184,All
2025,3,AHMEDABAD,DELHI,109326,105085,AHMEDABAD-DELHI,214411,All
2024,12,AHMEDABAD,DIMAPUR,177,98,AHMEDABAD-DIMAPUR,275,All
2025,3,AHMEDABAD,DIMAPUR,132,84,AHMEDABAD-DIMAPUR,216,All
2024,1,AHMEDABAD,DIU,1576,1687,AHMEDABAD-DIU,3263,All
2024,2,AHMEDABAD,DIU,1306,1320,AHMEDABAD-DIU,2626,All
2024,3,AHMEDABAD,DIU,1667,1903,AHMEDABAD-DIU,3570,All
2024,4,AHMEDABAD,DIU,1231,1252,AHMEDABAD-DIU,2483,All
2024,6,AHMEDABAD,DIU,1430,1302,AHMEDABAD-DIU,2732,All
2024,7,AHMEDABAD,DIU,735,579,AHMEDABAD-DIU,1314,All
2024,8,AHMEDABAD,DIU,1713,1378,AHMEDABAD-DIU,3091,All
2024,9,AHMEDABAD,DIU,1542,1402,AHMEDABAD-DIU,2944,All
2024,10,AHMEDABAD,DIU,1840,1775,AHMEDABAD-DIU,3615,All
2024,11,AHMEDABAD,DIU,2027,1896,AHMEDABAD-DIU,3923,All
2024,12,AHMEDABAD,DIU,2051,1824,AHMEDABAD-DIU,3875,All
2025,1,AHMEDABAD,DIU,2087,2144,AHMEDABAD-DIU,4231,All
2025,2,AHMEDABAD,DIU,1828,1865,AHMEDABAD-DIU,3693,All
2025,3,AHMEDABAD,DIU,2082,2121,AHMEDABAD-DIU,4203,All
2024,1,AHMEDABAD,DURGAPUR,292,253,AHMEDABAD-DURGAPUR,545,All
2024,2,AHMEDABAD,DURGAPUR,391,312,AHMEDABAD-DURGAPUR,703,All
2024,3,AHMEDABAD,DURGAPUR,269,211,AHMEDABAD-DURGAPUR,480,All
2024,6,AHMEDABAD,DURGAPUR,131,158,AHMEDABAD-DURGAPUR,289,All
2024,7,AHMEDABAD,DURGAPUR,135,203,AHMEDABAD-DURGAPUR,338,All
2024,8,AHMEDABAD,DURGAPUR,123,112,AHMEDABAD-DURGAPUR,235,All
2024,9,AHMEDABAD,DURGAPUR,141,135,AHMEDABAD-DURGAPUR,276,All
2024,10,AHMEDABAD,DURGAPUR,183,279,AHMEDABAD-DURGAPUR,462,All
2024,11,AHMEDABAD,DURGAPUR,95,149,AHMEDABAD-DURGAPUR,244,All
2024,12,AHMEDABAD,DURGAPUR,99,181,AHMEDABAD-DURGAPUR,280,All
2025,3,AHMEDABAD,DURGAPUR,206,104,AHMEDABAD-DURGAPUR,310,All
2024,1,AHMEDABAD,DehraDun,5178,4070,AHMEDABAD-DehraDun,9248,All
2024,2,AHMEDABAD,DehraDun,4854,3795,AHMEDABAD-DehraDun,8649,All
2024,3,AHMEDABAD,DehraDun,5126,4165,AHMEDABAD-DehraDun,9291,All
2024,4,AHMEDABAD,DehraDun,5107,4141,AHMEDABAD-DehraDun,9248,All
2024,6,AHMEDABAD,DehraDun,5018,4517,AHMEDABAD-DehraDun,9535,All
2024,7,AHMEDABAD,DehraDun,4963,4019,AHMEDABAD-DehraDun,8982,All
2024,8,AHMEDABAD,DehraDun,5223,4047,AHMEDABAD-DehraDun,9270,All
2024,9,AHMEDABAD,DehraDun,5086,4218,AHMEDABAD-DehraDun,9304,All
2024,10,AHMEDABAD,DehraDun,4998,3859,AHMEDABAD-DehraDun,8857,All
2024,11,AHMEDABAD,DehraDun,5177,5163,AHMEDABAD-DehraDun,10340,All
2024,12,AHMEDABAD,DehraDun,5104,5026,AHMEDABAD-DehraDun,10130,All
2025,1,AHMEDABAD,DehraDun,5362,4628,AHMEDABAD-DehraDun,9990,All
2025,2,AHMEDABAD,DehraDun,4972,4171,AHMEDABAD-DehraDun,9143,All
2025,3,AHMEDABAD,DehraDun,5510,5144,AHMEDABAD-DehraDun,10654,All
2025,1,AHMEDABAD,GORAKHPUR,95,0,AHMEDABAD-GORAKHPUR,95,All
2024,2,AHMEDABAD,GUWAHATI,0,0,AHMEDABAD-GUWAHATI,0,All
2024,12,AHMEDABAD,GUWAHATI,3710,3501,AHMEDABAD-GUWAHATI,7211,All
2025,1,AHMEDABAD,GUWAHATI,5178,5061,AHMEDABAD-GUWAHATI,10239,All
2025,2,AHMEDABAD,GUWAHATI,4752,4484,AHMEDABAD-GUWAHATI,9236,All
2025,3,AHMEDABAD,GUWAHATI,5241,4850,AHMEDABAD-GUWAHATI,10091,All
2024,2,AHMEDABAD,GWALIOR,472,389,AHMEDABAD-GWALIOR,861,All
2024,3,AHMEDABAD,GWALIOR,581,463,AHMEDABAD-GWALIOR,1044,All
2024,4,AHMEDABAD,GWALIOR,692,627,AHMEDABAD-GWALIOR,1319,All
2024,6,AHMEDABAD,GWALIOR,281,455,AHMEDABAD-GWALIOR,736,All
2024,7,AHMEDABAD,GWALIOR,501,482,AHMEDABAD-GWALIOR,983,All
2024,8,AHMEDABAD,GWALIOR,104,64,AHMEDABAD-GWALIOR,168,All
2024,10,AHMEDABAD,GWALIOR,162,17,AHMEDABAD-GWALIOR,179,All
2024,11,AHMEDABAD,GWALIOR,603,707,AHMEDABAD-GWALIOR,1310,All
2024,12,AHMEDABAD,GWALIOR,787,828,AHMEDABAD-GWALIOR,1615,All
2025,1,AHMEDABAD,GWALIOR,363,325,AHMEDABAD-GWALIOR,688,All
2024,1,AHMEDABAD,Goa,14827,15679,AHMEDABAD-Goa,30506,All
2024,2,AHMEDABAD,Goa,8342,8151,AHMEDABAD-Goa,16493,All
2024,3,AHMEDABAD,Goa,11720,10955,AHMEDABAD-Goa,22675,All
2024,4,AHMEDABAD,Goa,11863,10808,AHMEDABAD-Goa,22671,All
2024,6,AHMEDABAD,Goa,13551,14090,AHMEDABAD-Goa,27641,All
2024,7,AHMEDABAD,Goa,12308,12751,AHMEDABAD-Goa,25059,All
2024,8,AHMEDABAD,Goa,12779,12541,AHMEDABAD-Goa,25320,All
2024,9,AHMEDABAD,Goa,4441,4237,AHMEDABAD-Goa,8678,All
2024,10,AHMEDABAD,Goa,4951,4701,AHMEDABAD-Goa,9652,All
2024,11,AHMEDABAD,Goa,11470,10899,AHMEDABAD-Goa,22369,All
2024,12,AHMEDABAD,Goa,10532,9254,AHMEDABAD-Goa,19786,All
2025,1,AHMEDABAD,Goa,16124,16496,AHMEDABAD-Goa,32620,All
2025,2,AHMEDABAD,Goa,15273,14690,AHMEDABAD-Goa,29963,All
2025,3,AHMEDABAD,Goa,19677,18238,AHMEDABAD-Goa,37915,All
2024,1,AHMEDABAD,HYDERABAD,17950,17622,AHMEDABAD-HYDERABAD,35572,All
2024,2,AHMEDABAD,HYDERABAD,17189,16486,AHMEDABAD-HYDERABAD,33675,All
2024,3,AHMEDABAD,HYDERABAD,18741,17985,AHMEDABAD-HYDERABAD,36726,All
2024,4,AHMEDABAD,HYDERABAD,16928,17751,AHMEDABAD-HYDERABAD,34679,All
2024,6,AHMEDABAD,HYDERABAD,17964,15920,AHMEDABAD-HYDERABAD,33884,All
2024,7,AHMEDABAD,HYDERABAD,18363,17816,AHMEDABAD-HYDERABAD,36179,All
2024,8,AHMEDABAD,HYDERABAD,19710,19178,AHMEDABAD-HYDERABAD,38888,All
2024,9,AHMEDABAD,HYDERABAD,17912,18374,AHMEDABAD-HYDERABAD,36286,All
2024,10,AHMEDABAD,HYDERABAD,24823,21027,AHMEDABAD-HYDERABAD,45850,All
2024,11,AHMEDABAD,HYDERABAD,23752,23251,AHMEDABAD-HYDERABAD,47003,All
2024,12,AHMEDABAD,HYDERABAD,25527,22805,AHMEDABAD-HYDERABAD,48332,All
2025,1,AHMEDABAD,HYDERABAD,27134,24046,AHMEDABAD-HYDERABAD,51180,All
2025,2,AHMEDABAD,HYDERABAD,24219,21570,AHMEDABAD-HYDERABAD,45789,All
2025,3,AHMEDABAD,HYDERABAD,26053,24094,AHMEDABAD-HYDERABAD,50147,All
2024,1,AHMEDABAD,INDORE,6507,6369,AHMEDABAD-INDORE,12876,All
2024,2,AHMEDABAD,INDORE,6040,5920,AHMEDABAD-INDORE,11960,All
2024,3,AHMEDABAD,INDORE,6271,6477,AHMEDABAD-INDORE,12748,All
2024,4,AHMEDABAD,INDORE,5410,5790,AHMEDABAD-INDORE,11200,All
2024,6,AHMEDABAD,INDORE,4771,5488,AHMEDABAD-INDORE,10259,All
2024,7,AHMEDABAD,INDORE,4850,5257,AHMEDABAD-INDORE,10107,All
2024,8,AHMEDABAD,INDORE,4849,5252,AHMEDABAD-INDORE,10101,All
2024,9,AHMEDABAD,INDORE,4949,5676,AHMEDABAD-INDORE,10625,All
2024,10,AHMEDABAD,INDORE,5661,5118,AHMEDABAD-INDORE,10779,All
2024,11,AHMEDABAD,INDORE,5838,6415,AHMEDABAD-INDORE,12253,All
2024,12,AHMEDABAD,INDORE,6173,6665,AHMEDABAD-INDORE,12838,All
2025,1,AHMEDABAD,INDORE,6755,6808,AHMEDABAD-INDORE,13563,All
2025,2,AHMEDABAD,INDORE,5598,5487,AHMEDABAD-INDORE,11085,All
2025,3,AHMEDABAD,INDORE,5715,5873,AHMEDABAD-INDORE,11588,All
2024,3,AHMEDABAD,JABALPUR,28,31,AHMEDABAD-JABALPUR,59,All
2024,4,AHMEDABAD,JABALPUR,9,15,AHMEDABAD-JABALPUR,24,All
2024,6,AHMEDABAD,JABALPUR,21,41,AHMEDABAD-JABALPUR,62,All
2024,7,AHMEDABAD,JABALPUR,11,12,AHMEDABAD-JABALPUR,23,All
2024,8,AHMEDABAD,JABALPUR,13,9,AHMEDABAD-JABALPUR,22,All
2024,1,AHMEDABAD,JAIPUR,8201,7890,AHMEDABAD-JAIPUR,16091,All
2024,2,AHMEDABAD,JAIPUR,9731,9078,AHMEDABAD-JAIPUR,18809,All
2024,3,AHMEDABAD,JAIPUR,9939,8984,AHMEDABAD-JAIPUR,18923,All
2024,4,AHMEDABAD,JAIPUR,8819,8232,AHMEDABAD-JAIPUR,17051,All
2024,6,AHMEDABAD,JAIPUR,7975,8429,AHMEDABAD-JAIPUR,16404,All
2024,7,AHMEDABAD,JAIPUR,8055,8381,AHMEDABAD-JAIPUR,16436,All
2024,8,AHMEDABAD,JAIPUR,7940,7742,AHMEDABAD-JAIPUR,15682,All
2024,9,AHMEDABAD,JAIPUR,7562,7866,AHMEDABAD-JAIPUR,15428,All
2024,10,AHMEDABAD,JAIPUR,8670,7744,AHMEDABAD-JAIPUR,16414,All
2024,11,AHMEDABAD,JAIPUR,9014,8987,AHMEDABAD-JAIPUR,18001,All
2024,12,AHMEDABAD,JAIPUR,11649,12302,AHMEDABAD-JAIPUR,23951,All
2025,1,AHMEDABAD,JAIPUR,13667,12850,AHMEDABAD-JAIPUR,26517,All
2025,2,AHMEDABAD,JAIPUR,12750,11049,AHMEDABAD-JAIPUR,23799,All
2025,3,AHMEDABAD,JAIPUR,11347,10927,AHMEDABAD-JAIPUR,22274,All
2024,1,AHMEDABAD,JAISALMER,1409,1911,AHMEDABAD-JAISALMER,3320,All
2024,2,AHMEDABAD,JAISALMER,1369,1805,AHMEDABAD-JAISALMER,3174,All
2024,3,AHMEDABAD,JAISALMER,387,619,AHMEDABAD-JAISALMER,1006,All
2025,2,AHMEDABAD,JAISALMER,37,0,AHMEDABAD-JAISALMER,37,All
2024,10,AHMEDABAD,JALGAON,84,8,AHMEDABAD-JALGAON,92,All
2024,11,AHMEDABAD,JALGAON,493,603,AHMEDABAD-JALGAON,1096,All
2024,12,AHMEDABAD,JALGAON,517,596,AHMEDABAD-JALGAON,1113,All
2025,1,AHMEDABAD,JALGAON,405,434,AHMEDABAD-JALGAON,839,All
2025,2,AHMEDABAD,JALGAON,446,443,AHMEDABAD-JALGAON,889,All
2025,3,AHMEDABAD,JALGAON,353,268,AHMEDABAD-JALGAON,621,All
2024,1,AHMEDABAD,JAMMU,2791,2802,AHMEDABAD-JAMMU,5593,All
2024,2,AHMEDABAD,JAMMU,2831,2298,AHMEDABAD-JAMMU,5129,All
2024,3,AHMEDABAD,JAMMU,2883,2770,AHMEDABAD-JAMMU,5653,All
2024,4,AHMEDABAD,JAMMU,2826,2055,AHMEDABAD-JAMMU,4881,All
2024,6,AHMEDABAD,JAMMU,2452,1938,AHMEDABAD-JAMMU,4390,All
2024,7,AHMEDABAD,JAMMU,2390,1737,AHMEDABAD-JAMMU,4127,All
2024,8,AHMEDABAD,JAMMU,2374,1563,AHMEDABAD-JAMMU,3937,All
2024,9,AHMEDABAD,JAMMU,2608,1583,AHMEDABAD-JAMMU,4191,All
2024,10,AHMEDABAD,JAMMU,2517,1219,AHMEDABAD-JAMMU,3736,All
2024,11,AHMEDABAD,JAMMU,2734,2849,AHMEDABAD-JAMMU,5583,All
2024,12,AHMEDABAD,JAMMU,2983,3106,AHMEDABAD-JAMMU,6089,All
2025,1,AHMEDABAD,JAMMU,2749,2721,AHMEDABAD-JAMMU,5470,All
2025,2,AHMEDABAD,JAMMU,2740,2374,AHMEDABAD-JAMMU,5114,All
2025,3,AHMEDABAD,JAMMU,4524,3995,AHMEDABAD-JAMMU,8519,All
2024,1,AHMEDABAD,JODHPUR,2178,2010,AHMEDABAD-JODHPUR,4188,All
2024,2,AHMEDABAD,JODHPUR,1997,1730,AHMEDABAD-JODHPUR,3727,All
2024,3,AHMEDABAD,JODHPUR,2077,1647,AHMEDABAD-JODHPUR,3724,All
2024,4,AHMEDABAD,JODHPUR,2076,1733,AHMEDABAD-JODHPUR,3809,All
2024,6,AHMEDABAD,JODHPUR,1838,1528,AHMEDABAD-JODHPUR,3366,All
2024,7,AHMEDABAD,JODHPUR,1966,1631,AHMEDABAD-JODHPUR,3597,All
2024,8,AHMEDABAD,JODHPUR,1978,1765,AHMEDABAD-JODHPUR,3743,All
2024,9,AHMEDABAD,JODHPUR,2091,1912,AHMEDABAD-JODHPUR,4003,All
2024,10,AHMEDABAD,JODHPUR,2138,1705,AHMEDABAD-JODHPUR,3843,All
2024,11,AHMEDABAD,JODHPUR,2032,2087,AHMEDABAD-JODHPUR,4119,All
2024,12,AHMEDABAD,JODHPUR,2089,2027,AHMEDABAD-JODHPUR,4116,All
2025,1,AHMEDABAD,JODHPUR,2143,2174,AHMEDABAD-JODHPUR,4317,All
2025,2,AHMEDABAD,JODHPUR,2093,1811,AHMEDABAD-JODHPUR,3904,All
2025,3,AHMEDABAD,JODHPUR,2015,1994,AHMEDABAD-JODHPUR,4009,All
2024,10,AHMEDABAD,KESHOD,99,70,AHMEDABAD-KESHOD,169,All
2024,11,AHMEDABAD,KESHOD,690,676,AHMEDABAD-KESHOD,1366,All
2024,12,AHMEDABAD,KESHOD,410,284,AHMEDABAD-KESHOD,694,All
2025,1,AHMEDABAD,KESHOD,441,332,AHMEDABAD-KESHOD,773,All
2025,2,AHMEDABAD,KESHOD,455,325,AHMEDABAD-KESHOD,780,All
2025,3,AHMEDABAD,KESHOD,378,180,AHMEDABAD-KESHOD,558,All
2024,1,AHMEDABAD,KOCHI,5279,5320,AHMEDABAD-KOCHI,10599,All
2024,2,AHMEDABAD,KOCHI,4953,4806,AHMEDABAD-KOCHI,9759,All
2024,3,AHMEDABAD,KOCHI,5235,4782,AHMEDABAD-KOCHI,10017,All
2024,4,AHMEDABAD,KOCHI,4984,5047,AHMEDABAD-KOCHI,10031,All
2024,6,AHMEDABAD,KOCHI,5150,5013,AHMEDABAD-KOCHI,10163,All
2024,7,AHMEDABAD,KOCHI,5090,4477,AHMEDABAD-KOCHI,9567,All
2024,8,AHMEDABAD,KOCHI,4609,4906,AHMEDABAD-KOCHI,9515,All
2024,9,AHMEDABAD,KOCHI,4784,4682,AHMEDABAD-KOCHI,9466,All
2024,10,AHMEDABAD,KOCHI,5828,5184,AHMEDABAD-KOCHI,11012,All
2024,11,AHMEDABAD,KOCHI,7008,7162,AHMEDABAD-KOCHI,14170,All
2024,12,AHMEDABAD,KOCHI,7247,6713,AHMEDABAD-KOCHI,13960,All
2025,1,AHMEDABAD,KOCHI,7820,7820,AHMEDABAD-KOCHI,15640,All
2025,2,AHMEDABAD,KOCHI,6395,6434,AHMEDABAD-KOCHI,12829,All
2025,3,AHMEDABAD,KOCHI,6332,5991,AHMEDABAD-KOCHI,12323,All
2024,10,AHMEDABAD,KOLHAPUR,97,82,AHMEDABAD-KOLHAPUR,179,All
2024,11,AHMEDABAD,KOLHAPUR,598,607,AHMEDABAD-KOLHAPUR,1205,All
2024,12,AHMEDABAD,KOLHAPUR,480,473,AHMEDABAD-KOLHAPUR,953,All
2025,1,AHMEDABAD,KOLHAPUR,789,696,AHMEDABAD-KOLHAPUR,1485,All
2025,2,AHMEDABAD,KOLHAPUR,668,612,AHMEDABAD-KOLHAPUR,1280,All
2025,3,AHMEDABAD,KOLHAPUR,775,677,AHMEDABAD-KOLHAPUR,1452,All
2024,1,AHMEDABAD,KOLKATA,15798,15237,AHMEDABAD-KOLKATA,31035,All
2024,2,AHMEDABAD,KOLKATA,13597,13516,AHMEDABAD-KOLKATA,27113,All
2024,3,AHMEDABAD,KOLKATA,14715,13608,AHMEDABAD-KOLKATA,28323,All
2024,4,AHMEDABAD,KOLKATA,15881,14141,AHMEDABAD-KOLKATA,30022,All
2024,6,AHMEDABAD,KOLKATA,14216,14021,AHMEDABAD-KOLKATA,28237,All
2024,7,AHMEDABAD,KOLKATA,13484,14928,AHMEDABAD-KOLKATA,28412,All
2024,8,AHMEDABAD,KOLKATA,13697,13608,AHMEDABAD-KOLKATA,27305,All
2024,9,AHMEDABAD,KOLKATA,14764,13656,AHMEDABAD-KOLKATA,28420,All
2024,10,AHMEDABAD,KOLKATA,17921,15261,AHMEDABAD-KOLKATA,33182,All
2024,11,AHMEDABAD,KOLKATA,17400,18446,AHMEDABAD-KOLKATA,35846,All
2024,12,AHMEDABAD,KOLKATA,23575,23563,AHMEDABAD-KOLKATA,47138,All
2025,1,AHMEDABAD,KOLKATA,24629,24149,AHMEDABAD-KOLKATA,48778,All
2025,2,AHMEDABAD,KOLKATA,23769,22682,AHMEDABAD-KOLKATA,46451,All
2025,3,AHMEDABAD,KOLKATA,24131,20763,AHMEDABAD-KOLKATA,44894,All
2025,3,AHMEDABAD,Kishangarh,1427,1352,AHMEDABAD-Kishangarh,2779,All
2024,1,AHMEDABAD,LUCKNOW,12447,12600,AHMEDABAD-LUCKNOW,25047,All
2024,2,AHMEDABAD,LUCKNOW,13396,11534,AHMEDABAD-LUCKNOW,24930,All
2024,3,AHMEDABAD,LUCKNOW,13949,12941,AHMEDABAD-LUCKNOW,26890,All
2024,4,AHMEDABAD,LUCKNOW,14447,11384,AHMEDABAD-LUCKNOW,25831,All
2024,6,AHMEDABAD,LUCKNOW,12271,13596,AHMEDABAD-LUCKNOW,25867,All
2024,7,AHMEDABAD,LUCKNOW,10548,11750,AHMEDABAD-LUCKNOW,22298,All
2024,8,AHMEDABAD,LUCKNOW,10391,12368,AHMEDABAD-LUCKNOW,22759,All
2024,9,AHMEDABAD,LUCKNOW,10808,12002,AHMEDABAD-LUCKNOW,22810,All
2024,10,AHMEDABAD,LUCKNOW,14025,11363,AHMEDABAD-LUCKNOW,25388,All
2024,11,AHMEDABAD,LUCKNOW,14593,15565,AHMEDABAD-LUCKNOW,30158,All
2024,12,AHMEDABAD,LUCKNOW,12642,16327,AHMEDABAD-LUCKNOW,28969,All
2025,1,AHMEDABAD,LUCKNOW,14723,14174,AHMEDABAD-LUCKNOW,28897,All
2025,2,AHMEDABAD,LUCKNOW,12765,12895,AHMEDABAD-LUCKNOW,25660,All
2025,3,AHMEDABAD,LUCKNOW,9909,9515,AHMEDABAD-LUCKNOW,19424,All
2024,1,AHMEDABAD,MUMBAI,98595,98882,AHMEDABAD-MUMBAI,197477,All
2024,2,AHMEDABAD,MUMBAI,94448,93917,AHMEDABAD-MUMBAI,188365,All
2024,3,AHMEDABAD,MUMBAI,93952,90606,AHMEDABAD-MUMBAI,184558,All
2024,4,AHMEDABAD,MUMBAI,82317,89442,AHMEDABAD-MUMBAI,171759,All
2024,6,AHMEDABAD,MUMBAI,81345,88590,AHMEDABAD-MUMBAI,169935,All
2024,7,AHMEDABAD,MUMBAI,82645,87307,AHMEDABAD-MUMBAI,169952,All
2024,8,AHMEDABAD,MUMBAI,87703,86884,AHMEDABAD-MUMBAI,174587,All
2024,9,AHMEDABAD,MUMBAI,85902,85959,AHMEDABAD-MUMBAI,171861,All
2024,10,AHMEDABAD,MUMBAI,78060,85578,AHMEDABAD-MUMBAI,163638,All
2024,11,AHMEDABAD,MUMBAI,90248,89621,AHMEDABAD-MUMBAI,179869,All
2024,12,AHMEDABAD,MUMBAI,92420,92243,AHMEDABAD-MUMBAI,184663,All
2025,1,AHMEDABAD,MUMBAI,93727,91979,AHMEDABAD-MUMBAI,185706,All
2025,2,AHMEDABAD,MUMBAI,85128,83853,AHMEDABAD-MUMBAI,168981,All
2025,3,AHMEDABAD,MUMBAI,87364,81969,AHMEDABAD-MUMBAI,169333,All
2024,1,AHMEDABAD,NAGPUR,4403,4380,AHMEDABAD-NAGPUR,8783,All
2024,2,AHMEDABAD,NAGPUR,4064,4000,AHMEDABAD-NAGPUR,8064,All
2024,3,AHMEDABAD,NAGPUR,4430,4402,AHMEDABAD-NAGPUR,8832,All
2024,4,AHMEDABAD,NAGPUR,4190,4203,AHMEDABAD-NAGPUR,8393,All
2024,6,AHMEDABAD,NAGPUR,4319,4177,AHMEDABAD-NAGPUR,8496,All
2024,7,AHMEDABAD,NAGPUR,4186,4379,AHMEDABAD-NAGPUR,8565,All
2024,8,AHMEDABAD,NAGPUR,4354,4391,AHMEDABAD-NAGPUR,8745,All
2024,9,AHMEDABAD,NAGPUR,3963,4045,AHMEDABAD-NAGPUR,8008,All
2024,10,AHMEDABAD,NAGPUR,4117,3905,AHMEDABAD-NAGPUR,8022,All
2024,11,AHMEDABAD,NAGPUR,4130,4156,AHMEDABAD-NAGPUR,8286,All
2024,12,AHMEDABAD,NAGPUR,4557,4481,AHMEDABAD-NAGPUR,9038,All
2025,1,AHMEDABAD,NAGPUR,4541,4424,AHMEDABAD-NAGPUR,8965,All
2025,2,AHMEDABAD,NAGPUR,4121,4037,AHMEDABAD-NAGPUR,8158,All
2025,3,AHMEDABAD,NAGPUR,4387,4306,AHMEDABAD-NAGPUR,8693,All
2024,3,AHMEDABAD,NANDED,41,35,AHMEDABAD-NANDED,76,All
2024,4,AHMEDABAD,NANDED,901,1066,AHMEDABAD-NANDED,1967,All
2024,6,AHMEDABAD,NANDED,912,867,AHMEDABAD-NANDED,1779,All
2024,7,AHMEDABAD,NANDED,646,765,AHMEDABAD-NANDED,1411,All
2024,8,AHMEDABAD,NANDED,897,964,AHMEDABAD-NANDED,1861,All
2024,9,AHMEDABAD,NANDED,771,925,AHMEDABAD-NANDED,1696,All
2024,10,AHMEDABAD,NANDED,923,764,AHMEDABAD-NANDED,1687,All
2024,11,AHMEDABAD,NANDED,905,1078,AHMEDABAD-NANDED,1983,All
2024,12,AHMEDABAD,NANDED,1077,1191,AHMEDABAD-NANDED,2268,All
2025,1,AHMEDABAD,NANDED,985,949,AHMEDABAD-NANDED,1934,All
2025,2,AHMEDABAD,NANDED,897,916,AHMEDABAD-NANDED,1813,All
2025,3,AHMEDABAD,NANDED,928,1112,AHMEDABAD-NANDED,2040,All
2024,1,AHMEDABAD,NASIK,3762,3741,AHMEDABAD-NASIK,7503,All
2024,2,AHMEDABAD,NASIK,3661,3580,AHMEDABAD-NASIK,7241,All
2024,3,AHMEDABAD,NASIK,3764,3565,AHMEDABAD-NASIK,7329,All
2024,4,AHMEDABAD,NASIK,1896,1782,AHMEDABAD-NASIK,3678,All
2024,6,AHMEDABAD,NASIK,1805,1675,AHMEDABAD-NASIK,3480,All
2024,7,AHMEDABAD,NASIK,1701,1687,AHMEDABAD-NASIK,3388,All
2024,8,AHMEDABAD,NASIK,1838,1812,AHMEDABAD-NASIK,3650,All
2024,9,AHMEDABAD,NASIK,1804,1708,AHMEDABAD-NASIK,3512,All
2024,10,AHMEDABAD,NASIK,1703,1610,AHMEDABAD-NASIK,3313,All
2024,11,AHMEDABAD,NASIK,1998,2104,AHMEDABAD-NASIK,4102,All
2024,12,AHMEDABAD,NASIK,2231,2148,AHMEDABAD-NASIK,4379,All
2025,1,AHMEDABAD,NASIK,2198,2066,AHMEDABAD-NASIK,4264,All
2025,2,AHMEDABAD,NASIK,1988,2021,AHMEDABAD-NASIK,4009,All
2025,3,AHMEDABAD,NASIK,2134,2114,AHMEDABAD-NASIK,4248,All
2024,1,AHMEDABAD,PATNA,5552,5406,AHMEDABAD-PATNA,10958,All
2024,2,AHMEDABAD,PATNA,5019,4748,AHMEDABAD-PATNA,9767,All
2024,3,AHMEDABAD,PATNA,5184,4841,AHMEDABAD-PATNA,10025,All
2024,4,AHMEDABAD,PATNA,5277,4726,AHMEDABAD-PATNA,10003,All
2024,6,AHMEDABAD,PATNA,5102,5192,AHMEDABAD-PATNA,10294,All
2024,7,AHMEDABAD,PATNA,4611,5063,AHMEDABAD-PATNA,9674,All
2024,8,AHMEDABAD,PATNA,4519,4955,AHMEDABAD-PATNA,9474,All
2024,9,AHMEDABAD,PATNA,4329,3957,AHMEDABAD-PATNA,8286,All
2024,10,AHMEDABAD,PATNA,6729,4296,AHMEDABAD-PATNA,11025,All
2024,11,AHMEDABAD,PATNA,9186,8688,AHMEDABAD-PATNA,17874,All
2024,12,AHMEDABAD,PATNA,8719,9419,AHMEDABAD-PATNA,18138,All
2025,1,AHMEDABAD,PATNA,9296,9319,AHMEDABAD-PATNA,18615,All
2025,2,AHMEDABAD,PATNA,8194,7887,AHMEDABAD-PATNA,16081,All
2025,3,AHMEDABAD,PATNA,9106,8684,AHMEDABAD-PATNA,17790,All
2024,1,AHMEDABAD,PORT BLAIR,396,0,AHMEDABAD-PORT BLAIR,396,All
2024,2,AHMEDABAD,PORT BLAIR,16,0,AHMEDABAD-PORT BLAIR,16,All
2025,2,AHMEDABAD,PRAYAGRAJ,23529,23077,AHMEDABAD-PRAYAGRAJ,46606,All
2025,1,AHMEDABAD,PRAYAGRAJ ,5405,4918,AHMEDABAD-PRAYAGRAJ ,10323,All
2024,1,AHMEDABAD,PUNE,19218,20344,AHMEDABAD-PUNE,39562,All
2024,2,AHMEDABAD,PUNE,19728,20276,AHMEDABAD-PUNE,40004,All
2024,3,AHMEDABAD,PUNE,19682,20136,AHMEDABAD-PUNE,39818,All
2024,4,AHMEDABAD,PUNE,21108,23557,AHMEDABAD-PUNE,44665,All
2024,6,AHMEDABAD,PUNE,21889,22212,AHMEDABAD-PUNE,44101,All
2024,7,AHMEDABAD,PUNE,23283,24597,AHMEDABAD-PUNE,47880,All
2024,8,AHMEDABAD,PUNE,24469,25616,AHMEDABAD-PUNE,50085,All
2024,9,AHMEDABAD,PUNE,23256,24432,AHMEDABAD-PUNE,47688,All
2024,10,AHMEDABAD,PUNE,23130,24944,AHMEDABAD-PUNE,48074,All
2024,11,AHMEDABAD,PUNE,30146,30175,AHMEDABAD-PUNE,60321,All
2024,12,AHMEDABAD,PUNE,32474,32678,AHMEDABAD-PUNE,65152,All
2025,1,AHMEDABAD,PUNE,32670,32195,AHMEDABAD-PUNE,64865,All
2025,2,AHMEDABAD,PUNE,29563,30332,AHMEDABAD-PUNE,59895,All
2025,3,AHMEDABAD,PUNE,31143,31167,AHMEDABAD-PUNE,62310,All
2024,1,AHMEDABAD,RAIPUR,2479,2424,AHMEDABAD-RAIPUR,4903,All
2024,2,AHMEDABAD,RAIPUR,1995,1981,AHMEDABAD-RAIPUR,3976,All
2024,3,AHMEDABAD,RAIPUR,2290,2178,AHMEDABAD-RAIPUR,4468,All
2024,4,AHMEDABAD,RAIPUR,2200,2199,AHMEDABAD-RAIPUR,4399,All
2024,6,AHMEDABAD,RAIPUR,2061,1987,AHMEDABAD-RAIPUR,4048,All
2024,7,AHMEDABAD,RAIPUR,2410,2463,AHMEDABAD-RAIPUR,4873,All
2024,8,AHMEDABAD,RAIPUR,2189,2221,AHMEDABAD-RAIPUR,4410,All
2024,9,AHMEDABAD,RAIPUR,2229,2259,AHMEDABAD-RAIPUR,4488,All
2024,10,AHMEDABAD,RAIPUR,4985,4831,AHMEDABAD-RAIPUR,9816,All
2024,11,AHMEDABAD,RAIPUR,4545,5324,AHMEDABAD-RAIPUR,9869,All
2024,12,AHMEDABAD,RAIPUR,4709,5478,AHMEDABAD-RAIPUR,10187,All
2025,1,AHMEDABAD,RAIPUR,4567,5408,AHMEDABAD-RAIPUR,9975,All
2025,2,AHMEDABAD,RAIPUR,4242,4843,AHMEDABAD-RAIPUR,9085,All
2025,3,AHMEDABAD,RAIPUR,5142,4769,AHMEDABAD-RAIPUR,9911,All
2024,1,AHMEDABAD,RANCHI,3000,2957,AHMEDABAD-RANCHI,5957,All
2024,2,AHMEDABAD,RANCHI,2884,2867,AHMEDABAD-RANCHI,5751,All
2024,3,AHMEDABAD,RANCHI,2971,2978,AHMEDABAD-RANCHI,5949,All
2024,4,AHMEDABAD,RANCHI,2923,2897,AHMEDABAD-RANCHI,5820,All
2024,6,AHMEDABAD,RANCHI,3187,3171,AHMEDABAD-RANCHI,6358,All
2024,7,AHMEDABAD,RANCHI,2482,2888,AHMEDABAD-RANCHI,5370,All
2024,8,AHMEDABAD,RANCHI,2564,2944,AHMEDABAD-RANCHI,5508,All
2024,9,AHMEDABAD,RANCHI,2836,2965,AHMEDABAD-RANCHI,5801,All
2024,10,AHMEDABAD,RANCHI,5516,4764,AHMEDABAD-RANCHI,10280,All
2024,11,AHMEDABAD,RANCHI,4787,5237,AHMEDABAD-RANCHI,10024,All
2024,12,AHMEDABAD,RANCHI,5212,5362,AHMEDABAD-RANCHI,10574,All
2025,1,AHMEDABAD,RANCHI,5825,5887,AHMEDABAD-RANCHI,11712,All
2025,2,AHMEDABAD,RANCHI,5006,4998,AHMEDABAD-RANCHI,10004,All
2025,3,AHMEDABAD,RANCHI,6155,5141,AHMEDABAD-RANCHI,11296,All
2024,3,AHMEDABAD,Rajkot International Airport,33,37,AHMEDABAD-Rajkot International Airport,70,All
2024,4,AHMEDABAD,Rajkot International Airport,762,571,AHMEDABAD-Rajkot International Airport,1333,All
2024,6,AHMEDABAD,Rajkot International Airport,1103,927,AHMEDABAD-Rajkot International Airport,2030,All
2024,7,AHMEDABAD,Rajkot International Airport,731,828,AHMEDABAD-Rajkot International Airport,1559,All
2024,8,AHMEDABAD,Rajkot International Airport,790,904,AHMEDABAD-Rajkot International Airport,1694,All
2024,9,AHMEDABAD,Rajkot International Airport,1191,909,AHMEDABAD-Rajkot International Airport,2100,All
2024,10,AHMEDABAD,Rajkot International Airport,949,885,AHMEDABAD-Rajkot International Airport,1834,All
2024,1,AHMEDABAD,SRINAGAR,4336,4558,AHMEDABAD-SRINAGAR,8894,All
2024,2,AHMEDABAD,SRINAGAR,4249,4093,AHMEDABAD-SRINAGAR,8342,All
2024,3,AHMEDABAD,SRINAGAR,4662,4165,AHMEDABAD-SRINAGAR,8827,All
2024,4,AHMEDABAD,SRINAGAR,5197,3812,AHMEDABAD-SRINAGAR,9009,All
2024,6,AHMEDABAD,SRINAGAR,4948,4229,AHMEDABAD-SRINAGAR,9177,All
2024,7,AHMEDABAD,SRINAGAR,4726,4470,AHMEDABAD-SRINAGAR,9196,All
2024,8,AHMEDABAD,SRINAGAR,3729,3344,AHMEDABAD-SRINAGAR,7073,All
2024,9,AHMEDABAD,SRINAGAR,2970,2687,AHMEDABAD-SRINAGAR,5657,All
2024,10,AHMEDABAD,SRINAGAR,5246,3837,AHMEDABAD-SRINAGAR,9083,All
2024,11,AHMEDABAD,SRINAGAR,7132,7235,AHMEDABAD-SRINAGAR,14367,All
2024,12,AHMEDABAD,SRINAGAR,5271,5510,AHMEDABAD-SRINAGAR,10781,All
2025,1,AHMEDABAD,SRINAGAR,5710,5876,AHMEDABAD-SRINAGAR,11586,All
2025,2,AHMEDABAD,SRINAGAR,5082,5031,AHMEDABAD-SRINAGAR,10113,All
2025,3,AHMEDABAD,SRINAGAR,6481,6383,AHMEDABAD-SRINAGAR,12864,All
2024,1,AHMEDABAD,TRIVANDRUM,141,280,AHMEDABAD-TRIVANDRUM,421,All
2024,2,AHMEDABAD,TRIVANDRUM,48,153,AHMEDABAD-TRIVANDRUM,201,All
2024,12,AHMEDABAD,TRIVANDRUM,2080,2034,AHMEDABAD-TRIVANDRUM,4114,All
2025,1,AHMEDABAD,TRIVANDRUM,2663,3176,AHMEDABAD-TRIVANDRUM,5839,All
2025,2,AHMEDABAD,TRIVANDRUM,2103,2692,AHMEDABAD-TRIVANDRUM,4795,All
2025,3,AHMEDABAD,TRIVANDRUM,1948,2410,AHMEDABAD-TRIVANDRUM,4358,All
2024,1,AHMEDABAD,UDAIPUR,1020,908,AHMEDABAD-UDAIPUR,1928,All
2024,2,AHMEDABAD,UDAIPUR,771,526,AHMEDABAD-UDAIPUR,1297,All
2024,3,AHMEDABAD,UDAIPUR,762,542,AHMEDABAD-UDAIPUR,1304,All
2024,4,AHMEDABAD,UDAIPUR,633,362,AHMEDABAD-UDAIPUR,995,All
2024,6,AHMEDABAD,UDAIPUR,530,537,AHMEDABAD-UDAIPUR,1067,All
2024,7,AHMEDABAD,UDAIPUR,525,423,AHMEDABAD-UDAIPUR,948,All
2024,8,AHMEDABAD,UDAIPUR,858,714,AHMEDABAD-UDAIPUR,1572,All
2024,9,AHMEDABAD,UDAIPUR,802,595,AHMEDABAD-UDAIPUR,1397,All
2024,10,AHMEDABAD,UDAIPUR,547,387,AHMEDABAD-UDAIPUR,934,All
2024,11,AHMEDABAD,UDAIPUR,203,426,AHMEDABAD-UDAIPUR,629,All
2024,12,AHMEDABAD,UDAIPUR,209,306,AHMEDABAD-UDAIPUR,515,All
2025,1,AHMEDABAD,UDAIPUR,328,289,AHMEDABAD-UDAIPUR,617,All
2024,1,AHMEDABAD,VADODARA,277,0,AHMEDABAD-VADODARA,277,All
2024,8,AHMEDABAD,VADODARA,157,133,AHMEDABAD-VADODARA,290,All
2024,1,AHMEDABAD,VARANASI,4415,4545,AHMEDABAD-VARANASI,8960,All
2024,2,AHMEDABAD,VARANASI,4912,4815,AHMEDABAD-VARANASI,9727,All
2024,3,AHMEDABAD,VARANASI,5074,4944,AHMEDABAD-VARANASI,10018,All
2024,4,AHMEDABAD,VARANASI,5241,4919,AHMEDABAD-VARANASI,10160,All
2024,6,AHMEDABAD,VARANASI,4866,5244,AHMEDABAD-VARANASI,10110,All
2024,7,AHMEDABAD,VARANASI,4163,5062,AHMEDABAD-VARANASI,9225,All
2024,8,AHMEDABAD,VARANASI,4760,5640,AHMEDABAD-VARANASI,10400,All
2024,9,AHMEDABAD,VARANASI,6779,7170,AHMEDABAD-VARANASI,13949,All
2024,10,AHMEDABAD,VARANASI,4649,3949,AHMEDABAD-VARANASI,8598,All
2024,11,AHMEDABAD,VARANASI,4613,5320,AHMEDABAD-VARANASI,9933,All
2024,12,AHMEDABAD,VARANASI,4563,5611,AHMEDABAD-VARANASI,10174,All
2025,1,AHMEDABAD,VARANASI,4281,5210,AHMEDABAD-VARANASI,9491,All
2025,2,AHMEDABAD,VARANASI,4450,5277,AHMEDABAD-VARANASI,9727,All
2025,3,AHMEDABAD,VARANASI,6081,6904,AHMEDABAD-VARANASI,12985,All
2024,1,AHMEDABAD,VISAKHAPATNAM,354,317,AHMEDABAD-VISAKHAPATNAM,671,All
2024,2,AHMEDABAD,VISAKHAPATNAM,398,413,AHMEDABAD-VISAKHAPATNAM,811,All
2024,3,AHMEDABAD,VISAKHAPATNAM,248,480,AHMEDABAD-VISAKHAPATNAM,728,All
2024,4,AHMEDABAD,VISAKHAPATNAM,334,358,AHMEDABAD-VISAKHAPATNAM,692,All
2024,6,AHMEDABAD,VISAKHAPATNAM,465,471,AHMEDABAD-VISAKHAPATNAM,936,All
2024,7,AHMEDABAD,VISAKHAPATNAM,254,364,AHMEDABAD-VISAKHAPATNAM,618,All
2024,8,AHMEDABAD,VISAKHAPATNAM,247,388,AHMEDABAD-VISAKHAPATNAM,635,All
2024,9,AHMEDABAD,VISAKHAPATNAM,345,640,AHMEDABAD-VISAKHAPATNAM,985,All
2024,10,AHMEDABAD,VISAKHAPATNAM,365,837,AHMEDABAD-VISAKHAPATNAM,1202,All
2024,11,AHMEDABAD,VISAKHAPATNAM,322,771,AHMEDABAD-VISAKHAPATNAM,1093,All
2024,12,AHMEDABAD,VISAKHAPATNAM,489,1065,AHMEDABAD-VISAKHAPATNAM,1554,All
2025,3,AHMEDABAD,VISAKHAPATNAM,581,809,AHMEDABAD-VISAKHAPATNAM,1390,All
2024,6,AIZAWL,BENGALURU,116,160,AIZAWL-BENGALURU,276,All
2024,7,AIZAWL,BENGALURU,69,61,AIZAWL-BENGALURU,130,All
2024,8,AIZAWL,BENGALURU,85,69,AIZAWL-BENGALURU,154,All
2024,9,AIZAWL,BENGALURU,120,60,AIZAWL-BENGALURU,180,All
2024,10,AIZAWL,BENGALURU,59,91,AIZAWL-BENGALURU,150,All
2024,11,AIZAWL,BENGALURU,63,83,AIZAWL-BENGALURU,146,All
2024,12,AIZAWL,BENGALURU,59,289,AIZAWL-BENGALURU,348,All
2025,3,AIZAWL,BENGALURU,270,202,AIZAWL-BENGALURU,472,All
2024,1,AIZAWL,DELHI,2884,3091,AIZAWL-DELHI,5975,All
2024,2,AIZAWL,DELHI,3121,3302,AIZAWL-DELHI,6423,All
2024,3,AIZAWL,DELHI,3323,3651,AIZAWL-DELHI,6974,All
2024,4,AIZAWL,DELHI,3047,3595,AIZAWL-DELHI,6642,All
2024,6,AIZAWL,DELHI,3302,3552,AIZAWL-DELHI,6854,All
2024,7,AIZAWL,DELHI,3465,3262,AIZAWL-DELHI,6727,All
2024,8,AIZAWL,DELHI,3118,3130,AIZAWL-DELHI,6248,All
2024,9,AIZAWL,DELHI,3108,3335,AIZAWL-DELHI,6443,All
2024,10,AIZAWL,DELHI,5134,5294,AIZAWL-DELHI,10428,All
2024,11,AIZAWL,DELHI,5371,6171,AIZAWL-DELHI,11542,All
2024,12,AIZAWL,DELHI,5008,7505,AIZAWL-DELHI,12513,All
2025,1,AIZAWL,DELHI,6702,4927,AIZAWL-DELHI,11629,All
2025,2,AIZAWL,DELHI,5422,4609,AIZAWL-DELHI,10031,All
2025,3,AIZAWL,DELHI,6722,7115,AIZAWL-DELHI,13837,All
2024,7,AIZAWL,DIMAPUR,0,3,AIZAWL-DIMAPUR,3,All
2024,1,AIZAWL,GUWAHATI,6352,5493,AIZAWL-GUWAHATI,11845,All
2024,2,AIZAWL,GUWAHATI,5686,5664,AIZAWL-GUWAHATI,11350,All
2024,3,AIZAWL,GUWAHATI,6331,6125,AIZAWL-GUWAHATI,12456,All
2024,4,AIZAWL,GUWAHATI,7595,7023,AIZAWL-GUWAHATI,14618,All
2024,6,AIZAWL,GUWAHATI,8247,8906,AIZAWL-GUWAHATI,17153,All
2024,7,AIZAWL,GUWAHATI,8850,9570,AIZAWL-GUWAHATI,18420,All
2024,8,AIZAWL,GUWAHATI,6432,6521,AIZAWL-GUWAHATI,12953,All
2024,9,AIZAWL,GUWAHATI,5777,6082,AIZAWL-GUWAHATI,11859,All
2024,10,AIZAWL,GUWAHATI,6266,6374,AIZAWL-GUWAHATI,12640,All
2024,11,AIZAWL,GUWAHATI,6011,6191,AIZAWL-GUWAHATI,12202,All
2024,12,AIZAWL,GUWAHATI,5763,6154,AIZAWL-GUWAHATI,11917,All
2025,1,AIZAWL,GUWAHATI,6030,5922,AIZAWL-GUWAHATI,11952,All
2025,2,AIZAWL,GUWAHATI,5591,5417,AIZAWL-GUWAHATI,11008,All
2025,3,AIZAWL,GUWAHATI,6291,6328,AIZAWL-GUWAHATI,12619,All
2024,1,AIZAWL,IMPHAL,1066,914,AIZAWL-IMPHAL,1980,All
2024,2,AIZAWL,IMPHAL,710,584,AIZAWL-IMPHAL,1294,All
2024,3,AIZAWL,IMPHAL,906,738,AIZAWL-IMPHAL,1644,All
2024,4,AIZAWL,IMPHAL,642,831,AIZAWL-IMPHAL,1473,All
2024,6,AIZAWL,IMPHAL,871,760,AIZAWL-IMPHAL,1631,All
2024,7,AIZAWL,IMPHAL,733,811,AIZAWL-IMPHAL,1544,All
2024,8,AIZAWL,IMPHAL,478,520,AIZAWL-IMPHAL,998,All
2024,9,AIZAWL,IMPHAL,478,471,AIZAWL-IMPHAL,949,All
2024,10,AIZAWL,IMPHAL,182,218,AIZAWL-IMPHAL,400,All
2024,11,AIZAWL,IMPHAL,233,316,AIZAWL-IMPHAL,549,All
2024,12,AIZAWL,IMPHAL,475,496,AIZAWL-IMPHAL,971,All
2025,1,AIZAWL,IMPHAL,403,461,AIZAWL-IMPHAL,864,All
2025,2,AIZAWL,IMPHAL,351,335,AIZAWL-IMPHAL,686,All
2025,3,AIZAWL,IMPHAL,295,255,AIZAWL-IMPHAL,550,All
2024,1,AIZAWL,KOLKATA,6456,5627,AIZAWL-KOLKATA,12083,All
2024,2,AIZAWL,KOLKATA,5204,4649,AIZAWL-KOLKATA,9853,All
2024,3,AIZAWL,KOLKATA,7434,7116,AIZAWL-KOLKATA,14550,All
2024,4,AIZAWL,KOLKATA,7461,8045,AIZAWL-KOLKATA,15506,All
2024,6,AIZAWL,KOLKATA,9081,6683,AIZAWL-KOLKATA,15764,All
2024,7,AIZAWL,KOLKATA,9590,6799,AIZAWL-KOLKATA,16389,All
2024,8,AIZAWL,KOLKATA,8087,6854,AIZAWL-KOLKATA,14941,All
2024,9,AIZAWL,KOLKATA,8266,6755,AIZAWL-KOLKATA,15021,All
2024,10,AIZAWL,KOLKATA,8298,6873,AIZAWL-KOLKATA,15171,All
2024,11,AIZAWL,KOLKATA,7372,7279,AIZAWL-KOLKATA,14651,All
2024,12,AIZAWL,KOLKATA,8438,10088,AIZAWL-KOLKATA,18526,All
2025,1,AIZAWL,KOLKATA,10119,7641,AIZAWL-KOLKATA,17760,All
2025,2,AIZAWL,KOLKATA,4904,4832,AIZAWL-KOLKATA,9736,All
2025,3,AIZAWL,KOLKATA,6044,5597,AIZAWL-KOLKATA,11641,All
2024,3,AIZAWL,MUMBAI,0,2,AIZAWL-MUMBAI,2,All
2024,4,AIZAWL,MUMBAI,82,48,AIZAWL-MUMBAI,130,All
2024,1,AIZAWL,SHILLONG,953,638,AIZAWL-SHILLONG,1591,All
2024,2,AIZAWL,SHILLONG,797,486,AIZAWL-SHILLONG,1283,All
2024,3,AIZAWL,SHILLONG,911,838,AIZAWL-SHILLONG,1749,All
2024,4,AIZAWL,SHILLONG,508,547,AIZAWL-SHILLONG,1055,All
2024,6,AIZAWL,SHILLONG,247,352,AIZAWL-SHILLONG,599,All
2024,7,AIZAWL,SHILLONG,477,400,AIZAWL-SHILLONG,877,All
2024,8,AIZAWL,SHILLONG,697,763,AIZAWL-SHILLONG,1460,All
2024,9,AIZAWL,SHILLONG,747,703,AIZAWL-SHILLONG,1450,All
2024,10,AIZAWL,SHILLONG,819,812,AIZAWL-SHILLONG,1631,All
2024,11,AIZAWL,SHILLONG,739,777,AIZAWL-SHILLONG,1516,All
2024,12,AIZAWL,SHILLONG,654,938,AIZAWL-SHILLONG,1592,All
2025,1,AIZAWL,SHILLONG,700,471,AIZAWL-SHILLONG,1171,All
2025,2,AIZAWL,SHILLONG,550,339,AIZAWL-SHILLONG,889,All
2025,3,AIZAWL,SHILLONG,688,604,AIZAWL-SHILLONG,1292,All
2024,1,ALLAHABAD,BENGALURU,3579,3138,ALLAHABAD-BENGALURU,6717,All
2024,2,ALLAHABAD,BENGALURU,4318,4614,ALLAHABAD-BENGALURU,8932,All
2024,3,ALLAHABAD,BENGALURU,4206,4828,ALLAHABAD-BENGALURU,9034,All
2024,4,ALLAHABAD,BENGALURU,2800,3030,ALLAHABAD-BENGALURU,5830,All
2024,6,ALLAHABAD,BENGALURU,2784,2749,ALLAHABAD-BENGALURU,5533,All
2024,7,ALLAHABAD,BENGALURU,2553,2374,ALLAHABAD-BENGALURU,4927,All
2024,8,ALLAHABAD,BENGALURU,2459,2456,ALLAHABAD-BENGALURU,4915,All
2024,9,ALLAHABAD,BENGALURU,2602,2699,ALLAHABAD-BENGALURU,5301,All
2024,10,ALLAHABAD,BENGALURU,2349,2825,ALLAHABAD-BENGALURU,5174,All
2024,11,ALLAHABAD,BENGALURU,2963,2770,ALLAHABAD-BENGALURU,5733,All
2024,12,ALLAHABAD,BENGALURU,3089,3071,ALLAHABAD-BENGALURU,6160,All
2024,1,ALLAHABAD,BHOPAL,755,878,ALLAHABAD-BHOPAL,1633,All
2024,2,ALLAHABAD,BHOPAL,1256,1525,ALLAHABAD-BHOPAL,2781,All
2024,3,ALLAHABAD,BHOPAL,1274,1441,ALLAHABAD-BHOPAL,2715,All
2024,4,ALLAHABAD,BHOPAL,968,1875,ALLAHABAD-BHOPAL,2843,All
2024,6,ALLAHABAD,BHOPAL,1489,1625,ALLAHABAD-BHOPAL,3114,All
2024,7,ALLAHABAD,BHOPAL,1131,1443,ALLAHABAD-BHOPAL,2574,All
2024,8,ALLAHABAD,BHOPAL,701,916,ALLAHABAD-BHOPAL,1617,All
2024,9,ALLAHABAD,BHOPAL,109,230,ALLAHABAD-BHOPAL,339,All
2024,10,ALLAHABAD,BHOPAL,105,275,ALLAHABAD-BHOPAL,380,All
2024,11,ALLAHABAD,BHOPAL,177,232,ALLAHABAD-BHOPAL,409,All
2024,12,ALLAHABAD,BHOPAL,145,120,ALLAHABAD-BHOPAL,265,All
2024,1,ALLAHABAD,BHUBANESWAR,1677,1654,ALLAHABAD-BHUBANESWAR,3331,All
2024,2,ALLAHABAD,BHUBANESWAR,1854,1979,ALLAHABAD-BHUBANESWAR,3833,All
2024,3,ALLAHABAD,BHUBANESWAR,2118,2100,ALLAHABAD-BHUBANESWAR,4218,All
2024,4,ALLAHABAD,BHUBANESWAR,1686,1917,ALLAHABAD-BHUBANESWAR,3603,All
2024,6,ALLAHABAD,BHUBANESWAR,1787,1824,ALLAHABAD-BHUBANESWAR,3611,All
2024,7,ALLAHABAD,BHUBANESWAR,1772,1809,ALLAHABAD-BHUBANESWAR,3581,All
2024,8,ALLAHABAD,BHUBANESWAR,1778,1880,ALLAHABAD-BHUBANESWAR,3658,All
2024,9,ALLAHABAD,BHUBANESWAR,717,774,ALLAHABAD-BHUBANESWAR,1491,All
2024,10,ALLAHABAD,BHUBANESWAR,938,967,ALLAHABAD-BHUBANESWAR,1905,All
2024,11,ALLAHABAD,BHUBANESWAR,937,953,ALLAHABAD-BHUBANESWAR,1890,All
2024,12,ALLAHABAD,BHUBANESWAR,958,933,ALLAHABAD-BHUBANESWAR,1891,All
2024,1,ALLAHABAD,BILASPUR,470,452,ALLAHABAD-BILASPUR,922,All
2024,2,ALLAHABAD,BILASPUR,721,758,ALLAHABAD-BILASPUR,1479,All
2024,3,ALLAHABAD,BILASPUR,579,677,ALLAHABAD-BILASPUR,1256,All
2024,4,ALLAHABAD,BILASPUR,106,110,ALLAHABAD-BILASPUR,216,All
2024,6,ALLAHABAD,BILASPUR,261,331,ALLAHABAD-BILASPUR,592,All
2024,7,ALLAHABAD,BILASPUR,423,507,ALLAHABAD-BILASPUR,930,All
2024,8,ALLAHABAD,BILASPUR,397,512,ALLAHABAD-BILASPUR,909,All
2024,9,ALLAHABAD,BILASPUR,254,288,ALLAHABAD-BILASPUR,542,All
2024,10,ALLAHABAD,BILASPUR,504,551,ALLAHABAD-BILASPUR,1055,All
2024,11,ALLAHABAD,BILASPUR,448,469,ALLAHABAD-BILASPUR,917,All
2024,12,ALLAHABAD,BILASPUR,604,587,ALLAHABAD-BILASPUR,1191,All
2024,1,ALLAHABAD,DELHI,4771,4630,ALLAHABAD-DELHI,9401,All
2024,2,ALLAHABAD,DELHI,5541,5661,ALLAHABAD-DELHI,11202,All
2024,3,ALLAHABAD,DELHI,5723,5776,ALLAHABAD-DELHI,11499,All
2024,4,ALLAHABAD,DELHI,6118,6575,ALLAHABAD-DELHI,12693,All
2024,6,ALLAHABAD,DELHI,6871,6786,ALLAHABAD-DELHI,13657,All
2024,7,ALLAHABAD,DELHI,7246,6810,ALLAHABAD-DELHI,14056,All
2024,8,ALLAHABAD,DELHI,7066,6599,ALLAHABAD-DELHI,13665,All
2024,9,ALLAHABAD,DELHI,5920,6106,ALLAHABAD-DELHI,12026,All
2024,10,ALLAHABAD,DELHI,5666,6774,ALLAHABAD-DELHI,12440,All
2024,11,ALLAHABAD,DELHI,6549,6431,ALLAHABAD-DELHI,12980,All
2024,12,ALLAHABAD,DELHI,7415,7106,ALLAHABAD-DELHI,14521,All
2024,1,ALLAHABAD,DehraDun,720,530,ALLAHABAD-DehraDun,1250,All
2024,2,ALLAHABAD,DehraDun,1321,1092,ALLAHABAD-DehraDun,2413,All
2024,3,ALLAHABAD,DehraDun,1626,1527,ALLAHABAD-DehraDun,3153,All
2024,4,ALLAHABAD,DehraDun,1279,1181,ALLAHABAD-DehraDun,2460,All
2024,6,ALLAHABAD,DehraDun,1371,1467,ALLAHABAD-DehraDun,2838,All
2024,7,ALLAHABAD,DehraDun,1084,989,ALLAHABAD-DehraDun,2073,All
2024,8,ALLAHABAD,DehraDun,1037,888,ALLAHABAD-DehraDun,1925,All
2024,6,ALLAHABAD,GORAKHPUR,0,41,ALLAHABAD-GORAKHPUR,41,All
2024,9,ALLAHABAD,HYDERABAD,145,166,ALLAHABAD-HYDERABAD,311,All
2024,10,ALLAHABAD,HYDERABAD,1584,2198,ALLAHABAD-HYDERABAD,3782,All
2024,11,ALLAHABAD,HYDERABAD,2102,2101,ALLAHABAD-HYDERABAD,4203,All
2024,12,ALLAHABAD,HYDERABAD,2202,2024,ALLAHABAD-HYDERABAD,4226,All
2024,6,ALLAHABAD,JAIPUR,0,59,ALLAHABAD-JAIPUR,59,All
2024,1,ALLAHABAD,LUCKNOW,1190,1073,ALLAHABAD-LUCKNOW,2263,All
2024,2,ALLAHABAD,LUCKNOW,1559,1558,ALLAHABAD-LUCKNOW,3117,All
2024,3,ALLAHABAD,LUCKNOW,1952,1789,ALLAHABAD-LUCKNOW,3741,All
2024,4,ALLAHABAD,LUCKNOW,1896,1403,ALLAHABAD-LUCKNOW,3299,All
2024,6,ALLAHABAD,LUCKNOW,1511,1328,ALLAHABAD-LUCKNOW,2839,All
2024,7,ALLAHABAD,LUCKNOW,1748,1402,ALLAHABAD-LUCKNOW,3150,All
2024,8,ALLAHABAD,LUCKNOW,1799,1477,ALLAHABAD-LUCKNOW,3276,All
2024,9,ALLAHABAD,LUCKNOW,1576,1317,ALLAHABAD-LUCKNOW,2893,All
2024,10,ALLAHABAD,LUCKNOW,1718,1474,ALLAHABAD-LUCKNOW,3192,All
2024,11,ALLAHABAD,LUCKNOW,1109,919,ALLAHABAD-LUCKNOW,2028,All
2024,12,ALLAHABAD,LUCKNOW,1286,1004,ALLAHABAD-LUCKNOW,2290,All
2024,1,ALLAHABAD,MUMBAI,4139,4270,ALLAHABAD-MUMBAI,8409,All
2024,2,ALLAHABAD,MUMBAI,4707,5121,ALLAHABAD-MUMBAI,9828,All
2024,3,ALLAHABAD,MUMBAI,5011,5549,ALLAHABAD-MUMBAI,10560,All
2024,4,ALLAHABAD,MUMBAI,4548,5323,ALLAHABAD-MUMBAI,9871,All
2024,6,ALLAHABAD,MUMBAI,10121,8567,ALLAHABAD-MUMBAI,18688,All
2024,7,ALLAHABAD,MUMBAI,8957,7945,ALLAHABAD-MUMBAI,16902,All
2024,8,ALLAHABAD,MUMBAI,9502,8014,ALLAHABAD-MUMBAI,17516,All
2024,9,ALLAHABAD,MUMBAI,8752,9125,ALLAHABAD-MUMBAI,17877,All
2024,10,ALLAHABAD,MUMBAI,6687,10257,ALLAHABAD-MUMBAI,16944,All
2024,11,ALLAHABAD,MUMBAI,11696,12249,ALLAHABAD-MUMBAI,23945,All
2024,12,ALLAHABAD,MUMBAI,11515,11143,ALLAHABAD-MUMBAI,22658,All
2024,1,ALLAHABAD,PUNE,1545,1644,ALLAHABAD-PUNE,3189,All
2024,2,ALLAHABAD,PUNE,2103,2413,ALLAHABAD-PUNE,4516,All
2024,3,ALLAHABAD,PUNE,1933,2113,ALLAHABAD-PUNE,4046,All
2024,8,ALLAHABAD,RAIPUR,575,719,ALLAHABAD-RAIPUR,1294,All
2024,9,ALLAHABAD,RAIPUR,1189,1547,ALLAHABAD-RAIPUR,2736,All
2024,10,ALLAHABAD,RAIPUR,1510,1807,ALLAHABAD-RAIPUR,3317,All
2024,11,ALLAHABAD,RAIPUR,1918,1933,ALLAHABAD-RAIPUR,3851,All
2024,12,ALLAHABAD,RAIPUR,2137,1803,ALLAHABAD-RAIPUR,3940,All
2024,3,ALLAHABAD,VARANASI,174,0,ALLAHABAD-VARANASI,174,All
2024,1,AMRITSAR,BENGALURU,3579,4133,AMRITSAR-BENGALURU,7712,All
2024,2,AMRITSAR,BENGALURU,3542,3378,AMRITSAR-BENGALURU,6920,All
2024,3,AMRITSAR,BENGALURU,3870,3576,AMRITSAR-BENGALURU,7446,All
2024,4,AMRITSAR,BENGALURU,2960,2508,AMRITSAR-BENGALURU,5468,All
2024,6,AMRITSAR,BENGALURU,2847,2143,AMRITSAR-BENGALURU,4990,All
2024,7,AMRITSAR,BENGALURU,4162,4303,AMRITSAR-BENGALURU,8465,All
2024,8,AMRITSAR,BENGALURU,3691,4139,AMRITSAR-BENGALURU,7830,All
2024,9,AMRITSAR,BENGALURU,3691,4410,AMRITSAR-BENGALURU,8101,All
2024,10,AMRITSAR,BENGALURU,4552,5674,AMRITSAR-BENGALURU,10226,All
2024,11,AMRITSAR,BENGALURU,4632,4641,AMRITSAR-BENGALURU,9273,All
2024,12,AMRITSAR,BENGALURU,6009,5258,AMRITSAR-BENGALURU,11267,All
2025,1,AMRITSAR,BENGALURU,8334,6886,AMRITSAR-BENGALURU,15220,All
2025,2,AMRITSAR,BENGALURU,5783,5854,AMRITSAR-BENGALURU,11637,All
2025,3,AMRITSAR,BENGALURU,6535,5570,AMRITSAR-BENGALURU,12105,All
2024,6,AMRITSAR,CHANDIGARH,166,0,AMRITSAR-CHANDIGARH,166,All
2024,11,AMRITSAR,CHANDIGARH,0,311,AMRITSAR-CHANDIGARH,311,All
2025,2,AMRITSAR,CHANDIGARH,122,0,AMRITSAR-CHANDIGARH,122,All
2024,1,AMRITSAR,CHENNAI,140,0,AMRITSAR-CHENNAI,140,All
2024,2,AMRITSAR,CHENNAI,190,0,AMRITSAR-CHENNAI,190,All
2024,3,AMRITSAR,CHENNAI,109,0,AMRITSAR-CHENNAI,109,All
2024,4,AMRITSAR,CHENNAI,90,43,AMRITSAR-CHENNAI,133,All
2024,6,AMRITSAR,CHENNAI,111,33,AMRITSAR-CHENNAI,144,All
2024,7,AMRITSAR,CHENNAI,161,174,AMRITSAR-CHENNAI,335,All
2024,8,AMRITSAR,CHENNAI,135,117,AMRITSAR-CHENNAI,252,All
2024,9,AMRITSAR,CHENNAI,287,203,AMRITSAR-CHENNAI,490,All
2024,10,AMRITSAR,CHENNAI,322,79,AMRITSAR-CHENNAI,401,All
2024,11,AMRITSAR,CHENNAI,80,118,AMRITSAR-CHENNAI,198,All
2024,6,AMRITSAR,DABOLIM,0,6,AMRITSAR-DABOLIM,6,All
2024,1,AMRITSAR,DELHI,42781,47465,AMRITSAR-DELHI,90246,All
2024,2,AMRITSAR,DELHI,55048,57160,AMRITSAR-DELHI,112208,All
2024,3,AMRITSAR,DELHI,60569,60856,AMRITSAR-DELHI,121425,All
2024,4,AMRITSAR,DELHI,51511,49794,AMRITSAR-DELHI,101305,All
2024,6,AMRITSAR,DELHI,48407,42769,AMRITSAR-DELHI,91176,All
2024,7,AMRITSAR,DELHI,44159,46262,AMRITSAR-DELHI,90421,All
2024,8,AMRITSAR,DELHI,43762,48058,AMRITSAR-DELHI,91820,All
2024,9,AMRITSAR,DELHI,45218,49801,AMRITSAR-DELHI,95019,All
2024,10,AMRITSAR,DELHI,46482,54951,AMRITSAR-DELHI,101433,All
2024,11,AMRITSAR,DELHI,57858,57950,AMRITSAR-DELHI,115808,All
2024,12,AMRITSAR,DELHI,61164,60891,AMRITSAR-DELHI,122055,All
2025,1,AMRITSAR,DELHI,53380,56882,AMRITSAR-DELHI,110262,All
2025,2,AMRITSAR,DELHI,59957,63483,AMRITSAR-DELHI,123440,All
2025,3,AMRITSAR,DELHI,65075,64468,AMRITSAR-DELHI,129543,All
2024,4,AMRITSAR,DHARAMSALA,0,51,AMRITSAR-DHARAMSALA,51,All
2024,3,AMRITSAR,DehraDun,46,85,AMRITSAR-DehraDun,131,All
2024,6,AMRITSAR,DehraDun,121,116,AMRITSAR-DehraDun,237,All
2024,7,AMRITSAR,DehraDun,70,92,AMRITSAR-DehraDun,162,All
2024,8,AMRITSAR,DehraDun,198,208,AMRITSAR-DehraDun,406,All
2024,9,AMRITSAR,DehraDun,214,140,AMRITSAR-DehraDun,354,All
2024,10,AMRITSAR,DehraDun,261,240,AMRITSAR-DehraDun,501,All
2024,11,AMRITSAR,DehraDun,157,154,AMRITSAR-DehraDun,311,All
2024,4,AMRITSAR,GUWAHATI,52,102,AMRITSAR-GUWAHATI,154,All
2024,6,AMRITSAR,GUWAHATI,109,192,AMRITSAR-GUWAHATI,301,All
2024,7,AMRITSAR,GUWAHATI,176,197,AMRITSAR-GUWAHATI,373,All
2024,8,AMRITSAR,GUWAHATI,114,179,AMRITSAR-GUWAHATI,293,All
2024,9,AMRITSAR,GUWAHATI,99,112,AMRITSAR-GUWAHATI,211,All
2024,10,AMRITSAR,GUWAHATI,187,227,AMRITSAR-GUWAHATI,414,All
2024,11,AMRITSAR,GUWAHATI,109,121,AMRITSAR-GUWAHATI,230,All
2024,12,AMRITSAR,GUWAHATI,64,83,AMRITSAR-GUWAHATI,147,All
2025,3,AMRITSAR,GUWAHATI,37,110,AMRITSAR-GUWAHATI,147,All
2024,1,AMRITSAR,Goa,2673,2784,AMRITSAR-Goa,5457,All
2024,1,AMRITSAR,HYDERABAD,3870,4378,AMRITSAR-HYDERABAD,8248,All
2024,2,AMRITSAR,HYDERABAD,3480,3597,AMRITSAR-HYDERABAD,7077,All
2024,3,AMRITSAR,HYDERABAD,4732,4586,AMRITSAR-HYDERABAD,9318,All
2024,4,AMRITSAR,HYDERABAD,9558,8926,AMRITSAR-HYDERABAD,18484,All
2024,6,AMRITSAR,HYDERABAD,9879,8519,AMRITSAR-HYDERABAD,18398,All
2024,7,AMRITSAR,HYDERABAD,6439,6888,AMRITSAR-HYDERABAD,13327,All
2024,8,AMRITSAR,HYDERABAD,7173,8363,AMRITSAR-HYDERABAD,15536,All
2024,9,AMRITSAR,HYDERABAD,6558,7223,AMRITSAR-HYDERABAD,13781,All
2024,10,AMRITSAR,HYDERABAD,6834,8294,AMRITSAR-HYDERABAD,15128,All
2024,11,AMRITSAR,HYDERABAD,4890,4682,AMRITSAR-HYDERABAD,9572,All
2024,12,AMRITSAR,HYDERABAD,5146,4561,AMRITSAR-HYDERABAD,9707,All
2025,1,AMRITSAR,HYDERABAD,4258,5217,AMRITSAR-HYDERABAD,9475,All
2025,2,AMRITSAR,HYDERABAD,4114,4790,AMRITSAR-HYDERABAD,8904,All
2025,3,AMRITSAR,HYDERABAD,4879,5066,AMRITSAR-HYDERABAD,9945,All
2024,8,AMRITSAR,INDORE,13,0,AMRITSAR-INDORE,13,All
2024,11,AMRITSAR,INDORE,0,56,AMRITSAR-INDORE,56,All
2024,3,AMRITSAR,JAIPUR,30,0,AMRITSAR-JAIPUR,30,All
2024,11,AMRITSAR,JAIPUR,190,195,AMRITSAR-JAIPUR,385,All
2024,12,AMRITSAR,JAIPUR,63,59,AMRITSAR-JAIPUR,122,All
2025,3,AMRITSAR,JAIPUR,1459,1463,AMRITSAR-JAIPUR,2922,All
2024,4,AMRITSAR,JAMMU,165,0,AMRITSAR-JAMMU,165,All
2025,3,AMRITSAR,KOCHI,0,1,AMRITSAR-KOCHI,1,All
2024,4,AMRITSAR,KOLKATA,2051,1677,AMRITSAR-KOLKATA,3728,All
2024,6,AMRITSAR,KOLKATA,2051,1490,AMRITSAR-KOLKATA,3541,All
2024,7,AMRITSAR,KOLKATA,2043,1938,AMRITSAR-KOLKATA,3981,All
2024,8,AMRITSAR,KOLKATA,2019,2021,AMRITSAR-KOLKATA,4040,All
2024,9,AMRITSAR,KOLKATA,1765,1658,AMRITSAR-KOLKATA,3423,All
2024,10,AMRITSAR,KOLKATA,1967,1883,AMRITSAR-KOLKATA,3850,All
2024,11,AMRITSAR,KOLKATA,2229,2101,AMRITSAR-KOLKATA,4330,All
2024,12,AMRITSAR,KOLKATA,2762,2463,AMRITSAR-KOLKATA,5225,All
2025,1,AMRITSAR,KOLKATA,2291,2352,AMRITSAR-KOLKATA,4643,All
2025,2,AMRITSAR,KOLKATA,2199,2305,AMRITSAR-KOLKATA,4504,All
2025,3,AMRITSAR,KOLKATA,2554,2346,AMRITSAR-KOLKATA,4900,All
2024,1,AMRITSAR,KULLU,101,85,AMRITSAR-KULLU,186,All
2024,2,AMRITSAR,KULLU,311,309,AMRITSAR-KULLU,620,All
2024,3,AMRITSAR,KULLU,563,455,AMRITSAR-KULLU,1018,All
2024,4,AMRITSAR,KULLU,673,468,AMRITSAR-KULLU,1141,All
2024,6,AMRITSAR,KULLU,549,394,AMRITSAR-KULLU,943,All
2024,7,AMRITSAR,KULLU,244,212,AMRITSAR-KULLU,456,All
2024,8,AMRITSAR,KULLU,207,181,AMRITSAR-KULLU,388,All
2024,9,AMRITSAR,KULLU,467,277,AMRITSAR-KULLU,744,All
2024,10,AMRITSAR,KULLU,471,391,AMRITSAR-KULLU,862,All
2024,11,AMRITSAR,KULLU,329,218,AMRITSAR-KULLU,547,All
2024,12,AMRITSAR,KULLU,143,78,AMRITSAR-KULLU,221,All
2025,1,AMRITSAR,KULLU,158,133,AMRITSAR-KULLU,291,All
2025,2,AMRITSAR,KULLU,181,126,AMRITSAR-KULLU,307,All
2025,3,AMRITSAR,KULLU,462,296,AMRITSAR-KULLU,758,All
2024,2,AMRITSAR,LUCKNOW,949,712,AMRITSAR-LUCKNOW,1661,All
2024,3,AMRITSAR,LUCKNOW,3797,2725,AMRITSAR-LUCKNOW,6522,All
2024,4,AMRITSAR,LUCKNOW,3502,2214,AMRITSAR-LUCKNOW,5716,All
2024,6,AMRITSAR,LUCKNOW,2295,2040,AMRITSAR-LUCKNOW,4335,All
2024,7,AMRITSAR,LUCKNOW,1599,2105,AMRITSAR-LUCKNOW,3704,All
2024,8,AMRITSAR,LUCKNOW,2072,3135,AMRITSAR-LUCKNOW,5207,All
2024,9,AMRITSAR,LUCKNOW,2450,2456,AMRITSAR-LUCKNOW,4906,All
2024,10,AMRITSAR,LUCKNOW,2908,2309,AMRITSAR-LUCKNOW,5217,All
2024,11,AMRITSAR,LUCKNOW,3887,3203,AMRITSAR-LUCKNOW,7090,All
2024,12,AMRITSAR,LUCKNOW,3356,3242,AMRITSAR-LUCKNOW,6598,All
2025,1,AMRITSAR,LUCKNOW,3241,3354,AMRITSAR-LUCKNOW,6595,All
2025,2,AMRITSAR,LUCKNOW,3778,4396,AMRITSAR-LUCKNOW,8174,All
2024,1,AMRITSAR,MUMBAI,17463,17502,AMRITSAR-MUMBAI,34965,All
2024,2,AMRITSAR,MUMBAI,16359,16883,AMRITSAR-MUMBAI,33242,All
2024,3,AMRITSAR,MUMBAI,17539,17263,AMRITSAR-MUMBAI,34802,All
2024,4,AMRITSAR,MUMBAI,12099,12287,AMRITSAR-MUMBAI,24386,All
2024,6,AMRITSAR,MUMBAI,13235,9488,AMRITSAR-MUMBAI,22723,All
2024,7,AMRITSAR,MUMBAI,9582,8867,AMRITSAR-MUMBAI,18449,All
2024,8,AMRITSAR,MUMBAI,9582,8691,AMRITSAR-MUMBAI,18273,All
2024,9,AMRITSAR,MUMBAI,12325,12813,AMRITSAR-MUMBAI,25138,All
2024,10,AMRITSAR,MUMBAI,10423,13840,AMRITSAR-MUMBAI,24263,All
2024,11,AMRITSAR,MUMBAI,11045,10450,AMRITSAR-MUMBAI,21495,All
2024,12,AMRITSAR,MUMBAI,16885,15753,AMRITSAR-MUMBAI,32638,All
2025,1,AMRITSAR,MUMBAI,14736,15318,AMRITSAR-MUMBAI,30054,All
2025,2,AMRITSAR,MUMBAI,12621,14105,AMRITSAR-MUMBAI,26726,All
2025,3,AMRITSAR,MUMBAI,12496,11995,AMRITSAR-MUMBAI,24491,All
2024,4,AMRITSAR,NAGPUR,12,0,AMRITSAR-NAGPUR,12,All
2024,1,AMRITSAR,PUNE,4979,5104,AMRITSAR-PUNE,10083,All
2024,2,AMRITSAR,PUNE,4733,4899,AMRITSAR-PUNE,9632,All
2024,3,AMRITSAR,PUNE,5166,5327,AMRITSAR-PUNE,10493,All
2024,4,AMRITSAR,PUNE,5124,5138,AMRITSAR-PUNE,10262,All
2024,6,AMRITSAR,PUNE,5355,4944,AMRITSAR-PUNE,10299,All
2024,7,AMRITSAR,PUNE,5377,5052,AMRITSAR-PUNE,10429,All
2024,8,AMRITSAR,PUNE,4550,4325,AMRITSAR-PUNE,8875,All
2024,9,AMRITSAR,PUNE,4371,4451,AMRITSAR-PUNE,8822,All
2024,10,AMRITSAR,PUNE,4219,5209,AMRITSAR-PUNE,9428,All
2024,11,AMRITSAR,PUNE,3602,3407,AMRITSAR-PUNE,7009,All
2024,12,AMRITSAR,PUNE,5316,5069,AMRITSAR-PUNE,10385,All
2025,1,AMRITSAR,PUNE,3293,3327,AMRITSAR-PUNE,6620,All
2025,2,AMRITSAR,PUNE,4250,4652,AMRITSAR-PUNE,8902,All
2025,3,AMRITSAR,PUNE,5355,5014,AMRITSAR-PUNE,10369,All
2024,1,AMRITSAR,SIMLA,131,95,AMRITSAR-SIMLA,226,All
2024,2,AMRITSAR,SIMLA,199,135,AMRITSAR-SIMLA,334,All
2024,3,AMRITSAR,SIMLA,363,232,AMRITSAR-SIMLA,595,All
2024,4,AMRITSAR,SIMLA,369,185,AMRITSAR-SIMLA,554,All
2024,6,AMRITSAR,SIMLA,336,183,AMRITSAR-SIMLA,519,All
2024,7,AMRITSAR,SIMLA,65,25,AMRITSAR-SIMLA,90,All
2024,8,AMRITSAR,SIMLA,70,40,AMRITSAR-SIMLA,110,All
2024,9,AMRITSAR,SIMLA,72,52,AMRITSAR-SIMLA,124,All
2024,10,AMRITSAR,SIMLA,314,243,AMRITSAR-SIMLA,557,All
2024,11,AMRITSAR,SIMLA,191,121,AMRITSAR-SIMLA,312,All
2024,12,AMRITSAR,SIMLA,52,46,AMRITSAR-SIMLA,98,All
2025,1,AMRITSAR,SIMLA,104,68,AMRITSAR-SIMLA,172,All
2025,2,AMRITSAR,SIMLA,212,140,AMRITSAR-SIMLA,352,All
2025,3,AMRITSAR,SIMLA,361,260,AMRITSAR-SIMLA,621,All
2024,1,AMRITSAR,SRINAGAR,3521,3517,AMRITSAR-SRINAGAR,7038,All
2024,2,AMRITSAR,SRINAGAR,4241,3793,AMRITSAR-SRINAGAR,8034,All
2024,3,AMRITSAR,SRINAGAR,7342,6381,AMRITSAR-SRINAGAR,13723,All
2024,4,AMRITSAR,SRINAGAR,6205,5555,AMRITSAR-SRINAGAR,11760,All
2024,6,AMRITSAR,SRINAGAR,6549,5857,AMRITSAR-SRINAGAR,12406,All
2024,7,AMRITSAR,SRINAGAR,7557,7115,AMRITSAR-SRINAGAR,14672,All
2024,8,AMRITSAR,SRINAGAR,7069,6539,AMRITSAR-SRINAGAR,13608,All
2024,9,AMRITSAR,SRINAGAR,6626,6308,AMRITSAR-SRINAGAR,12934,All
2024,10,AMRITSAR,SRINAGAR,6111,7831,AMRITSAR-SRINAGAR,13942,All
2024,11,AMRITSAR,SRINAGAR,6248,5669,AMRITSAR-SRINAGAR,11917,All
2024,12,AMRITSAR,SRINAGAR,7799,7445,AMRITSAR-SRINAGAR,15244,All
2025,1,AMRITSAR,SRINAGAR,7219,6960,AMRITSAR-SRINAGAR,14179,All
2025,2,AMRITSAR,SRINAGAR,7860,7407,AMRITSAR-SRINAGAR,15267,All
2025,3,AMRITSAR,SRINAGAR,9574,8863,AMRITSAR-SRINAGAR,18437,All
2024,11,AMRITSAR,VARANASI,0,1,AMRITSAR-VARANASI,1,All
2024,12,AMRITSAR,VARANASI,0,1,AMRITSAR-VARANASI,1,All
2025,3,AMRITSAR,VARANASI,0,46,AMRITSAR-VARANASI,46,All
2024,1,AURANGABAD,BENGALURU,2848,2951,AURANGABAD-BENGALURU,5799,All
2024,2,AURANGABAD,BENGALURU,2500,2678,AURANGABAD-BENGALURU,5178,All
2024,3,AURANGABAD,BENGALURU,2677,2820,AURANGABAD-BENGALURU,5497,All
2024,4,AURANGABAD,BENGALURU,2673,2739,AURANGABAD-BENGALURU,5412,All
2024,6,AURANGABAD,BENGALURU,2803,2728,AURANGABAD-BENGALURU,5531,All
2024,7,AURANGABAD,BENGALURU,1460,1383,AURANGABAD-BENGALURU,2843,All
2024,8,AURANGABAD,BENGALURU,2836,2900,AURANGABAD-BENGALURU,5736,All
2024,9,AURANGABAD,BENGALURU,2554,2641,AURANGABAD-BENGALURU,5195,All
2024,10,AURANGABAD,BENGALURU,2560,2732,AURANGABAD-BENGALURU,5292,All
2024,11,AURANGABAD,BENGALURU,2104,1968,AURANGABAD-BENGALURU,4072,All
2024,12,AURANGABAD,BENGALURU,2170,2238,AURANGABAD-BENGALURU,4408,All
2025,1,AURANGABAD,BENGALURU,2173,2030,AURANGABAD-BENGALURU,4203,All
2025,2,AURANGABAD,BENGALURU,1270,1330,AURANGABAD-BENGALURU,2600,All
2025,3,AURANGABAD,BENGALURU,1960,2129,AURANGABAD-BENGALURU,4089,All
2024,10,AURANGABAD,DABOLIM,106,109,AURANGABAD-DABOLIM,215,All
2024,11,AURANGABAD,DABOLIM,669,556,AURANGABAD-DABOLIM,1225,All
2024,12,AURANGABAD,DABOLIM,601,593,AURANGABAD-DABOLIM,1194,All
2025,1,AURANGABAD,DABOLIM,617,521,AURANGABAD-DABOLIM,1138,All
2025,2,AURANGABAD,DABOLIM,611,581,AURANGABAD-DABOLIM,1192,All
2025,3,AURANGABAD,DABOLIM,562,603,AURANGABAD-DABOLIM,1165,All
2024,1,AURANGABAD,DELHI,9932,9380,AURANGABAD-DELHI,19312,All
2024,2,AURANGABAD,DELHI,9517,8730,AURANGABAD-DELHI,18247,All
2024,3,AURANGABAD,DELHI,11647,11815,AURANGABAD-DELHI,23462,All
2024,4,AURANGABAD,DELHI,10470,9425,AURANGABAD-DELHI,19895,All
2024,6,AURANGABAD,DELHI,10273,12426,AURANGABAD-DELHI,22699,All
2024,7,AURANGABAD,DELHI,9585,10867,AURANGABAD-DELHI,20452,All
2024,8,AURANGABAD,DELHI,10240,10655,AURANGABAD-DELHI,20895,All
2024,9,AURANGABAD,DELHI,9826,10590,AURANGABAD-DELHI,20416,All
2024,10,AURANGABAD,DELHI,12176,11511,AURANGABAD-DELHI,23687,All
2024,11,AURANGABAD,DELHI,13122,14220,AURANGABAD-DELHI,27342,All
2024,12,AURANGABAD,DELHI,13223,15393,AURANGABAD-DELHI,28616,All
2025,1,AURANGABAD,DELHI,11124,10617,AURANGABAD-DELHI,21741,All
2025,2,AURANGABAD,DELHI,10660,10293,AURANGABAD-DELHI,20953,All
2025,3,AURANGABAD,DELHI,11149,11231,AURANGABAD-DELHI,22380,All
2024,7,AURANGABAD,Goa,537,470,AURANGABAD-Goa,1007,All
2024,8,AURANGABAD,Goa,516,510,AURANGABAD-Goa,1026,All
2024,9,AURANGABAD,Goa,442,488,AURANGABAD-Goa,930,All
2024,10,AURANGABAD,Goa,471,440,AURANGABAD-Goa,911,All
2024,1,AURANGABAD,HYDERABAD,4077,3377,AURANGABAD-HYDERABAD,7454,All
2024,2,AURANGABAD,HYDERABAD,3772,3265,AURANGABAD-HYDERABAD,7037,All
2024,3,AURANGABAD,HYDERABAD,4283,3389,AURANGABAD-HYDERABAD,7672,All
2024,4,AURANGABAD,HYDERABAD,3763,3112,AURANGABAD-HYDERABAD,6875,All
2024,6,AURANGABAD,HYDERABAD,4101,3153,AURANGABAD-HYDERABAD,7254,All
2024,7,AURANGABAD,HYDERABAD,4159,3381,AURANGABAD-HYDERABAD,7540,All
2024,8,AURANGABAD,HYDERABAD,4265,3348,AURANGABAD-HYDERABAD,7613,All
2024,9,AURANGABAD,HYDERABAD,3929,3194,AURANGABAD-HYDERABAD,7123,All
2024,10,AURANGABAD,HYDERABAD,4107,3584,AURANGABAD-HYDERABAD,7691,All
2024,11,AURANGABAD,HYDERABAD,4293,4102,AURANGABAD-HYDERABAD,8395,All
2024,12,AURANGABAD,HYDERABAD,4442,4263,AURANGABAD-HYDERABAD,8705,All
2025,1,AURANGABAD,HYDERABAD,4436,4247,AURANGABAD-HYDERABAD,8683,All
2025,2,AURANGABAD,HYDERABAD,4151,3893,AURANGABAD-HYDERABAD,8044,All
2025,3,AURANGABAD,HYDERABAD,4367,3984,AURANGABAD-HYDERABAD,8351,All
2024,10,AURANGABAD,JAIPUR,31,17,AURANGABAD-JAIPUR,48,All
2024,11,AURANGABAD,JAIPUR,306,195,AURANGABAD-JAIPUR,501,All
2024,7,AURANGABAD,LUCKNOW,109,79,AURANGABAD-LUCKNOW,188,All
2024,8,AURANGABAD,LUCKNOW,132,116,AURANGABAD-LUCKNOW,248,All
2024,9,AURANGABAD,LUCKNOW,145,77,AURANGABAD-LUCKNOW,222,All
2024,10,AURANGABAD,LUCKNOW,155,78,AURANGABAD-LUCKNOW,233,All
2024,11,AURANGABAD,LUCKNOW,122,98,AURANGABAD-LUCKNOW,220,All
2024,12,AURANGABAD,LUCKNOW,64,58,AURANGABAD-LUCKNOW,122,All
2025,3,AURANGABAD,LUCKNOW,178,123,AURANGABAD-LUCKNOW,301,All
2024,1,AURANGABAD,MUMBAI,12890,11695,AURANGABAD-MUMBAI,24585,All
2024,2,AURANGABAD,MUMBAI,11277,10897,AURANGABAD-MUMBAI,22174,All
2024,3,AURANGABAD,MUMBAI,8839,8788,AURANGABAD-MUMBAI,17627,All
2024,4,AURANGABAD,MUMBAI,7136,7568,AURANGABAD-MUMBAI,14704,All
2024,6,AURANGABAD,MUMBAI,7903,8820,AURANGABAD-MUMBAI,16723,All
2024,7,AURANGABAD,MUMBAI,8452,8544,AURANGABAD-MUMBAI,16996,All
2024,8,AURANGABAD,MUMBAI,9717,9569,AURANGABAD-MUMBAI,19286,All
2024,9,AURANGABAD,MUMBAI,9805,9405,AURANGABAD-MUMBAI,19210,All
2024,10,AURANGABAD,MUMBAI,9038,10597,AURANGABAD-MUMBAI,19635,All
2024,11,AURANGABAD,MUMBAI,9617,8649,AURANGABAD-MUMBAI,18266,All
2024,12,AURANGABAD,MUMBAI,9947,9886,AURANGABAD-MUMBAI,19833,All
2025,1,AURANGABAD,MUMBAI,10104,9629,AURANGABAD-MUMBAI,19733,All
2025,2,AURANGABAD,MUMBAI,9584,9527,AURANGABAD-MUMBAI,19111,All
2025,3,AURANGABAD,MUMBAI,10330,9916,AURANGABAD-MUMBAI,20246,All
2024,7,AURANGABAD,NAGPUR,335,331,AURANGABAD-NAGPUR,666,All
2024,8,AURANGABAD,NAGPUR,387,389,AURANGABAD-NAGPUR,776,All
2024,9,AURANGABAD,NAGPUR,346,331,AURANGABAD-NAGPUR,677,All
2024,10,AURANGABAD,NAGPUR,424,275,AURANGABAD-NAGPUR,699,All
2024,11,AURANGABAD,NAGPUR,458,501,AURANGABAD-NAGPUR,959,All
2024,12,AURANGABAD,NAGPUR,370,397,AURANGABAD-NAGPUR,767,All
2025,1,AURANGABAD,NAGPUR,369,389,AURANGABAD-NAGPUR,758,All
2025,2,AURANGABAD,NAGPUR,424,336,AURANGABAD-NAGPUR,760,All
2025,3,AURANGABAD,NAGPUR,247,331,AURANGABAD-NAGPUR,578,All
2024,1,BAGDOGRA,BENGALURU,30094,29330,BAGDOGRA-BENGALURU,59424,All
2024,2,BAGDOGRA,BENGALURU,23920,23427,BAGDOGRA-BENGALURU,47347,All
2024,3,BAGDOGRA,BENGALURU,25268,25830,BAGDOGRA-BENGALURU,51098,All
2024,4,BAGDOGRA,BENGALURU,29385,30433,BAGDOGRA-BENGALURU,59818,All
2024,6,BAGDOGRA,BENGALURU,32147,29202,BAGDOGRA-BENGALURU,61349,All
2024,7,BAGDOGRA,BENGALURU,28872,25548,BAGDOGRA-BENGALURU,54420,All
2024,8,BAGDOGRA,BENGALURU,22762,21145,BAGDOGRA-BENGALURU,43907,All
2024,9,BAGDOGRA,BENGALURU,22840,22536,BAGDOGRA-BENGALURU,45376,All
2024,10,BAGDOGRA,BENGALURU,31038,30836,BAGDOGRA-BENGALURU,61874,All
2024,11,BAGDOGRA,BENGALURU,25189,20799,BAGDOGRA-BENGALURU,45988,All
2024,12,BAGDOGRA,BENGALURU,26159,23766,BAGDOGRA-BENGALURU,49925,All
2025,1,BAGDOGRA,BENGALURU,26152,23424,BAGDOGRA-BENGALURU,49576,All
2025,2,BAGDOGRA,BENGALURU,21473,20062,BAGDOGRA-BENGALURU,41535,All
2025,3,BAGDOGRA,BENGALURU,25715,23242,BAGDOGRA-BENGALURU,48957,All
2024,8,BAGDOGRA,BHUBANESWAR,4,22,BAGDOGRA-BHUBANESWAR,26,All
2024,9,BAGDOGRA,BHUBANESWAR,239,473,BAGDOGRA-BHUBANESWAR,712,All
2024,10,BAGDOGRA,BHUBANESWAR,554,546,BAGDOGRA-BHUBANESWAR,1100,All
2024,11,BAGDOGRA,BHUBANESWAR,708,754,BAGDOGRA-BHUBANESWAR,1462,All
2024,12,BAGDOGRA,BHUBANESWAR,763,717,BAGDOGRA-BHUBANESWAR,1480,All
2025,3,BAGDOGRA,BHUBANESWAR,689,723,BAGDOGRA-BHUBANESWAR,1412,All
2024,6,BAGDOGRA,CHANDIGARH,4,0,BAGDOGRA-CHANDIGARH,4,All
2024,1,BAGDOGRA,CHENNAI,5943,6157,BAGDOGRA-CHENNAI,12100,All
2024,2,BAGDOGRA,CHENNAI,5297,6378,BAGDOGRA-CHENNAI,11675,All
2024,3,BAGDOGRA,CHENNAI,5701,6578,BAGDOGRA-CHENNAI,12279,All
2024,4,BAGDOGRA,CHENNAI,4607,5045,BAGDOGRA-CHENNAI,9652,All
2024,6,BAGDOGRA,CHENNAI,4662,4695,BAGDOGRA-CHENNAI,9357,All
2024,7,BAGDOGRA,CHENNAI,5477,4204,BAGDOGRA-CHENNAI,9681,All
2024,8,BAGDOGRA,CHENNAI,7638,6122,BAGDOGRA-CHENNAI,13760,All
2024,9,BAGDOGRA,CHENNAI,7943,8690,BAGDOGRA-CHENNAI,16633,All
2024,10,BAGDOGRA,CHENNAI,6222,8363,BAGDOGRA-CHENNAI,14585,All
2024,11,BAGDOGRA,CHENNAI,6808,6469,BAGDOGRA-CHENNAI,13277,All
2024,12,BAGDOGRA,CHENNAI,7132,7162,BAGDOGRA-CHENNAI,14294,All
2025,1,BAGDOGRA,CHENNAI,7887,7387,BAGDOGRA-CHENNAI,15274,All
2025,2,BAGDOGRA,CHENNAI,7100,8393,BAGDOGRA-CHENNAI,15493,All
2025,3,BAGDOGRA,CHENNAI,9068,9081,BAGDOGRA-CHENNAI,18149,All
2025,3,BAGDOGRA,COIMBATORE,129,0,BAGDOGRA-COIMBATORE,129,All
2024,1,BAGDOGRA,DELHI,46195,45855,BAGDOGRA-DELHI,92050,All
2024,2,BAGDOGRA,DELHI,44799,46489,BAGDOGRA-DELHI,91288,All
2024,3,BAGDOGRA,DELHI,47610,49554,BAGDOGRA-DELHI,97164,All
2024,4,BAGDOGRA,DELHI,42695,47202,BAGDOGRA-DELHI,89897,All
2024,6,BAGDOGRA,DELHI,44879,44867,BAGDOGRA-DELHI,89746,All
2024,7,BAGDOGRA,DELHI,44141,42328,BAGDOGRA-DELHI,86469,All
2024,8,BAGDOGRA,DELHI,42186,40708,BAGDOGRA-DELHI,82894,All
2024,9,BAGDOGRA,DELHI,38648,40414,BAGDOGRA-DELHI,79062,All
2024,10,BAGDOGRA,DELHI,40334,44006,BAGDOGRA-DELHI,84340,All
2024,11,BAGDOGRA,DELHI,41968,43042,BAGDOGRA-DELHI,85010,All
2024,12,BAGDOGRA,DELHI,42511,43502,BAGDOGRA-DELHI,86013,All
2025,1,BAGDOGRA,DELHI,36114,36986,BAGDOGRA-DELHI,73100,All
2025,2,BAGDOGRA,DELHI,37371,40325,BAGDOGRA-DELHI,77696,All
2025,3,BAGDOGRA,DELHI,42926,46793,BAGDOGRA-DELHI,89719,All
2024,1,BAGDOGRA,DIBRUGARH,2711,2473,BAGDOGRA-DIBRUGARH,5184,All
2024,2,BAGDOGRA,DIBRUGARH,1923,2088,BAGDOGRA-DIBRUGARH,4011,All
2024,3,BAGDOGRA,DIBRUGARH,2576,2261,BAGDOGRA-DIBRUGARH,4837,All
2024,4,BAGDOGRA,DIBRUGARH,3424,2521,BAGDOGRA-DIBRUGARH,5945,All
2024,6,BAGDOGRA,DIBRUGARH,1605,1379,BAGDOGRA-DIBRUGARH,2984,All
2024,7,BAGDOGRA,DIBRUGARH,2945,3561,BAGDOGRA-DIBRUGARH,6506,All
2024,8,BAGDOGRA,DIBRUGARH,1728,1547,BAGDOGRA-DIBRUGARH,3275,All
2024,9,BAGDOGRA,DIBRUGARH,1427,1065,BAGDOGRA-DIBRUGARH,2492,All
2024,10,BAGDOGRA,DIBRUGARH,3488,3262,BAGDOGRA-DIBRUGARH,6750,All
2024,11,BAGDOGRA,DIBRUGARH,1799,1367,BAGDOGRA-DIBRUGARH,3166,All
2024,12,BAGDOGRA,DIBRUGARH,1995,1119,BAGDOGRA-DIBRUGARH,3114,All
2025,1,BAGDOGRA,DIBRUGARH,1764,1045,BAGDOGRA-DIBRUGARH,2809,All
2025,2,BAGDOGRA,DIBRUGARH,1552,1079,BAGDOGRA-DIBRUGARH,2631,All
2025,3,BAGDOGRA,DIBRUGARH,1599,1021,BAGDOGRA-DIBRUGARH,2620,All
2024,8,BAGDOGRA,DURGAPUR,16,15,BAGDOGRA-DURGAPUR,31,All
2024,9,BAGDOGRA,DURGAPUR,233,292,BAGDOGRA-DURGAPUR,525,All
2024,10,BAGDOGRA,DURGAPUR,555,563,BAGDOGRA-DURGAPUR,1118,All
2024,11,BAGDOGRA,DURGAPUR,445,438,BAGDOGRA-DURGAPUR,883,All
2024,12,BAGDOGRA,DURGAPUR,508,501,BAGDOGRA-DURGAPUR,1009,All
2025,1,BAGDOGRA,DURGAPUR,494,458,BAGDOGRA-DURGAPUR,952,All
2025,2,BAGDOGRA,DURGAPUR,438,510,BAGDOGRA-DURGAPUR,948,All
2025,3,BAGDOGRA,DURGAPUR,622,596,BAGDOGRA-DURGAPUR,1218,All
2024,1,BAGDOGRA,GUWAHATI,1896,4325,BAGDOGRA-GUWAHATI,6221,All
2024,2,BAGDOGRA,GUWAHATI,1347,3154,BAGDOGRA-GUWAHATI,4501,All
2024,3,BAGDOGRA,GUWAHATI,1904,3118,BAGDOGRA-GUWAHATI,5022,All
2024,4,BAGDOGRA,GUWAHATI,1010,2322,BAGDOGRA-GUWAHATI,3332,All
2024,6,BAGDOGRA,GUWAHATI,2164,3512,BAGDOGRA-GUWAHATI,5676,All
2024,7,BAGDOGRA,GUWAHATI,2396,4385,BAGDOGRA-GUWAHATI,6781,All
2024,8,BAGDOGRA,GUWAHATI,1375,3120,BAGDOGRA-GUWAHATI,4495,All
2024,9,BAGDOGRA,GUWAHATI,1114,2534,BAGDOGRA-GUWAHATI,3648,All
2024,10,BAGDOGRA,GUWAHATI,1617,3918,BAGDOGRA-GUWAHATI,5535,All
2024,11,BAGDOGRA,GUWAHATI,1431,4251,BAGDOGRA-GUWAHATI,5682,All
2024,12,BAGDOGRA,GUWAHATI,202,2643,BAGDOGRA-GUWAHATI,2845,All
2025,1,BAGDOGRA,GUWAHATI,518,2410,BAGDOGRA-GUWAHATI,2928,All
2025,2,BAGDOGRA,GUWAHATI,1441,3293,BAGDOGRA-GUWAHATI,4734,All
2025,3,BAGDOGRA,GUWAHATI,1334,4644,BAGDOGRA-GUWAHATI,5978,All
2024,1,BAGDOGRA,HYDERABAD,5401,5435,BAGDOGRA-HYDERABAD,10836,All
2024,2,BAGDOGRA,HYDERABAD,4967,5066,BAGDOGRA-HYDERABAD,10033,All
2024,3,BAGDOGRA,HYDERABAD,5263,5525,BAGDOGRA-HYDERABAD,10788,All
2024,4,BAGDOGRA,HYDERABAD,9465,11264,BAGDOGRA-HYDERABAD,20729,All
2024,6,BAGDOGRA,HYDERABAD,13231,12472,BAGDOGRA-HYDERABAD,25703,All
2024,7,BAGDOGRA,HYDERABAD,13368,9668,BAGDOGRA-HYDERABAD,23036,All
2024,8,BAGDOGRA,HYDERABAD,12237,10178,BAGDOGRA-HYDERABAD,22415,All
2024,9,BAGDOGRA,HYDERABAD,10496,12282,BAGDOGRA-HYDERABAD,22778,All
2024,10,BAGDOGRA,HYDERABAD,11648,14979,BAGDOGRA-HYDERABAD,26627,All
2024,11,BAGDOGRA,HYDERABAD,13982,14054,BAGDOGRA-HYDERABAD,28036,All
2024,12,BAGDOGRA,HYDERABAD,14912,14950,BAGDOGRA-HYDERABAD,29862,All
2025,1,BAGDOGRA,HYDERABAD,13046,13001,BAGDOGRA-HYDERABAD,26047,All
2025,2,BAGDOGRA,HYDERABAD,11902,13751,BAGDOGRA-HYDERABAD,25653,All
2025,3,BAGDOGRA,HYDERABAD,13184,14150,BAGDOGRA-HYDERABAD,27334,All
2025,1,BAGDOGRA,JAIPUR,156,0,BAGDOGRA-JAIPUR,156,All
2024,1,BAGDOGRA,KOLKATA,37716,36675,BAGDOGRA-KOLKATA,74391,All
2024,2,BAGDOGRA,KOLKATA,27693,28606,BAGDOGRA-KOLKATA,56299,All
2024,3,BAGDOGRA,KOLKATA,30033,31798,BAGDOGRA-KOLKATA,61831,All
2024,4,BAGDOGRA,KOLKATA,27623,29473,BAGDOGRA-KOLKATA,57096,All
2024,6,BAGDOGRA,KOLKATA,33640,28494,BAGDOGRA-KOLKATA,62134,All
2024,7,BAGDOGRA,KOLKATA,25748,21165,BAGDOGRA-KOLKATA,46913,All
2024,8,BAGDOGRA,KOLKATA,23158,21536,BAGDOGRA-KOLKATA,44694,All
2024,9,BAGDOGRA,KOLKATA,21436,22197,BAGDOGRA-KOLKATA,43633,All
2024,10,BAGDOGRA,KOLKATA,25530,26197,BAGDOGRA-KOLKATA,51727,All
2024,11,BAGDOGRA,KOLKATA,26025,24850,BAGDOGRA-KOLKATA,50875,All
2024,12,BAGDOGRA,KOLKATA,22530,22890,BAGDOGRA-KOLKATA,45420,All
2025,1,BAGDOGRA,KOLKATA,26734,25456,BAGDOGRA-KOLKATA,52190,All
2025,2,BAGDOGRA,KOLKATA,24617,23835,BAGDOGRA-KOLKATA,48452,All
2025,3,BAGDOGRA,KOLKATA,27803,27763,BAGDOGRA-KOLKATA,55566,All
2024,1,BAGDOGRA,MUMBAI,10589,10838,BAGDOGRA-MUMBAI,21427,All
2024,2,BAGDOGRA,MUMBAI,9448,10068,BAGDOGRA-MUMBAI,19516,All
2024,3,BAGDOGRA,MUMBAI,10643,11055,BAGDOGRA-MUMBAI,21698,All
2024,4,BAGDOGRA,MUMBAI,16646,18986,BAGDOGRA-MUMBAI,35632,All
2024,6,BAGDOGRA,MUMBAI,17484,16771,BAGDOGRA-MUMBAI,34255,All
2024,7,BAGDOGRA,MUMBAI,11040,10228,BAGDOGRA-MUMBAI,21268,All
2024,8,BAGDOGRA,MUMBAI,10828,10526,BAGDOGRA-MUMBAI,21354,All
2024,9,BAGDOGRA,MUMBAI,9854,9966,BAGDOGRA-MUMBAI,19820,All
2024,10,BAGDOGRA,MUMBAI,11290,11996,BAGDOGRA-MUMBAI,23286,All
2024,11,BAGDOGRA,MUMBAI,11907,11975,BAGDOGRA-MUMBAI,23882,All
2024,12,BAGDOGRA,MUMBAI,14217,14700,BAGDOGRA-MUMBAI,28917,All
2025,1,BAGDOGRA,MUMBAI,12589,12583,BAGDOGRA-MUMBAI,25172,All
2025,2,BAGDOGRA,MUMBAI,9620,9865,BAGDOGRA-MUMBAI,19485,All
2025,3,BAGDOGRA,MUMBAI,10296,10383,BAGDOGRA-MUMBAI,20679,All
2024,11,BAGDOGRA,PATNA,2,6,BAGDOGRA-PATNA,8,All
2024,12,BAGDOGRA,PATNA,3,8,BAGDOGRA-PATNA,11,All
2025,2,BAGDOGRA,PATNA,11,8,BAGDOGRA-PATNA,19,All
2025,3,BAGDOGRA,PATNA,21,70,BAGDOGRA-PATNA,91,All
2025,3,BAGDOGRA,SRINAGAR,0,2,BAGDOGRA-SRINAGAR,2,All
2025,1,BAGDOGRA,VARANASI,4,0,BAGDOGRA-VARANASI,4,All
2024,1,BAREILLY,BENGALURU,1154,1185,BAREILLY-BENGALURU,2339,All
2024,2,BAREILLY,BENGALURU,2033,2115,BAREILLY-BENGALURU,4148,All
2024,3,BAREILLY,BENGALURU,1884,2023,BAREILLY-BENGALURU,3907,All
2024,4,BAREILLY,BENGALURU,1987,2134,BAREILLY-BENGALURU,4121,All
2024,6,BAREILLY,BENGALURU,2195,2128,BAREILLY-BENGALURU,4323,All
2024,7,BAREILLY,BENGALURU,2153,2096,BAREILLY-BENGALURU,4249,All
2024,8,BAREILLY,BENGALURU,2260,2276,BAREILLY-BENGALURU,4536,All
2024,9,BAREILLY,BENGALURU,1866,1968,BAREILLY-BENGALURU,3834,All
2024,10,BAREILLY,BENGALURU,1840,2413,BAREILLY-BENGALURU,4253,All
2024,11,BAREILLY,BENGALURU,2293,2192,BAREILLY-BENGALURU,4485,All
2024,12,BAREILLY,BENGALURU,2173,2120,BAREILLY-BENGALURU,4293,All
2025,1,BAREILLY,BENGALURU,1830,1866,BAREILLY-BENGALURU,3696,All
2025,2,BAREILLY,BENGALURU,1646,1621,BAREILLY-BENGALURU,3267,All
2025,3,BAREILLY,BENGALURU,2202,2161,BAREILLY-BENGALURU,4363,All
2024,1,BAREILLY,DELHI,542,539,BAREILLY-DELHI,1081,All
2024,2,BAREILLY,DELHI,568,559,BAREILLY-DELHI,1127,All
2024,3,BAREILLY,DELHI,515,551,BAREILLY-DELHI,1066,All
2024,4,BAREILLY,DELHI,32,0,BAREILLY-DELHI,32,All
2024,6,BAREILLY,LUCKNOW,0,159,BAREILLY-LUCKNOW,159,All
2024,1,BAREILLY,MUMBAI,2071,2092,BAREILLY-MUMBAI,4163,All
2024,2,BAREILLY,MUMBAI,2625,2647,BAREILLY-MUMBAI,5272,All
2024,3,BAREILLY,MUMBAI,2820,2969,BAREILLY-MUMBAI,5789,All
2024,4,BAREILLY,MUMBAI,2682,2832,BAREILLY-MUMBAI,5514,All
2024,6,BAREILLY,MUMBAI,2887,2900,BAREILLY-MUMBAI,5787,All
2024,7,BAREILLY,MUMBAI,2745,2609,BAREILLY-MUMBAI,5354,All
2024,8,BAREILLY,MUMBAI,2788,2750,BAREILLY-MUMBAI,5538,All
2024,9,BAREILLY,MUMBAI,2785,2864,BAREILLY-MUMBAI,5649,All
2024,10,BAREILLY,MUMBAI,2364,2847,BAREILLY-MUMBAI,5211,All
2024,11,BAREILLY,MUMBAI,2786,2946,BAREILLY-MUMBAI,5732,All
2024,12,BAREILLY,MUMBAI,3174,3060,BAREILLY-MUMBAI,6234,All
2025,1,BAREILLY,MUMBAI,3018,3111,BAREILLY-MUMBAI,6129,All
2025,2,BAREILLY,MUMBAI,2844,2845,BAREILLY-MUMBAI,5689,All
2025,3,BAREILLY,MUMBAI,2838,2973,BAREILLY-MUMBAI,5811,All
2024,1,BELGAUM,BENGALURU,4223,3872,BELGAUM-BENGALURU,8095,All
2024,2,BELGAUM,BENGALURU,3820,3790,BELGAUM-BENGALURU,7610,All
2024,3,BELGAUM,BENGALURU,3762,3923,BELGAUM-BENGALURU,7685,All
2024,4,BELGAUM,BENGALURU,3730,3986,BELGAUM-BENGALURU,7716,All
2024,6,BELGAUM,BENGALURU,3893,4002,BELGAUM-BENGALURU,7895,All
2024,7,BELGAUM,BENGALURU,3811,3758,BELGAUM-BENGALURU,7569,All
2024,8,BELGAUM,BENGALURU,3950,4078,BELGAUM-BENGALURU,8028,All
2024,9,BELGAUM,BENGALURU,3649,3851,BELGAUM-BENGALURU,7500,All
2024,10,BELGAUM,BENGALURU,3452,3839,BELGAUM-BENGALURU,7291,All
2024,11,BELGAUM,BENGALURU,2163,2117,BELGAUM-BENGALURU,4280,All
2024,12,BELGAUM,BENGALURU,3730,4210,BELGAUM-BENGALURU,7940,All
2025,1,BELGAUM,BENGALURU,4269,4024,BELGAUM-BENGALURU,8293,All
2025,2,BELGAUM,BENGALURU,3254,3203,BELGAUM-BENGALURU,6457,All
2025,3,BELGAUM,BENGALURU,3996,3820,BELGAUM-BENGALURU,7816,All
2024,1,BELGAUM,DELHI,3519,2975,BELGAUM-DELHI,6494,All
2024,2,BELGAUM,DELHI,4069,3196,BELGAUM-DELHI,7265,All
2024,3,BELGAUM,DELHI,4208,2959,BELGAUM-DELHI,7167,All
2024,4,BELGAUM,DELHI,4512,3522,BELGAUM-DELHI,8034,All
2024,6,BELGAUM,DELHI,3804,4294,BELGAUM-DELHI,8098,All
2024,7,BELGAUM,DELHI,3488,3489,BELGAUM-DELHI,6977,All
2024,8,BELGAUM,DELHI,3252,3538,BELGAUM-DELHI,6790,All
2024,9,BELGAUM,DELHI,3747,3342,BELGAUM-DELHI,7089,All
2024,10,BELGAUM,DELHI,4707,4090,BELGAUM-DELHI,8797,All
2024,11,BELGAUM,DELHI,4381,4965,BELGAUM-DELHI,9346,All
2024,12,BELGAUM,DELHI,4589,5158,BELGAUM-DELHI,9747,All
2025,1,BELGAUM,DELHI,4004,3984,BELGAUM-DELHI,7988,All
2025,2,BELGAUM,DELHI,4717,4643,BELGAUM-DELHI,9360,All
2025,3,BELGAUM,DELHI,4232,4544,BELGAUM-DELHI,8776,All
2024,1,BELGAUM,HYDERABAD,1564,1515,BELGAUM-HYDERABAD,3079,All
2024,2,BELGAUM,HYDERABAD,1482,1449,BELGAUM-HYDERABAD,2931,All
2024,3,BELGAUM,HYDERABAD,1539,1427,BELGAUM-HYDERABAD,2966,All
2024,4,BELGAUM,HYDERABAD,1525,1739,BELGAUM-HYDERABAD,3264,All
2024,6,BELGAUM,HYDERABAD,1815,1553,BELGAUM-HYDERABAD,3368,All
2024,7,BELGAUM,HYDERABAD,1706,1605,BELGAUM-HYDERABAD,3311,All
2024,8,BELGAUM,HYDERABAD,1876,1854,BELGAUM-HYDERABAD,3730,All
2024,9,BELGAUM,HYDERABAD,1804,1813,BELGAUM-HYDERABAD,3617,All
2024,10,BELGAUM,HYDERABAD,1865,1752,BELGAUM-HYDERABAD,3617,All
2024,11,BELGAUM,HYDERABAD,1996,2065,BELGAUM-HYDERABAD,4061,All
2024,12,BELGAUM,HYDERABAD,2091,2163,BELGAUM-HYDERABAD,4254,All
2025,1,BELGAUM,HYDERABAD,2049,1991,BELGAUM-HYDERABAD,4040,All
2025,2,BELGAUM,HYDERABAD,1868,1927,BELGAUM-HYDERABAD,3795,All
2025,3,BELGAUM,HYDERABAD,2015,2041,BELGAUM-HYDERABAD,4056,All
2024,1,BELGAUM,JAIPUR,667,615,BELGAUM-JAIPUR,1282,All
2024,2,BELGAUM,JAIPUR,597,571,BELGAUM-JAIPUR,1168,All
2024,3,BELGAUM,JAIPUR,536,469,BELGAUM-JAIPUR,1005,All
2024,4,BELGAUM,JAIPUR,620,533,BELGAUM-JAIPUR,1153,All
2024,6,BELGAUM,JAIPUR,539,544,BELGAUM-JAIPUR,1083,All
2024,7,BELGAUM,JAIPUR,637,605,BELGAUM-JAIPUR,1242,All
2024,8,BELGAUM,JAIPUR,571,535,BELGAUM-JAIPUR,1106,All
2024,9,BELGAUM,JAIPUR,563,505,BELGAUM-JAIPUR,1068,All
2024,10,BELGAUM,JAIPUR,643,558,BELGAUM-JAIPUR,1201,All
2024,11,BELGAUM,JAIPUR,486,523,BELGAUM-JAIPUR,1009,All
2024,12,BELGAUM,JAIPUR,638,639,BELGAUM-JAIPUR,1277,All
2025,1,BELGAUM,JAIPUR,553,526,BELGAUM-JAIPUR,1079,All
2025,2,BELGAUM,JAIPUR,559,471,BELGAUM-JAIPUR,1030,All
2025,3,BELGAUM,JAIPUR,599,576,BELGAUM-JAIPUR,1175,All
2024,1,BELGAUM,JODHPUR,827,791,BELGAUM-JODHPUR,1618,All
2024,2,BELGAUM,JODHPUR,820,754,BELGAUM-JODHPUR,1574,All
2024,3,BELGAUM,JODHPUR,781,670,BELGAUM-JODHPUR,1451,All
2024,4,BELGAUM,JODHPUR,801,683,BELGAUM-JODHPUR,1484,All
2024,6,BELGAUM,JODHPUR,753,687,BELGAUM-JODHPUR,1440,All
2024,7,BELGAUM,JODHPUR,487,387,BELGAUM-JODHPUR,874,All
2024,1,BELGAUM,MUMBAI,1036,1050,BELGAUM-MUMBAI,2086,All
2024,2,BELGAUM,MUMBAI,1339,1389,BELGAUM-MUMBAI,2728,All
2024,3,BELGAUM,MUMBAI,1244,1296,BELGAUM-MUMBAI,2540,All
2024,4,BELGAUM,MUMBAI,1493,1510,BELGAUM-MUMBAI,3003,All
2024,6,BELGAUM,MUMBAI,1347,1535,BELGAUM-MUMBAI,2882,All
2024,7,BELGAUM,MUMBAI,1093,1059,BELGAUM-MUMBAI,2152,All
2024,8,BELGAUM,MUMBAI,1269,1209,BELGAUM-MUMBAI,2478,All
2024,9,BELGAUM,MUMBAI,1219,1323,BELGAUM-MUMBAI,2542,All
2024,10,BELGAUM,MUMBAI,1244,1356,BELGAUM-MUMBAI,2600,All
2024,11,BELGAUM,MUMBAI,1218,1327,BELGAUM-MUMBAI,2545,All
2024,12,BELGAUM,MUMBAI,1175,1421,BELGAUM-MUMBAI,2596,All
2025,1,BELGAUM,MUMBAI,1248,1327,BELGAUM-MUMBAI,2575,All
2025,2,BELGAUM,MUMBAI,1160,1184,BELGAUM-MUMBAI,2344,All
2025,3,BELGAUM,MUMBAI,1180,1252,BELGAUM-MUMBAI,2432,All
2024,1,BELGAUM,NAGPUR,552,567,BELGAUM-NAGPUR,1119,All
2024,2,BELGAUM,NAGPUR,467,485,BELGAUM-NAGPUR,952,All
2024,3,BELGAUM,NAGPUR,381,435,BELGAUM-NAGPUR,816,All
2024,4,BELGAUM,NAGPUR,553,592,BELGAUM-NAGPUR,1145,All
2024,6,BELGAUM,NAGPUR,602,621,BELGAUM-NAGPUR,1223,All
2024,7,BELGAUM,NAGPUR,487,492,BELGAUM-NAGPUR,979,All
2024,8,BELGAUM,NAGPUR,573,500,BELGAUM-NAGPUR,1073,All
2024,9,BELGAUM,NAGPUR,455,420,BELGAUM-NAGPUR,875,All
2024,10,BELGAUM,NAGPUR,440,452,BELGAUM-NAGPUR,892,All
2024,11,BELGAUM,NAGPUR,388,434,BELGAUM-NAGPUR,822,All
2024,12,BELGAUM,NAGPUR,424,444,BELGAUM-NAGPUR,868,All
2025,1,BELGAUM,NAGPUR,465,421,BELGAUM-NAGPUR,886,All
2025,2,BELGAUM,NAGPUR,567,539,BELGAUM-NAGPUR,1106,All
2025,3,BELGAUM,NAGPUR,423,342,BELGAUM-NAGPUR,765,All
2024,1,BELGAUM,SURAT,721,660,BELGAUM-SURAT,1381,All
2024,2,BELGAUM,SURAT,712,679,BELGAUM-SURAT,1391,All
2024,3,BELGAUM,SURAT,717,637,BELGAUM-SURAT,1354,All
2024,4,BELGAUM,SURAT,775,619,BELGAUM-SURAT,1394,All
2024,6,BELGAUM,SURAT,243,204,BELGAUM-SURAT,447,All
2024,1,BELGAUM,TIRUPATI,1031,1037,BELGAUM-TIRUPATI,2068,All
2024,2,BELGAUM,TIRUPATI,687,823,BELGAUM-TIRUPATI,1510,All
2024,3,BELGAUM,TIRUPATI,631,542,BELGAUM-TIRUPATI,1173,All
2024,4,BELGAUM,TIRUPATI,566,504,BELGAUM-TIRUPATI,1070,All
2024,6,BELGAUM,TIRUPATI,609,545,BELGAUM-TIRUPATI,1154,All
2024,7,BELGAUM,TIRUPATI,451,450,BELGAUM-TIRUPATI,901,All
2024,8,BELGAUM,TIRUPATI,573,573,BELGAUM-TIRUPATI,1146,All
2024,9,BELGAUM,TIRUPATI,570,527,BELGAUM-TIRUPATI,1097,All
2024,10,BELGAUM,TIRUPATI,524,625,BELGAUM-TIRUPATI,1149,All
2024,11,BELGAUM,TIRUPATI,362,268,BELGAUM-TIRUPATI,630,All
2024,12,BELGAUM,TIRUPATI,50,83,BELGAUM-TIRUPATI,133,All
2025,1,BELGAUM,TIRUPATI,27,27,BELGAUM-TIRUPATI,54,All
2024,1,BENGALURU,Ayodhya International Airport ,1146,916,Ayodhya International Airport -BENGALURU,2062,All
2024,2,BENGALURU,Ayodhya International Airport ,5346,4974,Ayodhya International Airport -BENGALURU,10320,All
2024,3,BENGALURU,Ayodhya International Airport ,5535,4775,Ayodhya International Airport -BENGALURU,10310,All
2024,4,BENGALURU,Ayodhya International Airport ,2676,2345,Ayodhya International Airport -BENGALURU,5021,All
2024,6,BENGALURU,Ayodhya International Airport ,7191,7810,Ayodhya International Airport -BENGALURU,15001,All
2024,7,BENGALURU,Ayodhya International Airport ,6771,7192,Ayodhya International Airport -BENGALURU,13963,All
2024,8,BENGALURU,Ayodhya International Airport ,7659,7387,Ayodhya International Airport -BENGALURU,15046,All
2024,9,BENGALURU,Ayodhya International Airport ,7340,6190,Ayodhya International Airport -BENGALURU,13530,All
2024,10,BENGALURU,Ayodhya International Airport ,8280,6010,Ayodhya International Airport -BENGALURU,14290,All
2024,11,BENGALURU,Ayodhya International Airport ,9321,9547,Ayodhya International Airport -BENGALURU,18868,All
2024,12,BENGALURU,Ayodhya International Airport ,9933,10914,Ayodhya International Airport -BENGALURU,20847,All
2025,1,BENGALURU,Ayodhya International Airport ,14524,14691,Ayodhya International Airport -BENGALURU,29215,All
2025,2,BENGALURU,Ayodhya International Airport ,14264,14122,Ayodhya International Airport -BENGALURU,28386,All
2025,3,BENGALURU,Ayodhya International Airport ,15136,15170,Ayodhya International Airport -BENGALURU,30306,All
2024,1,BENGALURU,BHOPAL,6180,6499,BENGALURU-BHOPAL,12679,All
2024,2,BENGALURU,BHOPAL,4800,4660,BENGALURU-BHOPAL,9460,All
2024,3,BENGALURU,BHOPAL,9006,8339,BENGALURU-BHOPAL,17345,All
2024,4,BENGALURU,BHOPAL,12617,11328,BENGALURU-BHOPAL,23945,All
2024,6,BENGALURU,BHOPAL,12059,12229,BENGALURU-BHOPAL,24288,All
2024,7,BENGALURU,BHOPAL,10472,10735,BENGALURU-BHOPAL,21207,All
2024,8,BENGALURU,BHOPAL,12035,12213,BENGALURU-BHOPAL,24248,All
2024,9,BENGALURU,BHOPAL,11159,10668,BENGALURU-BHOPAL,21827,All
2024,10,BENGALURU,BHOPAL,12252,10122,BENGALURU-BHOPAL,22374,All
2024,11,BENGALURU,BHOPAL,9418,10485,BENGALURU-BHOPAL,19903,All
2024,12,BENGALURU,BHOPAL,10221,10589,BENGALURU-BHOPAL,20810,All
2025,1,BENGALURU,BHOPAL,10254,10664,BENGALURU-BHOPAL,20918,All
2025,2,BENGALURU,BHOPAL,8260,8266,BENGALURU-BHOPAL,16526,All
2025,3,BENGALURU,BHOPAL,9897,9811,BENGALURU-BHOPAL,19708,All
2024,1,BENGALURU,BHUBANESWAR,35557,36945,BENGALURU-BHUBANESWAR,72502,All
2024,2,BENGALURU,BHUBANESWAR,36257,36437,BENGALURU-BHUBANESWAR,72694,All
2024,3,BENGALURU,BHUBANESWAR,36191,35000,BENGALURU-BHUBANESWAR,71191,All
2024,4,BENGALURU,BHUBANESWAR,33118,32592,BENGALURU-BHUBANESWAR,65710,All
2024,6,BENGALURU,BHUBANESWAR,35049,34728,BENGALURU-BHUBANESWAR,69777,All
2024,7,BENGALURU,BHUBANESWAR,33158,36815,BENGALURU-BHUBANESWAR,69973,All
2024,8,BENGALURU,BHUBANESWAR,32535,35078,BENGALURU-BHUBANESWAR,67613,All
2024,9,BENGALURU,BHUBANESWAR,31874,30485,BENGALURU-BHUBANESWAR,62359,All
2024,10,BENGALURU,BHUBANESWAR,37365,32395,BENGALURU-BHUBANESWAR,69760,All
2024,11,BENGALURU,BHUBANESWAR,34722,35689,BENGALURU-BHUBANESWAR,70411,All
2024,12,BENGALURU,BHUBANESWAR,31999,31298,BENGALURU-BHUBANESWAR,63297,All
2025,1,BENGALURU,BHUBANESWAR,35538,36286,BENGALURU-BHUBANESWAR,71824,All
2025,2,BENGALURU,BHUBANESWAR,31415,30250,BENGALURU-BHUBANESWAR,61665,All
2025,3,BENGALURU,BHUBANESWAR,34219,33575,BENGALURU-BHUBANESWAR,67794,All
2024,1,BENGALURU,CHANDIGARH,19180,19573,BENGALURU-CHANDIGARH,38753,All
2024,2,BENGALURU,CHANDIGARH,15411,14692,BENGALURU-CHANDIGARH,30103,All
2024,3,BENGALURU,CHANDIGARH,23440,21775,BENGALURU-CHANDIGARH,45215,All
2024,4,BENGALURU,CHANDIGARH,21330,20592,BENGALURU-CHANDIGARH,41922,All
2024,6,BENGALURU,CHANDIGARH,20426,21286,BENGALURU-CHANDIGARH,41712,All
2024,7,BENGALURU,CHANDIGARH,19955,19739,BENGALURU-CHANDIGARH,39694,All
2024,8,BENGALURU,CHANDIGARH,19884,18441,BENGALURU-CHANDIGARH,38325,All
2024,9,BENGALURU,CHANDIGARH,18966,16878,BENGALURU-CHANDIGARH,35844,All
2024,10,BENGALURU,CHANDIGARH,23598,18933,BENGALURU-CHANDIGARH,42531,All
2024,11,BENGALURU,CHANDIGARH,18794,21772,BENGALURU-CHANDIGARH,40566,All
2024,12,BENGALURU,CHANDIGARH,19352,20527,BENGALURU-CHANDIGARH,39879,All
2025,1,BENGALURU,CHANDIGARH,18391,19724,BENGALURU-CHANDIGARH,38115,All
2025,2,BENGALURU,CHANDIGARH,15932,15219,BENGALURU-CHANDIGARH,31151,All
2025,3,BENGALURU,CHANDIGARH,22795,21742,BENGALURU-CHANDIGARH,44537,All
2024,1,BENGALURU,CHENNAI,48808,51988,BENGALURU-CHENNAI,100796,All
2024,2,BENGALURU,CHENNAI,50428,54396,BENGALURU-CHENNAI,104824,All
2024,3,BENGALURU,CHENNAI,57872,58237,BENGALURU-CHENNAI,116109,All
2024,4,BENGALURU,CHENNAI,61328,60543,BENGALURU-CHENNAI,121871,All
2024,6,BENGALURU,CHENNAI,61002,61487,BENGALURU-CHENNAI,122489,All
2024,7,BENGALURU,CHENNAI,63975,63408,BENGALURU-CHENNAI,127383,All
2024,8,BENGALURU,CHENNAI,65548,65312,BENGALURU-CHENNAI,130860,All
2024,9,BENGALURU,CHENNAI,69705,69554,BENGALURU-CHENNAI,139259,All
2024,10,BENGALURU,CHENNAI,65638,62488,BENGALURU-CHENNAI,128126,All
2024,11,BENGALURU,CHENNAI,46712,50441,BENGALURU-CHENNAI,97153,All
2024,12,BENGALURU,CHENNAI,59701,59077,BENGALURU-CHENNAI,118778,All
2025,1,BENGALURU,CHENNAI,61468,63882,BENGALURU-CHENNAI,125350,All
2025,2,BENGALURU,CHENNAI,54317,55430,BENGALURU-CHENNAI,109747,All
2025,3,BENGALURU,CHENNAI,65189,67352,BENGALURU-CHENNAI,132541,All
2024,1,BENGALURU,COIMBATORE,9083,10012,BENGALURU-COIMBATORE,19095,All
2024,2,BENGALURU,COIMBATORE,8591,8454,BENGALURU-COIMBATORE,17045,All
2024,3,BENGALURU,COIMBATORE,10219,10263,BENGALURU-COIMBATORE,20482,All
2024,4,BENGALURU,COIMBATORE,12571,13298,BENGALURU-COIMBATORE,25869,All
2024,6,BENGALURU,COIMBATORE,15559,16542,BENGALURU-COIMBATORE,32101,All
2024,7,BENGALURU,COIMBATORE,13768,14065,BENGALURU-COIMBATORE,27833,All
2024,8,BENGALURU,COIMBATORE,15046,16049,BENGALURU-COIMBATORE,31095,All
2024,9,BENGALURU,COIMBATORE,14334,15472,BENGALURU-COIMBATORE,29806,All
2024,10,BENGALURU,COIMBATORE,14997,12892,BENGALURU-COIMBATORE,27889,All
2024,11,BENGALURU,COIMBATORE,13893,16051,BENGALURU-COIMBATORE,29944,All
2024,12,BENGALURU,COIMBATORE,16913,14511,BENGALURU-COIMBATORE,31424,All
2025,1,BENGALURU,COIMBATORE,16506,16860,BENGALURU-COIMBATORE,33366,All
2025,2,BENGALURU,COIMBATORE,16380,16066,BENGALURU-COIMBATORE,32446,All
2025,3,BENGALURU,COIMBATORE,17441,18154,BENGALURU-COIMBATORE,35595,All
2024,1,BENGALURU,Cuddapah,406,532,BENGALURU-Cuddapah,938,All
2024,2,BENGALURU,Cuddapah,483,611,BENGALURU-Cuddapah,1094,All
2024,3,BENGALURU,Cuddapah,398,526,BENGALURU-Cuddapah,924,All
2024,4,BENGALURU,Cuddapah,448,478,BENGALURU-Cuddapah,926,All
2024,6,BENGALURU,Cuddapah,513,594,BENGALURU-Cuddapah,1107,All
2024,7,BENGALURU,Cuddapah,426,580,BENGALURU-Cuddapah,1006,All
2024,8,BENGALURU,Cuddapah,543,596,BENGALURU-Cuddapah,1139,All
2024,9,BENGALURU,Cuddapah,401,546,BENGALURU-Cuddapah,947,All
2024,10,BENGALURU,Cuddapah,279,317,BENGALURU-Cuddapah,596,All
2024,1,BENGALURU,DABOLIM,46358,49166,BENGALURU-DABOLIM,95524,All
2024,2,BENGALURU,DABOLIM,42983,44592,BENGALURU-DABOLIM,87575,All
2024,3,BENGALURU,DABOLIM,41088,41633,BENGALURU-DABOLIM,82721,All
2024,4,BENGALURU,DABOLIM,43250,44275,BENGALURU-DABOLIM,87525,All
2024,6,BENGALURU,DABOLIM,35693,38389,BENGALURU-DABOLIM,74082,All
2024,7,BENGALURU,DABOLIM,33864,36460,BENGALURU-DABOLIM,70324,All
2024,8,BENGALURU,DABOLIM,43212,43169,BENGALURU-DABOLIM,86381,All
2024,9,BENGALURU,DABOLIM,50107,52167,BENGALURU-DABOLIM,102274,All
2024,10,BENGALURU,DABOLIM,54730,53416,BENGALURU-DABOLIM,108146,All
2024,11,BENGALURU,DABOLIM,50162,52481,BENGALURU-DABOLIM,102643,All
2024,12,BENGALURU,DABOLIM,62573,60309,BENGALURU-DABOLIM,122882,All
2025,1,BENGALURU,DABOLIM,55302,58352,BENGALURU-DABOLIM,113654,All
2025,2,BENGALURU,DABOLIM,50139,51306,BENGALURU-DABOLIM,101445,All
2025,3,BENGALURU,DABOLIM,52180,52985,BENGALURU-DABOLIM,105165,All
2024,1,BENGALURU,DARBHANGA,3613,3651,BENGALURU-DARBHANGA,7264,All
2024,2,BENGALURU,DARBHANGA,127,195,BENGALURU-DARBHANGA,322,All
2024,3,BENGALURU,DARBHANGA,288,244,BENGALURU-DARBHANGA,532,All
2024,4,BENGALURU,DARBHANGA,304,364,BENGALURU-DARBHANGA,668,All
2024,6,BENGALURU,DARBHANGA,621,574,BENGALURU-DARBHANGA,1195,All
2024,7,BENGALURU,DARBHANGA,399,387,BENGALURU-DARBHANGA,786,All
2024,8,BENGALURU,DARBHANGA,395,343,BENGALURU-DARBHANGA,738,All
2024,9,BENGALURU,DARBHANGA,373,265,BENGALURU-DARBHANGA,638,All
2024,10,BENGALURU,DARBHANGA,1470,585,BENGALURU-DARBHANGA,2055,All
2024,11,BENGALURU,DARBHANGA,3666,4612,BENGALURU-DARBHANGA,8278,All
2024,12,BENGALURU,DARBHANGA,4168,5085,BENGALURU-DARBHANGA,9253,All
2025,1,BENGALURU,DARBHANGA,1689,2505,BENGALURU-DARBHANGA,4194,All
2025,3,BENGALURU,DARBHANGA,5014,4277,BENGALURU-DARBHANGA,9291,All
2024,1,BENGALURU,DELHI,202724,201415,BENGALURU-DELHI,404139,All
2024,2,BENGALURU,DELHI,201616,195258,BENGALURU-DELHI,396874,All
2024,3,BENGALURU,DELHI,206370,197494,BENGALURU-DELHI,403864,All
2024,4,BENGALURU,DELHI,202807,197812,BENGALURU-DELHI,400619,All
2024,6,BENGALURU,DELHI,187355,201380,BENGALURU-DELHI,388735,All
2024,7,BENGALURU,DELHI,194677,201763,BENGALURU-DELHI,396440,All
2024,8,BENGALURU,DELHI,197396,195261,BENGALURU-DELHI,392657,All
2024,9,BENGALURU,DELHI,195132,188636,BENGALURU-DELHI,383768,All
2024,10,BENGALURU,DELHI,210278,174119,BENGALURU-DELHI,384397,All
2024,11,BENGALURU,DELHI,188317,209474,BENGALURU-DELHI,397791,All
2024,12,BENGALURU,DELHI,194427,202492,BENGALURU-DELHI,396919,All
2025,1,BENGALURU,DELHI,194935,192619,BENGALURU-DELHI,387554,All
2025,2,BENGALURU,DELHI,182478,179446,BENGALURU-DELHI,361924,All
2025,3,BENGALURU,DELHI,185461,189358,BENGALURU-DELHI,374819,All
2024,10,BENGALURU,DIBRUGARH,60,9,BENGALURU-DIBRUGARH,69,All
2024,11,BENGALURU,DIBRUGARH,322,436,BENGALURU-DIBRUGARH,758,All
2024,12,BENGALURU,DIBRUGARH,337,490,BENGALURU-DIBRUGARH,827,All
2025,3,BENGALURU,DIBRUGARH,522,415,BENGALURU-DIBRUGARH,937,All
2024,1,BENGALURU,DURGAPUR,4618,4610,BENGALURU-DURGAPUR,9228,All
2024,2,BENGALURU,DURGAPUR,4317,4346,BENGALURU-DURGAPUR,8663,All
2024,3,BENGALURU,DURGAPUR,4936,4687,BENGALURU-DURGAPUR,9623,All
2024,4,BENGALURU,DURGAPUR,4935,4817,BENGALURU-DURGAPUR,9752,All
2024,6,BENGALURU,DURGAPUR,5311,5418,BENGALURU-DURGAPUR,10729,All
2024,7,BENGALURU,DURGAPUR,4976,5884,BENGALURU-DURGAPUR,10860,All
2024,8,BENGALURU,DURGAPUR,4629,4908,BENGALURU-DURGAPUR,9537,All
2024,9,BENGALURU,DURGAPUR,4316,3492,BENGALURU-DURGAPUR,7808,All
2024,10,BENGALURU,DURGAPUR,5384,4271,BENGALURU-DURGAPUR,9655,All
2024,11,BENGALURU,DURGAPUR,4406,4929,BENGALURU-DURGAPUR,9335,All
2024,12,BENGALURU,DURGAPUR,5018,4842,BENGALURU-DURGAPUR,9860,All
2025,1,BENGALURU,DURGAPUR,4803,4925,BENGALURU-DURGAPUR,9728,All
2025,2,BENGALURU,DURGAPUR,3251,3131,BENGALURU-DURGAPUR,6382,All
2025,3,BENGALURU,DURGAPUR,4766,4245,BENGALURU-DURGAPUR,9011,All
2024,1,BENGALURU,DehraDun,3005,2929,BENGALURU-DehraDun,5934,All
2024,2,BENGALURU,DehraDun,3086,2959,BENGALURU-DehraDun,6045,All
2024,3,BENGALURU,DehraDun,6978,6008,BENGALURU-DehraDun,12986,All
2024,4,BENGALURU,DehraDun,8985,8772,BENGALURU-DehraDun,17757,All
2024,6,BENGALURU,DehraDun,9441,10492,BENGALURU-DehraDun,19933,All
2024,7,BENGALURU,DehraDun,8279,8149,BENGALURU-DehraDun,16428,All
2024,8,BENGALURU,DehraDun,8050,7214,BENGALURU-DehraDun,15264,All
2024,9,BENGALURU,DehraDun,9351,7557,BENGALURU-DehraDun,16908,All
2024,10,BENGALURU,DehraDun,10118,8294,BENGALURU-DehraDun,18412,All
2024,11,BENGALURU,DehraDun,7923,9802,BENGALURU-DehraDun,17725,All
2024,12,BENGALURU,DehraDun,9111,9780,BENGALURU-DehraDun,18891,All
2025,1,BENGALURU,DehraDun,8231,7338,BENGALURU-DehraDun,15569,All
2025,2,BENGALURU,DehraDun,9147,8081,BENGALURU-DehraDun,17228,All
2025,3,BENGALURU,DehraDun,8747,8022,BENGALURU-DehraDun,16769,All
2024,6,BENGALURU,Deoghar ,2166,2035,BENGALURU-Deoghar ,4201,All
2024,7,BENGALURU,Deoghar ,2170,2223,BENGALURU-Deoghar ,4393,All
2024,8,BENGALURU,Deoghar ,2291,2278,BENGALURU-Deoghar ,4569,All
2024,9,BENGALURU,Deoghar ,2029,1981,BENGALURU-Deoghar ,4010,All
2024,10,BENGALURU,Deoghar ,2929,2049,BENGALURU-Deoghar ,4978,All
2024,11,BENGALURU,Deoghar ,4629,5055,BENGALURU-Deoghar ,9684,All
2024,12,BENGALURU,Deoghar ,5258,5332,BENGALURU-Deoghar ,10590,All
2025,1,BENGALURU,Deoghar ,4823,5004,BENGALURU-Deoghar ,9827,All
2025,2,BENGALURU,Deoghar ,3392,3144,BENGALURU-Deoghar ,6536,All
2025,3,BENGALURU,Deoghar ,5061,4851,BENGALURU-Deoghar ,9912,All
2024,1,BENGALURU,GORAKHPUR,201,35,BENGALURU-GORAKHPUR,236,All
2024,2,BENGALURU,GORAKHPUR,178,0,BENGALURU-GORAKHPUR,178,All
2024,3,BENGALURU,GORAKHPUR,204,15,BENGALURU-GORAKHPUR,219,All
2024,4,BENGALURU,GORAKHPUR,617,1059,BENGALURU-GORAKHPUR,1676,All
2024,6,BENGALURU,GORAKHPUR,4429,4583,BENGALURU-GORAKHPUR,9012,All
2024,7,BENGALURU,GORAKHPUR,3766,4084,BENGALURU-GORAKHPUR,7850,All
2024,8,BENGALURU,GORAKHPUR,3953,4216,BENGALURU-GORAKHPUR,8169,All
2024,9,BENGALURU,GORAKHPUR,5004,4997,BENGALURU-GORAKHPUR,10001,All
2024,10,BENGALURU,GORAKHPUR,5343,4381,BENGALURU-GORAKHPUR,9724,All
2024,11,BENGALURU,GORAKHPUR,5476,5497,BENGALURU-GORAKHPUR,10973,All
2024,12,BENGALURU,GORAKHPUR,7352,7605,BENGALURU-GORAKHPUR,14957,All
2025,1,BENGALURU,GORAKHPUR,10281,10649,BENGALURU-GORAKHPUR,20930,All
2025,2,BENGALURU,GORAKHPUR,9714,9693,BENGALURU-GORAKHPUR,19407,All
2025,3,BENGALURU,GORAKHPUR,10928,10651,BENGALURU-GORAKHPUR,21579,All
2024,1,BENGALURU,GUWAHATI,34368,32741,BENGALURU-GUWAHATI,67109,All
2024,2,BENGALURU,GUWAHATI,27528,26186,BENGALURU-GUWAHATI,53714,All
2024,3,BENGALURU,GUWAHATI,31729,25745,BENGALURU-GUWAHATI,57474,All
2024,4,BENGALURU,GUWAHATI,36787,29419,BENGALURU-GUWAHATI,66206,All
2024,6,BENGALURU,GUWAHATI,33238,34336,BENGALURU-GUWAHATI,67574,All
2024,7,BENGALURU,GUWAHATI,29570,28730,BENGALURU-GUWAHATI,58300,All
2024,8,BENGALURU,GUWAHATI,24363,21809,BENGALURU-GUWAHATI,46172,All
2024,9,BENGALURU,GUWAHATI,28768,26131,BENGALURU-GUWAHATI,54899,All
2024,10,BENGALURU,GUWAHATI,37045,30401,BENGALURU-GUWAHATI,67446,All
2024,11,BENGALURU,GUWAHATI,37103,31975,BENGALURU-GUWAHATI,69078,All
2024,12,BENGALURU,GUWAHATI,38627,34044,BENGALURU-GUWAHATI,72671,All
2025,1,BENGALURU,GUWAHATI,34174,30889,BENGALURU-GUWAHATI,65063,All
2025,2,BENGALURU,GUWAHATI,34490,30693,BENGALURU-GUWAHATI,65183,All
2025,3,BENGALURU,GUWAHATI,39010,34327,BENGALURU-GUWAHATI,73337,All
2024,1,BENGALURU,GWALIOR,993,2160,BENGALURU-GWALIOR,3153,All
2024,2,BENGALURU,GWALIOR,4340,4410,BENGALURU-GWALIOR,8750,All
2024,3,BENGALURU,GWALIOR,4598,4389,BENGALURU-GWALIOR,8987,All
2024,4,BENGALURU,GWALIOR,4735,4441,BENGALURU-GWALIOR,9176,All
2024,6,BENGALURU,GWALIOR,4274,4666,BENGALURU-GWALIOR,8940,All
2024,7,BENGALURU,GWALIOR,3018,2990,BENGALURU-GWALIOR,6008,All
2024,8,BENGALURU,GWALIOR,4372,4343,BENGALURU-GWALIOR,8715,All
2024,9,BENGALURU,GWALIOR,4239,3678,BENGALURU-GWALIOR,7917,All
2024,10,BENGALURU,GWALIOR,4713,2913,BENGALURU-GWALIOR,7626,All
2024,11,BENGALURU,GWALIOR,2396,3094,BENGALURU-GWALIOR,5490,All
2024,12,BENGALURU,GWALIOR,4022,4774,BENGALURU-GWALIOR,8796,All
2025,1,BENGALURU,GWALIOR,2363,2573,BENGALURU-GWALIOR,4936,All
2025,2,BENGALURU,GWALIOR,4628,4197,BENGALURU-GWALIOR,8825,All
2025,3,BENGALURU,GWALIOR,4196,3792,BENGALURU-GWALIOR,7988,All
2024,1,BENGALURU,Goa,26963,30530,BENGALURU-Goa,57493,All
2024,2,BENGALURU,Goa,25351,25041,BENGALURU-Goa,50392,All
2024,3,BENGALURU,Goa,26169,25109,BENGALURU-Goa,51278,All
2024,4,BENGALURU,Goa,29589,29757,BENGALURU-Goa,59346,All
2024,6,BENGALURU,Goa,29978,30183,BENGALURU-Goa,60161,All
2024,7,BENGALURU,Goa,26153,25796,BENGALURU-Goa,51949,All
2024,8,BENGALURU,Goa,26956,25472,BENGALURU-Goa,52428,All
2024,9,BENGALURU,Goa,21842,21188,BENGALURU-Goa,43030,All
2024,10,BENGALURU,Goa,23600,22547,BENGALURU-Goa,46147,All
2024,11,BENGALURU,Goa,17712,18198,BENGALURU-Goa,35910,All
2024,12,BENGALURU,Goa,12904,12192,BENGALURU-Goa,25096,All
2025,1,BENGALURU,Goa,15423,15618,BENGALURU-Goa,31041,All
2025,2,BENGALURU,Goa,13071,13443,BENGALURU-Goa,26514,All
2025,3,BENGALURU,Goa,15938,16816,BENGALURU-Goa,32754,All
2025,3,BENGALURU,HINDON AIRPORT,7177,7351,BENGALURU-HINDON AIRPORT,14528,All
2024,1,BENGALURU,HUBLI,3943,4248,BENGALURU-HUBLI,8191,All
2024,2,BENGALURU,HUBLI,3791,3875,BENGALURU-HUBLI,7666,All
2024,3,BENGALURU,HUBLI,3803,3895,BENGALURU-HUBLI,7698,All
2024,4,BENGALURU,HUBLI,3891,4032,BENGALURU-HUBLI,7923,All
2024,6,BENGALURU,HUBLI,3868,4037,BENGALURU-HUBLI,7905,All
2024,7,BENGALURU,HUBLI,3723,3894,BENGALURU-HUBLI,7617,All
2024,8,BENGALURU,HUBLI,3866,3784,BENGALURU-HUBLI,7650,All
2024,9,BENGALURU,HUBLI,3843,3513,BENGALURU-HUBLI,7356,All
2024,10,BENGALURU,HUBLI,3999,3842,BENGALURU-HUBLI,7841,All
2024,11,BENGALURU,HUBLI,4032,4135,BENGALURU-HUBLI,8167,All
2024,12,BENGALURU,HUBLI,4215,4130,BENGALURU-HUBLI,8345,All
2025,1,BENGALURU,HUBLI,3906,4101,BENGALURU-HUBLI,8007,All
2025,2,BENGALURU,HUBLI,3165,3271,BENGALURU-HUBLI,6436,All
2025,3,BENGALURU,HUBLI,3906,3978,BENGALURU-HUBLI,7884,All
2024,1,BENGALURU,HYDERABAD,88636,92409,BENGALURU-HYDERABAD,181045,All
2024,2,BENGALURU,HYDERABAD,89404,90781,BENGALURU-HYDERABAD,180185,All
2024,3,BENGALURU,HYDERABAD,92431,90281,BENGALURU-HYDERABAD,182712,All
2024,4,BENGALURU,HYDERABAD,100190,97164,BENGALURU-HYDERABAD,197354,All
2024,6,BENGALURU,HYDERABAD,92263,87964,BENGALURU-HYDERABAD,180227,All
2024,7,BENGALURU,HYDERABAD,91988,91704,BENGALURU-HYDERABAD,183692,All
2024,8,BENGALURU,HYDERABAD,97638,97547,BENGALURU-HYDERABAD,195185,All
2024,9,BENGALURU,HYDERABAD,93420,91911,BENGALURU-HYDERABAD,185331,All
2024,10,BENGALURU,HYDERABAD,96543,89388,BENGALURU-HYDERABAD,185931,All
2024,11,BENGALURU,HYDERABAD,91887,93016,BENGALURU-HYDERABAD,184903,All
2024,12,BENGALURU,HYDERABAD,103815,101828,BENGALURU-HYDERABAD,205643,All
2025,1,BENGALURU,HYDERABAD,96188,98008,BENGALURU-HYDERABAD,194196,All
2025,2,BENGALURU,HYDERABAD,93484,91552,BENGALURU-HYDERABAD,185036,All
2025,3,BENGALURU,HYDERABAD,104936,101042,BENGALURU-HYDERABAD,205978,All
2024,1,BENGALURU,IMPHAL,778,1497,BENGALURU-IMPHAL,2275,All
2024,2,BENGALURU,IMPHAL,925,1022,BENGALURU-IMPHAL,1947,All
2024,3,BENGALURU,IMPHAL,1215,836,BENGALURU-IMPHAL,2051,All
2024,4,BENGALURU,IMPHAL,943,567,BENGALURU-IMPHAL,1510,All
2024,6,BENGALURU,IMPHAL,1171,759,BENGALURU-IMPHAL,1930,All
2024,7,BENGALURU,IMPHAL,753,584,BENGALURU-IMPHAL,1337,All
2024,8,BENGALURU,IMPHAL,713,423,BENGALURU-IMPHAL,1136,All
2024,9,BENGALURU,IMPHAL,599,213,BENGALURU-IMPHAL,812,All
2024,10,BENGALURU,IMPHAL,1112,425,BENGALURU-IMPHAL,1537,All
2024,11,BENGALURU,IMPHAL,491,545,BENGALURU-IMPHAL,1036,All
2024,12,BENGALURU,IMPHAL,665,546,BENGALURU-IMPHAL,1211,All
2025,3,BENGALURU,IMPHAL,849,704,BENGALURU-IMPHAL,1553,All
2024,1,BENGALURU,INDORE,13722,14566,BENGALURU-INDORE,28288,All
2024,2,BENGALURU,INDORE,13147,13733,BENGALURU-INDORE,26880,All
2024,3,BENGALURU,INDORE,14442,15197,BENGALURU-INDORE,29639,All
2024,4,BENGALURU,INDORE,14224,13636,BENGALURU-INDORE,27860,All
2024,6,BENGALURU,INDORE,14063,14067,BENGALURU-INDORE,28130,All
2024,7,BENGALURU,INDORE,13064,13324,BENGALURU-INDORE,26388,All
2024,8,BENGALURU,INDORE,14326,14439,BENGALURU-INDORE,28765,All
2024,9,BENGALURU,INDORE,16133,16249,BENGALURU-INDORE,32382,All
2024,10,BENGALURU,INDORE,18351,14167,BENGALURU-INDORE,32518,All
2024,11,BENGALURU,INDORE,16359,18633,BENGALURU-INDORE,34992,All
2024,12,BENGALURU,INDORE,16853,17141,BENGALURU-INDORE,33994,All
2025,1,BENGALURU,INDORE,17797,18005,BENGALURU-INDORE,35802,All
2025,2,BENGALURU,INDORE,19200,18579,BENGALURU-INDORE,37779,All
2025,3,BENGALURU,INDORE,19873,19913,BENGALURU-INDORE,39786,All
2024,9,BENGALURU,JABALPUR,2881,2898,BENGALURU-JABALPUR,5779,All
2024,10,BENGALURU,JABALPUR,2801,2360,BENGALURU-JABALPUR,5161,All
2024,11,BENGALURU,JABALPUR,2636,2917,BENGALURU-JABALPUR,5553,All
2024,12,BENGALURU,JABALPUR,2809,2987,BENGALURU-JABALPUR,5796,All
2025,1,BENGALURU,JABALPUR,3237,3145,BENGALURU-JABALPUR,6382,All
2025,2,BENGALURU,JABALPUR,2614,2533,BENGALURU-JABALPUR,5147,All
2025,3,BENGALURU,JABALPUR,2916,2961,BENGALURU-JABALPUR,5877,All
2024,1,BENGALURU,JAIPUR,30206,29274,BENGALURU-JAIPUR,59480,All
2024,2,BENGALURU,JAIPUR,26747,25257,BENGALURU-JAIPUR,52004,All
2024,3,BENGALURU,JAIPUR,26450,24138,BENGALURU-JAIPUR,50588,All
2024,4,BENGALURU,JAIPUR,30387,27232,BENGALURU-JAIPUR,57619,All
2024,6,BENGALURU,JAIPUR,28408,28143,BENGALURU-JAIPUR,56551,All
2024,7,BENGALURU,JAIPUR,27985,27233,BENGALURU-JAIPUR,55218,All
2024,8,BENGALURU,JAIPUR,30173,28931,BENGALURU-JAIPUR,59104,All
2024,9,BENGALURU,JAIPUR,29523,27616,BENGALURU-JAIPUR,57139,All
2024,10,BENGALURU,JAIPUR,38989,29130,BENGALURU-JAIPUR,68119,All
2024,11,BENGALURU,JAIPUR,31654,33048,BENGALURU-JAIPUR,64702,All
2024,12,BENGALURU,JAIPUR,34917,36012,BENGALURU-JAIPUR,70929,All
2025,1,BENGALURU,JAIPUR,36579,35859,BENGALURU-JAIPUR,72438,All
2025,2,BENGALURU,JAIPUR,30378,30075,BENGALURU-JAIPUR,60453,All
2025,3,BENGALURU,JAIPUR,29929,29370,BENGALURU-JAIPUR,59299,All
2024,1,BENGALURU,JAMMU,768,871,BENGALURU-JAMMU,1639,All
2024,2,BENGALURU,JAMMU,961,590,BENGALURU-JAMMU,1551,All
2024,3,BENGALURU,JAMMU,1502,1187,BENGALURU-JAMMU,2689,All
2024,4,BENGALURU,JAMMU,873,1125,BENGALURU-JAMMU,1998,All
2024,6,BENGALURU,JAMMU,627,1076,BENGALURU-JAMMU,1703,All
2024,7,BENGALURU,JAMMU,601,738,BENGALURU-JAMMU,1339,All
2024,8,BENGALURU,JAMMU,685,601,BENGALURU-JAMMU,1286,All
2024,9,BENGALURU,JAMMU,1012,890,BENGALURU-JAMMU,1902,All
2024,10,BENGALURU,JAMMU,1390,1087,BENGALURU-JAMMU,2477,All
2024,11,BENGALURU,JAMMU,1864,1996,BENGALURU-JAMMU,3860,All
2024,12,BENGALURU,JAMMU,3623,3744,BENGALURU-JAMMU,7367,All
2025,1,BENGALURU,JAMMU,2404,2236,BENGALURU-JAMMU,4640,All
2025,2,BENGALURU,JAMMU,1525,1537,BENGALURU-JAMMU,3062,All
2025,3,BENGALURU,JAMMU,2196,2143,BENGALURU-JAMMU,4339,All
2024,1,BENGALURU,JAMNAGAR,1196,1135,BENGALURU-JAMNAGAR,2331,All
2024,2,BENGALURU,JAMNAGAR,1395,1280,BENGALURU-JAMNAGAR,2675,All
2024,3,BENGALURU,JAMNAGAR,1035,1066,BENGALURU-JAMNAGAR,2101,All
2024,4,BENGALURU,JAMNAGAR,1332,1212,BENGALURU-JAMNAGAR,2544,All
2024,6,BENGALURU,JAMNAGAR,1335,1239,BENGALURU-JAMNAGAR,2574,All
2024,7,BENGALURU,JAMNAGAR,1259,1235,BENGALURU-JAMNAGAR,2494,All
2024,8,BENGALURU,JAMNAGAR,1310,1217,BENGALURU-JAMNAGAR,2527,All
2024,9,BENGALURU,JAMNAGAR,1251,990,BENGALURU-JAMNAGAR,2241,All
2024,10,BENGALURU,JAMNAGAR,1407,1394,BENGALURU-JAMNAGAR,2801,All
2024,11,BENGALURU,JAMNAGAR,558,553,BENGALURU-JAMNAGAR,1111,All
2024,1,BENGALURU,JHARSUGUDA,4745,4868,BENGALURU-JHARSUGUDA,9613,All
2024,2,BENGALURU,JHARSUGUDA,4498,4472,BENGALURU-JHARSUGUDA,8970,All
2024,3,BENGALURU,JHARSUGUDA,4889,4643,BENGALURU-JHARSUGUDA,9532,All
2024,4,BENGALURU,JHARSUGUDA,5043,4318,BENGALURU-JHARSUGUDA,9361,All
2024,6,BENGALURU,JHARSUGUDA,4963,4962,BENGALURU-JHARSUGUDA,9925,All
2024,7,BENGALURU,JHARSUGUDA,4353,4977,BENGALURU-JHARSUGUDA,9330,All
2024,8,BENGALURU,JHARSUGUDA,4353,4742,BENGALURU-JHARSUGUDA,9095,All
2024,9,BENGALURU,JHARSUGUDA,4543,4448,BENGALURU-JHARSUGUDA,8991,All
2024,10,BENGALURU,JHARSUGUDA,5321,4520,BENGALURU-JHARSUGUDA,9841,All
2024,11,BENGALURU,JHARSUGUDA,4864,5177,BENGALURU-JHARSUGUDA,10041,All
2024,12,BENGALURU,JHARSUGUDA,4905,5064,BENGALURU-JHARSUGUDA,9969,All
2025,1,BENGALURU,JHARSUGUDA,5131,4995,BENGALURU-JHARSUGUDA,10126,All
2025,2,BENGALURU,JHARSUGUDA,3173,3183,BENGALURU-JHARSUGUDA,6356,All
2025,3,BENGALURU,JHARSUGUDA,4933,4748,BENGALURU-JHARSUGUDA,9681,All
2024,1,BENGALURU,JODHPUR,5319,5292,BENGALURU-JODHPUR,10611,All
2024,2,BENGALURU,JODHPUR,5092,4968,BENGALURU-JODHPUR,10060,All
2024,3,BENGALURU,JODHPUR,4952,4887,BENGALURU-JODHPUR,9839,All
2024,4,BENGALURU,JODHPUR,5222,4682,BENGALURU-JODHPUR,9904,All
2024,6,BENGALURU,JODHPUR,5042,4798,BENGALURU-JODHPUR,9840,All
2024,7,BENGALURU,JODHPUR,4630,4398,BENGALURU-JODHPUR,9028,All
2024,8,BENGALURU,JODHPUR,5505,4841,BENGALURU-JODHPUR,10346,All
2024,9,BENGALURU,JODHPUR,5202,5018,BENGALURU-JODHPUR,10220,All
2024,10,BENGALURU,JODHPUR,5503,4613,BENGALURU-JODHPUR,10116,All
2024,11,BENGALURU,JODHPUR,5232,5190,BENGALURU-JODHPUR,10422,All
2024,12,BENGALURU,JODHPUR,5984,5997,BENGALURU-JODHPUR,11981,All
2025,1,BENGALURU,JODHPUR,5426,5402,BENGALURU-JODHPUR,10828,All
2025,2,BENGALURU,JODHPUR,5575,5384,BENGALURU-JODHPUR,10959,All
2025,3,BENGALURU,JODHPUR,5581,5264,BENGALURU-JODHPUR,10845,All
2024,1,BENGALURU,KALABURAGI,2004,2110,BENGALURU-KALABURAGI,4114,All
2024,2,BENGALURU,KALABURAGI,1779,1674,BENGALURU-KALABURAGI,3453,All
2024,3,BENGALURU,KALABURAGI,1707,1602,BENGALURU-KALABURAGI,3309,All
2024,4,BENGALURU,KALABURAGI,895,897,BENGALURU-KALABURAGI,1792,All
2024,6,BENGALURU,KALABURAGI,1594,1603,BENGALURU-KALABURAGI,3197,All
2024,7,BENGALURU,KALABURAGI,1836,1970,BENGALURU-KALABURAGI,3806,All
2024,8,BENGALURU,KALABURAGI,1886,1954,BENGALURU-KALABURAGI,3840,All
2024,9,BENGALURU,KALABURAGI,1515,1402,BENGALURU-KALABURAGI,2917,All
2024,10,BENGALURU,KALABURAGI,1286,1113,BENGALURU-KALABURAGI,2399,All
2024,11,BENGALURU,KALABURAGI,479,476,BENGALURU-KALABURAGI,955,All
2024,12,BENGALURU,KALABURAGI,783,821,BENGALURU-KALABURAGI,1604,All
2025,1,BENGALURU,KALABURAGI,632,812,BENGALURU-KALABURAGI,1444,All
2025,2,BENGALURU,KALABURAGI,621,615,BENGALURU-KALABURAGI,1236,All
2025,3,BENGALURU,KALABURAGI,721,721,BENGALURU-KALABURAGI,1442,All
2024,1,BENGALURU,KANNUR,7763,7959,BENGALURU-KANNUR,15722,All
2024,2,BENGALURU,KANNUR,7562,7385,BENGALURU-KANNUR,14947,All
2024,3,BENGALURU,KANNUR,6732,6293,BENGALURU-KANNUR,13025,All
2024,4,BENGALURU,KANNUR,7172,6945,BENGALURU-KANNUR,14117,All
2024,6,BENGALURU,KANNUR,3718,3627,BENGALURU-KANNUR,7345,All
2024,7,BENGALURU,KANNUR,4256,3579,BENGALURU-KANNUR,7835,All
2024,8,BENGALURU,KANNUR,4116,3868,BENGALURU-KANNUR,7984,All
2024,9,BENGALURU,KANNUR,3837,3682,BENGALURU-KANNUR,7519,All
2024,10,BENGALURU,KANNUR,3364,3132,BENGALURU-KANNUR,6496,All
2024,11,BENGALURU,KANNUR,3228,3510,BENGALURU-KANNUR,6738,All
2024,12,BENGALURU,KANNUR,4245,3688,BENGALURU-KANNUR,7933,All
2025,1,BENGALURU,KANNUR,3978,4325,BENGALURU-KANNUR,8303,All
2025,2,BENGALURU,KANNUR,3096,2999,BENGALURU-KANNUR,6095,All
2025,3,BENGALURU,KANNUR,3765,3462,BENGALURU-KANNUR,7227,All
2024,1,BENGALURU,KANPUR,318,349,BENGALURU-KANPUR,667,All
2024,3,BENGALURU,KANPUR,843,680,BENGALURU-KANPUR,1523,All
2024,4,BENGALURU,KANPUR,2233,2088,BENGALURU-KANPUR,4321,All
2024,6,BENGALURU,KANPUR,2235,2196,BENGALURU-KANPUR,4431,All
2024,7,BENGALURU,KANPUR,2207,2199,BENGALURU-KANPUR,4406,All
2024,8,BENGALURU,KANPUR,2257,2324,BENGALURU-KANPUR,4581,All
2024,9,BENGALURU,KANPUR,2042,1880,BENGALURU-KANPUR,3922,All
2024,10,BENGALURU,KANPUR,2294,1733,BENGALURU-KANPUR,4027,All
2024,11,BENGALURU,KANPUR,2175,2219,BENGALURU-KANPUR,4394,All
2024,12,BENGALURU,KANPUR,2093,2215,BENGALURU-KANPUR,4308,All
2025,1,BENGALURU,KANPUR,2173,2225,BENGALURU-KANPUR,4398,All
2025,2,BENGALURU,KANPUR,2096,2071,BENGALURU-KANPUR,4167,All
2025,3,BENGALURU,KANPUR,2452,2257,BENGALURU-KANPUR,4709,All
2024,1,BENGALURU,KOCHI,57592,60406,BENGALURU-KOCHI,117998,All
2024,2,BENGALURU,KOCHI,50902,51689,BENGALURU-KOCHI,102591,All
2024,3,BENGALURU,KOCHI,58474,55998,BENGALURU-KOCHI,114472,All
2024,4,BENGALURU,KOCHI,71560,70860,BENGALURU-KOCHI,142420,All
2024,6,BENGALURU,KOCHI,57206,59350,BENGALURU-KOCHI,116556,All
2024,7,BENGALURU,KOCHI,59458,57164,BENGALURU-KOCHI,116622,All
2024,8,BENGALURU,KOCHI,63838,66344,BENGALURU-KOCHI,130182,All
2024,9,BENGALURU,KOCHI,70799,71511,BENGALURU-KOCHI,142310,All
2024,10,BENGALURU,KOCHI,68599,68574,BENGALURU-KOCHI,137173,All
2024,11,BENGALURU,KOCHI,62678,71060,BENGALURU-KOCHI,133738,All
2024,12,BENGALURU,KOCHI,62750,59598,BENGALURU-KOCHI,122348,All
2025,1,BENGALURU,KOCHI,57117,59807,BENGALURU-KOCHI,116924,All
2025,2,BENGALURU,KOCHI,42447,44251,BENGALURU-KOCHI,86698,All
2025,3,BENGALURU,KOCHI,55764,58113,BENGALURU-KOCHI,113877,All
2024,1,BENGALURU,KOLHAPUR,2944,3093,BENGALURU-KOLHAPUR,6037,All
2024,2,BENGALURU,KOLHAPUR,2882,2850,BENGALURU-KOLHAPUR,5732,All
2024,3,BENGALURU,KOLHAPUR,3184,2888,BENGALURU-KOLHAPUR,6072,All
2024,4,BENGALURU,KOLHAPUR,2910,2628,BENGALURU-KOLHAPUR,5538,All
2024,6,BENGALURU,KOLHAPUR,2481,2441,BENGALURU-KOLHAPUR,4922,All
2024,7,BENGALURU,KOLHAPUR,2016,2084,BENGALURU-KOLHAPUR,4100,All
2024,8,BENGALURU,KOLHAPUR,2031,1929,BENGALURU-KOLHAPUR,3960,All
2024,9,BENGALURU,KOLHAPUR,1985,1901,BENGALURU-KOLHAPUR,3886,All
2024,10,BENGALURU,KOLHAPUR,2127,2012,BENGALURU-KOLHAPUR,4139,All
2024,11,BENGALURU,KOLHAPUR,2113,2222,BENGALURU-KOLHAPUR,4335,All
2024,12,BENGALURU,KOLHAPUR,2253,2276,BENGALURU-KOLHAPUR,4529,All
2025,1,BENGALURU,KOLHAPUR,2082,2203,BENGALURU-KOLHAPUR,4285,All
2025,2,BENGALURU,KOLHAPUR,2022,2029,BENGALURU-KOLHAPUR,4051,All
2025,3,BENGALURU,KOLHAPUR,2292,1941,BENGALURU-KOLHAPUR,4233,All
2024,1,BENGALURU,KOLKATA,97699,94467,BENGALURU-KOLKATA,192166,All
2024,2,BENGALURU,KOLKATA,86009,81968,BENGALURU-KOLKATA,167977,All
2024,3,BENGALURU,KOLKATA,103143,89254,BENGALURU-KOLKATA,192397,All
2024,4,BENGALURU,KOLKATA,103477,89286,BENGALURU-KOLKATA,192763,All
2024,6,BENGALURU,KOLKATA,95922,92626,BENGALURU-KOLKATA,188548,All
2024,7,BENGALURU,KOLKATA,90629,97230,BENGALURU-KOLKATA,187859,All
2024,8,BENGALURU,KOLKATA,89605,93598,BENGALURU-KOLKATA,183203,All
2024,9,BENGALURU,KOLKATA,100303,91148,BENGALURU-KOLKATA,191451,All
2024,10,BENGALURU,KOLKATA,122296,98086,BENGALURU-KOLKATA,220382,All
2024,11,BENGALURU,KOLKATA,108705,111734,BENGALURU-KOLKATA,220439,All
2024,12,BENGALURU,KOLKATA,106293,104541,BENGALURU-KOLKATA,210834,All
2025,1,BENGALURU,KOLKATA,99123,97630,BENGALURU-KOLKATA,196753,All
2025,2,BENGALURU,KOLKATA,80547,76476,BENGALURU-KOLKATA,157023,All
2025,3,BENGALURU,KOLKATA,98985,90965,BENGALURU-KOLKATA,189950,All
2024,1,BENGALURU,KOZHIKODE,7673,9564,BENGALURU-KOZHIKODE,17237,All
2024,2,BENGALURU,KOZHIKODE,8780,9680,BENGALURU-KOZHIKODE,18460,All
2024,3,BENGALURU,KOZHIKODE,8536,9347,BENGALURU-KOZHIKODE,17883,All
2024,4,BENGALURU,KOZHIKODE,8845,9014,BENGALURU-KOZHIKODE,17859,All
2024,6,BENGALURU,KOZHIKODE,9086,10030,BENGALURU-KOZHIKODE,19116,All
2024,7,BENGALURU,KOZHIKODE,10486,10321,BENGALURU-KOZHIKODE,20807,All
2024,8,BENGALURU,KOZHIKODE,9928,9964,BENGALURU-KOZHIKODE,19892,All
2024,9,BENGALURU,KOZHIKODE,10385,10636,BENGALURU-KOZHIKODE,21021,All
2024,10,BENGALURU,KOZHIKODE,9383,9307,BENGALURU-KOZHIKODE,18690,All
2024,11,BENGALURU,KOZHIKODE,7838,8981,BENGALURU-KOZHIKODE,16819,All
2024,12,BENGALURU,KOZHIKODE,8589,8369,BENGALURU-KOZHIKODE,16958,All
2025,1,BENGALURU,KOZHIKODE,7764,8270,BENGALURU-KOZHIKODE,16034,All
2025,2,BENGALURU,KOZHIKODE,8491,8842,BENGALURU-KOZHIKODE,17333,All
2025,3,BENGALURU,KOZHIKODE,10409,10423,BENGALURU-KOZHIKODE,20832,All
2024,1,BENGALURU,KURNOOL,405,590,BENGALURU-KURNOOL,995,All
2024,2,BENGALURU,KURNOOL,321,353,BENGALURU-KURNOOL,674,All
2024,3,BENGALURU,KURNOOL,380,405,BENGALURU-KURNOOL,785,All
2024,8,BENGALURU,KURNOOL,91,85,BENGALURU-KURNOOL,176,All
2024,9,BENGALURU,KURNOOL,173,175,BENGALURU-KURNOOL,348,All
2024,10,BENGALURU,KURNOOL,256,174,BENGALURU-KURNOOL,430,All
2024,11,BENGALURU,KURNOOL,147,213,BENGALURU-KURNOOL,360,All
2024,12,BENGALURU,KURNOOL,138,196,BENGALURU-KURNOOL,334,All
2025,1,BENGALURU,KURNOOL,189,197,BENGALURU-KURNOOL,386,All
2025,2,BENGALURU,KURNOOL,96,155,BENGALURU-KURNOOL,251,All
2025,3,BENGALURU,KURNOOL,175,181,BENGALURU-KURNOOL,356,All
2024,1,BENGALURU,LUCKNOW,32573,33966,BENGALURU-LUCKNOW,66539,All
2024,2,BENGALURU,LUCKNOW,30919,29128,BENGALURU-LUCKNOW,60047,All
2024,3,BENGALURU,LUCKNOW,34731,32492,BENGALURU-LUCKNOW,67223,All
2024,4,BENGALURU,LUCKNOW,35024,32685,BENGALURU-LUCKNOW,67709,All
2024,6,BENGALURU,LUCKNOW,28967,30722,BENGALURU-LUCKNOW,59689,All
2024,7,BENGALURU,LUCKNOW,27662,30891,BENGALURU-LUCKNOW,58553,All
2024,8,BENGALURU,LUCKNOW,26189,27513,BENGALURU-LUCKNOW,53702,All
2024,9,BENGALURU,LUCKNOW,25419,25683,BENGALURU-LUCKNOW,51102,All
2024,10,BENGALURU,LUCKNOW,33570,26092,BENGALURU-LUCKNOW,59662,All
2024,11,BENGALURU,LUCKNOW,33751,34523,BENGALURU-LUCKNOW,68274,All
2024,12,BENGALURU,LUCKNOW,29299,31387,BENGALURU-LUCKNOW,60686,All
2025,1,BENGALURU,LUCKNOW,33846,34222,BENGALURU-LUCKNOW,68068,All
2025,2,BENGALURU,LUCKNOW,36390,35724,BENGALURU-LUCKNOW,72114,All
2025,3,BENGALURU,LUCKNOW,29840,29887,BENGALURU-LUCKNOW,59727,All
2024,1,BENGALURU,MADURAI,7875,8563,BENGALURU-MADURAI,16438,All
2024,2,BENGALURU,MADURAI,7758,7474,BENGALURU-MADURAI,15232,All
2024,3,BENGALURU,MADURAI,7892,7637,BENGALURU-MADURAI,15529,All
2024,4,BENGALURU,MADURAI,8386,8306,BENGALURU-MADURAI,16692,All
2024,6,BENGALURU,MADURAI,10051,9891,BENGALURU-MADURAI,19942,All
2024,7,BENGALURU,MADURAI,10097,9915,BENGALURU-MADURAI,20012,All
2024,8,BENGALURU,MADURAI,9482,8822,BENGALURU-MADURAI,18304,All
2024,9,BENGALURU,MADURAI,10067,9803,BENGALURU-MADURAI,19870,All
2024,10,BENGALURU,MADURAI,9662,7653,BENGALURU-MADURAI,17315,All
2024,11,BENGALURU,MADURAI,6980,7498,BENGALURU-MADURAI,14478,All
2024,12,BENGALURU,MADURAI,8391,7507,BENGALURU-MADURAI,15898,All
2025,1,BENGALURU,MADURAI,8368,8505,BENGALURU-MADURAI,16873,All
2025,2,BENGALURU,MADURAI,5578,5667,BENGALURU-MADURAI,11245,All
2025,3,BENGALURU,MADURAI,7748,7333,BENGALURU-MADURAI,15081,All
2024,1,BENGALURU,MANGALORE,25564,27945,BENGALURU-MANGALORE,53509,All
2024,2,BENGALURU,MANGALORE,23339,24191,BENGALURU-MANGALORE,47530,All
2024,3,BENGALURU,MANGALORE,25399,26335,BENGALURU-MANGALORE,51734,All
2024,4,BENGALURU,MANGALORE,32738,29244,BENGALURU-MANGALORE,61982,All
2024,6,BENGALURU,MANGALORE,23469,24372,BENGALURU-MANGALORE,47841,All
2024,7,BENGALURU,MANGALORE,26134,23657,BENGALURU-MANGALORE,49791,All
2024,8,BENGALURU,MANGALORE,29426,30143,BENGALURU-MANGALORE,59569,All
2024,9,BENGALURU,MANGALORE,28152,28207,BENGALURU-MANGALORE,56359,All
2024,10,BENGALURU,MANGALORE,33398,32756,BENGALURU-MANGALORE,66154,All
2024,11,BENGALURU,MANGALORE,30120,30593,BENGALURU-MANGALORE,60713,All
2024,12,BENGALURU,MANGALORE,32340,30611,BENGALURU-MANGALORE,62951,All
2025,1,BENGALURU,MANGALORE,32710,33040,BENGALURU-MANGALORE,65750,All
2025,2,BENGALURU,MANGALORE,26653,26107,BENGALURU-MANGALORE,52760,All
2025,3,BENGALURU,MANGALORE,32744,33254,BENGALURU-MANGALORE,65998,All
2024,1,BENGALURU,MUMBAI,185646,193499,BENGALURU-MUMBAI,379145,All
2024,2,BENGALURU,MUMBAI,185132,182819,BENGALURU-MUMBAI,367951,All
2024,3,BENGALURU,MUMBAI,174332,172311,BENGALURU-MUMBAI,346643,All
2024,4,BENGALURU,MUMBAI,176021,178804,BENGALURU-MUMBAI,354825,All
2024,6,BENGALURU,MUMBAI,161808,168200,BENGALURU-MUMBAI,330008,All
2024,7,BENGALURU,MUMBAI,165896,175751,BENGALURU-MUMBAI,341647,All
2024,8,BENGALURU,MUMBAI,181664,176390,BENGALURU-MUMBAI,358054,All
2024,9,BENGALURU,MUMBAI,176527,171363,BENGALURU-MUMBAI,347890,All
2024,10,BENGALURU,MUMBAI,173522,170143,BENGALURU-MUMBAI,343665,All
2024,11,BENGALURU,MUMBAI,169509,179437,BENGALURU-MUMBAI,348946,All
2024,12,BENGALURU,MUMBAI,171109,177501,BENGALURU-MUMBAI,348610,All
2025,1,BENGALURU,MUMBAI,171397,176799,BENGALURU-MUMBAI,348196,All
2025,2,BENGALURU,MUMBAI,145266,146794,BENGALURU-MUMBAI,292060,All
2025,3,BENGALURU,MUMBAI,160854,161483,BENGALURU-MUMBAI,322337,All
2024,3,BENGALURU,Malvan,86,61,BENGALURU-Malvan,147,All
2024,4,BENGALURU,Malvan,147,145,BENGALURU-Malvan,292,All
2024,6,BENGALURU,Malvan,180,133,BENGALURU-Malvan,313,All
2024,7,BENGALURU,Malvan,43,35,BENGALURU-Malvan,78,All
2024,8,BENGALURU,Malvan,137,93,BENGALURU-Malvan,230,All
2024,9,BENGALURU,Malvan,193,136,BENGALURU-Malvan,329,All
2024,10,BENGALURU,Malvan,199,128,BENGALURU-Malvan,327,All
2024,11,BENGALURU,Malvan,26,37,BENGALURU-Malvan,63,All
2024,1,BENGALURU,NAGPUR,12053,12137,BENGALURU-NAGPUR,24190,All
2024,2,BENGALURU,NAGPUR,9125,9114,BENGALURU-NAGPUR,18239,All
2024,3,BENGALURU,NAGPUR,13542,13615,BENGALURU-NAGPUR,27157,All
2024,4,BENGALURU,NAGPUR,12080,11957,BENGALURU-NAGPUR,24037,All
2024,6,BENGALURU,NAGPUR,13738,14126,BENGALURU-NAGPUR,27864,All
2024,7,BENGALURU,NAGPUR,13926,14907,BENGALURU-NAGPUR,28833,All
2024,8,BENGALURU,NAGPUR,14959,15149,BENGALURU-NAGPUR,30108,All
2024,9,BENGALURU,NAGPUR,13736,14261,BENGALURU-NAGPUR,27997,All
2024,10,BENGALURU,NAGPUR,19695,12618,BENGALURU-NAGPUR,32313,All
2024,11,BENGALURU,NAGPUR,16392,19256,BENGALURU-NAGPUR,35648,All
2024,12,BENGALURU,NAGPUR,21625,21095,BENGALURU-NAGPUR,42720,All
2025,1,BENGALURU,NAGPUR,21600,22337,BENGALURU-NAGPUR,43937,All
2025,2,BENGALURU,NAGPUR,20230,19708,BENGALURU-NAGPUR,39938,All
2025,3,BENGALURU,NAGPUR,17450,17317,BENGALURU-NAGPUR,34767,All
2024,3,BENGALURU,NANDED,62,69,BENGALURU-NANDED,131,All
2024,4,BENGALURU,NANDED,1115,1134,BENGALURU-NANDED,2249,All
2024,6,BENGALURU,NANDED,1340,1237,BENGALURU-NANDED,2577,All
2024,7,BENGALURU,NANDED,1098,1218,BENGALURU-NANDED,2316,All
2024,8,BENGALURU,NANDED,1110,1195,BENGALURU-NANDED,2305,All
2024,9,BENGALURU,NANDED,1106,1164,BENGALURU-NANDED,2270,All
2024,10,BENGALURU,NANDED,1498,1254,BENGALURU-NANDED,2752,All
2024,11,BENGALURU,NANDED,1121,1606,BENGALURU-NANDED,2727,All
2024,12,BENGALURU,NANDED,1976,1488,BENGALURU-NANDED,3464,All
2025,1,BENGALURU,NANDED,1448,1646,BENGALURU-NANDED,3094,All
2025,2,BENGALURU,NANDED,1712,1642,BENGALURU-NANDED,3354,All
2025,3,BENGALURU,NANDED,1732,1651,BENGALURU-NANDED,3383,All
2024,9,BENGALURU,NASIK,3763,4073,BENGALURU-NASIK,7836,All
2024,10,BENGALURU,NASIK,6100,5709,BENGALURU-NASIK,11809,All
2024,11,BENGALURU,NASIK,4760,4998,BENGALURU-NASIK,9758,All
2024,12,BENGALURU,NASIK,5128,5126,BENGALURU-NASIK,10254,All
2025,1,BENGALURU,NASIK,4825,5046,BENGALURU-NASIK,9871,All
2025,2,BENGALURU,NASIK,4218,4231,BENGALURU-NASIK,8449,All
2025,3,BENGALURU,NASIK,4722,4995,BENGALURU-NASIK,9717,All
2024,1,BENGALURU,PATNA,20101,20511,BENGALURU-PATNA,40612,All
2024,2,BENGALURU,PATNA,17128,16274,BENGALURU-PATNA,33402,All
2024,3,BENGALURU,PATNA,26563,23285,BENGALURU-PATNA,49848,All
2024,4,BENGALURU,PATNA,25902,23624,BENGALURU-PATNA,49526,All
2024,6,BENGALURU,PATNA,20756,20021,BENGALURU-PATNA,40777,All
2024,7,BENGALURU,PATNA,17775,18022,BENGALURU-PATNA,35797,All
2024,8,BENGALURU,PATNA,20289,20584,BENGALURU-PATNA,40873,All
2024,9,BENGALURU,PATNA,20285,18671,BENGALURU-PATNA,38956,All
2024,10,BENGALURU,PATNA,25871,16046,BENGALURU-PATNA,41917,All
2024,11,BENGALURU,PATNA,28336,28719,BENGALURU-PATNA,57055,All
2024,12,BENGALURU,PATNA,22481,22957,BENGALURU-PATNA,45438,All
2025,1,BENGALURU,PATNA,22859,23248,BENGALURU-PATNA,46107,All
2025,2,BENGALURU,PATNA,25588,24459,BENGALURU-PATNA,50047,All
2025,3,BENGALURU,PATNA,34783,32047,BENGALURU-PATNA,66830,All
2024,1,BENGALURU,PONDICHERRY,2054,2142,BENGALURU-PONDICHERRY,4196,All
2024,2,BENGALURU,PONDICHERRY,1637,1769,BENGALURU-PONDICHERRY,3406,All
2024,3,BENGALURU,PONDICHERRY,1159,1162,BENGALURU-PONDICHERRY,2321,All
2024,12,BENGALURU,PONDICHERRY,825,791,BENGALURU-PONDICHERRY,1616,All
2025,1,BENGALURU,PONDICHERRY,2103,2118,BENGALURU-PONDICHERRY,4221,All
2025,2,BENGALURU,PONDICHERRY,1825,1972,BENGALURU-PONDICHERRY,3797,All
2025,3,BENGALURU,PONDICHERRY,2105,2025,BENGALURU-PONDICHERRY,4130,All
2024,1,BENGALURU,PORT BLAIR,8952,9441,BENGALURU-PORT BLAIR,18393,All
2024,2,BENGALURU,PORT BLAIR,8743,9447,BENGALURU-PORT BLAIR,18190,All
2024,3,BENGALURU,PORT BLAIR,9717,9835,BENGALURU-PORT BLAIR,19552,All
2024,4,BENGALURU,PORT BLAIR,7996,8453,BENGALURU-PORT BLAIR,16449,All
2024,6,BENGALURU,PORT BLAIR,8930,7919,BENGALURU-PORT BLAIR,16849,All
2024,7,BENGALURU,PORT BLAIR,4340,3763,BENGALURU-PORT BLAIR,8103,All
2024,8,BENGALURU,PORT BLAIR,6055,5491,BENGALURU-PORT BLAIR,11546,All
2024,9,BENGALURU,PORT BLAIR,8662,7468,BENGALURU-PORT BLAIR,16130,All
2024,10,BENGALURU,PORT BLAIR,10281,8790,BENGALURU-PORT BLAIR,19071,All
2024,11,BENGALURU,PORT BLAIR,9213,10374,BENGALURU-PORT BLAIR,19587,All
2024,12,BENGALURU,PORT BLAIR,13881,12554,BENGALURU-PORT BLAIR,26435,All
2025,1,BENGALURU,PORT BLAIR,13864,15522,BENGALURU-PORT BLAIR,29386,All
2025,2,BENGALURU,PORT BLAIR,9867,10070,BENGALURU-PORT BLAIR,19937,All
2025,3,BENGALURU,PORT BLAIR,10815,11811,BENGALURU-PORT BLAIR,22626,All
2024,1,BENGALURU,PUNE,78547,80425,BENGALURU-PUNE,158972,All
2024,2,BENGALURU,PUNE,78466,77626,BENGALURU-PUNE,156092,All
2024,3,BENGALURU,PUNE,79286,79193,BENGALURU-PUNE,158479,All
2024,4,BENGALURU,PUNE,80466,80236,BENGALURU-PUNE,160702,All
2024,6,BENGALURU,PUNE,82652,81709,BENGALURU-PUNE,164361,All
2024,7,BENGALURU,PUNE,78135,82085,BENGALURU-PUNE,160220,All
2024,8,BENGALURU,PUNE,80701,83059,BENGALURU-PUNE,163760,All
2024,9,BENGALURU,PUNE,83060,83501,BENGALURU-PUNE,166561,All
2024,10,BENGALURU,PUNE,85876,82614,BENGALURU-PUNE,168490,All
2024,11,BENGALURU,PUNE,71294,71824,BENGALURU-PUNE,143118,All
2024,12,BENGALURU,PUNE,74399,73139,BENGALURU-PUNE,147538,All
2025,1,BENGALURU,PUNE,77990,76123,BENGALURU-PUNE,154113,All
2025,2,BENGALURU,PUNE,65898,63744,BENGALURU-PUNE,129642,All
2025,3,BENGALURU,PUNE,77626,74794,BENGALURU-PUNE,152420,All
2024,1,BENGALURU,RAIPUR,9562,9868,BENGALURU-RAIPUR,19430,All
2024,2,BENGALURU,RAIPUR,9390,9369,BENGALURU-RAIPUR,18759,All
2024,3,BENGALURU,RAIPUR,10324,9758,BENGALURU-RAIPUR,20082,All
2024,4,BENGALURU,RAIPUR,10811,9929,BENGALURU-RAIPUR,20740,All
2024,6,BENGALURU,RAIPUR,10726,10303,BENGALURU-RAIPUR,21029,All
2024,7,BENGALURU,RAIPUR,9511,9846,BENGALURU-RAIPUR,19357,All
2024,8,BENGALURU,RAIPUR,10344,10441,BENGALURU-RAIPUR,20785,All
2024,9,BENGALURU,RAIPUR,9767,9000,BENGALURU-RAIPUR,18767,All
2024,10,BENGALURU,RAIPUR,11115,8829,BENGALURU-RAIPUR,19944,All
2024,11,BENGALURU,RAIPUR,9922,11792,BENGALURU-RAIPUR,21714,All
2024,12,BENGALURU,RAIPUR,11732,11616,BENGALURU-RAIPUR,23348,All
2025,1,BENGALURU,RAIPUR,11217,11871,BENGALURU-RAIPUR,23088,All
2025,2,BENGALURU,RAIPUR,8731,8898,BENGALURU-RAIPUR,17629,All
2025,3,BENGALURU,RAIPUR,11328,11358,BENGALURU-RAIPUR,22686,All
2024,1,BENGALURU,RAJAHMUNDRY,4040,4463,BENGALURU-RAJAHMUNDRY,8503,All
2024,2,BENGALURU,RAJAHMUNDRY,3746,3730,BENGALURU-RAJAHMUNDRY,7476,All
2024,3,BENGALURU,RAJAHMUNDRY,3954,3870,BENGALURU-RAJAHMUNDRY,7824,All
2024,4,BENGALURU,RAJAHMUNDRY,3571,3932,BENGALURU-RAJAHMUNDRY,7503,All
2024,6,BENGALURU,RAJAHMUNDRY,3752,3759,BENGALURU-RAJAHMUNDRY,7511,All
2024,7,BENGALURU,RAJAHMUNDRY,3425,3768,BENGALURU-RAJAHMUNDRY,7193,All
2024,8,BENGALURU,RAJAHMUNDRY,3882,3966,BENGALURU-RAJAHMUNDRY,7848,All
2024,9,BENGALURU,RAJAHMUNDRY,3231,3417,BENGALURU-RAJAHMUNDRY,6648,All
2024,10,BENGALURU,RAJAHMUNDRY,3568,3130,BENGALURU-RAJAHMUNDRY,6698,All
2024,11,BENGALURU,RAJAHMUNDRY,3369,3691,BENGALURU-RAJAHMUNDRY,7060,All
2024,12,BENGALURU,RAJAHMUNDRY,3838,3659,BENGALURU-RAJAHMUNDRY,7497,All
2025,1,BENGALURU,RAJAHMUNDRY,3692,3908,BENGALURU-RAJAHMUNDRY,7600,All
2025,2,BENGALURU,RAJAHMUNDRY,2964,3143,BENGALURU-RAJAHMUNDRY,6107,All
2025,3,BENGALURU,RAJAHMUNDRY,3689,3574,BENGALURU-RAJAHMUNDRY,7263,All
2024,1,BENGALURU,RANCHI,17519,18653,BENGALURU-RANCHI,36172,All
2024,2,BENGALURU,RANCHI,18489,18216,BENGALURU-RANCHI,36705,All
2024,3,BENGALURU,RANCHI,20100,17112,BENGALURU-RANCHI,37212,All
2024,4,BENGALURU,RANCHI,19845,18360,BENGALURU-RANCHI,38205,All
2024,6,BENGALURU,RANCHI,19667,19255,BENGALURU-RANCHI,38922,All
2024,7,BENGALURU,RANCHI,18087,20101,BENGALURU-RANCHI,38188,All
2024,8,BENGALURU,RANCHI,17507,19328,BENGALURU-RANCHI,36835,All
2024,9,BENGALURU,RANCHI,17140,15251,BENGALURU-RANCHI,32391,All
2024,10,BENGALURU,RANCHI,20426,14822,BENGALURU-RANCHI,35248,All
2024,11,BENGALURU,RANCHI,19067,20633,BENGALURU-RANCHI,39700,All
2024,12,BENGALURU,RANCHI,20620,21177,BENGALURU-RANCHI,41797,All
2025,1,BENGALURU,RANCHI,20493,20402,BENGALURU-RANCHI,40895,All
2025,2,BENGALURU,RANCHI,19649,18678,BENGALURU-RANCHI,38327,All
2025,3,BENGALURU,RANCHI,23185,20976,BENGALURU-RANCHI,44161,All
2024,1,BENGALURU,Rajkot International Airport,2898,2909,BENGALURU-Rajkot International Airport,5807,All
2024,2,BENGALURU,Rajkot International Airport,2675,2581,BENGALURU-Rajkot International Airport,5256,All
2024,3,BENGALURU,Rajkot International Airport,4750,4533,BENGALURU-Rajkot International Airport,9283,All
2024,4,BENGALURU,Rajkot International Airport,4672,4285,BENGALURU-Rajkot International Airport,8957,All
2024,6,BENGALURU,Rajkot International Airport,4540,4425,BENGALURU-Rajkot International Airport,8965,All
2024,7,BENGALURU,Rajkot International Airport,4672,4462,BENGALURU-Rajkot International Airport,9134,All
2024,8,BENGALURU,Rajkot International Airport,4580,4316,BENGALURU-Rajkot International Airport,8896,All
2024,9,BENGALURU,Rajkot International Airport,4987,4360,BENGALURU-Rajkot International Airport,9347,All
2024,10,BENGALURU,Rajkot International Airport,4865,4501,BENGALURU-Rajkot International Airport,9366,All
2024,11,BENGALURU,Rajkot International Airport,4990,4920,BENGALURU-Rajkot International Airport,9910,All
2024,12,BENGALURU,Rajkot International Airport,5207,5148,BENGALURU-Rajkot International Airport,10355,All
2025,1,BENGALURU,Rajkot International Airport,5203,5418,BENGALURU-Rajkot International Airport,10621,All
2025,2,BENGALURU,Rajkot International Airport,4743,4737,BENGALURU-Rajkot International Airport,9480,All
2025,3,BENGALURU,Rajkot International Airport,4747,4673,BENGALURU-Rajkot International Airport,9420,All
2024,1,BENGALURU,SALEM,1080,1589,BENGALURU-SALEM,2669,All
2024,2,BENGALURU,SALEM,1484,1691,BENGALURU-SALEM,3175,All
2024,3,BENGALURU,SALEM,1588,1748,BENGALURU-SALEM,3336,All
2024,4,BENGALURU,SALEM,2043,1925,BENGALURU-SALEM,3968,All
2024,6,BENGALURU,SALEM,1968,2055,BENGALURU-SALEM,4023,All
2024,7,BENGALURU,SALEM,2000,2144,BENGALURU-SALEM,4144,All
2024,8,BENGALURU,SALEM,1919,2120,BENGALURU-SALEM,4039,All
2024,9,BENGALURU,SALEM,1814,2081,BENGALURU-SALEM,3895,All
2024,10,BENGALURU,SALEM,2041,2041,BENGALURU-SALEM,4082,All
2024,11,BENGALURU,SALEM,1571,1953,BENGALURU-SALEM,3524,All
2024,12,BENGALURU,SALEM,1733,1740,BENGALURU-SALEM,3473,All
2025,1,BENGALURU,SALEM,1828,2041,BENGALURU-SALEM,3869,All
2025,2,BENGALURU,SALEM,1025,1241,BENGALURU-SALEM,2266,All
2025,3,BENGALURU,SALEM,1725,2059,BENGALURU-SALEM,3784,All
2024,1,BENGALURU,SHIRDI,7547,7580,BENGALURU-SHIRDI,15127,All
2024,2,BENGALURU,SHIRDI,7205,6870,BENGALURU-SHIRDI,14075,All
2024,3,BENGALURU,SHIRDI,7605,7390,BENGALURU-SHIRDI,14995,All
2024,4,BENGALURU,SHIRDI,6733,6641,BENGALURU-SHIRDI,13374,All
2024,6,BENGALURU,SHIRDI,7171,6883,BENGALURU-SHIRDI,14054,All
2024,7,BENGALURU,SHIRDI,7738,7663,BENGALURU-SHIRDI,15401,All
2024,8,BENGALURU,SHIRDI,6687,6867,BENGALURU-SHIRDI,13554,All
2024,9,BENGALURU,SHIRDI,5527,5452,BENGALURU-SHIRDI,10979,All
2024,10,BENGALURU,SHIRDI,6488,5602,BENGALURU-SHIRDI,12090,All
2024,11,BENGALURU,SHIRDI,6225,7068,BENGALURU-SHIRDI,13293,All
2024,12,BENGALURU,SHIRDI,7102,7195,BENGALURU-SHIRDI,14297,All
2025,1,BENGALURU,SHIRDI,6629,6797,BENGALURU-SHIRDI,13426,All
2025,2,BENGALURU,SHIRDI,4115,4132,BENGALURU-SHIRDI,8247,All
2025,3,BENGALURU,SHIRDI,7386,7057,BENGALURU-SHIRDI,14443,All
2024,1,BENGALURU,SRINAGAR,1281,1538,BENGALURU-SRINAGAR,2819,All
2024,2,BENGALURU,SRINAGAR,1439,971,BENGALURU-SRINAGAR,2410,All
2024,3,BENGALURU,SRINAGAR,1550,1240,BENGALURU-SRINAGAR,2790,All
2024,4,BENGALURU,SRINAGAR,8268,8145,BENGALURU-SRINAGAR,16413,All
2024,6,BENGALURU,SRINAGAR,6885,7698,BENGALURU-SRINAGAR,14583,All
2024,7,BENGALURU,SRINAGAR,5495,6765,BENGALURU-SRINAGAR,12260,All
2024,8,BENGALURU,SRINAGAR,5040,5579,BENGALURU-SRINAGAR,10619,All
2024,9,BENGALURU,SRINAGAR,5516,5439,BENGALURU-SRINAGAR,10955,All
2024,10,BENGALURU,SRINAGAR,5339,5334,BENGALURU-SRINAGAR,10673,All
2024,11,BENGALURU,SRINAGAR,4547,5687,BENGALURU-SRINAGAR,10234,All
2024,12,BENGALURU,SRINAGAR,5704,6175,BENGALURU-SRINAGAR,11879,All
2025,1,BENGALURU,SRINAGAR,5958,6036,BENGALURU-SRINAGAR,11994,All
2025,2,BENGALURU,SRINAGAR,6123,5958,BENGALURU-SRINAGAR,12081,All
2025,3,BENGALURU,SRINAGAR,9276,8186,BENGALURU-SRINAGAR,17462,All
2024,1,BENGALURU,SURAT,10367,10536,BENGALURU-SURAT,20903,All
2024,2,BENGALURU,SURAT,10366,10370,BENGALURU-SURAT,20736,All
2024,3,BENGALURU,SURAT,10384,10145,BENGALURU-SURAT,20529,All
2024,4,BENGALURU,SURAT,10679,10528,BENGALURU-SURAT,21207,All
2024,6,BENGALURU,SURAT,11272,10790,BENGALURU-SURAT,22062,All
2024,7,BENGALURU,SURAT,11545,10929,BENGALURU-SURAT,22474,All
2024,8,BENGALURU,SURAT,11142,10610,BENGALURU-SURAT,21752,All
2024,9,BENGALURU,SURAT,11827,11149,BENGALURU-SURAT,22976,All
2024,10,BENGALURU,SURAT,11580,11143,BENGALURU-SURAT,22723,All
2024,11,BENGALURU,SURAT,10531,10688,BENGALURU-SURAT,21219,All
2024,12,BENGALURU,SURAT,10386,10481,BENGALURU-SURAT,20867,All
2025,1,BENGALURU,SURAT,14663,15358,BENGALURU-SURAT,30021,All
2025,2,BENGALURU,SURAT,12021,11908,BENGALURU-SURAT,23929,All
2025,3,BENGALURU,SURAT,13414,12917,BENGALURU-SURAT,26331,All
2024,1,BENGALURU,Shivamogga Airport,1354,1564,BENGALURU-Shivamogga Airport,2918,All
2024,2,BENGALURU,Shivamogga Airport,1576,1539,BENGALURU-Shivamogga Airport,3115,All
2024,3,BENGALURU,Shivamogga Airport,1428,1267,BENGALURU-Shivamogga Airport,2695,All
2024,4,BENGALURU,Shivamogga Airport,1580,1705,BENGALURU-Shivamogga Airport,3285,All
2024,6,BENGALURU,Shivamogga Airport,1010,958,BENGALURU-Shivamogga Airport,1968,All
2024,7,BENGALURU,Shivamogga Airport,1260,1287,BENGALURU-Shivamogga Airport,2547,All
2024,8,BENGALURU,Shivamogga Airport,1381,1249,BENGALURU-Shivamogga Airport,2630,All
2024,9,BENGALURU,Shivamogga Airport,1347,1436,BENGALURU-Shivamogga Airport,2783,All
2024,10,BENGALURU,Shivamogga Airport,1575,1408,BENGALURU-Shivamogga Airport,2983,All
2024,11,BENGALURU,Shivamogga Airport,1512,1557,BENGALURU-Shivamogga Airport,3069,All
2024,12,BENGALURU,Shivamogga Airport,1695,1535,BENGALURU-Shivamogga Airport,3230,All
2025,1,BENGALURU,Shivamogga Airport,1469,1622,BENGALURU-Shivamogga Airport,3091,All
2025,2,BENGALURU,Shivamogga Airport,936,1077,BENGALURU-Shivamogga Airport,2013,All
2025,3,BENGALURU,Shivamogga Airport,1603,1703,BENGALURU-Shivamogga Airport,3306,All
2024,1,BENGALURU,TIRUCHIRAPALLY,6035,6138,BENGALURU-TIRUCHIRAPALLY,12173,All
2024,2,BENGALURU,TIRUCHIRAPALLY,5457,5473,BENGALURU-TIRUCHIRAPALLY,10930,All
2024,3,BENGALURU,TIRUCHIRAPALLY,5718,5408,BENGALURU-TIRUCHIRAPALLY,11126,All
2024,4,BENGALURU,TIRUCHIRAPALLY,6470,6341,BENGALURU-TIRUCHIRAPALLY,12811,All
2024,6,BENGALURU,TIRUCHIRAPALLY,7211,6804,BENGALURU-TIRUCHIRAPALLY,14015,All
2024,7,BENGALURU,TIRUCHIRAPALLY,7193,7065,BENGALURU-TIRUCHIRAPALLY,14258,All
2024,8,BENGALURU,TIRUCHIRAPALLY,7248,7158,BENGALURU-TIRUCHIRAPALLY,14406,All
2024,9,BENGALURU,TIRUCHIRAPALLY,6479,6920,BENGALURU-TIRUCHIRAPALLY,13399,All
2024,10,BENGALURU,TIRUCHIRAPALLY,5645,4429,BENGALURU-TIRUCHIRAPALLY,10074,All
2024,11,BENGALURU,TIRUCHIRAPALLY,4632,5343,BENGALURU-TIRUCHIRAPALLY,9975,All
2024,12,BENGALURU,TIRUCHIRAPALLY,5935,5233,BENGALURU-TIRUCHIRAPALLY,11168,All
2025,1,BENGALURU,TIRUCHIRAPALLY,6135,5668,BENGALURU-TIRUCHIRAPALLY,11803,All
2025,2,BENGALURU,TIRUCHIRAPALLY,3987,4122,BENGALURU-TIRUCHIRAPALLY,8109,All
2025,3,BENGALURU,TIRUCHIRAPALLY,5485,5210,BENGALURU-TIRUCHIRAPALLY,10695,All
2024,1,BENGALURU,TIRUPATI,1948,2078,BENGALURU-TIRUPATI,4026,All
2024,2,BENGALURU,TIRUPATI,1972,1786,BENGALURU-TIRUPATI,3758,All
2024,3,BENGALURU,TIRUPATI,2140,1867,BENGALURU-TIRUPATI,4007,All
2024,4,BENGALURU,TIRUPATI,1945,1842,BENGALURU-TIRUPATI,3787,All
2024,6,BENGALURU,TIRUPATI,2035,1972,BENGALURU-TIRUPATI,4007,All
2024,7,BENGALURU,TIRUPATI,2134,2029,BENGALURU-TIRUPATI,4163,All
2024,8,BENGALURU,TIRUPATI,2097,2093,BENGALURU-TIRUPATI,4190,All
2024,9,BENGALURU,TIRUPATI,2001,1798,BENGALURU-TIRUPATI,3799,All
2024,10,BENGALURU,TIRUPATI,1926,1549,BENGALURU-TIRUPATI,3475,All
2024,11,BENGALURU,TIRUPATI,1758,1950,BENGALURU-TIRUPATI,3708,All
2024,12,BENGALURU,TIRUPATI,2142,2124,BENGALURU-TIRUPATI,4266,All
2025,1,BENGALURU,TIRUPATI,1960,2073,BENGALURU-TIRUPATI,4033,All
2025,2,BENGALURU,TIRUPATI,1453,1792,BENGALURU-TIRUPATI,3245,All
2025,3,BENGALURU,TIRUPATI,2169,2157,BENGALURU-TIRUPATI,4326,All
2024,1,BENGALURU,TRIVANDRUM,29573,34642,BENGALURU-TRIVANDRUM,64215,All
2024,2,BENGALURU,TRIVANDRUM,26360,28956,BENGALURU-TRIVANDRUM,55316,All
2024,3,BENGALURU,TRIVANDRUM,29341,29920,BENGALURU-TRIVANDRUM,59261,All
2024,4,BENGALURU,TRIVANDRUM,37831,38282,BENGALURU-TRIVANDRUM,76113,All
2024,6,BENGALURU,TRIVANDRUM,30726,32805,BENGALURU-TRIVANDRUM,63531,All
2024,7,BENGALURU,TRIVANDRUM,33216,32757,BENGALURU-TRIVANDRUM,65973,All
2024,8,BENGALURU,TRIVANDRUM,35423,36356,BENGALURU-TRIVANDRUM,71779,All
2024,9,BENGALURU,TRIVANDRUM,38821,39164,BENGALURU-TRIVANDRUM,77985,All
2024,10,BENGALURU,TRIVANDRUM,41046,39926,BENGALURU-TRIVANDRUM,80972,All
2024,11,BENGALURU,TRIVANDRUM,36790,42524,BENGALURU-TRIVANDRUM,79314,All
2024,12,BENGALURU,TRIVANDRUM,43761,42208,BENGALURU-TRIVANDRUM,85969,All
2025,1,BENGALURU,TRIVANDRUM,27716,28911,BENGALURU-TRIVANDRUM,56627,All
2025,2,BENGALURU,TRIVANDRUM,21743,22426,BENGALURU-TRIVANDRUM,44169,All
2025,3,BENGALURU,TRIVANDRUM,25571,26193,BENGALURU-TRIVANDRUM,51764,All
2024,1,BENGALURU,TUTICORIN,2227,2107,BENGALURU-TUTICORIN,4334,All
2024,2,BENGALURU,TUTICORIN,1918,1821,BENGALURU-TUTICORIN,3739,All
2024,3,BENGALURU,TUTICORIN,2018,1541,BENGALURU-TUTICORIN,3559,All
2024,4,BENGALURU,TUTICORIN,2263,1890,BENGALURU-TUTICORIN,4153,All
2024,6,BENGALURU,TUTICORIN,2690,2310,BENGALURU-TUTICORIN,5000,All
2024,7,BENGALURU,TUTICORIN,2775,2338,BENGALURU-TUTICORIN,5113,All
2024,8,BENGALURU,TUTICORIN,2442,2257,BENGALURU-TUTICORIN,4699,All
2024,9,BENGALURU,TUTICORIN,2334,2165,BENGALURU-TUTICORIN,4499,All
2024,10,BENGALURU,TUTICORIN,1885,1738,BENGALURU-TUTICORIN,3623,All
2024,11,BENGALURU,TUTICORIN,1514,1732,BENGALURU-TUTICORIN,3246,All
2024,12,BENGALURU,TUTICORIN,1929,1598,BENGALURU-TUTICORIN,3527,All
2025,1,BENGALURU,TUTICORIN,1963,1841,BENGALURU-TUTICORIN,3804,All
2025,2,BENGALURU,TUTICORIN,1145,1183,BENGALURU-TUTICORIN,2328,All
2025,3,BENGALURU,TUTICORIN,1929,1768,BENGALURU-TUTICORIN,3697,All
2024,1,BENGALURU,UDAIPUR,5480,5197,BENGALURU-UDAIPUR,10677,All
2024,2,BENGALURU,UDAIPUR,4805,4760,BENGALURU-UDAIPUR,9565,All
2024,3,BENGALURU,UDAIPUR,4986,4884,BENGALURU-UDAIPUR,9870,All
2024,4,BENGALURU,UDAIPUR,9532,8198,BENGALURU-UDAIPUR,17730,All
2024,6,BENGALURU,UDAIPUR,8371,8426,BENGALURU-UDAIPUR,16797,All
2024,7,BENGALURU,UDAIPUR,6529,6489,BENGALURU-UDAIPUR,13018,All
2024,8,BENGALURU,UDAIPUR,9092,9077,BENGALURU-UDAIPUR,18169,All
2024,9,BENGALURU,UDAIPUR,8709,8010,BENGALURU-UDAIPUR,16719,All
2024,10,BENGALURU,UDAIPUR,10062,8256,BENGALURU-UDAIPUR,18318,All
2024,11,BENGALURU,UDAIPUR,9729,9788,BENGALURU-UDAIPUR,19517,All
2024,12,BENGALURU,UDAIPUR,11333,11589,BENGALURU-UDAIPUR,22922,All
2025,1,BENGALURU,UDAIPUR,11475,11649,BENGALURU-UDAIPUR,23124,All
2025,2,BENGALURU,UDAIPUR,8584,8542,BENGALURU-UDAIPUR,17126,All
2025,3,BENGALURU,UDAIPUR,7125,6917,BENGALURU-UDAIPUR,14042,All
2024,1,BENGALURU,VADODARA,1910,1870,BENGALURU-VADODARA,3780,All
2024,2,BENGALURU,VADODARA,2133,2120,BENGALURU-VADODARA,4253,All
2024,3,BENGALURU,VADODARA,5135,5033,BENGALURU-VADODARA,10168,All
2024,4,BENGALURU,VADODARA,4798,4587,BENGALURU-VADODARA,9385,All
2024,6,BENGALURU,VADODARA,4815,4686,BENGALURU-VADODARA,9501,All
2024,7,BENGALURU,VADODARA,5069,4937,BENGALURU-VADODARA,10006,All
2024,8,BENGALURU,VADODARA,4812,4464,BENGALURU-VADODARA,9276,All
2024,9,BENGALURU,VADODARA,4748,4551,BENGALURU-VADODARA,9299,All
2024,10,BENGALURU,VADODARA,4729,4657,BENGALURU-VADODARA,9386,All
2024,11,BENGALURU,VADODARA,4886,4756,BENGALURU-VADODARA,9642,All
2024,12,BENGALURU,VADODARA,4791,4822,BENGALURU-VADODARA,9613,All
2025,1,BENGALURU,VADODARA,5015,4967,BENGALURU-VADODARA,9982,All
2025,2,BENGALURU,VADODARA,4616,4595,BENGALURU-VADODARA,9211,All
2025,3,BENGALURU,VADODARA,4757,4635,BENGALURU-VADODARA,9392,All
2024,1,BENGALURU,VARANASI,20582,20453,BENGALURU-VARANASI,41035,All
2024,2,BENGALURU,VARANASI,24743,23857,BENGALURU-VARANASI,48600,All
2024,3,BENGALURU,VARANASI,30259,28125,BENGALURU-VARANASI,58384,All
2024,4,BENGALURU,VARANASI,29900,27250,BENGALURU-VARANASI,57150,All
2024,6,BENGALURU,VARANASI,30608,32069,BENGALURU-VARANASI,62677,All
2024,7,BENGALURU,VARANASI,29398,31739,BENGALURU-VARANASI,61137,All
2024,8,BENGALURU,VARANASI,29853,31490,BENGALURU-VARANASI,61343,All
2024,9,BENGALURU,VARANASI,31928,31725,BENGALURU-VARANASI,63653,All
2024,10,BENGALURU,VARANASI,42539,28704,BENGALURU-VARANASI,71243,All
2024,11,BENGALURU,VARANASI,43231,45280,BENGALURU-VARANASI,88511,All
2024,12,BENGALURU,VARANASI,37882,40439,BENGALURU-VARANASI,78321,All
2025,1,BENGALURU,VARANASI,39857,38542,BENGALURU-VARANASI,78399,All
2025,2,BENGALURU,VARANASI,52974,52524,BENGALURU-VARANASI,105498,All
2025,3,BENGALURU,VARANASI,48169,48785,BENGALURU-VARANASI,96954,All
2024,1,BENGALURU,VIDYANAGAR,1497,1743,BENGALURU-VIDYANAGAR,3240,All
2024,2,BENGALURU,VIDYANAGAR,1296,1395,BENGALURU-VIDYANAGAR,2691,All
2024,3,BENGALURU,VIDYANAGAR,1342,1491,BENGALURU-VIDYANAGAR,2833,All
2024,4,BENGALURU,VIDYANAGAR,1063,1160,BENGALURU-VIDYANAGAR,2223,All
2024,6,BENGALURU,VIDYANAGAR,1382,1412,BENGALURU-VIDYANAGAR,2794,All
2024,7,BENGALURU,VIDYANAGAR,1230,1267,BENGALURU-VIDYANAGAR,2497,All
2024,8,BENGALURU,VIDYANAGAR,1227,1318,BENGALURU-VIDYANAGAR,2545,All
2024,9,BENGALURU,VIDYANAGAR,1090,1080,BENGALURU-VIDYANAGAR,2170,All
2024,10,BENGALURU,VIDYANAGAR,929,936,BENGALURU-VIDYANAGAR,1865,All
2024,11,BENGALURU,VIDYANAGAR,829,918,BENGALURU-VIDYANAGAR,1747,All
2024,12,BENGALURU,VIDYANAGAR,1019,994,BENGALURU-VIDYANAGAR,2013,All
2025,1,BENGALURU,VIDYANAGAR,662,782,BENGALURU-VIDYANAGAR,1444,All
2025,3,BENGALURU,VIDYANAGAR,564,566,BENGALURU-VIDYANAGAR,1130,All
2024,1,BENGALURU,VIJAYAWADA,10835,11485,BENGALURU-VIJAYAWADA,22320,All
2024,2,BENGALURU,VIJAYAWADA,10058,9970,BENGALURU-VIJAYAWADA,20028,All
2024,3,BENGALURU,VIJAYAWADA,10437,10381,BENGALURU-VIJAYAWADA,20818,All
2024,4,BENGALURU,VIJAYAWADA,10462,10630,BENGALURU-VIJAYAWADA,21092,All
2024,6,BENGALURU,VIJAYAWADA,12280,11457,BENGALURU-VIJAYAWADA,23737,All
2024,7,BENGALURU,VIJAYAWADA,11699,11762,BENGALURU-VIJAYAWADA,23461,All
2024,8,BENGALURU,VIJAYAWADA,12417,12772,BENGALURU-VIJAYAWADA,25189,All
2024,9,BENGALURU,VIJAYAWADA,12666,12365,BENGALURU-VIJAYAWADA,25031,All
2024,10,BENGALURU,VIJAYAWADA,14010,12264,BENGALURU-VIJAYAWADA,26274,All
2024,11,BENGALURU,VIJAYAWADA,12247,13214,BENGALURU-VIJAYAWADA,25461,All
2024,12,BENGALURU,VIJAYAWADA,13840,13738,BENGALURU-VIJAYAWADA,27578,All
2025,1,BENGALURU,VIJAYAWADA,14246,15696,BENGALURU-VIJAYAWADA,29942,All
2025,2,BENGALURU,VIJAYAWADA,11866,12191,BENGALURU-VIJAYAWADA,24057,All
2025,3,BENGALURU,VIJAYAWADA,13737,13637,BENGALURU-VIJAYAWADA,27374,All
2024,1,BENGALURU,VISAKHAPATNAM,19905,20830,BENGALURU-VISAKHAPATNAM,40735,All
2024,2,BENGALURU,VISAKHAPATNAM,19592,19476,BENGALURU-VISAKHAPATNAM,39068,All
2024,3,BENGALURU,VISAKHAPATNAM,24734,24073,BENGALURU-VISAKHAPATNAM,48807,All
2024,4,BENGALURU,VISAKHAPATNAM,25093,25045,BENGALURU-VISAKHAPATNAM,50138,All
2024,6,BENGALURU,VISAKHAPATNAM,22760,22399,BENGALURU-VISAKHAPATNAM,45159,All
2024,7,BENGALURU,VISAKHAPATNAM,20389,22973,BENGALURU-VISAKHAPATNAM,43362,All
2024,8,BENGALURU,VISAKHAPATNAM,24213,26134,BENGALURU-VISAKHAPATNAM,50347,All
2024,9,BENGALURU,VISAKHAPATNAM,21277,21201,BENGALURU-VISAKHAPATNAM,42478,All
2024,10,BENGALURU,VISAKHAPATNAM,25886,22605,BENGALURU-VISAKHAPATNAM,48491,All
2024,11,BENGALURU,VISAKHAPATNAM,16830,17878,BENGALURU-VISAKHAPATNAM,34708,All
2024,12,BENGALURU,VISAKHAPATNAM,20732,20268,BENGALURU-VISAKHAPATNAM,41000,All
2025,1,BENGALURU,VISAKHAPATNAM,19458,20777,BENGALURU-VISAKHAPATNAM,40235,All
2025,2,BENGALURU,VISAKHAPATNAM,17975,17358,BENGALURU-VISAKHAPATNAM,35333,All
2025,3,BENGALURU,VISAKHAPATNAM,20386,19948,BENGALURU-VISAKHAPATNAM,40334,All
2025,1,BHATINDA,CHANDIGARH,34,0,BHATINDA-CHANDIGARH,34,All
2024,1,BHATINDA,DELHI,553,603,BHATINDA-DELHI,1156,All
2024,2,BHATINDA,DELHI,941,931,BHATINDA-DELHI,1872,All
2024,3,BHATINDA,DELHI,971,1065,BHATINDA-DELHI,2036,All
2024,4,BHATINDA,DELHI,937,940,BHATINDA-DELHI,1877,All
2024,6,BHATINDA,DELHI,1226,1213,BHATINDA-DELHI,2439,All
2024,7,BHATINDA,DELHI,1240,1238,BHATINDA-DELHI,2478,All
2024,8,BHATINDA,DELHI,1330,1302,BHATINDA-DELHI,2632,All
2024,9,BHATINDA,DELHI,1205,1129,BHATINDA-DELHI,2334,All
2024,10,BHATINDA,DELHI,1078,1248,BHATINDA-DELHI,2326,All
2024,11,BHATINDA,DELHI,1279,1248,BHATINDA-DELHI,2527,All
2024,12,BHATINDA,DELHI,1243,1217,BHATINDA-DELHI,2460,All
2025,1,BHATINDA,DELHI,1114,1115,BHATINDA-DELHI,2229,All
2025,2,BHATINDA,DELHI,1120,1124,BHATINDA-DELHI,2244,All
2025,3,BHATINDA,DELHI,1095,1099,BHATINDA-DELHI,2194,All
2024,1,BHATINDA,GHAZIABAD,52,30,BHATINDA-GHAZIABAD,82,All
2024,2,BHATINDA,HINDON AIRPORT,22,20,BHATINDA-HINDON AIRPORT,42,All
2024,3,BHATINDA,HINDON AIRPORT,20,15,BHATINDA-HINDON AIRPORT,35,All
2024,4,BHATINDA,HINDON AIRPORT,14,21,BHATINDA-HINDON AIRPORT,35,All
2024,6,BHATINDA,HINDON AIRPORT,107,84,BHATINDA-HINDON AIRPORT,191,All
2024,7,BHATINDA,HINDON AIRPORT,65,53,BHATINDA-HINDON AIRPORT,118,All
2024,8,BHATINDA,HINDON AIRPORT,155,107,BHATINDA-HINDON AIRPORT,262,All
2024,9,BHATINDA,HINDON AIRPORT,118,97,BHATINDA-HINDON AIRPORT,215,All
2024,10,BHATINDA,HINDON AIRPORT,116,116,BHATINDA-HINDON AIRPORT,232,All
2024,11,BHATINDA,HINDON AIRPORT,77,84,BHATINDA-HINDON AIRPORT,161,All
2024,12,BHATINDA,HINDON AIRPORT,90,70,BHATINDA-HINDON AIRPORT,160,All
2025,1,BHATINDA,HINDON AIRPORT,102,100,BHATINDA-HINDON AIRPORT,202,All
2025,2,BHATINDA,HINDON AIRPORT,16,15,BHATINDA-HINDON AIRPORT,31,All
2025,3,BHATINDA,HINDON AIRPORT,39,32,BHATINDA-HINDON AIRPORT,71,All
2024,1,BHAVNAGAR,MUMBAI,2166,2088,BHAVNAGAR-MUMBAI,4254,All
2024,2,BHAVNAGAR,MUMBAI,1961,1962,BHAVNAGAR-MUMBAI,3923,All
2024,3,BHAVNAGAR,MUMBAI,1880,1819,BHAVNAGAR-MUMBAI,3699,All
2024,4,BHAVNAGAR,MUMBAI,1697,1704,BHAVNAGAR-MUMBAI,3401,All
2024,6,BHAVNAGAR,MUMBAI,783,857,BHAVNAGAR-MUMBAI,1640,All
2024,7,BHAVNAGAR,MUMBAI,1692,1924,BHAVNAGAR-MUMBAI,3616,All
2024,8,BHAVNAGAR,MUMBAI,1671,1613,BHAVNAGAR-MUMBAI,3284,All
2024,9,BHAVNAGAR,MUMBAI,1128,1016,BHAVNAGAR-MUMBAI,2144,All
2024,10,BHAVNAGAR,MUMBAI,1410,1615,BHAVNAGAR-MUMBAI,3025,All
2024,11,BHAVNAGAR,MUMBAI,1901,1820,BHAVNAGAR-MUMBAI,3721,All
2024,12,BHAVNAGAR,MUMBAI,1954,1987,BHAVNAGAR-MUMBAI,3941,All
2025,1,BHAVNAGAR,MUMBAI,1957,1875,BHAVNAGAR-MUMBAI,3832,All
2025,2,BHAVNAGAR,MUMBAI,1476,1524,BHAVNAGAR-MUMBAI,3000,All
2025,3,BHAVNAGAR,MUMBAI,1702,1648,BHAVNAGAR-MUMBAI,3350,All
2024,1,BHAVNAGAR,PUNE,2165,2088,BHAVNAGAR-PUNE,4253,All
2024,2,BHAVNAGAR,PUNE,1818,1657,BHAVNAGAR-PUNE,3475,All
2024,3,BHAVNAGAR,PUNE,1535,1538,BHAVNAGAR-PUNE,3073,All
2024,4,BHAVNAGAR,PUNE,1411,1331,BHAVNAGAR-PUNE,2742,All
2024,6,BHAVNAGAR,PUNE,608,618,BHAVNAGAR-PUNE,1226,All
2024,7,BHAVNAGAR,PUNE,1458,1422,BHAVNAGAR-PUNE,2880,All
2024,8,BHAVNAGAR,PUNE,1350,1406,BHAVNAGAR-PUNE,2756,All
2024,9,BHAVNAGAR,PUNE,800,908,BHAVNAGAR-PUNE,1708,All
2024,10,BHAVNAGAR,PUNE,1036,1320,BHAVNAGAR-PUNE,2356,All
2024,11,BHAVNAGAR,PUNE,1670,1660,BHAVNAGAR-PUNE,3330,All
2024,12,BHAVNAGAR,PUNE,1803,1840,BHAVNAGAR-PUNE,3643,All
2025,1,BHAVNAGAR,PUNE,1725,1638,BHAVNAGAR-PUNE,3363,All
2025,2,BHAVNAGAR,PUNE,1394,1336,BHAVNAGAR-PUNE,2730,All
2025,3,BHAVNAGAR,PUNE,1537,1377,BHAVNAGAR-PUNE,2914,All
2024,12,BHOPAL,DABOLIM,4363,4104,BHOPAL-DABOLIM,8467,All
2025,1,BHOPAL,DABOLIM,4524,4628,BHOPAL-DABOLIM,9152,All
2025,2,BHOPAL,DABOLIM,3882,4026,BHOPAL-DABOLIM,7908,All
2025,3,BHOPAL,DABOLIM,4089,4015,BHOPAL-DABOLIM,8104,All
2024,1,BHOPAL,DELHI,27621,26147,BHOPAL-DELHI,53768,All
2024,2,BHOPAL,DELHI,24607,24265,BHOPAL-DELHI,48872,All
2024,3,BHOPAL,DELHI,23966,25114,BHOPAL-DELHI,49080,All
2024,4,BHOPAL,DELHI,24082,24139,BHOPAL-DELHI,48221,All
2024,6,BHOPAL,DELHI,24312,27019,BHOPAL-DELHI,51331,All
2024,7,BHOPAL,DELHI,24862,25921,BHOPAL-DELHI,50783,All
2024,8,BHOPAL,DELHI,26097,26458,BHOPAL-DELHI,52555,All
2024,9,BHOPAL,DELHI,24787,24511,BHOPAL-DELHI,49298,All
2024,10,BHOPAL,DELHI,21575,24434,BHOPAL-DELHI,46009,All
2024,11,BHOPAL,DELHI,27691,26600,BHOPAL-DELHI,54291,All
2024,12,BHOPAL,DELHI,25448,26998,BHOPAL-DELHI,52446,All
2025,1,BHOPAL,DELHI,24713,23026,BHOPAL-DELHI,47739,All
2025,2,BHOPAL,DELHI,27471,25376,BHOPAL-DELHI,52847,All
2025,3,BHOPAL,DELHI,26828,27311,BHOPAL-DELHI,54139,All
2024,1,BHOPAL,GWALIOR,166,0,BHOPAL-GWALIOR,166,All
2024,1,BHOPAL,Goa,1165,1195,BHOPAL-Goa,2360,All
2024,2,BHOPAL,Goa,2186,2112,BHOPAL-Goa,4298,All
2024,3,BHOPAL,Goa,2091,2035,BHOPAL-Goa,4126,All
2024,1,BHOPAL,HYDERABAD,2211,2213,BHOPAL-HYDERABAD,4424,All
2024,2,BHOPAL,HYDERABAD,2032,2014,BHOPAL-HYDERABAD,4046,All
2024,3,BHOPAL,HYDERABAD,2071,2077,BHOPAL-HYDERABAD,4148,All
2024,4,BHOPAL,HYDERABAD,1984,2173,BHOPAL-HYDERABAD,4157,All
2024,6,BHOPAL,HYDERABAD,1765,1827,BHOPAL-HYDERABAD,3592,All
2024,7,BHOPAL,HYDERABAD,2162,1975,BHOPAL-HYDERABAD,4137,All
2024,8,BHOPAL,HYDERABAD,1986,1907,BHOPAL-HYDERABAD,3893,All
2024,9,BHOPAL,HYDERABAD,1941,1896,BHOPAL-HYDERABAD,3837,All
2024,10,BHOPAL,HYDERABAD,1965,2162,BHOPAL-HYDERABAD,4127,All
2024,11,BHOPAL,HYDERABAD,2236,2136,BHOPAL-HYDERABAD,4372,All
2024,12,BHOPAL,HYDERABAD,2294,2232,BHOPAL-HYDERABAD,4526,All
2025,1,BHOPAL,HYDERABAD,3652,3666,BHOPAL-HYDERABAD,7318,All
2025,2,BHOPAL,HYDERABAD,4040,4014,BHOPAL-HYDERABAD,8054,All
2025,3,BHOPAL,HYDERABAD,4145,4387,BHOPAL-HYDERABAD,8532,All
2024,2,BHOPAL,INDORE,0,115,BHOPAL-INDORE,115,All
2024,8,BHOPAL,INDORE,104,104,BHOPAL-INDORE,208,All
2025,3,BHOPAL,JABALPUR,498,811,BHOPAL-JABALPUR,1309,All
2024,1,BHOPAL,JAIPUR,2139,1925,BHOPAL-JAIPUR,4064,All
2024,2,BHOPAL,JAIPUR,1888,1753,BHOPAL-JAIPUR,3641,All
2024,3,BHOPAL,JAIPUR,1446,1503,BHOPAL-JAIPUR,2949,All
2024,4,BHOPAL,JAIPUR,1055,1117,BHOPAL-JAIPUR,2172,All
2024,6,BHOPAL,JAIPUR,1043,1207,BHOPAL-JAIPUR,2250,All
2024,7,BHOPAL,JAIPUR,955,1068,BHOPAL-JAIPUR,2023,All
2024,8,BHOPAL,JAIPUR,1176,1071,BHOPAL-JAIPUR,2247,All
2024,9,BHOPAL,JAIPUR,1201,1056,BHOPAL-JAIPUR,2257,All
2024,10,BHOPAL,JAIPUR,1077,940,BHOPAL-JAIPUR,2017,All
2024,11,BHOPAL,JAIPUR,1141,1067,BHOPAL-JAIPUR,2208,All
2024,12,BHOPAL,JAIPUR,1272,1277,BHOPAL-JAIPUR,2549,All
2025,1,BHOPAL,JAIPUR,1227,1261,BHOPAL-JAIPUR,2488,All
2025,2,BHOPAL,JAIPUR,1104,971,BHOPAL-JAIPUR,2075,All
2025,3,BHOPAL,JAIPUR,1049,912,BHOPAL-JAIPUR,1961,All
2025,3,BHOPAL,KANNUR,143,0,BHOPAL-KANNUR,143,All
2024,1,BHOPAL,KOCHI,260,358,BHOPAL-KOCHI,618,All
2024,2,BHOPAL,KOCHI,348,274,BHOPAL-KOCHI,622,All
2024,3,BHOPAL,KOCHI,600,382,BHOPAL-KOCHI,982,All
2024,1,BHOPAL,LUCKNOW,7,5,BHOPAL-LUCKNOW,12,All
2024,3,BHOPAL,LUCKNOW,72,78,BHOPAL-LUCKNOW,150,All
2024,4,BHOPAL,LUCKNOW,1216,1092,BHOPAL-LUCKNOW,2308,All
2024,6,BHOPAL,LUCKNOW,971,1205,BHOPAL-LUCKNOW,2176,All
2024,7,BHOPAL,LUCKNOW,1163,1134,BHOPAL-LUCKNOW,2297,All
2024,8,BHOPAL,LUCKNOW,1099,1187,BHOPAL-LUCKNOW,2286,All
2024,9,BHOPAL,LUCKNOW,1236,1165,BHOPAL-LUCKNOW,2401,All
2024,10,BHOPAL,LUCKNOW,1206,1018,BHOPAL-LUCKNOW,2224,All
2024,11,BHOPAL,LUCKNOW,1236,1263,BHOPAL-LUCKNOW,2499,All
2024,12,BHOPAL,LUCKNOW,1223,1366,BHOPAL-LUCKNOW,2589,All
2025,1,BHOPAL,LUCKNOW,1322,1301,BHOPAL-LUCKNOW,2623,All
2025,2,BHOPAL,LUCKNOW,1205,1208,BHOPAL-LUCKNOW,2413,All
2025,3,BHOPAL,LUCKNOW,1123,1107,BHOPAL-LUCKNOW,2230,All
2024,1,BHOPAL,MUMBAI,13911,13667,BHOPAL-MUMBAI,27578,All
2024,2,BHOPAL,MUMBAI,14831,14950,BHOPAL-MUMBAI,29781,All
2024,3,BHOPAL,MUMBAI,14294,14901,BHOPAL-MUMBAI,29195,All
2024,4,BHOPAL,MUMBAI,13637,15365,BHOPAL-MUMBAI,29002,All
2024,6,BHOPAL,MUMBAI,14992,14263,BHOPAL-MUMBAI,29255,All
2024,7,BHOPAL,MUMBAI,13837,13526,BHOPAL-MUMBAI,27363,All
2024,8,BHOPAL,MUMBAI,14880,13634,BHOPAL-MUMBAI,28514,All
2024,9,BHOPAL,MUMBAI,13190,13142,BHOPAL-MUMBAI,26332,All
2024,10,BHOPAL,MUMBAI,11832,15128,BHOPAL-MUMBAI,26960,All
2024,11,BHOPAL,MUMBAI,15956,13929,BHOPAL-MUMBAI,29885,All
2024,12,BHOPAL,MUMBAI,16532,14950,BHOPAL-MUMBAI,31482,All
2025,1,BHOPAL,MUMBAI,15082,15132,BHOPAL-MUMBAI,30214,All
2025,2,BHOPAL,MUMBAI,15092,15930,BHOPAL-MUMBAI,31022,All
2025,3,BHOPAL,MUMBAI,15028,15059,BHOPAL-MUMBAI,30087,All
2024,7,BHOPAL,NAGPUR,31,0,BHOPAL-NAGPUR,31,All
2024,10,BHOPAL,PUNE,317,713,BHOPAL-PUNE,1030,All
2024,11,BHOPAL,PUNE,5104,4536,BHOPAL-PUNE,9640,All
2024,12,BHOPAL,PUNE,5197,4789,BHOPAL-PUNE,9986,All
2025,1,BHOPAL,PUNE,4812,4778,BHOPAL-PUNE,9590,All
2025,2,BHOPAL,PUNE,4596,4788,BHOPAL-PUNE,9384,All
2025,3,BHOPAL,PUNE,4568,4961,BHOPAL-PUNE,9529,All
2024,1,BHOPAL,RAIPUR,2195,2218,BHOPAL-RAIPUR,4413,All
2024,2,BHOPAL,RAIPUR,1990,1946,BHOPAL-RAIPUR,3936,All
2024,3,BHOPAL,RAIPUR,2084,2088,BHOPAL-RAIPUR,4172,All
2024,4,BHOPAL,RAIPUR,1846,1892,BHOPAL-RAIPUR,3738,All
2024,6,BHOPAL,RAIPUR,1956,2000,BHOPAL-RAIPUR,3956,All
2024,7,BHOPAL,RAIPUR,1975,1977,BHOPAL-RAIPUR,3952,All
2024,8,BHOPAL,RAIPUR,1945,1935,BHOPAL-RAIPUR,3880,All
2024,9,BHOPAL,RAIPUR,1900,1942,BHOPAL-RAIPUR,3842,All
2024,10,BHOPAL,RAIPUR,1748,1809,BHOPAL-RAIPUR,3557,All
2024,11,BHOPAL,RAIPUR,1978,2071,BHOPAL-RAIPUR,4049,All
2024,12,BHOPAL,RAIPUR,2257,2196,BHOPAL-RAIPUR,4453,All
2025,1,BHOPAL,RAIPUR,2148,2195,BHOPAL-RAIPUR,4343,All
2025,2,BHOPAL,RAIPUR,1885,2026,BHOPAL-RAIPUR,3911,All
2025,3,BHOPAL,RAIPUR,1893,1959,BHOPAL-RAIPUR,3852,All
2024,11,BHOPAL,REWA,34,31,BHOPAL-REWA,65,All
2024,12,BHOPAL,REWA,82,96,BHOPAL-REWA,178,All
2025,1,BHOPAL,REWA,99,111,BHOPAL-REWA,210,All
2025,2,BHOPAL,REWA,75,94,BHOPAL-REWA,169,All
2025,3,BHOPAL,REWA,62,85,BHOPAL-REWA,147,All
2024,1,BHOPAL,UDAIPUR,513,489,BHOPAL-UDAIPUR,1002,All
2024,2,BHOPAL,UDAIPUR,818,822,BHOPAL-UDAIPUR,1640,All
2024,3,BHOPAL,UDAIPUR,757,775,BHOPAL-UDAIPUR,1532,All
2024,4,BHOPAL,UDAIPUR,713,710,BHOPAL-UDAIPUR,1423,All
2024,6,BHOPAL,UDAIPUR,558,526,BHOPAL-UDAIPUR,1084,All
2024,7,BHOPAL,UDAIPUR,708,850,BHOPAL-UDAIPUR,1558,All
2024,8,BHOPAL,UDAIPUR,912,789,BHOPAL-UDAIPUR,1701,All
2024,9,BHOPAL,UDAIPUR,705,714,BHOPAL-UDAIPUR,1419,All
2024,10,BHOPAL,UDAIPUR,796,915,BHOPAL-UDAIPUR,1711,All
2024,11,BHOPAL,UDAIPUR,930,960,BHOPAL-UDAIPUR,1890,All
2024,12,BHOPAL,UDAIPUR,929,925,BHOPAL-UDAIPUR,1854,All
2025,1,BHOPAL,UDAIPUR,946,911,BHOPAL-UDAIPUR,1857,All
2025,2,BHOPAL,UDAIPUR,805,879,BHOPAL-UDAIPUR,1684,All
2024,2,BHUBANESWAR,CHANDIGARH,144,120,BHUBANESWAR-CHANDIGARH,264,All
2024,3,BHUBANESWAR,CHANDIGARH,830,938,BHUBANESWAR-CHANDIGARH,1768,All
2024,4,BHUBANESWAR,CHANDIGARH,657,491,BHUBANESWAR-CHANDIGARH,1148,All
2024,6,BHUBANESWAR,CHANDIGARH,1146,742,BHUBANESWAR-CHANDIGARH,1888,All
2024,7,BHUBANESWAR,CHANDIGARH,1005,681,BHUBANESWAR-CHANDIGARH,1686,All
2024,8,BHUBANESWAR,CHANDIGARH,894,701,BHUBANESWAR-CHANDIGARH,1595,All
2024,9,BHUBANESWAR,CHANDIGARH,935,703,BHUBANESWAR-CHANDIGARH,1638,All
2024,10,BHUBANESWAR,CHANDIGARH,516,331,BHUBANESWAR-CHANDIGARH,847,All
2024,11,BHUBANESWAR,CHANDIGARH,397,593,BHUBANESWAR-CHANDIGARH,990,All
2024,12,BHUBANESWAR,CHANDIGARH,382,383,BHUBANESWAR-CHANDIGARH,765,All
2025,3,BHUBANESWAR,CHANDIGARH,607,588,BHUBANESWAR-CHANDIGARH,1195,All
2024,1,BHUBANESWAR,CHENNAI,9926,9133,BHUBANESWAR-CHENNAI,19059,All
2024,2,BHUBANESWAR,CHENNAI,8515,8941,BHUBANESWAR-CHENNAI,17456,All
2024,3,BHUBANESWAR,CHENNAI,8345,9172,BHUBANESWAR-CHENNAI,17517,All
2024,4,BHUBANESWAR,CHENNAI,7325,9401,BHUBANESWAR-CHENNAI,16726,All
2024,6,BHUBANESWAR,CHENNAI,8191,8086,BHUBANESWAR-CHENNAI,16277,All
2024,7,BHUBANESWAR,CHENNAI,6009,5392,BHUBANESWAR-CHENNAI,11401,All
2024,8,BHUBANESWAR,CHENNAI,10779,9626,BHUBANESWAR-CHENNAI,20405,All
2024,9,BHUBANESWAR,CHENNAI,9639,11527,BHUBANESWAR-CHENNAI,21166,All
2024,10,BHUBANESWAR,CHENNAI,11195,14552,BHUBANESWAR-CHENNAI,25747,All
2024,11,BHUBANESWAR,CHENNAI,10861,10824,BHUBANESWAR-CHENNAI,21685,All
2024,12,BHUBANESWAR,CHENNAI,11873,11686,BHUBANESWAR-CHENNAI,23559,All
2025,1,BHUBANESWAR,CHENNAI,13632,13435,BHUBANESWAR-CHENNAI,27067,All
2025,2,BHUBANESWAR,CHENNAI,11432,13641,BHUBANESWAR-CHENNAI,25073,All
2025,3,BHUBANESWAR,CHENNAI,12015,13716,BHUBANESWAR-CHENNAI,25731,All
2024,1,BHUBANESWAR,DELHI,48161,47695,BHUBANESWAR-DELHI,95856,All
2024,2,BHUBANESWAR,DELHI,49254,48071,BHUBANESWAR-DELHI,97325,All
2024,3,BHUBANESWAR,DELHI,51325,51180,BHUBANESWAR-DELHI,102505,All
2024,4,BHUBANESWAR,DELHI,46402,47169,BHUBANESWAR-DELHI,93571,All
2024,6,BHUBANESWAR,DELHI,44484,48199,BHUBANESWAR-DELHI,92683,All
2024,7,BHUBANESWAR,DELHI,39111,40905,BHUBANESWAR-DELHI,80016,All
2024,8,BHUBANESWAR,DELHI,44769,46498,BHUBANESWAR-DELHI,91267,All
2024,9,BHUBANESWAR,DELHI,43113,44641,BHUBANESWAR-DELHI,87754,All
2024,10,BHUBANESWAR,DELHI,46137,50646,BHUBANESWAR-DELHI,96783,All
2024,11,BHUBANESWAR,DELHI,46993,48869,BHUBANESWAR-DELHI,95862,All
2024,12,BHUBANESWAR,DELHI,49836,51798,BHUBANESWAR-DELHI,101634,All
2025,1,BHUBANESWAR,DELHI,48812,48712,BHUBANESWAR-DELHI,97524,All
2025,2,BHUBANESWAR,DELHI,48139,47509,BHUBANESWAR-DELHI,95648,All
2025,3,BHUBANESWAR,DELHI,49345,50661,BHUBANESWAR-DELHI,100006,All
2024,8,BHUBANESWAR,DURGAPUR,38,60,BHUBANESWAR-DURGAPUR,98,All
2024,9,BHUBANESWAR,DURGAPUR,807,879,BHUBANESWAR-DURGAPUR,1686,All
2024,10,BHUBANESWAR,DURGAPUR,857,617,BHUBANESWAR-DURGAPUR,1474,All
2024,11,BHUBANESWAR,DURGAPUR,744,1131,BHUBANESWAR-DURGAPUR,1875,All
2024,12,BHUBANESWAR,DURGAPUR,903,835,BHUBANESWAR-DURGAPUR,1738,All
2025,1,BHUBANESWAR,DURGAPUR,744,751,BHUBANESWAR-DURGAPUR,1495,All
2025,2,BHUBANESWAR,DURGAPUR,998,642,BHUBANESWAR-DURGAPUR,1640,All
2025,3,BHUBANESWAR,DURGAPUR,704,691,BHUBANESWAR-DURGAPUR,1395,All
2025,2,BHUBANESWAR,DehraDun,1019,1081,BHUBANESWAR-DehraDun,2100,All
2025,3,BHUBANESWAR,DehraDun,1392,1530,BHUBANESWAR-DehraDun,2922,All
2024,1,BHUBANESWAR,GUWAHATI,5135,5056,BHUBANESWAR-GUWAHATI,10191,All
2024,2,BHUBANESWAR,GUWAHATI,4536,4171,BHUBANESWAR-GUWAHATI,8707,All
2024,3,BHUBANESWAR,GUWAHATI,5139,4735,BHUBANESWAR-GUWAHATI,9874,All
2024,4,BHUBANESWAR,GUWAHATI,4219,3647,BHUBANESWAR-GUWAHATI,7866,All
2024,6,BHUBANESWAR,GUWAHATI,4125,3781,BHUBANESWAR-GUWAHATI,7906,All
2024,7,BHUBANESWAR,GUWAHATI,3987,3933,BHUBANESWAR-GUWAHATI,7920,All
2024,8,BHUBANESWAR,GUWAHATI,3640,3040,BHUBANESWAR-GUWAHATI,6680,All
2024,9,BHUBANESWAR,GUWAHATI,3099,2602,BHUBANESWAR-GUWAHATI,5701,All
2024,10,BHUBANESWAR,GUWAHATI,4875,4718,BHUBANESWAR-GUWAHATI,9593,All
2024,11,BHUBANESWAR,GUWAHATI,4850,4814,BHUBANESWAR-GUWAHATI,9664,All
2024,12,BHUBANESWAR,GUWAHATI,5139,5011,BHUBANESWAR-GUWAHATI,10150,All
2025,1,BHUBANESWAR,GUWAHATI,5178,5065,BHUBANESWAR-GUWAHATI,10243,All
2025,2,BHUBANESWAR,GUWAHATI,4062,3564,BHUBANESWAR-GUWAHATI,7626,All
2025,3,BHUBANESWAR,GUWAHATI,5396,5152,BHUBANESWAR-GUWAHATI,10548,All
2024,1,BHUBANESWAR,Goa,1564,1653,BHUBANESWAR-Goa,3217,All
2025,3,BHUBANESWAR,HINDON AIRPORT,293,227,BHUBANESWAR-HINDON AIRPORT,520,All
2024,1,BHUBANESWAR,HYDERABAD,13820,14315,BHUBANESWAR-HYDERABAD,28135,All
2024,2,BHUBANESWAR,HYDERABAD,12813,13039,BHUBANESWAR-HYDERABAD,25852,All
2024,3,BHUBANESWAR,HYDERABAD,13116,13917,BHUBANESWAR-HYDERABAD,27033,All
2024,4,BHUBANESWAR,HYDERABAD,13154,14040,BHUBANESWAR-HYDERABAD,27194,All
2024,6,BHUBANESWAR,HYDERABAD,13449,13930,BHUBANESWAR-HYDERABAD,27379,All
2024,7,BHUBANESWAR,HYDERABAD,14038,13878,BHUBANESWAR-HYDERABAD,27916,All
2024,8,BHUBANESWAR,HYDERABAD,17500,17087,BHUBANESWAR-HYDERABAD,34587,All
2024,9,BHUBANESWAR,HYDERABAD,17441,18935,BHUBANESWAR-HYDERABAD,36376,All
2024,10,BHUBANESWAR,HYDERABAD,20408,25260,BHUBANESWAR-HYDERABAD,45668,All
2024,11,BHUBANESWAR,HYDERABAD,24270,23510,BHUBANESWAR-HYDERABAD,47780,All
2024,12,BHUBANESWAR,HYDERABAD,27157,26958,BHUBANESWAR-HYDERABAD,54115,All
2025,1,BHUBANESWAR,HYDERABAD,26307,26457,BHUBANESWAR-HYDERABAD,52764,All
2025,2,BHUBANESWAR,HYDERABAD,21874,23285,BHUBANESWAR-HYDERABAD,45159,All
2025,3,BHUBANESWAR,HYDERABAD,23425,25060,BHUBANESWAR-HYDERABAD,48485,All
2024,6,BHUBANESWAR,IMPHAL,46,0,BHUBANESWAR-IMPHAL,46,All
2025,2,BHUBANESWAR,INDORE,2013,2160,BHUBANESWAR-INDORE,4173,All
2025,3,BHUBANESWAR,INDORE,2632,2687,BHUBANESWAR-INDORE,5319,All
2025,1,BHUBANESWAR,JAIPUR,2550,2484,BHUBANESWAR-JAIPUR,5034,All
2025,2,BHUBANESWAR,JAIPUR,2292,2323,BHUBANESWAR-JAIPUR,4615,All
2025,3,BHUBANESWAR,JAIPUR,2482,2539,BHUBANESWAR-JAIPUR,5021,All
2025,3,BHUBANESWAR,JAMMU,242,210,BHUBANESWAR-JAMMU,452,All
2024,1,BHUBANESWAR,JAMSHEDPUR,190,185,BHUBANESWAR-JAMSHEDPUR,375,All
2024,2,BHUBANESWAR,JAMSHEDPUR,181,208,BHUBANESWAR-JAMSHEDPUR,389,All
2024,3,BHUBANESWAR,JAMSHEDPUR,207,251,BHUBANESWAR-JAMSHEDPUR,458,All
2024,4,BHUBANESWAR,JAMSHEDPUR,145,168,BHUBANESWAR-JAMSHEDPUR,313,All
2024,6,BHUBANESWAR,JAMSHEDPUR,145,137,BHUBANESWAR-JAMSHEDPUR,282,All
2024,7,BHUBANESWAR,JAMSHEDPUR,134,177,BHUBANESWAR-JAMSHEDPUR,311,All
2024,8,BHUBANESWAR,JAMSHEDPUR,192,231,BHUBANESWAR-JAMSHEDPUR,423,All
2024,9,BHUBANESWAR,JAMSHEDPUR,151,198,BHUBANESWAR-JAMSHEDPUR,349,All
2024,10,BHUBANESWAR,JAMSHEDPUR,170,183,BHUBANESWAR-JAMSHEDPUR,353,All
2024,11,BHUBANESWAR,JAMSHEDPUR,166,215,BHUBANESWAR-JAMSHEDPUR,381,All
2024,12,BHUBANESWAR,JAMSHEDPUR,230,233,BHUBANESWAR-JAMSHEDPUR,463,All
2025,1,BHUBANESWAR,JAMSHEDPUR,142,160,BHUBANESWAR-JAMSHEDPUR,302,All
2025,2,BHUBANESWAR,JAMSHEDPUR,164,176,BHUBANESWAR-JAMSHEDPUR,340,All
2025,3,BHUBANESWAR,JAMSHEDPUR,183,215,BHUBANESWAR-JAMSHEDPUR,398,All
2024,1,BHUBANESWAR,JEYPORE,341,340,BHUBANESWAR-JEYPORE,681,All
2024,2,BHUBANESWAR,JEYPORE,293,314,BHUBANESWAR-JEYPORE,607,All
2024,3,BHUBANESWAR,JEYPORE,330,341,BHUBANESWAR-JEYPORE,671,All
2024,4,BHUBANESWAR,JEYPORE,311,331,BHUBANESWAR-JEYPORE,642,All
2024,6,BHUBANESWAR,JEYPORE,281,268,BHUBANESWAR-JEYPORE,549,All
2024,7,BHUBANESWAR,JEYPORE,232,223,BHUBANESWAR-JEYPORE,455,All
2024,8,BHUBANESWAR,JEYPORE,279,323,BHUBANESWAR-JEYPORE,602,All
2024,9,BHUBANESWAR,JEYPORE,349,372,BHUBANESWAR-JEYPORE,721,All
2024,10,BHUBANESWAR,JEYPORE,346,349,BHUBANESWAR-JEYPORE,695,All
2024,11,BHUBANESWAR,JEYPORE,375,372,BHUBANESWAR-JEYPORE,747,All
2024,12,BHUBANESWAR,JEYPORE,520,509,BHUBANESWAR-JEYPORE,1029,All
2025,1,BHUBANESWAR,JEYPORE,514,539,BHUBANESWAR-JEYPORE,1053,All
2025,2,BHUBANESWAR,JEYPORE,466,465,BHUBANESWAR-JEYPORE,931,All
2025,3,BHUBANESWAR,JEYPORE,518,521,BHUBANESWAR-JEYPORE,1039,All
2024,1,BHUBANESWAR,JHARSUGUDA,671,621,BHUBANESWAR-JHARSUGUDA,1292,All
2024,2,BHUBANESWAR,JHARSUGUDA,545,544,BHUBANESWAR-JHARSUGUDA,1089,All
2024,3,BHUBANESWAR,JHARSUGUDA,840,707,BHUBANESWAR-JHARSUGUDA,1547,All
2024,4,BHUBANESWAR,JHARSUGUDA,623,775,BHUBANESWAR-JHARSUGUDA,1398,All
2024,6,BHUBANESWAR,JHARSUGUDA,713,838,BHUBANESWAR-JHARSUGUDA,1551,All
2024,7,BHUBANESWAR,JHARSUGUDA,502,693,BHUBANESWAR-JHARSUGUDA,1195,All
2024,8,BHUBANESWAR,JHARSUGUDA,608,774,BHUBANESWAR-JHARSUGUDA,1382,All
2024,9,BHUBANESWAR,JHARSUGUDA,553,671,BHUBANESWAR-JHARSUGUDA,1224,All
2024,10,BHUBANESWAR,JHARSUGUDA,652,722,BHUBANESWAR-JHARSUGUDA,1374,All
2024,11,BHUBANESWAR,JHARSUGUDA,666,816,BHUBANESWAR-JHARSUGUDA,1482,All
2024,12,BHUBANESWAR,JHARSUGUDA,777,942,BHUBANESWAR-JHARSUGUDA,1719,All
2025,1,BHUBANESWAR,JHARSUGUDA,361,437,BHUBANESWAR-JHARSUGUDA,798,All
2025,2,BHUBANESWAR,JHARSUGUDA,436,523,BHUBANESWAR-JHARSUGUDA,959,All
2025,3,BHUBANESWAR,JHARSUGUDA,566,599,BHUBANESWAR-JHARSUGUDA,1165,All
2024,12,BHUBANESWAR,JODHPUR,60,58,BHUBANESWAR-JODHPUR,118,All
2024,3,BHUBANESWAR,KOCHI,30,0,BHUBANESWAR-KOCHI,30,All
2024,4,BHUBANESWAR,KOCHI,321,36,BHUBANESWAR-KOCHI,357,All
2024,6,BHUBANESWAR,KOCHI,494,63,BHUBANESWAR-KOCHI,557,All
2024,7,BHUBANESWAR,KOCHI,330,0,BHUBANESWAR-KOCHI,330,All
2024,8,BHUBANESWAR,KOCHI,269,0,BHUBANESWAR-KOCHI,269,All
2024,9,BHUBANESWAR,KOCHI,276,135,BHUBANESWAR-KOCHI,411,All
2024,10,BHUBANESWAR,KOCHI,225,113,BHUBANESWAR-KOCHI,338,All
2024,11,BHUBANESWAR,KOCHI,393,319,BHUBANESWAR-KOCHI,712,All
2024,12,BHUBANESWAR,KOCHI,371,305,BHUBANESWAR-KOCHI,676,All
2025,1,BHUBANESWAR,KOCHI,3851,3780,BHUBANESWAR-KOCHI,7631,All
2025,2,BHUBANESWAR,KOCHI,3727,3142,BHUBANESWAR-KOCHI,6869,All
2025,3,BHUBANESWAR,KOCHI,3232,2420,BHUBANESWAR-KOCHI,5652,All
2024,1,BHUBANESWAR,KOLKATA,24102,23692,BHUBANESWAR-KOLKATA,47794,All
2024,2,BHUBANESWAR,KOLKATA,21978,20804,BHUBANESWAR-KOLKATA,42782,All
2024,3,BHUBANESWAR,KOLKATA,24745,22921,BHUBANESWAR-KOLKATA,47666,All
2024,4,BHUBANESWAR,KOLKATA,26044,21444,BHUBANESWAR-KOLKATA,47488,All
2024,6,BHUBANESWAR,KOLKATA,24007,25429,BHUBANESWAR-KOLKATA,49436,All
2024,7,BHUBANESWAR,KOLKATA,22795,27129,BHUBANESWAR-KOLKATA,49924,All
2024,8,BHUBANESWAR,KOLKATA,23561,25688,BHUBANESWAR-KOLKATA,49249,All
2024,9,BHUBANESWAR,KOLKATA,23222,21609,BHUBANESWAR-KOLKATA,44831,All
2024,10,BHUBANESWAR,KOLKATA,25089,22213,BHUBANESWAR-KOLKATA,47302,All
2024,11,BHUBANESWAR,KOLKATA,20846,21481,BHUBANESWAR-KOLKATA,42327,All
2024,12,BHUBANESWAR,KOLKATA,22364,22802,BHUBANESWAR-KOLKATA,45166,All
2025,1,BHUBANESWAR,KOLKATA,26756,26845,BHUBANESWAR-KOLKATA,53601,All
2025,2,BHUBANESWAR,KOLKATA,22719,23320,BHUBANESWAR-KOLKATA,46039,All
2025,3,BHUBANESWAR,KOLKATA,25621,26026,BHUBANESWAR-KOLKATA,51647,All
2024,1,BHUBANESWAR,LUCKNOW,1548,1565,BHUBANESWAR-LUCKNOW,3113,All
2024,2,BHUBANESWAR,LUCKNOW,1341,1388,BHUBANESWAR-LUCKNOW,2729,All
2024,3,BHUBANESWAR,LUCKNOW,1398,1510,BHUBANESWAR-LUCKNOW,2908,All
2024,4,BHUBANESWAR,LUCKNOW,1581,1619,BHUBANESWAR-LUCKNOW,3200,All
2024,6,BHUBANESWAR,LUCKNOW,1343,1151,BHUBANESWAR-LUCKNOW,2494,All
2024,7,BHUBANESWAR,LUCKNOW,1106,1204,BHUBANESWAR-LUCKNOW,2310,All
2024,8,BHUBANESWAR,LUCKNOW,1242,1263,BHUBANESWAR-LUCKNOW,2505,All
2024,9,BHUBANESWAR,LUCKNOW,1715,1426,BHUBANESWAR-LUCKNOW,3141,All
2024,10,BHUBANESWAR,LUCKNOW,1481,1723,BHUBANESWAR-LUCKNOW,3204,All
2024,11,BHUBANESWAR,LUCKNOW,1135,1285,BHUBANESWAR-LUCKNOW,2420,All
2024,12,BHUBANESWAR,LUCKNOW,1865,1791,BHUBANESWAR-LUCKNOW,3656,All
2025,1,BHUBANESWAR,LUCKNOW,1736,1773,BHUBANESWAR-LUCKNOW,3509,All
2025,2,BHUBANESWAR,LUCKNOW,1851,1891,BHUBANESWAR-LUCKNOW,3742,All
2025,3,BHUBANESWAR,LUCKNOW,3697,3752,BHUBANESWAR-LUCKNOW,7449,All
2024,1,BHUBANESWAR,MUMBAI,24522,24798,BHUBANESWAR-MUMBAI,49320,All
2024,2,BHUBANESWAR,MUMBAI,24417,24836,BHUBANESWAR-MUMBAI,49253,All
2024,3,BHUBANESWAR,MUMBAI,26283,25765,BHUBANESWAR-MUMBAI,52048,All
2024,4,BHUBANESWAR,MUMBAI,21098,21952,BHUBANESWAR-MUMBAI,43050,All
2024,6,BHUBANESWAR,MUMBAI,22903,23307,BHUBANESWAR-MUMBAI,46210,All
2024,7,BHUBANESWAR,MUMBAI,22551,20768,BHUBANESWAR-MUMBAI,43319,All
2024,8,BHUBANESWAR,MUMBAI,24331,21681,BHUBANESWAR-MUMBAI,46012,All
2024,9,BHUBANESWAR,MUMBAI,24910,25179,BHUBANESWAR-MUMBAI,50089,All
2024,10,BHUBANESWAR,MUMBAI,22874,26709,BHUBANESWAR-MUMBAI,49583,All
2024,11,BHUBANESWAR,MUMBAI,25751,26088,BHUBANESWAR-MUMBAI,51839,All
2024,12,BHUBANESWAR,MUMBAI,27147,28146,BHUBANESWAR-MUMBAI,55293,All
2025,1,BHUBANESWAR,MUMBAI,27072,27715,BHUBANESWAR-MUMBAI,54787,All
2025,2,BHUBANESWAR,MUMBAI,23298,24765,BHUBANESWAR-MUMBAI,48063,All
2025,3,BHUBANESWAR,MUMBAI,23913,25152,BHUBANESWAR-MUMBAI,49065,All
2024,2,BHUBANESWAR,PATNA,1977,1920,BHUBANESWAR-PATNA,3897,All
2024,3,BHUBANESWAR,PATNA,4255,3878,BHUBANESWAR-PATNA,8133,All
2024,4,BHUBANESWAR,PATNA,4460,4006,BHUBANESWAR-PATNA,8466,All
2024,6,BHUBANESWAR,PATNA,3732,4000,BHUBANESWAR-PATNA,7732,All
2024,7,BHUBANESWAR,PATNA,3739,3965,BHUBANESWAR-PATNA,7704,All
2024,8,BHUBANESWAR,PATNA,4080,4057,BHUBANESWAR-PATNA,8137,All
2024,9,BHUBANESWAR,PATNA,3975,3868,BHUBANESWAR-PATNA,7843,All
2024,10,BHUBANESWAR,PATNA,4670,3927,BHUBANESWAR-PATNA,8597,All
2024,11,BHUBANESWAR,PATNA,4588,4513,BHUBANESWAR-PATNA,9101,All
2024,12,BHUBANESWAR,PATNA,1947,2057,BHUBANESWAR-PATNA,4004,All
2025,1,BHUBANESWAR,PATNA,2730,2536,BHUBANESWAR-PATNA,5266,All
2025,2,BHUBANESWAR,PATNA,8324,7789,BHUBANESWAR-PATNA,16113,All
2025,3,BHUBANESWAR,PATNA,8460,7736,BHUBANESWAR-PATNA,16196,All
2025,3,BHUBANESWAR,PORT BLAIR,251,317,BHUBANESWAR-PORT BLAIR,568,All
2024,1,BHUBANESWAR,PUNE,9041,9115,BHUBANESWAR-PUNE,18156,All
2024,2,BHUBANESWAR,PUNE,8557,8966,BHUBANESWAR-PUNE,17523,All
2024,3,BHUBANESWAR,PUNE,8733,9821,BHUBANESWAR-PUNE,18554,All
2024,4,BHUBANESWAR,PUNE,8121,8926,BHUBANESWAR-PUNE,17047,All
2024,6,BHUBANESWAR,PUNE,4908,4729,BHUBANESWAR-PUNE,9637,All
2024,7,BHUBANESWAR,PUNE,5048,4496,BHUBANESWAR-PUNE,9544,All
2024,8,BHUBANESWAR,PUNE,4887,4514,BHUBANESWAR-PUNE,9401,All
2024,9,BHUBANESWAR,PUNE,4346,4494,BHUBANESWAR-PUNE,8840,All
2024,10,BHUBANESWAR,PUNE,3987,4777,BHUBANESWAR-PUNE,8764,All
2024,11,BHUBANESWAR,PUNE,4065,4217,BHUBANESWAR-PUNE,8282,All
2024,12,BHUBANESWAR,PUNE,5141,4622,BHUBANESWAR-PUNE,9763,All
2025,1,BHUBANESWAR,PUNE,4938,4368,BHUBANESWAR-PUNE,9306,All
2025,2,BHUBANESWAR,PUNE,4605,3967,BHUBANESWAR-PUNE,8572,All
2025,3,BHUBANESWAR,PUNE,4800,3929,BHUBANESWAR-PUNE,8729,All
2024,1,BHUBANESWAR,RAIPUR,2062,1987,BHUBANESWAR-RAIPUR,4049,All
2024,2,BHUBANESWAR,RAIPUR,1772,1738,BHUBANESWAR-RAIPUR,3510,All
2024,3,BHUBANESWAR,RAIPUR,1998,2104,BHUBANESWAR-RAIPUR,4102,All
2024,4,BHUBANESWAR,RAIPUR,2588,2936,BHUBANESWAR-RAIPUR,5524,All
2024,6,BHUBANESWAR,RAIPUR,2851,3603,BHUBANESWAR-RAIPUR,6454,All
2024,7,BHUBANESWAR,RAIPUR,2864,3415,BHUBANESWAR-RAIPUR,6279,All
2024,8,BHUBANESWAR,RAIPUR,3053,3401,BHUBANESWAR-RAIPUR,6454,All
2024,9,BHUBANESWAR,RAIPUR,2884,3406,BHUBANESWAR-RAIPUR,6290,All
2024,10,BHUBANESWAR,RAIPUR,3219,3088,BHUBANESWAR-RAIPUR,6307,All
2024,11,BHUBANESWAR,RAIPUR,3529,3820,BHUBANESWAR-RAIPUR,7349,All
2024,12,BHUBANESWAR,RAIPUR,3354,3421,BHUBANESWAR-RAIPUR,6775,All
2025,1,BHUBANESWAR,RAIPUR,3466,3463,BHUBANESWAR-RAIPUR,6929,All
2025,2,BHUBANESWAR,RAIPUR,3746,3328,BHUBANESWAR-RAIPUR,7074,All
2025,3,BHUBANESWAR,RAIPUR,2989,3033,BHUBANESWAR-RAIPUR,6022,All
2024,1,BHUBANESWAR,RANCHI,1317,1295,BHUBANESWAR-RANCHI,2612,All
2024,2,BHUBANESWAR,RANCHI,1244,1432,BHUBANESWAR-RANCHI,2676,All
2024,3,BHUBANESWAR,RANCHI,1460,1461,BHUBANESWAR-RANCHI,2921,All
2024,4,BHUBANESWAR,RANCHI,869,788,BHUBANESWAR-RANCHI,1657,All
2024,6,BHUBANESWAR,RANCHI,667,678,BHUBANESWAR-RANCHI,1345,All
2024,7,BHUBANESWAR,RANCHI,1194,1184,BHUBANESWAR-RANCHI,2378,All
2024,8,BHUBANESWAR,RANCHI,1449,1296,BHUBANESWAR-RANCHI,2745,All
2024,9,BHUBANESWAR,RANCHI,1260,1139,BHUBANESWAR-RANCHI,2399,All
2024,10,BHUBANESWAR,RANCHI,1717,1365,BHUBANESWAR-RANCHI,3082,All
2024,11,BHUBANESWAR,RANCHI,1576,1923,BHUBANESWAR-RANCHI,3499,All
2024,12,BHUBANESWAR,RANCHI,1850,2086,BHUBANESWAR-RANCHI,3936,All
2025,1,BHUBANESWAR,RANCHI,1877,1919,BHUBANESWAR-RANCHI,3796,All
2025,2,BHUBANESWAR,RANCHI,1848,1757,BHUBANESWAR-RANCHI,3605,All
2025,3,BHUBANESWAR,RANCHI,1938,1794,BHUBANESWAR-RANCHI,3732,All
2024,1,BHUBANESWAR,ROURKELA,36,85,BHUBANESWAR-ROURKELA,121,All
2024,2,BHUBANESWAR,ROURKELA,760,809,BHUBANESWAR-ROURKELA,1569,All
2024,3,BHUBANESWAR,ROURKELA,1368,1471,BHUBANESWAR-ROURKELA,2839,All
2024,4,BHUBANESWAR,ROURKELA,1742,1654,BHUBANESWAR-ROURKELA,3396,All
2024,6,BHUBANESWAR,ROURKELA,1679,1597,BHUBANESWAR-ROURKELA,3276,All
2024,7,BHUBANESWAR,ROURKELA,1479,1397,BHUBANESWAR-ROURKELA,2876,All
2024,8,BHUBANESWAR,ROURKELA,1680,1811,BHUBANESWAR-ROURKELA,3491,All
2024,9,BHUBANESWAR,ROURKELA,1429,1525,BHUBANESWAR-ROURKELA,2954,All
2024,10,BHUBANESWAR,ROURKELA,1295,1392,BHUBANESWAR-ROURKELA,2687,All
2024,11,BHUBANESWAR,ROURKELA,1075,1223,BHUBANESWAR-ROURKELA,2298,All
2024,12,BHUBANESWAR,ROURKELA,986,941,BHUBANESWAR-ROURKELA,1927,All
2025,1,BHUBANESWAR,ROURKELA,847,893,BHUBANESWAR-ROURKELA,1740,All
2025,2,BHUBANESWAR,ROURKELA,876,846,BHUBANESWAR-ROURKELA,1722,All
2025,3,BHUBANESWAR,ROURKELA,883,1013,BHUBANESWAR-ROURKELA,1896,All
2025,3,BHUBANESWAR,SRINAGAR,630,499,BHUBANESWAR-SRINAGAR,1129,All
2024,1,BHUBANESWAR,Utkela,59,98,BHUBANESWAR-Utkela,157,All
2024,2,BHUBANESWAR,Utkela,64,96,BHUBANESWAR-Utkela,160,All
2024,3,BHUBANESWAR,Utkela,62,97,BHUBANESWAR-Utkela,159,All
2024,4,BHUBANESWAR,Utkela,64,85,BHUBANESWAR-Utkela,149,All
2024,6,BHUBANESWAR,Utkela,46,69,BHUBANESWAR-Utkela,115,All
2024,7,BHUBANESWAR,Utkela,61,84,BHUBANESWAR-Utkela,145,All
2024,8,BHUBANESWAR,Utkela,60,94,BHUBANESWAR-Utkela,154,All
2024,9,BHUBANESWAR,Utkela,79,114,BHUBANESWAR-Utkela,193,All
2024,10,BHUBANESWAR,Utkela,97,111,BHUBANESWAR-Utkela,208,All
2024,11,BHUBANESWAR,Utkela,96,143,BHUBANESWAR-Utkela,239,All
2024,12,BHUBANESWAR,Utkela,138,188,BHUBANESWAR-Utkela,326,All
2025,1,BHUBANESWAR,Utkela,128,152,BHUBANESWAR-Utkela,280,All
2025,2,BHUBANESWAR,Utkela,123,146,BHUBANESWAR-Utkela,269,All
2025,3,BHUBANESWAR,Utkela,118,147,BHUBANESWAR-Utkela,265,All
2024,1,BHUBANESWAR,VARANASI,749,491,BHUBANESWAR-VARANASI,1240,All
2024,2,BHUBANESWAR,VARANASI,1962,1914,BHUBANESWAR-VARANASI,3876,All
2024,3,BHUBANESWAR,VARANASI,2180,2189,BHUBANESWAR-VARANASI,4369,All
2024,4,BHUBANESWAR,VARANASI,2195,2122,BHUBANESWAR-VARANASI,4317,All
2024,6,BHUBANESWAR,VARANASI,1991,2058,BHUBANESWAR-VARANASI,4049,All
2024,7,BHUBANESWAR,VARANASI,1972,1999,BHUBANESWAR-VARANASI,3971,All
2024,8,BHUBANESWAR,VARANASI,1986,2051,BHUBANESWAR-VARANASI,4037,All
2024,9,BHUBANESWAR,VARANASI,1237,1205,BHUBANESWAR-VARANASI,2442,All
2024,10,BHUBANESWAR,VARANASI,1162,1148,BHUBANESWAR-VARANASI,2310,All
2024,11,BHUBANESWAR,VARANASI,1210,1289,BHUBANESWAR-VARANASI,2499,All
2024,12,BHUBANESWAR,VARANASI,1282,1349,BHUBANESWAR-VARANASI,2631,All
2025,1,BHUBANESWAR,VARANASI,1343,1341,BHUBANESWAR-VARANASI,2684,All
2025,2,BHUBANESWAR,VARANASI,1185,1214,BHUBANESWAR-VARANASI,2399,All
2025,3,BHUBANESWAR,VARANASI,1347,1372,BHUBANESWAR-VARANASI,2719,All
2024,12,BHUBANESWAR,VISAKHAPATNAM,219,0,BHUBANESWAR-VISAKHAPATNAM,219,All
2025,2,BHUJ,DELHI,4889,4839,BHUJ-DELHI,9728,All
2025,3,BHUJ,DELHI,4522,4602,BHUJ-DELHI,9124,All
2024,1,BHUJ,MUMBAI,1581,1792,BHUJ-MUMBAI,3373,All
2024,2,BHUJ,MUMBAI,1596,1791,BHUJ-MUMBAI,3387,All
2024,3,BHUJ,MUMBAI,4562,4695,BHUJ-MUMBAI,9257,All
2024,4,BHUJ,MUMBAI,5941,6331,BHUJ-MUMBAI,12272,All
2024,6,BHUJ,MUMBAI,6173,6006,BHUJ-MUMBAI,12179,All
2024,7,BHUJ,MUMBAI,5656,5974,BHUJ-MUMBAI,11630,All
2024,8,BHUJ,MUMBAI,5815,5931,BHUJ-MUMBAI,11746,All
2024,9,BHUJ,MUMBAI,5779,5911,BHUJ-MUMBAI,11690,All
2024,10,BHUJ,MUMBAI,5414,5813,BHUJ-MUMBAI,11227,All
2024,11,BHUJ,MUMBAI,4937,5014,BHUJ-MUMBAI,9951,All
2024,12,BHUJ,MUMBAI,5949,6167,BHUJ-MUMBAI,12116,All
2025,1,BHUJ,MUMBAI,5785,5854,BHUJ-MUMBAI,11639,All
2025,2,BHUJ,MUMBAI,3948,4014,BHUJ-MUMBAI,7962,All
2025,3,BHUJ,MUMBAI,5590,5568,BHUJ-MUMBAI,11158,All
2024,1,BIKANER,DELHI,272,281,BIKANER-DELHI,553,All
2024,2,BIKANER,DELHI,288,294,BIKANER-DELHI,582,All
2024,3,BIKANER,DELHI,261,325,BIKANER-DELHI,586,All
2024,4,BIKANER,DELHI,168,238,BIKANER-DELHI,406,All
2024,6,BIKANER,DELHI,42,47,BIKANER-DELHI,89,All
2024,10,BIKANER,DELHI,44,69,BIKANER-DELHI,113,All
2024,11,BIKANER,DELHI,509,409,BIKANER-DELHI,918,All
2024,12,BIKANER,DELHI,128,146,BIKANER-DELHI,274,All
2025,1,BIKANER,DELHI,83,102,BIKANER-DELHI,185,All
2025,2,BIKANER,DELHI,1543,1348,BIKANER-DELHI,2891,All
2025,3,BIKANER,DELHI,1722,1535,BIKANER-DELHI,3257,All
2024,6,BIKANER,JAIPUR,161,158,BIKANER-JAIPUR,319,All
2024,7,BIKANER,JAIPUR,304,337,BIKANER-JAIPUR,641,All
2024,8,BIKANER,JAIPUR,323,325,BIKANER-JAIPUR,648,All
2024,9,BIKANER,JAIPUR,397,427,BIKANER-JAIPUR,824,All
2024,10,BIKANER,JAIPUR,397,492,BIKANER-JAIPUR,889,All
2024,11,BIKANER,JAIPUR,426,561,BIKANER-JAIPUR,987,All
2024,12,BIKANER,JAIPUR,150,125,BIKANER-JAIPUR,275,All
2025,3,BIKANER,JAIPUR,20,26,BIKANER-JAIPUR,46,All
2024,12,BILASPUR,Ambikapur Airport,19,19,Ambikapur Airport-BILASPUR,38,All
2025,1,BILASPUR,Ambikapur Airport,33,37,Ambikapur Airport-BILASPUR,70,All
2025,2,BILASPUR,Ambikapur Airport,14,35,Ambikapur Airport-BILASPUR,49,All
2025,3,BILASPUR,Ambikapur Airport,23,22,Ambikapur Airport-BILASPUR,45,All
2024,1,BILASPUR,DELHI,0,69,BILASPUR-DELHI,69,All
2024,2,BILASPUR,DELHI,13,0,BILASPUR-DELHI,13,All
2024,3,BILASPUR,DELHI,59,64,BILASPUR-DELHI,123,All
2024,4,BILASPUR,DELHI,436,296,BILASPUR-DELHI,732,All
2024,6,BILASPUR,DELHI,751,603,BILASPUR-DELHI,1354,All
2024,7,BILASPUR,DELHI,594,392,BILASPUR-DELHI,986,All
2024,8,BILASPUR,DELHI,642,451,BILASPUR-DELHI,1093,All
2024,9,BILASPUR,DELHI,693,412,BILASPUR-DELHI,1105,All
2024,10,BILASPUR,DELHI,729,537,BILASPUR-DELHI,1266,All
2024,11,BILASPUR,DELHI,805,474,BILASPUR-DELHI,1279,All
2024,12,BILASPUR,DELHI,671,406,BILASPUR-DELHI,1077,All
2025,1,BILASPUR,DELHI,735,545,BILASPUR-DELHI,1280,All
2025,2,BILASPUR,DELHI,716,487,BILASPUR-DELHI,1203,All
2025,3,BILASPUR,DELHI,833,577,BILASPUR-DELHI,1410,All
2025,3,BILASPUR,HYDERABAD,18,1,BILASPUR-HYDERABAD,19,All
2025,1,BILASPUR,INDORE,0,18,BILASPUR-INDORE,18,All
2024,1,BILASPUR,JABALPUR,620,675,BILASPUR-JABALPUR,1295,All
2024,2,BILASPUR,JABALPUR,746,812,BILASPUR-JABALPUR,1558,All
2024,3,BILASPUR,JABALPUR,414,293,BILASPUR-JABALPUR,707,All
2024,4,BILASPUR,JABALPUR,106,50,BILASPUR-JABALPUR,156,All
2024,6,BILASPUR,JABALPUR,426,323,BILASPUR-JABALPUR,749,All
2024,7,BILASPUR,JABALPUR,340,290,BILASPUR-JABALPUR,630,All
2024,8,BILASPUR,JABALPUR,496,292,BILASPUR-JABALPUR,788,All
2024,9,BILASPUR,JABALPUR,491,380,BILASPUR-JABALPUR,871,All
2024,10,BILASPUR,JABALPUR,484,374,BILASPUR-JABALPUR,858,All
2024,11,BILASPUR,JABALPUR,472,412,BILASPUR-JABALPUR,884,All
2024,12,BILASPUR,JABALPUR,416,396,BILASPUR-JABALPUR,812,All
2025,1,BILASPUR,JABALPUR,376,348,BILASPUR-JABALPUR,724,All
2025,2,BILASPUR,JABALPUR,449,394,BILASPUR-JABALPUR,843,All
2025,3,BILASPUR,JABALPUR,442,390,BILASPUR-JABALPUR,832,All
2024,6,BILASPUR,JAGDALPUR,135,260,BILASPUR-JAGDALPUR,395,All
2024,7,BILASPUR,JAGDALPUR,124,129,BILASPUR-JAGDALPUR,253,All
2024,8,BILASPUR,JAGDALPUR,122,239,BILASPUR-JAGDALPUR,361,All
2024,9,BILASPUR,JAGDALPUR,122,188,BILASPUR-JAGDALPUR,310,All
2024,10,BILASPUR,JAGDALPUR,229,338,BILASPUR-JAGDALPUR,567,All
2024,11,BILASPUR,JAGDALPUR,232,276,BILASPUR-JAGDALPUR,508,All
2024,12,BILASPUR,JAGDALPUR,219,346,BILASPUR-JAGDALPUR,565,All
2025,1,BILASPUR,JAGDALPUR,228,213,BILASPUR-JAGDALPUR,441,All
2025,2,BILASPUR,JAGDALPUR,140,255,BILASPUR-JAGDALPUR,395,All
2025,3,BILASPUR,JAGDALPUR,182,264,BILASPUR-JAGDALPUR,446,All
2024,3,BILASPUR,KOLKATA,49,21,BILASPUR-KOLKATA,70,All
2024,4,BILASPUR,KOLKATA,105,46,BILASPUR-KOLKATA,151,All
2024,6,BILASPUR,KOLKATA,266,224,BILASPUR-KOLKATA,490,All
2024,7,BILASPUR,KOLKATA,187,219,BILASPUR-KOLKATA,406,All
2024,8,BILASPUR,KOLKATA,215,218,BILASPUR-KOLKATA,433,All
2024,9,BILASPUR,KOLKATA,154,129,BILASPUR-KOLKATA,283,All
2024,10,BILASPUR,KOLKATA,370,265,BILASPUR-KOLKATA,635,All
2024,11,BILASPUR,KOLKATA,297,276,BILASPUR-KOLKATA,573,All
2024,12,BILASPUR,KOLKATA,363,364,BILASPUR-KOLKATA,727,All
2025,1,BILASPUR,KOLKATA,124,129,BILASPUR-KOLKATA,253,All
2025,2,BILASPUR,KOLKATA,263,213,BILASPUR-KOLKATA,476,All
2025,3,BILASPUR,KOLKATA,285,283,BILASPUR-KOLKATA,568,All
2024,4,CHANDIGARH,Ayodhya International Airport ,0,8,Ayodhya International Airport -CHANDIGARH,8,All
2024,1,CHANDIGARH,CHENNAI,4838,5442,CHANDIGARH-CHENNAI,10280,All
2024,2,CHANDIGARH,CHENNAI,4978,5045,CHANDIGARH-CHENNAI,10023,All
2024,3,CHANDIGARH,CHENNAI,5094,5186,CHANDIGARH-CHENNAI,10280,All
2024,4,CHANDIGARH,CHENNAI,4753,4927,CHANDIGARH-CHENNAI,9680,All
2024,6,CHANDIGARH,CHENNAI,4952,4819,CHANDIGARH-CHENNAI,9771,All
2024,7,CHANDIGARH,CHENNAI,5029,5040,CHANDIGARH-CHENNAI,10069,All
2024,8,CHANDIGARH,CHENNAI,4693,4790,CHANDIGARH-CHENNAI,9483,All
2024,9,CHANDIGARH,CHENNAI,4383,4845,CHANDIGARH-CHENNAI,9228,All
2024,10,CHANDIGARH,CHENNAI,4585,5167,CHANDIGARH-CHENNAI,9752,All
2024,11,CHANDIGARH,CHENNAI,5805,5982,CHANDIGARH-CHENNAI,11787,All
2024,12,CHANDIGARH,CHENNAI,6214,5771,CHANDIGARH-CHENNAI,11985,All
2025,1,CHANDIGARH,CHENNAI,4784,5049,CHANDIGARH-CHENNAI,9833,All
2025,2,CHANDIGARH,CHENNAI,5603,5848,CHANDIGARH-CHENNAI,11451,All
2025,3,CHANDIGARH,CHENNAI,5648,5856,CHANDIGARH-CHENNAI,11504,All
2024,1,CHANDIGARH,DABOLIM,5709,5142,CHANDIGARH-DABOLIM,10851,All
2024,2,CHANDIGARH,DABOLIM,5387,5535,CHANDIGARH-DABOLIM,10922,All
2024,3,CHANDIGARH,DABOLIM,5837,5969,CHANDIGARH-DABOLIM,11806,All
2024,4,CHANDIGARH,DABOLIM,5099,5562,CHANDIGARH-DABOLIM,10661,All
2024,6,CHANDIGARH,DABOLIM,6250,5898,CHANDIGARH-DABOLIM,12148,All
2024,7,CHANDIGARH,DABOLIM,4786,5504,CHANDIGARH-DABOLIM,10290,All
2024,8,CHANDIGARH,DABOLIM,5188,5747,CHANDIGARH-DABOLIM,10935,All
2024,9,CHANDIGARH,DABOLIM,5519,5881,CHANDIGARH-DABOLIM,11400,All
2024,10,CHANDIGARH,DABOLIM,4583,5884,CHANDIGARH-DABOLIM,10467,All
2024,11,CHANDIGARH,DABOLIM,7377,6422,CHANDIGARH-DABOLIM,13799,All
2024,12,CHANDIGARH,DABOLIM,11642,10889,CHANDIGARH-DABOLIM,22531,All
2025,1,CHANDIGARH,DABOLIM,11360,11584,CHANDIGARH-DABOLIM,22944,All
2025,2,CHANDIGARH,DABOLIM,10315,10908,CHANDIGARH-DABOLIM,21223,All
2025,3,CHANDIGARH,DABOLIM,10940,11447,CHANDIGARH-DABOLIM,22387,All
2024,1,CHANDIGARH,DELHI,26291,26657,CHANDIGARH-DELHI,52948,All
2024,2,CHANDIGARH,DELHI,32753,32493,CHANDIGARH-DELHI,65246,All
2024,3,CHANDIGARH,DELHI,31632,31628,CHANDIGARH-DELHI,63260,All
2024,4,CHANDIGARH,DELHI,38374,37896,CHANDIGARH-DELHI,76270,All
2024,6,CHANDIGARH,DELHI,43631,40269,CHANDIGARH-DELHI,83900,All
2024,7,CHANDIGARH,DELHI,37846,37441,CHANDIGARH-DELHI,75287,All
2024,8,CHANDIGARH,DELHI,38154,37337,CHANDIGARH-DELHI,75491,All
2024,9,CHANDIGARH,DELHI,35614,35932,CHANDIGARH-DELHI,71546,All
2024,10,CHANDIGARH,DELHI,37339,40862,CHANDIGARH-DELHI,78201,All
2024,11,CHANDIGARH,DELHI,37263,36782,CHANDIGARH-DELHI,74045,All
2024,12,CHANDIGARH,DELHI,39039,40684,CHANDIGARH-DELHI,79723,All
2025,1,CHANDIGARH,DELHI,36747,38173,CHANDIGARH-DELHI,74920,All
2025,2,CHANDIGARH,DELHI,39331,42201,CHANDIGARH-DELHI,81532,All
2025,3,CHANDIGARH,DELHI,47817,45381,CHANDIGARH-DELHI,93198,All
2024,4,CHANDIGARH,DHARAMSALA,636,725,CHANDIGARH-DHARAMSALA,1361,All
2024,6,CHANDIGARH,DHARAMSALA,550,531,CHANDIGARH-DHARAMSALA,1081,All
2024,7,CHANDIGARH,DHARAMSALA,323,531,CHANDIGARH-DHARAMSALA,854,All
2024,8,CHANDIGARH,DHARAMSALA,322,360,CHANDIGARH-DHARAMSALA,682,All
2024,9,CHANDIGARH,DHARAMSALA,566,512,CHANDIGARH-DHARAMSALA,1078,All
2024,10,CHANDIGARH,DHARAMSALA,736,807,CHANDIGARH-DHARAMSALA,1543,All
2024,11,CHANDIGARH,DHARAMSALA,1068,1352,CHANDIGARH-DHARAMSALA,2420,All
2024,12,CHANDIGARH,DHARAMSALA,1206,1394,CHANDIGARH-DHARAMSALA,2600,All
2025,1,CHANDIGARH,DHARAMSALA,925,1199,CHANDIGARH-DHARAMSALA,2124,All
2025,2,CHANDIGARH,DHARAMSALA,1248,1305,CHANDIGARH-DHARAMSALA,2553,All
2025,3,CHANDIGARH,DHARAMSALA,1497,1407,CHANDIGARH-DHARAMSALA,2904,All
2024,1,CHANDIGARH,DehraDun,0,77,CHANDIGARH-DehraDun,77,All
2024,1,CHANDIGARH,GUWAHATI,520,702,CHANDIGARH-GUWAHATI,1222,All
2024,2,CHANDIGARH,GUWAHATI,570,652,CHANDIGARH-GUWAHATI,1222,All
2024,3,CHANDIGARH,GUWAHATI,1005,1098,CHANDIGARH-GUWAHATI,2103,All
2024,4,CHANDIGARH,GUWAHATI,913,835,CHANDIGARH-GUWAHATI,1748,All
2024,6,CHANDIGARH,GUWAHATI,790,813,CHANDIGARH-GUWAHATI,1603,All
2024,7,CHANDIGARH,GUWAHATI,1364,1540,CHANDIGARH-GUWAHATI,2904,All
2024,8,CHANDIGARH,GUWAHATI,946,1281,CHANDIGARH-GUWAHATI,2227,All
2024,9,CHANDIGARH,GUWAHATI,949,1276,CHANDIGARH-GUWAHATI,2225,All
2024,10,CHANDIGARH,GUWAHATI,1055,1009,CHANDIGARH-GUWAHATI,2064,All
2024,11,CHANDIGARH,GUWAHATI,712,880,CHANDIGARH-GUWAHATI,1592,All
2024,12,CHANDIGARH,GUWAHATI,910,1057,CHANDIGARH-GUWAHATI,1967,All
2025,3,CHANDIGARH,GUWAHATI,1025,921,CHANDIGARH-GUWAHATI,1946,All
2024,1,CHANDIGARH,Goa,4621,4697,CHANDIGARH-Goa,9318,All
2024,2,CHANDIGARH,Goa,4031,4243,CHANDIGARH-Goa,8274,All
2024,3,CHANDIGARH,Goa,4224,4352,CHANDIGARH-Goa,8576,All
2024,10,CHANDIGARH,Goa,399,780,CHANDIGARH-Goa,1179,All
2024,11,CHANDIGARH,Goa,3426,3121,CHANDIGARH-Goa,6547,All
2024,1,CHANDIGARH,HYDERABAD,5925,6076,CHANDIGARH-HYDERABAD,12001,All
2024,2,CHANDIGARH,HYDERABAD,6363,6748,CHANDIGARH-HYDERABAD,13111,All
2024,3,CHANDIGARH,HYDERABAD,9080,9301,CHANDIGARH-HYDERABAD,18381,All
2024,4,CHANDIGARH,HYDERABAD,11129,12076,CHANDIGARH-HYDERABAD,23205,All
2024,6,CHANDIGARH,HYDERABAD,11968,10166,CHANDIGARH-HYDERABAD,22134,All
2024,7,CHANDIGARH,HYDERABAD,10348,9691,CHANDIGARH-HYDERABAD,20039,All
2024,8,CHANDIGARH,HYDERABAD,9554,10212,CHANDIGARH-HYDERABAD,19766,All
2024,9,CHANDIGARH,HYDERABAD,9329,9716,CHANDIGARH-HYDERABAD,19045,All
2024,10,CHANDIGARH,HYDERABAD,10790,11561,CHANDIGARH-HYDERABAD,22351,All
2024,11,CHANDIGARH,HYDERABAD,10179,9836,CHANDIGARH-HYDERABAD,20015,All
2024,12,CHANDIGARH,HYDERABAD,11623,11698,CHANDIGARH-HYDERABAD,23321,All
2025,1,CHANDIGARH,HYDERABAD,9714,11031,CHANDIGARH-HYDERABAD,20745,All
2025,2,CHANDIGARH,HYDERABAD,9389,10844,CHANDIGARH-HYDERABAD,20233,All
2025,3,CHANDIGARH,HYDERABAD,10572,11955,CHANDIGARH-HYDERABAD,22527,All
2024,1,CHANDIGARH,INDORE,1932,2079,CHANDIGARH-INDORE,4011,All
2024,2,CHANDIGARH,INDORE,2055,1974,CHANDIGARH-INDORE,4029,All
2024,3,CHANDIGARH,INDORE,2513,2388,CHANDIGARH-INDORE,4901,All
2024,4,CHANDIGARH,INDORE,1971,1953,CHANDIGARH-INDORE,3924,All
2024,6,CHANDIGARH,INDORE,2061,1909,CHANDIGARH-INDORE,3970,All
2024,7,CHANDIGARH,INDORE,2090,2009,CHANDIGARH-INDORE,4099,All
2024,8,CHANDIGARH,INDORE,2126,2170,CHANDIGARH-INDORE,4296,All
2024,9,CHANDIGARH,INDORE,1859,1872,CHANDIGARH-INDORE,3731,All
2024,10,CHANDIGARH,INDORE,1951,1710,CHANDIGARH-INDORE,3661,All
2024,11,CHANDIGARH,INDORE,2160,2614,CHANDIGARH-INDORE,4774,All
2024,12,CHANDIGARH,INDORE,1694,1955,CHANDIGARH-INDORE,3649,All
2025,1,CHANDIGARH,INDORE,2338,2663,CHANDIGARH-INDORE,5001,All
2025,2,CHANDIGARH,INDORE,2364,2576,CHANDIGARH-INDORE,4940,All
2025,3,CHANDIGARH,INDORE,2696,2727,CHANDIGARH-INDORE,5423,All
2024,1,CHANDIGARH,JAIPUR,4861,5018,CHANDIGARH-JAIPUR,9879,All
2024,2,CHANDIGARH,JAIPUR,5544,5822,CHANDIGARH-JAIPUR,11366,All
2024,3,CHANDIGARH,JAIPUR,5981,5815,CHANDIGARH-JAIPUR,11796,All
2024,4,CHANDIGARH,JAIPUR,5569,5645,CHANDIGARH-JAIPUR,11214,All
2024,6,CHANDIGARH,JAIPUR,6052,5371,CHANDIGARH-JAIPUR,11423,All
2024,7,CHANDIGARH,JAIPUR,5593,5421,CHANDIGARH-JAIPUR,11014,All
2024,8,CHANDIGARH,JAIPUR,5014,5275,CHANDIGARH-JAIPUR,10289,All
2024,9,CHANDIGARH,JAIPUR,5117,5194,CHANDIGARH-JAIPUR,10311,All
2024,10,CHANDIGARH,JAIPUR,5060,5469,CHANDIGARH-JAIPUR,10529,All
2024,11,CHANDIGARH,JAIPUR,5297,5312,CHANDIGARH-JAIPUR,10609,All
2024,12,CHANDIGARH,JAIPUR,5425,5570,CHANDIGARH-JAIPUR,10995,All
2025,1,CHANDIGARH,JAIPUR,4443,5033,CHANDIGARH-JAIPUR,9476,All
2025,2,CHANDIGARH,JAIPUR,5107,5634,CHANDIGARH-JAIPUR,10741,All
2025,3,CHANDIGARH,JAIPUR,6390,6736,CHANDIGARH-JAIPUR,13126,All
2024,4,CHANDIGARH,JAMMU,2515,1626,CHANDIGARH-JAMMU,4141,All
2024,6,CHANDIGARH,JAMMU,2668,2036,CHANDIGARH-JAMMU,4704,All
2024,7,CHANDIGARH,JAMMU,1764,1258,CHANDIGARH-JAMMU,3022,All
2024,8,CHANDIGARH,JAMMU,1773,1018,CHANDIGARH-JAMMU,2791,All
2024,9,CHANDIGARH,JAMMU,1873,1093,CHANDIGARH-JAMMU,2966,All
2024,10,CHANDIGARH,JAMMU,2082,1156,CHANDIGARH-JAMMU,3238,All
2024,11,CHANDIGARH,JAMMU,423,313,CHANDIGARH-JAMMU,736,All
2024,12,CHANDIGARH,JAMMU,1302,1263,CHANDIGARH-JAMMU,2565,All
2025,1,CHANDIGARH,JAMMU,1370,1421,CHANDIGARH-JAMMU,2791,All
2025,2,CHANDIGARH,JAMMU,979,896,CHANDIGARH-JAMMU,1875,All
2024,1,CHANDIGARH,KOCHI,92,92,CHANDIGARH-KOCHI,184,All
2024,2,CHANDIGARH,KOCHI,199,352,CHANDIGARH-KOCHI,551,All
2024,3,CHANDIGARH,KOCHI,219,331,CHANDIGARH-KOCHI,550,All
2024,4,CHANDIGARH,KOCHI,241,272,CHANDIGARH-KOCHI,513,All
2024,6,CHANDIGARH,KOCHI,225,334,CHANDIGARH-KOCHI,559,All
2024,7,CHANDIGARH,KOCHI,143,453,CHANDIGARH-KOCHI,596,All
2024,8,CHANDIGARH,KOCHI,251,411,CHANDIGARH-KOCHI,662,All
2024,9,CHANDIGARH,KOCHI,466,590,CHANDIGARH-KOCHI,1056,All
2024,10,CHANDIGARH,KOCHI,488,390,CHANDIGARH-KOCHI,878,All
2024,11,CHANDIGARH,KOCHI,238,409,CHANDIGARH-KOCHI,647,All
2024,12,CHANDIGARH,KOCHI,739,631,CHANDIGARH-KOCHI,1370,All
2025,3,CHANDIGARH,KOCHI,316,552,CHANDIGARH-KOCHI,868,All
2024,1,CHANDIGARH,KOLKATA,4649,5630,CHANDIGARH-KOLKATA,10279,All
2024,2,CHANDIGARH,KOLKATA,4604,4925,CHANDIGARH-KOLKATA,9529,All
2024,3,CHANDIGARH,KOLKATA,4690,4374,CHANDIGARH-KOLKATA,9064,All
2024,4,CHANDIGARH,KOLKATA,2863,2765,CHANDIGARH-KOLKATA,5628,All
2024,6,CHANDIGARH,KOLKATA,4651,3367,CHANDIGARH-KOLKATA,8018,All
2024,7,CHANDIGARH,KOLKATA,4248,4304,CHANDIGARH-KOLKATA,8552,All
2024,8,CHANDIGARH,KOLKATA,3769,4690,CHANDIGARH-KOLKATA,8459,All
2024,9,CHANDIGARH,KOLKATA,4058,4315,CHANDIGARH-KOLKATA,8373,All
2024,10,CHANDIGARH,KOLKATA,4995,5051,CHANDIGARH-KOLKATA,10046,All
2024,11,CHANDIGARH,KOLKATA,5090,4941,CHANDIGARH-KOLKATA,10031,All
2024,12,CHANDIGARH,KOLKATA,5849,5264,CHANDIGARH-KOLKATA,11113,All
2025,1,CHANDIGARH,KOLKATA,5039,5381,CHANDIGARH-KOLKATA,10420,All
2025,2,CHANDIGARH,KOLKATA,5484,5515,CHANDIGARH-KOLKATA,10999,All
2025,3,CHANDIGARH,KOLKATA,4945,4876,CHANDIGARH-KOLKATA,9821,All
2024,4,CHANDIGARH,KULLU,40,0,CHANDIGARH-KULLU,40,All
2024,7,CHANDIGARH,KULLU,77,0,CHANDIGARH-KULLU,77,All
2024,1,CHANDIGARH,LEH,2424,2857,CHANDIGARH-LEH,5281,All
2024,2,CHANDIGARH,LEH,3288,2022,CHANDIGARH-LEH,5310,All
2024,3,CHANDIGARH,LEH,2941,2158,CHANDIGARH-LEH,5099,All
2024,4,CHANDIGARH,LEH,1056,1271,CHANDIGARH-LEH,2327,All
2024,6,CHANDIGARH,LEH,1101,1135,CHANDIGARH-LEH,2236,All
2024,7,CHANDIGARH,LEH,1033,1232,CHANDIGARH-LEH,2265,All
2024,8,CHANDIGARH,LEH,1166,1298,CHANDIGARH-LEH,2464,All
2024,9,CHANDIGARH,LEH,757,1185,CHANDIGARH-LEH,1942,All
2024,10,CHANDIGARH,LEH,936,1694,CHANDIGARH-LEH,2630,All
2024,11,CHANDIGARH,LEH,2795,3409,CHANDIGARH-LEH,6204,All
2024,12,CHANDIGARH,LEH,2506,3530,CHANDIGARH-LEH,6036,All
2025,1,CHANDIGARH,LEH,2159,3210,CHANDIGARH-LEH,5369,All
2025,2,CHANDIGARH,LEH,3087,2586,CHANDIGARH-LEH,5673,All
2025,3,CHANDIGARH,LEH,3052,2078,CHANDIGARH-LEH,5130,All
2024,1,CHANDIGARH,LUCKNOW,2216,2138,CHANDIGARH-LUCKNOW,4354,All
2024,2,CHANDIGARH,LUCKNOW,2110,2084,CHANDIGARH-LUCKNOW,4194,All
2024,3,CHANDIGARH,LUCKNOW,3884,3942,CHANDIGARH-LUCKNOW,7826,All
2024,4,CHANDIGARH,LUCKNOW,3906,4116,CHANDIGARH-LUCKNOW,8022,All
2024,6,CHANDIGARH,LUCKNOW,4052,4197,CHANDIGARH-LUCKNOW,8249,All
2024,7,CHANDIGARH,LUCKNOW,2949,3240,CHANDIGARH-LUCKNOW,6189,All
2024,8,CHANDIGARH,LUCKNOW,2755,3428,CHANDIGARH-LUCKNOW,6183,All
2024,9,CHANDIGARH,LUCKNOW,2655,3199,CHANDIGARH-LUCKNOW,5854,All
2024,10,CHANDIGARH,LUCKNOW,3851,4054,CHANDIGARH-LUCKNOW,7905,All
2024,11,CHANDIGARH,LUCKNOW,4458,4394,CHANDIGARH-LUCKNOW,8852,All
2024,12,CHANDIGARH,LUCKNOW,4369,4380,CHANDIGARH-LUCKNOW,8749,All
2025,1,CHANDIGARH,LUCKNOW,3913,4421,CHANDIGARH-LUCKNOW,8334,All
2025,2,CHANDIGARH,LUCKNOW,4447,4710,CHANDIGARH-LUCKNOW,9157,All
2025,3,CHANDIGARH,LUCKNOW,4355,5712,CHANDIGARH-LUCKNOW,10067,All
2024,1,CHANDIGARH,MUMBAI,26949,27453,CHANDIGARH-MUMBAI,54402,All
2024,2,CHANDIGARH,MUMBAI,27673,28612,CHANDIGARH-MUMBAI,56285,All
2024,3,CHANDIGARH,MUMBAI,28656,29397,CHANDIGARH-MUMBAI,58053,All
2024,4,CHANDIGARH,MUMBAI,25918,26641,CHANDIGARH-MUMBAI,52559,All
2024,6,CHANDIGARH,MUMBAI,27629,26840,CHANDIGARH-MUMBAI,54469,All
2024,7,CHANDIGARH,MUMBAI,23670,25163,CHANDIGARH-MUMBAI,48833,All
2024,8,CHANDIGARH,MUMBAI,23983,25803,CHANDIGARH-MUMBAI,49786,All
2024,9,CHANDIGARH,MUMBAI,25433,27016,CHANDIGARH-MUMBAI,52449,All
2024,10,CHANDIGARH,MUMBAI,25706,33144,CHANDIGARH-MUMBAI,58850,All
2024,11,CHANDIGARH,MUMBAI,31396,31288,CHANDIGARH-MUMBAI,62684,All
2024,12,CHANDIGARH,MUMBAI,33100,32667,CHANDIGARH-MUMBAI,65767,All
2025,1,CHANDIGARH,MUMBAI,28661,29668,CHANDIGARH-MUMBAI,58329,All
2025,2,CHANDIGARH,MUMBAI,27514,29428,CHANDIGARH-MUMBAI,56942,All
2025,3,CHANDIGARH,MUMBAI,30444,30326,CHANDIGARH-MUMBAI,60770,All
2024,1,CHANDIGARH,PATNA,2031,2071,CHANDIGARH-PATNA,4102,All
2024,2,CHANDIGARH,PATNA,2196,2143,CHANDIGARH-PATNA,4339,All
2024,3,CHANDIGARH,PATNA,4334,4328,CHANDIGARH-PATNA,8662,All
2024,4,CHANDIGARH,PATNA,4853,4473,CHANDIGARH-PATNA,9326,All
2024,6,CHANDIGARH,PATNA,4620,4112,CHANDIGARH-PATNA,8732,All
2024,7,CHANDIGARH,PATNA,4497,4486,CHANDIGARH-PATNA,8983,All
2024,8,CHANDIGARH,PATNA,4175,3956,CHANDIGARH-PATNA,8131,All
2024,9,CHANDIGARH,PATNA,4363,3697,CHANDIGARH-PATNA,8060,All
2024,10,CHANDIGARH,PATNA,5263,4553,CHANDIGARH-PATNA,9816,All
2024,11,CHANDIGARH,PATNA,4714,4734,CHANDIGARH-PATNA,9448,All
2024,12,CHANDIGARH,PATNA,4603,4576,CHANDIGARH-PATNA,9179,All
2025,1,CHANDIGARH,PATNA,4504,4637,CHANDIGARH-PATNA,9141,All
2025,2,CHANDIGARH,PATNA,4313,4467,CHANDIGARH-PATNA,8780,All
2025,3,CHANDIGARH,PATNA,4899,4725,CHANDIGARH-PATNA,9624,All
2024,1,CHANDIGARH,PUNE,1845,1506,CHANDIGARH-PUNE,3351,All
2024,2,CHANDIGARH,PUNE,4594,4246,CHANDIGARH-PUNE,8840,All
2024,3,CHANDIGARH,PUNE,5063,4967,CHANDIGARH-PUNE,10030,All
2024,4,CHANDIGARH,PUNE,4797,4867,CHANDIGARH-PUNE,9664,All
2024,6,CHANDIGARH,PUNE,4909,4707,CHANDIGARH-PUNE,9616,All
2024,7,CHANDIGARH,PUNE,5166,4825,CHANDIGARH-PUNE,9991,All
2024,8,CHANDIGARH,PUNE,4886,4679,CHANDIGARH-PUNE,9565,All
2024,9,CHANDIGARH,PUNE,4612,4419,CHANDIGARH-PUNE,9031,All
2024,10,CHANDIGARH,PUNE,4515,5116,CHANDIGARH-PUNE,9631,All
2024,11,CHANDIGARH,PUNE,5627,5230,CHANDIGARH-PUNE,10857,All
2024,12,CHANDIGARH,PUNE,6123,6092,CHANDIGARH-PUNE,12215,All
2025,1,CHANDIGARH,PUNE,4738,4481,CHANDIGARH-PUNE,9219,All
2025,2,CHANDIGARH,PUNE,5693,5419,CHANDIGARH-PUNE,11112,All
2025,3,CHANDIGARH,PUNE,6574,6152,CHANDIGARH-PUNE,12726,All
2024,7,CHANDIGARH,RAIPUR,0,1,CHANDIGARH-RAIPUR,1,All
2024,12,CHANDIGARH,SIMLA,45,0,CHANDIGARH-SIMLA,45,All
2024,1,CHANDIGARH,SRINAGAR,4443,4118,CHANDIGARH-SRINAGAR,8561,All
2024,2,CHANDIGARH,SRINAGAR,4946,4238,CHANDIGARH-SRINAGAR,9184,All
2024,3,CHANDIGARH,SRINAGAR,4494,4038,CHANDIGARH-SRINAGAR,8532,All
2024,4,CHANDIGARH,SRINAGAR,9030,9269,CHANDIGARH-SRINAGAR,18299,All
2024,6,CHANDIGARH,SRINAGAR,10145,11203,CHANDIGARH-SRINAGAR,21348,All
2024,7,CHANDIGARH,SRINAGAR,10621,11479,CHANDIGARH-SRINAGAR,22100,All
2024,8,CHANDIGARH,SRINAGAR,7500,7528,CHANDIGARH-SRINAGAR,15028,All
2024,9,CHANDIGARH,SRINAGAR,7633,7253,CHANDIGARH-SRINAGAR,14886,All
2024,10,CHANDIGARH,SRINAGAR,8325,10072,CHANDIGARH-SRINAGAR,18397,All
2024,11,CHANDIGARH,SRINAGAR,7595,7596,CHANDIGARH-SRINAGAR,15191,All
2024,12,CHANDIGARH,SRINAGAR,8539,9046,CHANDIGARH-SRINAGAR,17585,All
2025,1,CHANDIGARH,SRINAGAR,10040,9785,CHANDIGARH-SRINAGAR,19825,All
2025,2,CHANDIGARH,SRINAGAR,9994,8940,CHANDIGARH-SRINAGAR,18934,All
2025,3,CHANDIGARH,SRINAGAR,10130,8737,CHANDIGARH-SRINAGAR,18867,All
2024,10,CHANDIGARH,UDAIPUR,44,51,CHANDIGARH-UDAIPUR,95,All
2024,11,CHANDIGARH,UDAIPUR,259,217,CHANDIGARH-UDAIPUR,476,All
2024,12,CHANDIGARH,UDAIPUR,236,138,CHANDIGARH-UDAIPUR,374,All
2025,3,CHANDIGARH,UDAIPUR,370,383,CHANDIGARH-UDAIPUR,753,All
2024,2,CHENNAI,Ayodhya International Airport ,3901,3462,Ayodhya International Airport -CHENNAI,7363,All
2024,3,CHENNAI,Ayodhya International Airport ,3564,3415,Ayodhya International Airport -CHENNAI,6979,All
2024,4,CHENNAI,Ayodhya International Airport ,4634,3623,Ayodhya International Airport -CHENNAI,8257,All
2024,6,CHENNAI,Ayodhya International Airport ,2416,2174,Ayodhya International Airport -CHENNAI,4590,All
2024,7,CHENNAI,Ayodhya International Airport ,1538,1546,Ayodhya International Airport -CHENNAI,3084,All
2024,1,CHENNAI,COIMBATORE,29284,31492,CHENNAI-COIMBATORE,60776,All
2024,2,CHENNAI,COIMBATORE,28601,29542,CHENNAI-COIMBATORE,58143,All
2024,3,CHENNAI,COIMBATORE,28760,29546,CHENNAI-COIMBATORE,58306,All
2024,4,CHENNAI,COIMBATORE,35769,36250,CHENNAI-COIMBATORE,72019,All
2024,6,CHENNAI,COIMBATORE,37520,39213,CHENNAI-COIMBATORE,76733,All
2024,7,CHENNAI,COIMBATORE,38848,39664,CHENNAI-COIMBATORE,78512,All
2024,8,CHENNAI,COIMBATORE,38620,38672,CHENNAI-COIMBATORE,77292,All
2024,9,CHENNAI,COIMBATORE,38301,39176,CHENNAI-COIMBATORE,77477,All
2024,10,CHENNAI,COIMBATORE,36096,34397,CHENNAI-COIMBATORE,70493,All
2024,11,CHENNAI,COIMBATORE,34552,35105,CHENNAI-COIMBATORE,69657,All
2024,12,CHENNAI,COIMBATORE,41336,40836,CHENNAI-COIMBATORE,82172,All
2025,1,CHENNAI,COIMBATORE,39688,39834,CHENNAI-COIMBATORE,79522,All
2025,2,CHENNAI,COIMBATORE,38299,34465,CHENNAI-COIMBATORE,72764,All
2025,3,CHENNAI,COIMBATORE,39939,40777,CHENNAI-COIMBATORE,80716,All
2024,1,CHENNAI,Cuddapah,543,693,CHENNAI-Cuddapah,1236,All
2024,2,CHENNAI,Cuddapah,616,759,CHENNAI-Cuddapah,1375,All
2024,3,CHENNAI,Cuddapah,497,615,CHENNAI-Cuddapah,1112,All
2024,4,CHENNAI,Cuddapah,379,644,CHENNAI-Cuddapah,1023,All
2024,6,CHENNAI,Cuddapah,435,711,CHENNAI-Cuddapah,1146,All
2024,7,CHENNAI,Cuddapah,447,744,CHENNAI-Cuddapah,1191,All
2024,8,CHENNAI,Cuddapah,452,652,CHENNAI-Cuddapah,1104,All
2024,9,CHENNAI,Cuddapah,446,691,CHENNAI-Cuddapah,1137,All
2024,10,CHENNAI,Cuddapah,351,674,CHENNAI-Cuddapah,1025,All
2024,11,CHENNAI,Cuddapah,364,515,CHENNAI-Cuddapah,879,All
2024,12,CHENNAI,Cuddapah,437,374,CHENNAI-Cuddapah,811,All
2025,1,CHENNAI,Cuddapah,375,648,CHENNAI-Cuddapah,1023,All
2025,2,CHENNAI,Cuddapah,408,642,CHENNAI-Cuddapah,1050,All
2025,3,CHENNAI,Cuddapah,468,695,CHENNAI-Cuddapah,1163,All
2024,1,CHENNAI,DABOLIM,4855,5202,CHENNAI-DABOLIM,10057,All
2024,2,CHENNAI,DABOLIM,4573,4436,CHENNAI-DABOLIM,9009,All
2024,3,CHENNAI,DABOLIM,4568,4258,CHENNAI-DABOLIM,8826,All
2024,4,CHENNAI,DABOLIM,4384,4795,CHENNAI-DABOLIM,9179,All
2024,6,CHENNAI,DABOLIM,4065,4645,CHENNAI-DABOLIM,8710,All
2024,7,CHENNAI,DABOLIM,3727,4104,CHENNAI-DABOLIM,7831,All
2024,8,CHENNAI,DABOLIM,4061,4602,CHENNAI-DABOLIM,8663,All
2024,9,CHENNAI,DABOLIM,4140,4481,CHENNAI-DABOLIM,8621,All
2024,10,CHENNAI,DABOLIM,5058,5608,CHENNAI-DABOLIM,10666,All
2024,11,CHENNAI,DABOLIM,12718,12131,CHENNAI-DABOLIM,24849,All
2024,12,CHENNAI,DABOLIM,19277,19067,CHENNAI-DABOLIM,38344,All
2025,1,CHENNAI,DABOLIM,16155,18013,CHENNAI-DABOLIM,34168,All
2025,2,CHENNAI,DABOLIM,14332,14689,CHENNAI-DABOLIM,29021,All
2025,3,CHENNAI,DABOLIM,12669,13330,CHENNAI-DABOLIM,25999,All
2024,1,CHENNAI,DELHI,102766,104314,CHENNAI-DELHI,207080,All
2024,2,CHENNAI,DELHI,101243,97890,CHENNAI-DELHI,199133,All
2024,3,CHENNAI,DELHI,100786,99331,CHENNAI-DELHI,200117,All
2024,4,CHENNAI,DELHI,103449,93254,CHENNAI-DELHI,196703,All
2024,6,CHENNAI,DELHI,91150,104418,CHENNAI-DELHI,195568,All
2024,7,CHENNAI,DELHI,97954,104919,CHENNAI-DELHI,202873,All
2024,8,CHENNAI,DELHI,105534,101786,CHENNAI-DELHI,207320,All
2024,9,CHENNAI,DELHI,103544,95176,CHENNAI-DELHI,198720,All
2024,10,CHENNAI,DELHI,97862,86506,CHENNAI-DELHI,184368,All
2024,11,CHENNAI,DELHI,96677,103848,CHENNAI-DELHI,200525,All
2024,12,CHENNAI,DELHI,105787,119201,CHENNAI-DELHI,224988,All
2025,1,CHENNAI,DELHI,110168,107038,CHENNAI-DELHI,217206,All
2025,2,CHENNAI,DELHI,108491,103197,CHENNAI-DELHI,211688,All
2025,3,CHENNAI,DELHI,101807,103629,CHENNAI-DELHI,205436,All
2024,1,CHENNAI,DIBRUGARH,676,632,CHENNAI-DIBRUGARH,1308,All
2024,2,CHENNAI,DIBRUGARH,862,773,CHENNAI-DIBRUGARH,1635,All
2024,3,CHENNAI,DIBRUGARH,808,749,CHENNAI-DIBRUGARH,1557,All
2024,4,CHENNAI,DIBRUGARH,400,458,CHENNAI-DIBRUGARH,858,All
2024,1,CHENNAI,DURGAPUR,787,957,CHENNAI-DURGAPUR,1744,All
2024,2,CHENNAI,DURGAPUR,644,859,CHENNAI-DURGAPUR,1503,All
2024,3,CHENNAI,DURGAPUR,611,801,CHENNAI-DURGAPUR,1412,All
2024,6,CHENNAI,DURGAPUR,2136,2047,CHENNAI-DURGAPUR,4183,All
2024,7,CHENNAI,DURGAPUR,2031,2228,CHENNAI-DURGAPUR,4259,All
2024,8,CHENNAI,DURGAPUR,1813,1963,CHENNAI-DURGAPUR,3776,All
2024,9,CHENNAI,DURGAPUR,1593,1542,CHENNAI-DURGAPUR,3135,All
2024,10,CHENNAI,DURGAPUR,2669,1540,CHENNAI-DURGAPUR,4209,All
2024,11,CHENNAI,DURGAPUR,2969,2629,CHENNAI-DURGAPUR,5598,All
2024,12,CHENNAI,DURGAPUR,5310,5017,CHENNAI-DURGAPUR,10327,All
2025,1,CHENNAI,DURGAPUR,4129,4158,CHENNAI-DURGAPUR,8287,All
2025,2,CHENNAI,DURGAPUR,4509,3693,CHENNAI-DURGAPUR,8202,All
2025,3,CHENNAI,DURGAPUR,4864,3896,CHENNAI-DURGAPUR,8760,All
2024,3,CHENNAI,DehraDun,9,22,CHENNAI-DehraDun,31,All
2024,4,CHENNAI,DehraDun,412,533,CHENNAI-DehraDun,945,All
2024,6,CHENNAI,DehraDun,619,828,CHENNAI-DehraDun,1447,All
2024,7,CHENNAI,DehraDun,312,527,CHENNAI-DehraDun,839,All
2024,8,CHENNAI,DehraDun,227,319,CHENNAI-DehraDun,546,All
2024,9,CHENNAI,DehraDun,609,705,CHENNAI-DehraDun,1314,All
2024,10,CHENNAI,DehraDun,659,1022,CHENNAI-DehraDun,1681,All
2024,11,CHENNAI,DehraDun,502,562,CHENNAI-DehraDun,1064,All
2024,12,CHENNAI,DehraDun,655,842,CHENNAI-DehraDun,1497,All
2025,3,CHENNAI,DehraDun,21,79,CHENNAI-DehraDun,100,All
2024,6,CHENNAI,GORAKHPUR,0,157,CHENNAI-GORAKHPUR,157,All
2024,1,CHENNAI,GUWAHATI,14148,14827,CHENNAI-GUWAHATI,28975,All
2024,2,CHENNAI,GUWAHATI,13672,13111,CHENNAI-GUWAHATI,26783,All
2024,3,CHENNAI,GUWAHATI,15155,13464,CHENNAI-GUWAHATI,28619,All
2024,4,CHENNAI,GUWAHATI,15049,13175,CHENNAI-GUWAHATI,28224,All
2024,6,CHENNAI,GUWAHATI,12683,13289,CHENNAI-GUWAHATI,25972,All
2024,7,CHENNAI,GUWAHATI,14238,14923,CHENNAI-GUWAHATI,29161,All
2024,8,CHENNAI,GUWAHATI,13248,13270,CHENNAI-GUWAHATI,26518,All
2024,9,CHENNAI,GUWAHATI,12812,12004,CHENNAI-GUWAHATI,24816,All
2024,10,CHENNAI,GUWAHATI,15123,12854,CHENNAI-GUWAHATI,27977,All
2024,11,CHENNAI,GUWAHATI,12989,13728,CHENNAI-GUWAHATI,26717,All
2024,12,CHENNAI,GUWAHATI,16215,15467,CHENNAI-GUWAHATI,31682,All
2025,1,CHENNAI,GUWAHATI,15039,15797,CHENNAI-GUWAHATI,30836,All
2025,2,CHENNAI,GUWAHATI,14800,13930,CHENNAI-GUWAHATI,28730,All
2025,3,CHENNAI,GUWAHATI,15946,15118,CHENNAI-GUWAHATI,31064,All
2024,1,CHENNAI,Goa,6774,8331,CHENNAI-Goa,15105,All
2024,2,CHENNAI,Goa,6198,7551,CHENNAI-Goa,13749,All
2024,3,CHENNAI,Goa,5834,6914,CHENNAI-Goa,12748,All
2024,4,CHENNAI,Goa,3791,4033,CHENNAI-Goa,7824,All
2024,6,CHENNAI,Goa,6018,6263,CHENNAI-Goa,12281,All
2024,7,CHENNAI,Goa,4581,5219,CHENNAI-Goa,9800,All
2024,8,CHENNAI,Goa,6347,6218,CHENNAI-Goa,12565,All
2024,9,CHENNAI,Goa,6829,6766,CHENNAI-Goa,13595,All
2024,10,CHENNAI,Goa,6980,7453,CHENNAI-Goa,14433,All
2024,11,CHENNAI,Goa,4023,3780,CHENNAI-Goa,7803,All
2024,12,CHENNAI,Goa,684,642,CHENNAI-Goa,1326,All
2025,1,CHENNAI,Goa,645,573,CHENNAI-Goa,1218,All
2025,2,CHENNAI,Goa,704,525,CHENNAI-Goa,1229,All
2025,3,CHENNAI,Goa,986,802,CHENNAI-Goa,1788,All
2025,3,CHENNAI,HINDON AIRPORT,1541,1498,CHENNAI-HINDON AIRPORT,3039,All
2024,1,CHENNAI,HUBLI,715,715,CHENNAI-HUBLI,1430,All
2024,2,CHENNAI,HUBLI,772,710,CHENNAI-HUBLI,1482,All
2024,3,CHENNAI,HUBLI,662,597,CHENNAI-HUBLI,1259,All
2024,4,CHENNAI,HUBLI,664,699,CHENNAI-HUBLI,1363,All
2024,6,CHENNAI,HUBLI,645,699,CHENNAI-HUBLI,1344,All
2024,7,CHENNAI,HUBLI,631,665,CHENNAI-HUBLI,1296,All
2024,8,CHENNAI,HUBLI,707,753,CHENNAI-HUBLI,1460,All
2024,9,CHENNAI,HUBLI,669,674,CHENNAI-HUBLI,1343,All
2024,10,CHENNAI,HUBLI,651,671,CHENNAI-HUBLI,1322,All
2024,1,CHENNAI,HYDERABAD,59733,61696,CHENNAI-HYDERABAD,121429,All
2024,2,CHENNAI,HYDERABAD,57715,53181,CHENNAI-HYDERABAD,110896,All
2024,3,CHENNAI,HYDERABAD,66021,63248,CHENNAI-HYDERABAD,129269,All
2024,4,CHENNAI,HYDERABAD,67331,65439,CHENNAI-HYDERABAD,132770,All
2024,6,CHENNAI,HYDERABAD,63165,60912,CHENNAI-HYDERABAD,124077,All
2024,7,CHENNAI,HYDERABAD,63246,62618,CHENNAI-HYDERABAD,125864,All
2024,8,CHENNAI,HYDERABAD,69357,67498,CHENNAI-HYDERABAD,136855,All
2024,9,CHENNAI,HYDERABAD,68919,63671,CHENNAI-HYDERABAD,132590,All
2024,10,CHENNAI,HYDERABAD,68756,65614,CHENNAI-HYDERABAD,134370,All
2024,11,CHENNAI,HYDERABAD,60607,59959,CHENNAI-HYDERABAD,120566,All
2024,12,CHENNAI,HYDERABAD,67843,67415,CHENNAI-HYDERABAD,135258,All
2025,1,CHENNAI,HYDERABAD,66939,67835,CHENNAI-HYDERABAD,134774,All
2025,2,CHENNAI,HYDERABAD,60140,58828,CHENNAI-HYDERABAD,118968,All
2025,3,CHENNAI,HYDERABAD,67266,65060,CHENNAI-HYDERABAD,132326,All
2024,1,CHENNAI,INDORE,5049,5073,CHENNAI-INDORE,10122,All
2024,2,CHENNAI,INDORE,4884,4814,CHENNAI-INDORE,9698,All
2024,3,CHENNAI,INDORE,5119,5049,CHENNAI-INDORE,10168,All
2024,4,CHENNAI,INDORE,6067,5433,CHENNAI-INDORE,11500,All
2024,6,CHENNAI,INDORE,4794,5072,CHENNAI-INDORE,9866,All
2024,7,CHENNAI,INDORE,5134,5215,CHENNAI-INDORE,10349,All
2024,8,CHENNAI,INDORE,4776,4772,CHENNAI-INDORE,9548,All
2024,9,CHENNAI,INDORE,4837,4906,CHENNAI-INDORE,9743,All
2024,10,CHENNAI,INDORE,4609,3974,CHENNAI-INDORE,8583,All
2024,11,CHENNAI,INDORE,5893,6519,CHENNAI-INDORE,12412,All
2024,12,CHENNAI,INDORE,7262,7750,CHENNAI-INDORE,15012,All
2025,1,CHENNAI,INDORE,7647,8243,CHENNAI-INDORE,15890,All
2025,2,CHENNAI,INDORE,7433,7106,CHENNAI-INDORE,14539,All
2025,3,CHENNAI,INDORE,6514,6416,CHENNAI-INDORE,12930,All
2024,1,CHENNAI,JAIPUR,7416,6941,CHENNAI-JAIPUR,14357,All
2024,2,CHENNAI,JAIPUR,10265,9793,CHENNAI-JAIPUR,20058,All
2024,3,CHENNAI,JAIPUR,9088,9237,CHENNAI-JAIPUR,18325,All
2024,4,CHENNAI,JAIPUR,6367,5747,CHENNAI-JAIPUR,12114,All
2024,6,CHENNAI,JAIPUR,6401,6718,CHENNAI-JAIPUR,13119,All
2024,7,CHENNAI,JAIPUR,5241,6582,CHENNAI-JAIPUR,11823,All
2024,8,CHENNAI,JAIPUR,5671,6306,CHENNAI-JAIPUR,11977,All
2024,9,CHENNAI,JAIPUR,6937,7135,CHENNAI-JAIPUR,14072,All
2024,10,CHENNAI,JAIPUR,11552,10211,CHENNAI-JAIPUR,21763,All
2024,11,CHENNAI,JAIPUR,14986,15176,CHENNAI-JAIPUR,30162,All
2024,12,CHENNAI,JAIPUR,14962,16695,CHENNAI-JAIPUR,31657,All
2025,1,CHENNAI,JAIPUR,13306,13282,CHENNAI-JAIPUR,26588,All
2025,2,CHENNAI,JAIPUR,15405,15369,CHENNAI-JAIPUR,30774,All
2025,3,CHENNAI,JAIPUR,13593,13796,CHENNAI-JAIPUR,27389,All
2024,10,CHENNAI,JAMMU,17,7,CHENNAI-JAMMU,24,All
2024,11,CHENNAI,JAMMU,144,156,CHENNAI-JAMMU,300,All
2024,12,CHENNAI,JAMMU,140,86,CHENNAI-JAMMU,226,All
2025,3,CHENNAI,JAMMU,175,83,CHENNAI-JAMMU,258,All
2024,11,CHENNAI,JODHPUR,0,172,CHENNAI-JODHPUR,172,All
2024,1,CHENNAI,KANNUR,1843,2042,CHENNAI-KANNUR,3885,All
2024,2,CHENNAI,KANNUR,1593,1587,CHENNAI-KANNUR,3180,All
2024,3,CHENNAI,KANNUR,1572,1584,CHENNAI-KANNUR,3156,All
2024,4,CHENNAI,KANNUR,1935,1815,CHENNAI-KANNUR,3750,All
2024,6,CHENNAI,KANNUR,3307,3307,CHENNAI-KANNUR,6614,All
2024,7,CHENNAI,KANNUR,3807,3035,CHENNAI-KANNUR,6842,All
2024,8,CHENNAI,KANNUR,3770,3603,CHENNAI-KANNUR,7373,All
2024,9,CHENNAI,KANNUR,3371,3490,CHENNAI-KANNUR,6861,All
2024,10,CHENNAI,KANNUR,2887,3140,CHENNAI-KANNUR,6027,All
2024,11,CHENNAI,KANNUR,3715,2862,CHENNAI-KANNUR,6577,All
2024,12,CHENNAI,KANNUR,4434,3460,CHENNAI-KANNUR,7894,All
2025,1,CHENNAI,KANNUR,3029,3756,CHENNAI-KANNUR,6785,All
2025,2,CHENNAI,KANNUR,3133,3122,CHENNAI-KANNUR,6255,All
2025,3,CHENNAI,KANNUR,2273,1882,CHENNAI-KANNUR,4155,All
2024,1,CHENNAI,KANPUR,4,8,CHENNAI-KANPUR,12,All
2024,10,CHENNAI,KANPUR,2,14,CHENNAI-KANPUR,16,All
2024,11,CHENNAI,KANPUR,66,21,CHENNAI-KANPUR,87,All
2024,12,CHENNAI,KANPUR,79,63,CHENNAI-KANPUR,142,All
2024,1,CHENNAI,KOCHI,23572,25639,CHENNAI-KOCHI,49211,All
2024,2,CHENNAI,KOCHI,21303,22883,CHENNAI-KOCHI,44186,All
2024,3,CHENNAI,KOCHI,21705,22906,CHENNAI-KOCHI,44611,All
2024,4,CHENNAI,KOCHI,22784,23334,CHENNAI-KOCHI,46118,All
2024,6,CHENNAI,KOCHI,21350,24994,CHENNAI-KOCHI,46344,All
2024,7,CHENNAI,KOCHI,24198,23492,CHENNAI-KOCHI,47690,All
2024,8,CHENNAI,KOCHI,25488,26118,CHENNAI-KOCHI,51606,All
2024,9,CHENNAI,KOCHI,26097,28272,CHENNAI-KOCHI,54369,All
2024,10,CHENNAI,KOCHI,28747,29926,CHENNAI-KOCHI,58673,All
2024,11,CHENNAI,KOCHI,32946,31440,CHENNAI-KOCHI,64386,All
2024,12,CHENNAI,KOCHI,35369,33057,CHENNAI-KOCHI,68426,All
2025,1,CHENNAI,KOCHI,32157,36445,CHENNAI-KOCHI,68602,All
2025,2,CHENNAI,KOCHI,27933,28378,CHENNAI-KOCHI,56311,All
2025,3,CHENNAI,KOCHI,27977,28577,CHENNAI-KOCHI,56554,All
2024,1,CHENNAI,KOLKATA,32088,32124,CHENNAI-KOLKATA,64212,All
2024,2,CHENNAI,KOLKATA,32266,30847,CHENNAI-KOLKATA,63113,All
2024,3,CHENNAI,KOLKATA,44472,37725,CHENNAI-KOLKATA,82197,All
2024,4,CHENNAI,KOLKATA,46559,36085,CHENNAI-KOLKATA,82644,All
2024,6,CHENNAI,KOLKATA,46624,46039,CHENNAI-KOLKATA,92663,All
2024,7,CHENNAI,KOLKATA,41965,46331,CHENNAI-KOLKATA,88296,All
2024,8,CHENNAI,KOLKATA,43546,43554,CHENNAI-KOLKATA,87100,All
2024,9,CHENNAI,KOLKATA,49351,42430,CHENNAI-KOLKATA,91781,All
2024,10,CHENNAI,KOLKATA,52942,46421,CHENNAI-KOLKATA,99363,All
2024,11,CHENNAI,KOLKATA,40000,38960,CHENNAI-KOLKATA,78960,All
2024,12,CHENNAI,KOLKATA,45382,43726,CHENNAI-KOLKATA,89108,All
2025,1,CHENNAI,KOLKATA,44780,43590,CHENNAI-KOLKATA,88370,All
2025,2,CHENNAI,KOLKATA,39340,38059,CHENNAI-KOLKATA,77399,All
2025,3,CHENNAI,KOLKATA,42789,40161,CHENNAI-KOLKATA,82950,All
2024,1,CHENNAI,KOZHIKODE,3802,4143,CHENNAI-KOZHIKODE,7945,All
2024,2,CHENNAI,KOZHIKODE,3592,3570,CHENNAI-KOZHIKODE,7162,All
2024,3,CHENNAI,KOZHIKODE,3249,3634,CHENNAI-KOZHIKODE,6883,All
2024,4,CHENNAI,KOZHIKODE,4058,3997,CHENNAI-KOZHIKODE,8055,All
2024,6,CHENNAI,KOZHIKODE,3855,3861,CHENNAI-KOZHIKODE,7716,All
2024,7,CHENNAI,KOZHIKODE,4382,3608,CHENNAI-KOZHIKODE,7990,All
2024,8,CHENNAI,KOZHIKODE,3987,3640,CHENNAI-KOZHIKODE,7627,All
2024,9,CHENNAI,KOZHIKODE,3847,3781,CHENNAI-KOZHIKODE,7628,All
2024,10,CHENNAI,KOZHIKODE,3560,3483,CHENNAI-KOZHIKODE,7043,All
2024,11,CHENNAI,KOZHIKODE,3560,3477,CHENNAI-KOZHIKODE,7037,All
2024,12,CHENNAI,KOZHIKODE,4021,3670,CHENNAI-KOZHIKODE,7691,All
2025,1,CHENNAI,KOZHIKODE,3940,4138,CHENNAI-KOZHIKODE,8078,All
2025,2,CHENNAI,KOZHIKODE,3733,3655,CHENNAI-KOZHIKODE,7388,All
2025,3,CHENNAI,KOZHIKODE,3626,3144,CHENNAI-KOZHIKODE,6770,All
2024,1,CHENNAI,KURNOOL,409,412,CHENNAI-KURNOOL,821,All
2024,2,CHENNAI,KURNOOL,340,327,CHENNAI-KURNOOL,667,All
2024,3,CHENNAI,KURNOOL,297,308,CHENNAI-KURNOOL,605,All
2024,4,CHENNAI,KURNOOL,228,259,CHENNAI-KURNOOL,487,All
2024,6,CHENNAI,KURNOOL,276,211,CHENNAI-KURNOOL,487,All
2024,7,CHENNAI,KURNOOL,295,301,CHENNAI-KURNOOL,596,All
2024,8,CHENNAI,KURNOOL,351,319,CHENNAI-KURNOOL,670,All
2024,9,CHENNAI,KURNOOL,304,237,CHENNAI-KURNOOL,541,All
2024,10,CHENNAI,KURNOOL,331,320,CHENNAI-KURNOOL,651,All
2024,11,CHENNAI,KURNOOL,352,299,CHENNAI-KURNOOL,651,All
2024,12,CHENNAI,KURNOOL,449,286,CHENNAI-KURNOOL,735,All
2025,1,CHENNAI,KURNOOL,481,448,CHENNAI-KURNOOL,929,All
2025,2,CHENNAI,KURNOOL,422,335,CHENNAI-KURNOOL,757,All
2025,3,CHENNAI,KURNOOL,355,261,CHENNAI-KURNOOL,616,All
2024,1,CHENNAI,LUCKNOW,5923,5906,CHENNAI-LUCKNOW,11829,All
2024,2,CHENNAI,LUCKNOW,5522,5317,CHENNAI-LUCKNOW,10839,All
2024,3,CHENNAI,LUCKNOW,5661,5553,CHENNAI-LUCKNOW,11214,All
2024,4,CHENNAI,LUCKNOW,4653,4304,CHENNAI-LUCKNOW,8957,All
2024,6,CHENNAI,LUCKNOW,4299,4120,CHENNAI-LUCKNOW,8419,All
2024,7,CHENNAI,LUCKNOW,4469,4464,CHENNAI-LUCKNOW,8933,All
2024,8,CHENNAI,LUCKNOW,4731,4432,CHENNAI-LUCKNOW,9163,All
2024,9,CHENNAI,LUCKNOW,4430,4004,CHENNAI-LUCKNOW,8434,All
2024,10,CHENNAI,LUCKNOW,4681,3446,CHENNAI-LUCKNOW,8127,All
2024,11,CHENNAI,LUCKNOW,4406,4189,CHENNAI-LUCKNOW,8595,All
2024,12,CHENNAI,LUCKNOW,4513,4542,CHENNAI-LUCKNOW,9055,All
2025,1,CHENNAI,LUCKNOW,4599,4364,CHENNAI-LUCKNOW,8963,All
2025,2,CHENNAI,LUCKNOW,4558,4287,CHENNAI-LUCKNOW,8845,All
2025,3,CHENNAI,LUCKNOW,4673,4557,CHENNAI-LUCKNOW,9230,All
2024,1,CHENNAI,MADURAI,16286,17078,CHENNAI-MADURAI,33364,All
2024,2,CHENNAI,MADURAI,14626,14705,CHENNAI-MADURAI,29331,All
2024,3,CHENNAI,MADURAI,16214,15811,CHENNAI-MADURAI,32025,All
2024,4,CHENNAI,MADURAI,15317,15072,CHENNAI-MADURAI,30389,All
2024,6,CHENNAI,MADURAI,15541,15875,CHENNAI-MADURAI,31416,All
2024,7,CHENNAI,MADURAI,16451,16409,CHENNAI-MADURAI,32860,All
2024,8,CHENNAI,MADURAI,16683,16358,CHENNAI-MADURAI,33041,All
2024,9,CHENNAI,MADURAI,15560,15496,CHENNAI-MADURAI,31056,All
2024,10,CHENNAI,MADURAI,16108,14084,CHENNAI-MADURAI,30192,All
2024,11,CHENNAI,MADURAI,18724,18077,CHENNAI-MADURAI,36801,All
2024,12,CHENNAI,MADURAI,20723,18567,CHENNAI-MADURAI,39290,All
2025,1,CHENNAI,MADURAI,22623,22354,CHENNAI-MADURAI,44977,All
2025,2,CHENNAI,MADURAI,20756,19837,CHENNAI-MADURAI,40593,All
2025,3,CHENNAI,MADURAI,21758,20465,CHENNAI-MADURAI,42223,All
2024,1,CHENNAI,MANGALORE,2808,2961,CHENNAI-MANGALORE,5769,All
2024,2,CHENNAI,MANGALORE,2660,2647,CHENNAI-MANGALORE,5307,All
2024,3,CHENNAI,MANGALORE,2818,2863,CHENNAI-MANGALORE,5681,All
2024,4,CHENNAI,MANGALORE,3510,3508,CHENNAI-MANGALORE,7018,All
2024,6,CHENNAI,MANGALORE,3147,3528,CHENNAI-MANGALORE,6675,All
2024,7,CHENNAI,MANGALORE,3724,3450,CHENNAI-MANGALORE,7174,All
2024,8,CHENNAI,MANGALORE,3637,3747,CHENNAI-MANGALORE,7384,All
2024,9,CHENNAI,MANGALORE,2932,3034,CHENNAI-MANGALORE,5966,All
2024,10,CHENNAI,MANGALORE,2859,3139,CHENNAI-MANGALORE,5998,All
2024,11,CHENNAI,MANGALORE,3618,3081,CHENNAI-MANGALORE,6699,All
2024,12,CHENNAI,MANGALORE,3782,3752,CHENNAI-MANGALORE,7534,All
2025,1,CHENNAI,MANGALORE,3503,3682,CHENNAI-MANGALORE,7185,All
2025,2,CHENNAI,MANGALORE,3389,3391,CHENNAI-MANGALORE,6780,All
2025,3,CHENNAI,MANGALORE,3143,3138,CHENNAI-MANGALORE,6281,All
2024,1,CHENNAI,MUMBAI,114843,120294,CHENNAI-MUMBAI,235137,All
2024,2,CHENNAI,MUMBAI,108650,111152,CHENNAI-MUMBAI,219802,All
2024,3,CHENNAI,MUMBAI,94590,94377,CHENNAI-MUMBAI,188967,All
2024,4,CHENNAI,MUMBAI,87665,86760,CHENNAI-MUMBAI,174425,All
2024,6,CHENNAI,MUMBAI,81225,90413,CHENNAI-MUMBAI,171638,All
2024,7,CHENNAI,MUMBAI,83743,95267,CHENNAI-MUMBAI,179010,All
2024,8,CHENNAI,MUMBAI,97209,89941,CHENNAI-MUMBAI,187150,All
2024,9,CHENNAI,MUMBAI,95339,83455,CHENNAI-MUMBAI,178794,All
2024,10,CHENNAI,MUMBAI,80449,86932,CHENNAI-MUMBAI,167381,All
2024,11,CHENNAI,MUMBAI,89708,83994,CHENNAI-MUMBAI,173702,All
2024,12,CHENNAI,MUMBAI,91337,94742,CHENNAI-MUMBAI,186079,All
2025,1,CHENNAI,MUMBAI,87813,90471,CHENNAI-MUMBAI,178284,All
2025,2,CHENNAI,MUMBAI,81532,82031,CHENNAI-MUMBAI,163563,All
2025,3,CHENNAI,MUMBAI,81523,80009,CHENNAI-MUMBAI,161532,All
2024,1,CHENNAI,MYSORE,1791,1767,CHENNAI-MYSORE,3558,All
2024,2,CHENNAI,MYSORE,1768,1585,CHENNAI-MYSORE,3353,All
2024,3,CHENNAI,MYSORE,1807,1658,CHENNAI-MYSORE,3465,All
2024,4,CHENNAI,MYSORE,1469,1336,CHENNAI-MYSORE,2805,All
2024,6,CHENNAI,MYSORE,1866,1540,CHENNAI-MYSORE,3406,All
2024,7,CHENNAI,MYSORE,1622,1537,CHENNAI-MYSORE,3159,All
2024,8,CHENNAI,MYSORE,1607,1486,CHENNAI-MYSORE,3093,All
2024,9,CHENNAI,MYSORE,1529,1494,CHENNAI-MYSORE,3023,All
2024,10,CHENNAI,MYSORE,1782,1659,CHENNAI-MYSORE,3441,All
2024,11,CHENNAI,MYSORE,1970,1642,CHENNAI-MYSORE,3612,All
2024,12,CHENNAI,MYSORE,2062,1819,CHENNAI-MYSORE,3881,All
2025,1,CHENNAI,MYSORE,2078,2001,CHENNAI-MYSORE,4079,All
2025,2,CHENNAI,MYSORE,2026,1705,CHENNAI-MYSORE,3731,All
2025,3,CHENNAI,MYSORE,2019,1752,CHENNAI-MYSORE,3771,All
2024,2,CHENNAI,NAGPUR,97,0,CHENNAI-NAGPUR,97,All
2024,3,CHENNAI,NAGPUR,41,0,CHENNAI-NAGPUR,41,All
2024,4,CHENNAI,NAGPUR,76,36,CHENNAI-NAGPUR,112,All
2024,1,CHENNAI,PATNA,2371,2838,CHENNAI-PATNA,5209,All
2024,2,CHENNAI,PATNA,2113,1983,CHENNAI-PATNA,4096,All
2024,3,CHENNAI,PATNA,2336,2121,CHENNAI-PATNA,4457,All
2024,4,CHENNAI,PATNA,5298,4782,CHENNAI-PATNA,10080,All
2024,6,CHENNAI,PATNA,5131,5186,CHENNAI-PATNA,10317,All
2024,7,CHENNAI,PATNA,5159,5363,CHENNAI-PATNA,10522,All
2024,8,CHENNAI,PATNA,5048,5247,CHENNAI-PATNA,10295,All
2024,9,CHENNAI,PATNA,5009,4812,CHENNAI-PATNA,9821,All
2024,10,CHENNAI,PATNA,5720,4669,CHENNAI-PATNA,10389,All
2024,11,CHENNAI,PATNA,5323,5119,CHENNAI-PATNA,10442,All
2024,12,CHENNAI,PATNA,5077,5141,CHENNAI-PATNA,10218,All
2025,1,CHENNAI,PATNA,4962,5006,CHENNAI-PATNA,9968,All
2025,2,CHENNAI,PATNA,6036,5569,CHENNAI-PATNA,11605,All
2025,3,CHENNAI,PATNA,5316,4996,CHENNAI-PATNA,10312,All
2024,1,CHENNAI,PORT BLAIR,26085,28517,CHENNAI-PORT BLAIR,54602,All
2024,2,CHENNAI,PORT BLAIR,23419,21762,CHENNAI-PORT BLAIR,45181,All
2024,3,CHENNAI,PORT BLAIR,23510,22919,CHENNAI-PORT BLAIR,46429,All
2024,4,CHENNAI,PORT BLAIR,21664,23485,CHENNAI-PORT BLAIR,45149,All
2024,6,CHENNAI,PORT BLAIR,19618,17146,CHENNAI-PORT BLAIR,36764,All
2024,7,CHENNAI,PORT BLAIR,15013,16193,CHENNAI-PORT BLAIR,31206,All
2024,8,CHENNAI,PORT BLAIR,16472,16633,CHENNAI-PORT BLAIR,33105,All
2024,9,CHENNAI,PORT BLAIR,17608,17195,CHENNAI-PORT BLAIR,34803,All
2024,10,CHENNAI,PORT BLAIR,20465,18604,CHENNAI-PORT BLAIR,39069,All
2024,11,CHENNAI,PORT BLAIR,23871,24081,CHENNAI-PORT BLAIR,47952,All
2024,12,CHENNAI,PORT BLAIR,28431,26605,CHENNAI-PORT BLAIR,55036,All
2025,1,CHENNAI,PORT BLAIR,26410,28717,CHENNAI-PORT BLAIR,55127,All
2025,2,CHENNAI,PORT BLAIR,25272,24280,CHENNAI-PORT BLAIR,49552,All
2025,3,CHENNAI,PORT BLAIR,26337,26583,CHENNAI-PORT BLAIR,52920,All
2024,1,CHENNAI,PUNE,29458,32037,CHENNAI-PUNE,61495,All
2024,2,CHENNAI,PUNE,23704,25348,CHENNAI-PUNE,49052,All
2024,3,CHENNAI,PUNE,23200,24938,CHENNAI-PUNE,48138,All
2024,4,CHENNAI,PUNE,22391,23278,CHENNAI-PUNE,45669,All
2024,6,CHENNAI,PUNE,24207,24577,CHENNAI-PUNE,48784,All
2024,7,CHENNAI,PUNE,26066,27071,CHENNAI-PUNE,53137,All
2024,8,CHENNAI,PUNE,26642,26379,CHENNAI-PUNE,53021,All
2024,9,CHENNAI,PUNE,26501,26202,CHENNAI-PUNE,52703,All
2024,10,CHENNAI,PUNE,23590,26344,CHENNAI-PUNE,49934,All
2024,11,CHENNAI,PUNE,35383,32628,CHENNAI-PUNE,68011,All
2024,12,CHENNAI,PUNE,34250,35603,CHENNAI-PUNE,69853,All
2025,1,CHENNAI,PUNE,36614,37817,CHENNAI-PUNE,74431,All
2025,2,CHENNAI,PUNE,34079,33694,CHENNAI-PUNE,67773,All
2025,3,CHENNAI,PUNE,34434,34229,CHENNAI-PUNE,68663,All
2024,1,CHENNAI,RAIPUR,2507,2572,CHENNAI-RAIPUR,5079,All
2024,2,CHENNAI,RAIPUR,2348,2303,CHENNAI-RAIPUR,4651,All
2024,3,CHENNAI,RAIPUR,2329,2147,CHENNAI-RAIPUR,4476,All
2024,4,CHENNAI,RAIPUR,2451,2501,CHENNAI-RAIPUR,4952,All
2024,6,CHENNAI,RAIPUR,2740,2697,CHENNAI-RAIPUR,5437,All
2024,7,CHENNAI,RAIPUR,2936,3182,CHENNAI-RAIPUR,6118,All
2024,8,CHENNAI,RAIPUR,2796,3005,CHENNAI-RAIPUR,5801,All
2024,9,CHENNAI,RAIPUR,2640,2624,CHENNAI-RAIPUR,5264,All
2024,10,CHENNAI,RAIPUR,3238,2539,CHENNAI-RAIPUR,5777,All
2024,11,CHENNAI,RAIPUR,4466,4725,CHENNAI-RAIPUR,9191,All
2024,12,CHENNAI,RAIPUR,5066,4782,CHENNAI-RAIPUR,9848,All
2025,1,CHENNAI,RAIPUR,4582,4397,CHENNAI-RAIPUR,8979,All
2025,2,CHENNAI,RAIPUR,4622,4356,CHENNAI-RAIPUR,8978,All
2025,3,CHENNAI,RAIPUR,4688,4125,CHENNAI-RAIPUR,8813,All
2024,1,CHENNAI,RAJAHMUNDRY,1973,2222,CHENNAI-RAJAHMUNDRY,4195,All
2024,2,CHENNAI,RAJAHMUNDRY,1824,1981,CHENNAI-RAJAHMUNDRY,3805,All
2024,3,CHENNAI,RAJAHMUNDRY,1892,1973,CHENNAI-RAJAHMUNDRY,3865,All
2024,4,CHENNAI,RAJAHMUNDRY,2088,1921,CHENNAI-RAJAHMUNDRY,4009,All
2024,6,CHENNAI,RAJAHMUNDRY,2085,2017,CHENNAI-RAJAHMUNDRY,4102,All
2024,7,CHENNAI,RAJAHMUNDRY,1779,1793,CHENNAI-RAJAHMUNDRY,3572,All
2024,8,CHENNAI,RAJAHMUNDRY,1826,1878,CHENNAI-RAJAHMUNDRY,3704,All
2024,9,CHENNAI,RAJAHMUNDRY,1785,1632,CHENNAI-RAJAHMUNDRY,3417,All
2024,10,CHENNAI,RAJAHMUNDRY,1967,1748,CHENNAI-RAJAHMUNDRY,3715,All
2024,11,CHENNAI,RAJAHMUNDRY,1825,1936,CHENNAI-RAJAHMUNDRY,3761,All
2024,12,CHENNAI,RAJAHMUNDRY,2182,2117,CHENNAI-RAJAHMUNDRY,4299,All
2025,1,CHENNAI,RAJAHMUNDRY,2117,2263,CHENNAI-RAJAHMUNDRY,4380,All
2025,2,CHENNAI,RAJAHMUNDRY,1890,1896,CHENNAI-RAJAHMUNDRY,3786,All
2025,3,CHENNAI,RAJAHMUNDRY,1974,1918,CHENNAI-RAJAHMUNDRY,3892,All
2024,1,CHENNAI,RANCHI,7687,7351,CHENNAI-RANCHI,15038,All
2024,2,CHENNAI,RANCHI,6073,5894,CHENNAI-RANCHI,11967,All
2024,3,CHENNAI,RANCHI,6535,5819,CHENNAI-RANCHI,12354,All
2024,4,CHENNAI,RANCHI,5087,4805,CHENNAI-RANCHI,9892,All
2024,6,CHENNAI,RANCHI,5007,5035,CHENNAI-RANCHI,10042,All
2024,7,CHENNAI,RANCHI,4562,5273,CHENNAI-RANCHI,9835,All
2024,8,CHENNAI,RANCHI,4808,4956,CHENNAI-RANCHI,9764,All
2024,9,CHENNAI,RANCHI,4725,4283,CHENNAI-RANCHI,9008,All
2024,10,CHENNAI,RANCHI,5571,4637,CHENNAI-RANCHI,10208,All
2024,11,CHENNAI,RANCHI,4845,4908,CHENNAI-RANCHI,9753,All
2024,12,CHENNAI,RANCHI,5281,5289,CHENNAI-RANCHI,10570,All
2025,1,CHENNAI,RANCHI,5261,5192,CHENNAI-RANCHI,10453,All
2025,2,CHENNAI,RANCHI,5201,4788,CHENNAI-RANCHI,9989,All
2025,3,CHENNAI,RANCHI,5608,4670,CHENNAI-RANCHI,10278,All
2024,1,CHENNAI,SALEM,1864,2016,CHENNAI-SALEM,3880,All
2024,2,CHENNAI,SALEM,1650,1800,CHENNAI-SALEM,3450,All
2024,3,CHENNAI,SALEM,1661,1840,CHENNAI-SALEM,3501,All
2024,4,CHENNAI,SALEM,1537,1789,CHENNAI-SALEM,3326,All
2024,6,CHENNAI,SALEM,1761,2066,CHENNAI-SALEM,3827,All
2024,7,CHENNAI,SALEM,1825,2057,CHENNAI-SALEM,3882,All
2024,8,CHENNAI,SALEM,1903,2179,CHENNAI-SALEM,4082,All
2024,9,CHENNAI,SALEM,1618,1968,CHENNAI-SALEM,3586,All
2024,10,CHENNAI,SALEM,1615,1532,CHENNAI-SALEM,3147,All
2024,11,CHENNAI,SALEM,1600,1812,CHENNAI-SALEM,3412,All
2024,12,CHENNAI,SALEM,1803,1833,CHENNAI-SALEM,3636,All
2025,1,CHENNAI,SALEM,1643,1942,CHENNAI-SALEM,3585,All
2025,2,CHENNAI,SALEM,1616,1839,CHENNAI-SALEM,3455,All
2025,3,CHENNAI,SALEM,1682,1961,CHENNAI-SALEM,3643,All
2024,1,CHENNAI,SHIRDI,5737,5750,CHENNAI-SHIRDI,11487,All
2024,2,CHENNAI,SHIRDI,5369,5316,CHENNAI-SHIRDI,10685,All
2024,3,CHENNAI,SHIRDI,5392,5057,CHENNAI-SHIRDI,10449,All
2024,4,CHENNAI,SHIRDI,3514,3273,CHENNAI-SHIRDI,6787,All
2024,6,CHENNAI,SHIRDI,2796,2424,CHENNAI-SHIRDI,5220,All
2024,7,CHENNAI,SHIRDI,3919,3607,CHENNAI-SHIRDI,7526,All
2024,8,CHENNAI,SHIRDI,3917,3478,CHENNAI-SHIRDI,7395,All
2024,9,CHENNAI,SHIRDI,3552,3347,CHENNAI-SHIRDI,6899,All
2024,10,CHENNAI,SHIRDI,6120,6503,CHENNAI-SHIRDI,12623,All
2024,11,CHENNAI,SHIRDI,6634,6585,CHENNAI-SHIRDI,13219,All
2024,12,CHENNAI,SHIRDI,5559,5259,CHENNAI-SHIRDI,10818,All
2025,1,CHENNAI,SHIRDI,4800,4550,CHENNAI-SHIRDI,9350,All
2025,2,CHENNAI,SHIRDI,5485,5207,CHENNAI-SHIRDI,10692,All
2025,3,CHENNAI,SHIRDI,5291,5201,CHENNAI-SHIRDI,10492,All
2024,1,CHENNAI,SRINAGAR,0,142,CHENNAI-SRINAGAR,142,All
2024,2,CHENNAI,SRINAGAR,0,14,CHENNAI-SRINAGAR,14,All
2024,3,CHENNAI,SRINAGAR,0,60,CHENNAI-SRINAGAR,60,All
2024,4,CHENNAI,SRINAGAR,121,121,CHENNAI-SRINAGAR,242,All
2024,6,CHENNAI,SRINAGAR,32,74,CHENNAI-SRINAGAR,106,All
2024,7,CHENNAI,SRINAGAR,50,80,CHENNAI-SRINAGAR,130,All
2024,8,CHENNAI,SRINAGAR,29,24,CHENNAI-SRINAGAR,53,All
2024,9,CHENNAI,SRINAGAR,2,18,CHENNAI-SRINAGAR,20,All
2024,10,CHENNAI,SRINAGAR,4,4,CHENNAI-SRINAGAR,8,All
2024,11,CHENNAI,SRINAGAR,14,0,CHENNAI-SRINAGAR,14,All
2024,1,CHENNAI,SURAT,3218,3253,CHENNAI-SURAT,6471,All
2024,2,CHENNAI,SURAT,3121,3037,CHENNAI-SURAT,6158,All
2024,3,CHENNAI,SURAT,3085,2765,CHENNAI-SURAT,5850,All
2024,4,CHENNAI,SURAT,1841,1983,CHENNAI-SURAT,3824,All
2024,6,CHENNAI,SURAT,1996,2064,CHENNAI-SURAT,4060,All
2024,7,CHENNAI,SURAT,2060,2121,CHENNAI-SURAT,4181,All
2024,8,CHENNAI,SURAT,2118,2043,CHENNAI-SURAT,4161,All
2024,9,CHENNAI,SURAT,2184,2128,CHENNAI-SURAT,4312,All
2024,10,CHENNAI,SURAT,2052,2006,CHENNAI-SURAT,4058,All
2024,11,CHENNAI,SURAT,2879,2588,CHENNAI-SURAT,5467,All
2024,12,CHENNAI,SURAT,3489,3556,CHENNAI-SURAT,7045,All
2025,1,CHENNAI,SURAT,4304,4742,CHENNAI-SURAT,9046,All
2025,2,CHENNAI,SURAT,4221,4175,CHENNAI-SURAT,8396,All
2025,3,CHENNAI,SURAT,3754,3608,CHENNAI-SURAT,7362,All
2024,10,CHENNAI,Shivamogga Airport,424,453,CHENNAI-Shivamogga Airport,877,All
2024,11,CHENNAI,Shivamogga Airport,578,667,CHENNAI-Shivamogga Airport,1245,All
2024,12,CHENNAI,Shivamogga Airport,855,817,CHENNAI-Shivamogga Airport,1672,All
2025,1,CHENNAI,Shivamogga Airport,597,691,CHENNAI-Shivamogga Airport,1288,All
2025,2,CHENNAI,Shivamogga Airport,707,777,CHENNAI-Shivamogga Airport,1484,All
2025,3,CHENNAI,Shivamogga Airport,658,699,CHENNAI-Shivamogga Airport,1357,All
2024,1,CHENNAI,TIRUCHIRAPALLY,10580,9473,CHENNAI-TIRUCHIRAPALLY,20053,All
2024,2,CHENNAI,TIRUCHIRAPALLY,9764,9048,CHENNAI-TIRUCHIRAPALLY,18812,All
2024,3,CHENNAI,TIRUCHIRAPALLY,9963,8640,CHENNAI-TIRUCHIRAPALLY,18603,All
2024,4,CHENNAI,TIRUCHIRAPALLY,11176,9112,CHENNAI-TIRUCHIRAPALLY,20288,All
2024,6,CHENNAI,TIRUCHIRAPALLY,11508,10622,CHENNAI-TIRUCHIRAPALLY,22130,All
2024,7,CHENNAI,TIRUCHIRAPALLY,11026,9990,CHENNAI-TIRUCHIRAPALLY,21016,All
2024,8,CHENNAI,TIRUCHIRAPALLY,11653,10707,CHENNAI-TIRUCHIRAPALLY,22360,All
2024,9,CHENNAI,TIRUCHIRAPALLY,10159,10494,CHENNAI-TIRUCHIRAPALLY,20653,All
2024,10,CHENNAI,TIRUCHIRAPALLY,9995,8801,CHENNAI-TIRUCHIRAPALLY,18796,All
2024,11,CHENNAI,TIRUCHIRAPALLY,10150,11051,CHENNAI-TIRUCHIRAPALLY,21201,All
2024,12,CHENNAI,TIRUCHIRAPALLY,12224,11380,CHENNAI-TIRUCHIRAPALLY,23604,All
2025,1,CHENNAI,TIRUCHIRAPALLY,12192,11853,CHENNAI-TIRUCHIRAPALLY,24045,All
2025,2,CHENNAI,TIRUCHIRAPALLY,11656,11900,CHENNAI-TIRUCHIRAPALLY,23556,All
2025,3,CHENNAI,TIRUCHIRAPALLY,14413,14067,CHENNAI-TIRUCHIRAPALLY,28480,All
2024,10,CHENNAI,TIRUPATI,68,0,CHENNAI-TIRUPATI,68,All
2024,1,CHENNAI,TRIVANDRUM,15941,18968,CHENNAI-TRIVANDRUM,34909,All
2024,2,CHENNAI,TRIVANDRUM,14498,16084,CHENNAI-TRIVANDRUM,30582,All
2024,3,CHENNAI,TRIVANDRUM,14921,15752,CHENNAI-TRIVANDRUM,30673,All
2024,4,CHENNAI,TRIVANDRUM,13490,13673,CHENNAI-TRIVANDRUM,27163,All
2024,6,CHENNAI,TRIVANDRUM,14146,15487,CHENNAI-TRIVANDRUM,29633,All
2024,7,CHENNAI,TRIVANDRUM,14116,14651,CHENNAI-TRIVANDRUM,28767,All
2024,8,CHENNAI,TRIVANDRUM,16208,16873,CHENNAI-TRIVANDRUM,33081,All
2024,9,CHENNAI,TRIVANDRUM,16710,17743,CHENNAI-TRIVANDRUM,34453,All
2024,10,CHENNAI,TRIVANDRUM,14132,15406,CHENNAI-TRIVANDRUM,29538,All
2024,11,CHENNAI,TRIVANDRUM,16160,17439,CHENNAI-TRIVANDRUM,33599,All
2024,12,CHENNAI,TRIVANDRUM,17444,16801,CHENNAI-TRIVANDRUM,34245,All
2025,1,CHENNAI,TRIVANDRUM,14823,17503,CHENNAI-TRIVANDRUM,32326,All
2025,2,CHENNAI,TRIVANDRUM,12696,14528,CHENNAI-TRIVANDRUM,27224,All
2025,3,CHENNAI,TRIVANDRUM,12876,14268,CHENNAI-TRIVANDRUM,27144,All
2024,1,CHENNAI,TUTICORIN,6584,6488,CHENNAI-TUTICORIN,13072,All
2024,2,CHENNAI,TUTICORIN,6362,5954,CHENNAI-TUTICORIN,12316,All
2024,3,CHENNAI,TUTICORIN,6514,5945,CHENNAI-TUTICORIN,12459,All
2024,4,CHENNAI,TUTICORIN,8050,7266,CHENNAI-TUTICORIN,15316,All
2024,6,CHENNAI,TUTICORIN,7721,7491,CHENNAI-TUTICORIN,15212,All
2024,7,CHENNAI,TUTICORIN,7965,7320,CHENNAI-TUTICORIN,15285,All
2024,8,CHENNAI,TUTICORIN,7349,6808,CHENNAI-TUTICORIN,14157,All
2024,9,CHENNAI,TUTICORIN,6162,5911,CHENNAI-TUTICORIN,12073,All
2024,10,CHENNAI,TUTICORIN,6240,5570,CHENNAI-TUTICORIN,11810,All
2024,11,CHENNAI,TUTICORIN,7137,6502,CHENNAI-TUTICORIN,13639,All
2024,12,CHENNAI,TUTICORIN,8045,6879,CHENNAI-TUTICORIN,14924,All
2025,1,CHENNAI,TUTICORIN,8041,7931,CHENNAI-TUTICORIN,15972,All
2025,2,CHENNAI,TUTICORIN,7609,7090,CHENNAI-TUTICORIN,14699,All
2025,3,CHENNAI,TUTICORIN,8628,7614,CHENNAI-TUTICORIN,16242,All
2024,10,CHENNAI,VADODARA,104,164,CHENNAI-VADODARA,268,All
2024,11,CHENNAI,VADODARA,677,581,CHENNAI-VADODARA,1258,All
2024,12,CHENNAI,VADODARA,629,673,CHENNAI-VADODARA,1302,All
2025,1,CHENNAI,VADODARA,675,762,CHENNAI-VADODARA,1437,All
2025,2,CHENNAI,VADODARA,690,615,CHENNAI-VADODARA,1305,All
2025,3,CHENNAI,VADODARA,521,559,CHENNAI-VADODARA,1080,All
2024,1,CHENNAI,VARANASI,4263,4876,CHENNAI-VARANASI,9139,All
2024,2,CHENNAI,VARANASI,4379,3985,CHENNAI-VARANASI,8364,All
2024,3,CHENNAI,VARANASI,4332,4166,CHENNAI-VARANASI,8498,All
2024,4,CHENNAI,VARANASI,5686,4489,CHENNAI-VARANASI,10175,All
2024,6,CHENNAI,VARANASI,4703,4995,CHENNAI-VARANASI,9698,All
2024,7,CHENNAI,VARANASI,5907,6370,CHENNAI-VARANASI,12277,All
2024,8,CHENNAI,VARANASI,4837,5021,CHENNAI-VARANASI,9858,All
2024,9,CHENNAI,VARANASI,4550,4346,CHENNAI-VARANASI,8896,All
2024,10,CHENNAI,VARANASI,5862,4416,CHENNAI-VARANASI,10278,All
2024,11,CHENNAI,VARANASI,4764,4980,CHENNAI-VARANASI,9744,All
2024,12,CHENNAI,VARANASI,4575,5271,CHENNAI-VARANASI,9846,All
2025,1,CHENNAI,VARANASI,5236,5202,CHENNAI-VARANASI,10438,All
2025,2,CHENNAI,VARANASI,5159,5212,CHENNAI-VARANASI,10371,All
2025,3,CHENNAI,VARANASI,5534,5228,CHENNAI-VARANASI,10762,All
2024,1,CHENNAI,VIJAYAWADA,3697,4370,CHENNAI-VIJAYAWADA,8067,All
2024,2,CHENNAI,VIJAYAWADA,3465,3627,CHENNAI-VIJAYAWADA,7092,All
2024,3,CHENNAI,VIJAYAWADA,3541,3779,CHENNAI-VIJAYAWADA,7320,All
2024,4,CHENNAI,VIJAYAWADA,3786,3597,CHENNAI-VIJAYAWADA,7383,All
2024,6,CHENNAI,VIJAYAWADA,4221,3731,CHENNAI-VIJAYAWADA,7952,All
2024,7,CHENNAI,VIJAYAWADA,3873,3805,CHENNAI-VIJAYAWADA,7678,All
2024,8,CHENNAI,VIJAYAWADA,4036,4164,CHENNAI-VIJAYAWADA,8200,All
2024,9,CHENNAI,VIJAYAWADA,3464,3466,CHENNAI-VIJAYAWADA,6930,All
2024,10,CHENNAI,VIJAYAWADA,3957,3672,CHENNAI-VIJAYAWADA,7629,All
2024,11,CHENNAI,VIJAYAWADA,3730,3631,CHENNAI-VIJAYAWADA,7361,All
2024,12,CHENNAI,VIJAYAWADA,4192,4028,CHENNAI-VIJAYAWADA,8220,All
2025,1,CHENNAI,VIJAYAWADA,4004,4185,CHENNAI-VIJAYAWADA,8189,All
2025,2,CHENNAI,VIJAYAWADA,4114,4066,CHENNAI-VIJAYAWADA,8180,All
2025,3,CHENNAI,VIJAYAWADA,3933,3735,CHENNAI-VIJAYAWADA,7668,All
2024,1,CHENNAI,VISAKHAPATNAM,9018,9779,CHENNAI-VISAKHAPATNAM,18797,All
2024,2,CHENNAI,VISAKHAPATNAM,8686,8232,CHENNAI-VISAKHAPATNAM,16918,All
2024,3,CHENNAI,VISAKHAPATNAM,9298,7998,CHENNAI-VISAKHAPATNAM,17296,All
2024,4,CHENNAI,VISAKHAPATNAM,9421,10298,CHENNAI-VISAKHAPATNAM,19719,All
2024,6,CHENNAI,VISAKHAPATNAM,11028,10300,CHENNAI-VISAKHAPATNAM,21328,All
2024,7,CHENNAI,VISAKHAPATNAM,9143,11819,CHENNAI-VISAKHAPATNAM,20962,All
2024,8,CHENNAI,VISAKHAPATNAM,11300,12858,CHENNAI-VISAKHAPATNAM,24158,All
2024,9,CHENNAI,VISAKHAPATNAM,10783,10660,CHENNAI-VISAKHAPATNAM,21443,All
2024,10,CHENNAI,VISAKHAPATNAM,13258,10849,CHENNAI-VISAKHAPATNAM,24107,All
2024,11,CHENNAI,VISAKHAPATNAM,11224,12442,CHENNAI-VISAKHAPATNAM,23666,All
2024,12,CHENNAI,VISAKHAPATNAM,14579,13791,CHENNAI-VISAKHAPATNAM,28370,All
2025,1,CHENNAI,VISAKHAPATNAM,12216,13754,CHENNAI-VISAKHAPATNAM,25970,All
2025,2,CHENNAI,VISAKHAPATNAM,12761,12233,CHENNAI-VISAKHAPATNAM,24994,All
2025,3,CHENNAI,VISAKHAPATNAM,13222,12130,CHENNAI-VISAKHAPATNAM,25352,All
2024,10,COIMBATORE,DABOLIM,377,359,COIMBATORE-DABOLIM,736,All
2024,11,COIMBATORE,DABOLIM,2115,2102,COIMBATORE-DABOLIM,4217,All
2024,12,COIMBATORE,DABOLIM,2175,2226,COIMBATORE-DABOLIM,4401,All
2025,1,COIMBATORE,DABOLIM,2174,2224,COIMBATORE-DABOLIM,4398,All
2025,2,COIMBATORE,DABOLIM,1970,1938,COIMBATORE-DABOLIM,3908,All
2025,3,COIMBATORE,DABOLIM,2117,2215,COIMBATORE-DABOLIM,4332,All
2024,1,COIMBATORE,DELHI,14721,14527,COIMBATORE-DELHI,29248,All
2024,2,COIMBATORE,DELHI,16560,15402,COIMBATORE-DELHI,31962,All
2024,3,COIMBATORE,DELHI,16656,16738,COIMBATORE-DELHI,33394,All
2024,4,COIMBATORE,DELHI,14326,13093,COIMBATORE-DELHI,27419,All
2024,6,COIMBATORE,DELHI,16919,17916,COIMBATORE-DELHI,34835,All
2024,7,COIMBATORE,DELHI,17424,18634,COIMBATORE-DELHI,36058,All
2024,8,COIMBATORE,DELHI,17816,17614,COIMBATORE-DELHI,35430,All
2024,9,COIMBATORE,DELHI,18892,17371,COIMBATORE-DELHI,36263,All
2024,10,COIMBATORE,DELHI,18381,16476,COIMBATORE-DELHI,34857,All
2024,11,COIMBATORE,DELHI,18573,20308,COIMBATORE-DELHI,38881,All
2024,12,COIMBATORE,DELHI,19495,21042,COIMBATORE-DELHI,40537,All
2025,1,COIMBATORE,DELHI,18440,17668,COIMBATORE-DELHI,36108,All
2025,2,COIMBATORE,DELHI,19346,18706,COIMBATORE-DELHI,38052,All
2025,3,COIMBATORE,DELHI,17333,17070,COIMBATORE-DELHI,34403,All
2024,1,COIMBATORE,DURGAPUR,73,64,COIMBATORE-DURGAPUR,137,All
2024,10,COIMBATORE,DURGAPUR,26,3,COIMBATORE-DURGAPUR,29,All
2024,11,COIMBATORE,DURGAPUR,134,108,COIMBATORE-DURGAPUR,242,All
2024,12,COIMBATORE,DURGAPUR,163,0,COIMBATORE-DURGAPUR,163,All
2025,3,COIMBATORE,DURGAPUR,0,59,COIMBATORE-DURGAPUR,59,All
2024,3,COIMBATORE,GUWAHATI,8,12,COIMBATORE-GUWAHATI,20,All
2024,4,COIMBATORE,GUWAHATI,265,224,COIMBATORE-GUWAHATI,489,All
2024,6,COIMBATORE,GUWAHATI,350,325,COIMBATORE-GUWAHATI,675,All
2024,7,COIMBATORE,GUWAHATI,175,210,COIMBATORE-GUWAHATI,385,All
2024,8,COIMBATORE,GUWAHATI,315,220,COIMBATORE-GUWAHATI,535,All
2024,9,COIMBATORE,GUWAHATI,203,121,COIMBATORE-GUWAHATI,324,All
2024,10,COIMBATORE,GUWAHATI,377,248,COIMBATORE-GUWAHATI,625,All
2024,11,COIMBATORE,GUWAHATI,311,290,COIMBATORE-GUWAHATI,601,All
2024,12,COIMBATORE,GUWAHATI,282,337,COIMBATORE-GUWAHATI,619,All
2025,3,COIMBATORE,GUWAHATI,212,108,COIMBATORE-GUWAHATI,320,All
2024,1,COIMBATORE,Goa,1397,1686,COIMBATORE-Goa,3083,All
2024,2,COIMBATORE,Goa,1814,1961,COIMBATORE-Goa,3775,All
2024,3,COIMBATORE,Goa,1725,1800,COIMBATORE-Goa,3525,All
2024,4,COIMBATORE,Goa,1512,1159,COIMBATORE-Goa,2671,All
2024,6,COIMBATORE,Goa,1429,1108,COIMBATORE-Goa,2537,All
2024,7,COIMBATORE,Goa,1814,1533,COIMBATORE-Goa,3347,All
2024,8,COIMBATORE,Goa,1912,1300,COIMBATORE-Goa,3212,All
2024,9,COIMBATORE,Goa,2064,1560,COIMBATORE-Goa,3624,All
2024,10,COIMBATORE,Goa,1706,1355,COIMBATORE-Goa,3061,All
2024,1,COIMBATORE,HYDERABAD,10032,10339,COIMBATORE-HYDERABAD,20371,All
2024,2,COIMBATORE,HYDERABAD,10007,9859,COIMBATORE-HYDERABAD,19866,All
2024,3,COIMBATORE,HYDERABAD,12181,12045,COIMBATORE-HYDERABAD,24226,All
2024,4,COIMBATORE,HYDERABAD,13289,13281,COIMBATORE-HYDERABAD,26570,All
2024,6,COIMBATORE,HYDERABAD,13464,12627,COIMBATORE-HYDERABAD,26091,All
2024,7,COIMBATORE,HYDERABAD,13334,13260,COIMBATORE-HYDERABAD,26594,All
2024,8,COIMBATORE,HYDERABAD,14788,14530,COIMBATORE-HYDERABAD,29318,All
2024,9,COIMBATORE,HYDERABAD,14511,13566,COIMBATORE-HYDERABAD,28077,All
2024,10,COIMBATORE,HYDERABAD,17260,17238,COIMBATORE-HYDERABAD,34498,All
2024,11,COIMBATORE,HYDERABAD,17673,17440,COIMBATORE-HYDERABAD,35113,All
2024,12,COIMBATORE,HYDERABAD,19068,19368,COIMBATORE-HYDERABAD,38436,All
2025,1,COIMBATORE,HYDERABAD,21396,20720,COIMBATORE-HYDERABAD,42116,All
2025,2,COIMBATORE,HYDERABAD,18681,18788,COIMBATORE-HYDERABAD,37469,All
2025,3,COIMBATORE,HYDERABAD,19360,18372,COIMBATORE-HYDERABAD,37732,All
2024,1,COIMBATORE,JAIPUR,724,565,COIMBATORE-JAIPUR,1289,All
2024,2,COIMBATORE,JAIPUR,660,648,COIMBATORE-JAIPUR,1308,All
2024,3,COIMBATORE,JAIPUR,716,780,COIMBATORE-JAIPUR,1496,All
2024,4,COIMBATORE,JAIPUR,845,652,COIMBATORE-JAIPUR,1497,All
2024,6,COIMBATORE,JAIPUR,576,667,COIMBATORE-JAIPUR,1243,All
2024,7,COIMBATORE,JAIPUR,427,307,COIMBATORE-JAIPUR,734,All
2024,8,COIMBATORE,JAIPUR,497,488,COIMBATORE-JAIPUR,985,All
2024,9,COIMBATORE,JAIPUR,818,620,COIMBATORE-JAIPUR,1438,All
2024,10,COIMBATORE,JAIPUR,454,538,COIMBATORE-JAIPUR,992,All
2024,11,COIMBATORE,JAIPUR,257,166,COIMBATORE-JAIPUR,423,All
2024,12,COIMBATORE,JAIPUR,284,262,COIMBATORE-JAIPUR,546,All
2025,3,COIMBATORE,JAIPUR,97,152,COIMBATORE-JAIPUR,249,All
2024,1,COIMBATORE,KOLKATA,470,415,COIMBATORE-KOLKATA,885,All
2024,2,COIMBATORE,KOLKATA,426,307,COIMBATORE-KOLKATA,733,All
2024,3,COIMBATORE,KOLKATA,537,266,COIMBATORE-KOLKATA,803,All
2024,4,COIMBATORE,KOLKATA,259,147,COIMBATORE-KOLKATA,406,All
2024,6,COIMBATORE,KOLKATA,400,158,COIMBATORE-KOLKATA,558,All
2024,7,COIMBATORE,KOLKATA,237,332,COIMBATORE-KOLKATA,569,All
2024,8,COIMBATORE,KOLKATA,354,210,COIMBATORE-KOLKATA,564,All
2024,9,COIMBATORE,KOLKATA,261,148,COIMBATORE-KOLKATA,409,All
2024,10,COIMBATORE,KOLKATA,398,173,COIMBATORE-KOLKATA,571,All
2024,11,COIMBATORE,KOLKATA,0,124,COIMBATORE-KOLKATA,124,All
2024,12,COIMBATORE,KOLKATA,0,223,COIMBATORE-KOLKATA,223,All
2025,3,COIMBATORE,KOLKATA,0,196,COIMBATORE-KOLKATA,196,All
2024,10,COIMBATORE,LUCKNOW,1,0,COIMBATORE-LUCKNOW,1,All
2024,11,COIMBATORE,LUCKNOW,25,0,COIMBATORE-LUCKNOW,25,All
2024,12,COIMBATORE,LUCKNOW,22,0,COIMBATORE-LUCKNOW,22,All
2024,1,COIMBATORE,MUMBAI,29708,28862,COIMBATORE-MUMBAI,58570,All
2024,2,COIMBATORE,MUMBAI,28016,26674,COIMBATORE-MUMBAI,54690,All
2024,3,COIMBATORE,MUMBAI,28584,27638,COIMBATORE-MUMBAI,56222,All
2024,4,COIMBATORE,MUMBAI,32121,30210,COIMBATORE-MUMBAI,62331,All
2024,6,COIMBATORE,MUMBAI,31779,30851,COIMBATORE-MUMBAI,62630,All
2024,7,COIMBATORE,MUMBAI,27375,31225,COIMBATORE-MUMBAI,58600,All
2024,8,COIMBATORE,MUMBAI,31464,28517,COIMBATORE-MUMBAI,59981,All
2024,9,COIMBATORE,MUMBAI,31868,29325,COIMBATORE-MUMBAI,61193,All
2024,10,COIMBATORE,MUMBAI,25749,29223,COIMBATORE-MUMBAI,54972,All
2024,11,COIMBATORE,MUMBAI,28471,28203,COIMBATORE-MUMBAI,56674,All
2024,12,COIMBATORE,MUMBAI,31333,33244,COIMBATORE-MUMBAI,64577,All
2025,1,COIMBATORE,MUMBAI,32990,33663,COIMBATORE-MUMBAI,66653,All
2025,2,COIMBATORE,MUMBAI,28326,29194,COIMBATORE-MUMBAI,57520,All
2025,3,COIMBATORE,MUMBAI,29686,30116,COIMBATORE-MUMBAI,59802,All
2025,3,COIMBATORE,NASIK,8,1,COIMBATORE-NASIK,9,All
2024,1,COIMBATORE,PUNE,4720,4671,COIMBATORE-PUNE,9391,All
2024,2,COIMBATORE,PUNE,4627,4512,COIMBATORE-PUNE,9139,All
2024,3,COIMBATORE,PUNE,4738,4615,COIMBATORE-PUNE,9353,All
2024,4,COIMBATORE,PUNE,4613,4338,COIMBATORE-PUNE,8951,All
2024,6,COIMBATORE,PUNE,4637,4506,COIMBATORE-PUNE,9143,All
2024,7,COIMBATORE,PUNE,5101,4911,COIMBATORE-PUNE,10012,All
2024,8,COIMBATORE,PUNE,4942,4759,COIMBATORE-PUNE,9701,All
2024,9,COIMBATORE,PUNE,4999,4914,COIMBATORE-PUNE,9913,All
2024,10,COIMBATORE,PUNE,4336,4687,COIMBATORE-PUNE,9023,All
2024,11,COIMBATORE,PUNE,5168,4650,COIMBATORE-PUNE,9818,All
2024,12,COIMBATORE,PUNE,5263,5200,COIMBATORE-PUNE,10463,All
2025,1,COIMBATORE,PUNE,5344,4894,COIMBATORE-PUNE,10238,All
2025,2,COIMBATORE,PUNE,4740,4596,COIMBATORE-PUNE,9336,All
2025,3,COIMBATORE,PUNE,5057,4688,COIMBATORE-PUNE,9745,All
2024,1,COIMBATORE,RAIPUR,129,139,COIMBATORE-RAIPUR,268,All
2024,2,COIMBATORE,RAIPUR,188,168,COIMBATORE-RAIPUR,356,All
2024,3,COIMBATORE,RAIPUR,239,144,COIMBATORE-RAIPUR,383,All
2024,10,COIMBATORE,SHIRDI,12,0,COIMBATORE-SHIRDI,12,All
2024,11,COIMBATORE,SHIRDI,344,0,COIMBATORE-SHIRDI,344,All
2024,12,COIMBATORE,SHIRDI,236,470,COIMBATORE-SHIRDI,706,All
2025,3,COIMBATORE,SHIRDI,0,245,COIMBATORE-SHIRDI,245,All
2024,1,COIMBATORE,SURAT,237,191,COIMBATORE-SURAT,428,All
2024,2,COIMBATORE,SURAT,297,238,COIMBATORE-SURAT,535,All
2024,3,COIMBATORE,SURAT,298,238,COIMBATORE-SURAT,536,All
2024,4,COIMBATORE,VARANASI,125,0,COIMBATORE-VARANASI,125,All
2024,6,COIMBATORE,VARANASI,7,0,COIMBATORE-VARANASI,7,All
2024,7,COIMBATORE,VARANASI,16,0,COIMBATORE-VARANASI,16,All
2024,8,COIMBATORE,VARANASI,9,0,COIMBATORE-VARANASI,9,All
2024,9,COIMBATORE,VARANASI,26,0,COIMBATORE-VARANASI,26,All
2024,10,COIMBATORE,VARANASI,35,0,COIMBATORE-VARANASI,35,All
2024,1,COIMBATORE,VISAKHAPATNAM,0,526,COIMBATORE-VISAKHAPATNAM,526,All
2024,2,COIMBATORE,VISAKHAPATNAM,0,645,COIMBATORE-VISAKHAPATNAM,645,All
2024,3,COIMBATORE,VISAKHAPATNAM,0,644,COIMBATORE-VISAKHAPATNAM,644,All
2024,4,COIMBATORE,VISAKHAPATNAM,0,463,COIMBATORE-VISAKHAPATNAM,463,All
2024,6,COIMBATORE,VISAKHAPATNAM,0,639,COIMBATORE-VISAKHAPATNAM,639,All
2024,7,COIMBATORE,VISAKHAPATNAM,0,590,COIMBATORE-VISAKHAPATNAM,590,All
2024,8,COIMBATORE,VISAKHAPATNAM,0,444,COIMBATORE-VISAKHAPATNAM,444,All
2024,9,COIMBATORE,VISAKHAPATNAM,0,215,COIMBATORE-VISAKHAPATNAM,215,All
2024,10,COIMBATORE,VISAKHAPATNAM,0,310,COIMBATORE-VISAKHAPATNAM,310,All
2025,3,COIMBATORE,VISAKHAPATNAM,7,5,COIMBATORE-VISAKHAPATNAM,12,All
2024,1,COOCH BEHAR,KOLKATA,204,205,COOCH BEHAR-KOLKATA,409,All
2024,2,COOCH BEHAR,KOLKATA,205,218,COOCH BEHAR-KOLKATA,423,All
2024,3,COOCH BEHAR,KOLKATA,258,262,COOCH BEHAR-KOLKATA,520,All
2024,4,COOCH BEHAR,KOLKATA,170,177,COOCH BEHAR-KOLKATA,347,All
2024,6,COOCH BEHAR,KOLKATA,209,213,COOCH BEHAR-KOLKATA,422,All
2024,7,COOCH BEHAR,KOLKATA,169,169,COOCH BEHAR-KOLKATA,338,All
2024,8,COOCH BEHAR,KOLKATA,201,168,COOCH BEHAR-KOLKATA,369,All
2024,9,COOCH BEHAR,KOLKATA,212,200,COOCH BEHAR-KOLKATA,412,All
2024,10,COOCH BEHAR,KOLKATA,184,184,COOCH BEHAR-KOLKATA,368,All
2024,11,COOCH BEHAR,KOLKATA,253,243,COOCH BEHAR-KOLKATA,496,All
2024,12,COOCH BEHAR,KOLKATA,263,263,COOCH BEHAR-KOLKATA,526,All
2025,1,COOCH BEHAR,KOLKATA,260,261,COOCH BEHAR-KOLKATA,521,All
2025,2,COOCH BEHAR,KOLKATA,229,232,COOCH BEHAR-KOLKATA,461,All
2025,3,COOCH BEHAR,KOLKATA,261,267,COOCH BEHAR-KOLKATA,528,All
2024,1,Cuddapah,VIJAYAWADA,463,319,Cuddapah-VIJAYAWADA,782,All
2024,2,Cuddapah,VIJAYAWADA,332,245,Cuddapah-VIJAYAWADA,577,All
2024,3,Cuddapah,VIJAYAWADA,267,256,Cuddapah-VIJAYAWADA,523,All
2024,4,Cuddapah,VIJAYAWADA,282,232,Cuddapah-VIJAYAWADA,514,All
2024,6,Cuddapah,VIJAYAWADA,459,304,Cuddapah-VIJAYAWADA,763,All
2024,7,Cuddapah,VIJAYAWADA,388,239,Cuddapah-VIJAYAWADA,627,All
2024,8,Cuddapah,VIJAYAWADA,398,204,Cuddapah-VIJAYAWADA,602,All
2024,9,Cuddapah,VIJAYAWADA,310,235,Cuddapah-VIJAYAWADA,545,All
2024,10,Cuddapah,VIJAYAWADA,522,431,Cuddapah-VIJAYAWADA,953,All
2024,11,Cuddapah,VIJAYAWADA,518,312,Cuddapah-VIJAYAWADA,830,All
2024,12,Cuddapah,VIJAYAWADA,424,238,Cuddapah-VIJAYAWADA,662,All
2025,1,Cuddapah,VIJAYAWADA,399,247,Cuddapah-VIJAYAWADA,646,All
2025,2,Cuddapah,VIJAYAWADA,502,218,Cuddapah-VIJAYAWADA,720,All
2025,3,Cuddapah,VIJAYAWADA,341,220,Cuddapah-VIJAYAWADA,561,All
2024,1,Cuddapah,VISAKHAPATNAM,439,426,Cuddapah-VISAKHAPATNAM,865,All
2024,2,Cuddapah,VISAKHAPATNAM,411,280,Cuddapah-VISAKHAPATNAM,691,All
2024,3,Cuddapah,VISAKHAPATNAM,324,334,Cuddapah-VISAKHAPATNAM,658,All
2024,4,Cuddapah,VISAKHAPATNAM,413,358,Cuddapah-VISAKHAPATNAM,771,All
2024,6,Cuddapah,VISAKHAPATNAM,425,299,Cuddapah-VISAKHAPATNAM,724,All
2024,7,Cuddapah,VISAKHAPATNAM,364,357,Cuddapah-VISAKHAPATNAM,721,All
2024,8,Cuddapah,VISAKHAPATNAM,455,361,Cuddapah-VISAKHAPATNAM,816,All
2024,9,Cuddapah,VISAKHAPATNAM,272,259,Cuddapah-VISAKHAPATNAM,531,All
2024,10,Cuddapah,VISAKHAPATNAM,298,338,Cuddapah-VISAKHAPATNAM,636,All
2024,1,DABOLIM,DELHI,78194,71861,DABOLIM-DELHI,150055,All
2024,2,DABOLIM,DELHI,71502,68760,DABOLIM-DELHI,140262,All
2024,3,DABOLIM,DELHI,75205,73985,DABOLIM-DELHI,149190,All
2024,4,DABOLIM,DELHI,72136,62419,DABOLIM-DELHI,134555,All
2024,6,DABOLIM,DELHI,69536,72377,DABOLIM-DELHI,141913,All
2024,7,DABOLIM,DELHI,58338,54894,DABOLIM-DELHI,113232,All
2024,8,DABOLIM,DELHI,62921,63125,DABOLIM-DELHI,126046,All
2024,9,DABOLIM,DELHI,68130,67121,DABOLIM-DELHI,135251,All
2024,10,DABOLIM,DELHI,67371,58418,DABOLIM-DELHI,125789,All
2024,11,DABOLIM,DELHI,60922,66993,DABOLIM-DELHI,127915,All
2024,12,DABOLIM,DELHI,65319,73085,DABOLIM-DELHI,138404,All
2025,1,DABOLIM,DELHI,73232,68809,DABOLIM-DELHI,142041,All
2025,2,DABOLIM,DELHI,64391,62218,DABOLIM-DELHI,126609,All
2025,3,DABOLIM,DELHI,63052,61658,DABOLIM-DELHI,124710,All
2024,2,DABOLIM,Goa,123,0,DABOLIM-Goa,123,All
2025,3,DABOLIM,HINDON AIRPORT,3671,4118,DABOLIM-HINDON AIRPORT,7789,All
2024,1,DABOLIM,HYDERABAD,38830,37993,DABOLIM-HYDERABAD,76823,All
2024,2,DABOLIM,HYDERABAD,37314,35303,DABOLIM-HYDERABAD,72617,All
2024,3,DABOLIM,HYDERABAD,39447,38133,DABOLIM-HYDERABAD,77580,All
2024,4,DABOLIM,HYDERABAD,32929,31903,DABOLIM-HYDERABAD,64832,All
2024,6,DABOLIM,HYDERABAD,38840,37890,DABOLIM-HYDERABAD,76730,All
2024,7,DABOLIM,HYDERABAD,38673,36894,DABOLIM-HYDERABAD,75567,All
2024,8,DABOLIM,HYDERABAD,36275,37211,DABOLIM-HYDERABAD,73486,All
2024,9,DABOLIM,HYDERABAD,38163,38136,DABOLIM-HYDERABAD,76299,All
2024,10,DABOLIM,HYDERABAD,42882,40732,DABOLIM-HYDERABAD,83614,All
2024,11,DABOLIM,HYDERABAD,38553,40060,DABOLIM-HYDERABAD,78613,All
2024,12,DABOLIM,HYDERABAD,42325,42442,DABOLIM-HYDERABAD,84767,All
2025,1,DABOLIM,HYDERABAD,36631,33596,DABOLIM-HYDERABAD,70227,All
2025,2,DABOLIM,HYDERABAD,34877,32699,DABOLIM-HYDERABAD,67576,All
2025,3,DABOLIM,HYDERABAD,35651,33062,DABOLIM-HYDERABAD,68713,All
2024,1,DABOLIM,INDORE,3766,4066,DABOLIM-INDORE,7832,All
2024,2,DABOLIM,INDORE,3866,3914,DABOLIM-INDORE,7780,All
2024,3,DABOLIM,INDORE,4205,4481,DABOLIM-INDORE,8686,All
2024,4,DABOLIM,INDORE,4410,4500,DABOLIM-INDORE,8910,All
2024,6,DABOLIM,INDORE,4857,4707,DABOLIM-INDORE,9564,All
2024,7,DABOLIM,INDORE,4519,4298,DABOLIM-INDORE,8817,All
2024,8,DABOLIM,INDORE,4456,4349,DABOLIM-INDORE,8805,All
2024,9,DABOLIM,INDORE,4217,4344,DABOLIM-INDORE,8561,All
2024,10,DABOLIM,INDORE,3427,3128,DABOLIM-INDORE,6555,All
2024,11,DABOLIM,INDORE,2977,3640,DABOLIM-INDORE,6617,All
2024,12,DABOLIM,INDORE,2629,3583,DABOLIM-INDORE,6212,All
2025,1,DABOLIM,INDORE,3307,4211,DABOLIM-INDORE,7518,All
2025,2,DABOLIM,INDORE,3967,4193,DABOLIM-INDORE,8160,All
2025,3,DABOLIM,INDORE,4332,4626,DABOLIM-INDORE,8958,All
2024,8,DABOLIM,JAIPUR,5,0,DABOLIM-JAIPUR,5,All
2024,11,DABOLIM,JAIPUR,1969,2518,DABOLIM-JAIPUR,4487,All
2024,12,DABOLIM,JAIPUR,4337,4690,DABOLIM-JAIPUR,9027,All
2025,1,DABOLIM,JAIPUR,5400,4728,DABOLIM-JAIPUR,10128,All
2025,2,DABOLIM,JAIPUR,4896,4455,DABOLIM-JAIPUR,9351,All
2025,3,DABOLIM,JAIPUR,4287,3864,DABOLIM-JAIPUR,8151,All
2024,1,DABOLIM,KOCHI,4918,4531,DABOLIM-KOCHI,9449,All
2024,2,DABOLIM,KOCHI,4300,3968,DABOLIM-KOCHI,8268,All
2024,3,DABOLIM,KOCHI,3906,3547,DABOLIM-KOCHI,7453,All
2024,4,DABOLIM,KOCHI,4275,3889,DABOLIM-KOCHI,8164,All
2024,6,DABOLIM,KOCHI,3713,2917,DABOLIM-KOCHI,6630,All
2024,7,DABOLIM,KOCHI,4162,3418,DABOLIM-KOCHI,7580,All
2024,8,DABOLIM,KOCHI,3905,3962,DABOLIM-KOCHI,7867,All
2024,9,DABOLIM,KOCHI,4165,4180,DABOLIM-KOCHI,8345,All
2024,10,DABOLIM,KOCHI,4196,3952,DABOLIM-KOCHI,8148,All
2024,11,DABOLIM,KOCHI,4775,5015,DABOLIM-KOCHI,9790,All
2024,12,DABOLIM,KOCHI,4996,4926,DABOLIM-KOCHI,9922,All
2025,1,DABOLIM,KOCHI,4998,4936,DABOLIM-KOCHI,9934,All
2025,2,DABOLIM,KOCHI,4458,4426,DABOLIM-KOCHI,8884,All
2025,3,DABOLIM,KOCHI,4085,3952,DABOLIM-KOCHI,8037,All
2024,1,DABOLIM,KOLKATA,6261,5802,DABOLIM-KOLKATA,12063,All
2024,2,DABOLIM,KOLKATA,5819,5437,DABOLIM-KOLKATA,11256,All
2024,3,DABOLIM,KOLKATA,6151,5826,DABOLIM-KOLKATA,11977,All
2024,4,DABOLIM,KOLKATA,4876,4509,DABOLIM-KOLKATA,9385,All
2024,6,DABOLIM,KOLKATA,4785,4730,DABOLIM-KOLKATA,9515,All
2024,7,DABOLIM,KOLKATA,4065,5090,DABOLIM-KOLKATA,9155,All
2024,8,DABOLIM,KOLKATA,4330,4725,DABOLIM-KOLKATA,9055,All
2024,9,DABOLIM,KOLKATA,5465,5540,DABOLIM-KOLKATA,11005,All
2024,10,DABOLIM,KOLKATA,6256,5134,DABOLIM-KOLKATA,11390,All
2024,11,DABOLIM,KOLKATA,4099,4954,DABOLIM-KOLKATA,9053,All
2024,12,DABOLIM,KOLKATA,5174,5026,DABOLIM-KOLKATA,10200,All
2025,1,DABOLIM,KOLKATA,6040,5537,DABOLIM-KOLKATA,11577,All
2025,2,DABOLIM,KOLKATA,4665,4452,DABOLIM-KOLKATA,9117,All
2025,3,DABOLIM,KOLKATA,5479,4609,DABOLIM-KOLKATA,10088,All
2024,1,DABOLIM,LUCKNOW,5319,5294,DABOLIM-LUCKNOW,10613,All
2024,2,DABOLIM,LUCKNOW,4950,4814,DABOLIM-LUCKNOW,9764,All
2024,3,DABOLIM,LUCKNOW,5092,4882,DABOLIM-LUCKNOW,9974,All
2024,4,DABOLIM,LUCKNOW,5161,4653,DABOLIM-LUCKNOW,9814,All
2024,6,DABOLIM,LUCKNOW,4846,5021,DABOLIM-LUCKNOW,9867,All
2024,7,DABOLIM,LUCKNOW,4603,4763,DABOLIM-LUCKNOW,9366,All
2024,8,DABOLIM,LUCKNOW,4883,5180,DABOLIM-LUCKNOW,10063,All
2024,9,DABOLIM,LUCKNOW,4845,4787,DABOLIM-LUCKNOW,9632,All
2024,10,DABOLIM,LUCKNOW,4741,3106,DABOLIM-LUCKNOW,7847,All
2024,11,DABOLIM,LUCKNOW,4967,5101,DABOLIM-LUCKNOW,10068,All
2024,12,DABOLIM,LUCKNOW,5078,5356,DABOLIM-LUCKNOW,10434,All
2025,1,DABOLIM,LUCKNOW,5265,4737,DABOLIM-LUCKNOW,10002,All
2025,2,DABOLIM,LUCKNOW,4781,4565,DABOLIM-LUCKNOW,9346,All
2025,3,DABOLIM,LUCKNOW,4581,120,DABOLIM-LUCKNOW,4701,All
2024,1,DABOLIM,MUMBAI,66761,64087,DABOLIM-MUMBAI,130848,All
2024,2,DABOLIM,MUMBAI,58620,58275,DABOLIM-MUMBAI,116895,All
2024,3,DABOLIM,MUMBAI,60143,59813,DABOLIM-MUMBAI,119956,All
2024,4,DABOLIM,MUMBAI,56271,57709,DABOLIM-MUMBAI,113980,All
2024,6,DABOLIM,MUMBAI,60327,56762,DABOLIM-MUMBAI,117089,All
2024,7,DABOLIM,MUMBAI,54588,53998,DABOLIM-MUMBAI,108586,All
2024,8,DABOLIM,MUMBAI,57385,58116,DABOLIM-MUMBAI,115501,All
2024,9,DABOLIM,MUMBAI,65403,66020,DABOLIM-MUMBAI,131423,All
2024,10,DABOLIM,MUMBAI,62674,64567,DABOLIM-MUMBAI,127241,All
2024,11,DABOLIM,MUMBAI,64898,65566,DABOLIM-MUMBAI,130464,All
2024,12,DABOLIM,MUMBAI,62554,65228,DABOLIM-MUMBAI,127782,All
2025,1,DABOLIM,MUMBAI,70044,69814,DABOLIM-MUMBAI,139858,All
2025,2,DABOLIM,MUMBAI,65213,65688,DABOLIM-MUMBAI,130901,All
2025,3,DABOLIM,MUMBAI,66163,64000,DABOLIM-MUMBAI,130163,All
2024,10,DABOLIM,NAGPUR,102,50,DABOLIM-NAGPUR,152,All
2024,11,DABOLIM,NAGPUR,1815,2001,DABOLIM-NAGPUR,3816,All
2024,12,DABOLIM,NAGPUR,5954,6213,DABOLIM-NAGPUR,12167,All
2025,1,DABOLIM,NAGPUR,5406,5292,DABOLIM-NAGPUR,10698,All
2025,2,DABOLIM,NAGPUR,4672,4871,DABOLIM-NAGPUR,9543,All
2025,3,DABOLIM,NAGPUR,5372,5169,DABOLIM-NAGPUR,10541,All
2024,10,DABOLIM,NASIK,144,143,DABOLIM-NASIK,287,All
2024,11,DABOLIM,NASIK,659,770,DABOLIM-NASIK,1429,All
2024,12,DABOLIM,NASIK,854,862,DABOLIM-NASIK,1716,All
2025,1,DABOLIM,NASIK,791,858,DABOLIM-NASIK,1649,All
2025,2,DABOLIM,NASIK,826,870,DABOLIM-NASIK,1696,All
2025,3,DABOLIM,NASIK,913,788,DABOLIM-NASIK,1701,All
2024,2,DABOLIM,PUNE,428,451,DABOLIM-PUNE,879,All
2024,3,DABOLIM,PUNE,3349,3463,DABOLIM-PUNE,6812,All
2024,6,DABOLIM,PUNE,4176,3811,DABOLIM-PUNE,7987,All
2024,7,DABOLIM,PUNE,4343,4411,DABOLIM-PUNE,8754,All
2024,8,DABOLIM,PUNE,4343,4459,DABOLIM-PUNE,8802,All
2024,9,DABOLIM,PUNE,4293,4417,DABOLIM-PUNE,8710,All
2024,10,DABOLIM,PUNE,3541,3454,DABOLIM-PUNE,6995,All
2024,11,DABOLIM,PUNE,1312,1323,DABOLIM-PUNE,2635,All
2024,12,DABOLIM,PUNE,10884,11220,DABOLIM-PUNE,22104,All
2025,1,DABOLIM,PUNE,11254,10264,DABOLIM-PUNE,21518,All
2025,2,DABOLIM,PUNE,7967,7912,DABOLIM-PUNE,15879,All
2025,3,DABOLIM,PUNE,5351,5062,DABOLIM-PUNE,10413,All
2024,1,DABOLIM,RAIPUR,5875,5905,DABOLIM-RAIPUR,11780,All
2024,2,DABOLIM,RAIPUR,5381,5370,DABOLIM-RAIPUR,10751,All
2024,3,DABOLIM,RAIPUR,5681,5489,DABOLIM-RAIPUR,11170,All
2024,4,DABOLIM,RAIPUR,5010,4456,DABOLIM-RAIPUR,9466,All
2024,6,DABOLIM,RAIPUR,4982,5188,DABOLIM-RAIPUR,10170,All
2024,7,DABOLIM,RAIPUR,4353,4040,DABOLIM-RAIPUR,8393,All
2024,8,DABOLIM,RAIPUR,4687,5009,DABOLIM-RAIPUR,9696,All
2024,9,DABOLIM,RAIPUR,5218,5027,DABOLIM-RAIPUR,10245,All
2024,10,DABOLIM,RAIPUR,6115,4601,DABOLIM-RAIPUR,10716,All
2024,11,DABOLIM,RAIPUR,6379,6146,DABOLIM-RAIPUR,12525,All
2024,12,DABOLIM,RAIPUR,7661,6776,DABOLIM-RAIPUR,14437,All
2025,1,DABOLIM,RAIPUR,4824,4577,DABOLIM-RAIPUR,9401,All
2025,2,DABOLIM,RAIPUR,4332,4016,DABOLIM-RAIPUR,8348,All
2025,3,DABOLIM,RAIPUR,6115,5424,DABOLIM-RAIPUR,11539,All
2024,1,DABOLIM,SURAT,6204,5029,DABOLIM-SURAT,11233,All
2024,2,DABOLIM,SURAT,5577,4734,DABOLIM-SURAT,10311,All
2024,3,DABOLIM,SURAT,5383,4380,DABOLIM-SURAT,9763,All
2024,4,DABOLIM,SURAT,5172,4130,DABOLIM-SURAT,9302,All
2024,6,DABOLIM,SURAT,6192,4961,DABOLIM-SURAT,11153,All
2024,7,DABOLIM,SURAT,6070,5247,DABOLIM-SURAT,11317,All
2024,8,DABOLIM,SURAT,5886,5699,DABOLIM-SURAT,11585,All
2024,9,DABOLIM,SURAT,5929,5861,DABOLIM-SURAT,11790,All
2024,10,DABOLIM,SURAT,4519,3947,DABOLIM-SURAT,8466,All
2024,11,DABOLIM,SURAT,5884,5429,DABOLIM-SURAT,11313,All
2024,12,DABOLIM,SURAT,5517,5472,DABOLIM-SURAT,10989,All
2025,1,DABOLIM,SURAT,6028,5563,DABOLIM-SURAT,11591,All
2025,2,DABOLIM,SURAT,5060,4787,DABOLIM-SURAT,9847,All
2025,3,DABOLIM,SURAT,5517,4469,DABOLIM-SURAT,9986,All
2024,2,DARBHANGA,Ayodhya International Airport ,786,566,Ayodhya International Airport -DARBHANGA,1352,All
2024,1,DARBHANGA,DELHI,4241,4427,DARBHANGA-DELHI,8668,All
2024,2,DARBHANGA,DELHI,4899,4896,DARBHANGA-DELHI,9795,All
2024,3,DARBHANGA,DELHI,5995,6012,DARBHANGA-DELHI,12007,All
2024,4,DARBHANGA,DELHI,9631,10216,DARBHANGA-DELHI,19847,All
2024,6,DARBHANGA,DELHI,9466,9596,DARBHANGA-DELHI,19062,All
2024,7,DARBHANGA,DELHI,8556,8084,DARBHANGA-DELHI,16640,All
2024,8,DARBHANGA,DELHI,6939,7123,DARBHANGA-DELHI,14062,All
2024,9,DARBHANGA,DELHI,6204,7009,DARBHANGA-DELHI,13213,All
2024,10,DARBHANGA,DELHI,5890,8811,DARBHANGA-DELHI,14701,All
2024,11,DARBHANGA,DELHI,7882,8707,DARBHANGA-DELHI,16589,All
2024,12,DARBHANGA,DELHI,9965,10146,DARBHANGA-DELHI,20111,All
2025,1,DARBHANGA,DELHI,5509,5792,DARBHANGA-DELHI,11301,All
2025,2,DARBHANGA,DELHI,8197,8437,DARBHANGA-DELHI,16634,All
2025,3,DARBHANGA,DELHI,13684,14713,DARBHANGA-DELHI,28397,All
2024,1,DARBHANGA,HYDERABAD,2951,3173,DARBHANGA-HYDERABAD,6124,All
2024,2,DARBHANGA,HYDERABAD,3808,4315,DARBHANGA-HYDERABAD,8123,All
2024,3,DARBHANGA,HYDERABAD,4586,5022,DARBHANGA-HYDERABAD,9608,All
2024,4,DARBHANGA,HYDERABAD,4390,4999,DARBHANGA-HYDERABAD,9389,All
2024,6,DARBHANGA,HYDERABAD,4472,4468,DARBHANGA-HYDERABAD,8940,All
2024,7,DARBHANGA,HYDERABAD,4834,4536,DARBHANGA-HYDERABAD,9370,All
2024,8,DARBHANGA,HYDERABAD,4618,4528,DARBHANGA-HYDERABAD,9146,All
2024,9,DARBHANGA,HYDERABAD,4430,4618,DARBHANGA-HYDERABAD,9048,All
2024,10,DARBHANGA,HYDERABAD,3809,4909,DARBHANGA-HYDERABAD,8718,All
2024,11,DARBHANGA,HYDERABAD,4553,4881,DARBHANGA-HYDERABAD,9434,All
2024,12,DARBHANGA,HYDERABAD,4880,4244,DARBHANGA-HYDERABAD,9124,All
2025,1,DARBHANGA,HYDERABAD,2696,2691,DARBHANGA-HYDERABAD,5387,All
2025,2,DARBHANGA,HYDERABAD,4116,4634,DARBHANGA-HYDERABAD,8750,All
2025,3,DARBHANGA,HYDERABAD,4726,6010,DARBHANGA-HYDERABAD,10736,All
2024,1,DARBHANGA,KOLKATA,1515,1843,DARBHANGA-KOLKATA,3358,All
2024,2,DARBHANGA,KOLKATA,3294,4302,DARBHANGA-KOLKATA,7596,All
2024,3,DARBHANGA,KOLKATA,4238,5074,DARBHANGA-KOLKATA,9312,All
2024,4,DARBHANGA,KOLKATA,1991,2192,DARBHANGA-KOLKATA,4183,All
2024,6,DARBHANGA,KOLKATA,1919,1936,DARBHANGA-KOLKATA,3855,All
2024,7,DARBHANGA,KOLKATA,1798,1972,DARBHANGA-KOLKATA,3770,All
2024,8,DARBHANGA,KOLKATA,1552,1811,DARBHANGA-KOLKATA,3363,All
2024,9,DARBHANGA,KOLKATA,1576,1863,DARBHANGA-KOLKATA,3439,All
2024,10,DARBHANGA,KOLKATA,1167,1752,DARBHANGA-KOLKATA,2919,All
2024,11,DARBHANGA,KOLKATA,1658,1751,DARBHANGA-KOLKATA,3409,All
2024,12,DARBHANGA,KOLKATA,1897,1629,DARBHANGA-KOLKATA,3526,All
2025,1,DARBHANGA,KOLKATA,779,818,DARBHANGA-KOLKATA,1597,All
2025,2,DARBHANGA,KOLKATA,1653,1849,DARBHANGA-KOLKATA,3502,All
2025,3,DARBHANGA,KOLKATA,2007,2168,DARBHANGA-KOLKATA,4175,All
2024,1,DARBHANGA,MUMBAI,1890,1890,DARBHANGA-MUMBAI,3780,All
2024,2,DARBHANGA,MUMBAI,4615,4683,DARBHANGA-MUMBAI,9298,All
2024,3,DARBHANGA,MUMBAI,3827,3942,DARBHANGA-MUMBAI,7769,All
2024,4,DARBHANGA,MUMBAI,4778,5481,DARBHANGA-MUMBAI,10259,All
2024,6,DARBHANGA,MUMBAI,5519,5139,DARBHANGA-MUMBAI,10658,All
2024,7,DARBHANGA,MUMBAI,4146,3575,DARBHANGA-MUMBAI,7721,All
2024,8,DARBHANGA,MUMBAI,4089,3623,DARBHANGA-MUMBAI,7712,All
2024,9,DARBHANGA,MUMBAI,3203,4052,DARBHANGA-MUMBAI,7255,All
2024,10,DARBHANGA,MUMBAI,2869,5310,DARBHANGA-MUMBAI,8179,All
2024,11,DARBHANGA,MUMBAI,4090,4692,DARBHANGA-MUMBAI,8782,All
2024,12,DARBHANGA,MUMBAI,8430,8329,DARBHANGA-MUMBAI,16759,All
2025,1,DARBHANGA,MUMBAI,4457,4598,DARBHANGA-MUMBAI,9055,All
2025,2,DARBHANGA,MUMBAI,5292,5747,DARBHANGA-MUMBAI,11039,All
2025,3,DARBHANGA,MUMBAI,7858,8561,DARBHANGA-MUMBAI,16419,All
2025,3,DARBHANGA,SRINAGAR,11,2,DARBHANGA-SRINAGAR,13,All
2024,1,DELHI,Ayodhya International Airport ,6441,5608,Ayodhya International Airport -DELHI,12049,All
2024,2,DELHI,Ayodhya International Airport ,16800,16272,Ayodhya International Airport -DELHI,33072,All
2024,3,DELHI,Ayodhya International Airport ,20269,19511,Ayodhya International Airport -DELHI,39780,All
2024,4,DELHI,Ayodhya International Airport ,19483,17448,Ayodhya International Airport -DELHI,36931,All
2024,6,DELHI,Ayodhya International Airport ,18756,18837,Ayodhya International Airport -DELHI,37593,All
2024,7,DELHI,Ayodhya International Airport ,16005,16868,Ayodhya International Airport -DELHI,32873,All
2024,8,DELHI,Ayodhya International Airport ,14874,15113,Ayodhya International Airport -DELHI,29987,All
2024,9,DELHI,Ayodhya International Airport ,16017,16033,Ayodhya International Airport -DELHI,32050,All
2024,10,DELHI,Ayodhya International Airport ,18331,15677,Ayodhya International Airport -DELHI,34008,All
2024,11,DELHI,Ayodhya International Airport ,17018,16747,Ayodhya International Airport -DELHI,33765,All
2024,12,DELHI,Ayodhya International Airport ,17688,18321,Ayodhya International Airport -DELHI,36009,All
2025,1,DELHI,Ayodhya International Airport ,14062,14036,Ayodhya International Airport -DELHI,28098,All
2025,2,DELHI,Ayodhya International Airport ,11800,12343,Ayodhya International Airport -DELHI,24143,All
2025,3,DELHI,Ayodhya International Airport ,18320,16810,Ayodhya International Airport -DELHI,35130,All
2024,1,DELHI,DHARAMSALA,6830,6269,DELHI-DHARAMSALA,13099,All
2024,2,DELHI,DHARAMSALA,7472,6390,DELHI-DHARAMSALA,13862,All
2024,3,DELHI,DHARAMSALA,9151,7629,DELHI-DHARAMSALA,16780,All
2024,4,DELHI,DHARAMSALA,10576,8189,DELHI-DHARAMSALA,18765,All
2024,6,DELHI,DHARAMSALA,10780,7357,DELHI-DHARAMSALA,18137,All
2024,7,DELHI,DHARAMSALA,8594,6713,DELHI-DHARAMSALA,15307,All
2024,8,DELHI,DHARAMSALA,7360,5843,DELHI-DHARAMSALA,13203,All
2024,9,DELHI,DHARAMSALA,8205,6222,DELHI-DHARAMSALA,14427,All
2024,10,DELHI,DHARAMSALA,9410,7760,DELHI-DHARAMSALA,17170,All
2024,11,DELHI,DHARAMSALA,7530,6259,DELHI-DHARAMSALA,13789,All
2024,12,DELHI,DHARAMSALA,7187,5838,DELHI-DHARAMSALA,13025,All
2025,1,DELHI,DHARAMSALA,5565,4904,DELHI-DHARAMSALA,10469,All
2025,2,DELHI,DHARAMSALA,4514,4064,DELHI-DHARAMSALA,8578,All
2025,3,DELHI,DHARAMSALA,7575,6213,DELHI-DHARAMSALA,13788,All
2024,1,DELHI,DIBRUGARH,8802,8858,DELHI-DIBRUGARH,17660,All
2024,2,DELHI,DIBRUGARH,9663,9163,DELHI-DIBRUGARH,18826,All
2024,3,DELHI,DIBRUGARH,10575,10342,DELHI-DIBRUGARH,20917,All
2024,4,DELHI,DIBRUGARH,10353,9842,DELHI-DIBRUGARH,20195,All
2024,6,DELHI,DIBRUGARH,10054,9298,DELHI-DIBRUGARH,19352,All
2024,7,DELHI,DIBRUGARH,10016,10473,DELHI-DIBRUGARH,20489,All
2024,8,DELHI,DIBRUGARH,9386,9567,DELHI-DIBRUGARH,18953,All
2024,9,DELHI,DIBRUGARH,9541,8351,DELHI-DIBRUGARH,17892,All
2024,10,DELHI,DIBRUGARH,10554,10113,DELHI-DIBRUGARH,20667,All
2024,11,DELHI,DIBRUGARH,11726,10376,DELHI-DIBRUGARH,22102,All
2024,12,DELHI,DIBRUGARH,10673,9554,DELHI-DIBRUGARH,20227,All
2025,1,DELHI,DIBRUGARH,8843,9373,DELHI-DIBRUGARH,18216,All
2025,2,DELHI,DIBRUGARH,9453,9153,DELHI-DIBRUGARH,18606,All
2025,3,DELHI,DIBRUGARH,10275,9500,DELHI-DIBRUGARH,19775,All
2024,1,DELHI,DIMAPUR,3414,3479,DELHI-DIMAPUR,6893,All
2024,2,DELHI,DIMAPUR,3262,3250,DELHI-DIMAPUR,6512,All
2024,3,DELHI,DIMAPUR,3903,3789,DELHI-DIMAPUR,7692,All
2024,4,DELHI,DIMAPUR,3632,3430,DELHI-DIMAPUR,7062,All
2024,6,DELHI,DIMAPUR,3583,3450,DELHI-DIMAPUR,7033,All
2024,7,DELHI,DIMAPUR,3646,3816,DELHI-DIMAPUR,7462,All
2024,8,DELHI,DIMAPUR,3507,3491,DELHI-DIMAPUR,6998,All
2024,9,DELHI,DIMAPUR,3468,3339,DELHI-DIMAPUR,6807,All
2024,10,DELHI,DIMAPUR,5035,4721,DELHI-DIMAPUR,9756,All
2024,11,DELHI,DIMAPUR,5058,4866,DELHI-DIMAPUR,9924,All
2024,12,DELHI,DIMAPUR,5426,4829,DELHI-DIMAPUR,10255,All
2025,1,DELHI,DIMAPUR,4851,5338,DELHI-DIMAPUR,10189,All
2025,2,DELHI,DIMAPUR,4652,4708,DELHI-DIMAPUR,9360,All
2025,3,DELHI,DIMAPUR,5043,4784,DELHI-DIMAPUR,9827,All
2024,1,DELHI,DURGAPUR,5060,4928,DELHI-DURGAPUR,9988,All
2024,2,DELHI,DURGAPUR,4201,4185,DELHI-DURGAPUR,8386,All
2024,3,DELHI,DURGAPUR,4792,4696,DELHI-DURGAPUR,9488,All
2024,4,DELHI,DURGAPUR,4959,4358,DELHI-DURGAPUR,9317,All
2024,6,DELHI,DURGAPUR,5860,4404,DELHI-DURGAPUR,10264,All
2024,7,DELHI,DURGAPUR,5273,5548,DELHI-DURGAPUR,10821,All
2024,8,DELHI,DURGAPUR,4805,4599,DELHI-DURGAPUR,9404,All
2024,9,DELHI,DURGAPUR,4941,4028,DELHI-DURGAPUR,8969,All
2024,10,DELHI,DURGAPUR,9590,7257,DELHI-DURGAPUR,16847,All
2024,11,DELHI,DURGAPUR,5212,4945,DELHI-DURGAPUR,10157,All
2024,12,DELHI,DURGAPUR,5376,4783,DELHI-DURGAPUR,10159,All
2025,1,DELHI,DURGAPUR,4945,4785,DELHI-DURGAPUR,9730,All
2025,2,DELHI,DURGAPUR,4821,4821,DELHI-DURGAPUR,9642,All
2025,3,DELHI,DURGAPUR,5101,5109,DELHI-DURGAPUR,10210,All
2024,1,DELHI,Deoghar ,2299,2109,DELHI-Deoghar ,4408,All
2024,2,DELHI,Deoghar ,4091,4077,DELHI-Deoghar ,8168,All
2024,3,DELHI,Deoghar ,5544,5375,DELHI-Deoghar ,10919,All
2024,4,DELHI,Deoghar ,5343,5145,DELHI-Deoghar ,10488,All
2024,6,DELHI,Deoghar ,5145,4549,DELHI-Deoghar ,9694,All
2024,7,DELHI,Deoghar ,4861,5302,DELHI-Deoghar ,10163,All
2024,8,DELHI,Deoghar ,4948,5055,DELHI-Deoghar ,10003,All
2024,9,DELHI,Deoghar ,5091,5022,DELHI-Deoghar ,10113,All
2024,10,DELHI,Deoghar ,5458,4668,DELHI-Deoghar ,10126,All
2024,11,DELHI,Deoghar ,5277,5143,DELHI-Deoghar ,10420,All
2024,12,DELHI,Deoghar ,5676,5496,DELHI-Deoghar ,11172,All
2025,1,DELHI,Deoghar ,5533,5632,DELHI-Deoghar ,11165,All
2025,2,DELHI,Deoghar ,5219,5221,DELHI-Deoghar ,10440,All
2025,3,DELHI,Deoghar ,5330,5261,DELHI-Deoghar ,10591,All
2024,1,DELHI,GAYA,4873,4940,DELHI-GAYA,9813,All
2024,2,DELHI,GAYA,4674,4511,DELHI-GAYA,9185,All
2024,3,DELHI,GAYA,5131,4725,DELHI-GAYA,9856,All
2024,4,DELHI,GAYA,5070,4527,DELHI-GAYA,9597,All
2024,6,DELHI,GAYA,5249,4699,DELHI-GAYA,9948,All
2024,7,DELHI,GAYA,4747,5184,DELHI-GAYA,9931,All
2024,8,DELHI,GAYA,4729,4846,DELHI-GAYA,9575,All
2024,9,DELHI,GAYA,4663,4438,DELHI-GAYA,9101,All
2024,10,DELHI,GAYA,5254,4456,DELHI-GAYA,9710,All
2024,11,DELHI,GAYA,5160,4914,DELHI-GAYA,10074,All
2024,12,DELHI,GAYA,5447,5266,DELHI-GAYA,10713,All
2025,1,DELHI,GAYA,4737,4827,DELHI-GAYA,9564,All
2025,2,DELHI,GAYA,4773,4834,DELHI-GAYA,9607,All
2025,3,DELHI,GAYA,5206,5140,DELHI-GAYA,10346,All
2024,1,DELHI,GORAKHPUR,12843,12629,DELHI-GORAKHPUR,25472,All
2024,2,DELHI,GORAKHPUR,9978,9426,DELHI-GORAKHPUR,19404,All
2024,3,DELHI,GORAKHPUR,10849,9521,DELHI-GORAKHPUR,20370,All
2024,4,DELHI,GORAKHPUR,11638,10623,DELHI-GORAKHPUR,22261,All
2024,6,DELHI,GORAKHPUR,14858,14361,DELHI-GORAKHPUR,29219,All
2024,7,DELHI,GORAKHPUR,14173,14509,DELHI-GORAKHPUR,28682,All
2024,8,DELHI,GORAKHPUR,13715,13816,DELHI-GORAKHPUR,27531,All
2024,9,DELHI,GORAKHPUR,14191,12931,DELHI-GORAKHPUR,27122,All
2024,10,DELHI,GORAKHPUR,16193,13021,DELHI-GORAKHPUR,29214,All
2024,11,DELHI,GORAKHPUR,17210,15926,DELHI-GORAKHPUR,33136,All
2024,12,DELHI,GORAKHPUR,19165,18626,DELHI-GORAKHPUR,37791,All
2025,1,DELHI,GORAKHPUR,17919,17025,DELHI-GORAKHPUR,34944,All
2025,2,DELHI,GORAKHPUR,17107,16237,DELHI-GORAKHPUR,33344,All
2025,3,DELHI,GORAKHPUR,22750,21092,DELHI-GORAKHPUR,43842,All
2024,1,DELHI,GUWAHATI,63194,65812,DELHI-GUWAHATI,129006,All
2024,2,DELHI,GUWAHATI,61836,62535,DELHI-GUWAHATI,124371,All
2024,3,DELHI,GUWAHATI,65945,63530,DELHI-GUWAHATI,129475,All
2024,4,DELHI,GUWAHATI,67932,62532,DELHI-GUWAHATI,130464,All
2024,6,DELHI,GUWAHATI,66172,62392,DELHI-GUWAHATI,128564,All
2024,7,DELHI,GUWAHATI,64085,65140,DELHI-GUWAHATI,129225,All
2024,8,DELHI,GUWAHATI,59721,61488,DELHI-GUWAHATI,121209,All
2024,9,DELHI,GUWAHATI,61688,56394,DELHI-GUWAHATI,118082,All
2024,10,DELHI,GUWAHATI,66246,64859,DELHI-GUWAHATI,131105,All
2024,11,DELHI,GUWAHATI,65523,63956,DELHI-GUWAHATI,129479,All
2024,12,DELHI,GUWAHATI,71432,66018,DELHI-GUWAHATI,137450,All
2025,1,DELHI,GUWAHATI,65528,68780,DELHI-GUWAHATI,134308,All
2025,2,DELHI,GUWAHATI,61255,60745,DELHI-GUWAHATI,122000,All
2025,3,DELHI,GUWAHATI,68842,64457,DELHI-GUWAHATI,133299,All
2024,1,DELHI,GWALIOR,4012,3697,DELHI-GWALIOR,7709,All
2024,2,DELHI,GWALIOR,5387,6363,DELHI-GWALIOR,11750,All
2024,3,DELHI,GWALIOR,5887,6117,DELHI-GWALIOR,12004,All
2024,4,DELHI,GWALIOR,4970,6329,DELHI-GWALIOR,11299,All
2024,6,DELHI,GWALIOR,8847,7504,DELHI-GWALIOR,16351,All
2024,7,DELHI,GWALIOR,6938,6434,DELHI-GWALIOR,13372,All
2024,8,DELHI,GWALIOR,7720,6975,DELHI-GWALIOR,14695,All
2024,9,DELHI,GWALIOR,7152,6844,DELHI-GWALIOR,13996,All
2024,10,DELHI,GWALIOR,6480,5570,DELHI-GWALIOR,12050,All
2024,11,DELHI,GWALIOR,4311,5062,DELHI-GWALIOR,9373,All
2024,12,DELHI,GWALIOR,4696,4743,DELHI-GWALIOR,9439,All
2025,1,DELHI,GWALIOR,3407,3383,DELHI-GWALIOR,6790,All
2025,2,DELHI,GWALIOR,4107,4253,DELHI-GWALIOR,8360,All
2025,3,DELHI,GWALIOR,4809,4747,DELHI-GWALIOR,9556,All
2024,1,DELHI,Goa,48933,46039,DELHI-Goa,94972,All
2024,2,DELHI,Goa,41506,42380,DELHI-Goa,83886,All
2024,3,DELHI,Goa,43829,45256,DELHI-Goa,89085,All
2024,4,DELHI,Goa,26172,29482,DELHI-Goa,55654,All
2024,6,DELHI,Goa,40474,38175,DELHI-Goa,78649,All
2024,7,DELHI,Goa,33221,34544,DELHI-Goa,67765,All
2024,8,DELHI,Goa,36925,35602,DELHI-Goa,72527,All
2024,9,DELHI,Goa,38557,39097,DELHI-Goa,77654,All
2024,10,DELHI,Goa,33656,40272,DELHI-Goa,73928,All
2024,11,DELHI,Goa,46341,42057,DELHI-Goa,88398,All
2024,12,DELHI,Goa,53353,49521,DELHI-Goa,102874,All
2025,1,DELHI,Goa,54132,57872,DELHI-Goa,112004,All
2025,2,DELHI,Goa,50219,52841,DELHI-Goa,103060,All
2025,3,DELHI,Goa,53722,54897,DELHI-Goa,108619,All
2024,1,DELHI,HUBLI,5228,4493,DELHI-HUBLI,9721,All
2024,2,DELHI,HUBLI,4506,4252,DELHI-HUBLI,8758,All
2024,3,DELHI,HUBLI,4199,4026,DELHI-HUBLI,8225,All
2024,4,DELHI,HUBLI,4319,4199,DELHI-HUBLI,8518,All
2024,6,DELHI,HUBLI,4955,3698,DELHI-HUBLI,8653,All
2024,7,DELHI,HUBLI,4107,4124,DELHI-HUBLI,8231,All
2024,8,DELHI,HUBLI,3613,3873,DELHI-HUBLI,7486,All
2024,9,DELHI,HUBLI,3668,4011,DELHI-HUBLI,7679,All
2024,10,DELHI,HUBLI,4279,4982,DELHI-HUBLI,9261,All
2024,11,DELHI,HUBLI,4947,4501,DELHI-HUBLI,9448,All
2024,12,DELHI,HUBLI,5127,4847,DELHI-HUBLI,9974,All
2025,1,DELHI,HUBLI,4405,4490,DELHI-HUBLI,8895,All
2025,2,DELHI,HUBLI,4681,4767,DELHI-HUBLI,9448,All
2025,3,DELHI,HUBLI,4811,4724,DELHI-HUBLI,9535,All
2024,1,DELHI,HYDERABAD,125954,131108,DELHI-HYDERABAD,257062,All
2024,2,DELHI,HYDERABAD,127583,132845,DELHI-HYDERABAD,260428,All
2024,3,DELHI,HYDERABAD,136046,138489,DELHI-HYDERABAD,274535,All
2024,4,DELHI,HYDERABAD,123479,137642,DELHI-HYDERABAD,261121,All
2024,6,DELHI,HYDERABAD,143661,129569,DELHI-HYDERABAD,273230,All
2024,7,DELHI,HYDERABAD,145674,142694,DELHI-HYDERABAD,288368,All
2024,8,DELHI,HYDERABAD,136422,147330,DELHI-HYDERABAD,283752,All
2024,9,DELHI,HYDERABAD,123034,133886,DELHI-HYDERABAD,256920,All
2024,10,DELHI,HYDERABAD,126055,142602,DELHI-HYDERABAD,268657,All
2024,11,DELHI,HYDERABAD,147397,139733,DELHI-HYDERABAD,287130,All
2024,12,DELHI,HYDERABAD,146637,134591,DELHI-HYDERABAD,281228,All
2025,1,DELHI,HYDERABAD,127462,130615,DELHI-HYDERABAD,258077,All
2025,2,DELHI,HYDERABAD,131586,137712,DELHI-HYDERABAD,269298,All
2025,3,DELHI,HYDERABAD,140650,139203,DELHI-HYDERABAD,279853,All
2024,1,DELHI,IMPHAL,7719,8012,DELHI-IMPHAL,15731,All
2024,2,DELHI,IMPHAL,7227,6685,DELHI-IMPHAL,13912,All
2024,3,DELHI,IMPHAL,7244,6919,DELHI-IMPHAL,14163,All
2024,4,DELHI,IMPHAL,7023,6441,DELHI-IMPHAL,13464,All
2024,6,DELHI,IMPHAL,8167,7167,DELHI-IMPHAL,15334,All
2024,7,DELHI,IMPHAL,7756,8604,DELHI-IMPHAL,16360,All
2024,8,DELHI,IMPHAL,8157,9245,DELHI-IMPHAL,17402,All
2024,9,DELHI,IMPHAL,7485,7810,DELHI-IMPHAL,15295,All
2024,10,DELHI,IMPHAL,7072,6410,DELHI-IMPHAL,13482,All
2024,11,DELHI,IMPHAL,8795,8194,DELHI-IMPHAL,16989,All
2024,12,DELHI,IMPHAL,8379,7381,DELHI-IMPHAL,15760,All
2025,1,DELHI,IMPHAL,6783,6772,DELHI-IMPHAL,13555,All
2025,2,DELHI,IMPHAL,8068,8332,DELHI-IMPHAL,16400,All
2025,3,DELHI,IMPHAL,10530,10109,DELHI-IMPHAL,20639,All
2024,1,DELHI,INDORE,35305,34948,DELHI-INDORE,70253,All
2024,2,DELHI,INDORE,35392,36331,DELHI-INDORE,71723,All
2024,3,DELHI,INDORE,39730,39799,DELHI-INDORE,79529,All
2024,4,DELHI,INDORE,34419,34987,DELHI-INDORE,69406,All
2024,6,DELHI,INDORE,34958,32844,DELHI-INDORE,67802,All
2024,7,DELHI,INDORE,37393,37983,DELHI-INDORE,75376,All
2024,8,DELHI,INDORE,38289,39077,DELHI-INDORE,77366,All
2024,9,DELHI,INDORE,38228,39655,DELHI-INDORE,77883,All
2024,10,DELHI,INDORE,38807,38105,DELHI-INDORE,76912,All
2024,11,DELHI,INDORE,40828,40386,DELHI-INDORE,81214,All
2024,12,DELHI,INDORE,45799,42247,DELHI-INDORE,88046,All
2025,1,DELHI,INDORE,40145,42688,DELHI-INDORE,82833,All
2025,2,DELHI,INDORE,37445,39569,DELHI-INDORE,77014,All
2025,3,DELHI,INDORE,42275,42875,DELHI-INDORE,85150,All
2024,1,DELHI,Itanagar,2224,2315,DELHI-Itanagar,4539,All
2024,2,DELHI,Itanagar,2726,2751,DELHI-Itanagar,5477,All
2024,3,DELHI,Itanagar,2845,2820,DELHI-Itanagar,5665,All
2024,4,DELHI,Itanagar,3045,2961,DELHI-Itanagar,6006,All
2024,6,DELHI,Itanagar,2939,2736,DELHI-Itanagar,5675,All
2024,7,DELHI,Itanagar,2835,3080,DELHI-Itanagar,5915,All
2024,8,DELHI,Itanagar,2902,3000,DELHI-Itanagar,5902,All
2024,9,DELHI,Itanagar,2795,2826,DELHI-Itanagar,5621,All
2024,10,DELHI,Itanagar,3106,3011,DELHI-Itanagar,6117,All
2024,11,DELHI,Itanagar,3006,2870,DELHI-Itanagar,5876,All
2024,12,DELHI,Itanagar,3102,2831,DELHI-Itanagar,5933,All
2025,1,DELHI,Itanagar,2802,2878,DELHI-Itanagar,5680,All
2025,2,DELHI,Itanagar,2714,2704,DELHI-Itanagar,5418,All
2025,3,DELHI,Itanagar,3103,3056,DELHI-Itanagar,6159,All
2024,1,DELHI,JABALPUR,6307,6530,DELHI-JABALPUR,12837,All
2024,2,DELHI,JABALPUR,6779,6699,DELHI-JABALPUR,13478,All
2024,3,DELHI,JABALPUR,7684,7707,DELHI-JABALPUR,15391,All
2024,4,DELHI,JABALPUR,6654,6528,DELHI-JABALPUR,13182,All
2024,6,DELHI,JABALPUR,7056,6428,DELHI-JABALPUR,13484,All
2024,7,DELHI,JABALPUR,6520,6190,DELHI-JABALPUR,12710,All
2024,8,DELHI,JABALPUR,6194,5916,DELHI-JABALPUR,12110,All
2024,9,DELHI,JABALPUR,5797,5485,DELHI-JABALPUR,11282,All
2024,10,DELHI,JABALPUR,5863,5092,DELHI-JABALPUR,10955,All
2024,11,DELHI,JABALPUR,5773,5667,DELHI-JABALPUR,11440,All
2024,12,DELHI,JABALPUR,6136,5793,DELHI-JABALPUR,11929,All
2025,1,DELHI,JABALPUR,5674,5723,DELHI-JABALPUR,11397,All
2025,2,DELHI,JABALPUR,5358,5340,DELHI-JABALPUR,10698,All
2025,3,DELHI,JABALPUR,6024,5738,DELHI-JABALPUR,11762,All
2024,1,DELHI,JAGDALPUR,257,353,DELHI-JAGDALPUR,610,All
2024,2,DELHI,JAGDALPUR,294,444,DELHI-JAGDALPUR,738,All
2024,3,DELHI,JAGDALPUR,333,520,DELHI-JAGDALPUR,853,All
2024,4,DELHI,JAGDALPUR,306,490,DELHI-JAGDALPUR,796,All
2024,6,DELHI,JAGDALPUR,300,469,DELHI-JAGDALPUR,769,All
2024,7,DELHI,JAGDALPUR,223,302,DELHI-JAGDALPUR,525,All
2024,8,DELHI,JAGDALPUR,265,390,DELHI-JAGDALPUR,655,All
2024,9,DELHI,JAGDALPUR,223,411,DELHI-JAGDALPUR,634,All
2024,10,DELHI,JAGDALPUR,219,455,DELHI-JAGDALPUR,674,All
2024,11,DELHI,JAGDALPUR,359,476,DELHI-JAGDALPUR,835,All
2024,12,DELHI,JAGDALPUR,436,541,DELHI-JAGDALPUR,977,All
2025,1,DELHI,JAGDALPUR,0,25,DELHI-JAGDALPUR,25,All
2025,3,DELHI,JAGDALPUR,382,581,DELHI-JAGDALPUR,963,All
2024,1,DELHI,JAIPUR,27518,30537,DELHI-JAIPUR,58055,All
2024,2,DELHI,JAIPUR,24196,25419,DELHI-JAIPUR,49615,All
2024,3,DELHI,JAIPUR,25576,27161,DELHI-JAIPUR,52737,All
2024,4,DELHI,JAIPUR,24569,27097,DELHI-JAIPUR,51666,All
2024,6,DELHI,JAIPUR,24369,22624,DELHI-JAIPUR,46993,All
2024,7,DELHI,JAIPUR,24145,24875,DELHI-JAIPUR,49020,All
2024,8,DELHI,JAIPUR,24422,24964,DELHI-JAIPUR,49386,All
2024,9,DELHI,JAIPUR,25086,26267,DELHI-JAIPUR,51353,All
2024,10,DELHI,JAIPUR,26740,25575,DELHI-JAIPUR,52315,All
2024,11,DELHI,JAIPUR,26020,26158,DELHI-JAIPUR,52178,All
2024,12,DELHI,JAIPUR,29148,27091,DELHI-JAIPUR,56239,All
2025,1,DELHI,JAIPUR,22917,22556,DELHI-JAIPUR,45473,All
2025,2,DELHI,JAIPUR,22683,22915,DELHI-JAIPUR,45598,All
2025,3,DELHI,JAIPUR,22834,23600,DELHI-JAIPUR,46434,All
2024,1,DELHI,JAISALMER,7927,8039,DELHI-JAISALMER,15966,All
2024,2,DELHI,JAISALMER,4737,4877,DELHI-JAISALMER,9614,All
2024,3,DELHI,JAISALMER,2079,2143,DELHI-JAISALMER,4222,All
2024,10,DELHI,JAISALMER,3877,3945,DELHI-JAISALMER,7822,All
2024,11,DELHI,JAISALMER,5144,4945,DELHI-JAISALMER,10089,All
2024,12,DELHI,JAISALMER,5180,5149,DELHI-JAISALMER,10329,All
2025,1,DELHI,JAISALMER,5308,5392,DELHI-JAISALMER,10700,All
2025,2,DELHI,JAISALMER,5169,5095,DELHI-JAISALMER,10264,All
2025,3,DELHI,JAISALMER,2177,2068,DELHI-JAISALMER,4245,All
2024,1,DELHI,JAMMU,18739,18865,DELHI-JAMMU,37604,All
2024,2,DELHI,JAMMU,22728,24350,DELHI-JAMMU,47078,All
2024,3,DELHI,JAMMU,28849,29160,DELHI-JAMMU,58009,All
2024,4,DELHI,JAMMU,30321,32129,DELHI-JAMMU,62450,All
2024,6,DELHI,JAMMU,28445,28488,DELHI-JAMMU,56933,All
2024,7,DELHI,JAMMU,27671,28110,DELHI-JAMMU,55781,All
2024,8,DELHI,JAMMU,27619,27275,DELHI-JAMMU,54894,All
2024,9,DELHI,JAMMU,29183,26292,DELHI-JAMMU,55475,All
2024,10,DELHI,JAMMU,31632,27561,DELHI-JAMMU,59193,All
2024,11,DELHI,JAMMU,30949,28847,DELHI-JAMMU,59796,All
2024,12,DELHI,JAMMU,26616,25722,DELHI-JAMMU,52338,All
2025,1,DELHI,JAMMU,21324,20608,DELHI-JAMMU,41932,All
2025,2,DELHI,JAMMU,26333,25869,DELHI-JAMMU,52202,All
2025,3,DELHI,JAMMU,33345,33833,DELHI-JAMMU,67178,All
2024,1,DELHI,JHARSUGUDA,5670,5470,DELHI-JHARSUGUDA,11140,All
2024,2,DELHI,JHARSUGUDA,5367,5431,DELHI-JHARSUGUDA,10798,All
2024,3,DELHI,JHARSUGUDA,5544,5289,DELHI-JHARSUGUDA,10833,All
2024,6,DELHI,JHARSUGUDA,5179,5074,DELHI-JHARSUGUDA,10253,All
2024,7,DELHI,JHARSUGUDA,5271,5179,DELHI-JHARSUGUDA,10450,All
2024,8,DELHI,JHARSUGUDA,5173,5062,DELHI-JHARSUGUDA,10235,All
2024,9,DELHI,JHARSUGUDA,5147,4811,DELHI-JHARSUGUDA,9958,All
2024,10,DELHI,JHARSUGUDA,5188,4784,DELHI-JHARSUGUDA,9972,All
2024,11,DELHI,JHARSUGUDA,5272,5076,DELHI-JHARSUGUDA,10348,All
2024,12,DELHI,JHARSUGUDA,5484,5082,DELHI-JHARSUGUDA,10566,All
2025,1,DELHI,JHARSUGUDA,5320,5232,DELHI-JHARSUGUDA,10552,All
2025,2,DELHI,JHARSUGUDA,4699,4643,DELHI-JHARSUGUDA,9342,All
2025,3,DELHI,JHARSUGUDA,5102,5324,DELHI-JHARSUGUDA,10426,All
2024,1,DELHI,JODHPUR,13366,13750,DELHI-JODHPUR,27116,All
2024,2,DELHI,JODHPUR,13542,13862,DELHI-JODHPUR,27404,All
2024,3,DELHI,JODHPUR,13163,13767,DELHI-JODHPUR,26930,All
2024,4,DELHI,JODHPUR,9134,9234,DELHI-JODHPUR,18368,All
2024,6,DELHI,JODHPUR,9182,8055,DELHI-JODHPUR,17237,All
2024,7,DELHI,JODHPUR,9245,9053,DELHI-JODHPUR,18298,All
2024,8,DELHI,JODHPUR,9305,9505,DELHI-JODHPUR,18810,All
2024,9,DELHI,JODHPUR,8841,8787,DELHI-JODHPUR,17628,All
2024,10,DELHI,JODHPUR,9666,8862,DELHI-JODHPUR,18528,All
2024,11,DELHI,JODHPUR,15325,14659,DELHI-JODHPUR,29984,All
2024,12,DELHI,JODHPUR,16674,15675,DELHI-JODHPUR,32349,All
2025,1,DELHI,JODHPUR,15153,16299,DELHI-JODHPUR,31452,All
2025,2,DELHI,JODHPUR,14670,14939,DELHI-JODHPUR,29609,All
2025,3,DELHI,JODHPUR,14943,15013,DELHI-JODHPUR,29956,All
2024,1,DELHI,JORHAT,1279,894,DELHI-JORHAT,2173,All
2024,2,DELHI,JORHAT,1210,928,DELHI-JORHAT,2138,All
2024,3,DELHI,JORHAT,1056,1038,DELHI-JORHAT,2094,All
2024,1,DELHI,KANDLA,2497,2339,DELHI-KANDLA,4836,All
2024,2,DELHI,KANDLA,2256,2227,DELHI-KANDLA,4483,All
2024,3,DELHI,KANDLA,1960,2022,DELHI-KANDLA,3982,All
2024,4,DELHI,KANDLA,769,758,DELHI-KANDLA,1527,All
2024,6,DELHI,KANDLA,1146,977,DELHI-KANDLA,2123,All
2024,7,DELHI,KANDLA,1236,1126,DELHI-KANDLA,2362,All
2024,8,DELHI,KANDLA,533,576,DELHI-KANDLA,1109,All
2025,1,DELHI,KANDLA,409,378,DELHI-KANDLA,787,All
2024,2,DELHI,KANNUR,30,40,DELHI-KANNUR,70,All
2024,8,DELHI,KANNUR,80,0,DELHI-KANNUR,80,All
2024,9,DELHI,KANNUR,0,65,DELHI-KANNUR,65,All
2024,12,DELHI,KANNUR,3728,3093,DELHI-KANNUR,6821,All
2025,1,DELHI,KANNUR,5407,5231,DELHI-KANNUR,10638,All
2025,2,DELHI,KANNUR,4840,4815,DELHI-KANNUR,9655,All
2025,3,DELHI,KANNUR,4710,4321,DELHI-KANNUR,9031,All
2024,1,DELHI,KANPUR,4258,4401,DELHI-KANPUR,8659,All
2024,2,DELHI,KANPUR,4568,4417,DELHI-KANPUR,8985,All
2024,3,DELHI,KANPUR,4678,4454,DELHI-KANPUR,9132,All
2024,4,DELHI,KANPUR,4748,4066,DELHI-KANPUR,8814,All
2024,6,DELHI,KANPUR,4643,4535,DELHI-KANPUR,9178,All
2024,7,DELHI,KANPUR,4927,4788,DELHI-KANPUR,9715,All
2024,8,DELHI,KANPUR,4574,4901,DELHI-KANPUR,9475,All
2024,9,DELHI,KANPUR,4443,4540,DELHI-KANPUR,8983,All
2024,10,DELHI,KANPUR,4731,3810,DELHI-KANPUR,8541,All
2024,11,DELHI,KANPUR,4999,5231,DELHI-KANPUR,10230,All
2024,12,DELHI,KANPUR,4848,5049,DELHI-KANPUR,9897,All
2025,1,DELHI,KANPUR,4755,5004,DELHI-KANPUR,9759,All
2025,2,DELHI,KANPUR,4861,4943,DELHI-KANPUR,9804,All
2025,3,DELHI,KANPUR,5071,5190,DELHI-KANPUR,10261,All
2024,1,DELHI,KHAJURAHO,2501,2669,DELHI-KHAJURAHO,5170,All
2024,2,DELHI,KHAJURAHO,2358,2345,DELHI-KHAJURAHO,4703,All
2024,3,DELHI,KHAJURAHO,2295,2393,DELHI-KHAJURAHO,4688,All
2024,4,DELHI,KHAJURAHO,1703,1683,DELHI-KHAJURAHO,3386,All
2024,6,DELHI,KHAJURAHO,836,807,DELHI-KHAJURAHO,1643,All
2024,7,DELHI,KHAJURAHO,653,763,DELHI-KHAJURAHO,1416,All
2024,8,DELHI,KHAJURAHO,478,314,DELHI-KHAJURAHO,792,All
2024,10,DELHI,KHAJURAHO,1617,1216,DELHI-KHAJURAHO,2833,All
2024,11,DELHI,KHAJURAHO,3985,4207,DELHI-KHAJURAHO,8192,All
2024,12,DELHI,KHAJURAHO,4067,4031,DELHI-KHAJURAHO,8098,All
2025,1,DELHI,KHAJURAHO,3382,3856,DELHI-KHAJURAHO,7238,All
2025,2,DELHI,KHAJURAHO,2818,2574,DELHI-KHAJURAHO,5392,All
2025,3,DELHI,KHAJURAHO,3112,2971,DELHI-KHAJURAHO,6083,All
2024,1,DELHI,KOCHI,43050,43939,DELHI-KOCHI,86989,All
2024,2,DELHI,KOCHI,41711,43050,DELHI-KOCHI,84761,All
2024,3,DELHI,KOCHI,43576,41911,DELHI-KOCHI,85487,All
2024,4,DELHI,KOCHI,41472,42138,DELHI-KOCHI,83610,All
2024,6,DELHI,KOCHI,42280,39832,DELHI-KOCHI,82112,All
2024,7,DELHI,KOCHI,42595,40594,DELHI-KOCHI,83189,All
2024,8,DELHI,KOCHI,42495,43492,DELHI-KOCHI,85987,All
2024,9,DELHI,KOCHI,42434,43017,DELHI-KOCHI,85451,All
2024,10,DELHI,KOCHI,35515,42875,DELHI-KOCHI,78390,All
2024,11,DELHI,KOCHI,43876,41262,DELHI-KOCHI,85138,All
2024,12,DELHI,KOCHI,45869,38776,DELHI-KOCHI,84645,All
2025,1,DELHI,KOCHI,41969,45024,DELHI-KOCHI,86993,All
2025,2,DELHI,KOCHI,41278,43011,DELHI-KOCHI,84289,All
2025,3,DELHI,KOCHI,41534,38604,DELHI-KOCHI,80138,All
2024,1,DELHI,KOLKATA,119251,118865,DELHI-KOLKATA,238116,All
2024,2,DELHI,KOLKATA,115415,113691,DELHI-KOLKATA,229106,All
2024,3,DELHI,KOLKATA,125476,120424,DELHI-KOLKATA,245900,All
2024,4,DELHI,KOLKATA,121262,107008,DELHI-KOLKATA,228270,All
2024,6,DELHI,KOLKATA,116303,101109,DELHI-KOLKATA,217412,All
2024,7,DELHI,KOLKATA,109039,112902,DELHI-KOLKATA,221941,All
2024,8,DELHI,KOLKATA,102142,103636,DELHI-KOLKATA,205778,All
2024,9,DELHI,KOLKATA,108371,100242,DELHI-KOLKATA,208613,All
2024,10,DELHI,KOLKATA,129537,119736,DELHI-KOLKATA,249273,All
2024,11,DELHI,KOLKATA,125031,122788,DELHI-KOLKATA,247819,All
2024,12,DELHI,KOLKATA,130761,122625,DELHI-KOLKATA,253386,All
2025,1,DELHI,KOLKATA,121831,123163,DELHI-KOLKATA,244994,All
2025,2,DELHI,KOLKATA,115354,114877,DELHI-KOLKATA,230231,All
2025,3,DELHI,KOLKATA,127340,122804,DELHI-KOLKATA,250144,All
2024,1,DELHI,KOZHIKODE,5154,5169,DELHI-KOZHIKODE,10323,All
2024,2,DELHI,KOZHIKODE,4713,4730,DELHI-KOZHIKODE,9443,All
2024,3,DELHI,KOZHIKODE,4718,4579,DELHI-KOZHIKODE,9297,All
2024,4,DELHI,KOZHIKODE,4983,5126,DELHI-KOZHIKODE,10109,All
2024,6,DELHI,KOZHIKODE,5106,4855,DELHI-KOZHIKODE,9961,All
2024,7,DELHI,KOZHIKODE,4978,4646,DELHI-KOZHIKODE,9624,All
2024,8,DELHI,KOZHIKODE,4768,4946,DELHI-KOZHIKODE,9714,All
2024,9,DELHI,KOZHIKODE,4904,5150,DELHI-KOZHIKODE,10054,All
2024,10,DELHI,KOZHIKODE,5029,5121,DELHI-KOZHIKODE,10150,All
2024,11,DELHI,KOZHIKODE,5108,4844,DELHI-KOZHIKODE,9952,All
2024,12,DELHI,KOZHIKODE,5719,5409,DELHI-KOZHIKODE,11128,All
2025,1,DELHI,KOZHIKODE,5819,5677,DELHI-KOZHIKODE,11496,All
2025,2,DELHI,KOZHIKODE,5263,5262,DELHI-KOZHIKODE,10525,All
2025,3,DELHI,KOZHIKODE,4767,4255,DELHI-KOZHIKODE,9022,All
2024,1,DELHI,KULLU,145,120,DELHI-KULLU,265,All
2024,2,DELHI,KULLU,589,296,DELHI-KULLU,885,All
2024,3,DELHI,KULLU,709,457,DELHI-KULLU,1166,All
2024,4,DELHI,KULLU,1069,620,DELHI-KULLU,1689,All
2024,6,DELHI,KULLU,1879,728,DELHI-KULLU,2607,All
2024,7,DELHI,KULLU,673,334,DELHI-KULLU,1007,All
2024,8,DELHI,KULLU,640,231,DELHI-KULLU,871,All
2024,9,DELHI,KULLU,939,398,DELHI-KULLU,1337,All
2024,10,DELHI,KULLU,1018,595,DELHI-KULLU,1613,All
2024,11,DELHI,KULLU,423,261,DELHI-KULLU,684,All
2024,12,DELHI,KULLU,427,234,DELHI-KULLU,661,All
2025,1,DELHI,KULLU,474,277,DELHI-KULLU,751,All
2025,2,DELHI,KULLU,367,156,DELHI-KULLU,523,All
2025,3,DELHI,KULLU,543,260,DELHI-KULLU,803,All
2024,1,DELHI,LEH,21739,21517,DELHI-LEH,43256,All
2024,2,DELHI,LEH,22295,16162,DELHI-LEH,38457,All
2024,3,DELHI,LEH,23951,17786,DELHI-LEH,41737,All
2024,4,DELHI,LEH,50900,36066,DELHI-LEH,86966,All
2024,6,DELHI,LEH,50603,52457,DELHI-LEH,103060,All
2024,7,DELHI,LEH,47621,50451,DELHI-LEH,98072,All
2024,8,DELHI,LEH,45734,50413,DELHI-LEH,96147,All
2024,9,DELHI,LEH,43578,48262,DELHI-LEH,91840,All
2024,10,DELHI,LEH,29274,45541,DELHI-LEH,74815,All
2024,11,DELHI,LEH,23362,24558,DELHI-LEH,47920,All
2024,12,DELHI,LEH,22532,24793,DELHI-LEH,47325,All
2025,1,DELHI,LEH,18865,22722,DELHI-LEH,41587,All
2025,2,DELHI,LEH,21119,16723,DELHI-LEH,37842,All
2025,3,DELHI,LEH,31355,20062,DELHI-LEH,51417,All
2024,1,DELHI,LUCKNOW,65374,64617,DELHI-LUCKNOW,129991,All
2024,2,DELHI,LUCKNOW,66488,63670,DELHI-LUCKNOW,130158,All
2024,3,DELHI,LUCKNOW,67683,61845,DELHI-LUCKNOW,129528,All
2024,4,DELHI,LUCKNOW,62994,54113,DELHI-LUCKNOW,117107,All
2024,6,DELHI,LUCKNOW,68311,60352,DELHI-LUCKNOW,128663,All
2024,7,DELHI,LUCKNOW,61487,62671,DELHI-LUCKNOW,124158,All
2024,8,DELHI,LUCKNOW,60609,62645,DELHI-LUCKNOW,123254,All
2024,9,DELHI,LUCKNOW,56770,58292,DELHI-LUCKNOW,115062,All
2024,10,DELHI,LUCKNOW,64283,50978,DELHI-LUCKNOW,115261,All
2024,11,DELHI,LUCKNOW,62768,61879,DELHI-LUCKNOW,124647,All
2024,12,DELHI,LUCKNOW,63093,66509,DELHI-LUCKNOW,129602,All
2025,1,DELHI,LUCKNOW,62684,61073,DELHI-LUCKNOW,123757,All
2025,2,DELHI,LUCKNOW,58569,58841,DELHI-LUCKNOW,117410,All
2025,3,DELHI,LUCKNOW,49424,48411,DELHI-LUCKNOW,97835,All
2024,1,DELHI,MADURAI,3907,3980,DELHI-MADURAI,7887,All
2024,2,DELHI,MADURAI,4810,4825,DELHI-MADURAI,9635,All
2024,3,DELHI,MADURAI,5124,4821,DELHI-MADURAI,9945,All
2024,4,DELHI,MADURAI,4979,4795,DELHI-MADURAI,9774,All
2024,6,DELHI,MADURAI,5063,4727,DELHI-MADURAI,9790,All
2024,7,DELHI,MADURAI,6062,5617,DELHI-MADURAI,11679,All
2024,8,DELHI,MADURAI,5448,5377,DELHI-MADURAI,10825,All
2024,9,DELHI,MADURAI,4490,4365,DELHI-MADURAI,8855,All
2024,10,DELHI,MADURAI,4951,4894,DELHI-MADURAI,9845,All
2024,11,DELHI,MADURAI,5864,5759,DELHI-MADURAI,11623,All
2024,12,DELHI,MADURAI,6389,6061,DELHI-MADURAI,12450,All
2025,1,DELHI,MADURAI,6453,6325,DELHI-MADURAI,12778,All
2025,2,DELHI,MADURAI,5932,6031,DELHI-MADURAI,11963,All
2025,3,DELHI,MADURAI,6279,5893,DELHI-MADURAI,12172,All
2024,1,DELHI,MANGALORE,4985,5212,DELHI-MANGALORE,10197,All
2024,2,DELHI,MANGALORE,4387,4866,DELHI-MANGALORE,9253,All
2024,3,DELHI,MANGALORE,5038,5519,DELHI-MANGALORE,10557,All
2024,4,DELHI,MANGALORE,5787,5833,DELHI-MANGALORE,11620,All
2024,6,DELHI,MANGALORE,6012,5448,DELHI-MANGALORE,11460,All
2024,7,DELHI,MANGALORE,5907,5533,DELHI-MANGALORE,11440,All
2024,8,DELHI,MANGALORE,5849,5722,DELHI-MANGALORE,11571,All
2024,9,DELHI,MANGALORE,5091,5125,DELHI-MANGALORE,10216,All
2024,10,DELHI,MANGALORE,4725,5200,DELHI-MANGALORE,9925,All
2024,11,DELHI,MANGALORE,5229,5198,DELHI-MANGALORE,10427,All
2024,12,DELHI,MANGALORE,5624,5233,DELHI-MANGALORE,10857,All
2025,1,DELHI,MANGALORE,5280,5379,DELHI-MANGALORE,10659,All
2025,2,DELHI,MANGALORE,10023,10257,DELHI-MANGALORE,20280,All
2025,3,DELHI,MANGALORE,8973,8600,DELHI-MANGALORE,17573,All
2024,1,DELHI,MUMBAI,284143,289788,DELHI-MUMBAI,573931,All
2024,2,DELHI,MUMBAI,280016,293493,DELHI-MUMBAI,573509,All
2024,3,DELHI,MUMBAI,290453,288891,DELHI-MUMBAI,579344,All
2024,4,DELHI,MUMBAI,276200,302589,DELHI-MUMBAI,578789,All
2024,6,DELHI,MUMBAI,290790,262604,DELHI-MUMBAI,553394,All
2024,7,DELHI,MUMBAI,277921,269329,DELHI-MUMBAI,547250,All
2024,8,DELHI,MUMBAI,290187,290300,DELHI-MUMBAI,580487,All
2024,9,DELHI,MUMBAI,288534,292814,DELHI-MUMBAI,581348,All
2024,10,DELHI,MUMBAI,261087,298125,DELHI-MUMBAI,559212,All
2024,11,DELHI,MUMBAI,296267,283790,DELHI-MUMBAI,580057,All
2024,12,DELHI,MUMBAI,295226,271126,DELHI-MUMBAI,566352,All
2025,1,DELHI,MUMBAI,279457,282359,DELHI-MUMBAI,561816,All
2025,2,DELHI,MUMBAI,271320,283669,DELHI-MUMBAI,554989,All
2025,3,DELHI,MUMBAI,290413,285382,DELHI-MUMBAI,575795,All
2024,1,DELHI,NAGPUR,22875,24507,DELHI-NAGPUR,47382,All
2024,2,DELHI,NAGPUR,22792,23175,DELHI-NAGPUR,45967,All
2024,3,DELHI,NAGPUR,24178,24048,DELHI-NAGPUR,48226,All
2024,4,DELHI,NAGPUR,23944,25116,DELHI-NAGPUR,49060,All
2024,6,DELHI,NAGPUR,25576,22222,DELHI-NAGPUR,47798,All
2024,7,DELHI,NAGPUR,23166,22695,DELHI-NAGPUR,45861,All
2024,8,DELHI,NAGPUR,24813,24660,DELHI-NAGPUR,49473,All
2024,9,DELHI,NAGPUR,27515,28316,DELHI-NAGPUR,55831,All
2024,10,DELHI,NAGPUR,29249,28685,DELHI-NAGPUR,57934,All
2024,11,DELHI,NAGPUR,32759,31491,DELHI-NAGPUR,64250,All
2024,12,DELHI,NAGPUR,35176,30796,DELHI-NAGPUR,65972,All
2025,1,DELHI,NAGPUR,29134,30007,DELHI-NAGPUR,59141,All
2025,2,DELHI,NAGPUR,29570,31388,DELHI-NAGPUR,60958,All
2025,3,DELHI,NAGPUR,30548,29359,DELHI-NAGPUR,59907,All
2024,6,DELHI,NASIK,5041,4762,DELHI-NASIK,9803,All
2024,7,DELHI,NASIK,4413,4618,DELHI-NASIK,9031,All
2024,8,DELHI,NASIK,4561,4894,DELHI-NASIK,9455,All
2024,9,DELHI,NASIK,4415,5055,DELHI-NASIK,9470,All
2024,10,DELHI,NASIK,4950,5171,DELHI-NASIK,10121,All
2024,11,DELHI,NASIK,5011,5099,DELHI-NASIK,10110,All
2024,12,DELHI,NASIK,4498,4322,DELHI-NASIK,8820,All
2025,1,DELHI,NASIK,4341,4611,DELHI-NASIK,8952,All
2025,2,DELHI,NASIK,4712,4836,DELHI-NASIK,9548,All
2025,3,DELHI,NASIK,5300,5360,DELHI-NASIK,10660,All
2024,3,DELHI,PAKYONG,67,74,DELHI-PAKYONG,141,All
2024,4,DELHI,PAKYONG,1155,880,DELHI-PAKYONG,2035,All
2024,6,DELHI,PAKYONG,444,360,DELHI-PAKYONG,804,All
2024,1,DELHI,PANTNAGAR,58,56,DELHI-PANTNAGAR,114,All
2024,2,DELHI,PANTNAGAR,3124,3135,DELHI-PANTNAGAR,6259,All
2024,3,DELHI,PANTNAGAR,3144,2956,DELHI-PANTNAGAR,6100,All
2024,4,DELHI,PANTNAGAR,4604,4303,DELHI-PANTNAGAR,8907,All
2024,6,DELHI,PANTNAGAR,4278,3857,DELHI-PANTNAGAR,8135,All
2024,7,DELHI,PANTNAGAR,3568,3150,DELHI-PANTNAGAR,6718,All
2024,8,DELHI,PANTNAGAR,4127,3683,DELHI-PANTNAGAR,7810,All
2024,9,DELHI,PANTNAGAR,4076,3742,DELHI-PANTNAGAR,7818,All
2024,10,DELHI,PANTNAGAR,4815,4157,DELHI-PANTNAGAR,8972,All
2024,11,DELHI,PANTNAGAR,4093,4036,DELHI-PANTNAGAR,8129,All
2024,12,DELHI,PANTNAGAR,4405,4418,DELHI-PANTNAGAR,8823,All
2025,1,DELHI,PANTNAGAR,3497,3417,DELHI-PANTNAGAR,6914,All
2025,2,DELHI,PANTNAGAR,3721,3710,DELHI-PANTNAGAR,7431,All
2025,3,DELHI,PANTNAGAR,4002,3866,DELHI-PANTNAGAR,7868,All
2024,1,DELHI,PATNA,50016,50150,DELHI-PATNA,100166,All
2024,2,DELHI,PATNA,60299,58354,DELHI-PATNA,118653,All
2024,3,DELHI,PATNA,67213,61223,DELHI-PATNA,128436,All
2024,4,DELHI,PATNA,59649,54607,DELHI-PATNA,114256,All
2024,6,DELHI,PATNA,58646,55868,DELHI-PATNA,114514,All
2024,7,DELHI,PATNA,57143,60790,DELHI-PATNA,117933,All
2024,8,DELHI,PATNA,56818,57380,DELHI-PATNA,114198,All
2024,9,DELHI,PATNA,56957,49206,DELHI-PATNA,106163,All
2024,10,DELHI,PATNA,63596,47019,DELHI-PATNA,110615,All
2024,11,DELHI,PATNA,65663,62281,DELHI-PATNA,127944,All
2024,12,DELHI,PATNA,58882,57141,DELHI-PATNA,116023,All
2025,1,DELHI,PATNA,52105,49844,DELHI-PATNA,101949,All
2025,2,DELHI,PATNA,49737,49302,DELHI-PATNA,99039,All
2025,3,DELHI,PATNA,60291,55448,DELHI-PATNA,115739,All
2024,11,DELHI,PITHORAGARH,282,230,DELHI-PITHORAGARH,512,All
2024,12,DELHI,PITHORAGARH,280,243,DELHI-PITHORAGARH,523,All
2025,1,DELHI,PITHORAGARH,258,223,DELHI-PITHORAGARH,481,All
2025,2,DELHI,PITHORAGARH,279,235,DELHI-PITHORAGARH,514,All
2025,3,DELHI,PITHORAGARH,302,213,DELHI-PITHORAGARH,515,All
2024,1,DELHI,PORT BLAIR,5163,5196,DELHI-PORT BLAIR,10359,All
2024,2,DELHI,PORT BLAIR,3310,3573,DELHI-PORT BLAIR,6883,All
2024,3,DELHI,PORT BLAIR,3725,4073,DELHI-PORT BLAIR,7798,All
2024,4,DELHI,PORT BLAIR,3291,2966,DELHI-PORT BLAIR,6257,All
2024,6,DELHI,PORT BLAIR,2618,2525,DELHI-PORT BLAIR,5143,All
2024,7,DELHI,PORT BLAIR,2359,2136,DELHI-PORT BLAIR,4495,All
2024,8,DELHI,PORT BLAIR,2376,1993,DELHI-PORT BLAIR,4369,All
2024,9,DELHI,PORT BLAIR,2847,2253,DELHI-PORT BLAIR,5100,All
2024,10,DELHI,PORT BLAIR,3364,3052,DELHI-PORT BLAIR,6416,All
2024,11,DELHI,PORT BLAIR,8845,7698,DELHI-PORT BLAIR,16543,All
2024,12,DELHI,PORT BLAIR,8295,7777,DELHI-PORT BLAIR,16072,All
2025,1,DELHI,PORT BLAIR,5679,6002,DELHI-PORT BLAIR,11681,All
2025,2,DELHI,PORT BLAIR,2139,2363,DELHI-PORT BLAIR,4502,All
2025,3,DELHI,PORT BLAIR,2033,2179,DELHI-PORT BLAIR,4212,All
2024,1,DELHI,PUNE,113725,113497,DELHI-PUNE,227222,All
2024,2,DELHI,PUNE,113664,116998,DELHI-PUNE,230662,All
2024,3,DELHI,PUNE,121645,123334,DELHI-PUNE,244979,All
2024,4,DELHI,PUNE,118809,123871,DELHI-PUNE,242680,All
2024,6,DELHI,PUNE,127274,112743,DELHI-PUNE,240017,All
2024,7,DELHI,PUNE,123462,117729,DELHI-PUNE,241191,All
2024,8,DELHI,PUNE,119895,118496,DELHI-PUNE,238391,All
2024,9,DELHI,PUNE,115280,118046,DELHI-PUNE,233326,All
2024,10,DELHI,PUNE,113908,129527,DELHI-PUNE,243435,All
2024,11,DELHI,PUNE,125164,123018,DELHI-PUNE,248182,All
2024,12,DELHI,PUNE,134175,125760,DELHI-PUNE,259935,All
2025,1,DELHI,PUNE,124651,124066,DELHI-PUNE,248717,All
2025,2,DELHI,PUNE,110248,112173,DELHI-PUNE,222421,All
2025,3,DELHI,PUNE,126739,122769,DELHI-PUNE,249508,All
2024,1,DELHI,RAIPUR,31441,31985,DELHI-RAIPUR,63426,All
2024,2,DELHI,RAIPUR,30970,31021,DELHI-RAIPUR,61991,All
2024,3,DELHI,RAIPUR,32143,32491,DELHI-RAIPUR,64634,All
2024,4,DELHI,RAIPUR,32853,32989,DELHI-RAIPUR,65842,All
2024,6,DELHI,RAIPUR,31498,30419,DELHI-RAIPUR,61917,All
2024,7,DELHI,RAIPUR,32584,32632,DELHI-RAIPUR,65216,All
2024,8,DELHI,RAIPUR,32864,32665,DELHI-RAIPUR,65529,All
2024,9,DELHI,RAIPUR,32375,32462,DELHI-RAIPUR,64837,All
2024,10,DELHI,RAIPUR,32874,31337,DELHI-RAIPUR,64211,All
2024,11,DELHI,RAIPUR,33906,34578,DELHI-RAIPUR,68484,All
2024,12,DELHI,RAIPUR,35745,33850,DELHI-RAIPUR,69595,All
2025,1,DELHI,RAIPUR,30851,31028,DELHI-RAIPUR,61879,All
2025,2,DELHI,RAIPUR,32189,33466,DELHI-RAIPUR,65655,All
2025,3,DELHI,RAIPUR,33941,34355,DELHI-RAIPUR,68296,All
2024,12,DELHI,RAJAHMUNDRY,3516,2189,DELHI-RAJAHMUNDRY,5705,All
2025,1,DELHI,RAJAHMUNDRY,4061,4854,DELHI-RAJAHMUNDRY,8915,All
2025,2,DELHI,RAJAHMUNDRY,4117,4642,DELHI-RAJAHMUNDRY,8759,All
2025,3,DELHI,RAJAHMUNDRY,3716,3603,DELHI-RAJAHMUNDRY,7319,All
2024,1,DELHI,RANCHI,36184,36519,DELHI-RANCHI,72703,All
2024,2,DELHI,RANCHI,37492,37449,DELHI-RANCHI,74941,All
2024,3,DELHI,RANCHI,41943,38479,DELHI-RANCHI,80422,All
2024,4,DELHI,RANCHI,39009,36052,DELHI-RANCHI,75061,All
2024,6,DELHI,RANCHI,40028,35641,DELHI-RANCHI,75669,All
2024,7,DELHI,RANCHI,37688,38692,DELHI-RANCHI,76380,All
2024,8,DELHI,RANCHI,37546,37345,DELHI-RANCHI,74891,All
2024,9,DELHI,RANCHI,36097,33485,DELHI-RANCHI,69582,All
2024,10,DELHI,RANCHI,42716,36729,DELHI-RANCHI,79445,All
2024,11,DELHI,RANCHI,44144,42874,DELHI-RANCHI,87018,All
2024,12,DELHI,RANCHI,44830,42528,DELHI-RANCHI,87358,All
2025,1,DELHI,RANCHI,40297,41115,DELHI-RANCHI,81412,All
2025,2,DELHI,RANCHI,38920,38841,DELHI-RANCHI,77761,All
2025,3,DELHI,RANCHI,42853,41437,DELHI-RANCHI,84290,All
2024,1,DELHI,Rajkot International Airport,9917,9803,DELHI-Rajkot International Airport,19720,All
2024,2,DELHI,Rajkot International Airport,8982,8925,DELHI-Rajkot International Airport,17907,All
2024,3,DELHI,Rajkot International Airport,8490,8746,DELHI-Rajkot International Airport,17236,All
2024,4,DELHI,Rajkot International Airport,9716,9990,DELHI-Rajkot International Airport,19706,All
2024,6,DELHI,Rajkot International Airport,10102,8120,DELHI-Rajkot International Airport,18222,All
2024,7,DELHI,Rajkot International Airport,8919,7552,DELHI-Rajkot International Airport,16471,All
2024,8,DELHI,Rajkot International Airport,8798,8791,DELHI-Rajkot International Airport,17589,All
2024,9,DELHI,Rajkot International Airport,8446,8286,DELHI-Rajkot International Airport,16732,All
2024,10,DELHI,Rajkot International Airport,8145,8614,DELHI-Rajkot International Airport,16759,All
2024,11,DELHI,Rajkot International Airport,9946,9326,DELHI-Rajkot International Airport,19272,All
2024,12,DELHI,Rajkot International Airport,9913,9590,DELHI-Rajkot International Airport,19503,All
2025,1,DELHI,Rajkot International Airport,10633,10789,DELHI-Rajkot International Airport,21422,All
2025,2,DELHI,Rajkot International Airport,9033,9416,DELHI-Rajkot International Airport,18449,All
2025,3,DELHI,Rajkot International Airport,10049,9604,DELHI-Rajkot International Airport,19653,All
2024,1,DELHI,SHILLONG,702,702,DELHI-SHILLONG,1404,All
2024,2,DELHI,SHILLONG,606,577,DELHI-SHILLONG,1183,All
2024,3,DELHI,SHILLONG,720,668,DELHI-SHILLONG,1388,All
2024,4,DELHI,SHILLONG,798,588,DELHI-SHILLONG,1386,All
2024,6,DELHI,SHILLONG,627,523,DELHI-SHILLONG,1150,All
2024,7,DELHI,SHILLONG,693,658,DELHI-SHILLONG,1351,All
2024,8,DELHI,SHILLONG,445,470,DELHI-SHILLONG,915,All
2024,9,DELHI,SHILLONG,502,338,DELHI-SHILLONG,840,All
2024,10,DELHI,SHILLONG,579,537,DELHI-SHILLONG,1116,All
2024,11,DELHI,SHILLONG,633,536,DELHI-SHILLONG,1169,All
2024,12,DELHI,SHILLONG,618,561,DELHI-SHILLONG,1179,All
2025,1,DELHI,SHILLONG,616,611,DELHI-SHILLONG,1227,All
2025,2,DELHI,SHILLONG,602,449,DELHI-SHILLONG,1051,All
2025,3,DELHI,SHILLONG,785,555,DELHI-SHILLONG,1340,All
2024,1,DELHI,SHIRDI,11904,12200,DELHI-SHIRDI,24104,All
2024,2,DELHI,SHIRDI,10533,10835,DELHI-SHIRDI,21368,All
2024,3,DELHI,SHIRDI,11767,11622,DELHI-SHIRDI,23389,All
2024,4,DELHI,SHIRDI,9628,10204,DELHI-SHIRDI,19832,All
2024,6,DELHI,SHIRDI,8560,7740,DELHI-SHIRDI,16300,All
2024,7,DELHI,SHIRDI,10019,9647,DELHI-SHIRDI,19666,All
2024,8,DELHI,SHIRDI,10312,9785,DELHI-SHIRDI,20097,All
2024,9,DELHI,SHIRDI,7344,7366,DELHI-SHIRDI,14710,All
2024,10,DELHI,SHIRDI,6183,6965,DELHI-SHIRDI,13148,All
2024,11,DELHI,SHIRDI,10684,8991,DELHI-SHIRDI,19675,All
2024,12,DELHI,SHIRDI,11755,10395,DELHI-SHIRDI,22150,All
2025,1,DELHI,SHIRDI,11034,11154,DELHI-SHIRDI,22188,All
2025,2,DELHI,SHIRDI,9753,9952,DELHI-SHIRDI,19705,All
2025,3,DELHI,SHIRDI,11257,10888,DELHI-SHIRDI,22145,All
2024,1,DELHI,SILCHAR,1010,760,DELHI-SILCHAR,1770,All
2024,2,DELHI,SILCHAR,694,847,DELHI-SILCHAR,1541,All
2024,3,DELHI,SILCHAR,722,896,DELHI-SILCHAR,1618,All
2024,4,DELHI,SILCHAR,342,497,DELHI-SILCHAR,839,All
2024,6,DELHI,SILCHAR,386,462,DELHI-SILCHAR,848,All
2024,7,DELHI,SILCHAR,486,577,DELHI-SILCHAR,1063,All
2024,8,DELHI,SILCHAR,552,1082,DELHI-SILCHAR,1634,All
2024,9,DELHI,SILCHAR,448,912,DELHI-SILCHAR,1360,All
2024,10,DELHI,SILCHAR,415,786,DELHI-SILCHAR,1201,All
2024,11,DELHI,SILCHAR,654,1193,DELHI-SILCHAR,1847,All
2024,12,DELHI,SILCHAR,544,1190,DELHI-SILCHAR,1734,All
2025,3,DELHI,SILCHAR,988,1203,DELHI-SILCHAR,2191,All
2024,1,DELHI,SIMLA,967,538,DELHI-SIMLA,1505,All
2024,2,DELHI,SIMLA,698,366,DELHI-SIMLA,1064,All
2024,3,DELHI,SIMLA,1026,542,DELHI-SIMLA,1568,All
2024,4,DELHI,SIMLA,1161,591,DELHI-SIMLA,1752,All
2024,6,DELHI,SIMLA,1049,514,DELHI-SIMLA,1563,All
2024,7,DELHI,SIMLA,133,72,DELHI-SIMLA,205,All
2024,8,DELHI,SIMLA,410,239,DELHI-SIMLA,649,All
2024,9,DELHI,SIMLA,529,270,DELHI-SIMLA,799,All
2024,10,DELHI,SIMLA,1197,711,DELHI-SIMLA,1908,All
2024,11,DELHI,SIMLA,1036,661,DELHI-SIMLA,1697,All
2024,12,DELHI,SIMLA,993,598,DELHI-SIMLA,1591,All
2025,1,DELHI,SIMLA,1028,610,DELHI-SIMLA,1638,All
2025,2,DELHI,SIMLA,895,526,DELHI-SIMLA,1421,All
2025,3,DELHI,SIMLA,921,520,DELHI-SIMLA,1441,All
2024,1,DELHI,SRINAGAR,88501,93899,DELHI-SRINAGAR,182400,All
2024,2,DELHI,SRINAGAR,96158,88774,DELHI-SRINAGAR,184932,All
2024,3,DELHI,SRINAGAR,107123,100072,DELHI-SRINAGAR,207195,All
2024,4,DELHI,SRINAGAR,125671,122211,DELHI-SRINAGAR,247882,All
2024,6,DELHI,SRINAGAR,132450,129277,DELHI-SRINAGAR,261727,All
2024,7,DELHI,SRINAGAR,106367,110873,DELHI-SRINAGAR,217240,All
2024,8,DELHI,SRINAGAR,77395,86335,DELHI-SRINAGAR,163730,All
2024,9,DELHI,SRINAGAR,80495,78520,DELHI-SRINAGAR,159015,All
2024,10,DELHI,SRINAGAR,82538,94620,DELHI-SRINAGAR,177158,All
2024,11,DELHI,SRINAGAR,78534,80069,DELHI-SRINAGAR,158603,All
2024,12,DELHI,SRINAGAR,80676,82620,DELHI-SRINAGAR,163296,All
2025,1,DELHI,SRINAGAR,76135,78528,DELHI-SRINAGAR,154663,All
2025,2,DELHI,SRINAGAR,76199,73778,DELHI-SRINAGAR,149977,All
2025,3,DELHI,SRINAGAR,95385,86117,DELHI-SRINAGAR,181502,All
2024,1,DELHI,SURAT,16469,16384,DELHI-SURAT,32853,All
2024,2,DELHI,SURAT,15143,15659,DELHI-SURAT,30802,All
2024,3,DELHI,SURAT,18266,18571,DELHI-SURAT,36837,All
2024,4,DELHI,SURAT,20705,21123,DELHI-SURAT,41828,All
2024,6,DELHI,SURAT,25856,23201,DELHI-SURAT,49057,All
2024,7,DELHI,SURAT,27081,24855,DELHI-SURAT,51936,All
2024,8,DELHI,SURAT,26001,24829,DELHI-SURAT,50830,All
2024,9,DELHI,SURAT,25834,24413,DELHI-SURAT,50247,All
2024,10,DELHI,SURAT,23594,25977,DELHI-SURAT,49571,All
2024,11,DELHI,SURAT,29117,27192,DELHI-SURAT,56309,All
2024,12,DELHI,SURAT,31466,28035,DELHI-SURAT,59501,All
2025,1,DELHI,SURAT,28817,29105,DELHI-SURAT,57922,All
2025,2,DELHI,SURAT,25094,26143,DELHI-SURAT,51237,All
2025,3,DELHI,SURAT,27292,26471,DELHI-SURAT,53763,All
2024,1,DELHI,TIRUPATI,1436,948,DELHI-TIRUPATI,2384,All
2024,2,DELHI,TIRUPATI,1584,1071,DELHI-TIRUPATI,2655,All
2024,3,DELHI,TIRUPATI,2474,1639,DELHI-TIRUPATI,4113,All
2024,4,DELHI,TIRUPATI,1639,1142,DELHI-TIRUPATI,2781,All
2024,6,DELHI,TIRUPATI,1048,751,DELHI-TIRUPATI,1799,All
2024,7,DELHI,TIRUPATI,1208,796,DELHI-TIRUPATI,2004,All
2024,8,DELHI,TIRUPATI,1165,911,DELHI-TIRUPATI,2076,All
2024,9,DELHI,TIRUPATI,1114,764,DELHI-TIRUPATI,1878,All
2024,10,DELHI,TIRUPATI,3104,3706,DELHI-TIRUPATI,6810,All
2024,11,DELHI,TIRUPATI,5609,4343,DELHI-TIRUPATI,9952,All
2024,12,DELHI,TIRUPATI,5240,4630,DELHI-TIRUPATI,9870,All
2025,1,DELHI,TIRUPATI,3259,3357,DELHI-TIRUPATI,6616,All
2025,2,DELHI,TIRUPATI,4251,4671,DELHI-TIRUPATI,8922,All
2025,3,DELHI,TIRUPATI,4481,4260,DELHI-TIRUPATI,8741,All
2024,1,DELHI,TRIVANDRUM,20725,21057,DELHI-TRIVANDRUM,41782,All
2024,2,DELHI,TRIVANDRUM,18896,19649,DELHI-TRIVANDRUM,38545,All
2024,3,DELHI,TRIVANDRUM,20087,18804,DELHI-TRIVANDRUM,38891,All
2024,4,DELHI,TRIVANDRUM,18408,19837,DELHI-TRIVANDRUM,38245,All
2024,6,DELHI,TRIVANDRUM,19022,18259,DELHI-TRIVANDRUM,37281,All
2024,7,DELHI,TRIVANDRUM,19312,17627,DELHI-TRIVANDRUM,36939,All
2024,8,DELHI,TRIVANDRUM,17892,18995,DELHI-TRIVANDRUM,36887,All
2024,9,DELHI,TRIVANDRUM,17783,18301,DELHI-TRIVANDRUM,36084,All
2024,10,DELHI,TRIVANDRUM,16091,20155,DELHI-TRIVANDRUM,36246,All
2024,11,DELHI,TRIVANDRUM,19110,19319,DELHI-TRIVANDRUM,38429,All
2024,12,DELHI,TRIVANDRUM,19001,18923,DELHI-TRIVANDRUM,37924,All
2025,1,DELHI,TRIVANDRUM,19415,21735,DELHI-TRIVANDRUM,41150,All
2025,2,DELHI,TRIVANDRUM,19826,21202,DELHI-TRIVANDRUM,41028,All
2025,3,DELHI,TRIVANDRUM,19839,21369,DELHI-TRIVANDRUM,41208,All
2024,1,DELHI,UDAIPUR,28195,29071,DELHI-UDAIPUR,57266,All
2024,2,DELHI,UDAIPUR,26915,28222,DELHI-UDAIPUR,55137,All
2024,3,DELHI,UDAIPUR,28890,29147,DELHI-UDAIPUR,58037,All
2024,4,DELHI,UDAIPUR,17339,19267,DELHI-UDAIPUR,36606,All
2024,6,DELHI,UDAIPUR,21198,18197,DELHI-UDAIPUR,39395,All
2024,7,DELHI,UDAIPUR,21624,21461,DELHI-UDAIPUR,43085,All
2024,8,DELHI,UDAIPUR,20950,21375,DELHI-UDAIPUR,42325,All
2024,9,DELHI,UDAIPUR,18815,19415,DELHI-UDAIPUR,38230,All
2024,10,DELHI,UDAIPUR,19399,19944,DELHI-UDAIPUR,39343,All
2024,11,DELHI,UDAIPUR,32595,30206,DELHI-UDAIPUR,62801,All
2024,12,DELHI,UDAIPUR,37534,35228,DELHI-UDAIPUR,72762,All
2025,1,DELHI,UDAIPUR,31596,34558,DELHI-UDAIPUR,66154,All
2025,2,DELHI,UDAIPUR,31967,33200,DELHI-UDAIPUR,65167,All
2025,3,DELHI,UDAIPUR,30444,31022,DELHI-UDAIPUR,61466,All
2024,1,DELHI,VADODARA,20088,19771,DELHI-VADODARA,39859,All
2024,2,DELHI,VADODARA,16133,19452,DELHI-VADODARA,35585,All
2024,3,DELHI,VADODARA,18826,20271,DELHI-VADODARA,39097,All
2024,4,DELHI,VADODARA,21196,23288,DELHI-VADODARA,44484,All
2024,6,DELHI,VADODARA,21758,18371,DELHI-VADODARA,40129,All
2024,7,DELHI,VADODARA,20136,19473,DELHI-VADODARA,39609,All
2024,8,DELHI,VADODARA,20105,21048,DELHI-VADODARA,41153,All
2024,9,DELHI,VADODARA,21328,21741,DELHI-VADODARA,43069,All
2024,10,DELHI,VADODARA,20161,23025,DELHI-VADODARA,43186,All
2024,11,DELHI,VADODARA,26388,24255,DELHI-VADODARA,50643,All
2024,12,DELHI,VADODARA,28957,24242,DELHI-VADODARA,53199,All
2025,1,DELHI,VADODARA,26730,26932,DELHI-VADODARA,53662,All
2025,2,DELHI,VADODARA,24725,26566,DELHI-VADODARA,51291,All
2025,3,DELHI,VADODARA,23434,25169,DELHI-VADODARA,48603,All
2024,1,DELHI,VARANASI,26000,26929,DELHI-VARANASI,52929,All
2024,2,DELHI,VARANASI,32282,32071,DELHI-VARANASI,64353,All
2024,3,DELHI,VARANASI,36544,34936,DELHI-VARANASI,71480,All
2024,4,DELHI,VARANASI,34189,31359,DELHI-VARANASI,65548,All
2024,6,DELHI,VARANASI,33150,31200,DELHI-VARANASI,64350,All
2024,7,DELHI,VARANASI,32150,35449,DELHI-VARANASI,67599,All
2024,8,DELHI,VARANASI,31958,34202,DELHI-VARANASI,66160,All
2024,9,DELHI,VARANASI,30898,31104,DELHI-VARANASI,62002,All
2024,10,DELHI,VARANASI,35107,28857,DELHI-VARANASI,63964,All
2024,11,DELHI,VARANASI,44949,45963,DELHI-VARANASI,90912,All
2024,12,DELHI,VARANASI,33605,34720,DELHI-VARANASI,68325,All
2025,1,DELHI,VARANASI,27370,28440,DELHI-VARANASI,55810,All
2025,2,DELHI,VARANASI,41053,41988,DELHI-VARANASI,83041,All
2025,3,DELHI,VARANASI,46057,47732,DELHI-VARANASI,93789,All
2024,1,DELHI,VIJAYAWADA,7545,7780,DELHI-VIJAYAWADA,15325,All
2024,2,DELHI,VIJAYAWADA,7768,7649,DELHI-VIJAYAWADA,15417,All
2024,3,DELHI,VIJAYAWADA,9177,7878,DELHI-VIJAYAWADA,17055,All
2024,4,DELHI,VIJAYAWADA,8235,9315,DELHI-VIJAYAWADA,17550,All
2024,6,DELHI,VIJAYAWADA,10333,8915,DELHI-VIJAYAWADA,19248,All
2024,7,DELHI,VIJAYAWADA,10093,9771,DELHI-VIJAYAWADA,19864,All
2024,8,DELHI,VIJAYAWADA,8651,9355,DELHI-VIJAYAWADA,18006,All
2024,9,DELHI,VIJAYAWADA,8266,9507,DELHI-VIJAYAWADA,17773,All
2024,10,DELHI,VIJAYAWADA,11094,12439,DELHI-VIJAYAWADA,23533,All
2024,11,DELHI,VIJAYAWADA,12853,11816,DELHI-VIJAYAWADA,24669,All
2024,12,DELHI,VIJAYAWADA,15609,13732,DELHI-VIJAYAWADA,29341,All
2025,1,DELHI,VIJAYAWADA,11019,12998,DELHI-VIJAYAWADA,24017,All
2025,2,DELHI,VIJAYAWADA,13278,15686,DELHI-VIJAYAWADA,28964,All
2025,3,DELHI,VIJAYAWADA,11502,12234,DELHI-VIJAYAWADA,23736,All
2024,1,DELHI,VISAKHAPATNAM,15973,16468,DELHI-VISAKHAPATNAM,32441,All
2024,2,DELHI,VISAKHAPATNAM,16634,17573,DELHI-VISAKHAPATNAM,34207,All
2024,3,DELHI,VISAKHAPATNAM,18073,17974,DELHI-VISAKHAPATNAM,36047,All
2024,4,DELHI,VISAKHAPATNAM,17436,19731,DELHI-VISAKHAPATNAM,37167,All
2024,6,DELHI,VISAKHAPATNAM,22549,20143,DELHI-VISAKHAPATNAM,42692,All
2024,7,DELHI,VISAKHAPATNAM,21833,20815,DELHI-VISAKHAPATNAM,42648,All
2024,8,DELHI,VISAKHAPATNAM,22215,23129,DELHI-VISAKHAPATNAM,45344,All
2024,9,DELHI,VISAKHAPATNAM,20494,22470,DELHI-VISAKHAPATNAM,42964,All
2024,10,DELHI,VISAKHAPATNAM,23116,23048,DELHI-VISAKHAPATNAM,46164,All
2024,11,DELHI,VISAKHAPATNAM,22674,21115,DELHI-VISAKHAPATNAM,43789,All
2024,12,DELHI,VISAKHAPATNAM,25144,19573,DELHI-VISAKHAPATNAM,44717,All
2025,1,DELHI,VISAKHAPATNAM,21264,22075,DELHI-VISAKHAPATNAM,43339,All
2025,2,DELHI,VISAKHAPATNAM,20077,22792,DELHI-VISAKHAPATNAM,42869,All
2025,3,DELHI,VISAKHAPATNAM,20424,20136,DELHI-VISAKHAPATNAM,40560,All
2024,4,DHARAMSALA,JAIPUR,62,93,DHARAMSALA-JAIPUR,155,All
2024,6,DHARAMSALA,JAIPUR,132,258,DHARAMSALA-JAIPUR,390,All
2024,7,DHARAMSALA,JAIPUR,50,109,DHARAMSALA-JAIPUR,159,All
2024,8,DHARAMSALA,JAIPUR,61,73,DHARAMSALA-JAIPUR,134,All
2024,9,DHARAMSALA,JAIPUR,67,101,DHARAMSALA-JAIPUR,168,All
2024,10,DHARAMSALA,JAIPUR,115,131,DHARAMSALA-JAIPUR,246,All
2024,11,DHARAMSALA,JAIPUR,31,22,DHARAMSALA-JAIPUR,53,All
2024,12,DHARAMSALA,JAIPUR,37,69,DHARAMSALA-JAIPUR,106,All
2025,3,DHARAMSALA,JAIPUR,49,110,DHARAMSALA-JAIPUR,159,All
2024,2,DHARAMSALA,KULLU,0,11,DHARAMSALA-KULLU,11,All
2024,1,DHARAMSALA,SIMLA,98,70,DHARAMSALA-SIMLA,168,All
2024,2,DHARAMSALA,SIMLA,76,58,DHARAMSALA-SIMLA,134,All
2024,3,DHARAMSALA,SIMLA,158,171,DHARAMSALA-SIMLA,329,All
2024,4,DHARAMSALA,SIMLA,120,113,DHARAMSALA-SIMLA,233,All
2024,6,DHARAMSALA,SIMLA,171,172,DHARAMSALA-SIMLA,343,All
2024,8,DHARAMSALA,SIMLA,66,35,DHARAMSALA-SIMLA,101,All
2024,9,DHARAMSALA,SIMLA,131,94,DHARAMSALA-SIMLA,225,All
2024,10,DHARAMSALA,SIMLA,254,268,DHARAMSALA-SIMLA,522,All
2024,11,DHARAMSALA,SIMLA,249,203,DHARAMSALA-SIMLA,452,All
2024,12,DHARAMSALA,SIMLA,153,190,DHARAMSALA-SIMLA,343,All
2025,1,DHARAMSALA,SIMLA,213,208,DHARAMSALA-SIMLA,421,All
2025,2,DHARAMSALA,SIMLA,239,222,DHARAMSALA-SIMLA,461,All
2025,3,DHARAMSALA,SIMLA,211,208,DHARAMSALA-SIMLA,419,All
2025,3,DHARAMSALA,UDAIPUR,2,0,DHARAMSALA-UDAIPUR,2,All
2024,1,DIBRUGARH,DIMAPUR,509,631,DIBRUGARH-DIMAPUR,1140,All
2024,2,DIBRUGARH,DIMAPUR,328,224,DIBRUGARH-DIMAPUR,552,All
2024,3,DIBRUGARH,DIMAPUR,340,191,DIBRUGARH-DIMAPUR,531,All
2024,1,DIBRUGARH,GUWAHATI,8771,8343,DIBRUGARH-GUWAHATI,17114,All
2024,2,DIBRUGARH,GUWAHATI,6258,6975,DIBRUGARH-GUWAHATI,13233,All
2024,3,DIBRUGARH,GUWAHATI,7051,8349,DIBRUGARH-GUWAHATI,15400,All
2024,4,DIBRUGARH,GUWAHATI,6809,8807,DIBRUGARH-GUWAHATI,15616,All
2024,6,DIBRUGARH,GUWAHATI,5996,8184,DIBRUGARH-GUWAHATI,14180,All
2024,7,DIBRUGARH,GUWAHATI,7677,9274,DIBRUGARH-GUWAHATI,16951,All
2024,8,DIBRUGARH,GUWAHATI,6708,8946,DIBRUGARH-GUWAHATI,15654,All
2024,9,DIBRUGARH,GUWAHATI,5827,8152,DIBRUGARH-GUWAHATI,13979,All
2024,10,DIBRUGARH,GUWAHATI,7288,9413,DIBRUGARH-GUWAHATI,16701,All
2024,11,DIBRUGARH,GUWAHATI,7448,8120,DIBRUGARH-GUWAHATI,15568,All
2024,12,DIBRUGARH,GUWAHATI,7122,8744,DIBRUGARH-GUWAHATI,15866,All
2025,1,DIBRUGARH,GUWAHATI,6943,8541,DIBRUGARH-GUWAHATI,15484,All
2025,2,DIBRUGARH,GUWAHATI,7921,8827,DIBRUGARH-GUWAHATI,16748,All
2025,3,DIBRUGARH,GUWAHATI,9511,10047,DIBRUGARH-GUWAHATI,19558,All
2024,6,DIBRUGARH,HYDERABAD,181,381,DIBRUGARH-HYDERABAD,562,All
2024,7,DIBRUGARH,HYDERABAD,166,233,DIBRUGARH-HYDERABAD,399,All
2024,8,DIBRUGARH,HYDERABAD,131,225,DIBRUGARH-HYDERABAD,356,All
2024,9,DIBRUGARH,HYDERABAD,175,203,DIBRUGARH-HYDERABAD,378,All
2024,10,DIBRUGARH,HYDERABAD,302,283,DIBRUGARH-HYDERABAD,585,All
2024,11,DIBRUGARH,HYDERABAD,555,479,DIBRUGARH-HYDERABAD,1034,All
2024,12,DIBRUGARH,HYDERABAD,436,320,DIBRUGARH-HYDERABAD,756,All
2025,3,DIBRUGARH,HYDERABAD,185,301,DIBRUGARH-HYDERABAD,486,All
2024,1,DIBRUGARH,IMPHAL,2293,2776,DIBRUGARH-IMPHAL,5069,All
2024,2,DIBRUGARH,IMPHAL,2008,1719,DIBRUGARH-IMPHAL,3727,All
2024,3,DIBRUGARH,IMPHAL,2937,2952,DIBRUGARH-IMPHAL,5889,All
2024,4,DIBRUGARH,IMPHAL,3191,3171,DIBRUGARH-IMPHAL,6362,All
2024,6,DIBRUGARH,IMPHAL,3376,2642,DIBRUGARH-IMPHAL,6018,All
2024,7,DIBRUGARH,IMPHAL,2177,3046,DIBRUGARH-IMPHAL,5223,All
2024,8,DIBRUGARH,IMPHAL,1681,1942,DIBRUGARH-IMPHAL,3623,All
2024,9,DIBRUGARH,IMPHAL,1283,1638,DIBRUGARH-IMPHAL,2921,All
2024,10,DIBRUGARH,IMPHAL,2378,1991,DIBRUGARH-IMPHAL,4369,All
2024,11,DIBRUGARH,IMPHAL,1835,2122,DIBRUGARH-IMPHAL,3957,All
2024,12,DIBRUGARH,IMPHAL,3198,2125,DIBRUGARH-IMPHAL,5323,All
2025,1,DIBRUGARH,IMPHAL,2866,2688,DIBRUGARH-IMPHAL,5554,All
2025,2,DIBRUGARH,IMPHAL,2101,2091,DIBRUGARH-IMPHAL,4192,All
2025,3,DIBRUGARH,IMPHAL,2733,2081,DIBRUGARH-IMPHAL,4814,All
2024,1,DIBRUGARH,Itanagar,15,29,DIBRUGARH-Itanagar,44,All
2024,2,DIBRUGARH,Itanagar,25,32,DIBRUGARH-Itanagar,57,All
2024,3,DIBRUGARH,Itanagar,24,72,DIBRUGARH-Itanagar,96,All
2024,4,DIBRUGARH,Itanagar,58,87,DIBRUGARH-Itanagar,145,All
2024,6,DIBRUGARH,Itanagar,20,29,DIBRUGARH-Itanagar,49,All
2024,7,DIBRUGARH,Itanagar,22,50,DIBRUGARH-Itanagar,72,All
2024,8,DIBRUGARH,Itanagar,22,38,DIBRUGARH-Itanagar,60,All
2024,9,DIBRUGARH,Itanagar,16,35,DIBRUGARH-Itanagar,51,All
2024,10,DIBRUGARH,Itanagar,8,19,DIBRUGARH-Itanagar,27,All
2024,11,DIBRUGARH,Itanagar,9,12,DIBRUGARH-Itanagar,21,All
2024,12,DIBRUGARH,Itanagar,2,2,DIBRUGARH-Itanagar,4,All
2024,1,DIBRUGARH,KOLKATA,10307,11141,DIBRUGARH-KOLKATA,21448,All
2024,2,DIBRUGARH,KOLKATA,9017,10026,DIBRUGARH-KOLKATA,19043,All
2024,3,DIBRUGARH,KOLKATA,11032,11428,DIBRUGARH-KOLKATA,22460,All
2024,4,DIBRUGARH,KOLKATA,11245,11497,DIBRUGARH-KOLKATA,22742,All
2024,6,DIBRUGARH,KOLKATA,10411,8841,DIBRUGARH-KOLKATA,19252,All
2024,7,DIBRUGARH,KOLKATA,12143,10723,DIBRUGARH-KOLKATA,22866,All
2024,8,DIBRUGARH,KOLKATA,10258,8435,DIBRUGARH-KOLKATA,18693,All
2024,9,DIBRUGARH,KOLKATA,9997,8625,DIBRUGARH-KOLKATA,18622,All
2024,10,DIBRUGARH,KOLKATA,11661,11381,DIBRUGARH-KOLKATA,23042,All
2024,11,DIBRUGARH,KOLKATA,11527,11162,DIBRUGARH-KOLKATA,22689,All
2024,12,DIBRUGARH,KOLKATA,10538,10542,DIBRUGARH-KOLKATA,21080,All
2025,1,DIBRUGARH,KOLKATA,10676,10225,DIBRUGARH-KOLKATA,20901,All
2025,2,DIBRUGARH,KOLKATA,9036,8766,DIBRUGARH-KOLKATA,17802,All
2025,3,DIBRUGARH,KOLKATA,9996,9797,DIBRUGARH-KOLKATA,19793,All
2024,1,DIBRUGARH,SHILLONG,289,355,DIBRUGARH-SHILLONG,644,All
2024,2,DIBRUGARH,SHILLONG,210,180,DIBRUGARH-SHILLONG,390,All
2024,3,DIBRUGARH,SHILLONG,276,305,DIBRUGARH-SHILLONG,581,All
2024,4,DIBRUGARH,SHILLONG,153,204,DIBRUGARH-SHILLONG,357,All
2024,6,DIBRUGARH,SHILLONG,266,307,DIBRUGARH-SHILLONG,573,All
2024,7,DIBRUGARH,SHILLONG,533,377,DIBRUGARH-SHILLONG,910,All
2024,8,DIBRUGARH,SHILLONG,244,201,DIBRUGARH-SHILLONG,445,All
2024,9,DIBRUGARH,SHILLONG,177,205,DIBRUGARH-SHILLONG,382,All
2024,10,DIBRUGARH,SHILLONG,374,374,DIBRUGARH-SHILLONG,748,All
2024,1,DIBRUGARH,TEZU,16,15,DIBRUGARH-TEZU,31,All
2024,2,DIBRUGARH,TEZU,21,11,DIBRUGARH-TEZU,32,All
2024,3,DIBRUGARH,TEZU,36,25,DIBRUGARH-TEZU,61,All
2024,4,DIBRUGARH,TEZU,39,26,DIBRUGARH-TEZU,65,All
2024,6,DIBRUGARH,TEZU,9,8,DIBRUGARH-TEZU,17,All
2024,7,DIBRUGARH,TEZU,10,27,DIBRUGARH-TEZU,37,All
2024,8,DIBRUGARH,TEZU,11,5,DIBRUGARH-TEZU,16,All
2024,9,DIBRUGARH,TEZU,8,8,DIBRUGARH-TEZU,16,All
2024,10,DIBRUGARH,TEZU,5,5,DIBRUGARH-TEZU,10,All
2024,11,DIBRUGARH,TEZU,10,14,DIBRUGARH-TEZU,24,All
2024,12,DIBRUGARH,TEZU,1,7,DIBRUGARH-TEZU,8,All
2024,1,DIMAPUR,GUWAHATI,2859,1514,DIMAPUR-GUWAHATI,4373,All
2024,2,DIMAPUR,GUWAHATI,2598,1219,DIMAPUR-GUWAHATI,3817,All
2024,3,DIMAPUR,GUWAHATI,2665,1441,DIMAPUR-GUWAHATI,4106,All
2024,4,DIMAPUR,GUWAHATI,2364,1435,DIMAPUR-GUWAHATI,3799,All
2024,6,DIMAPUR,GUWAHATI,1883,1435,DIMAPUR-GUWAHATI,3318,All
2024,7,DIMAPUR,GUWAHATI,2769,2031,DIMAPUR-GUWAHATI,4800,All
2024,8,DIMAPUR,GUWAHATI,2496,1731,DIMAPUR-GUWAHATI,4227,All
2024,9,DIMAPUR,GUWAHATI,1684,1122,DIMAPUR-GUWAHATI,2806,All
2024,10,DIMAPUR,GUWAHATI,1430,1394,DIMAPUR-GUWAHATI,2824,All
2024,11,DIMAPUR,GUWAHATI,1549,1990,DIMAPUR-GUWAHATI,3539,All
2024,12,DIMAPUR,GUWAHATI,4331,5664,DIMAPUR-GUWAHATI,9995,All
2025,1,DIMAPUR,GUWAHATI,7826,5041,DIMAPUR-GUWAHATI,12867,All
2025,2,DIMAPUR,GUWAHATI,5325,4842,DIMAPUR-GUWAHATI,10167,All
2025,3,DIMAPUR,GUWAHATI,5703,6174,DIMAPUR-GUWAHATI,11877,All
2024,1,DIMAPUR,IMPHAL,640,700,DIMAPUR-IMPHAL,1340,All
2024,2,DIMAPUR,IMPHAL,716,518,DIMAPUR-IMPHAL,1234,All
2024,3,DIMAPUR,IMPHAL,855,793,DIMAPUR-IMPHAL,1648,All
2024,4,DIMAPUR,IMPHAL,632,687,DIMAPUR-IMPHAL,1319,All
2024,6,DIMAPUR,IMPHAL,806,720,DIMAPUR-IMPHAL,1526,All
2024,7,DIMAPUR,IMPHAL,768,770,DIMAPUR-IMPHAL,1538,All
2024,8,DIMAPUR,IMPHAL,660,660,DIMAPUR-IMPHAL,1320,All
2024,9,DIMAPUR,IMPHAL,767,738,DIMAPUR-IMPHAL,1505,All
2024,10,DIMAPUR,IMPHAL,434,450,DIMAPUR-IMPHAL,884,All
2024,11,DIMAPUR,IMPHAL,326,388,DIMAPUR-IMPHAL,714,All
2024,12,DIMAPUR,IMPHAL,546,478,DIMAPUR-IMPHAL,1024,All
2025,1,DIMAPUR,IMPHAL,505,490,DIMAPUR-IMPHAL,995,All
2025,2,DIMAPUR,IMPHAL,509,502,DIMAPUR-IMPHAL,1011,All
2025,3,DIMAPUR,IMPHAL,511,475,DIMAPUR-IMPHAL,986,All
2024,4,DIMAPUR,JAIPUR,12,0,DIMAPUR-JAIPUR,12,All
2024,1,DIMAPUR,KOLKATA,6928,6435,DIMAPUR-KOLKATA,13363,All
2024,2,DIMAPUR,KOLKATA,5349,5470,DIMAPUR-KOLKATA,10819,All
2024,3,DIMAPUR,KOLKATA,5191,6002,DIMAPUR-KOLKATA,11193,All
2024,4,DIMAPUR,KOLKATA,5097,5789,DIMAPUR-KOLKATA,10886,All
2024,6,DIMAPUR,KOLKATA,5519,5522,DIMAPUR-KOLKATA,11041,All
2024,7,DIMAPUR,KOLKATA,6361,6032,DIMAPUR-KOLKATA,12393,All
2024,8,DIMAPUR,KOLKATA,5570,5425,DIMAPUR-KOLKATA,10995,All
2024,9,DIMAPUR,KOLKATA,5555,5345,DIMAPUR-KOLKATA,10900,All
2024,10,DIMAPUR,KOLKATA,5909,5412,DIMAPUR-KOLKATA,11321,All
2024,11,DIMAPUR,KOLKATA,5607,6866,DIMAPUR-KOLKATA,12473,All
2024,12,DIMAPUR,KOLKATA,5075,5217,DIMAPUR-KOLKATA,10292,All
2025,1,DIMAPUR,KOLKATA,5386,4656,DIMAPUR-KOLKATA,10042,All
2025,2,DIMAPUR,KOLKATA,4232,3337,DIMAPUR-KOLKATA,7569,All
2025,3,DIMAPUR,KOLKATA,4861,4281,DIMAPUR-KOLKATA,9142,All
2024,1,DIMAPUR,SHILLONG,512,452,DIMAPUR-SHILLONG,964,All
2024,2,DIMAPUR,SHILLONG,462,400,DIMAPUR-SHILLONG,862,All
2024,3,DIMAPUR,SHILLONG,453,556,DIMAPUR-SHILLONG,1009,All
2024,4,DIMAPUR,SHILLONG,634,693,DIMAPUR-SHILLONG,1327,All
2024,6,DIMAPUR,SHILLONG,711,618,DIMAPUR-SHILLONG,1329,All
2024,7,DIMAPUR,SHILLONG,1007,941,DIMAPUR-SHILLONG,1948,All
2024,8,DIMAPUR,SHILLONG,1124,1017,DIMAPUR-SHILLONG,2141,All
2024,9,DIMAPUR,SHILLONG,1008,849,DIMAPUR-SHILLONG,1857,All
2024,10,DIMAPUR,SHILLONG,815,784,DIMAPUR-SHILLONG,1599,All
2024,1,DIU,KESHOD,70,40,DIU-KESHOD,110,All
2024,10,DIU,KESHOD,5,13,DIU-KESHOD,18,All
2024,11,DIU,KESHOD,12,62,DIU-KESHOD,74,All
2024,12,DIU,KESHOD,4,36,DIU-KESHOD,40,All
2025,1,DIU,KESHOD,5,26,DIU-KESHOD,31,All
2025,2,DIU,KESHOD,5,34,DIU-KESHOD,39,All
2025,3,DIU,KESHOD,8,15,DIU-KESHOD,23,All
2024,1,DIU,MUMBAI,1801,1792,DIU-MUMBAI,3593,All
2024,2,DIU,MUMBAI,1867,1773,DIU-MUMBAI,3640,All
2024,3,DIU,MUMBAI,1755,1697,DIU-MUMBAI,3452,All
2024,4,DIU,MUMBAI,1400,1275,DIU-MUMBAI,2675,All
2024,6,DIU,MUMBAI,1347,1143,DIU-MUMBAI,2490,All
2024,7,DIU,MUMBAI,429,555,DIU-MUMBAI,984,All
2024,8,DIU,MUMBAI,1092,1206,DIU-MUMBAI,2298,All
2024,9,DIU,MUMBAI,1022,889,DIU-MUMBAI,1911,All
2024,10,DIU,MUMBAI,944,1100,DIU-MUMBAI,2044,All
2024,11,DIU,MUMBAI,1749,1766,DIU-MUMBAI,3515,All
2024,12,DIU,MUMBAI,1607,1601,DIU-MUMBAI,3208,All
2025,1,DIU,MUMBAI,1218,1162,DIU-MUMBAI,2380,All
2025,2,DIU,MUMBAI,1335,1364,DIU-MUMBAI,2699,All
2025,3,DIU,MUMBAI,780,680,DIU-MUMBAI,1460,All
2024,1,DIU,SURAT,1581,1312,DIU-SURAT,2893,All
2024,2,DIU,SURAT,1151,1129,DIU-SURAT,2280,All
2024,3,DIU,SURAT,1318,1192,DIU-SURAT,2510,All
2024,4,DIU,SURAT,1207,943,DIU-SURAT,2150,All
2024,6,DIU,SURAT,1135,852,DIU-SURAT,1987,All
2024,7,DIU,SURAT,383,335,DIU-SURAT,718,All
2024,8,DIU,SURAT,1262,1026,DIU-SURAT,2288,All
2024,9,DIU,SURAT,1196,973,DIU-SURAT,2169,All
2024,10,DIU,SURAT,1358,1397,DIU-SURAT,2755,All
2024,11,DIU,SURAT,1934,1589,DIU-SURAT,3523,All
2024,12,DIU,SURAT,1760,1544,DIU-SURAT,3304,All
2025,1,DIU,SURAT,2005,1864,DIU-SURAT,3869,All
2025,2,DIU,SURAT,1900,1770,DIU-SURAT,3670,All
2025,3,DIU,SURAT,1903,1487,DIU-SURAT,3390,All
2024,8,DURGAPUR,GUWAHATI,52,32,DURGAPUR-GUWAHATI,84,All
2024,9,DURGAPUR,GUWAHATI,426,414,DURGAPUR-GUWAHATI,840,All
2024,10,DURGAPUR,GUWAHATI,391,433,DURGAPUR-GUWAHATI,824,All
2024,11,DURGAPUR,GUWAHATI,615,566,DURGAPUR-GUWAHATI,1181,All
2024,12,DURGAPUR,GUWAHATI,808,617,DURGAPUR-GUWAHATI,1425,All
2025,1,DURGAPUR,GUWAHATI,675,533,DURGAPUR-GUWAHATI,1208,All
2025,2,DURGAPUR,GUWAHATI,548,427,DURGAPUR-GUWAHATI,975,All
2025,3,DURGAPUR,GUWAHATI,577,468,DURGAPUR-GUWAHATI,1045,All
2024,1,DURGAPUR,HYDERABAD,3994,4324,DURGAPUR-HYDERABAD,8318,All
2024,2,DURGAPUR,HYDERABAD,3687,4044,DURGAPUR-HYDERABAD,7731,All
2024,3,DURGAPUR,HYDERABAD,4013,4420,DURGAPUR-HYDERABAD,8433,All
2024,4,DURGAPUR,HYDERABAD,4213,4866,DURGAPUR-HYDERABAD,9079,All
2024,6,DURGAPUR,HYDERABAD,5045,4925,DURGAPUR-HYDERABAD,9970,All
2024,7,DURGAPUR,HYDERABAD,5976,5120,DURGAPUR-HYDERABAD,11096,All
2024,8,DURGAPUR,HYDERABAD,5201,5011,DURGAPUR-HYDERABAD,10212,All
2024,9,DURGAPUR,HYDERABAD,4483,5275,DURGAPUR-HYDERABAD,9758,All
2024,10,DURGAPUR,HYDERABAD,4245,5251,DURGAPUR-HYDERABAD,9496,All
2024,11,DURGAPUR,HYDERABAD,5112,4388,DURGAPUR-HYDERABAD,9500,All
2024,12,DURGAPUR,HYDERABAD,4724,4640,DURGAPUR-HYDERABAD,9364,All
2025,1,DURGAPUR,HYDERABAD,4906,5156,DURGAPUR-HYDERABAD,10062,All
2025,2,DURGAPUR,HYDERABAD,4344,4707,DURGAPUR-HYDERABAD,9051,All
2025,3,DURGAPUR,HYDERABAD,4854,5060,DURGAPUR-HYDERABAD,9914,All
2024,7,DURGAPUR,JAIPUR,16,0,DURGAPUR-JAIPUR,16,All
2025,2,DURGAPUR,KOLKATA,51,0,DURGAPUR-KOLKATA,51,All
2024,1,DURGAPUR,MUMBAI,4122,4078,DURGAPUR-MUMBAI,8200,All
2024,2,DURGAPUR,MUMBAI,3366,3537,DURGAPUR-MUMBAI,6903,All
2024,3,DURGAPUR,MUMBAI,2347,2400,DURGAPUR-MUMBAI,4747,All
2024,4,DURGAPUR,MUMBAI,2287,2845,DURGAPUR-MUMBAI,5132,All
2024,6,DURGAPUR,MUMBAI,2731,2708,DURGAPUR-MUMBAI,5439,All
2024,7,DURGAPUR,MUMBAI,2936,2376,DURGAPUR-MUMBAI,5312,All
2024,8,DURGAPUR,MUMBAI,2372,2048,DURGAPUR-MUMBAI,4420,All
2024,9,DURGAPUR,MUMBAI,1982,2128,DURGAPUR-MUMBAI,4110,All
2024,10,DURGAPUR,MUMBAI,2117,2884,DURGAPUR-MUMBAI,5001,All
2024,11,DURGAPUR,MUMBAI,2952,2838,DURGAPUR-MUMBAI,5790,All
2024,12,DURGAPUR,MUMBAI,2767,2810,DURGAPUR-MUMBAI,5577,All
2025,1,DURGAPUR,MUMBAI,3033,3146,DURGAPUR-MUMBAI,6179,All
2025,2,DURGAPUR,MUMBAI,2513,2808,DURGAPUR-MUMBAI,5321,All
2025,3,DURGAPUR,MUMBAI,2692,3142,DURGAPUR-MUMBAI,5834,All
2025,3,DURGAPUR,RAIPUR,4,0,DURGAPUR-RAIPUR,4,All
2024,1,DURGAPUR,SURAT,0,43,DURGAPUR-SURAT,43,All
2024,2,DURGAPUR,SURAT,0,30,DURGAPUR-SURAT,30,All
2024,3,DURGAPUR,SURAT,0,18,DURGAPUR-SURAT,18,All
2024,6,DURGAPUR,SURAT,0,4,DURGAPUR-SURAT,4,All
2024,7,DURGAPUR,SURAT,0,3,DURGAPUR-SURAT,3,All
2024,8,DURGAPUR,SURAT,0,8,DURGAPUR-SURAT,8,All
2024,9,DURGAPUR,SURAT,0,11,DURGAPUR-SURAT,11,All
2024,10,DURGAPUR,SURAT,0,16,DURGAPUR-SURAT,16,All
2024,3,DehraDun,Ayodhya International Airport ,615,537,Ayodhya International Airport -DehraDun,1152,All
2024,4,DehraDun,Ayodhya International Airport ,148,130,Ayodhya International Airport -DehraDun,278,All
2024,6,DehraDun,Ayodhya International Airport ,141,123,Ayodhya International Airport -DehraDun,264,All
2024,7,DehraDun,Ayodhya International Airport ,169,143,Ayodhya International Airport -DehraDun,312,All
2024,8,DehraDun,Ayodhya International Airport ,225,239,Ayodhya International Airport -DehraDun,464,All
2024,9,DehraDun,Ayodhya International Airport ,184,143,Ayodhya International Airport -DehraDun,327,All
2024,10,DehraDun,Ayodhya International Airport ,63,64,Ayodhya International Airport -DehraDun,127,All
2024,1,DehraDun,DELHI,20428,20025,DehraDun-DELHI,40453,All
2024,2,DehraDun,DELHI,22259,23095,DehraDun-DELHI,45354,All
2024,3,DehraDun,DELHI,24616,25225,DehraDun-DELHI,49841,All
2024,4,DehraDun,DELHI,22486,22911,DehraDun-DELHI,45397,All
2024,6,DehraDun,DELHI,26774,26180,DehraDun-DELHI,52954,All
2024,7,DehraDun,DELHI,23804,23938,DehraDun-DELHI,47742,All
2024,8,DehraDun,DELHI,24017,23639,DehraDun-DELHI,47656,All
2024,9,DehraDun,DELHI,23986,24346,DehraDun-DELHI,48332,All
2024,10,DehraDun,DELHI,24688,24744,DehraDun-DELHI,49432,All
2024,11,DehraDun,DELHI,23748,24207,DehraDun-DELHI,47955,All
2024,12,DehraDun,DELHI,23214,22577,DehraDun-DELHI,45791,All
2025,1,DehraDun,DELHI,21933,21801,DehraDun-DELHI,43734,All
2025,2,DehraDun,DELHI,23023,23999,DehraDun-DELHI,47022,All
2025,3,DehraDun,DELHI,27814,28477,DehraDun-DELHI,56291,All
2024,1,DehraDun,GHAZIABAD,1,1,DehraDun-GHAZIABAD,2,All
2024,3,DehraDun,GUWAHATI,4,2,DehraDun-GUWAHATI,6,All
2024,4,DehraDun,GUWAHATI,133,137,DehraDun-GUWAHATI,270,All
2024,6,DehraDun,GUWAHATI,163,288,DehraDun-GUWAHATI,451,All
2024,7,DehraDun,GUWAHATI,318,308,DehraDun-GUWAHATI,626,All
2024,8,DehraDun,GUWAHATI,359,122,DehraDun-GUWAHATI,481,All
2024,9,DehraDun,GUWAHATI,234,137,DehraDun-GUWAHATI,371,All
2024,10,DehraDun,GUWAHATI,207,192,DehraDun-GUWAHATI,399,All
2024,11,DehraDun,GUWAHATI,260,433,DehraDun-GUWAHATI,693,All
2024,12,DehraDun,GUWAHATI,231,223,DehraDun-GUWAHATI,454,All
2025,3,DehraDun,GUWAHATI,195,183,DehraDun-GUWAHATI,378,All
2024,1,DehraDun,Goa,1150,1141,DehraDun-Goa,2291,All
2024,2,DehraDun,HINDON AIRPORT,3,5,DehraDun-HINDON AIRPORT,8,All
2024,1,DehraDun,HYDERABAD,4687,5207,DehraDun-HYDERABAD,9894,All
2024,2,DehraDun,HYDERABAD,4624,4806,DehraDun-HYDERABAD,9430,All
2024,3,DehraDun,HYDERABAD,4704,4916,DehraDun-HYDERABAD,9620,All
2024,4,DehraDun,HYDERABAD,4432,4862,DehraDun-HYDERABAD,9294,All
2024,6,DehraDun,HYDERABAD,4968,4467,DehraDun-HYDERABAD,9435,All
2024,7,DehraDun,HYDERABAD,4541,4800,DehraDun-HYDERABAD,9341,All
2024,8,DehraDun,HYDERABAD,3897,4622,DehraDun-HYDERABAD,8519,All
2024,9,DehraDun,HYDERABAD,4059,4546,DehraDun-HYDERABAD,8605,All
2024,10,DehraDun,HYDERABAD,4437,5009,DehraDun-HYDERABAD,9446,All
2024,11,DehraDun,HYDERABAD,4803,4079,DehraDun-HYDERABAD,8882,All
2024,12,DehraDun,HYDERABAD,5402,4841,DehraDun-HYDERABAD,10243,All
2025,1,DehraDun,HYDERABAD,4237,4540,DehraDun-HYDERABAD,8777,All
2025,2,DehraDun,HYDERABAD,4289,4720,DehraDun-HYDERABAD,9009,All
2025,3,DehraDun,HYDERABAD,4885,4840,DehraDun-HYDERABAD,9725,All
2024,10,DehraDun,INDORE,68,74,DehraDun-INDORE,142,All
2024,11,DehraDun,INDORE,400,398,DehraDun-INDORE,798,All
2024,12,DehraDun,INDORE,426,429,DehraDun-INDORE,855,All
2025,3,DehraDun,INDORE,468,492,DehraDun-INDORE,960,All
2024,1,DehraDun,JAIPUR,2396,2915,DehraDun-JAIPUR,5311,All
2024,2,DehraDun,JAIPUR,2875,3396,DehraDun-JAIPUR,6271,All
2024,3,DehraDun,JAIPUR,3635,3556,DehraDun-JAIPUR,7191,All
2024,4,DehraDun,JAIPUR,3500,3424,DehraDun-JAIPUR,6924,All
2024,6,DehraDun,JAIPUR,3853,3238,DehraDun-JAIPUR,7091,All
2024,7,DehraDun,JAIPUR,3240,2871,DehraDun-JAIPUR,6111,All
2024,8,DehraDun,JAIPUR,2711,2691,DehraDun-JAIPUR,5402,All
2024,9,DehraDun,JAIPUR,3426,3350,DehraDun-JAIPUR,6776,All
2024,10,DehraDun,JAIPUR,3843,3392,DehraDun-JAIPUR,7235,All
2024,11,DehraDun,JAIPUR,3960,3448,DehraDun-JAIPUR,7408,All
2024,12,DehraDun,JAIPUR,2816,2603,DehraDun-JAIPUR,5419,All
2025,1,DehraDun,JAIPUR,1691,1787,DehraDun-JAIPUR,3478,All
2025,2,DehraDun,JAIPUR,3008,2890,DehraDun-JAIPUR,5898,All
2025,3,DehraDun,JAIPUR,3635,3404,DehraDun-JAIPUR,7039,All
2024,3,DehraDun,KOLKATA,164,150,DehraDun-KOLKATA,314,All
2024,4,DehraDun,KOLKATA,2692,2575,DehraDun-KOLKATA,5267,All
2024,6,DehraDun,KOLKATA,2856,2465,DehraDun-KOLKATA,5321,All
2024,7,DehraDun,KOLKATA,2868,2709,DehraDun-KOLKATA,5577,All
2024,8,DehraDun,KOLKATA,2417,2389,DehraDun-KOLKATA,4806,All
2024,9,DehraDun,KOLKATA,2498,2539,DehraDun-KOLKATA,5037,All
2024,10,DehraDun,KOLKATA,2569,2187,DehraDun-KOLKATA,4756,All
2024,11,DehraDun,KOLKATA,2626,2330,DehraDun-KOLKATA,4956,All
2024,12,DehraDun,KOLKATA,2896,2532,DehraDun-KOLKATA,5428,All
2025,1,DehraDun,KOLKATA,2810,3063,DehraDun-KOLKATA,5873,All
2025,2,DehraDun,KOLKATA,2935,2881,DehraDun-KOLKATA,5816,All
2025,3,DehraDun,KOLKATA,3329,3120,DehraDun-KOLKATA,6449,All
2024,6,DehraDun,KULLU,223,129,DehraDun-KULLU,352,All
2024,7,DehraDun,KULLU,147,152,DehraDun-KULLU,299,All
2024,8,DehraDun,KULLU,87,117,DehraDun-KULLU,204,All
2024,9,DehraDun,KULLU,139,121,DehraDun-KULLU,260,All
2024,10,DehraDun,KULLU,391,321,DehraDun-KULLU,712,All
2024,11,DehraDun,KULLU,355,246,DehraDun-KULLU,601,All
2024,12,DehraDun,KULLU,57,15,DehraDun-KULLU,72,All
2025,1,DehraDun,KULLU,243,138,DehraDun-KULLU,381,All
2025,2,DehraDun,KULLU,103,65,DehraDun-KULLU,168,All
2025,3,DehraDun,KULLU,140,72,DehraDun-KULLU,212,All
2024,1,DehraDun,LUCKNOW,3970,4308,DehraDun-LUCKNOW,8278,All
2024,2,DehraDun,LUCKNOW,3774,3986,DehraDun-LUCKNOW,7760,All
2024,3,DehraDun,LUCKNOW,4146,4299,DehraDun-LUCKNOW,8445,All
2024,4,DehraDun,LUCKNOW,4209,4119,DehraDun-LUCKNOW,8328,All
2024,6,DehraDun,LUCKNOW,4342,4233,DehraDun-LUCKNOW,8575,All
2024,7,DehraDun,LUCKNOW,3569,3987,DehraDun-LUCKNOW,7556,All
2024,8,DehraDun,LUCKNOW,3900,4442,DehraDun-LUCKNOW,8342,All
2024,9,DehraDun,LUCKNOW,4066,4431,DehraDun-LUCKNOW,8497,All
2024,10,DehraDun,LUCKNOW,4974,4505,DehraDun-LUCKNOW,9479,All
2024,11,DehraDun,LUCKNOW,3651,4255,DehraDun-LUCKNOW,7906,All
2024,12,DehraDun,LUCKNOW,4015,4191,DehraDun-LUCKNOW,8206,All
2025,1,DehraDun,LUCKNOW,3741,3905,DehraDun-LUCKNOW,7646,All
2025,2,DehraDun,LUCKNOW,4092,4275,DehraDun-LUCKNOW,8367,All
2025,3,DehraDun,LUCKNOW,3096,3916,DehraDun-LUCKNOW,7012,All
2024,1,DehraDun,MUMBAI,10010,9315,DehraDun-MUMBAI,19325,All
2024,2,DehraDun,MUMBAI,9843,9461,DehraDun-MUMBAI,19304,All
2024,3,DehraDun,MUMBAI,13180,13003,DehraDun-MUMBAI,26183,All
2024,4,DehraDun,MUMBAI,13996,14801,DehraDun-MUMBAI,28797,All
2024,6,DehraDun,MUMBAI,15943,13082,DehraDun-MUMBAI,29025,All
2024,7,DehraDun,MUMBAI,11271,9655,DehraDun-MUMBAI,20926,All
2024,8,DehraDun,MUMBAI,11120,10345,DehraDun-MUMBAI,21465,All
2024,9,DehraDun,MUMBAI,12829,13217,DehraDun-MUMBAI,26046,All
2024,10,DehraDun,MUMBAI,9222,9551,DehraDun-MUMBAI,18773,All
2024,11,DehraDun,MUMBAI,9734,9160,DehraDun-MUMBAI,18894,All
2024,12,DehraDun,MUMBAI,10183,9559,DehraDun-MUMBAI,19742,All
2025,1,DehraDun,MUMBAI,9259,9624,DehraDun-MUMBAI,18883,All
2025,2,DehraDun,MUMBAI,8891,9307,DehraDun-MUMBAI,18198,All
2025,3,DehraDun,MUMBAI,12577,12097,DehraDun-MUMBAI,24674,All
2024,3,DehraDun,PANTNAGAR,17,34,DehraDun-PANTNAGAR,51,All
2024,6,DehraDun,PANTNAGAR,19,86,DehraDun-PANTNAGAR,105,All
2024,7,DehraDun,PANTNAGAR,16,25,DehraDun-PANTNAGAR,41,All
2024,8,DehraDun,PANTNAGAR,15,53,DehraDun-PANTNAGAR,68,All
2024,9,DehraDun,PANTNAGAR,34,30,DehraDun-PANTNAGAR,64,All
2024,2,DehraDun,PITHORAGARH,120,133,DehraDun-PITHORAGARH,253,All
2024,3,DehraDun,PITHORAGARH,207,190,DehraDun-PITHORAGARH,397,All
2024,4,DehraDun,PITHORAGARH,235,247,DehraDun-PITHORAGARH,482,All
2024,6,DehraDun,PITHORAGARH,251,245,DehraDun-PITHORAGARH,496,All
2024,7,DehraDun,PITHORAGARH,92,117,DehraDun-PITHORAGARH,209,All
2024,8,DehraDun,PITHORAGARH,165,183,DehraDun-PITHORAGARH,348,All
2024,9,DehraDun,PITHORAGARH,184,185,DehraDun-PITHORAGARH,369,All
2024,10,DehraDun,PITHORAGARH,265,254,DehraDun-PITHORAGARH,519,All
2024,11,DehraDun,PITHORAGARH,320,328,DehraDun-PITHORAGARH,648,All
2024,12,DehraDun,PITHORAGARH,211,202,DehraDun-PITHORAGARH,413,All
2025,1,DehraDun,PITHORAGARH,162,140,DehraDun-PITHORAGARH,302,All
2025,2,DehraDun,PITHORAGARH,144,158,DehraDun-PITHORAGARH,302,All
2025,3,DehraDun,PITHORAGARH,249,246,DehraDun-PITHORAGARH,495,All
2024,1,DehraDun,PUNE,4021,3844,DehraDun-PUNE,7865,All
2024,2,DehraDun,PUNE,3872,4000,DehraDun-PUNE,7872,All
2024,3,DehraDun,PUNE,4122,4296,DehraDun-PUNE,8418,All
2024,4,DehraDun,PUNE,4222,4557,DehraDun-PUNE,8779,All
2024,6,DehraDun,PUNE,4437,3962,DehraDun-PUNE,8399,All
2024,7,DehraDun,PUNE,4458,4241,DehraDun-PUNE,8699,All
2024,8,DehraDun,PUNE,3856,3972,DehraDun-PUNE,7828,All
2024,9,DehraDun,PUNE,3841,4104,DehraDun-PUNE,7945,All
2024,10,DehraDun,PUNE,3605,4341,DehraDun-PUNE,7946,All
2024,11,DehraDun,PUNE,4173,4024,DehraDun-PUNE,8197,All
2024,12,DehraDun,PUNE,4602,4284,DehraDun-PUNE,8886,All
2025,1,DehraDun,PUNE,4444,4463,DehraDun-PUNE,8907,All
2025,2,DehraDun,PUNE,4045,4217,DehraDun-PUNE,8262,All
2025,3,DehraDun,PUNE,4306,4355,DehraDun-PUNE,8661,All
2025,2,DehraDun,SRINAGAR,862,940,DehraDun-SRINAGAR,1802,All
2025,3,DehraDun,SRINAGAR,1575,1139,DehraDun-SRINAGAR,2714,All
2024,4,Deoghar ,JAIPUR,8,0,Deoghar -JAIPUR,8,All
2024,1,Deoghar ,KOLKATA,800,791,Deoghar -KOLKATA,1591,All
2024,2,Deoghar ,KOLKATA,1391,1509,Deoghar -KOLKATA,2900,All
2024,3,Deoghar ,KOLKATA,1850,2007,Deoghar -KOLKATA,3857,All
2024,4,Deoghar ,KOLKATA,1828,1855,Deoghar -KOLKATA,3683,All
2024,6,Deoghar ,KOLKATA,1866,1719,Deoghar -KOLKATA,3585,All
2024,7,Deoghar ,KOLKATA,1895,1831,Deoghar -KOLKATA,3726,All
2024,8,Deoghar ,KOLKATA,1953,1595,Deoghar -KOLKATA,3548,All
2024,9,Deoghar ,KOLKATA,1914,1798,Deoghar -KOLKATA,3712,All
2024,10,Deoghar ,KOLKATA,1710,1833,Deoghar -KOLKATA,3543,All
2024,11,Deoghar ,KOLKATA,2105,2010,Deoghar -KOLKATA,4115,All
2024,12,Deoghar ,KOLKATA,2196,1682,Deoghar -KOLKATA,3878,All
2025,1,Deoghar ,KOLKATA,1891,1674,Deoghar -KOLKATA,3565,All
2025,2,Deoghar ,KOLKATA,1881,1663,Deoghar -KOLKATA,3544,All
2025,3,Deoghar ,KOLKATA,1999,2108,Deoghar -KOLKATA,4107,All
2024,12,Deoghar ,MUMBAI,2283,2205,Deoghar -MUMBAI,4488,All
2025,1,Deoghar ,MUMBAI,2160,2011,Deoghar -MUMBAI,4171,All
2025,2,Deoghar ,MUMBAI,1994,2087,Deoghar -MUMBAI,4081,All
2025,3,Deoghar ,MUMBAI,2114,2198,Deoghar -MUMBAI,4312,All
2024,1,Deoghar ,PATNA,262,258,Deoghar -PATNA,520,All
2024,2,Deoghar ,PATNA,547,522,Deoghar -PATNA,1069,All
2024,3,Deoghar ,PATNA,637,761,Deoghar -PATNA,1398,All
2024,4,Deoghar ,PATNA,571,730,Deoghar -PATNA,1301,All
2024,6,Deoghar ,PATNA,259,233,Deoghar -PATNA,492,All
2024,7,Deoghar ,PATNA,402,298,Deoghar -PATNA,700,All
2024,8,Deoghar ,PATNA,351,256,Deoghar -PATNA,607,All
2024,9,Deoghar ,PATNA,533,492,Deoghar -PATNA,1025,All
2024,10,Deoghar ,PATNA,630,620,Deoghar -PATNA,1250,All
2024,11,Deoghar ,PATNA,519,489,Deoghar -PATNA,1008,All
2024,12,Deoghar ,PATNA,590,530,Deoghar -PATNA,1120,All
2025,1,Deoghar ,PATNA,816,366,Deoghar -PATNA,1182,All
2025,2,Deoghar ,PATNA,761,688,Deoghar -PATNA,1449,All
2024,1,Deoghar ,RANCHI,183,185,Deoghar -RANCHI,368,All
2024,2,Deoghar ,RANCHI,390,491,Deoghar -RANCHI,881,All
2024,3,Deoghar ,RANCHI,672,667,Deoghar -RANCHI,1339,All
2024,4,Deoghar ,RANCHI,460,556,Deoghar -RANCHI,1016,All
2024,6,Deoghar ,RANCHI,301,338,Deoghar -RANCHI,639,All
2024,7,Deoghar ,RANCHI,340,477,Deoghar -RANCHI,817,All
2024,8,Deoghar ,RANCHI,413,490,Deoghar -RANCHI,903,All
2024,9,Deoghar ,RANCHI,351,640,Deoghar -RANCHI,991,All
2024,10,Deoghar ,RANCHI,499,690,Deoghar -RANCHI,1189,All
2024,11,Deoghar ,RANCHI,711,867,Deoghar -RANCHI,1578,All
2024,12,Deoghar ,RANCHI,670,787,Deoghar -RANCHI,1457,All
2025,1,Deoghar ,RANCHI,427,971,Deoghar -RANCHI,1398,All
2025,2,Deoghar ,RANCHI,623,793,Deoghar -RANCHI,1416,All
2024,1,GAYA,KOLKATA,4630,3730,GAYA-KOLKATA,8360,All
2024,2,GAYA,KOLKATA,4027,4387,GAYA-KOLKATA,8414,All
2024,3,GAYA,KOLKATA,4886,4742,GAYA-KOLKATA,9628,All
2024,4,GAYA,KOLKATA,4659,4719,GAYA-KOLKATA,9378,All
2024,6,GAYA,KOLKATA,4607,4170,GAYA-KOLKATA,8777,All
2024,7,GAYA,KOLKATA,4382,4539,GAYA-KOLKATA,8921,All
2024,8,GAYA,KOLKATA,4213,4384,GAYA-KOLKATA,8597,All
2024,9,GAYA,KOLKATA,4562,4615,GAYA-KOLKATA,9177,All
2024,10,GAYA,KOLKATA,3617,4459,GAYA-KOLKATA,8076,All
2024,11,GAYA,KOLKATA,5055,4642,GAYA-KOLKATA,9697,All
2024,12,GAYA,KOLKATA,5355,3908,GAYA-KOLKATA,9263,All
2025,1,GAYA,KOLKATA,4138,4455,GAYA-KOLKATA,8593,All
2025,2,GAYA,KOLKATA,4675,4612,GAYA-KOLKATA,9287,All
2025,3,GAYA,KOLKATA,5035,5020,GAYA-KOLKATA,10055,All
2024,1,GORAKHPUR,HYDERABAD,4739,4892,GORAKHPUR-HYDERABAD,9631,All
2024,2,GORAKHPUR,HYDERABAD,4592,4948,GORAKHPUR-HYDERABAD,9540,All
2024,3,GORAKHPUR,HYDERABAD,4941,5339,GORAKHPUR-HYDERABAD,10280,All
2024,4,GORAKHPUR,HYDERABAD,4549,5546,GORAKHPUR-HYDERABAD,10095,All
2024,6,GORAKHPUR,HYDERABAD,6040,6048,GORAKHPUR-HYDERABAD,12088,All
2024,7,GORAKHPUR,HYDERABAD,6143,5614,GORAKHPUR-HYDERABAD,11757,All
2024,8,GORAKHPUR,HYDERABAD,5362,6260,GORAKHPUR-HYDERABAD,11622,All
2024,9,GORAKHPUR,HYDERABAD,5258,6260,GORAKHPUR-HYDERABAD,11518,All
2024,10,GORAKHPUR,HYDERABAD,5351,6978,GORAKHPUR-HYDERABAD,12329,All
2024,11,GORAKHPUR,HYDERABAD,5928,6443,GORAKHPUR-HYDERABAD,12371,All
2024,12,GORAKHPUR,HYDERABAD,4947,4829,GORAKHPUR-HYDERABAD,9776,All
2025,1,GORAKHPUR,HYDERABAD,4948,6158,GORAKHPUR-HYDERABAD,11106,All
2025,2,GORAKHPUR,HYDERABAD,5062,5836,GORAKHPUR-HYDERABAD,10898,All
2025,3,GORAKHPUR,HYDERABAD,5690,6456,GORAKHPUR-HYDERABAD,12146,All
2024,4,GORAKHPUR,JAIPUR,6,0,GORAKHPUR-JAIPUR,6,All
2024,1,GORAKHPUR,KOLKATA,1814,1711,GORAKHPUR-KOLKATA,3525,All
2024,2,GORAKHPUR,KOLKATA,1961,2044,GORAKHPUR-KOLKATA,4005,All
2024,3,GORAKHPUR,KOLKATA,2098,2137,GORAKHPUR-KOLKATA,4235,All
2024,4,GORAKHPUR,KOLKATA,1956,2218,GORAKHPUR-KOLKATA,4174,All
2024,6,GORAKHPUR,KOLKATA,2125,1800,GORAKHPUR-KOLKATA,3925,All
2024,7,GORAKHPUR,KOLKATA,1976,1730,GORAKHPUR-KOLKATA,3706,All
2024,8,GORAKHPUR,KOLKATA,1813,1626,GORAKHPUR-KOLKATA,3439,All
2024,9,GORAKHPUR,KOLKATA,1838,1740,GORAKHPUR-KOLKATA,3578,All
2024,10,GORAKHPUR,KOLKATA,1974,2107,GORAKHPUR-KOLKATA,4081,All
2024,11,GORAKHPUR,KOLKATA,2113,2251,GORAKHPUR-KOLKATA,4364,All
2024,12,GORAKHPUR,KOLKATA,2362,2139,GORAKHPUR-KOLKATA,4501,All
2025,1,GORAKHPUR,KOLKATA,1980,1962,GORAKHPUR-KOLKATA,3942,All
2025,2,GORAKHPUR,KOLKATA,2035,2079,GORAKHPUR-KOLKATA,4114,All
2025,3,GORAKHPUR,KOLKATA,2196,2162,GORAKHPUR-KOLKATA,4358,All
2024,1,GORAKHPUR,LUCKNOW,1138,1097,GORAKHPUR-LUCKNOW,2235,All
2024,2,GORAKHPUR,LUCKNOW,793,1067,GORAKHPUR-LUCKNOW,1860,All
2024,3,GORAKHPUR,LUCKNOW,785,1064,GORAKHPUR-LUCKNOW,1849,All
2024,1,GORAKHPUR,MUMBAI,9840,9938,GORAKHPUR-MUMBAI,19778,All
2024,2,GORAKHPUR,MUMBAI,5057,5420,GORAKHPUR-MUMBAI,10477,All
2024,3,GORAKHPUR,MUMBAI,5510,5719,GORAKHPUR-MUMBAI,11229,All
2024,4,GORAKHPUR,MUMBAI,4903,5207,GORAKHPUR-MUMBAI,10110,All
2024,6,GORAKHPUR,MUMBAI,5345,5189,GORAKHPUR-MUMBAI,10534,All
2024,7,GORAKHPUR,MUMBAI,5508,5541,GORAKHPUR-MUMBAI,11049,All
2024,8,GORAKHPUR,MUMBAI,5940,6197,GORAKHPUR-MUMBAI,12137,All
2024,9,GORAKHPUR,MUMBAI,6228,6464,GORAKHPUR-MUMBAI,12692,All
2024,10,GORAKHPUR,MUMBAI,6176,6927,GORAKHPUR-MUMBAI,13103,All
2024,11,GORAKHPUR,MUMBAI,6539,6759,GORAKHPUR-MUMBAI,13298,All
2024,12,GORAKHPUR,MUMBAI,10142,9297,GORAKHPUR-MUMBAI,19439,All
2025,1,GORAKHPUR,MUMBAI,11502,10757,GORAKHPUR-MUMBAI,22259,All
2025,2,GORAKHPUR,MUMBAI,9778,10304,GORAKHPUR-MUMBAI,20082,All
2025,3,GORAKHPUR,MUMBAI,11731,12642,GORAKHPUR-MUMBAI,24373,All
2024,4,GORAKHPUR,VARANASI,0,77,GORAKHPUR-VARANASI,77,All
2024,7,GORAKHPUR,VARANASI,0,153,GORAKHPUR-VARANASI,153,All
2025,3,GORAKHPUR,VARANASI,0,225,GORAKHPUR-VARANASI,225,All
2024,1,GUWAHATI,HYDERABAD,6376,6277,GUWAHATI-HYDERABAD,12653,All
2024,2,GUWAHATI,HYDERABAD,5744,5723,GUWAHATI-HYDERABAD,11467,All
2024,3,GUWAHATI,HYDERABAD,5924,6209,GUWAHATI-HYDERABAD,12133,All
2024,4,GUWAHATI,HYDERABAD,5970,6960,GUWAHATI-HYDERABAD,12930,All
2024,6,GUWAHATI,HYDERABAD,6297,5594,GUWAHATI-HYDERABAD,11891,All
2024,7,GUWAHATI,HYDERABAD,7471,6521,GUWAHATI-HYDERABAD,13992,All
2024,8,GUWAHATI,HYDERABAD,7721,7111,GUWAHATI-HYDERABAD,14832,All
2024,9,GUWAHATI,HYDERABAD,13063,13269,GUWAHATI-HYDERABAD,26332,All
2024,10,GUWAHATI,HYDERABAD,14687,15428,GUWAHATI-HYDERABAD,30115,All
2024,11,GUWAHATI,HYDERABAD,14096,13823,GUWAHATI-HYDERABAD,27919,All
2024,12,GUWAHATI,HYDERABAD,15125,15237,GUWAHATI-HYDERABAD,30362,All
2025,1,GUWAHATI,HYDERABAD,15138,14733,GUWAHATI-HYDERABAD,29871,All
2025,2,GUWAHATI,HYDERABAD,13218,13694,GUWAHATI-HYDERABAD,26912,All
2025,3,GUWAHATI,HYDERABAD,14280,14917,GUWAHATI-HYDERABAD,29197,All
2024,1,GUWAHATI,IMPHAL,19417,20635,GUWAHATI-IMPHAL,40052,All
2024,2,GUWAHATI,IMPHAL,20549,20394,GUWAHATI-IMPHAL,40943,All
2024,3,GUWAHATI,IMPHAL,21734,23010,GUWAHATI-IMPHAL,44744,All
2024,4,GUWAHATI,IMPHAL,20537,21972,GUWAHATI-IMPHAL,42509,All
2024,6,GUWAHATI,IMPHAL,22574,20010,GUWAHATI-IMPHAL,42584,All
2024,7,GUWAHATI,IMPHAL,21104,21856,GUWAHATI-IMPHAL,42960,All
2024,8,GUWAHATI,IMPHAL,21162,22730,GUWAHATI-IMPHAL,43892,All
2024,9,GUWAHATI,IMPHAL,18935,21339,GUWAHATI-IMPHAL,40274,All
2024,10,GUWAHATI,IMPHAL,24342,23418,GUWAHATI-IMPHAL,47760,All
2024,11,GUWAHATI,IMPHAL,20268,22333,GUWAHATI-IMPHAL,42601,All
2024,12,GUWAHATI,IMPHAL,21362,20159,GUWAHATI-IMPHAL,41521,All
2025,1,GUWAHATI,IMPHAL,20610,20718,GUWAHATI-IMPHAL,41328,All
2025,2,GUWAHATI,IMPHAL,20192,22320,GUWAHATI-IMPHAL,42512,All
2025,3,GUWAHATI,IMPHAL,25184,23504,GUWAHATI-IMPHAL,48688,All
2024,8,GUWAHATI,Itanagar,30,26,GUWAHATI-Itanagar,56,All
2024,9,GUWAHATI,Itanagar,148,109,GUWAHATI-Itanagar,257,All
2024,10,GUWAHATI,Itanagar,100,86,GUWAHATI-Itanagar,186,All
2024,11,GUWAHATI,Itanagar,62,49,GUWAHATI-Itanagar,111,All
2024,12,GUWAHATI,Itanagar,138,131,GUWAHATI-Itanagar,269,All
2025,1,GUWAHATI,Itanagar,121,106,GUWAHATI-Itanagar,227,All
2025,2,GUWAHATI,Itanagar,121,110,GUWAHATI-Itanagar,231,All
2025,3,GUWAHATI,Itanagar,102,73,GUWAHATI-Itanagar,175,All
2024,1,GUWAHATI,JAIPUR,5158,5005,GUWAHATI-JAIPUR,10163,All
2024,2,GUWAHATI,JAIPUR,4749,5088,GUWAHATI-JAIPUR,9837,All
2024,3,GUWAHATI,JAIPUR,4821,5388,GUWAHATI-JAIPUR,10209,All
2024,4,GUWAHATI,JAIPUR,852,913,GUWAHATI-JAIPUR,1765,All
2024,6,GUWAHATI,JAIPUR,1670,1514,GUWAHATI-JAIPUR,3184,All
2024,7,GUWAHATI,JAIPUR,1951,1675,GUWAHATI-JAIPUR,3626,All
2024,8,GUWAHATI,JAIPUR,3076,2850,GUWAHATI-JAIPUR,5926,All
2024,9,GUWAHATI,JAIPUR,3538,3570,GUWAHATI-JAIPUR,7108,All
2024,10,GUWAHATI,JAIPUR,4822,5307,GUWAHATI-JAIPUR,10129,All
2024,11,GUWAHATI,JAIPUR,4964,5123,GUWAHATI-JAIPUR,10087,All
2024,12,GUWAHATI,JAIPUR,5046,5529,GUWAHATI-JAIPUR,10575,All
2025,1,GUWAHATI,JAIPUR,4964,4498,GUWAHATI-JAIPUR,9462,All
2025,2,GUWAHATI,JAIPUR,4374,4334,GUWAHATI-JAIPUR,8708,All
2025,3,GUWAHATI,JAIPUR,4755,5387,GUWAHATI-JAIPUR,10142,All
2024,1,GUWAHATI,JORHAT,1408,1536,GUWAHATI-JORHAT,2944,All
2024,2,GUWAHATI,JORHAT,1394,1399,GUWAHATI-JORHAT,2793,All
2024,3,GUWAHATI,JORHAT,1658,1313,GUWAHATI-JORHAT,2971,All
2025,2,GUWAHATI,JORHAT,8,0,GUWAHATI-JORHAT,8,All
2024,11,GUWAHATI,KOCHI,15,13,GUWAHATI-KOCHI,28,All
2024,12,GUWAHATI,KOCHI,501,816,GUWAHATI-KOCHI,1317,All
2024,1,GUWAHATI,KOLKATA,43634,43608,GUWAHATI-KOLKATA,87242,All
2024,2,GUWAHATI,KOLKATA,39288,38638,GUWAHATI-KOLKATA,77926,All
2024,3,GUWAHATI,KOLKATA,41811,42777,GUWAHATI-KOLKATA,84588,All
2024,4,GUWAHATI,KOLKATA,45102,47422,GUWAHATI-KOLKATA,92524,All
2024,6,GUWAHATI,KOLKATA,47752,45046,GUWAHATI-KOLKATA,92798,All
2024,7,GUWAHATI,KOLKATA,49755,48090,GUWAHATI-KOLKATA,97845,All
2024,8,GUWAHATI,KOLKATA,44117,43673,GUWAHATI-KOLKATA,87790,All
2024,9,GUWAHATI,KOLKATA,46589,47563,GUWAHATI-KOLKATA,94152,All
2024,10,GUWAHATI,KOLKATA,50785,49189,GUWAHATI-KOLKATA,99974,All
2024,11,GUWAHATI,KOLKATA,43168,44061,GUWAHATI-KOLKATA,87229,All
2024,12,GUWAHATI,KOLKATA,45628,46546,GUWAHATI-KOLKATA,92174,All
2025,1,GUWAHATI,KOLKATA,43396,42815,GUWAHATI-KOLKATA,86211,All
2025,2,GUWAHATI,KOLKATA,39011,40989,GUWAHATI-KOLKATA,80000,All
2025,3,GUWAHATI,KOLKATA,49043,51001,GUWAHATI-KOLKATA,100044,All
2024,1,GUWAHATI,LILABARI,162,227,GUWAHATI-LILABARI,389,All
2024,2,GUWAHATI,LILABARI,107,182,GUWAHATI-LILABARI,289,All
2024,3,GUWAHATI,LILABARI,165,198,GUWAHATI-LILABARI,363,All
2024,4,GUWAHATI,LILABARI,0,41,GUWAHATI-LILABARI,41,All
2024,10,GUWAHATI,LILABARI,0,51,GUWAHATI-LILABARI,51,All
2024,1,GUWAHATI,LUCKNOW,1883,2193,GUWAHATI-LUCKNOW,4076,All
2024,2,GUWAHATI,LUCKNOW,2034,2122,GUWAHATI-LUCKNOW,4156,All
2024,3,GUWAHATI,LUCKNOW,3999,4230,GUWAHATI-LUCKNOW,8229,All
2024,4,GUWAHATI,LUCKNOW,4113,4288,GUWAHATI-LUCKNOW,8401,All
2024,6,GUWAHATI,LUCKNOW,4250,4420,GUWAHATI-LUCKNOW,8670,All
2024,7,GUWAHATI,LUCKNOW,3954,3749,GUWAHATI-LUCKNOW,7703,All
2024,8,GUWAHATI,LUCKNOW,3809,3318,GUWAHATI-LUCKNOW,7127,All
2024,9,GUWAHATI,LUCKNOW,3355,3307,GUWAHATI-LUCKNOW,6662,All
2024,10,GUWAHATI,LUCKNOW,4531,4314,GUWAHATI-LUCKNOW,8845,All
2024,11,GUWAHATI,LUCKNOW,4291,4605,GUWAHATI-LUCKNOW,8896,All
2024,12,GUWAHATI,LUCKNOW,3933,4603,GUWAHATI-LUCKNOW,8536,All
2025,1,GUWAHATI,LUCKNOW,4447,4463,GUWAHATI-LUCKNOW,8910,All
2025,2,GUWAHATI,LUCKNOW,4411,4753,GUWAHATI-LUCKNOW,9164,All
2025,3,GUWAHATI,LUCKNOW,5197,4247,GUWAHATI-LUCKNOW,9444,All
2024,1,GUWAHATI,MUMBAI,21860,21670,GUWAHATI-MUMBAI,43530,All
2024,2,GUWAHATI,MUMBAI,19804,19924,GUWAHATI-MUMBAI,39728,All
2024,3,GUWAHATI,MUMBAI,20123,21328,GUWAHATI-MUMBAI,41451,All
2024,4,GUWAHATI,MUMBAI,14193,15401,GUWAHATI-MUMBAI,29594,All
2024,6,GUWAHATI,MUMBAI,14746,14093,GUWAHATI-MUMBAI,28839,All
2024,7,GUWAHATI,MUMBAI,16351,15669,GUWAHATI-MUMBAI,32020,All
2024,8,GUWAHATI,MUMBAI,14537,13549,GUWAHATI-MUMBAI,28086,All
2024,9,GUWAHATI,MUMBAI,14289,15366,GUWAHATI-MUMBAI,29655,All
2024,10,GUWAHATI,MUMBAI,16400,17545,GUWAHATI-MUMBAI,33945,All
2024,11,GUWAHATI,MUMBAI,16503,16764,GUWAHATI-MUMBAI,33267,All
2024,12,GUWAHATI,MUMBAI,18069,18783,GUWAHATI-MUMBAI,36852,All
2025,1,GUWAHATI,MUMBAI,17383,17536,GUWAHATI-MUMBAI,34919,All
2025,2,GUWAHATI,MUMBAI,16178,16944,GUWAHATI-MUMBAI,33122,All
2025,3,GUWAHATI,MUMBAI,16936,17047,GUWAHATI-MUMBAI,33983,All
2024,1,GUWAHATI,PASIGHAT,460,555,GUWAHATI-PASIGHAT,1015,All
2024,2,GUWAHATI,PASIGHAT,140,181,GUWAHATI-PASIGHAT,321,All
2024,3,GUWAHATI,PASIGHAT,247,333,GUWAHATI-PASIGHAT,580,All
2024,4,GUWAHATI,PASIGHAT,251,318,GUWAHATI-PASIGHAT,569,All
2024,6,GUWAHATI,PASIGHAT,77,159,GUWAHATI-PASIGHAT,236,All
2024,7,GUWAHATI,PASIGHAT,193,183,GUWAHATI-PASIGHAT,376,All
2024,8,GUWAHATI,PASIGHAT,225,294,GUWAHATI-PASIGHAT,519,All
2024,9,GUWAHATI,PASIGHAT,403,518,GUWAHATI-PASIGHAT,921,All
2024,10,GUWAHATI,PASIGHAT,271,296,GUWAHATI-PASIGHAT,567,All
2024,11,GUWAHATI,PASIGHAT,380,462,GUWAHATI-PASIGHAT,842,All
2024,12,GUWAHATI,PASIGHAT,542,619,GUWAHATI-PASIGHAT,1161,All
2025,1,GUWAHATI,PASIGHAT,451,605,GUWAHATI-PASIGHAT,1056,All
2025,2,GUWAHATI,PASIGHAT,271,307,GUWAHATI-PASIGHAT,578,All
2025,3,GUWAHATI,PASIGHAT,30,39,GUWAHATI-PASIGHAT,69,All
2024,2,GUWAHATI,PATNA,1484,1679,GUWAHATI-PATNA,3163,All
2024,3,GUWAHATI,PATNA,2745,2997,GUWAHATI-PATNA,5742,All
2024,10,GUWAHATI,PATNA,333,134,GUWAHATI-PATNA,467,All
2024,11,GUWAHATI,PATNA,1958,1884,GUWAHATI-PATNA,3842,All
2024,12,GUWAHATI,PATNA,291,354,GUWAHATI-PATNA,645,All
2025,2,GUWAHATI,PATNA,1816,1983,GUWAHATI-PATNA,3799,All
2025,3,GUWAHATI,PATNA,1643,1700,GUWAHATI-PATNA,3343,All
2024,3,GUWAHATI,PUNE,182,176,GUWAHATI-PUNE,358,All
2024,4,GUWAHATI,PUNE,4867,5227,GUWAHATI-PUNE,10094,All
2024,6,GUWAHATI,PUNE,5276,4963,GUWAHATI-PUNE,10239,All
2024,7,GUWAHATI,PUNE,5367,5174,GUWAHATI-PUNE,10541,All
2024,8,GUWAHATI,PUNE,5245,5016,GUWAHATI-PUNE,10261,All
2024,9,GUWAHATI,PUNE,4520,4774,GUWAHATI-PUNE,9294,All
2024,10,GUWAHATI,PUNE,4846,5288,GUWAHATI-PUNE,10134,All
2024,11,GUWAHATI,PUNE,5281,5126,GUWAHATI-PUNE,10407,All
2024,12,GUWAHATI,PUNE,5030,5235,GUWAHATI-PUNE,10265,All
2025,1,GUWAHATI,PUNE,4157,4318,GUWAHATI-PUNE,8475,All
2025,2,GUWAHATI,PUNE,4552,4458,GUWAHATI-PUNE,9010,All
2025,3,GUWAHATI,PUNE,4931,5166,GUWAHATI-PUNE,10097,All
2024,10,GUWAHATI,RUPSI,218,112,GUWAHATI-RUPSI,330,All
2024,11,GUWAHATI,RUPSI,386,516,GUWAHATI-RUPSI,902,All
2024,12,GUWAHATI,RUPSI,351,343,GUWAHATI-RUPSI,694,All
2025,1,GUWAHATI,RUPSI,53,100,GUWAHATI-RUPSI,153,All
2024,1,GUWAHATI,SHILLONG,404,711,GUWAHATI-SHILLONG,1115,All
2024,2,GUWAHATI,SHILLONG,407,584,GUWAHATI-SHILLONG,991,All
2024,3,GUWAHATI,SHILLONG,514,700,GUWAHATI-SHILLONG,1214,All
2024,4,GUWAHATI,SHILLONG,1136,1111,GUWAHATI-SHILLONG,2247,All
2024,6,GUWAHATI,SHILLONG,1170,860,GUWAHATI-SHILLONG,2030,All
2024,7,GUWAHATI,SHILLONG,1050,841,GUWAHATI-SHILLONG,1891,All
2024,8,GUWAHATI,SHILLONG,437,267,GUWAHATI-SHILLONG,704,All
2024,9,GUWAHATI,SHILLONG,449,406,GUWAHATI-SHILLONG,855,All
2024,10,GUWAHATI,SHILLONG,223,61,GUWAHATI-SHILLONG,284,All
2025,1,GUWAHATI,SHILLONG,0,37,GUWAHATI-SHILLONG,37,All
2024,1,GUWAHATI,SILCHAR,2268,2270,GUWAHATI-SILCHAR,4538,All
2024,2,GUWAHATI,SILCHAR,2111,1964,GUWAHATI-SILCHAR,4075,All
2024,3,GUWAHATI,SILCHAR,2293,2070,GUWAHATI-SILCHAR,4363,All
2024,4,GUWAHATI,SILCHAR,4496,3654,GUWAHATI-SILCHAR,8150,All
2024,6,GUWAHATI,SILCHAR,4400,4371,GUWAHATI-SILCHAR,8771,All
2024,7,GUWAHATI,SILCHAR,4650,4327,GUWAHATI-SILCHAR,8977,All
2024,8,GUWAHATI,SILCHAR,4235,3461,GUWAHATI-SILCHAR,7696,All
2024,9,GUWAHATI,SILCHAR,4094,3159,GUWAHATI-SILCHAR,7253,All
2024,10,GUWAHATI,SILCHAR,4555,3667,GUWAHATI-SILCHAR,8222,All
2024,11,GUWAHATI,SILCHAR,4977,4472,GUWAHATI-SILCHAR,9449,All
2024,12,GUWAHATI,SILCHAR,5293,4527,GUWAHATI-SILCHAR,9820,All
2025,1,GUWAHATI,SILCHAR,4544,3857,GUWAHATI-SILCHAR,8401,All
2025,2,GUWAHATI,SILCHAR,4731,4180,GUWAHATI-SILCHAR,8911,All
2025,3,GUWAHATI,SILCHAR,4818,3638,GUWAHATI-SILCHAR,8456,All
2024,1,GUWAHATI,TEZPUR,118,250,GUWAHATI-TEZPUR,368,All
2024,2,GUWAHATI,TEZPUR,89,209,GUWAHATI-TEZPUR,298,All
2024,3,GUWAHATI,TEZPUR,198,263,GUWAHATI-TEZPUR,461,All
2024,4,GUWAHATI,TEZPUR,155,277,GUWAHATI-TEZPUR,432,All
2024,6,GUWAHATI,TEZPUR,279,494,GUWAHATI-TEZPUR,773,All
2024,7,GUWAHATI,TEZPUR,384,455,GUWAHATI-TEZPUR,839,All
2024,8,GUWAHATI,TEZPUR,401,489,GUWAHATI-TEZPUR,890,All
2024,9,GUWAHATI,TEZPUR,317,477,GUWAHATI-TEZPUR,794,All
2024,10,GUWAHATI,TEZU,180,183,GUWAHATI-TEZU,363,All
2024,11,GUWAHATI,TEZU,480,548,GUWAHATI-TEZU,1028,All
2024,12,GUWAHATI,TEZU,887,719,GUWAHATI-TEZU,1606,All
2025,1,GUWAHATI,TEZU,509,364,GUWAHATI-TEZU,873,All
2025,2,GUWAHATI,TEZU,21,19,GUWAHATI-TEZU,40,All
2025,3,GUWAHATI,TEZU,36,28,GUWAHATI-TEZU,64,All
2024,12,GUWAHATI,Ziro,62,43,GUWAHATI-Ziro,105,All
2025,1,GUWAHATI,Ziro,43,60,GUWAHATI-Ziro,103,All
2025,2,GUWAHATI,Ziro,36,35,GUWAHATI-Ziro,71,All
2025,3,GUWAHATI,Ziro,13,19,GUWAHATI-Ziro,32,All
2024,1,GWALIOR,HYDERABAD,1386,1360,GWALIOR-HYDERABAD,2746,All
2024,2,GWALIOR,HYDERABAD,960,1261,GWALIOR-HYDERABAD,2221,All
2024,3,GWALIOR,HYDERABAD,1044,1301,GWALIOR-HYDERABAD,2345,All
2024,4,GWALIOR,HYDERABAD,1401,1983,GWALIOR-HYDERABAD,3384,All
2024,6,GWALIOR,HYDERABAD,2026,1841,GWALIOR-HYDERABAD,3867,All
2024,7,GWALIOR,HYDERABAD,253,424,GWALIOR-HYDERABAD,677,All
2024,10,GWALIOR,HYDERABAD,47,320,GWALIOR-HYDERABAD,367,All
2024,11,GWALIOR,HYDERABAD,1112,542,GWALIOR-HYDERABAD,1654,All
2024,12,GWALIOR,HYDERABAD,932,614,GWALIOR-HYDERABAD,1546,All
2025,1,GWALIOR,HYDERABAD,872,702,GWALIOR-HYDERABAD,1574,All
2024,1,GWALIOR,INDORE,389,353,GWALIOR-INDORE,742,All
2024,2,GWALIOR,INDORE,441,472,GWALIOR-INDORE,913,All
2024,3,GWALIOR,INDORE,534,501,GWALIOR-INDORE,1035,All
2024,4,GWALIOR,INDORE,549,525,GWALIOR-INDORE,1074,All
2024,6,GWALIOR,INDORE,700,698,GWALIOR-INDORE,1398,All
2024,7,GWALIOR,INDORE,282,275,GWALIOR-INDORE,557,All
2024,1,GWALIOR,MUMBAI,4673,4594,GWALIOR-MUMBAI,9267,All
2024,2,GWALIOR,MUMBAI,4301,4664,GWALIOR-MUMBAI,8965,All
2024,3,GWALIOR,MUMBAI,4876,5029,GWALIOR-MUMBAI,9905,All
2024,4,GWALIOR,MUMBAI,4592,5735,GWALIOR-MUMBAI,10327,All
2024,6,GWALIOR,MUMBAI,5523,4425,GWALIOR-MUMBAI,9948,All
2024,7,GWALIOR,MUMBAI,5073,5094,GWALIOR-MUMBAI,10167,All
2024,8,GWALIOR,MUMBAI,4205,4140,GWALIOR-MUMBAI,8345,All
2024,9,GWALIOR,MUMBAI,3576,3846,GWALIOR-MUMBAI,7422,All
2024,10,GWALIOR,MUMBAI,3400,4918,GWALIOR-MUMBAI,8318,All
2024,11,GWALIOR,MUMBAI,5403,5156,GWALIOR-MUMBAI,10559,All
2024,12,GWALIOR,MUMBAI,5554,5024,GWALIOR-MUMBAI,10578,All
2025,1,GWALIOR,MUMBAI,5108,5381,GWALIOR-MUMBAI,10489,All
2025,2,GWALIOR,MUMBAI,4719,4976,GWALIOR-MUMBAI,9695,All
2025,3,GWALIOR,MUMBAI,4979,5029,GWALIOR-MUMBAI,10008,All
2024,1,Goa,HYDERABAD,23206,22977,Goa-HYDERABAD,46183,All
2024,2,Goa,HYDERABAD,18590,18686,Goa-HYDERABAD,37276,All
2024,3,Goa,HYDERABAD,18662,19174,Goa-HYDERABAD,37836,All
2024,4,Goa,HYDERABAD,21200,20074,Goa-HYDERABAD,41274,All
2024,6,Goa,HYDERABAD,15433,15022,Goa-HYDERABAD,30455,All
2024,7,Goa,HYDERABAD,15476,14325,Goa-HYDERABAD,29801,All
2024,8,Goa,HYDERABAD,18769,19764,Goa-HYDERABAD,38533,All
2024,9,Goa,HYDERABAD,15333,15848,Goa-HYDERABAD,31181,All
2024,10,Goa,HYDERABAD,18570,17567,Goa-HYDERABAD,36137,All
2024,11,Goa,HYDERABAD,20296,21807,Goa-HYDERABAD,42103,All
2024,12,Goa,HYDERABAD,25835,26229,Goa-HYDERABAD,52064,All
2025,1,Goa,HYDERABAD,28282,26826,Goa-HYDERABAD,55108,All
2025,2,Goa,HYDERABAD,20807,19509,Goa-HYDERABAD,40316,All
2025,3,Goa,HYDERABAD,21553,19863,Goa-HYDERABAD,41416,All
2024,1,Goa,JAIPUR,6530,6355,Goa-JAIPUR,12885,All
2024,2,Goa,JAIPUR,6135,6068,Goa-JAIPUR,12203,All
2024,3,Goa,JAIPUR,6216,6292,Goa-JAIPUR,12508,All
2024,4,Goa,JAIPUR,4848,4385,Goa-JAIPUR,9233,All
2024,6,Goa,JAIPUR,5095,5296,Goa-JAIPUR,10391,All
2024,7,Goa,JAIPUR,5184,5343,Goa-JAIPUR,10527,All
2024,8,Goa,JAIPUR,5796,5899,Goa-JAIPUR,11695,All
2024,9,Goa,JAIPUR,4970,5034,Goa-JAIPUR,10004,All
2024,10,Goa,JAIPUR,5126,4910,Goa-JAIPUR,10036,All
2024,11,Goa,JAIPUR,5340,6340,Goa-JAIPUR,11680,All
2024,12,Goa,JAIPUR,5513,6374,Goa-JAIPUR,11887,All
2025,1,Goa,JAIPUR,6583,6279,Goa-JAIPUR,12862,All
2025,2,Goa,JAIPUR,6030,5901,Goa-JAIPUR,11931,All
2025,3,Goa,JAIPUR,5747,6202,Goa-JAIPUR,11949,All
2024,4,Goa,JALGAON,286,283,Goa-JALGAON,569,All
2024,6,Goa,JALGAON,1612,1371,Goa-JALGAON,2983,All
2024,7,Goa,JALGAON,1419,1389,Goa-JALGAON,2808,All
2024,8,Goa,JALGAON,1311,1285,Goa-JALGAON,2596,All
2024,9,Goa,JALGAON,1402,1258,Goa-JALGAON,2660,All
2024,10,Goa,JALGAON,1625,1264,Goa-JALGAON,2889,All
2024,11,Goa,JALGAON,1791,1759,Goa-JALGAON,3550,All
2024,12,Goa,JALGAON,1833,1896,Goa-JALGAON,3729,All
2025,1,Goa,JALGAON,1868,1822,Goa-JALGAON,3690,All
2025,2,Goa,JALGAON,1691,1566,Goa-JALGAON,3257,All
2025,3,Goa,JALGAON,1650,1406,Goa-JALGAON,3056,All
2024,1,Goa,KOLKATA,6127,5646,Goa-KOLKATA,11773,All
2024,2,Goa,KOLKATA,4666,4232,Goa-KOLKATA,8898,All
2024,3,Goa,KOLKATA,4815,4072,Goa-KOLKATA,8887,All
2024,4,Goa,KOLKATA,4694,3493,Goa-KOLKATA,8187,All
2024,6,Goa,KOLKATA,4427,4397,Goa-KOLKATA,8824,All
2024,7,Goa,KOLKATA,4240,5176,Goa-KOLKATA,9416,All
2024,8,Goa,KOLKATA,4223,4646,Goa-KOLKATA,8869,All
2024,9,Goa,KOLKATA,4421,4255,Goa-KOLKATA,8676,All
2024,10,Goa,KOLKATA,5113,3889,Goa-KOLKATA,9002,All
2024,11,Goa,KOLKATA,4921,4920,Goa-KOLKATA,9841,All
2024,12,Goa,KOLKATA,5307,5119,Goa-KOLKATA,10426,All
2025,1,Goa,KOLKATA,5403,4964,Goa-KOLKATA,10367,All
2025,2,Goa,KOLKATA,4821,4468,Goa-KOLKATA,9289,All
2025,3,Goa,KOLKATA,4756,4406,Goa-KOLKATA,9162,All
2024,9,Goa,LUCKNOW,1,0,Goa-LUCKNOW,1,All
2025,3,Goa,LUCKNOW,283,3913,Goa-LUCKNOW,4196,All
2024,1,Goa,MUMBAI,62493,59017,Goa-MUMBAI,121510,All
2024,2,Goa,MUMBAI,52559,51355,Goa-MUMBAI,103914,All
2024,3,Goa,MUMBAI,50491,49421,Goa-MUMBAI,99912,All
2024,4,Goa,MUMBAI,49555,50082,Goa-MUMBAI,99637,All
2024,6,Goa,MUMBAI,41602,40445,Goa-MUMBAI,82047,All
2024,7,Goa,MUMBAI,33438,32971,Goa-MUMBAI,66409,All
2024,8,Goa,MUMBAI,37783,39329,Goa-MUMBAI,77112,All
2024,9,Goa,MUMBAI,35365,36238,Goa-MUMBAI,71603,All
2024,10,Goa,MUMBAI,35900,36933,Goa-MUMBAI,72833,All
2024,11,Goa,MUMBAI,43416,43900,Goa-MUMBAI,87316,All
2024,12,Goa,MUMBAI,42021,44067,Goa-MUMBAI,86088,All
2025,1,Goa,MUMBAI,41178,40867,Goa-MUMBAI,82045,All
2025,2,Goa,MUMBAI,37298,38064,Goa-MUMBAI,75362,All
2025,3,Goa,MUMBAI,41243,40888,Goa-MUMBAI,82131,All
2024,1,Goa,NAGPUR,4899,5092,Goa-NAGPUR,9991,All
2024,2,Goa,NAGPUR,4637,4638,Goa-NAGPUR,9275,All
2024,3,Goa,NAGPUR,4907,4841,Goa-NAGPUR,9748,All
2024,4,Goa,NAGPUR,5163,4405,Goa-NAGPUR,9568,All
2024,6,Goa,NAGPUR,5183,4925,Goa-NAGPUR,10108,All
2024,7,Goa,NAGPUR,5038,4339,Goa-NAGPUR,9377,All
2024,8,Goa,NAGPUR,4705,4677,Goa-NAGPUR,9382,All
2024,9,Goa,NAGPUR,4766,4301,Goa-NAGPUR,9067,All
2024,10,Goa,NAGPUR,6123,4627,Goa-NAGPUR,10750,All
2024,11,Goa,NAGPUR,7877,8874,Goa-NAGPUR,16751,All
2024,12,Goa,NAGPUR,4873,5067,Goa-NAGPUR,9940,All
2025,1,Goa,NAGPUR,5113,4981,Goa-NAGPUR,10094,All
2025,2,Goa,NAGPUR,4786,4609,Goa-NAGPUR,9395,All
2025,3,Goa,NAGPUR,4669,4287,Goa-NAGPUR,8956,All
2024,1,Goa,NASIK,1799,1851,Goa-NASIK,3650,All
2024,2,Goa,NASIK,1541,1559,Goa-NASIK,3100,All
2024,3,Goa,NASIK,1693,1695,Goa-NASIK,3388,All
2024,4,Goa,NASIK,1656,1687,Goa-NASIK,3343,All
2024,6,Goa,NASIK,1711,1503,Goa-NASIK,3214,All
2024,7,Goa,NASIK,988,785,Goa-NASIK,1773,All
2024,8,Goa,NASIK,833,722,Goa-NASIK,1555,All
2024,9,Goa,NASIK,869,671,Goa-NASIK,1540,All
2024,10,Goa,NASIK,563,488,Goa-NASIK,1051,All
2024,1,Goa,PATNA,1634,1757,Goa-PATNA,3391,All
2024,2,Goa,PATNA,2159,1960,Goa-PATNA,4119,All
2024,3,Goa,PATNA,2055,2036,Goa-PATNA,4091,All
2024,1,Goa,PORT BLAIR,0,5,Goa-PORT BLAIR,5,All
2024,2,Goa,PORT BLAIR,0,12,Goa-PORT BLAIR,12,All
2024,3,Goa,PORT BLAIR,0,8,Goa-PORT BLAIR,8,All
2024,1,Goa,PUNE,10434,10072,Goa-PUNE,20506,All
2024,2,Goa,PUNE,13615,12477,Goa-PUNE,26092,All
2024,3,Goa,PUNE,14167,13371,Goa-PUNE,27538,All
2024,4,Goa,PUNE,13351,12613,Goa-PUNE,25964,All
2024,6,Goa,PUNE,13416,11724,Goa-PUNE,25140,All
2024,7,Goa,PUNE,12298,11482,Goa-PUNE,23780,All
2024,8,Goa,PUNE,12568,12359,Goa-PUNE,24927,All
2024,9,Goa,PUNE,13056,12929,Goa-PUNE,25985,All
2024,10,Goa,PUNE,13121,12849,Goa-PUNE,25970,All
2024,11,Goa,PUNE,12511,12475,Goa-PUNE,24986,All
2024,12,Goa,PUNE,11466,11469,Goa-PUNE,22935,All
2025,1,Goa,PUNE,9825,10075,Goa-PUNE,19900,All
2025,2,Goa,PUNE,6036,6141,Goa-PUNE,12177,All
2025,3,Goa,PUNE,10244,10263,Goa-PUNE,20507,All
2024,1,Goa,RANCHI,1173,1146,Goa-RANCHI,2319,All
2024,2,Goa,RANCHI,2590,2567,Goa-RANCHI,5157,All
2024,3,Goa,RANCHI,2709,2475,Goa-RANCHI,5184,All
2024,1,Goa,Rajkot International Airport,2015,2248,Goa-Rajkot International Airport,4263,All
2024,2,Goa,Rajkot International Airport,2154,2297,Goa-Rajkot International Airport,4451,All
2024,3,Goa,Rajkot International Airport,1945,2254,Goa-Rajkot International Airport,4199,All
2024,4,Goa,Rajkot International Airport,1799,2115,Goa-Rajkot International Airport,3914,All
2024,6,Goa,Rajkot International Airport,1938,2224,Goa-Rajkot International Airport,4162,All
2024,7,Goa,Rajkot International Airport,1691,1842,Goa-Rajkot International Airport,3533,All
2024,8,Goa,Rajkot International Airport,2066,2205,Goa-Rajkot International Airport,4271,All
2024,9,Goa,Rajkot International Airport,1978,2063,Goa-Rajkot International Airport,4041,All
2024,10,Goa,Rajkot International Airport,2218,2559,Goa-Rajkot International Airport,4777,All
2024,11,Goa,Rajkot International Airport,4688,4424,Goa-Rajkot International Airport,9112,All
2024,12,Goa,Rajkot International Airport,4317,4172,Goa-Rajkot International Airport,8489,All
2025,1,Goa,Rajkot International Airport,4827,3953,Goa-Rajkot International Airport,8780,All
2025,2,Goa,Rajkot International Airport,3877,3513,Goa-Rajkot International Airport,7390,All
2025,3,Goa,Rajkot International Airport,4313,3873,Goa-Rajkot International Airport,8186,All
2024,1,Goa,SURAT,1900,1253,Goa-SURAT,3153,All
2024,10,Goa,SURAT,4,0,Goa-SURAT,4,All
2024,1,Goa,Shivamogga Airport,518,706,Goa-Shivamogga Airport,1224,All
2024,2,Goa,Shivamogga Airport,535,731,Goa-Shivamogga Airport,1266,All
2024,3,Goa,Shivamogga Airport,417,558,Goa-Shivamogga Airport,975,All
2024,4,Goa,Shivamogga Airport,382,728,Goa-Shivamogga Airport,1110,All
2024,6,Goa,Shivamogga Airport,450,724,Goa-Shivamogga Airport,1174,All
2024,7,Goa,Shivamogga Airport,244,477,Goa-Shivamogga Airport,721,All
2024,9,Goa,Shivamogga Airport,412,465,Goa-Shivamogga Airport,877,All
2024,10,Goa,Shivamogga Airport,720,885,Goa-Shivamogga Airport,1605,All
2024,11,Goa,Shivamogga Airport,641,904,Goa-Shivamogga Airport,1545,All
2024,12,Goa,Shivamogga Airport,820,845,Goa-Shivamogga Airport,1665,All
2025,1,Goa,Shivamogga Airport,1321,1124,Goa-Shivamogga Airport,2445,All
2025,2,Goa,Shivamogga Airport,398,564,Goa-Shivamogga Airport,962,All
2025,3,Goa,Shivamogga Airport,534,495,Goa-Shivamogga Airport,1029,All
2024,1,Goa,VADODARA,2608,2312,Goa-VADODARA,4920,All
2024,2,Goa,VADODARA,1980,1712,Goa-VADODARA,3692,All
2024,3,Goa,VADODARA,2288,1728,Goa-VADODARA,4016,All
2024,4,Goa,VADODARA,1783,1458,Goa-VADODARA,3241,All
2024,6,Goa,VADODARA,2116,1733,Goa-VADODARA,3849,All
2024,7,Goa,VADODARA,1702,1308,Goa-VADODARA,3010,All
2024,8,Goa,VADODARA,1560,1413,Goa-VADODARA,2973,All
2024,9,Goa,VADODARA,1826,1308,Goa-VADODARA,3134,All
2024,10,Goa,VADODARA,1439,1449,Goa-VADODARA,2888,All
2024,11,Goa,VADODARA,4277,3626,Goa-VADODARA,7903,All
2024,12,Goa,VADODARA,4439,3675,Goa-VADODARA,8114,All
2025,1,Goa,VADODARA,4652,3415,Goa-VADODARA,8067,All
2025,2,Goa,VADODARA,3825,2737,Goa-VADODARA,6562,All
2025,3,Goa,VADODARA,3851,2394,Goa-VADODARA,6245,All
2024,1,Goa,VARANASI,1213,1281,Goa-VARANASI,2494,All
2024,1,Goa,VISAKHAPATNAM,1145,1152,Goa-VISAKHAPATNAM,2297,All
2024,1,Gondia ,HYDERABAD,624,658,Gondia -HYDERABAD,1282,All
2024,2,Gondia ,HYDERABAD,1121,1024,Gondia -HYDERABAD,2145,All
2024,3,Gondia ,HYDERABAD,1269,1290,Gondia -HYDERABAD,2559,All
2024,4,Gondia ,HYDERABAD,1522,1497,Gondia -HYDERABAD,3019,All
2024,6,Gondia ,HYDERABAD,1732,1593,Gondia -HYDERABAD,3325,All
2024,7,Gondia ,HYDERABAD,1260,1157,Gondia -HYDERABAD,2417,All
2024,8,Gondia ,HYDERABAD,1209,1110,Gondia -HYDERABAD,2319,All
2024,9,Gondia ,HYDERABAD,694,844,Gondia -HYDERABAD,1538,All
2024,10,Gondia ,HYDERABAD,661,1223,Gondia -HYDERABAD,1884,All
2024,11,Gondia ,HYDERABAD,1795,1442,Gondia -HYDERABAD,3237,All
2024,12,Gondia ,HYDERABAD,1466,1210,Gondia -HYDERABAD,2676,All
2025,1,Gondia ,HYDERABAD,1102,902,Gondia -HYDERABAD,2004,All
2025,2,Gondia ,HYDERABAD,1203,1061,Gondia -HYDERABAD,2264,All
2025,3,Gondia ,HYDERABAD,1415,1217,Gondia -HYDERABAD,2632,All
2024,1,HUBLI,HYDERABAD,2025,1893,HUBLI-HYDERABAD,3918,All
2024,2,HUBLI,HYDERABAD,1858,1970,HUBLI-HYDERABAD,3828,All
2024,3,HUBLI,HYDERABAD,1837,2028,HUBLI-HYDERABAD,3865,All
2024,4,HUBLI,HYDERABAD,1849,1930,HUBLI-HYDERABAD,3779,All
2024,6,HUBLI,HYDERABAD,1869,1789,HUBLI-HYDERABAD,3658,All
2024,7,HUBLI,HYDERABAD,1543,1749,HUBLI-HYDERABAD,3292,All
2024,8,HUBLI,HYDERABAD,1495,1733,HUBLI-HYDERABAD,3228,All
2024,9,HUBLI,HYDERABAD,1775,1787,HUBLI-HYDERABAD,3562,All
2024,10,HUBLI,HYDERABAD,1805,1776,HUBLI-HYDERABAD,3581,All
2024,11,HUBLI,HYDERABAD,1926,1915,HUBLI-HYDERABAD,3841,All
2024,12,HUBLI,HYDERABAD,2030,1933,HUBLI-HYDERABAD,3963,All
2025,1,HUBLI,HYDERABAD,2044,1893,HUBLI-HYDERABAD,3937,All
2025,2,HUBLI,HYDERABAD,2062,2009,HUBLI-HYDERABAD,4071,All
2025,3,HUBLI,HYDERABAD,2095,1881,HUBLI-HYDERABAD,3976,All
2024,1,HUBLI,MUMBAI,4014,4113,HUBLI-MUMBAI,8127,All
2024,2,HUBLI,MUMBAI,2089,2183,HUBLI-MUMBAI,4272,All
2024,7,HUBLI,MUMBAI,2121,2255,HUBLI-MUMBAI,4376,All
2024,8,HUBLI,MUMBAI,4350,3875,HUBLI-MUMBAI,8225,All
2024,9,HUBLI,MUMBAI,4078,3789,HUBLI-MUMBAI,7867,All
2024,10,HUBLI,MUMBAI,3662,3862,HUBLI-MUMBAI,7524,All
2024,11,HUBLI,MUMBAI,4030,4005,HUBLI-MUMBAI,8035,All
2024,12,HUBLI,MUMBAI,4229,4670,HUBLI-MUMBAI,8899,All
2025,1,HUBLI,MUMBAI,4184,4320,HUBLI-MUMBAI,8504,All
2025,2,HUBLI,MUMBAI,4415,4578,HUBLI-MUMBAI,8993,All
2025,3,HUBLI,MUMBAI,3883,3946,HUBLI-MUMBAI,7829,All
2024,2,HUBLI,PUNE,802,868,HUBLI-PUNE,1670,All
2024,3,HUBLI,PUNE,789,814,HUBLI-PUNE,1603,All
2024,4,HUBLI,PUNE,830,876,HUBLI-PUNE,1706,All
2024,6,HUBLI,PUNE,801,927,HUBLI-PUNE,1728,All
2024,7,HUBLI,PUNE,811,1024,HUBLI-PUNE,1835,All
2024,8,HUBLI,PUNE,805,867,HUBLI-PUNE,1672,All
2024,9,HUBLI,PUNE,818,899,HUBLI-PUNE,1717,All
2024,10,HUBLI,PUNE,701,914,HUBLI-PUNE,1615,All
2024,11,HUBLI,PUNE,1038,975,HUBLI-PUNE,2013,All
2024,12,HUBLI,PUNE,1171,1190,HUBLI-PUNE,2361,All
2025,1,HUBLI,PUNE,1112,1175,HUBLI-PUNE,2287,All
2025,2,HUBLI,PUNE,761,796,HUBLI-PUNE,1557,All
2025,3,HUBLI,PUNE,1007,1079,HUBLI-PUNE,2086,All
2024,3,HYDERABAD,Ayodhya International Airport ,10,12,Ayodhya International Airport -HYDERABAD,22,All
2024,4,HYDERABAD,Ayodhya International Airport ,1988,1189,Ayodhya International Airport -HYDERABAD,3177,All
2024,9,HYDERABAD,Ayodhya International Airport ,462,428,Ayodhya International Airport -HYDERABAD,890,All
2024,10,HYDERABAD,Ayodhya International Airport ,2728,2431,Ayodhya International Airport -HYDERABAD,5159,All
2024,11,HYDERABAD,Ayodhya International Airport ,2830,2798,Ayodhya International Airport -HYDERABAD,5628,All
2024,12,HYDERABAD,Ayodhya International Airport ,2912,3099,Ayodhya International Airport -HYDERABAD,6011,All
2025,1,HYDERABAD,Ayodhya International Airport ,3015,3001,Ayodhya International Airport -HYDERABAD,6016,All
2025,2,HYDERABAD,Ayodhya International Airport ,2815,2846,Ayodhya International Airport -HYDERABAD,5661,All
2025,3,HYDERABAD,Ayodhya International Airport ,2922,2917,Ayodhya International Airport -HYDERABAD,5839,All
2024,10,HYDERABAD,Cuddapah,207,295,Cuddapah-HYDERABAD,502,All
2024,11,HYDERABAD,Cuddapah,1580,1918,Cuddapah-HYDERABAD,3498,All
2024,12,HYDERABAD,Cuddapah,1540,1556,Cuddapah-HYDERABAD,3096,All
2025,1,HYDERABAD,Cuddapah,2119,2038,Cuddapah-HYDERABAD,4157,All
2025,2,HYDERABAD,Cuddapah,1763,1771,Cuddapah-HYDERABAD,3534,All
2025,3,HYDERABAD,Cuddapah,1825,1903,Cuddapah-HYDERABAD,3728,All
2024,1,HYDERABAD,IMPHAL,485,472,HYDERABAD-IMPHAL,957,All
2024,2,HYDERABAD,IMPHAL,583,587,HYDERABAD-IMPHAL,1170,All
2024,3,HYDERABAD,IMPHAL,470,541,HYDERABAD-IMPHAL,1011,All
2024,4,HYDERABAD,IMPHAL,173,274,HYDERABAD-IMPHAL,447,All
2024,1,HYDERABAD,INDORE,14512,15101,HYDERABAD-INDORE,29613,All
2024,2,HYDERABAD,INDORE,13720,14162,HYDERABAD-INDORE,27882,All
2024,3,HYDERABAD,INDORE,14392,14932,HYDERABAD-INDORE,29324,All
2024,4,HYDERABAD,INDORE,15922,14902,HYDERABAD-INDORE,30824,All
2024,6,HYDERABAD,INDORE,15341,16194,HYDERABAD-INDORE,31535,All
2024,7,HYDERABAD,INDORE,15332,15898,HYDERABAD-INDORE,31230,All
2024,8,HYDERABAD,INDORE,15977,15929,HYDERABAD-INDORE,31906,All
2024,9,HYDERABAD,INDORE,13551,15630,HYDERABAD-INDORE,29181,All
2024,10,HYDERABAD,INDORE,16833,13805,HYDERABAD-INDORE,30638,All
2024,11,HYDERABAD,INDORE,14339,16453,HYDERABAD-INDORE,30792,All
2024,12,HYDERABAD,INDORE,16564,17813,HYDERABAD-INDORE,34377,All
2025,1,HYDERABAD,INDORE,18352,18149,HYDERABAD-INDORE,36501,All
2025,2,HYDERABAD,INDORE,17859,17021,HYDERABAD-INDORE,34880,All
2025,3,HYDERABAD,INDORE,18241,18578,HYDERABAD-INDORE,36819,All
2024,1,HYDERABAD,JABALPUR,1820,1906,HYDERABAD-JABALPUR,3726,All
2024,2,HYDERABAD,JABALPUR,2116,2089,HYDERABAD-JABALPUR,4205,All
2024,3,HYDERABAD,JABALPUR,2204,2195,HYDERABAD-JABALPUR,4399,All
2024,4,HYDERABAD,JABALPUR,2931,2979,HYDERABAD-JABALPUR,5910,All
2024,6,HYDERABAD,JABALPUR,2029,2121,HYDERABAD-JABALPUR,4150,All
2024,7,HYDERABAD,JABALPUR,2157,2104,HYDERABAD-JABALPUR,4261,All
2024,8,HYDERABAD,JABALPUR,2104,2104,HYDERABAD-JABALPUR,4208,All
2024,9,HYDERABAD,JABALPUR,2075,1944,HYDERABAD-JABALPUR,4019,All
2024,10,HYDERABAD,JABALPUR,2229,1926,HYDERABAD-JABALPUR,4155,All
2024,11,HYDERABAD,JABALPUR,2204,2187,HYDERABAD-JABALPUR,4391,All
2024,12,HYDERABAD,JABALPUR,2313,2271,HYDERABAD-JABALPUR,4584,All
2025,1,HYDERABAD,JABALPUR,2820,2757,HYDERABAD-JABALPUR,5577,All
2025,2,HYDERABAD,JABALPUR,3020,2935,HYDERABAD-JABALPUR,5955,All
2025,3,HYDERABAD,JABALPUR,3294,3077,HYDERABAD-JABALPUR,6371,All
2024,1,HYDERABAD,JAGDALPUR,1232,1259,HYDERABAD-JAGDALPUR,2491,All
2024,2,HYDERABAD,JAGDALPUR,1250,1261,HYDERABAD-JAGDALPUR,2511,All
2024,3,HYDERABAD,JAGDALPUR,1523,1365,HYDERABAD-JAGDALPUR,2888,All
2024,4,HYDERABAD,JAGDALPUR,2156,1909,HYDERABAD-JAGDALPUR,4065,All
2024,6,HYDERABAD,JAGDALPUR,1870,1760,HYDERABAD-JAGDALPUR,3630,All
2024,7,HYDERABAD,JAGDALPUR,1771,1740,HYDERABAD-JAGDALPUR,3511,All
2024,8,HYDERABAD,JAGDALPUR,1900,1826,HYDERABAD-JAGDALPUR,3726,All
2024,9,HYDERABAD,JAGDALPUR,1949,1680,HYDERABAD-JAGDALPUR,3629,All
2024,10,HYDERABAD,JAGDALPUR,2058,1717,HYDERABAD-JAGDALPUR,3775,All
2024,11,HYDERABAD,JAGDALPUR,1565,1648,HYDERABAD-JAGDALPUR,3213,All
2024,12,HYDERABAD,JAGDALPUR,1617,1595,HYDERABAD-JAGDALPUR,3212,All
2025,1,HYDERABAD,JAGDALPUR,1591,1518,HYDERABAD-JAGDALPUR,3109,All
2025,2,HYDERABAD,JAGDALPUR,1442,1493,HYDERABAD-JAGDALPUR,2935,All
2025,3,HYDERABAD,JAGDALPUR,1683,1513,HYDERABAD-JAGDALPUR,3196,All
2024,1,HYDERABAD,JAIPUR,24655,23001,HYDERABAD-JAIPUR,47656,All
2024,2,HYDERABAD,JAIPUR,25429,23739,HYDERABAD-JAIPUR,49168,All
2024,3,HYDERABAD,JAIPUR,26521,24668,HYDERABAD-JAIPUR,51189,All
2024,4,HYDERABAD,JAIPUR,25434,23304,HYDERABAD-JAIPUR,48738,All
2024,6,HYDERABAD,JAIPUR,21439,21213,HYDERABAD-JAIPUR,42652,All
2024,7,HYDERABAD,JAIPUR,22672,22308,HYDERABAD-JAIPUR,44980,All
2024,8,HYDERABAD,JAIPUR,24372,22805,HYDERABAD-JAIPUR,47177,All
2024,9,HYDERABAD,JAIPUR,22938,21227,HYDERABAD-JAIPUR,44165,All
2024,10,HYDERABAD,JAIPUR,28438,23002,HYDERABAD-JAIPUR,51440,All
2024,11,HYDERABAD,JAIPUR,25156,25208,HYDERABAD-JAIPUR,50364,All
2024,12,HYDERABAD,JAIPUR,25646,26242,HYDERABAD-JAIPUR,51888,All
2025,1,HYDERABAD,JAIPUR,23573,21562,HYDERABAD-JAIPUR,45135,All
2025,2,HYDERABAD,JAIPUR,25570,23559,HYDERABAD-JAIPUR,49129,All
2025,3,HYDERABAD,JAIPUR,21664,20866,HYDERABAD-JAIPUR,42530,All
2024,4,HYDERABAD,JALGAON,232,245,HYDERABAD-JALGAON,477,All
2024,6,HYDERABAD,JALGAON,542,625,HYDERABAD-JALGAON,1167,All
2024,7,HYDERABAD,JALGAON,775,791,HYDERABAD-JALGAON,1566,All
2024,8,HYDERABAD,JALGAON,898,983,HYDERABAD-JALGAON,1881,All
2024,9,HYDERABAD,JALGAON,868,978,HYDERABAD-JALGAON,1846,All
2024,10,HYDERABAD,JALGAON,1206,1001,HYDERABAD-JALGAON,2207,All
2024,11,HYDERABAD,JALGAON,1313,1368,HYDERABAD-JALGAON,2681,All
2024,12,HYDERABAD,JALGAON,1302,1342,HYDERABAD-JALGAON,2644,All
2025,1,HYDERABAD,JALGAON,809,924,HYDERABAD-JALGAON,1733,All
2025,2,HYDERABAD,JALGAON,428,399,HYDERABAD-JALGAON,827,All
2025,3,HYDERABAD,JALGAON,570,669,HYDERABAD-JALGAON,1239,All
2024,1,HYDERABAD,JAMMU,380,0,HYDERABAD-JAMMU,380,All
2024,2,HYDERABAD,JAMMU,338,0,HYDERABAD-JAMMU,338,All
2024,3,HYDERABAD,JAMMU,319,1,HYDERABAD-JAMMU,320,All
2024,4,HYDERABAD,JAMMU,879,109,HYDERABAD-JAMMU,988,All
2024,6,HYDERABAD,JAMMU,433,0,HYDERABAD-JAMMU,433,All
2024,7,HYDERABAD,JAMMU,192,0,HYDERABAD-JAMMU,192,All
2024,8,HYDERABAD,JAMMU,88,0,HYDERABAD-JAMMU,88,All
2024,9,HYDERABAD,JAMMU,387,346,HYDERABAD-JAMMU,733,All
2024,10,HYDERABAD,JAMMU,2119,1810,HYDERABAD-JAMMU,3929,All
2024,11,HYDERABAD,JAMMU,2356,2422,HYDERABAD-JAMMU,4778,All
2024,12,HYDERABAD,JAMMU,2599,2716,HYDERABAD-JAMMU,5315,All
2025,1,HYDERABAD,JAMMU,2416,2328,HYDERABAD-JAMMU,4744,All
2025,2,HYDERABAD,JAMMU,2379,2011,HYDERABAD-JAMMU,4390,All
2025,3,HYDERABAD,JAMMU,2341,2058,HYDERABAD-JAMMU,4399,All
2024,1,HYDERABAD,JAMNAGAR,1135,1080,HYDERABAD-JAMNAGAR,2215,All
2024,2,HYDERABAD,JAMNAGAR,1222,1115,HYDERABAD-JAMNAGAR,2337,All
2024,3,HYDERABAD,JAMNAGAR,961,1016,HYDERABAD-JAMNAGAR,1977,All
2024,4,HYDERABAD,JAMNAGAR,1176,1010,HYDERABAD-JAMNAGAR,2186,All
2024,6,HYDERABAD,JAMNAGAR,1237,1257,HYDERABAD-JAMNAGAR,2494,All
2024,7,HYDERABAD,JAMNAGAR,1132,1126,HYDERABAD-JAMNAGAR,2258,All
2024,8,HYDERABAD,JAMNAGAR,1249,1264,HYDERABAD-JAMNAGAR,2513,All
2024,9,HYDERABAD,JAMNAGAR,950,862,HYDERABAD-JAMNAGAR,1812,All
2024,10,HYDERABAD,JAMNAGAR,1055,1115,HYDERABAD-JAMNAGAR,2170,All
2024,11,HYDERABAD,JAMNAGAR,552,446,HYDERABAD-JAMNAGAR,998,All
2025,1,HYDERABAD,JHARSUGUDA,2108,2231,HYDERABAD-JHARSUGUDA,4339,All
2025,2,HYDERABAD,JHARSUGUDA,2004,1972,HYDERABAD-JHARSUGUDA,3976,All
2025,3,HYDERABAD,JHARSUGUDA,2121,2121,HYDERABAD-JHARSUGUDA,4242,All
2024,1,HYDERABAD,JODHPUR,5031,4989,HYDERABAD-JODHPUR,10020,All
2024,2,HYDERABAD,JODHPUR,4695,4716,HYDERABAD-JODHPUR,9411,All
2024,3,HYDERABAD,JODHPUR,4975,4970,HYDERABAD-JODHPUR,9945,All
2024,4,HYDERABAD,JODHPUR,3658,3251,HYDERABAD-JODHPUR,6909,All
2024,6,HYDERABAD,JODHPUR,3552,3367,HYDERABAD-JODHPUR,6919,All
2024,7,HYDERABAD,JODHPUR,3631,3372,HYDERABAD-JODHPUR,7003,All
2024,8,HYDERABAD,JODHPUR,3648,3238,HYDERABAD-JODHPUR,6886,All
2024,9,HYDERABAD,JODHPUR,5585,5061,HYDERABAD-JODHPUR,10646,All
2024,10,HYDERABAD,JODHPUR,6048,5096,HYDERABAD-JODHPUR,11144,All
2024,11,HYDERABAD,JODHPUR,4956,4738,HYDERABAD-JODHPUR,9694,All
2024,12,HYDERABAD,JODHPUR,5352,5334,HYDERABAD-JODHPUR,10686,All
2025,1,HYDERABAD,JODHPUR,5165,5076,HYDERABAD-JODHPUR,10241,All
2025,2,HYDERABAD,JODHPUR,4807,4713,HYDERABAD-JODHPUR,9520,All
2025,3,HYDERABAD,JODHPUR,4842,4633,HYDERABAD-JODHPUR,9475,All
2024,1,HYDERABAD,KANNUR,1807,2055,HYDERABAD-KANNUR,3862,All
2024,2,HYDERABAD,KANNUR,1459,2010,HYDERABAD-KANNUR,3469,All
2024,3,HYDERABAD,KANNUR,1625,2103,HYDERABAD-KANNUR,3728,All
2024,4,HYDERABAD,KANNUR,2015,1808,HYDERABAD-KANNUR,3823,All
2024,6,HYDERABAD,KANNUR,1587,1784,HYDERABAD-KANNUR,3371,All
2024,7,HYDERABAD,KANNUR,1967,1604,HYDERABAD-KANNUR,3571,All
2024,8,HYDERABAD,KANNUR,1704,1821,HYDERABAD-KANNUR,3525,All
2024,9,HYDERABAD,KANNUR,1544,1604,HYDERABAD-KANNUR,3148,All
2024,10,HYDERABAD,KANNUR,1555,1704,HYDERABAD-KANNUR,3259,All
2024,11,HYDERABAD,KANNUR,1775,1713,HYDERABAD-KANNUR,3488,All
2024,12,HYDERABAD,KANNUR,2120,1893,HYDERABAD-KANNUR,4013,All
2025,1,HYDERABAD,KANNUR,1774,1932,HYDERABAD-KANNUR,3706,All
2025,2,HYDERABAD,KANNUR,2111,1989,HYDERABAD-KANNUR,4100,All
2025,3,HYDERABAD,KANNUR,1594,1553,HYDERABAD-KANNUR,3147,All
2024,9,HYDERABAD,KANPUR,429,312,HYDERABAD-KANPUR,741,All
2024,10,HYDERABAD,KANPUR,2859,1769,HYDERABAD-KANPUR,4628,All
2024,11,HYDERABAD,KANPUR,2355,2856,HYDERABAD-KANPUR,5211,All
2024,12,HYDERABAD,KANPUR,2548,3175,HYDERABAD-KANPUR,5723,All
2025,1,HYDERABAD,KANPUR,2827,2679,HYDERABAD-KANPUR,5506,All
2025,2,HYDERABAD,KANPUR,3578,3443,HYDERABAD-KANPUR,7021,All
2025,3,HYDERABAD,KANPUR,3092,2981,HYDERABAD-KANPUR,6073,All
2024,1,HYDERABAD,KOCHI,31830,33512,HYDERABAD-KOCHI,65342,All
2024,2,HYDERABAD,KOCHI,25372,27993,HYDERABAD-KOCHI,53365,All
2024,3,HYDERABAD,KOCHI,26287,28316,HYDERABAD-KOCHI,54603,All
2024,4,HYDERABAD,KOCHI,25898,25089,HYDERABAD-KOCHI,50987,All
2024,6,HYDERABAD,KOCHI,22735,25128,HYDERABAD-KOCHI,47863,All
2024,7,HYDERABAD,KOCHI,24648,21715,HYDERABAD-KOCHI,46363,All
2024,8,HYDERABAD,KOCHI,24703,23394,HYDERABAD-KOCHI,48097,All
2024,9,HYDERABAD,KOCHI,28530,28914,HYDERABAD-KOCHI,57444,All
2024,10,HYDERABAD,KOCHI,31645,30737,HYDERABAD-KOCHI,62382,All
2024,11,HYDERABAD,KOCHI,35706,34038,HYDERABAD-KOCHI,69744,All
2024,12,HYDERABAD,KOCHI,41883,38761,HYDERABAD-KOCHI,80644,All
2025,1,HYDERABAD,KOCHI,38618,40174,HYDERABAD-KOCHI,78792,All
2025,2,HYDERABAD,KOCHI,34359,34580,HYDERABAD-KOCHI,68939,All
2025,3,HYDERABAD,KOCHI,27044,29354,HYDERABAD-KOCHI,56398,All
2024,1,HYDERABAD,KOLHAPUR,1816,1807,HYDERABAD-KOLHAPUR,3623,All
2024,2,HYDERABAD,KOLHAPUR,1711,1722,HYDERABAD-KOLHAPUR,3433,All
2024,3,HYDERABAD,KOLHAPUR,1642,1610,HYDERABAD-KOLHAPUR,3252,All
2024,4,HYDERABAD,KOLHAPUR,1727,1688,HYDERABAD-KOLHAPUR,3415,All
2024,6,HYDERABAD,KOLHAPUR,1758,1793,HYDERABAD-KOLHAPUR,3551,All
2024,7,HYDERABAD,KOLHAPUR,1848,1919,HYDERABAD-KOLHAPUR,3767,All
2024,8,HYDERABAD,KOLHAPUR,1757,1817,HYDERABAD-KOLHAPUR,3574,All
2024,9,HYDERABAD,KOLHAPUR,1749,1928,HYDERABAD-KOLHAPUR,3677,All
2024,10,HYDERABAD,KOLHAPUR,1874,2000,HYDERABAD-KOLHAPUR,3874,All
2024,11,HYDERABAD,KOLHAPUR,1815,2041,HYDERABAD-KOLHAPUR,3856,All
2024,12,HYDERABAD,KOLHAPUR,1773,2069,HYDERABAD-KOLHAPUR,3842,All
2025,1,HYDERABAD,KOLHAPUR,1668,2026,HYDERABAD-KOLHAPUR,3694,All
2025,2,HYDERABAD,KOLHAPUR,1613,1952,HYDERABAD-KOLHAPUR,3565,All
2025,3,HYDERABAD,KOLHAPUR,1771,1876,HYDERABAD-KOLHAPUR,3647,All
2024,1,HYDERABAD,KOLKATA,43717,42238,HYDERABAD-KOLKATA,85955,All
2024,2,HYDERABAD,KOLKATA,42825,41671,HYDERABAD-KOLKATA,84496,All
2024,3,HYDERABAD,KOLKATA,53274,47328,HYDERABAD-KOLKATA,100602,All
2024,4,HYDERABAD,KOLKATA,57302,45422,HYDERABAD-KOLKATA,102724,All
2024,6,HYDERABAD,KOLKATA,45240,46990,HYDERABAD-KOLKATA,92230,All
2024,7,HYDERABAD,KOLKATA,45178,49262,HYDERABAD-KOLKATA,94440,All
2024,8,HYDERABAD,KOLKATA,46153,47662,HYDERABAD-KOLKATA,93815,All
2024,9,HYDERABAD,KOLKATA,46815,41801,HYDERABAD-KOLKATA,88616,All
2024,10,HYDERABAD,KOLKATA,60585,48172,HYDERABAD-KOLKATA,108757,All
2024,11,HYDERABAD,KOLKATA,47780,50897,HYDERABAD-KOLKATA,98677,All
2024,12,HYDERABAD,KOLKATA,53977,52923,HYDERABAD-KOLKATA,106900,All
2025,1,HYDERABAD,KOLKATA,49624,47048,HYDERABAD-KOLKATA,96672,All
2025,2,HYDERABAD,KOLKATA,47222,44115,HYDERABAD-KOLKATA,91337,All
2025,3,HYDERABAD,KOLKATA,53615,45909,HYDERABAD-KOLKATA,99524,All
2024,1,HYDERABAD,KOZHIKODE,2032,2184,HYDERABAD-KOZHIKODE,4216,All
2024,2,HYDERABAD,KOZHIKODE,1761,1841,HYDERABAD-KOZHIKODE,3602,All
2024,3,HYDERABAD,KOZHIKODE,1788,1958,HYDERABAD-KOZHIKODE,3746,All
2024,4,HYDERABAD,KOZHIKODE,1863,1941,HYDERABAD-KOZHIKODE,3804,All
2024,6,HYDERABAD,KOZHIKODE,1982,2055,HYDERABAD-KOZHIKODE,4037,All
2024,7,HYDERABAD,KOZHIKODE,2081,1865,HYDERABAD-KOZHIKODE,3946,All
2024,8,HYDERABAD,KOZHIKODE,1890,1947,HYDERABAD-KOZHIKODE,3837,All
2024,9,HYDERABAD,KOZHIKODE,1691,1837,HYDERABAD-KOZHIKODE,3528,All
2024,10,HYDERABAD,KOZHIKODE,2017,2135,HYDERABAD-KOZHIKODE,4152,All
2024,11,HYDERABAD,KOZHIKODE,3959,4270,HYDERABAD-KOZHIKODE,8229,All
2024,12,HYDERABAD,KOZHIKODE,4745,4462,HYDERABAD-KOZHIKODE,9207,All
2025,1,HYDERABAD,KOZHIKODE,4551,4625,HYDERABAD-KOZHIKODE,9176,All
2025,2,HYDERABAD,KOZHIKODE,4591,4667,HYDERABAD-KOZHIKODE,9258,All
2025,3,HYDERABAD,KOZHIKODE,3664,3947,HYDERABAD-KOZHIKODE,7611,All
2024,1,HYDERABAD,LUCKNOW,13523,13903,HYDERABAD-LUCKNOW,27426,All
2024,2,HYDERABAD,LUCKNOW,13248,12682,HYDERABAD-LUCKNOW,25930,All
2024,3,HYDERABAD,LUCKNOW,17296,15914,HYDERABAD-LUCKNOW,33210,All
2024,4,HYDERABAD,LUCKNOW,17138,14794,HYDERABAD-LUCKNOW,31932,All
2024,6,HYDERABAD,LUCKNOW,15233,16613,HYDERABAD-LUCKNOW,31846,All
2024,7,HYDERABAD,LUCKNOW,14995,16152,HYDERABAD-LUCKNOW,31147,All
2024,8,HYDERABAD,LUCKNOW,16796,16062,HYDERABAD-LUCKNOW,32858,All
2024,9,HYDERABAD,LUCKNOW,15509,13488,HYDERABAD-LUCKNOW,28997,All
2024,10,HYDERABAD,LUCKNOW,25006,14875,HYDERABAD-LUCKNOW,39881,All
2024,11,HYDERABAD,LUCKNOW,23597,23355,HYDERABAD-LUCKNOW,46952,All
2024,12,HYDERABAD,LUCKNOW,20997,27073,HYDERABAD-LUCKNOW,48070,All
2025,1,HYDERABAD,LUCKNOW,24334,22994,HYDERABAD-LUCKNOW,47328,All
2025,2,HYDERABAD,LUCKNOW,32440,30056,HYDERABAD-LUCKNOW,62496,All
2025,3,HYDERABAD,LUCKNOW,26244,22823,HYDERABAD-LUCKNOW,49067,All
2024,1,HYDERABAD,MADURAI,4923,4966,HYDERABAD-MADURAI,9889,All
2024,2,HYDERABAD,MADURAI,4511,4481,HYDERABAD-MADURAI,8992,All
2024,3,HYDERABAD,MADURAI,4762,4799,HYDERABAD-MADURAI,9561,All
2024,4,HYDERABAD,MADURAI,6038,5834,HYDERABAD-MADURAI,11872,All
2024,6,HYDERABAD,MADURAI,4348,4774,HYDERABAD-MADURAI,9122,All
2024,7,HYDERABAD,MADURAI,4889,5022,HYDERABAD-MADURAI,9911,All
2024,8,HYDERABAD,MADURAI,4740,5038,HYDERABAD-MADURAI,9778,All
2024,9,HYDERABAD,MADURAI,5183,5888,HYDERABAD-MADURAI,11071,All
2024,10,HYDERABAD,MADURAI,4661,4632,HYDERABAD-MADURAI,9293,All
2024,11,HYDERABAD,MADURAI,6004,5908,HYDERABAD-MADURAI,11912,All
2024,12,HYDERABAD,MADURAI,9396,8638,HYDERABAD-MADURAI,18034,All
2025,1,HYDERABAD,MADURAI,9690,8874,HYDERABAD-MADURAI,18564,All
2025,2,HYDERABAD,MADURAI,8221,8126,HYDERABAD-MADURAI,16347,All
2025,3,HYDERABAD,MADURAI,8408,8132,HYDERABAD-MADURAI,16540,All
2024,1,HYDERABAD,MANGALORE,3798,3811,HYDERABAD-MANGALORE,7609,All
2024,2,HYDERABAD,MANGALORE,3420,3532,HYDERABAD-MANGALORE,6952,All
2024,3,HYDERABAD,MANGALORE,3978,4069,HYDERABAD-MANGALORE,8047,All
2024,4,HYDERABAD,MANGALORE,4020,3961,HYDERABAD-MANGALORE,7981,All
2024,6,HYDERABAD,MANGALORE,3918,4131,HYDERABAD-MANGALORE,8049,All
2024,7,HYDERABAD,MANGALORE,4188,3812,HYDERABAD-MANGALORE,8000,All
2024,8,HYDERABAD,MANGALORE,4068,4029,HYDERABAD-MANGALORE,8097,All
2024,9,HYDERABAD,MANGALORE,3339,3683,HYDERABAD-MANGALORE,7022,All
2024,10,HYDERABAD,MANGALORE,3747,4107,HYDERABAD-MANGALORE,7854,All
2024,11,HYDERABAD,MANGALORE,4415,4172,HYDERABAD-MANGALORE,8587,All
2024,12,HYDERABAD,MANGALORE,4572,4628,HYDERABAD-MANGALORE,9200,All
2025,1,HYDERABAD,MANGALORE,4908,5141,HYDERABAD-MANGALORE,10049,All
2025,2,HYDERABAD,MANGALORE,5303,5304,HYDERABAD-MANGALORE,10607,All
2025,3,HYDERABAD,MANGALORE,4864,5098,HYDERABAD-MANGALORE,9962,All
2024,1,HYDERABAD,MUMBAI,108612,105344,HYDERABAD-MUMBAI,213956,All
2024,2,HYDERABAD,MUMBAI,97310,100044,HYDERABAD-MUMBAI,197354,All
2024,3,HYDERABAD,MUMBAI,95517,95348,HYDERABAD-MUMBAI,190865,All
2024,4,HYDERABAD,MUMBAI,99889,94837,HYDERABAD-MUMBAI,194726,All
2024,6,HYDERABAD,MUMBAI,94337,99030,HYDERABAD-MUMBAI,193367,All
2024,7,HYDERABAD,MUMBAI,95689,95245,HYDERABAD-MUMBAI,190934,All
2024,8,HYDERABAD,MUMBAI,109924,98516,HYDERABAD-MUMBAI,208440,All
2024,9,HYDERABAD,MUMBAI,102814,97960,HYDERABAD-MUMBAI,200774,All
2024,10,HYDERABAD,MUMBAI,95696,102069,HYDERABAD-MUMBAI,197765,All
2024,11,HYDERABAD,MUMBAI,98997,97302,HYDERABAD-MUMBAI,196299,All
2024,12,HYDERABAD,MUMBAI,99982,106152,HYDERABAD-MUMBAI,206134,All
2025,1,HYDERABAD,MUMBAI,96955,101542,HYDERABAD-MUMBAI,198497,All
2025,2,HYDERABAD,MUMBAI,88795,97707,HYDERABAD-MUMBAI,186502,All
2025,3,HYDERABAD,MUMBAI,81610,90547,HYDERABAD-MUMBAI,172157,All
2024,1,HYDERABAD,MYSORE,2631,2488,HYDERABAD-MYSORE,5119,All
2024,2,HYDERABAD,MYSORE,2113,1891,HYDERABAD-MYSORE,4004,All
2024,3,HYDERABAD,MYSORE,2023,1942,HYDERABAD-MYSORE,3965,All
2024,4,HYDERABAD,MYSORE,1952,1651,HYDERABAD-MYSORE,3603,All
2024,6,HYDERABAD,MYSORE,2099,1686,HYDERABAD-MYSORE,3785,All
2024,7,HYDERABAD,MYSORE,2152,1771,HYDERABAD-MYSORE,3923,All
2024,8,HYDERABAD,MYSORE,1994,1640,HYDERABAD-MYSORE,3634,All
2024,9,HYDERABAD,MYSORE,1836,1534,HYDERABAD-MYSORE,3370,All
2024,10,HYDERABAD,MYSORE,1957,1725,HYDERABAD-MYSORE,3682,All
2024,11,HYDERABAD,MYSORE,2066,1820,HYDERABAD-MYSORE,3886,All
2024,12,HYDERABAD,MYSORE,1991,2077,HYDERABAD-MYSORE,4068,All
2025,1,HYDERABAD,MYSORE,2092,1992,HYDERABAD-MYSORE,4084,All
2025,2,HYDERABAD,MYSORE,1789,1804,HYDERABAD-MYSORE,3593,All
2025,3,HYDERABAD,MYSORE,1996,1724,HYDERABAD-MYSORE,3720,All
2024,3,HYDERABAD,Malvan,39,46,HYDERABAD-Malvan,85,All
2024,4,HYDERABAD,Malvan,59,99,HYDERABAD-Malvan,158,All
2024,6,HYDERABAD,Malvan,124,149,HYDERABAD-Malvan,273,All
2024,7,HYDERABAD,Malvan,29,60,HYDERABAD-Malvan,89,All
2024,8,HYDERABAD,Malvan,61,86,HYDERABAD-Malvan,147,All
2024,9,HYDERABAD,Malvan,34,106,HYDERABAD-Malvan,140,All
2024,10,HYDERABAD,Malvan,109,75,HYDERABAD-Malvan,184,All
2024,1,HYDERABAD,NAGPUR,5270,5541,HYDERABAD-NAGPUR,10811,All
2024,2,HYDERABAD,NAGPUR,5146,5217,HYDERABAD-NAGPUR,10363,All
2024,3,HYDERABAD,NAGPUR,4876,4864,HYDERABAD-NAGPUR,9740,All
2024,4,HYDERABAD,NAGPUR,4101,4087,HYDERABAD-NAGPUR,8188,All
2024,6,HYDERABAD,NAGPUR,4179,4246,HYDERABAD-NAGPUR,8425,All
2024,7,HYDERABAD,NAGPUR,3867,4304,HYDERABAD-NAGPUR,8171,All
2024,8,HYDERABAD,NAGPUR,4072,4239,HYDERABAD-NAGPUR,8311,All
2024,9,HYDERABAD,NAGPUR,3889,4123,HYDERABAD-NAGPUR,8012,All
2024,10,HYDERABAD,NAGPUR,3910,3947,HYDERABAD-NAGPUR,7857,All
2024,11,HYDERABAD,NAGPUR,4038,4381,HYDERABAD-NAGPUR,8419,All
2024,12,HYDERABAD,NAGPUR,4645,5115,HYDERABAD-NAGPUR,9760,All
2025,1,HYDERABAD,NAGPUR,5143,6153,HYDERABAD-NAGPUR,11296,All
2025,2,HYDERABAD,NAGPUR,4202,4107,HYDERABAD-NAGPUR,8309,All
2025,3,HYDERABAD,NAGPUR,4093,4306,HYDERABAD-NAGPUR,8399,All
2024,3,HYDERABAD,NANDED,33,45,HYDERABAD-NANDED,78,All
2024,4,HYDERABAD,NANDED,781,927,HYDERABAD-NANDED,1708,All
2024,6,HYDERABAD,NANDED,804,1151,HYDERABAD-NANDED,1955,All
2024,7,HYDERABAD,NANDED,623,638,HYDERABAD-NANDED,1261,All
2024,8,HYDERABAD,NANDED,803,912,HYDERABAD-NANDED,1715,All
2024,9,HYDERABAD,NANDED,797,703,HYDERABAD-NANDED,1500,All
2024,10,HYDERABAD,NANDED,897,986,HYDERABAD-NANDED,1883,All
2024,11,HYDERABAD,NANDED,910,956,HYDERABAD-NANDED,1866,All
2024,12,HYDERABAD,NANDED,1033,943,HYDERABAD-NANDED,1976,All
2025,1,HYDERABAD,NANDED,878,923,HYDERABAD-NANDED,1801,All
2025,2,HYDERABAD,NANDED,711,832,HYDERABAD-NANDED,1543,All
2025,3,HYDERABAD,NANDED,945,989,HYDERABAD-NANDED,1934,All
2024,1,HYDERABAD,NASIK,2468,2464,HYDERABAD-NASIK,4932,All
2024,2,HYDERABAD,NASIK,2156,2183,HYDERABAD-NASIK,4339,All
2024,3,HYDERABAD,NASIK,2336,2461,HYDERABAD-NASIK,4797,All
2024,4,HYDERABAD,NASIK,2038,1891,HYDERABAD-NASIK,3929,All
2024,6,HYDERABAD,NASIK,2091,1950,HYDERABAD-NASIK,4041,All
2024,7,HYDERABAD,NASIK,2146,1848,HYDERABAD-NASIK,3994,All
2024,8,HYDERABAD,NASIK,2242,1858,HYDERABAD-NASIK,4100,All
2024,9,HYDERABAD,NASIK,1980,1823,HYDERABAD-NASIK,3803,All
2024,10,HYDERABAD,NASIK,1940,1845,HYDERABAD-NASIK,3785,All
2024,11,HYDERABAD,NASIK,2059,2079,HYDERABAD-NASIK,4138,All
2024,12,HYDERABAD,NASIK,1754,1879,HYDERABAD-NASIK,3633,All
2025,1,HYDERABAD,NASIK,2017,2036,HYDERABAD-NASIK,4053,All
2025,2,HYDERABAD,NASIK,1971,1950,HYDERABAD-NASIK,3921,All
2025,3,HYDERABAD,NASIK,2180,2202,HYDERABAD-NASIK,4382,All
2024,1,HYDERABAD,PATNA,9707,9134,HYDERABAD-PATNA,18841,All
2024,2,HYDERABAD,PATNA,10330,9492,HYDERABAD-PATNA,19822,All
2024,3,HYDERABAD,PATNA,10888,9525,HYDERABAD-PATNA,20413,All
2024,4,HYDERABAD,PATNA,10607,9381,HYDERABAD-PATNA,19988,All
2024,6,HYDERABAD,PATNA,9852,9985,HYDERABAD-PATNA,19837,All
2024,7,HYDERABAD,PATNA,9021,10603,HYDERABAD-PATNA,19624,All
2024,8,HYDERABAD,PATNA,9210,10103,HYDERABAD-PATNA,19313,All
2024,9,HYDERABAD,PATNA,13465,12656,HYDERABAD-PATNA,26121,All
2024,10,HYDERABAD,PATNA,17085,10491,HYDERABAD-PATNA,27576,All
2024,11,HYDERABAD,PATNA,18188,16406,HYDERABAD-PATNA,34594,All
2024,12,HYDERABAD,PATNA,15635,16406,HYDERABAD-PATNA,32041,All
2025,1,HYDERABAD,PATNA,18163,16938,HYDERABAD-PATNA,35101,All
2025,2,HYDERABAD,PATNA,23411,21744,HYDERABAD-PATNA,45155,All
2025,3,HYDERABAD,PATNA,22171,18921,HYDERABAD-PATNA,41092,All
2024,1,HYDERABAD,PONDICHERRY,2433,2474,HYDERABAD-PONDICHERRY,4907,All
2024,2,HYDERABAD,PONDICHERRY,2090,2028,HYDERABAD-PONDICHERRY,4118,All
2024,3,HYDERABAD,PONDICHERRY,1981,2203,HYDERABAD-PONDICHERRY,4184,All
2024,12,HYDERABAD,PONDICHERRY,819,820,HYDERABAD-PONDICHERRY,1639,All
2025,1,HYDERABAD,PONDICHERRY,2208,2141,HYDERABAD-PONDICHERRY,4349,All
2025,2,HYDERABAD,PONDICHERRY,1984,1976,HYDERABAD-PONDICHERRY,3960,All
2025,3,HYDERABAD,PONDICHERRY,2078,2164,HYDERABAD-PONDICHERRY,4242,All
2024,1,HYDERABAD,PORT BLAIR,4692,4925,HYDERABAD-PORT BLAIR,9617,All
2024,2,HYDERABAD,PORT BLAIR,4661,4947,HYDERABAD-PORT BLAIR,9608,All
2024,3,HYDERABAD,PORT BLAIR,5123,5217,HYDERABAD-PORT BLAIR,10340,All
2024,4,HYDERABAD,PORT BLAIR,4134,4948,HYDERABAD-PORT BLAIR,9082,All
2024,6,HYDERABAD,PORT BLAIR,4137,4526,HYDERABAD-PORT BLAIR,8663,All
2024,7,HYDERABAD,PORT BLAIR,2177,2944,HYDERABAD-PORT BLAIR,5121,All
2024,8,HYDERABAD,PORT BLAIR,2637,2907,HYDERABAD-PORT BLAIR,5544,All
2024,9,HYDERABAD,PORT BLAIR,4355,4235,HYDERABAD-PORT BLAIR,8590,All
2024,10,HYDERABAD,PORT BLAIR,4950,5007,HYDERABAD-PORT BLAIR,9957,All
2024,11,HYDERABAD,PORT BLAIR,6125,5832,HYDERABAD-PORT BLAIR,11957,All
2024,12,HYDERABAD,PORT BLAIR,8494,8449,HYDERABAD-PORT BLAIR,16943,All
2025,1,HYDERABAD,PORT BLAIR,9645,11405,HYDERABAD-PORT BLAIR,21050,All
2025,2,HYDERABAD,PORT BLAIR,5457,6189,HYDERABAD-PORT BLAIR,11646,All
2025,3,HYDERABAD,PORT BLAIR,5708,6720,HYDERABAD-PORT BLAIR,12428,All
2024,1,HYDERABAD,PUNE,22792,23880,HYDERABAD-PUNE,46672,All
2024,2,HYDERABAD,PUNE,21839,23192,HYDERABAD-PUNE,45031,All
2024,3,HYDERABAD,PUNE,22138,23807,HYDERABAD-PUNE,45945,All
2024,4,HYDERABAD,PUNE,24331,25805,HYDERABAD-PUNE,50136,All
2024,6,HYDERABAD,PUNE,25688,26024,HYDERABAD-PUNE,51712,All
2024,7,HYDERABAD,PUNE,27433,28177,HYDERABAD-PUNE,55610,All
2024,8,HYDERABAD,PUNE,28291,27900,HYDERABAD-PUNE,56191,All
2024,9,HYDERABAD,PUNE,26820,28376,HYDERABAD-PUNE,55196,All
2024,10,HYDERABAD,PUNE,24380,26630,HYDERABAD-PUNE,51010,All
2024,11,HYDERABAD,PUNE,24031,23560,HYDERABAD-PUNE,47591,All
2024,12,HYDERABAD,PUNE,24590,24973,HYDERABAD-PUNE,49563,All
2025,1,HYDERABAD,PUNE,25418,25397,HYDERABAD-PUNE,50815,All
2025,2,HYDERABAD,PUNE,22561,23043,HYDERABAD-PUNE,45604,All
2025,3,HYDERABAD,PUNE,25055,25858,HYDERABAD-PUNE,50913,All
2024,1,HYDERABAD,RAIPUR,9095,9317,HYDERABAD-RAIPUR,18412,All
2024,2,HYDERABAD,RAIPUR,7320,7529,HYDERABAD-RAIPUR,14849,All
2024,3,HYDERABAD,RAIPUR,7689,7955,HYDERABAD-RAIPUR,15644,All
2024,4,HYDERABAD,RAIPUR,7502,7095,HYDERABAD-RAIPUR,14597,All
2024,6,HYDERABAD,RAIPUR,6983,7269,HYDERABAD-RAIPUR,14252,All
2024,7,HYDERABAD,RAIPUR,7030,7476,HYDERABAD-RAIPUR,14506,All
2024,8,HYDERABAD,RAIPUR,6989,7522,HYDERABAD-RAIPUR,14511,All
2024,9,HYDERABAD,RAIPUR,7430,7331,HYDERABAD-RAIPUR,14761,All
2024,10,HYDERABAD,RAIPUR,10540,9214,HYDERABAD-RAIPUR,19754,All
2024,11,HYDERABAD,RAIPUR,7284,7435,HYDERABAD-RAIPUR,14719,All
2024,12,HYDERABAD,RAIPUR,7822,7530,HYDERABAD-RAIPUR,15352,All
2025,1,HYDERABAD,RAIPUR,9929,9729,HYDERABAD-RAIPUR,19658,All
2025,2,HYDERABAD,RAIPUR,10269,9849,HYDERABAD-RAIPUR,20118,All
2025,3,HYDERABAD,RAIPUR,10210,10331,HYDERABAD-RAIPUR,20541,All
2024,1,HYDERABAD,RAJAHMUNDRY,11767,11669,HYDERABAD-RAJAHMUNDRY,23436,All
2024,2,HYDERABAD,RAJAHMUNDRY,11447,10309,HYDERABAD-RAJAHMUNDRY,21756,All
2024,3,HYDERABAD,RAJAHMUNDRY,12228,11886,HYDERABAD-RAJAHMUNDRY,24114,All
2024,4,HYDERABAD,RAJAHMUNDRY,10892,10865,HYDERABAD-RAJAHMUNDRY,21757,All
2024,6,HYDERABAD,RAJAHMUNDRY,12529,12143,HYDERABAD-RAJAHMUNDRY,24672,All
2024,7,HYDERABAD,RAJAHMUNDRY,11998,11718,HYDERABAD-RAJAHMUNDRY,23716,All
2024,8,HYDERABAD,RAJAHMUNDRY,12385,12790,HYDERABAD-RAJAHMUNDRY,25175,All
2024,9,HYDERABAD,RAJAHMUNDRY,10902,11289,HYDERABAD-RAJAHMUNDRY,22191,All
2024,10,HYDERABAD,RAJAHMUNDRY,12992,12425,HYDERABAD-RAJAHMUNDRY,25417,All
2024,11,HYDERABAD,RAJAHMUNDRY,12495,12665,HYDERABAD-RAJAHMUNDRY,25160,All
2024,12,HYDERABAD,RAJAHMUNDRY,13371,11711,HYDERABAD-RAJAHMUNDRY,25082,All
2025,1,HYDERABAD,RAJAHMUNDRY,11581,11508,HYDERABAD-RAJAHMUNDRY,23089,All
2025,2,HYDERABAD,RAJAHMUNDRY,11677,11365,HYDERABAD-RAJAHMUNDRY,23042,All
2025,3,HYDERABAD,RAJAHMUNDRY,11669,11210,HYDERABAD-RAJAHMUNDRY,22879,All
2024,1,HYDERABAD,RANCHI,8322,8605,HYDERABAD-RANCHI,16927,All
2024,2,HYDERABAD,RANCHI,7502,7370,HYDERABAD-RANCHI,14872,All
2024,3,HYDERABAD,RANCHI,10761,9759,HYDERABAD-RANCHI,20520,All
2024,4,HYDERABAD,RANCHI,9140,8383,HYDERABAD-RANCHI,17523,All
2024,6,HYDERABAD,RANCHI,10268,10544,HYDERABAD-RANCHI,20812,All
2024,7,HYDERABAD,RANCHI,9051,11591,HYDERABAD-RANCHI,20642,All
2024,8,HYDERABAD,RANCHI,9699,11526,HYDERABAD-RANCHI,21225,All
2024,9,HYDERABAD,RANCHI,9756,9789,HYDERABAD-RANCHI,19545,All
2024,10,HYDERABAD,RANCHI,12664,9533,HYDERABAD-RANCHI,22197,All
2024,11,HYDERABAD,RANCHI,12517,12678,HYDERABAD-RANCHI,25195,All
2024,12,HYDERABAD,RANCHI,13136,13608,HYDERABAD-RANCHI,26744,All
2025,1,HYDERABAD,RANCHI,13702,12865,HYDERABAD-RANCHI,26567,All
2025,2,HYDERABAD,RANCHI,12659,11931,HYDERABAD-RANCHI,24590,All
2025,3,HYDERABAD,RANCHI,13301,11900,HYDERABAD-RANCHI,25201,All
2024,9,HYDERABAD,Rajkot International Airport,2128,1641,HYDERABAD-Rajkot International Airport,3769,All
2024,10,HYDERABAD,Rajkot International Airport,4146,4060,HYDERABAD-Rajkot International Airport,8206,All
2024,11,HYDERABAD,Rajkot International Airport,3036,2994,HYDERABAD-Rajkot International Airport,6030,All
2024,12,HYDERABAD,Rajkot International Airport,3366,3376,HYDERABAD-Rajkot International Airport,6742,All
2025,1,HYDERABAD,Rajkot International Airport,4550,4836,HYDERABAD-Rajkot International Airport,9386,All
2025,2,HYDERABAD,Rajkot International Airport,3767,4433,HYDERABAD-Rajkot International Airport,8200,All
2025,3,HYDERABAD,Rajkot International Airport,3389,4302,HYDERABAD-Rajkot International Airport,7691,All
2024,1,HYDERABAD,SALEM,756,806,HYDERABAD-SALEM,1562,All
2024,2,HYDERABAD,SALEM,654,683,HYDERABAD-SALEM,1337,All
2024,3,HYDERABAD,SALEM,566,625,HYDERABAD-SALEM,1191,All
2024,4,HYDERABAD,SALEM,676,671,HYDERABAD-SALEM,1347,All
2024,6,HYDERABAD,SALEM,780,891,HYDERABAD-SALEM,1671,All
2024,7,HYDERABAD,SALEM,791,725,HYDERABAD-SALEM,1516,All
2024,8,HYDERABAD,SALEM,750,696,HYDERABAD-SALEM,1446,All
2024,9,HYDERABAD,SALEM,744,780,HYDERABAD-SALEM,1524,All
2024,10,HYDERABAD,SALEM,787,741,HYDERABAD-SALEM,1528,All
2024,11,HYDERABAD,SALEM,810,853,HYDERABAD-SALEM,1663,All
2024,12,HYDERABAD,SALEM,882,876,HYDERABAD-SALEM,1758,All
2025,1,HYDERABAD,SALEM,898,831,HYDERABAD-SALEM,1729,All
2025,2,HYDERABAD,SALEM,801,850,HYDERABAD-SALEM,1651,All
2025,3,HYDERABAD,SALEM,793,761,HYDERABAD-SALEM,1554,All
2024,1,HYDERABAD,SHIRDI,8732,8616,HYDERABAD-SHIRDI,17348,All
2024,2,HYDERABAD,SHIRDI,8119,7845,HYDERABAD-SHIRDI,15964,All
2024,3,HYDERABAD,SHIRDI,8598,8541,HYDERABAD-SHIRDI,17139,All
2024,4,HYDERABAD,SHIRDI,6975,7085,HYDERABAD-SHIRDI,14060,All
2024,6,HYDERABAD,SHIRDI,7582,7554,HYDERABAD-SHIRDI,15136,All
2024,7,HYDERABAD,SHIRDI,7612,7734,HYDERABAD-SHIRDI,15346,All
2024,8,HYDERABAD,SHIRDI,6877,6902,HYDERABAD-SHIRDI,13779,All
2024,9,HYDERABAD,SHIRDI,5643,5990,HYDERABAD-SHIRDI,11633,All
2024,10,HYDERABAD,SHIRDI,5578,5877,HYDERABAD-SHIRDI,11455,All
2024,11,HYDERABAD,SHIRDI,6827,6995,HYDERABAD-SHIRDI,13822,All
2024,12,HYDERABAD,SHIRDI,8005,8151,HYDERABAD-SHIRDI,16156,All
2025,1,HYDERABAD,SHIRDI,7180,7365,HYDERABAD-SHIRDI,14545,All
2025,2,HYDERABAD,SHIRDI,5091,5340,HYDERABAD-SHIRDI,10431,All
2025,3,HYDERABAD,SHIRDI,6398,6661,HYDERABAD-SHIRDI,13059,All
2024,1,HYDERABAD,SRINAGAR,6150,6018,HYDERABAD-SRINAGAR,12168,All
2024,2,HYDERABAD,SRINAGAR,5750,5270,HYDERABAD-SRINAGAR,11020,All
2024,3,HYDERABAD,SRINAGAR,6095,5495,HYDERABAD-SRINAGAR,11590,All
2024,4,HYDERABAD,SRINAGAR,4670,4302,HYDERABAD-SRINAGAR,8972,All
2024,6,HYDERABAD,SRINAGAR,5301,5000,HYDERABAD-SRINAGAR,10301,All
2024,7,HYDERABAD,SRINAGAR,5020,5390,HYDERABAD-SRINAGAR,10410,All
2024,8,HYDERABAD,SRINAGAR,3178,3733,HYDERABAD-SRINAGAR,6911,All
2024,9,HYDERABAD,SRINAGAR,3010,2781,HYDERABAD-SRINAGAR,5791,All
2024,10,HYDERABAD,SRINAGAR,7156,7956,HYDERABAD-SRINAGAR,15112,All
2024,11,HYDERABAD,SRINAGAR,8824,10073,HYDERABAD-SRINAGAR,18897,All
2024,12,HYDERABAD,SRINAGAR,7067,7631,HYDERABAD-SRINAGAR,14698,All
2025,1,HYDERABAD,SRINAGAR,6433,6328,HYDERABAD-SRINAGAR,12761,All
2025,2,HYDERABAD,SRINAGAR,8394,7762,HYDERABAD-SRINAGAR,16156,All
2025,3,HYDERABAD,SRINAGAR,9368,9052,HYDERABAD-SRINAGAR,18420,All
2024,1,HYDERABAD,SURAT,6445,6238,HYDERABAD-SURAT,12683,All
2024,2,HYDERABAD,SURAT,6773,7172,HYDERABAD-SURAT,13945,All
2024,3,HYDERABAD,SURAT,7171,7205,HYDERABAD-SURAT,14376,All
2024,4,HYDERABAD,SURAT,6456,5508,HYDERABAD-SURAT,11964,All
2024,6,HYDERABAD,SURAT,6851,7569,HYDERABAD-SURAT,14420,All
2024,7,HYDERABAD,SURAT,6304,6879,HYDERABAD-SURAT,13183,All
2024,8,HYDERABAD,SURAT,7098,6825,HYDERABAD-SURAT,13923,All
2024,9,HYDERABAD,SURAT,7226,6988,HYDERABAD-SURAT,14214,All
2024,10,HYDERABAD,SURAT,7962,7968,HYDERABAD-SURAT,15930,All
2024,11,HYDERABAD,SURAT,8167,7780,HYDERABAD-SURAT,15947,All
2024,12,HYDERABAD,SURAT,8612,8365,HYDERABAD-SURAT,16977,All
2025,1,HYDERABAD,SURAT,8066,7951,HYDERABAD-SURAT,16017,All
2025,2,HYDERABAD,SURAT,6859,6969,HYDERABAD-SURAT,13828,All
2025,3,HYDERABAD,SURAT,6306,6917,HYDERABAD-SURAT,13223,All
2024,1,HYDERABAD,Shivamogga Airport,743,728,HYDERABAD-Shivamogga Airport,1471,All
2024,2,HYDERABAD,Shivamogga Airport,943,921,HYDERABAD-Shivamogga Airport,1864,All
2024,3,HYDERABAD,Shivamogga Airport,971,908,HYDERABAD-Shivamogga Airport,1879,All
2024,4,HYDERABAD,Shivamogga Airport,1019,915,HYDERABAD-Shivamogga Airport,1934,All
2024,6,HYDERABAD,Shivamogga Airport,881,977,HYDERABAD-Shivamogga Airport,1858,All
2024,7,HYDERABAD,Shivamogga Airport,1010,810,HYDERABAD-Shivamogga Airport,1820,All
2024,8,HYDERABAD,Shivamogga Airport,223,191,HYDERABAD-Shivamogga Airport,414,All
2024,9,HYDERABAD,Shivamogga Airport,646,665,HYDERABAD-Shivamogga Airport,1311,All
2024,10,HYDERABAD,Shivamogga Airport,2063,2074,HYDERABAD-Shivamogga Airport,4137,All
2024,11,HYDERABAD,Shivamogga Airport,2361,2230,HYDERABAD-Shivamogga Airport,4591,All
2024,12,HYDERABAD,Shivamogga Airport,2972,2910,HYDERABAD-Shivamogga Airport,5882,All
2025,1,HYDERABAD,Shivamogga Airport,2504,2756,HYDERABAD-Shivamogga Airport,5260,All
2025,2,HYDERABAD,Shivamogga Airport,2708,2358,HYDERABAD-Shivamogga Airport,5066,All
2025,3,HYDERABAD,Shivamogga Airport,2494,2272,HYDERABAD-Shivamogga Airport,4766,All
2024,1,HYDERABAD,TIRUCHIRAPALLY,6358,5990,HYDERABAD-TIRUCHIRAPALLY,12348,All
2024,2,HYDERABAD,TIRUCHIRAPALLY,5761,5838,HYDERABAD-TIRUCHIRAPALLY,11599,All
2024,3,HYDERABAD,TIRUCHIRAPALLY,6131,6021,HYDERABAD-TIRUCHIRAPALLY,12152,All
2024,4,HYDERABAD,TIRUCHIRAPALLY,4386,4357,HYDERABAD-TIRUCHIRAPALLY,8743,All
2024,6,HYDERABAD,TIRUCHIRAPALLY,4496,4459,HYDERABAD-TIRUCHIRAPALLY,8955,All
2024,7,HYDERABAD,TIRUCHIRAPALLY,4879,4450,HYDERABAD-TIRUCHIRAPALLY,9329,All
2024,8,HYDERABAD,TIRUCHIRAPALLY,4827,4952,HYDERABAD-TIRUCHIRAPALLY,9779,All
2024,9,HYDERABAD,TIRUCHIRAPALLY,4744,4978,HYDERABAD-TIRUCHIRAPALLY,9722,All
2024,10,HYDERABAD,TIRUCHIRAPALLY,5087,4679,HYDERABAD-TIRUCHIRAPALLY,9766,All
2024,11,HYDERABAD,TIRUCHIRAPALLY,4732,4468,HYDERABAD-TIRUCHIRAPALLY,9200,All
2024,12,HYDERABAD,TIRUCHIRAPALLY,5230,4638,HYDERABAD-TIRUCHIRAPALLY,9868,All
2025,1,HYDERABAD,TIRUCHIRAPALLY,5195,4479,HYDERABAD-TIRUCHIRAPALLY,9674,All
2025,2,HYDERABAD,TIRUCHIRAPALLY,4829,4750,HYDERABAD-TIRUCHIRAPALLY,9579,All
2025,3,HYDERABAD,TIRUCHIRAPALLY,4705,4168,HYDERABAD-TIRUCHIRAPALLY,8873,All
2024,1,HYDERABAD,TIRUPATI,28907,28441,HYDERABAD-TIRUPATI,57348,All
2024,2,HYDERABAD,TIRUPATI,27874,27620,HYDERABAD-TIRUPATI,55494,All
2024,3,HYDERABAD,TIRUPATI,33261,32785,HYDERABAD-TIRUPATI,66046,All
2024,4,HYDERABAD,TIRUPATI,28178,27750,HYDERABAD-TIRUPATI,55928,All
2024,6,HYDERABAD,TIRUPATI,28497,27505,HYDERABAD-TIRUPATI,56002,All
2024,7,HYDERABAD,TIRUPATI,28740,28204,HYDERABAD-TIRUPATI,56944,All
2024,8,HYDERABAD,TIRUPATI,29302,28954,HYDERABAD-TIRUPATI,58256,All
2024,9,HYDERABAD,TIRUPATI,28796,28656,HYDERABAD-TIRUPATI,57452,All
2024,10,HYDERABAD,TIRUPATI,28049,27998,HYDERABAD-TIRUPATI,56047,All
2024,11,HYDERABAD,TIRUPATI,29992,29503,HYDERABAD-TIRUPATI,59495,All
2024,12,HYDERABAD,TIRUPATI,33356,32359,HYDERABAD-TIRUPATI,65715,All
2025,1,HYDERABAD,TIRUPATI,32780,32111,HYDERABAD-TIRUPATI,64891,All
2025,2,HYDERABAD,TIRUPATI,33593,32209,HYDERABAD-TIRUPATI,65802,All
2025,3,HYDERABAD,TIRUPATI,37991,37228,HYDERABAD-TIRUPATI,75219,All
2024,1,HYDERABAD,TRIVANDRUM,9077,9922,HYDERABAD-TRIVANDRUM,18999,All
2024,2,HYDERABAD,TRIVANDRUM,9660,11131,HYDERABAD-TRIVANDRUM,20791,All
2024,3,HYDERABAD,TRIVANDRUM,12381,13143,HYDERABAD-TRIVANDRUM,25524,All
2024,4,HYDERABAD,TRIVANDRUM,13018,13777,HYDERABAD-TRIVANDRUM,26795,All
2024,6,HYDERABAD,TRIVANDRUM,11168,13673,HYDERABAD-TRIVANDRUM,24841,All
2024,7,HYDERABAD,TRIVANDRUM,10861,11045,HYDERABAD-TRIVANDRUM,21906,All
2024,8,HYDERABAD,TRIVANDRUM,12822,14111,HYDERABAD-TRIVANDRUM,26933,All
2024,9,HYDERABAD,TRIVANDRUM,14224,15700,HYDERABAD-TRIVANDRUM,29924,All
2024,10,HYDERABAD,TRIVANDRUM,15015,15881,HYDERABAD-TRIVANDRUM,30896,All
2024,11,HYDERABAD,TRIVANDRUM,17096,18586,HYDERABAD-TRIVANDRUM,35682,All
2024,12,HYDERABAD,TRIVANDRUM,20645,20464,HYDERABAD-TRIVANDRUM,41109,All
2025,1,HYDERABAD,TRIVANDRUM,16719,17895,HYDERABAD-TRIVANDRUM,34614,All
2025,2,HYDERABAD,TRIVANDRUM,13459,13962,HYDERABAD-TRIVANDRUM,27421,All
2025,3,HYDERABAD,TRIVANDRUM,14127,14744,HYDERABAD-TRIVANDRUM,28871,All
2024,1,HYDERABAD,UDAIPUR,5991,5858,HYDERABAD-UDAIPUR,11849,All
2024,2,HYDERABAD,UDAIPUR,5718,5527,HYDERABAD-UDAIPUR,11245,All
2024,3,HYDERABAD,UDAIPUR,5115,5394,HYDERABAD-UDAIPUR,10509,All
2024,4,HYDERABAD,UDAIPUR,2513,2070,HYDERABAD-UDAIPUR,4583,All
2024,6,HYDERABAD,UDAIPUR,2295,1968,HYDERABAD-UDAIPUR,4263,All
2024,7,HYDERABAD,UDAIPUR,2711,2454,HYDERABAD-UDAIPUR,5165,All
2024,8,HYDERABAD,UDAIPUR,2917,2574,HYDERABAD-UDAIPUR,5491,All
2024,9,HYDERABAD,UDAIPUR,4540,5358,HYDERABAD-UDAIPUR,9898,All
2024,10,HYDERABAD,UDAIPUR,5685,5763,HYDERABAD-UDAIPUR,11448,All
2024,11,HYDERABAD,UDAIPUR,6128,6559,HYDERABAD-UDAIPUR,12687,All
2024,12,HYDERABAD,UDAIPUR,6672,7199,HYDERABAD-UDAIPUR,13871,All
2025,1,HYDERABAD,UDAIPUR,6758,6829,HYDERABAD-UDAIPUR,13587,All
2025,2,HYDERABAD,UDAIPUR,6379,6342,HYDERABAD-UDAIPUR,12721,All
2025,3,HYDERABAD,UDAIPUR,5848,6457,HYDERABAD-UDAIPUR,12305,All
2024,1,HYDERABAD,VADODARA,4773,4611,HYDERABAD-VADODARA,9384,All
2024,2,HYDERABAD,VADODARA,4618,4685,HYDERABAD-VADODARA,9303,All
2024,3,HYDERABAD,VADODARA,4955,4928,HYDERABAD-VADODARA,9883,All
2024,4,HYDERABAD,VADODARA,4672,4517,HYDERABAD-VADODARA,9189,All
2024,6,HYDERABAD,VADODARA,4685,4584,HYDERABAD-VADODARA,9269,All
2024,7,HYDERABAD,VADODARA,4722,4788,HYDERABAD-VADODARA,9510,All
2024,8,HYDERABAD,VADODARA,4734,4879,HYDERABAD-VADODARA,9613,All
2024,9,HYDERABAD,VADODARA,4784,4702,HYDERABAD-VADODARA,9486,All
2024,10,HYDERABAD,VADODARA,4693,5038,HYDERABAD-VADODARA,9731,All
2024,11,HYDERABAD,VADODARA,5106,5150,HYDERABAD-VADODARA,10256,All
2024,12,HYDERABAD,VADODARA,5252,5238,HYDERABAD-VADODARA,10490,All
2025,1,HYDERABAD,VADODARA,5241,5074,HYDERABAD-VADODARA,10315,All
2025,2,HYDERABAD,VADODARA,4581,4610,HYDERABAD-VADODARA,9191,All
2025,3,HYDERABAD,VADODARA,4894,4985,HYDERABAD-VADODARA,9879,All
2024,1,HYDERABAD,VARANASI,8437,8089,HYDERABAD-VARANASI,16526,All
2024,2,HYDERABAD,VARANASI,10319,9560,HYDERABAD-VARANASI,19879,All
2024,3,HYDERABAD,VARANASI,14751,14083,HYDERABAD-VARANASI,28834,All
2024,4,HYDERABAD,VARANASI,18808,15674,HYDERABAD-VARANASI,34482,All
2024,6,HYDERABAD,VARANASI,15548,16442,HYDERABAD-VARANASI,31990,All
2024,7,HYDERABAD,VARANASI,17489,19572,HYDERABAD-VARANASI,37061,All
2024,8,HYDERABAD,VARANASI,18603,20133,HYDERABAD-VARANASI,38736,All
2024,9,HYDERABAD,VARANASI,24653,24164,HYDERABAD-VARANASI,48817,All
2024,10,HYDERABAD,VARANASI,28597,22141,HYDERABAD-VARANASI,50738,All
2024,11,HYDERABAD,VARANASI,25966,25857,HYDERABAD-VARANASI,51823,All
2024,12,HYDERABAD,VARANASI,22587,26591,HYDERABAD-VARANASI,49178,All
2025,1,HYDERABAD,VARANASI,26391,25420,HYDERABAD-VARANASI,51811,All
2025,2,HYDERABAD,VARANASI,26791,26551,HYDERABAD-VARANASI,53342,All
2025,3,HYDERABAD,VARANASI,29584,29027,HYDERABAD-VARANASI,58611,All
2024,1,HYDERABAD,VIDYANAGAR,610,790,HYDERABAD-VIDYANAGAR,1400,All
2024,2,HYDERABAD,VIDYANAGAR,746,821,HYDERABAD-VIDYANAGAR,1567,All
2024,3,HYDERABAD,VIDYANAGAR,602,789,HYDERABAD-VIDYANAGAR,1391,All
2024,4,HYDERABAD,VIDYANAGAR,933,1316,HYDERABAD-VIDYANAGAR,2249,All
2024,6,HYDERABAD,VIDYANAGAR,846,1133,HYDERABAD-VIDYANAGAR,1979,All
2024,7,HYDERABAD,VIDYANAGAR,797,1052,HYDERABAD-VIDYANAGAR,1849,All
2024,8,HYDERABAD,VIDYANAGAR,1120,1339,HYDERABAD-VIDYANAGAR,2459,All
2024,9,HYDERABAD,VIDYANAGAR,1070,1345,HYDERABAD-VIDYANAGAR,2415,All
2024,10,HYDERABAD,VIDYANAGAR,878,948,HYDERABAD-VIDYANAGAR,1826,All
2024,11,HYDERABAD,VIDYANAGAR,704,774,HYDERABAD-VIDYANAGAR,1478,All
2024,12,HYDERABAD,VIDYANAGAR,983,1198,HYDERABAD-VIDYANAGAR,2181,All
2025,1,HYDERABAD,VIDYANAGAR,852,995,HYDERABAD-VIDYANAGAR,1847,All
2025,3,HYDERABAD,VIDYANAGAR,330,397,HYDERABAD-VIDYANAGAR,727,All
2024,1,HYDERABAD,VIJAYAWADA,12539,12665,HYDERABAD-VIJAYAWADA,25204,All
2024,2,HYDERABAD,VIJAYAWADA,11631,11575,HYDERABAD-VIJAYAWADA,23206,All
2024,3,HYDERABAD,VIJAYAWADA,12078,11938,HYDERABAD-VIJAYAWADA,24016,All
2024,4,HYDERABAD,VIJAYAWADA,13561,14448,HYDERABAD-VIJAYAWADA,28009,All
2024,6,HYDERABAD,VIJAYAWADA,15600,15404,HYDERABAD-VIJAYAWADA,31004,All
2024,7,HYDERABAD,VIJAYAWADA,16304,16209,HYDERABAD-VIJAYAWADA,32513,All
2024,8,HYDERABAD,VIJAYAWADA,16061,16084,HYDERABAD-VIJAYAWADA,32145,All
2024,9,HYDERABAD,VIJAYAWADA,15183,15738,HYDERABAD-VIJAYAWADA,30921,All
2024,10,HYDERABAD,VIJAYAWADA,16794,16612,HYDERABAD-VIJAYAWADA,33406,All
2024,11,HYDERABAD,VIJAYAWADA,14472,15150,HYDERABAD-VIJAYAWADA,29622,All
2024,12,HYDERABAD,VIJAYAWADA,16766,17092,HYDERABAD-VIJAYAWADA,33858,All
2025,1,HYDERABAD,VIJAYAWADA,14337,14584,HYDERABAD-VIJAYAWADA,28921,All
2025,2,HYDERABAD,VIJAYAWADA,14814,15299,HYDERABAD-VIJAYAWADA,30113,All
2025,3,HYDERABAD,VIJAYAWADA,16249,16446,HYDERABAD-VIJAYAWADA,32695,All
2024,1,HYDERABAD,VISAKHAPATNAM,28579,29641,HYDERABAD-VISAKHAPATNAM,58220,All
2024,2,HYDERABAD,VISAKHAPATNAM,29992,29359,HYDERABAD-VISAKHAPATNAM,59351,All
2024,3,HYDERABAD,VISAKHAPATNAM,32869,32744,HYDERABAD-VISAKHAPATNAM,65613,All
2024,4,HYDERABAD,VISAKHAPATNAM,30617,29538,HYDERABAD-VISAKHAPATNAM,60155,All
2024,6,HYDERABAD,VISAKHAPATNAM,35257,32857,HYDERABAD-VISAKHAPATNAM,68114,All
2024,7,HYDERABAD,VISAKHAPATNAM,32703,30831,HYDERABAD-VISAKHAPATNAM,63534,All
2024,8,HYDERABAD,VISAKHAPATNAM,35978,35581,HYDERABAD-VISAKHAPATNAM,71559,All
2024,9,HYDERABAD,VISAKHAPATNAM,33777,33258,HYDERABAD-VISAKHAPATNAM,67035,All
2024,10,HYDERABAD,VISAKHAPATNAM,44927,39766,HYDERABAD-VISAKHAPATNAM,84693,All
2024,11,HYDERABAD,VISAKHAPATNAM,40491,43074,HYDERABAD-VISAKHAPATNAM,83565,All
2024,12,HYDERABAD,VISAKHAPATNAM,46339,44677,HYDERABAD-VISAKHAPATNAM,91016,All
2025,1,HYDERABAD,VISAKHAPATNAM,47150,46798,HYDERABAD-VISAKHAPATNAM,93948,All
2025,2,HYDERABAD,VISAKHAPATNAM,43377,41827,HYDERABAD-VISAKHAPATNAM,85204,All
2025,3,HYDERABAD,VISAKHAPATNAM,45010,42888,HYDERABAD-VISAKHAPATNAM,87898,All
2025,1,Hyderabad,HYDERABAD,0,2,HYDERABAD-Hyderabad,2,All
2024,1,IMPHAL,KOLKATA,14847,13914,IMPHAL-KOLKATA,28761,All
2024,2,IMPHAL,KOLKATA,12354,12707,IMPHAL-KOLKATA,25061,All
2024,3,IMPHAL,KOLKATA,14636,14527,IMPHAL-KOLKATA,29163,All
2024,4,IMPHAL,KOLKATA,15315,15350,IMPHAL-KOLKATA,30665,All
2024,6,IMPHAL,KOLKATA,16984,14601,IMPHAL-KOLKATA,31585,All
2024,7,IMPHAL,KOLKATA,17003,14396,IMPHAL-KOLKATA,31399,All
2024,8,IMPHAL,KOLKATA,16323,11955,IMPHAL-KOLKATA,28278,All
2024,9,IMPHAL,KOLKATA,15599,11954,IMPHAL-KOLKATA,27553,All
2024,10,IMPHAL,KOLKATA,16905,16218,IMPHAL-KOLKATA,33123,All
2024,11,IMPHAL,KOLKATA,17750,17292,IMPHAL-KOLKATA,35042,All
2024,12,IMPHAL,KOLKATA,18387,19210,IMPHAL-KOLKATA,37597,All
2025,1,IMPHAL,KOLKATA,18792,19010,IMPHAL-KOLKATA,37802,All
2025,2,IMPHAL,KOLKATA,16634,16238,IMPHAL-KOLKATA,32872,All
2025,3,IMPHAL,KOLKATA,18647,18661,IMPHAL-KOLKATA,37308,All
2024,6,IMPHAL,MUMBAI,150,197,IMPHAL-MUMBAI,347,All
2024,7,IMPHAL,MUMBAI,87,77,IMPHAL-MUMBAI,164,All
2024,8,IMPHAL,MUMBAI,101,107,IMPHAL-MUMBAI,208,All
2024,9,IMPHAL,MUMBAI,65,84,IMPHAL-MUMBAI,149,All
2024,10,IMPHAL,MUMBAI,116,139,IMPHAL-MUMBAI,255,All
2024,11,IMPHAL,MUMBAI,303,105,IMPHAL-MUMBAI,408,All
2024,12,IMPHAL,MUMBAI,196,181,IMPHAL-MUMBAI,377,All
2025,3,IMPHAL,MUMBAI,231,116,IMPHAL-MUMBAI,347,All
2024,1,IMPHAL,SHILLONG,976,774,IMPHAL-SHILLONG,1750,All
2024,2,IMPHAL,SHILLONG,837,650,IMPHAL-SHILLONG,1487,All
2024,3,IMPHAL,SHILLONG,795,715,IMPHAL-SHILLONG,1510,All
2024,4,IMPHAL,SHILLONG,465,401,IMPHAL-SHILLONG,866,All
2024,6,IMPHAL,SHILLONG,608,575,IMPHAL-SHILLONG,1183,All
2024,7,IMPHAL,SHILLONG,838,707,IMPHAL-SHILLONG,1545,All
2024,8,IMPHAL,SHILLONG,776,566,IMPHAL-SHILLONG,1342,All
2024,9,IMPHAL,SHILLONG,695,565,IMPHAL-SHILLONG,1260,All
2024,10,IMPHAL,SHILLONG,739,626,IMPHAL-SHILLONG,1365,All
2024,11,IMPHAL,SHILLONG,749,603,IMPHAL-SHILLONG,1352,All
2024,12,IMPHAL,SHILLONG,792,697,IMPHAL-SHILLONG,1489,All
2025,1,IMPHAL,SHILLONG,952,772,IMPHAL-SHILLONG,1724,All
2025,2,IMPHAL,SHILLONG,752,523,IMPHAL-SHILLONG,1275,All
2025,3,IMPHAL,SHILLONG,619,483,IMPHAL-SHILLONG,1102,All
2024,1,IMPHAL,SILCHAR,1974,1921,IMPHAL-SILCHAR,3895,All
2024,2,IMPHAL,SILCHAR,1804,1845,IMPHAL-SILCHAR,3649,All
2024,3,IMPHAL,SILCHAR,1941,1949,IMPHAL-SILCHAR,3890,All
2024,4,IMPHAL,SILCHAR,1888,1918,IMPHAL-SILCHAR,3806,All
2024,6,IMPHAL,SILCHAR,1907,1910,IMPHAL-SILCHAR,3817,All
2024,7,IMPHAL,SILCHAR,1889,1877,IMPHAL-SILCHAR,3766,All
2024,8,IMPHAL,SILCHAR,1195,1167,IMPHAL-SILCHAR,2362,All
2024,9,IMPHAL,SILCHAR,1242,1176,IMPHAL-SILCHAR,2418,All
2024,10,IMPHAL,SILCHAR,1707,1723,IMPHAL-SILCHAR,3430,All
2024,11,IMPHAL,SILCHAR,1120,1094,IMPHAL-SILCHAR,2214,All
2024,12,IMPHAL,SILCHAR,1138,1132,IMPHAL-SILCHAR,2270,All
2025,1,IMPHAL,SILCHAR,899,1015,IMPHAL-SILCHAR,1914,All
2025,2,IMPHAL,SILCHAR,1018,1014,IMPHAL-SILCHAR,2032,All
2025,3,IMPHAL,SILCHAR,958,965,IMPHAL-SILCHAR,1923,All
2024,10,IMPHAL,TEZU,23,22,IMPHAL-TEZU,45,All
2024,11,IMPHAL,TEZU,207,155,IMPHAL-TEZU,362,All
2024,12,IMPHAL,TEZU,664,794,IMPHAL-TEZU,1458,All
2025,1,IMPHAL,TEZU,390,404,IMPHAL-TEZU,794,All
2024,1,INDORE,JABALPUR,1677,1794,INDORE-JABALPUR,3471,All
2024,2,INDORE,JABALPUR,2035,2137,INDORE-JABALPUR,4172,All
2024,3,INDORE,JABALPUR,2105,2276,INDORE-JABALPUR,4381,All
2024,4,INDORE,JABALPUR,2119,2127,INDORE-JABALPUR,4246,All
2024,6,INDORE,JABALPUR,1895,2173,INDORE-JABALPUR,4068,All
2024,7,INDORE,JABALPUR,1622,1812,INDORE-JABALPUR,3434,All
2024,8,INDORE,JABALPUR,1900,1994,INDORE-JABALPUR,3894,All
2024,9,INDORE,JABALPUR,1593,1869,INDORE-JABALPUR,3462,All
2024,10,INDORE,JABALPUR,2069,1844,INDORE-JABALPUR,3913,All
2024,11,INDORE,JABALPUR,1729,2145,INDORE-JABALPUR,3874,All
2024,12,INDORE,JABALPUR,1946,2225,INDORE-JABALPUR,4171,All
2025,1,INDORE,JABALPUR,1834,2267,INDORE-JABALPUR,4101,All
2025,2,INDORE,JABALPUR,1800,2025,INDORE-JABALPUR,3825,All
2025,3,INDORE,JABALPUR,1386,2029,INDORE-JABALPUR,3415,All
2024,1,INDORE,JAIPUR,4533,4148,INDORE-JAIPUR,8681,All
2024,2,INDORE,JAIPUR,4147,3929,INDORE-JAIPUR,8076,All
2024,3,INDORE,JAIPUR,5100,4685,INDORE-JAIPUR,9785,All
2024,4,INDORE,JAIPUR,3947,3431,INDORE-JAIPUR,7378,All
2024,6,INDORE,JAIPUR,3387,3750,INDORE-JAIPUR,7137,All
2024,7,INDORE,JAIPUR,4039,3794,INDORE-JAIPUR,7833,All
2024,8,INDORE,JAIPUR,4357,3969,INDORE-JAIPUR,8326,All
2024,9,INDORE,JAIPUR,4245,3925,INDORE-JAIPUR,8170,All
2024,10,INDORE,JAIPUR,3900,3683,INDORE-JAIPUR,7583,All
2024,11,INDORE,JAIPUR,4568,4579,INDORE-JAIPUR,9147,All
2024,12,INDORE,JAIPUR,4780,4731,INDORE-JAIPUR,9511,All
2025,1,INDORE,JAIPUR,4870,4880,INDORE-JAIPUR,9750,All
2025,2,INDORE,JAIPUR,4555,4487,INDORE-JAIPUR,9042,All
2025,3,INDORE,JAIPUR,4458,4622,INDORE-JAIPUR,9080,All
2024,1,INDORE,JAMMU,2102,1852,INDORE-JAMMU,3954,All
2024,2,INDORE,JAMMU,1777,1596,INDORE-JAMMU,3373,All
2024,3,INDORE,JAMMU,2184,2179,INDORE-JAMMU,4363,All
2024,4,INDORE,JAMMU,2089,1730,INDORE-JAMMU,3819,All
2024,6,INDORE,JAMMU,2110,1848,INDORE-JAMMU,3958,All
2024,7,INDORE,JAMMU,2102,1885,INDORE-JAMMU,3987,All
2024,8,INDORE,JAMMU,2025,1340,INDORE-JAMMU,3365,All
2024,9,INDORE,JAMMU,1956,1509,INDORE-JAMMU,3465,All
2024,10,INDORE,JAMMU,1261,1393,INDORE-JAMMU,2654,All
2024,11,INDORE,JAMMU,865,718,INDORE-JAMMU,1583,All
2024,12,INDORE,JAMMU,828,746,INDORE-JAMMU,1574,All
2025,1,INDORE,JAMMU,856,896,INDORE-JAMMU,1752,All
2025,2,INDORE,JAMMU,2353,1921,INDORE-JAMMU,4274,All
2025,3,INDORE,JAMMU,1927,1988,INDORE-JAMMU,3915,All
2024,1,INDORE,JODHPUR,1953,1794,INDORE-JODHPUR,3747,All
2024,2,INDORE,JODHPUR,1861,1890,INDORE-JODHPUR,3751,All
2024,3,INDORE,JODHPUR,1849,1901,INDORE-JODHPUR,3750,All
2024,4,INDORE,JODHPUR,1760,1646,INDORE-JODHPUR,3406,All
2024,6,INDORE,JODHPUR,1735,1855,INDORE-JODHPUR,3590,All
2024,7,INDORE,JODHPUR,1878,1804,INDORE-JODHPUR,3682,All
2024,8,INDORE,JODHPUR,1961,1859,INDORE-JODHPUR,3820,All
2024,9,INDORE,JODHPUR,1746,1648,INDORE-JODHPUR,3394,All
2024,10,INDORE,JODHPUR,1956,1833,INDORE-JODHPUR,3789,All
2024,11,INDORE,JODHPUR,2055,2016,INDORE-JODHPUR,4071,All
2024,12,INDORE,JODHPUR,2024,2083,INDORE-JODHPUR,4107,All
2025,1,INDORE,JODHPUR,2201,2158,INDORE-JODHPUR,4359,All
2025,2,INDORE,JODHPUR,2006,1982,INDORE-JODHPUR,3988,All
2025,3,INDORE,JODHPUR,1803,1778,INDORE-JODHPUR,3581,All
2024,1,INDORE,KOLKATA,5945,5822,INDORE-KOLKATA,11767,All
2024,2,INDORE,KOLKATA,4974,4815,INDORE-KOLKATA,9789,All
2024,3,INDORE,KOLKATA,5421,5284,INDORE-KOLKATA,10705,All
2024,4,INDORE,KOLKATA,5297,5209,INDORE-KOLKATA,10506,All
2024,6,INDORE,KOLKATA,5143,5112,INDORE-KOLKATA,10255,All
2024,7,INDORE,KOLKATA,5044,5251,INDORE-KOLKATA,10295,All
2024,8,INDORE,KOLKATA,5905,6483,INDORE-KOLKATA,12388,All
2024,9,INDORE,KOLKATA,5872,6037,INDORE-KOLKATA,11909,All
2024,10,INDORE,KOLKATA,5098,4721,INDORE-KOLKATA,9819,All
2024,11,INDORE,KOLKATA,5068,5116,INDORE-KOLKATA,10184,All
2024,12,INDORE,KOLKATA,10390,10545,INDORE-KOLKATA,20935,All
2025,1,INDORE,KOLKATA,12121,13035,INDORE-KOLKATA,25156,All
2025,2,INDORE,KOLKATA,13059,13372,INDORE-KOLKATA,26431,All
2025,3,INDORE,KOLKATA,13400,13038,INDORE-KOLKATA,26438,All
2024,1,INDORE,LUCKNOW,3845,3421,INDORE-LUCKNOW,7266,All
2024,2,INDORE,LUCKNOW,4067,3922,INDORE-LUCKNOW,7989,All
2024,3,INDORE,LUCKNOW,4178,3848,INDORE-LUCKNOW,8026,All
2024,4,INDORE,LUCKNOW,4047,3787,INDORE-LUCKNOW,7834,All
2024,6,INDORE,LUCKNOW,3780,4063,INDORE-LUCKNOW,7843,All
2024,7,INDORE,LUCKNOW,3911,3951,INDORE-LUCKNOW,7862,All
2024,8,INDORE,LUCKNOW,3814,3787,INDORE-LUCKNOW,7601,All
2024,9,INDORE,LUCKNOW,3658,3416,INDORE-LUCKNOW,7074,All
2024,10,INDORE,LUCKNOW,3873,3195,INDORE-LUCKNOW,7068,All
2024,11,INDORE,LUCKNOW,4148,3832,INDORE-LUCKNOW,7980,All
2024,12,INDORE,LUCKNOW,3932,4302,INDORE-LUCKNOW,8234,All
2025,1,INDORE,LUCKNOW,4064,4193,INDORE-LUCKNOW,8257,All
2025,2,INDORE,LUCKNOW,3881,3683,INDORE-LUCKNOW,7564,All
2025,3,INDORE,LUCKNOW,3974,3749,INDORE-LUCKNOW,7723,All
2024,1,INDORE,MUMBAI,30827,29056,INDORE-MUMBAI,59883,All
2024,2,INDORE,MUMBAI,29159,28332,INDORE-MUMBAI,57491,All
2024,3,INDORE,MUMBAI,29301,27992,INDORE-MUMBAI,57293,All
2024,4,INDORE,MUMBAI,27284,28843,INDORE-MUMBAI,56127,All
2024,6,INDORE,MUMBAI,27873,29174,INDORE-MUMBAI,57047,All
2024,7,INDORE,MUMBAI,28309,28081,INDORE-MUMBAI,56390,All
2024,8,INDORE,MUMBAI,29997,28606,INDORE-MUMBAI,58603,All
2024,9,INDORE,MUMBAI,28667,29537,INDORE-MUMBAI,58204,All
2024,10,INDORE,MUMBAI,26885,32870,INDORE-MUMBAI,59755,All
2024,11,INDORE,MUMBAI,34141,30831,INDORE-MUMBAI,64972,All
2024,12,INDORE,MUMBAI,33798,33488,INDORE-MUMBAI,67286,All
2025,1,INDORE,MUMBAI,31823,32660,INDORE-MUMBAI,64483,All
2025,2,INDORE,MUMBAI,29133,30415,INDORE-MUMBAI,59548,All
2025,3,INDORE,MUMBAI,30524,30862,INDORE-MUMBAI,61386,All
2024,1,INDORE,NAGPUR,3601,4201,INDORE-NAGPUR,7802,All
2024,2,INDORE,NAGPUR,3757,3726,INDORE-NAGPUR,7483,All
2024,3,INDORE,NAGPUR,3629,3628,INDORE-NAGPUR,7257,All
2024,4,INDORE,NAGPUR,2985,3656,INDORE-NAGPUR,6641,All
2024,6,INDORE,NAGPUR,3942,3824,INDORE-NAGPUR,7766,All
2024,7,INDORE,NAGPUR,3755,3863,INDORE-NAGPUR,7618,All
2024,8,INDORE,NAGPUR,4080,3928,INDORE-NAGPUR,8008,All
2024,9,INDORE,NAGPUR,3662,3731,INDORE-NAGPUR,7393,All
2024,10,INDORE,NAGPUR,3953,3781,INDORE-NAGPUR,7734,All
2024,11,INDORE,NAGPUR,3359,3310,INDORE-NAGPUR,6669,All
2024,12,INDORE,NAGPUR,3563,3440,INDORE-NAGPUR,7003,All
2025,1,INDORE,NAGPUR,3370,3297,INDORE-NAGPUR,6667,All
2025,2,INDORE,NAGPUR,2973,2995,INDORE-NAGPUR,5968,All
2025,3,INDORE,NAGPUR,3113,2980,INDORE-NAGPUR,6093,All
2024,1,INDORE,NASIK,2069,1773,INDORE-NASIK,3842,All
2024,2,INDORE,NASIK,1835,1901,INDORE-NASIK,3736,All
2024,3,INDORE,NASIK,1803,1881,INDORE-NASIK,3684,All
2024,4,INDORE,NASIK,446,491,INDORE-NASIK,937,All
2024,6,INDORE,NASIK,723,547,INDORE-NASIK,1270,All
2024,7,INDORE,NASIK,666,642,INDORE-NASIK,1308,All
2024,8,INDORE,NASIK,905,726,INDORE-NASIK,1631,All
2024,9,INDORE,NASIK,579,466,INDORE-NASIK,1045,All
2024,10,INDORE,NASIK,426,678,INDORE-NASIK,1104,All
2024,11,INDORE,NASIK,766,705,INDORE-NASIK,1471,All
2024,12,INDORE,NASIK,567,583,INDORE-NASIK,1150,All
2025,1,INDORE,NASIK,446,594,INDORE-NASIK,1040,All
2025,2,INDORE,NASIK,632,634,INDORE-NASIK,1266,All
2025,3,INDORE,NASIK,627,624,INDORE-NASIK,1251,All
2024,3,INDORE,PATNA,0,2,INDORE-PATNA,2,All
2024,1,INDORE,PUNE,5142,4893,INDORE-PUNE,10035,All
2024,2,INDORE,PUNE,5069,4743,INDORE-PUNE,9812,All
2024,3,INDORE,PUNE,5412,5024,INDORE-PUNE,10436,All
2024,4,INDORE,PUNE,5185,5023,INDORE-PUNE,10208,All
2024,6,INDORE,PUNE,5262,5039,INDORE-PUNE,10301,All
2024,7,INDORE,PUNE,5037,4853,INDORE-PUNE,9890,All
2024,8,INDORE,PUNE,5280,4820,INDORE-PUNE,10100,All
2024,9,INDORE,PUNE,5152,4580,INDORE-PUNE,9732,All
2024,10,INDORE,PUNE,4803,5504,INDORE-PUNE,10307,All
2024,11,INDORE,PUNE,8689,7673,INDORE-PUNE,16362,All
2024,12,INDORE,PUNE,8934,8423,INDORE-PUNE,17357,All
2025,1,INDORE,PUNE,9382,8920,INDORE-PUNE,18302,All
2025,2,INDORE,PUNE,8076,8059,INDORE-PUNE,16135,All
2025,3,INDORE,PUNE,8565,7873,INDORE-PUNE,16438,All
2024,1,INDORE,RAIPUR,3900,4021,INDORE-RAIPUR,7921,All
2024,2,INDORE,RAIPUR,3955,4026,INDORE-RAIPUR,7981,All
2024,3,INDORE,RAIPUR,4395,4438,INDORE-RAIPUR,8833,All
2024,4,INDORE,RAIPUR,4419,4267,INDORE-RAIPUR,8686,All
2024,6,INDORE,RAIPUR,4629,4298,INDORE-RAIPUR,8927,All
2024,7,INDORE,RAIPUR,4303,4121,INDORE-RAIPUR,8424,All
2024,8,INDORE,RAIPUR,4346,4174,INDORE-RAIPUR,8520,All
2024,9,INDORE,RAIPUR,4163,3820,INDORE-RAIPUR,7983,All
2024,10,INDORE,RAIPUR,3297,3106,INDORE-RAIPUR,6403,All
2024,11,INDORE,RAIPUR,2914,3565,INDORE-RAIPUR,6479,All
2024,12,INDORE,RAIPUR,2754,3434,INDORE-RAIPUR,6188,All
2025,1,INDORE,RAIPUR,3133,3853,INDORE-RAIPUR,6986,All
2025,2,INDORE,RAIPUR,3719,3721,INDORE-RAIPUR,7440,All
2025,3,INDORE,RAIPUR,4234,4339,INDORE-RAIPUR,8573,All
2024,1,INDORE,Rajkot International Airport,1830,1782,INDORE-Rajkot International Airport,3612,All
2024,2,INDORE,Rajkot International Airport,1676,1751,INDORE-Rajkot International Airport,3427,All
2024,3,INDORE,Rajkot International Airport,1697,1699,INDORE-Rajkot International Airport,3396,All
2024,1,INDORE,SHIRDI,1723,1653,INDORE-SHIRDI,3376,All
2024,2,INDORE,SHIRDI,1437,1493,INDORE-SHIRDI,2930,All
2024,3,INDORE,SHIRDI,1400,1221,INDORE-SHIRDI,2621,All
2024,4,INDORE,SHIRDI,964,1056,INDORE-SHIRDI,2020,All
2024,6,INDORE,SHIRDI,1622,1371,INDORE-SHIRDI,2993,All
2024,7,INDORE,SHIRDI,1322,1231,INDORE-SHIRDI,2553,All
2024,8,INDORE,SHIRDI,1376,1376,INDORE-SHIRDI,2752,All
2024,9,INDORE,SHIRDI,1331,1296,INDORE-SHIRDI,2627,All
2024,10,INDORE,SHIRDI,1243,1501,INDORE-SHIRDI,2744,All
2024,11,INDORE,SHIRDI,1789,1284,INDORE-SHIRDI,3073,All
2024,12,INDORE,SHIRDI,1993,1577,INDORE-SHIRDI,3570,All
2025,1,INDORE,SHIRDI,1810,1338,INDORE-SHIRDI,3148,All
2025,2,INDORE,SHIRDI,1512,1440,INDORE-SHIRDI,2952,All
2025,3,INDORE,SHIRDI,1510,1467,INDORE-SHIRDI,2977,All
2024,1,INDORE,SURAT,2140,1974,INDORE-SURAT,4114,All
2024,2,INDORE,SURAT,2015,1756,INDORE-SURAT,3771,All
2024,3,INDORE,SURAT,2046,1644,INDORE-SURAT,3690,All
2024,4,INDORE,SURAT,1492,1319,INDORE-SURAT,2811,All
2024,6,INDORE,SURAT,2125,1905,INDORE-SURAT,4030,All
2024,7,INDORE,SURAT,2061,1557,INDORE-SURAT,3618,All
2024,8,INDORE,SURAT,2036,1940,INDORE-SURAT,3976,All
2024,9,INDORE,SURAT,1904,1795,INDORE-SURAT,3699,All
2024,10,INDORE,SURAT,1442,1432,INDORE-SURAT,2874,All
2024,10,INDORE,TIRUPATI,2,0,INDORE-TIRUPATI,2,All
2024,11,INDORE,TIRUPATI,16,0,INDORE-TIRUPATI,16,All
2024,1,INDORE,UDAIPUR,1631,1544,INDORE-UDAIPUR,3175,All
2024,2,INDORE,UDAIPUR,1656,1771,INDORE-UDAIPUR,3427,All
2024,3,INDORE,UDAIPUR,1516,1412,INDORE-UDAIPUR,2928,All
2024,4,INDORE,UDAIPUR,943,665,INDORE-UDAIPUR,1608,All
2024,6,INDORE,UDAIPUR,993,798,INDORE-UDAIPUR,1791,All
2024,7,INDORE,UDAIPUR,1203,797,INDORE-UDAIPUR,2000,All
2024,8,INDORE,UDAIPUR,1079,743,INDORE-UDAIPUR,1822,All
2024,9,INDORE,UDAIPUR,982,755,INDORE-UDAIPUR,1737,All
2024,10,INDORE,UDAIPUR,944,853,INDORE-UDAIPUR,1797,All
2024,11,INDORE,UDAIPUR,1046,995,INDORE-UDAIPUR,2041,All
2024,12,INDORE,UDAIPUR,1272,1238,INDORE-UDAIPUR,2510,All
2025,1,INDORE,UDAIPUR,1207,1161,INDORE-UDAIPUR,2368,All
2025,2,INDORE,UDAIPUR,1198,1179,INDORE-UDAIPUR,2377,All
2025,3,INDORE,UDAIPUR,1281,1245,INDORE-UDAIPUR,2526,All
2024,8,INDORE,VADODARA,150,0,INDORE-VADODARA,150,All
2024,1,INDORE,VARANASI,0,52,INDORE-VARANASI,52,All
2024,3,INDORE,VARANASI,59,66,INDORE-VARANASI,125,All
2024,4,INDORE,VARANASI,1950,1330,INDORE-VARANASI,3280,All
2024,6,INDORE,VARANASI,1723,1639,INDORE-VARANASI,3362,All
2024,7,INDORE,VARANASI,1832,1439,INDORE-VARANASI,3271,All
2024,8,INDORE,VARANASI,1723,1477,INDORE-VARANASI,3200,All
2024,9,INDORE,VARANASI,1886,1703,INDORE-VARANASI,3589,All
2024,10,INDORE,VARANASI,1807,1522,INDORE-VARANASI,3329,All
2024,10,INDORE,VIJAYAWADA,12,24,INDORE-VIJAYAWADA,36,All
2024,11,INDORE,VIJAYAWADA,101,148,INDORE-VIJAYAWADA,249,All
2024,12,INDORE,VIJAYAWADA,94,103,INDORE-VIJAYAWADA,197,All
2025,3,INDORE,VIJAYAWADA,87,75,INDORE-VIJAYAWADA,162,All
2025,3,INDORE,VISAKHAPATNAM,1,5,INDORE-VISAKHAPATNAM,6,All
2025,2,Itanagar,JORHAT,0,8,Itanagar-JORHAT,8,All
2024,1,Itanagar,KOLKATA,4037,3853,Itanagar-KOLKATA,7890,All
2024,2,Itanagar,KOLKATA,3100,3353,Itanagar-KOLKATA,6453,All
2024,3,Itanagar,KOLKATA,3546,3773,Itanagar-KOLKATA,7319,All
2024,4,Itanagar,KOLKATA,3560,3979,Itanagar-KOLKATA,7539,All
2024,6,Itanagar,KOLKATA,3919,3931,Itanagar-KOLKATA,7850,All
2024,7,Itanagar,KOLKATA,4110,3837,Itanagar-KOLKATA,7947,All
2024,8,Itanagar,KOLKATA,3968,4146,Itanagar-KOLKATA,8114,All
2024,9,Itanagar,KOLKATA,4111,4648,Itanagar-KOLKATA,8759,All
2024,10,Itanagar,KOLKATA,4956,4919,Itanagar-KOLKATA,9875,All
2024,11,Itanagar,KOLKATA,3781,4143,Itanagar-KOLKATA,7924,All
2024,12,Itanagar,KOLKATA,3875,4605,Itanagar-KOLKATA,8480,All
2025,1,Itanagar,KOLKATA,4095,4189,Itanagar-KOLKATA,8284,All
2025,2,Itanagar,KOLKATA,2855,3346,Itanagar-KOLKATA,6201,All
2025,3,Itanagar,KOLKATA,3428,3895,Itanagar-KOLKATA,7323,All
2024,1,Itanagar,PASIGHAT,30,11,Itanagar-PASIGHAT,41,All
2024,2,Itanagar,PASIGHAT,2,0,Itanagar-PASIGHAT,2,All
2024,3,Itanagar,PASIGHAT,16,7,Itanagar-PASIGHAT,23,All
2024,4,Itanagar,PASIGHAT,44,13,Itanagar-PASIGHAT,57,All
2024,6,Itanagar,PASIGHAT,0,7,Itanagar-PASIGHAT,7,All
2024,7,Itanagar,PASIGHAT,2,0,Itanagar-PASIGHAT,2,All
2024,8,Itanagar,PASIGHAT,5,5,Itanagar-PASIGHAT,10,All
2024,9,Itanagar,PASIGHAT,12,17,Itanagar-PASIGHAT,29,All
2024,10,Itanagar,PASIGHAT,7,3,Itanagar-PASIGHAT,10,All
2024,11,Itanagar,PASIGHAT,4,21,Itanagar-PASIGHAT,25,All
2024,12,Itanagar,PASIGHAT,2,0,Itanagar-PASIGHAT,2,All
2024,12,Itanagar,TEZU,20,39,Itanagar-TEZU,59,All
2025,1,Itanagar,TEZU,18,47,Itanagar-TEZU,65,All
2025,2,Itanagar,TEZU,8,17,Itanagar-TEZU,25,All
2025,3,Itanagar,TEZU,4,12,Itanagar-TEZU,16,All
2024,1,Itanagar,Ziro,7,15,Itanagar-Ziro,22,All
2024,2,Itanagar,Ziro,9,13,Itanagar-Ziro,22,All
2024,3,Itanagar,Ziro,6,7,Itanagar-Ziro,13,All
2024,4,Itanagar,Ziro,22,18,Itanagar-Ziro,40,All
2024,7,Itanagar,Ziro,12,8,Itanagar-Ziro,20,All
2024,8,Itanagar,Ziro,5,8,Itanagar-Ziro,13,All
2024,9,Itanagar,Ziro,0,4,Itanagar-Ziro,4,All
2024,10,Itanagar,Ziro,1,8,Itanagar-Ziro,9,All
2024,11,Itanagar,Ziro,5,5,Itanagar-Ziro,10,All
2024,12,Itanagar,Ziro,0,2,Itanagar-Ziro,2,All
2024,4,JABALPUR,JAGDALPUR,99,165,JABALPUR-JAGDALPUR,264,All
2024,6,JABALPUR,JAGDALPUR,444,196,JABALPUR-JAGDALPUR,640,All
2024,7,JABALPUR,JAGDALPUR,173,165,JABALPUR-JAGDALPUR,338,All
2024,8,JABALPUR,JAGDALPUR,225,129,JABALPUR-JAGDALPUR,354,All
2024,9,JABALPUR,JAGDALPUR,214,102,JABALPUR-JAGDALPUR,316,All
2024,10,JABALPUR,JAGDALPUR,257,221,JABALPUR-JAGDALPUR,478,All
2024,11,JABALPUR,JAGDALPUR,294,189,JABALPUR-JAGDALPUR,483,All
2024,12,JABALPUR,JAGDALPUR,394,175,JABALPUR-JAGDALPUR,569,All
2025,1,JABALPUR,JAGDALPUR,215,180,JABALPUR-JAGDALPUR,395,All
2025,2,JABALPUR,JAGDALPUR,300,209,JABALPUR-JAGDALPUR,509,All
2025,3,JABALPUR,JAGDALPUR,300,178,JABALPUR-JAGDALPUR,478,All
2024,1,JABALPUR,MUMBAI,2100,2102,JABALPUR-MUMBAI,4202,All
2024,2,JABALPUR,MUMBAI,1026,1022,JABALPUR-MUMBAI,2048,All
2024,3,JABALPUR,MUMBAI,307,345,JABALPUR-MUMBAI,652,All
2024,4,JABALPUR,MUMBAI,116,139,JABALPUR-MUMBAI,255,All
2024,6,JABALPUR,MUMBAI,191,225,JABALPUR-MUMBAI,416,All
2024,7,JABALPUR,MUMBAI,5093,4802,JABALPUR-MUMBAI,9895,All
2024,8,JABALPUR,MUMBAI,4969,4594,JABALPUR-MUMBAI,9563,All
2024,9,JABALPUR,MUMBAI,4336,4151,JABALPUR-MUMBAI,8487,All
2024,10,JABALPUR,MUMBAI,3816,5088,JABALPUR-MUMBAI,8904,All
2024,11,JABALPUR,MUMBAI,5263,5301,JABALPUR-MUMBAI,10564,All
2024,12,JABALPUR,MUMBAI,5485,5138,JABALPUR-MUMBAI,10623,All
2025,1,JABALPUR,MUMBAI,5204,5235,JABALPUR-MUMBAI,10439,All
2025,2,JABALPUR,MUMBAI,4699,4827,JABALPUR-MUMBAI,9526,All
2025,3,JABALPUR,MUMBAI,4984,5092,JABALPUR-MUMBAI,10076,All
2024,9,JABALPUR,NAGPUR,51,0,JABALPUR-NAGPUR,51,All
2024,1,JAGDALPUR,RAIPUR,433,299,JAGDALPUR-RAIPUR,732,All
2024,2,JAGDALPUR,RAIPUR,417,400,JAGDALPUR-RAIPUR,817,All
2024,3,JAGDALPUR,RAIPUR,458,276,JAGDALPUR-RAIPUR,734,All
2024,4,JAGDALPUR,RAIPUR,1061,807,JAGDALPUR-RAIPUR,1868,All
2024,6,JAGDALPUR,RAIPUR,704,674,JAGDALPUR-RAIPUR,1378,All
2024,7,JAGDALPUR,RAIPUR,656,539,JAGDALPUR-RAIPUR,1195,All
2024,8,JAGDALPUR,RAIPUR,1006,775,JAGDALPUR-RAIPUR,1781,All
2024,9,JAGDALPUR,RAIPUR,952,754,JAGDALPUR-RAIPUR,1706,All
2024,10,JAGDALPUR,RAIPUR,896,911,JAGDALPUR-RAIPUR,1807,All
2025,1,JAGDALPUR,RAIPUR,0,80,JAGDALPUR-RAIPUR,80,All
2025,2,JAGDALPUR,RAIPUR,2,2,JAGDALPUR-RAIPUR,4,All
2024,2,JAIPUR,Ayodhya International Airport ,1015,901,Ayodhya International Airport -JAIPUR,1916,All
2024,7,JAIPUR,Ayodhya International Airport ,1227,1205,Ayodhya International Airport -JAIPUR,2432,All
2024,8,JAIPUR,Ayodhya International Airport ,2593,2497,Ayodhya International Airport -JAIPUR,5090,All
2024,9,JAIPUR,Ayodhya International Airport ,3674,3430,Ayodhya International Airport -JAIPUR,7104,All
2024,10,JAIPUR,Ayodhya International Airport ,1465,1081,Ayodhya International Airport -JAIPUR,2546,All
2024,1,JAIPUR,JAISALMER,1779,1714,JAIPUR-JAISALMER,3493,All
2024,2,JAIPUR,JAISALMER,1732,1778,JAIPUR-JAISALMER,3510,All
2024,3,JAIPUR,JAISALMER,566,557,JAIPUR-JAISALMER,1123,All
2024,12,JAIPUR,JAISALMER,2157,1862,JAIPUR-JAISALMER,4019,All
2025,1,JAIPUR,JAISALMER,2133,2111,JAIPUR-JAISALMER,4244,All
2025,2,JAIPUR,JAISALMER,1928,1790,JAIPUR-JAISALMER,3718,All
2025,3,JAIPUR,JAISALMER,774,726,JAIPUR-JAISALMER,1500,All
2024,1,JAIPUR,JODHPUR,1986,1843,JAIPUR-JODHPUR,3829,All
2024,2,JAIPUR,JODHPUR,1827,1846,JAIPUR-JODHPUR,3673,All
2024,3,JAIPUR,JODHPUR,1620,1540,JAIPUR-JODHPUR,3160,All
2024,4,JAIPUR,JODHPUR,1479,1419,JAIPUR-JODHPUR,2898,All
2024,6,JAIPUR,JODHPUR,1083,1123,JAIPUR-JODHPUR,2206,All
2024,7,JAIPUR,JODHPUR,1300,1185,JAIPUR-JODHPUR,2485,All
2024,8,JAIPUR,JODHPUR,1378,1376,JAIPUR-JODHPUR,2754,All
2024,9,JAIPUR,JODHPUR,1665,1484,JAIPUR-JODHPUR,3149,All
2024,10,JAIPUR,JODHPUR,1902,1740,JAIPUR-JODHPUR,3642,All
2024,11,JAIPUR,JODHPUR,1993,1902,JAIPUR-JODHPUR,3895,All
2024,12,JAIPUR,JODHPUR,1909,1679,JAIPUR-JODHPUR,3588,All
2025,1,JAIPUR,JODHPUR,1565,1617,JAIPUR-JODHPUR,3182,All
2025,2,JAIPUR,JODHPUR,1668,1551,JAIPUR-JODHPUR,3219,All
2025,3,JAIPUR,JODHPUR,1783,1427,JAIPUR-JODHPUR,3210,All
2024,4,JAIPUR,KANPUR,0,9,JAIPUR-KANPUR,9,All
2025,2,JAIPUR,KHAJURAHO,25,0,JAIPUR-KHAJURAHO,25,All
2024,10,JAIPUR,KOCHI,120,214,JAIPUR-KOCHI,334,All
2024,11,JAIPUR,KOCHI,1146,1132,JAIPUR-KOCHI,2278,All
2024,12,JAIPUR,KOCHI,1209,1076,JAIPUR-KOCHI,2285,All
2025,3,JAIPUR,KOCHI,918,899,JAIPUR-KOCHI,1817,All
2024,1,JAIPUR,KOLKATA,13990,13525,JAIPUR-KOLKATA,27515,All
2024,2,JAIPUR,KOLKATA,13844,13894,JAIPUR-KOLKATA,27738,All
2024,3,JAIPUR,KOLKATA,19413,19005,JAIPUR-KOLKATA,38418,All
2024,4,JAIPUR,KOLKATA,18082,16699,JAIPUR-KOLKATA,34781,All
2024,6,JAIPUR,KOLKATA,16854,14951,JAIPUR-KOLKATA,31805,All
2024,7,JAIPUR,KOLKATA,17581,18545,JAIPUR-KOLKATA,36126,All
2024,8,JAIPUR,KOLKATA,15887,16991,JAIPUR-KOLKATA,32878,All
2024,9,JAIPUR,KOLKATA,16465,14687,JAIPUR-KOLKATA,31152,All
2024,10,JAIPUR,KOLKATA,23986,22039,JAIPUR-KOLKATA,46025,All
2024,11,JAIPUR,KOLKATA,28057,27571,JAIPUR-KOLKATA,55628,All
2024,12,JAIPUR,KOLKATA,29273,26096,JAIPUR-KOLKATA,55369,All
2025,1,JAIPUR,KOLKATA,26655,27272,JAIPUR-KOLKATA,53927,All
2025,2,JAIPUR,KOLKATA,26723,27998,JAIPUR-KOLKATA,54721,All
2025,3,JAIPUR,KOLKATA,27127,25212,JAIPUR-KOLKATA,52339,All
2024,10,JAIPUR,KULLU,303,116,JAIPUR-KULLU,419,All
2024,11,JAIPUR,KULLU,661,206,JAIPUR-KULLU,867,All
2024,12,JAIPUR,KULLU,472,176,JAIPUR-KULLU,648,All
2025,1,JAIPUR,KULLU,372,208,JAIPUR-KULLU,580,All
2025,2,JAIPUR,KULLU,260,142,JAIPUR-KULLU,402,All
2025,3,JAIPUR,KULLU,297,163,JAIPUR-KULLU,460,All
2024,1,JAIPUR,LUCKNOW,2110,2135,JAIPUR-LUCKNOW,4245,All
2024,2,JAIPUR,LUCKNOW,2017,1930,JAIPUR-LUCKNOW,3947,All
2024,3,JAIPUR,LUCKNOW,2219,2187,JAIPUR-LUCKNOW,4406,All
2024,4,JAIPUR,LUCKNOW,4286,3588,JAIPUR-LUCKNOW,7874,All
2024,6,JAIPUR,LUCKNOW,3684,3546,JAIPUR-LUCKNOW,7230,All
2024,7,JAIPUR,LUCKNOW,3901,3512,JAIPUR-LUCKNOW,7413,All
2024,8,JAIPUR,LUCKNOW,3605,3396,JAIPUR-LUCKNOW,7001,All
2024,9,JAIPUR,LUCKNOW,3570,3069,JAIPUR-LUCKNOW,6639,All
2024,10,JAIPUR,LUCKNOW,4238,3255,JAIPUR-LUCKNOW,7493,All
2024,11,JAIPUR,LUCKNOW,4294,4145,JAIPUR-LUCKNOW,8439,All
2024,12,JAIPUR,LUCKNOW,3269,3277,JAIPUR-LUCKNOW,6546,All
2025,1,JAIPUR,LUCKNOW,2198,2228,JAIPUR-LUCKNOW,4426,All
2025,2,JAIPUR,LUCKNOW,3846,3836,JAIPUR-LUCKNOW,7682,All
2025,3,JAIPUR,LUCKNOW,2228,2126,JAIPUR-LUCKNOW,4354,All
2024,1,JAIPUR,MUMBAI,61338,61741,JAIPUR-MUMBAI,123079,All
2024,2,JAIPUR,MUMBAI,55401,54715,JAIPUR-MUMBAI,110116,All
2024,3,JAIPUR,MUMBAI,55506,53088,JAIPUR-MUMBAI,108594,All
2024,4,JAIPUR,MUMBAI,48523,52704,JAIPUR-MUMBAI,101227,All
2024,6,JAIPUR,MUMBAI,53284,45160,JAIPUR-MUMBAI,98444,All
2024,7,JAIPUR,MUMBAI,52528,52166,JAIPUR-MUMBAI,104694,All
2024,8,JAIPUR,MUMBAI,51462,50661,JAIPUR-MUMBAI,102123,All
2024,9,JAIPUR,MUMBAI,50570,50256,JAIPUR-MUMBAI,100826,All
2024,10,JAIPUR,MUMBAI,39244,51773,JAIPUR-MUMBAI,91017,All
2024,11,JAIPUR,MUMBAI,56044,53836,JAIPUR-MUMBAI,109880,All
2024,12,JAIPUR,MUMBAI,55255,52583,JAIPUR-MUMBAI,107838,All
2025,1,JAIPUR,MUMBAI,50064,51485,JAIPUR-MUMBAI,101549,All
2025,2,JAIPUR,MUMBAI,47740,49073,JAIPUR-MUMBAI,96813,All
2025,3,JAIPUR,MUMBAI,47862,47785,JAIPUR-MUMBAI,95647,All
2024,3,JAIPUR,NAGPUR,18,0,JAIPUR-NAGPUR,18,All
2024,10,JAIPUR,NAGPUR,111,87,JAIPUR-NAGPUR,198,All
2024,11,JAIPUR,NAGPUR,822,983,JAIPUR-NAGPUR,1805,All
2024,12,JAIPUR,NAGPUR,950,989,JAIPUR-NAGPUR,1939,All
2025,3,JAIPUR,NAGPUR,835,915,JAIPUR-NAGPUR,1750,All
2024,10,JAIPUR,NASIK,12,23,JAIPUR-NASIK,35,All
2024,11,JAIPUR,NASIK,186,201,JAIPUR-NASIK,387,All
2024,12,JAIPUR,NASIK,107,114,JAIPUR-NASIK,221,All
2025,3,JAIPUR,NASIK,247,250,JAIPUR-NASIK,497,All
2024,2,JAIPUR,PANTNAGAR,1163,1088,JAIPUR-PANTNAGAR,2251,All
2024,3,JAIPUR,PANTNAGAR,1868,1786,JAIPUR-PANTNAGAR,3654,All
2024,6,JAIPUR,PATNA,0,5,JAIPUR-PATNA,5,All
2024,1,JAIPUR,PUNE,11622,11324,JAIPUR-PUNE,22946,All
2024,2,JAIPUR,PUNE,11048,10440,JAIPUR-PUNE,21488,All
2024,3,JAIPUR,PUNE,11837,11069,JAIPUR-PUNE,22906,All
2024,4,JAIPUR,PUNE,12023,10933,JAIPUR-PUNE,22956,All
2024,6,JAIPUR,PUNE,11375,9847,JAIPUR-PUNE,21222,All
2024,7,JAIPUR,PUNE,12670,11245,JAIPUR-PUNE,23915,All
2024,8,JAIPUR,PUNE,12023,10533,JAIPUR-PUNE,22556,All
2024,9,JAIPUR,PUNE,11331,10401,JAIPUR-PUNE,21732,All
2024,10,JAIPUR,PUNE,11084,12027,JAIPUR-PUNE,23111,All
2024,11,JAIPUR,PUNE,13136,12004,JAIPUR-PUNE,25140,All
2024,12,JAIPUR,PUNE,12969,12040,JAIPUR-PUNE,25009,All
2025,1,JAIPUR,PUNE,13382,14201,JAIPUR-PUNE,27583,All
2025,2,JAIPUR,PUNE,12159,12093,JAIPUR-PUNE,24252,All
2025,3,JAIPUR,PUNE,12375,11913,JAIPUR-PUNE,24288,All
2024,6,JAIPUR,RAIPUR,0,9,JAIPUR-RAIPUR,9,All
2025,3,JAIPUR,RAIPUR,0,67,JAIPUR-RAIPUR,67,All
2024,1,JAIPUR,SURAT,6943,7327,JAIPUR-SURAT,14270,All
2024,2,JAIPUR,SURAT,4755,4785,JAIPUR-SURAT,9540,All
2024,3,JAIPUR,SURAT,5450,5270,JAIPUR-SURAT,10720,All
2024,4,JAIPUR,SURAT,4521,4791,JAIPUR-SURAT,9312,All
2024,6,JAIPUR,SURAT,4211,4027,JAIPUR-SURAT,8238,All
2024,7,JAIPUR,SURAT,3960,3835,JAIPUR-SURAT,7795,All
2024,8,JAIPUR,SURAT,3876,3929,JAIPUR-SURAT,7805,All
2024,9,JAIPUR,SURAT,3699,3380,JAIPUR-SURAT,7079,All
2024,10,JAIPUR,SURAT,3305,4136,JAIPUR-SURAT,7441,All
2024,11,JAIPUR,SURAT,5478,5492,JAIPUR-SURAT,10970,All
2024,12,JAIPUR,SURAT,5931,5720,JAIPUR-SURAT,11651,All
2025,1,JAIPUR,SURAT,4944,5169,JAIPUR-SURAT,10113,All
2025,2,JAIPUR,SURAT,4996,5447,JAIPUR-SURAT,10443,All
2025,3,JAIPUR,SURAT,4577,4823,JAIPUR-SURAT,9400,All
2024,1,JAIPUR,UDAIPUR,3400,3451,JAIPUR-UDAIPUR,6851,All
2024,2,JAIPUR,UDAIPUR,3777,3951,JAIPUR-UDAIPUR,7728,All
2024,3,JAIPUR,UDAIPUR,4097,3919,JAIPUR-UDAIPUR,8016,All
2024,4,JAIPUR,UDAIPUR,3125,3088,JAIPUR-UDAIPUR,6213,All
2024,6,JAIPUR,UDAIPUR,3062,2757,JAIPUR-UDAIPUR,5819,All
2024,7,JAIPUR,UDAIPUR,3486,3503,JAIPUR-UDAIPUR,6989,All
2024,8,JAIPUR,UDAIPUR,3345,3560,JAIPUR-UDAIPUR,6905,All
2024,9,JAIPUR,UDAIPUR,3439,3653,JAIPUR-UDAIPUR,7092,All
2024,10,JAIPUR,UDAIPUR,3757,3943,JAIPUR-UDAIPUR,7700,All
2024,11,JAIPUR,UDAIPUR,4004,4002,JAIPUR-UDAIPUR,8006,All
2024,12,JAIPUR,UDAIPUR,4236,4297,JAIPUR-UDAIPUR,8533,All
2025,1,JAIPUR,UDAIPUR,3489,3544,JAIPUR-UDAIPUR,7033,All
2025,2,JAIPUR,UDAIPUR,4156,4044,JAIPUR-UDAIPUR,8200,All
2025,3,JAIPUR,UDAIPUR,3981,3948,JAIPUR-UDAIPUR,7929,All
2025,3,JAIPUR,VADODARA,8,0,JAIPUR-VADODARA,8,All
2024,1,JAIPUR,VARANASI,2533,2538,JAIPUR-VARANASI,5071,All
2024,11,JAIPUR,VARANASI,282,327,JAIPUR-VARANASI,609,All
2024,12,JAIPUR,VARANASI,1446,1555,JAIPUR-VARANASI,3001,All
2025,1,JAIPUR,VARANASI,1714,1813,JAIPUR-VARANASI,3527,All
2025,2,JAIPUR,VARANASI,1617,1661,JAIPUR-VARANASI,3278,All
2025,3,JAIPUR,VARANASI,992,869,JAIPUR-VARANASI,1861,All
2025,3,JAISALMER,Ayodhya International Airport ,13,0,Ayodhya International Airport -JAISALMER,13,All
2024,1,JAISALMER,MUMBAI,6172,5811,JAISALMER-MUMBAI,11983,All
2024,2,JAISALMER,MUMBAI,4781,4545,JAISALMER-MUMBAI,9326,All
2024,3,JAISALMER,MUMBAI,1965,1807,JAISALMER-MUMBAI,3772,All
2024,10,JAISALMER,MUMBAI,3017,3762,JAISALMER-MUMBAI,6779,All
2024,11,JAISALMER,MUMBAI,4942,4698,JAISALMER-MUMBAI,9640,All
2024,12,JAISALMER,MUMBAI,5161,5160,JAISALMER-MUMBAI,10321,All
2025,1,JAISALMER,MUMBAI,5152,4902,JAISALMER-MUMBAI,10054,All
2025,2,JAISALMER,MUMBAI,4667,4794,JAISALMER-MUMBAI,9461,All
2025,3,JAISALMER,MUMBAI,1808,1659,JAISALMER-MUMBAI,3467,All
2024,6,JALGAON,MUMBAI,194,141,JALGAON-MUMBAI,335,All
2024,7,JALGAON,MUMBAI,537,408,JALGAON-MUMBAI,945,All
2024,8,JALGAON,MUMBAI,661,597,JALGAON-MUMBAI,1258,All
2024,9,JALGAON,MUMBAI,500,368,JALGAON-MUMBAI,868,All
2024,10,JALGAON,MUMBAI,586,625,JALGAON-MUMBAI,1211,All
2024,11,JALGAON,MUMBAI,755,652,JALGAON-MUMBAI,1407,All
2024,12,JALGAON,MUMBAI,731,693,JALGAON-MUMBAI,1424,All
2025,1,JALGAON,MUMBAI,554,462,JALGAON-MUMBAI,1016,All
2025,2,JALGAON,MUMBAI,657,602,JALGAON-MUMBAI,1259,All
2025,3,JALGAON,MUMBAI,375,292,JALGAON-MUMBAI,667,All
2024,6,JALGAON,PUNE,731,808,JALGAON-PUNE,1539,All
2024,7,JALGAON,PUNE,687,654,JALGAON-PUNE,1341,All
2024,8,JALGAON,PUNE,885,784,JALGAON-PUNE,1669,All
2024,9,JALGAON,PUNE,877,794,JALGAON-PUNE,1671,All
2024,10,JALGAON,PUNE,768,1038,JALGAON-PUNE,1806,All
2024,11,JALGAON,PUNE,1592,1343,JALGAON-PUNE,2935,All
2024,12,JALGAON,PUNE,1826,1700,JALGAON-PUNE,3526,All
2025,1,JALGAON,PUNE,1485,1281,JALGAON-PUNE,2766,All
2025,2,JALGAON,PUNE,733,674,JALGAON-PUNE,1407,All
2025,3,JALGAON,PUNE,812,844,JALGAON-PUNE,1656,All
2025,3,JAMMU,HINDON AIRPORT,550,975,HINDON AIRPORT-JAMMU,1525,All
2024,4,JAMMU,KOLKATA,502,421,JAMMU-KOLKATA,923,All
2024,6,JAMMU,KOLKATA,727,790,JAMMU-KOLKATA,1517,All
2024,7,JAMMU,KOLKATA,573,880,JAMMU-KOLKATA,1453,All
2024,8,JAMMU,KOLKATA,617,967,JAMMU-KOLKATA,1584,All
2024,9,JAMMU,KOLKATA,1104,1242,JAMMU-KOLKATA,2346,All
2024,10,JAMMU,KOLKATA,1651,1465,JAMMU-KOLKATA,3116,All
2025,3,JAMMU,KOLKATA,216,214,JAMMU-KOLKATA,430,All
2024,1,JAMMU,LEH,3129,3727,JAMMU-LEH,6856,All
2024,2,JAMMU,LEH,3958,3312,JAMMU-LEH,7270,All
2024,3,JAMMU,LEH,4387,3398,JAMMU-LEH,7785,All
2024,4,JAMMU,LEH,1402,1600,JAMMU-LEH,3002,All
2024,6,JAMMU,LEH,1730,1776,JAMMU-LEH,3506,All
2024,7,JAMMU,LEH,1554,1638,JAMMU-LEH,3192,All
2024,8,JAMMU,LEH,1626,1874,JAMMU-LEH,3500,All
2024,9,JAMMU,LEH,1716,2072,JAMMU-LEH,3788,All
2024,10,JAMMU,LEH,1301,2205,JAMMU-LEH,3506,All
2024,11,JAMMU,LEH,3156,4466,JAMMU-LEH,7622,All
2024,12,JAMMU,LEH,3304,4919,JAMMU-LEH,8223,All
2025,1,JAMMU,LEH,3645,4404,JAMMU-LEH,8049,All
2025,2,JAMMU,LEH,3308,2943,JAMMU-LEH,6251,All
2025,3,JAMMU,LEH,4390,3858,JAMMU-LEH,8248,All
2024,1,JAMMU,MUMBAI,3203,4509,JAMMU-MUMBAI,7712,All
2024,2,JAMMU,MUMBAI,3893,4390,JAMMU-MUMBAI,8283,All
2024,3,JAMMU,MUMBAI,3816,4307,JAMMU-MUMBAI,8123,All
2024,4,JAMMU,MUMBAI,1641,1036,JAMMU-MUMBAI,2677,All
2024,6,JAMMU,MUMBAI,3593,3335,JAMMU-MUMBAI,6928,All
2024,7,JAMMU,MUMBAI,3867,3418,JAMMU-MUMBAI,7285,All
2024,8,JAMMU,MUMBAI,3415,3289,JAMMU-MUMBAI,6704,All
2024,9,JAMMU,MUMBAI,3290,3628,JAMMU-MUMBAI,6918,All
2024,10,JAMMU,MUMBAI,2111,2504,JAMMU-MUMBAI,4615,All
2024,11,JAMMU,MUMBAI,3335,3873,JAMMU-MUMBAI,7208,All
2024,12,JAMMU,MUMBAI,3837,4073,JAMMU-MUMBAI,7910,All
2025,1,JAMMU,MUMBAI,2755,3400,JAMMU-MUMBAI,6155,All
2025,2,JAMMU,MUMBAI,3306,3204,JAMMU-MUMBAI,6510,All
2025,3,JAMMU,MUMBAI,3480,3293,JAMMU-MUMBAI,6773,All
2024,1,JAMMU,SRINAGAR,19079,18960,JAMMU-SRINAGAR,38039,All
2024,2,JAMMU,SRINAGAR,23800,23322,JAMMU-SRINAGAR,47122,All
2024,3,JAMMU,SRINAGAR,27529,26405,JAMMU-SRINAGAR,53934,All
2024,4,JAMMU,SRINAGAR,25724,26622,JAMMU-SRINAGAR,52346,All
2024,6,JAMMU,SRINAGAR,27759,26374,JAMMU-SRINAGAR,54133,All
2024,7,JAMMU,SRINAGAR,24740,23912,JAMMU-SRINAGAR,48652,All
2024,8,JAMMU,SRINAGAR,20727,19588,JAMMU-SRINAGAR,40315,All
2024,9,JAMMU,SRINAGAR,18511,15137,JAMMU-SRINAGAR,33648,All
2024,10,JAMMU,SRINAGAR,17222,18608,JAMMU-SRINAGAR,35830,All
2024,11,JAMMU,SRINAGAR,19923,18876,JAMMU-SRINAGAR,38799,All
2024,12,JAMMU,SRINAGAR,21529,22079,JAMMU-SRINAGAR,43608,All
2025,1,JAMMU,SRINAGAR,23521,19385,JAMMU-SRINAGAR,42906,All
2025,2,JAMMU,SRINAGAR,20780,17587,JAMMU-SRINAGAR,38367,All
2025,3,JAMMU,SRINAGAR,19512,18125,JAMMU-SRINAGAR,37637,All
2024,1,JAMNAGAR,MUMBAI,4684,5269,JAMNAGAR-MUMBAI,9953,All
2024,2,JAMNAGAR,MUMBAI,4692,5035,JAMNAGAR-MUMBAI,9727,All
2024,3,JAMNAGAR,MUMBAI,4471,4752,JAMNAGAR-MUMBAI,9223,All
2024,4,JAMNAGAR,MUMBAI,4042,4446,JAMNAGAR-MUMBAI,8488,All
2024,6,JAMNAGAR,MUMBAI,3821,4359,JAMNAGAR-MUMBAI,8180,All
2024,7,JAMNAGAR,MUMBAI,3766,4323,JAMNAGAR-MUMBAI,8089,All
2024,8,JAMNAGAR,MUMBAI,4192,4077,JAMNAGAR-MUMBAI,8269,All
2024,9,JAMNAGAR,MUMBAI,3687,4177,JAMNAGAR-MUMBAI,7864,All
2024,10,JAMNAGAR,MUMBAI,4303,4954,JAMNAGAR-MUMBAI,9257,All
2024,11,JAMNAGAR,MUMBAI,4447,4619,JAMNAGAR-MUMBAI,9066,All
2024,12,JAMNAGAR,MUMBAI,4518,4967,JAMNAGAR-MUMBAI,9485,All
2025,1,JAMNAGAR,MUMBAI,5060,5258,JAMNAGAR-MUMBAI,10318,All
2025,2,JAMNAGAR,MUMBAI,4906,4989,JAMNAGAR-MUMBAI,9895,All
2025,3,JAMNAGAR,MUMBAI,4997,5101,JAMNAGAR-MUMBAI,10098,All
2024,1,JAMSHEDPUR,KOLKATA,196,180,JAMSHEDPUR-KOLKATA,376,All
2024,2,JAMSHEDPUR,KOLKATA,191,149,JAMSHEDPUR-KOLKATA,340,All
2024,3,JAMSHEDPUR,KOLKATA,238,211,JAMSHEDPUR-KOLKATA,449,All
2024,4,JAMSHEDPUR,KOLKATA,165,129,JAMSHEDPUR-KOLKATA,294,All
2024,6,JAMSHEDPUR,KOLKATA,177,100,JAMSHEDPUR-KOLKATA,277,All
2024,7,JAMSHEDPUR,KOLKATA,189,142,JAMSHEDPUR-KOLKATA,331,All
2024,8,JAMSHEDPUR,KOLKATA,222,170,JAMSHEDPUR-KOLKATA,392,All
2024,9,JAMSHEDPUR,KOLKATA,199,132,JAMSHEDPUR-KOLKATA,331,All
2024,10,JAMSHEDPUR,KOLKATA,194,145,JAMSHEDPUR-KOLKATA,339,All
2024,11,JAMSHEDPUR,KOLKATA,245,154,JAMSHEDPUR-KOLKATA,399,All
2024,12,JAMSHEDPUR,KOLKATA,264,209,JAMSHEDPUR-KOLKATA,473,All
2025,1,JAMSHEDPUR,KOLKATA,201,141,JAMSHEDPUR-KOLKATA,342,All
2025,2,JAMSHEDPUR,KOLKATA,226,155,JAMSHEDPUR-KOLKATA,381,All
2025,3,JAMSHEDPUR,KOLKATA,243,171,JAMSHEDPUR-KOLKATA,414,All
2024,1,JEYPORE,VISAKHAPATNAM,219,194,JEYPORE-VISAKHAPATNAM,413,All
2024,2,JEYPORE,VISAKHAPATNAM,206,144,JEYPORE-VISAKHAPATNAM,350,All
2024,3,JEYPORE,VISAKHAPATNAM,212,151,JEYPORE-VISAKHAPATNAM,363,All
2024,4,JEYPORE,VISAKHAPATNAM,160,138,JEYPORE-VISAKHAPATNAM,298,All
2024,6,JEYPORE,VISAKHAPATNAM,96,82,JEYPORE-VISAKHAPATNAM,178,All
2024,7,JEYPORE,VISAKHAPATNAM,39,34,JEYPORE-VISAKHAPATNAM,73,All
2024,8,JEYPORE,VISAKHAPATNAM,110,73,JEYPORE-VISAKHAPATNAM,183,All
2024,9,JEYPORE,VISAKHAPATNAM,145,95,JEYPORE-VISAKHAPATNAM,240,All
2024,10,JEYPORE,VISAKHAPATNAM,58,76,JEYPORE-VISAKHAPATNAM,134,All
2024,11,JEYPORE,VISAKHAPATNAM,185,143,JEYPORE-VISAKHAPATNAM,328,All
2024,12,JEYPORE,VISAKHAPATNAM,141,131,JEYPORE-VISAKHAPATNAM,272,All
2025,1,JEYPORE,VISAKHAPATNAM,199,138,JEYPORE-VISAKHAPATNAM,337,All
2025,2,JEYPORE,VISAKHAPATNAM,152,149,JEYPORE-VISAKHAPATNAM,301,All
2025,3,JEYPORE,VISAKHAPATNAM,179,145,JEYPORE-VISAKHAPATNAM,324,All
2024,1,JHARSUGUDA,KOLKATA,2228,2031,JHARSUGUDA-KOLKATA,4259,All
2024,2,JHARSUGUDA,KOLKATA,1925,1913,JHARSUGUDA-KOLKATA,3838,All
2024,3,JHARSUGUDA,KOLKATA,1958,1854,JHARSUGUDA-KOLKATA,3812,All
2024,4,JHARSUGUDA,KOLKATA,2191,2156,JHARSUGUDA-KOLKATA,4347,All
2024,6,JHARSUGUDA,KOLKATA,1628,1867,JHARSUGUDA-KOLKATA,3495,All
2024,7,JHARSUGUDA,KOLKATA,1774,1932,JHARSUGUDA-KOLKATA,3706,All
2024,8,JHARSUGUDA,KOLKATA,1804,1893,JHARSUGUDA-KOLKATA,3697,All
2024,9,JHARSUGUDA,KOLKATA,1792,1916,JHARSUGUDA-KOLKATA,3708,All
2024,10,JHARSUGUDA,KOLKATA,1908,1872,JHARSUGUDA-KOLKATA,3780,All
2024,11,JHARSUGUDA,KOLKATA,2056,2037,JHARSUGUDA-KOLKATA,4093,All
2024,12,JHARSUGUDA,KOLKATA,2036,2113,JHARSUGUDA-KOLKATA,4149,All
2025,1,JHARSUGUDA,KOLKATA,1979,2083,JHARSUGUDA-KOLKATA,4062,All
2025,2,JHARSUGUDA,KOLKATA,1958,1989,JHARSUGUDA-KOLKATA,3947,All
2025,3,JHARSUGUDA,KOLKATA,1928,1922,JHARSUGUDA-KOLKATA,3850,All
2025,2,JHARSUGUDA,LUCKNOW,1010,979,JHARSUGUDA-LUCKNOW,1989,All
2025,3,JHARSUGUDA,LUCKNOW,676,594,JHARSUGUDA-LUCKNOW,1270,All
2025,1,JHARSUGUDA,MUMBAI,0,57,JHARSUGUDA-MUMBAI,57,All
2025,3,JHARSUGUDA,MUMBAI,3306,3422,JHARSUGUDA-MUMBAI,6728,All
2025,2,JHARSUGUDA,RAIPUR,421,365,JHARSUGUDA-RAIPUR,786,All
2025,3,JHARSUGUDA,RAIPUR,391,423,JHARSUGUDA-RAIPUR,814,All
2025,1,JODHPUR,KOLKATA,367,500,JODHPUR-KOLKATA,867,All
2024,1,JODHPUR,MUMBAI,13780,14890,JODHPUR-MUMBAI,28670,All
2024,2,JODHPUR,MUMBAI,12962,13769,JODHPUR-MUMBAI,26731,All
2024,3,JODHPUR,MUMBAI,12875,13588,JODHPUR-MUMBAI,26463,All
2024,4,JODHPUR,MUMBAI,10215,10551,JODHPUR-MUMBAI,20766,All
2024,6,JODHPUR,MUMBAI,10542,10442,JODHPUR-MUMBAI,20984,All
2024,7,JODHPUR,MUMBAI,10951,11223,JODHPUR-MUMBAI,22174,All
2024,8,JODHPUR,MUMBAI,11128,10963,JODHPUR-MUMBAI,22091,All
2024,9,JODHPUR,MUMBAI,10954,10990,JODHPUR-MUMBAI,21944,All
2024,10,JODHPUR,MUMBAI,9419,12054,JODHPUR-MUMBAI,21473,All
2024,11,JODHPUR,MUMBAI,14535,14432,JODHPUR-MUMBAI,28967,All
2024,12,JODHPUR,MUMBAI,15143,15595,JODHPUR-MUMBAI,30738,All
2025,1,JODHPUR,MUMBAI,13953,15003,JODHPUR-MUMBAI,28956,All
2025,2,JODHPUR,MUMBAI,12821,13796,JODHPUR-MUMBAI,26617,All
2025,3,JODHPUR,MUMBAI,12555,13609,JODHPUR-MUMBAI,26164,All
2024,1,JODHPUR,PUNE,4485,4436,JODHPUR-PUNE,8921,All
2024,2,JODHPUR,PUNE,4132,4116,JODHPUR-PUNE,8248,All
2024,3,JODHPUR,PUNE,3757,3977,JODHPUR-PUNE,7734,All
2024,4,JODHPUR,PUNE,3544,4244,JODHPUR-PUNE,7788,All
2024,6,JODHPUR,PUNE,3686,3824,JODHPUR-PUNE,7510,All
2024,7,JODHPUR,PUNE,3811,4167,JODHPUR-PUNE,7978,All
2024,8,JODHPUR,PUNE,3685,4042,JODHPUR-PUNE,7727,All
2024,9,JODHPUR,PUNE,2443,2769,JODHPUR-PUNE,5212,All
2024,10,JODHPUR,PUNE,3507,4100,JODHPUR-PUNE,7607,All
2024,11,JODHPUR,PUNE,4247,4223,JODHPUR-PUNE,8470,All
2024,12,JODHPUR,PUNE,4429,4561,JODHPUR-PUNE,8990,All
2025,1,JODHPUR,PUNE,4474,4753,JODHPUR-PUNE,9227,All
2025,2,JODHPUR,PUNE,4060,4145,JODHPUR-PUNE,8205,All
2025,3,JODHPUR,PUNE,4021,4141,JODHPUR-PUNE,8162,All
2024,1,JORHAT,KOLKATA,4986,5046,JORHAT-KOLKATA,10032,All
2024,2,JORHAT,KOLKATA,4267,4637,JORHAT-KOLKATA,8904,All
2024,3,JORHAT,KOLKATA,4942,5161,JORHAT-KOLKATA,10103,All
2024,4,JORHAT,KOLKATA,5221,5425,JORHAT-KOLKATA,10646,All
2024,6,JORHAT,KOLKATA,5109,5126,JORHAT-KOLKATA,10235,All
2024,7,JORHAT,KOLKATA,5300,5259,JORHAT-KOLKATA,10559,All
2024,8,JORHAT,KOLKATA,4891,4978,JORHAT-KOLKATA,9869,All
2024,9,JORHAT,KOLKATA,4380,4809,JORHAT-KOLKATA,9189,All
2024,10,JORHAT,KOLKATA,4995,5114,JORHAT-KOLKATA,10109,All
2024,11,JORHAT,KOLKATA,5101,5140,JORHAT-KOLKATA,10241,All
2024,12,JORHAT,KOLKATA,5287,5386,JORHAT-KOLKATA,10673,All
2025,1,JORHAT,KOLKATA,6415,6510,JORHAT-KOLKATA,12925,All
2025,2,JORHAT,KOLKATA,5212,5627,JORHAT-KOLKATA,10839,All
2025,3,JORHAT,KOLKATA,6073,6621,JORHAT-KOLKATA,12694,All
2024,12,JORHAT,PASIGHAT,16,3,JORHAT-PASIGHAT,19,All
2025,1,JORHAT,PASIGHAT,2,12,JORHAT-PASIGHAT,14,All
2024,10,JORHAT,TEZU,1,6,JORHAT-TEZU,7,All
2024,11,JORHAT,TEZU,45,28,JORHAT-TEZU,73,All
2024,12,JORHAT,TEZU,459,280,JORHAT-TEZU,739,All
2025,1,JORHAT,TEZU,278,204,JORHAT-TEZU,482,All
2024,1,KALABURAGI,TIRUPATI,713,609,KALABURAGI-TIRUPATI,1322,All
2024,2,KALABURAGI,TIRUPATI,701,432,KALABURAGI-TIRUPATI,1133,All
2024,3,KALABURAGI,TIRUPATI,870,672,KALABURAGI-TIRUPATI,1542,All
2024,4,KALABURAGI,TIRUPATI,421,360,KALABURAGI-TIRUPATI,781,All
2024,6,KALABURAGI,TIRUPATI,423,282,KALABURAGI-TIRUPATI,705,All
2024,1,KANDLA,MUMBAI,2448,2370,KANDLA-MUMBAI,4818,All
2024,2,KANDLA,MUMBAI,2241,2178,KANDLA-MUMBAI,4419,All
2024,3,KANDLA,MUMBAI,1884,2095,KANDLA-MUMBAI,3979,All
2024,4,KANDLA,MUMBAI,1630,1837,KANDLA-MUMBAI,3467,All
2024,6,KANDLA,MUMBAI,559,688,KANDLA-MUMBAI,1247,All
2024,7,KANDLA,MUMBAI,1145,1437,KANDLA-MUMBAI,2582,All
2024,8,KANDLA,MUMBAI,905,1017,KANDLA-MUMBAI,1922,All
2024,9,KANDLA,MUMBAI,828,1132,KANDLA-MUMBAI,1960,All
2024,10,KANDLA,MUMBAI,1299,1729,KANDLA-MUMBAI,3028,All
2024,11,KANDLA,MUMBAI,2159,2367,KANDLA-MUMBAI,4526,All
2024,12,KANDLA,MUMBAI,2274,2444,KANDLA-MUMBAI,4718,All
2025,1,KANDLA,MUMBAI,2352,2455,KANDLA-MUMBAI,4807,All
2025,2,KANDLA,MUMBAI,2099,2082,KANDLA-MUMBAI,4181,All
2025,3,KANDLA,MUMBAI,1783,1884,KANDLA-MUMBAI,3667,All
2024,1,KANNUR,KOCHI,1991,1904,KANNUR-KOCHI,3895,All
2024,2,KANNUR,KOCHI,1682,1334,KANNUR-KOCHI,3016,All
2024,3,KANNUR,KOCHI,1312,1287,KANNUR-KOCHI,2599,All
2024,4,KANNUR,KOCHI,1493,1682,KANNUR-KOCHI,3175,All
2024,6,KANNUR,KOCHI,1005,1640,KANNUR-KOCHI,2645,All
2024,7,KANNUR,KOCHI,1280,1728,KANNUR-KOCHI,3008,All
2024,8,KANNUR,KOCHI,1230,1778,KANNUR-KOCHI,3008,All
2024,9,KANNUR,KOCHI,1133,1399,KANNUR-KOCHI,2532,All
2024,10,KANNUR,KOCHI,941,1167,KANNUR-KOCHI,2108,All
2024,11,KANNUR,KOCHI,1102,1141,KANNUR-KOCHI,2243,All
2024,12,KANNUR,KOCHI,1443,1422,KANNUR-KOCHI,2865,All
2025,1,KANNUR,KOCHI,1407,1592,KANNUR-KOCHI,2999,All
2025,2,KANNUR,KOCHI,1242,1264,KANNUR-KOCHI,2506,All
2025,3,KANNUR,KOCHI,1081,1442,KANNUR-KOCHI,2523,All
2024,2,KANNUR,MANGALORE,119,0,KANNUR-MANGALORE,119,All
2025,3,KANNUR,MANGALORE,167,0,KANNUR-MANGALORE,167,All
2024,1,KANNUR,MUMBAI,4846,4640,KANNUR-MUMBAI,9486,All
2024,2,KANNUR,MUMBAI,3243,3086,KANNUR-MUMBAI,6329,All
2024,3,KANNUR,MUMBAI,3140,3059,KANNUR-MUMBAI,6199,All
2024,4,KANNUR,MUMBAI,2829,2897,KANNUR-MUMBAI,5726,All
2024,6,KANNUR,MUMBAI,2642,2821,KANNUR-MUMBAI,5463,All
2024,7,KANNUR,MUMBAI,2545,2933,KANNUR-MUMBAI,5478,All
2024,8,KANNUR,MUMBAI,2950,2801,KANNUR-MUMBAI,5751,All
2024,9,KANNUR,MUMBAI,3360,3422,KANNUR-MUMBAI,6782,All
2024,10,KANNUR,MUMBAI,2416,2734,KANNUR-MUMBAI,5150,All
2024,11,KANNUR,MUMBAI,2828,2747,KANNUR-MUMBAI,5575,All
2024,12,KANNUR,MUMBAI,2856,3232,KANNUR-MUMBAI,6088,All
2025,1,KANNUR,MUMBAI,2991,3105,KANNUR-MUMBAI,6096,All
2025,2,KANNUR,MUMBAI,2552,2499,KANNUR-MUMBAI,5051,All
2025,3,KANNUR,MUMBAI,2521,2570,KANNUR-MUMBAI,5091,All
2024,2,KANNUR,PUNE,0,3,KANNUR-PUNE,3,All
2024,1,KANNUR,TRIVANDRUM,2762,1992,KANNUR-TRIVANDRUM,4754,All
2024,2,KANNUR,TRIVANDRUM,2304,1497,KANNUR-TRIVANDRUM,3801,All
2024,3,KANNUR,TRIVANDRUM,2354,1297,KANNUR-TRIVANDRUM,3651,All
2024,4,KANNUR,TRIVANDRUM,1303,1268,KANNUR-TRIVANDRUM,2571,All
2024,6,KANNUR,TRIVANDRUM,1285,1034,KANNUR-TRIVANDRUM,2319,All
2024,7,KANNUR,TRIVANDRUM,770,883,KANNUR-TRIVANDRUM,1653,All
2024,8,KANNUR,TRIVANDRUM,1026,1173,KANNUR-TRIVANDRUM,2199,All
2024,9,KANNUR,TRIVANDRUM,1472,1332,KANNUR-TRIVANDRUM,2804,All
2024,10,KANNUR,TRIVANDRUM,785,721,KANNUR-TRIVANDRUM,1506,All
2024,11,KANNUR,TRIVANDRUM,734,677,KANNUR-TRIVANDRUM,1411,All
2024,12,KANNUR,TRIVANDRUM,1472,1206,KANNUR-TRIVANDRUM,2678,All
2025,1,KANNUR,TRIVANDRUM,874,1037,KANNUR-TRIVANDRUM,1911,All
2025,2,KANNUR,TRIVANDRUM,914,659,KANNUR-TRIVANDRUM,1573,All
2025,3,KANNUR,TRIVANDRUM,681,544,KANNUR-TRIVANDRUM,1225,All
2024,1,KANPUR,MUMBAI,4600,4642,KANPUR-MUMBAI,9242,All
2024,2,KANPUR,MUMBAI,4531,4676,KANPUR-MUMBAI,9207,All
2024,3,KANPUR,MUMBAI,4495,4949,KANPUR-MUMBAI,9444,All
2024,4,KANPUR,MUMBAI,4530,4974,KANPUR-MUMBAI,9504,All
2024,6,KANPUR,MUMBAI,5015,4689,KANPUR-MUMBAI,9704,All
2024,7,KANPUR,MUMBAI,4842,4728,KANPUR-MUMBAI,9570,All
2024,8,KANPUR,MUMBAI,4612,4306,KANPUR-MUMBAI,8918,All
2024,9,KANPUR,MUMBAI,4296,4483,KANPUR-MUMBAI,8779,All
2024,10,KANPUR,MUMBAI,3751,5315,KANPUR-MUMBAI,9066,All
2024,11,KANPUR,MUMBAI,5170,5310,KANPUR-MUMBAI,10480,All
2024,12,KANPUR,MUMBAI,5588,4981,KANPUR-MUMBAI,10569,All
2025,1,KANPUR,MUMBAI,5489,5249,KANPUR-MUMBAI,10738,All
2025,2,KANPUR,MUMBAI,4898,5004,KANPUR-MUMBAI,9902,All
2025,3,KANPUR,MUMBAI,5364,5484,KANPUR-MUMBAI,10848,All
2024,1,KESHOD,MUMBAI,414,493,KESHOD-MUMBAI,907,All
2024,2,KESHOD,MUMBAI,600,639,KESHOD-MUMBAI,1239,All
2024,3,KESHOD,MUMBAI,646,695,KESHOD-MUMBAI,1341,All
2024,4,KESHOD,MUMBAI,573,591,KESHOD-MUMBAI,1164,All
2024,6,KESHOD,MUMBAI,571,572,KESHOD-MUMBAI,1143,All
2024,7,KESHOD,MUMBAI,192,206,KESHOD-MUMBAI,398,All
2024,8,KESHOD,MUMBAI,401,454,KESHOD-MUMBAI,855,All
2024,9,KESHOD,MUMBAI,547,603,KESHOD-MUMBAI,1150,All
2024,10,KESHOD,MUMBAI,411,536,KESHOD-MUMBAI,947,All
2024,11,KESHOD,MUMBAI,876,1002,KESHOD-MUMBAI,1878,All
2024,12,KESHOD,MUMBAI,705,825,KESHOD-MUMBAI,1530,All
2025,1,KESHOD,MUMBAI,478,544,KESHOD-MUMBAI,1022,All
2025,2,KESHOD,MUMBAI,671,761,KESHOD-MUMBAI,1432,All
2025,3,KESHOD,MUMBAI,308,328,KESHOD-MUMBAI,636,All
2024,11,KHAJURAHO,REWA,9,15,KHAJURAHO-REWA,24,All
2024,12,KHAJURAHO,REWA,22,24,KHAJURAHO-REWA,46,All
2025,1,KHAJURAHO,REWA,8,5,KHAJURAHO-REWA,13,All
2025,2,KHAJURAHO,REWA,5,12,KHAJURAHO-REWA,17,All
2025,3,KHAJURAHO,REWA,12,4,KHAJURAHO-REWA,16,All
2024,1,KHAJURAHO,VARANASI,697,583,KHAJURAHO-VARANASI,1280,All
2024,10,KHAJURAHO,VARANASI,287,89,KHAJURAHO-VARANASI,376,All
2024,11,KHAJURAHO,VARANASI,2440,1524,KHAJURAHO-VARANASI,3964,All
2024,12,KHAJURAHO,VARANASI,1797,1058,KHAJURAHO-VARANASI,2855,All
2025,1,KHAJURAHO,VARANASI,1633,1296,KHAJURAHO-VARANASI,2929,All
2025,2,KHAJURAHO,VARANASI,2495,1794,KHAJURAHO-VARANASI,4289,All
2025,3,KHAJURAHO,VARANASI,2811,1489,KHAJURAHO-VARANASI,4300,All
2024,4,KOCHI,KOLKATA,2945,2376,KOCHI-KOLKATA,5321,All
2024,6,KOCHI,KOLKATA,3540,3677,KOCHI-KOLKATA,7217,All
2024,7,KOCHI,KOLKATA,679,822,KOCHI-KOLKATA,1501,All
2024,8,KOCHI,KOLKATA,2645,3232,KOCHI-KOLKATA,5877,All
2024,9,KOCHI,KOLKATA,2975,3075,KOCHI-KOLKATA,6050,All
2024,10,KOCHI,KOLKATA,6949,6580,KOCHI-KOLKATA,13529,All
2024,11,KOCHI,KOLKATA,4050,4605,KOCHI-KOLKATA,8655,All
2024,12,KOCHI,KOLKATA,8780,9680,KOCHI-KOLKATA,18460,All
2025,1,KOCHI,KOLKATA,8580,8279,KOCHI-KOLKATA,16859,All
2025,2,KOCHI,KOLKATA,3746,3649,KOCHI-KOLKATA,7395,All
2025,3,KOCHI,KOLKATA,3683,3524,KOCHI-KOLKATA,7207,All
2024,6,KOCHI,KOZHIKODE,1340,1077,KOCHI-KOZHIKODE,2417,All
2024,7,KOCHI,KOZHIKODE,1345,1343,KOCHI-KOZHIKODE,2688,All
2024,8,KOCHI,KOZHIKODE,1232,1403,KOCHI-KOZHIKODE,2635,All
2024,9,KOCHI,KOZHIKODE,1031,1146,KOCHI-KOZHIKODE,2177,All
2024,10,KOCHI,KOZHIKODE,660,988,KOCHI-KOZHIKODE,1648,All
2024,11,KOCHI,KOZHIKODE,950,1053,KOCHI-KOZHIKODE,2003,All
2024,12,KOCHI,KOZHIKODE,910,731,KOCHI-KOZHIKODE,1641,All
2025,1,KOCHI,KOZHIKODE,1067,1213,KOCHI-KOZHIKODE,2280,All
2025,2,KOCHI,KOZHIKODE,896,978,KOCHI-KOZHIKODE,1874,All
2025,3,KOCHI,KOZHIKODE,988,1017,KOCHI-KOZHIKODE,2005,All
2024,3,KOCHI,LUCKNOW,34,1,KOCHI-LUCKNOW,35,All
2024,4,KOCHI,LUCKNOW,396,286,KOCHI-LUCKNOW,682,All
2024,6,KOCHI,LUCKNOW,654,348,KOCHI-LUCKNOW,1002,All
2024,7,KOCHI,LUCKNOW,343,143,KOCHI-LUCKNOW,486,All
2024,8,KOCHI,LUCKNOW,247,180,KOCHI-LUCKNOW,427,All
2024,9,KOCHI,LUCKNOW,456,362,KOCHI-LUCKNOW,818,All
2024,10,KOCHI,LUCKNOW,391,341,KOCHI-LUCKNOW,732,All
2024,11,KOCHI,LUCKNOW,110,183,KOCHI-LUCKNOW,293,All
2024,12,KOCHI,LUCKNOW,230,402,KOCHI-LUCKNOW,632,All
2024,11,KOCHI,MANGALORE,3,8,KOCHI-MANGALORE,11,All
2024,1,KOCHI,MUMBAI,59340,55268,KOCHI-MUMBAI,114608,All
2024,2,KOCHI,MUMBAI,48188,47321,KOCHI-MUMBAI,95509,All
2024,3,KOCHI,MUMBAI,44795,47202,KOCHI-MUMBAI,91997,All
2024,4,KOCHI,MUMBAI,48058,47974,KOCHI-MUMBAI,96032,All
2024,6,KOCHI,MUMBAI,45873,47717,KOCHI-MUMBAI,93590,All
2024,7,KOCHI,MUMBAI,47903,54948,KOCHI-MUMBAI,102851,All
2024,8,KOCHI,MUMBAI,54558,50454,KOCHI-MUMBAI,105012,All
2024,9,KOCHI,MUMBAI,53260,47267,KOCHI-MUMBAI,100527,All
2024,10,KOCHI,MUMBAI,42724,44064,KOCHI-MUMBAI,86788,All
2024,11,KOCHI,MUMBAI,50654,48790,KOCHI-MUMBAI,99444,All
2024,12,KOCHI,MUMBAI,48982,54753,KOCHI-MUMBAI,103735,All
2025,1,KOCHI,MUMBAI,52503,51601,KOCHI-MUMBAI,104104,All
2025,2,KOCHI,MUMBAI,47305,46714,KOCHI-MUMBAI,94019,All
2025,3,KOCHI,MUMBAI,42583,42176,KOCHI-MUMBAI,84759,All
2024,4,KOCHI,NAGPUR,7,23,KOCHI-NAGPUR,30,All
2025,2,KOCHI,NAGPUR,11,0,KOCHI-NAGPUR,11,All
2024,1,KOCHI,PATNA,231,212,KOCHI-PATNA,443,All
2024,2,KOCHI,PATNA,190,144,KOCHI-PATNA,334,All
2024,3,KOCHI,PATNA,94,115,KOCHI-PATNA,209,All
2024,10,KOCHI,PATNA,26,66,KOCHI-PATNA,92,All
2024,11,KOCHI,PATNA,311,220,KOCHI-PATNA,531,All
2024,12,KOCHI,PATNA,280,308,KOCHI-PATNA,588,All
2025,3,KOCHI,PATNA,261,239,KOCHI-PATNA,500,All
2024,1,KOCHI,PUNE,4901,4631,KOCHI-PUNE,9532,All
2024,2,KOCHI,PUNE,4182,4079,KOCHI-PUNE,8261,All
2024,3,KOCHI,PUNE,4008,4308,KOCHI-PUNE,8316,All
2024,4,KOCHI,PUNE,4548,4418,KOCHI-PUNE,8966,All
2024,6,KOCHI,PUNE,4206,3804,KOCHI-PUNE,8010,All
2024,7,KOCHI,PUNE,4744,4844,KOCHI-PUNE,9588,All
2024,8,KOCHI,PUNE,4224,4076,KOCHI-PUNE,8300,All
2024,9,KOCHI,PUNE,3683,3774,KOCHI-PUNE,7457,All
2024,10,KOCHI,PUNE,3931,4953,KOCHI-PUNE,8884,All
2024,11,KOCHI,PUNE,9772,9361,KOCHI-PUNE,19133,All
2024,12,KOCHI,PUNE,9873,10848,KOCHI-PUNE,20721,All
2025,1,KOCHI,PUNE,10401,10452,KOCHI-PUNE,20853,All
2025,2,KOCHI,PUNE,9070,9395,KOCHI-PUNE,18465,All
2025,3,KOCHI,PUNE,8808,8963,KOCHI-PUNE,17771,All
2024,1,KOCHI,RAIPUR,602,430,KOCHI-RAIPUR,1032,All
2024,2,KOCHI,RAIPUR,380,328,KOCHI-RAIPUR,708,All
2024,3,KOCHI,RAIPUR,350,352,KOCHI-RAIPUR,702,All
2024,4,KOCHI,RAIPUR,665,576,KOCHI-RAIPUR,1241,All
2024,6,KOCHI,RAIPUR,772,548,KOCHI-RAIPUR,1320,All
2024,7,KOCHI,RAIPUR,500,497,KOCHI-RAIPUR,997,All
2024,8,KOCHI,RAIPUR,473,371,KOCHI-RAIPUR,844,All
2024,9,KOCHI,RAIPUR,377,394,KOCHI-RAIPUR,771,All
2024,10,KOCHI,RAIPUR,618,536,KOCHI-RAIPUR,1154,All
2024,11,KOCHI,RAIPUR,304,555,KOCHI-RAIPUR,859,All
2024,12,KOCHI,RAIPUR,281,393,KOCHI-RAIPUR,674,All
2025,3,KOCHI,RAIPUR,129,299,KOCHI-RAIPUR,428,All
2024,12,KOCHI,RANCHI,58,45,KOCHI-RANCHI,103,All
2024,1,KOCHI,SALEM,183,296,KOCHI-SALEM,479,All
2024,2,KOCHI,SALEM,185,296,KOCHI-SALEM,481,All
2024,3,KOCHI,SALEM,195,275,KOCHI-SALEM,470,All
2024,4,KOCHI,SALEM,802,790,KOCHI-SALEM,1592,All
2024,6,KOCHI,SALEM,869,764,KOCHI-SALEM,1633,All
2024,7,KOCHI,SALEM,694,603,KOCHI-SALEM,1297,All
2024,8,KOCHI,SALEM,658,573,KOCHI-SALEM,1231,All
2024,9,KOCHI,SALEM,711,678,KOCHI-SALEM,1389,All
2024,10,KOCHI,SALEM,1014,899,KOCHI-SALEM,1913,All
2024,11,KOCHI,SALEM,833,747,KOCHI-SALEM,1580,All
2024,12,KOCHI,SALEM,766,728,KOCHI-SALEM,1494,All
2025,1,KOCHI,SALEM,916,826,KOCHI-SALEM,1742,All
2025,2,KOCHI,SALEM,774,730,KOCHI-SALEM,1504,All
2025,3,KOCHI,SALEM,886,854,KOCHI-SALEM,1740,All
2024,11,KOCHI,Shivamogga Airport,15,5,KOCHI-Shivamogga Airport,20,All
2024,12,KOCHI,Shivamogga Airport,19,12,KOCHI-Shivamogga Airport,31,All
2025,1,KOCHI,Shivamogga Airport,27,11,KOCHI-Shivamogga Airport,38,All
2024,3,KOCHI,TIRUCHIRAPALLY,3,0,KOCHI-TIRUCHIRAPALLY,3,All
2024,1,KOCHI,TRIVANDRUM,1718,1640,KOCHI-TRIVANDRUM,3358,All
2024,2,KOCHI,TRIVANDRUM,1582,1174,KOCHI-TRIVANDRUM,2756,All
2024,3,KOCHI,TRIVANDRUM,1908,1164,KOCHI-TRIVANDRUM,3072,All
2024,4,KOCHI,TRIVANDRUM,1988,1560,KOCHI-TRIVANDRUM,3548,All
2024,6,KOCHI,TRIVANDRUM,2240,1881,KOCHI-TRIVANDRUM,4121,All
2024,7,KOCHI,TRIVANDRUM,1963,1853,KOCHI-TRIVANDRUM,3816,All
2024,8,KOCHI,TRIVANDRUM,1603,1156,KOCHI-TRIVANDRUM,2759,All
2024,9,KOCHI,TRIVANDRUM,1638,1230,KOCHI-TRIVANDRUM,2868,All
2024,10,KOCHI,TRIVANDRUM,1438,1262,KOCHI-TRIVANDRUM,2700,All
2024,11,KOCHI,TRIVANDRUM,1720,1437,KOCHI-TRIVANDRUM,3157,All
2024,12,KOCHI,TRIVANDRUM,2211,2124,KOCHI-TRIVANDRUM,4335,All
2025,1,KOCHI,TRIVANDRUM,1323,1434,KOCHI-TRIVANDRUM,2757,All
2025,2,KOCHI,TRIVANDRUM,450,684,KOCHI-TRIVANDRUM,1134,All
2025,3,KOCHI,TRIVANDRUM,620,844,KOCHI-TRIVANDRUM,1464,All
2024,1,KOCHI,VARANASI,2,384,KOCHI-VARANASI,386,All
2024,3,KOCHI,VARANASI,3,1,KOCHI-VARANASI,4,All
2024,4,KOCHI,VARANASI,292,224,KOCHI-VARANASI,516,All
2024,6,KOCHI,VARANASI,86,296,KOCHI-VARANASI,382,All
2024,7,KOCHI,VARANASI,75,205,KOCHI-VARANASI,280,All
2024,8,KOCHI,VARANASI,136,302,KOCHI-VARANASI,438,All
2024,9,KOCHI,VARANASI,246,283,KOCHI-VARANASI,529,All
2024,10,KOCHI,VARANASI,430,488,KOCHI-VARANASI,918,All
2024,11,KOCHI,VARANASI,424,643,KOCHI-VARANASI,1067,All
2024,12,KOCHI,VARANASI,717,984,KOCHI-VARANASI,1701,All
2025,3,KOCHI,VARANASI,532,682,KOCHI-VARANASI,1214,All
2024,1,KOLHAPUR,MUMBAI,1762,1728,KOLHAPUR-MUMBAI,3490,All
2024,2,KOLHAPUR,MUMBAI,1590,1655,KOLHAPUR-MUMBAI,3245,All
2024,3,KOLHAPUR,MUMBAI,1669,1670,KOLHAPUR-MUMBAI,3339,All
2024,4,KOLHAPUR,MUMBAI,1644,1674,KOLHAPUR-MUMBAI,3318,All
2024,6,KOLHAPUR,MUMBAI,1500,1607,KOLHAPUR-MUMBAI,3107,All
2024,7,KOLHAPUR,MUMBAI,996,1107,KOLHAPUR-MUMBAI,2103,All
2024,8,KOLHAPUR,MUMBAI,1352,1473,KOLHAPUR-MUMBAI,2825,All
2024,9,KOLHAPUR,MUMBAI,1331,1479,KOLHAPUR-MUMBAI,2810,All
2024,10,KOLHAPUR,MUMBAI,1199,1365,KOLHAPUR-MUMBAI,2564,All
2024,11,KOLHAPUR,MUMBAI,1199,1340,KOLHAPUR-MUMBAI,2539,All
2024,12,KOLHAPUR,MUMBAI,1212,1372,KOLHAPUR-MUMBAI,2584,All
2025,1,KOLHAPUR,MUMBAI,1238,1378,KOLHAPUR-MUMBAI,2616,All
2025,2,KOLHAPUR,MUMBAI,1191,1249,KOLHAPUR-MUMBAI,2440,All
2025,3,KOLHAPUR,MUMBAI,1287,1295,KOLHAPUR-MUMBAI,2582,All
2024,1,KOLHAPUR,TIRUPATI,102,266,KOLHAPUR-TIRUPATI,368,All
2024,2,KOLHAPUR,TIRUPATI,90,352,KOLHAPUR-TIRUPATI,442,All
2024,3,KOLHAPUR,TIRUPATI,224,597,KOLHAPUR-TIRUPATI,821,All
2024,4,KOLHAPUR,TIRUPATI,660,886,KOLHAPUR-TIRUPATI,1546,All
2024,6,KOLHAPUR,TIRUPATI,562,898,KOLHAPUR-TIRUPATI,1460,All
2024,7,KOLHAPUR,TIRUPATI,469,718,KOLHAPUR-TIRUPATI,1187,All
2024,8,KOLHAPUR,TIRUPATI,462,744,KOLHAPUR-TIRUPATI,1206,All
2024,9,KOLHAPUR,TIRUPATI,532,775,KOLHAPUR-TIRUPATI,1307,All
2024,10,KOLHAPUR,TIRUPATI,553,795,KOLHAPUR-TIRUPATI,1348,All
2024,11,KOLHAPUR,TIRUPATI,585,869,KOLHAPUR-TIRUPATI,1454,All
2024,12,KOLHAPUR,TIRUPATI,584,849,KOLHAPUR-TIRUPATI,1433,All
2025,1,KOLHAPUR,TIRUPATI,512,532,KOLHAPUR-TIRUPATI,1044,All
2025,2,KOLHAPUR,TIRUPATI,435,473,KOLHAPUR-TIRUPATI,908,All
2025,3,KOLHAPUR,TIRUPATI,634,1001,KOLHAPUR-TIRUPATI,1635,All
2024,1,KOLKATA,Ayodhya International Airport ,857,733,Ayodhya International Airport -KOLKATA,1590,All
2024,2,KOLKATA,Ayodhya International Airport ,1624,1502,Ayodhya International Airport -KOLKATA,3126,All
2024,3,KOLKATA,Ayodhya International Airport ,1982,1965,Ayodhya International Airport -KOLKATA,3947,All
2024,4,KOLKATA,Ayodhya International Airport ,2113,1843,Ayodhya International Airport -KOLKATA,3956,All
2024,6,KOLKATA,Ayodhya International Airport ,1876,2254,Ayodhya International Airport -KOLKATA,4130,All
2024,7,KOLKATA,Ayodhya International Airport ,485,305,Ayodhya International Airport -KOLKATA,790,All
2025,3,KOLKATA,HINDON AIRPORT,5010,4291,HINDON AIRPORT-KOLKATA,9301,All
2024,1,KOLKATA,LILABARI,724,770,KOLKATA-LILABARI,1494,All
2024,2,KOLKATA,LILABARI,490,625,KOLKATA-LILABARI,1115,All
2024,3,KOLKATA,LILABARI,1066,1099,KOLKATA-LILABARI,2165,All
2024,4,KOLKATA,LILABARI,1102,1059,KOLKATA-LILABARI,2161,All
2024,6,KOLKATA,LILABARI,620,860,KOLKATA-LILABARI,1480,All
2024,7,KOLKATA,LILABARI,908,1098,KOLKATA-LILABARI,2006,All
2024,8,KOLKATA,LILABARI,544,705,KOLKATA-LILABARI,1249,All
2024,9,KOLKATA,LILABARI,560,619,KOLKATA-LILABARI,1179,All
2024,10,KOLKATA,LILABARI,710,721,KOLKATA-LILABARI,1431,All
2024,11,KOLKATA,LILABARI,608,628,KOLKATA-LILABARI,1236,All
2024,12,KOLKATA,LILABARI,728,707,KOLKATA-LILABARI,1435,All
2025,1,KOLKATA,LILABARI,705,766,KOLKATA-LILABARI,1471,All
2025,2,KOLKATA,LILABARI,609,658,KOLKATA-LILABARI,1267,All
2025,3,KOLKATA,LILABARI,683,822,KOLKATA-LILABARI,1505,All
2024,1,KOLKATA,LUCKNOW,11481,12327,KOLKATA-LUCKNOW,23808,All
2024,2,KOLKATA,LUCKNOW,10294,10992,KOLKATA-LUCKNOW,21286,All
2024,3,KOLKATA,LUCKNOW,10927,12611,KOLKATA-LUCKNOW,23538,All
2024,4,KOLKATA,LUCKNOW,9158,9816,KOLKATA-LUCKNOW,18974,All
2024,6,KOLKATA,LUCKNOW,8653,10788,KOLKATA-LUCKNOW,19441,All
2024,7,KOLKATA,LUCKNOW,9749,10048,KOLKATA-LUCKNOW,19797,All
2024,8,KOLKATA,LUCKNOW,9006,9273,KOLKATA-LUCKNOW,18279,All
2024,9,KOLKATA,LUCKNOW,8975,10190,KOLKATA-LUCKNOW,19165,All
2024,10,KOLKATA,LUCKNOW,11064,11538,KOLKATA-LUCKNOW,22602,All
2024,11,KOLKATA,LUCKNOW,11133,11614,KOLKATA-LUCKNOW,22747,All
2024,12,KOLKATA,LUCKNOW,11534,12532,KOLKATA-LUCKNOW,24066,All
2025,1,KOLKATA,LUCKNOW,12680,12557,KOLKATA-LUCKNOW,25237,All
2025,2,KOLKATA,LUCKNOW,13575,13412,KOLKATA-LUCKNOW,26987,All
2025,3,KOLKATA,LUCKNOW,10701,11707,KOLKATA-LUCKNOW,22408,All
2024,1,KOLKATA,MUMBAI,78355,79428,KOLKATA-MUMBAI,157783,All
2024,2,KOLKATA,MUMBAI,73696,76950,KOLKATA-MUMBAI,150646,All
2024,3,KOLKATA,MUMBAI,73853,78438,KOLKATA-MUMBAI,152291,All
2024,4,KOLKATA,MUMBAI,79037,92277,KOLKATA-MUMBAI,171314,All
2024,6,KOLKATA,MUMBAI,81635,80175,KOLKATA-MUMBAI,161810,All
2024,7,KOLKATA,MUMBAI,89171,77665,KOLKATA-MUMBAI,166836,All
2024,8,KOLKATA,MUMBAI,87800,76956,KOLKATA-MUMBAI,164756,All
2024,9,KOLKATA,MUMBAI,85272,84679,KOLKATA-MUMBAI,169951,All
2024,10,KOLKATA,MUMBAI,84155,103743,KOLKATA-MUMBAI,187898,All
2024,11,KOLKATA,MUMBAI,98940,98968,KOLKATA-MUMBAI,197908,All
2024,12,KOLKATA,MUMBAI,98172,101233,KOLKATA-MUMBAI,199405,All
2025,1,KOLKATA,MUMBAI,96998,97527,KOLKATA-MUMBAI,194525,All
2025,2,KOLKATA,MUMBAI,87209,90906,KOLKATA-MUMBAI,178115,All
2025,3,KOLKATA,MUMBAI,92609,101280,KOLKATA-MUMBAI,193889,All
2024,1,KOLKATA,NAGPUR,6231,6125,KOLKATA-NAGPUR,12356,All
2024,2,KOLKATA,NAGPUR,5797,5436,KOLKATA-NAGPUR,11233,All
2024,3,KOLKATA,NAGPUR,6239,5793,KOLKATA-NAGPUR,12032,All
2024,4,KOLKATA,NAGPUR,4827,5134,KOLKATA-NAGPUR,9961,All
2024,6,KOLKATA,NAGPUR,4884,4964,KOLKATA-NAGPUR,9848,All
2024,7,KOLKATA,NAGPUR,5423,5319,KOLKATA-NAGPUR,10742,All
2024,8,KOLKATA,NAGPUR,5141,5096,KOLKATA-NAGPUR,10237,All
2024,9,KOLKATA,NAGPUR,4930,4823,KOLKATA-NAGPUR,9753,All
2024,10,KOLKATA,NAGPUR,4721,5090,KOLKATA-NAGPUR,9811,All
2024,11,KOLKATA,NAGPUR,5198,5317,KOLKATA-NAGPUR,10515,All
2024,12,KOLKATA,NAGPUR,5463,5475,KOLKATA-NAGPUR,10938,All
2025,1,KOLKATA,NAGPUR,5416,5522,KOLKATA-NAGPUR,10938,All
2025,2,KOLKATA,NAGPUR,4802,5006,KOLKATA-NAGPUR,9808,All
2025,3,KOLKATA,NAGPUR,5065,5284,KOLKATA-NAGPUR,10349,All
2024,4,KOLKATA,PAKYONG,1615,1533,KOLKATA-PAKYONG,3148,All
2024,6,KOLKATA,PAKYONG,533,542,KOLKATA-PAKYONG,1075,All
2024,1,KOLKATA,PATNA,10644,10506,KOLKATA-PATNA,21150,All
2024,2,KOLKATA,PATNA,11622,11484,KOLKATA-PATNA,23106,All
2024,3,KOLKATA,PATNA,13240,13004,KOLKATA-PATNA,26244,All
2024,4,KOLKATA,PATNA,13392,12848,KOLKATA-PATNA,26240,All
2024,6,KOLKATA,PATNA,12046,12803,KOLKATA-PATNA,24849,All
2024,7,KOLKATA,PATNA,12369,13063,KOLKATA-PATNA,25432,All
2024,8,KOLKATA,PATNA,12972,13774,KOLKATA-PATNA,26746,All
2024,9,KOLKATA,PATNA,12819,12738,KOLKATA-PATNA,25557,All
2024,10,KOLKATA,PATNA,15035,12336,KOLKATA-PATNA,27371,All
2024,11,KOLKATA,PATNA,18285,17512,KOLKATA-PATNA,35797,All
2024,12,KOLKATA,PATNA,12188,13296,KOLKATA-PATNA,25484,All
2025,1,KOLKATA,PATNA,10525,10348,KOLKATA-PATNA,20873,All
2025,2,KOLKATA,PATNA,14899,14758,KOLKATA-PATNA,29657,All
2025,3,KOLKATA,PATNA,17251,16619,KOLKATA-PATNA,33870,All
2024,1,KOLKATA,PORT BLAIR,28723,30598,KOLKATA-PORT BLAIR,59321,All
2024,2,KOLKATA,PORT BLAIR,26838,27086,KOLKATA-PORT BLAIR,53924,All
2024,3,KOLKATA,PORT BLAIR,29348,28844,KOLKATA-PORT BLAIR,58192,All
2024,4,KOLKATA,PORT BLAIR,19096,25011,KOLKATA-PORT BLAIR,44107,All
2024,6,KOLKATA,PORT BLAIR,19884,18676,KOLKATA-PORT BLAIR,38560,All
2024,7,KOLKATA,PORT BLAIR,16463,11230,KOLKATA-PORT BLAIR,27693,All
2024,8,KOLKATA,PORT BLAIR,14953,12779,KOLKATA-PORT BLAIR,27732,All
2024,9,KOLKATA,PORT BLAIR,18797,16710,KOLKATA-PORT BLAIR,35507,All
2024,10,KOLKATA,PORT BLAIR,21866,23651,KOLKATA-PORT BLAIR,45517,All
2024,11,KOLKATA,PORT BLAIR,26229,23685,KOLKATA-PORT BLAIR,49914,All
2024,12,KOLKATA,PORT BLAIR,32836,29605,KOLKATA-PORT BLAIR,62441,All
2025,1,KOLKATA,PORT BLAIR,28715,30642,KOLKATA-PORT BLAIR,59357,All
2025,2,KOLKATA,PORT BLAIR,26410,27236,KOLKATA-PORT BLAIR,53646,All
2025,3,KOLKATA,PORT BLAIR,27934,27751,KOLKATA-PORT BLAIR,55685,All
2024,1,KOLKATA,PUNE,14492,15099,KOLKATA-PUNE,29591,All
2024,2,KOLKATA,PUNE,13664,14333,KOLKATA-PUNE,27997,All
2024,3,KOLKATA,PUNE,14228,15244,KOLKATA-PUNE,29472,All
2024,4,KOLKATA,PUNE,12990,15042,KOLKATA-PUNE,28032,All
2024,6,KOLKATA,PUNE,18727,18275,KOLKATA-PUNE,37002,All
2024,7,KOLKATA,PUNE,19321,17228,KOLKATA-PUNE,36549,All
2024,8,KOLKATA,PUNE,17609,17518,KOLKATA-PUNE,35127,All
2024,9,KOLKATA,PUNE,15763,17814,KOLKATA-PUNE,33577,All
2024,10,KOLKATA,PUNE,18747,21158,KOLKATA-PUNE,39905,All
2024,11,KOLKATA,PUNE,20432,21685,KOLKATA-PUNE,42117,All
2024,12,KOLKATA,PUNE,20984,22997,KOLKATA-PUNE,43981,All
2025,1,KOLKATA,PUNE,20784,22854,KOLKATA-PUNE,43638,All
2025,2,KOLKATA,PUNE,18477,21173,KOLKATA-PUNE,39650,All
2025,3,KOLKATA,PUNE,20141,22745,KOLKATA-PUNE,42886,All
2024,1,KOLKATA,RAIPUR,11182,11436,KOLKATA-RAIPUR,22618,All
2024,2,KOLKATA,RAIPUR,9624,10093,KOLKATA-RAIPUR,19717,All
2024,3,KOLKATA,RAIPUR,9941,10437,KOLKATA-RAIPUR,20378,All
2024,4,KOLKATA,RAIPUR,9900,11483,KOLKATA-RAIPUR,21383,All
2024,6,KOLKATA,RAIPUR,11365,10819,KOLKATA-RAIPUR,22184,All
2024,7,KOLKATA,RAIPUR,11389,9809,KOLKATA-RAIPUR,21198,All
2024,8,KOLKATA,RAIPUR,10828,10359,KOLKATA-RAIPUR,21187,All
2024,9,KOLKATA,RAIPUR,9843,10260,KOLKATA-RAIPUR,20103,All
2024,10,KOLKATA,RAIPUR,10462,11822,KOLKATA-RAIPUR,22284,All
2024,11,KOLKATA,RAIPUR,12155,11932,KOLKATA-RAIPUR,24087,All
2024,12,KOLKATA,RAIPUR,11869,11888,KOLKATA-RAIPUR,23757,All
2025,1,KOLKATA,RAIPUR,11534,11718,KOLKATA-RAIPUR,23252,All
2025,2,KOLKATA,RAIPUR,12026,12287,KOLKATA-RAIPUR,24313,All
2025,3,KOLKATA,RAIPUR,10475,11843,KOLKATA-RAIPUR,22318,All
2024,1,KOLKATA,RANCHI,6132,6106,KOLKATA-RANCHI,12238,All
2024,2,KOLKATA,RANCHI,6064,5754,KOLKATA-RANCHI,11818,All
2024,3,KOLKATA,RANCHI,6103,6021,KOLKATA-RANCHI,12124,All
2024,4,KOLKATA,RANCHI,8320,8344,KOLKATA-RANCHI,16664,All
2024,6,KOLKATA,RANCHI,8432,8693,KOLKATA-RANCHI,17125,All
2024,7,KOLKATA,RANCHI,7571,8027,KOLKATA-RANCHI,15598,All
2024,8,KOLKATA,RANCHI,7622,7978,KOLKATA-RANCHI,15600,All
2024,9,KOLKATA,RANCHI,7175,7871,KOLKATA-RANCHI,15046,All
2024,10,KOLKATA,RANCHI,8345,7529,KOLKATA-RANCHI,15874,All
2024,11,KOLKATA,RANCHI,7999,9003,KOLKATA-RANCHI,17002,All
2024,12,KOLKATA,RANCHI,8673,9638,KOLKATA-RANCHI,18311,All
2025,1,KOLKATA,RANCHI,8410,9337,KOLKATA-RANCHI,17747,All
2025,2,KOLKATA,RANCHI,7977,8502,KOLKATA-RANCHI,16479,All
2025,3,KOLKATA,RANCHI,8828,9099,KOLKATA-RANCHI,17927,All
2024,1,KOLKATA,ROURKELA,33,0,KOLKATA-ROURKELA,33,All
2024,2,KOLKATA,ROURKELA,116,191,KOLKATA-ROURKELA,307,All
2024,3,KOLKATA,ROURKELA,305,389,KOLKATA-ROURKELA,694,All
2024,4,KOLKATA,ROURKELA,559,663,KOLKATA-ROURKELA,1222,All
2024,6,KOLKATA,ROURKELA,549,583,KOLKATA-ROURKELA,1132,All
2024,7,KOLKATA,ROURKELA,518,521,KOLKATA-ROURKELA,1039,All
2024,8,KOLKATA,ROURKELA,657,643,KOLKATA-ROURKELA,1300,All
2024,9,KOLKATA,ROURKELA,367,346,KOLKATA-ROURKELA,713,All
2024,10,KOLKATA,ROURKELA,480,322,KOLKATA-ROURKELA,802,All
2024,11,KOLKATA,ROURKELA,400,334,KOLKATA-ROURKELA,734,All
2024,12,KOLKATA,ROURKELA,519,618,KOLKATA-ROURKELA,1137,All
2025,1,KOLKATA,ROURKELA,295,407,KOLKATA-ROURKELA,702,All
2025,2,KOLKATA,ROURKELA,302,437,KOLKATA-ROURKELA,739,All
2025,3,KOLKATA,ROURKELA,223,316,KOLKATA-ROURKELA,539,All
2024,10,KOLKATA,RUPSI,170,387,KOLKATA-RUPSI,557,All
2024,11,KOLKATA,RUPSI,708,637,KOLKATA-RUPSI,1345,All
2024,12,KOLKATA,RUPSI,663,639,KOLKATA-RUPSI,1302,All
2025,1,KOLKATA,RUPSI,221,242,KOLKATA-RUPSI,463,All
2025,2,KOLKATA,RUPSI,85,109,KOLKATA-RUPSI,194,All
2025,3,KOLKATA,RUPSI,401,362,KOLKATA-RUPSI,763,All
2024,3,KOLKATA,Rajkot International Airport,12,7,KOLKATA-Rajkot International Airport,19,All
2024,4,KOLKATA,Rajkot International Airport,109,128,KOLKATA-Rajkot International Airport,237,All
2024,6,KOLKATA,Rajkot International Airport,182,134,KOLKATA-Rajkot International Airport,316,All
2024,7,KOLKATA,Rajkot International Airport,92,84,KOLKATA-Rajkot International Airport,176,All
2024,8,KOLKATA,Rajkot International Airport,58,85,KOLKATA-Rajkot International Airport,143,All
2024,9,KOLKATA,Rajkot International Airport,47,33,KOLKATA-Rajkot International Airport,80,All
2024,10,KOLKATA,Rajkot International Airport,135,154,KOLKATA-Rajkot International Airport,289,All
2024,11,KOLKATA,Rajkot International Airport,107,126,KOLKATA-Rajkot International Airport,233,All
2024,12,KOLKATA,Rajkot International Airport,143,146,KOLKATA-Rajkot International Airport,289,All
2025,3,KOLKATA,Rajkot International Airport,113,91,KOLKATA-Rajkot International Airport,204,All
2024,1,KOLKATA,SHILLONG,3974,3740,KOLKATA-SHILLONG,7714,All
2024,2,KOLKATA,SHILLONG,3478,2904,KOLKATA-SHILLONG,6382,All
2024,3,KOLKATA,SHILLONG,3899,3210,KOLKATA-SHILLONG,7109,All
2024,4,KOLKATA,SHILLONG,2281,1520,KOLKATA-SHILLONG,3801,All
2024,6,KOLKATA,SHILLONG,2980,2574,KOLKATA-SHILLONG,5554,All
2024,7,KOLKATA,SHILLONG,2244,1889,KOLKATA-SHILLONG,4133,All
2024,8,KOLKATA,SHILLONG,1939,1573,KOLKATA-SHILLONG,3512,All
2024,9,KOLKATA,SHILLONG,1641,1187,KOLKATA-SHILLONG,2828,All
2024,10,KOLKATA,SHILLONG,2168,1739,KOLKATA-SHILLONG,3907,All
2024,11,KOLKATA,SHILLONG,3193,2442,KOLKATA-SHILLONG,5635,All
2024,12,KOLKATA,SHILLONG,3260,2465,KOLKATA-SHILLONG,5725,All
2025,1,KOLKATA,SHILLONG,3025,2522,KOLKATA-SHILLONG,5547,All
2025,2,KOLKATA,SHILLONG,2632,1913,KOLKATA-SHILLONG,4545,All
2025,3,KOLKATA,SHILLONG,2530,1829,KOLKATA-SHILLONG,4359,All
2024,1,KOLKATA,SILCHAR,12045,10563,KOLKATA-SILCHAR,22608,All
2024,2,KOLKATA,SILCHAR,10740,10216,KOLKATA-SILCHAR,20956,All
2024,3,KOLKATA,SILCHAR,11768,11307,KOLKATA-SILCHAR,23075,All
2024,4,KOLKATA,SILCHAR,10443,9686,KOLKATA-SILCHAR,20129,All
2024,6,KOLKATA,SILCHAR,10519,11618,KOLKATA-SILCHAR,22137,All
2024,7,KOLKATA,SILCHAR,12938,13345,KOLKATA-SILCHAR,26283,All
2024,8,KOLKATA,SILCHAR,11935,12741,KOLKATA-SILCHAR,24676,All
2024,9,KOLKATA,SILCHAR,12363,11321,KOLKATA-SILCHAR,23684,All
2024,10,KOLKATA,SILCHAR,15785,14850,KOLKATA-SILCHAR,30635,All
2024,11,KOLKATA,SILCHAR,15392,14312,KOLKATA-SILCHAR,29704,All
2024,12,KOLKATA,SILCHAR,15421,14353,KOLKATA-SILCHAR,29774,All
2025,1,KOLKATA,SILCHAR,15321,14335,KOLKATA-SILCHAR,29656,All
2025,2,KOLKATA,SILCHAR,13954,13369,KOLKATA-SILCHAR,27323,All
2025,3,KOLKATA,SILCHAR,15050,14370,KOLKATA-SILCHAR,29420,All
2024,1,KOLKATA,SRINAGAR,1107,1704,KOLKATA-SRINAGAR,2811,All
2024,2,KOLKATA,SRINAGAR,1096,1409,KOLKATA-SRINAGAR,2505,All
2024,3,KOLKATA,SRINAGAR,2041,1793,KOLKATA-SRINAGAR,3834,All
2024,4,KOLKATA,SRINAGAR,6026,5138,KOLKATA-SRINAGAR,11164,All
2024,6,KOLKATA,SRINAGAR,5935,5132,KOLKATA-SRINAGAR,11067,All
2024,7,KOLKATA,SRINAGAR,5516,4362,KOLKATA-SRINAGAR,9878,All
2024,8,KOLKATA,SRINAGAR,3769,2888,KOLKATA-SRINAGAR,6657,All
2024,9,KOLKATA,SRINAGAR,3587,2848,KOLKATA-SRINAGAR,6435,All
2024,10,KOLKATA,SRINAGAR,4033,4232,KOLKATA-SRINAGAR,8265,All
2024,11,KOLKATA,SRINAGAR,1871,1674,KOLKATA-SRINAGAR,3545,All
2024,12,KOLKATA,SRINAGAR,4978,5513,KOLKATA-SRINAGAR,10491,All
2025,1,KOLKATA,SRINAGAR,5050,4683,KOLKATA-SRINAGAR,9733,All
2025,2,KOLKATA,SRINAGAR,4570,3960,KOLKATA-SRINAGAR,8530,All
2025,3,KOLKATA,SRINAGAR,6342,5627,KOLKATA-SRINAGAR,11969,All
2024,1,KOLKATA,SURAT,5006,5086,KOLKATA-SURAT,10092,All
2024,2,KOLKATA,SURAT,4005,4269,KOLKATA-SURAT,8274,All
2024,3,KOLKATA,SURAT,3961,4038,KOLKATA-SURAT,7999,All
2024,4,KOLKATA,SURAT,4077,4844,KOLKATA-SURAT,8921,All
2024,6,KOLKATA,SURAT,5655,5675,KOLKATA-SURAT,11330,All
2024,7,KOLKATA,SURAT,5629,4935,KOLKATA-SURAT,10564,All
2024,8,KOLKATA,SURAT,5329,5057,KOLKATA-SURAT,10386,All
2024,9,KOLKATA,SURAT,4491,4835,KOLKATA-SURAT,9326,All
2024,10,KOLKATA,SURAT,4275,5573,KOLKATA-SURAT,9848,All
2024,11,KOLKATA,SURAT,5622,5478,KOLKATA-SURAT,11100,All
2024,12,KOLKATA,SURAT,6776,6421,KOLKATA-SURAT,13197,All
2025,1,KOLKATA,SURAT,3392,3508,KOLKATA-SURAT,6900,All
2025,2,KOLKATA,SURAT,3274,3360,KOLKATA-SURAT,6634,All
2025,3,KOLKATA,SURAT,5206,5607,KOLKATA-SURAT,10813,All
2024,1,KOLKATA,TEZPUR,2759,2641,KOLKATA-TEZPUR,5400,All
2024,2,KOLKATA,TEZPUR,1922,1784,KOLKATA-TEZPUR,3706,All
2024,3,KOLKATA,TEZPUR,2523,2336,KOLKATA-TEZPUR,4859,All
2024,4,KOLKATA,TEZPUR,2454,2087,KOLKATA-TEZPUR,4541,All
2024,6,KOLKATA,TEZPUR,2182,2184,KOLKATA-TEZPUR,4366,All
2024,7,KOLKATA,TEZPUR,2438,2385,KOLKATA-TEZPUR,4823,All
2024,8,KOLKATA,TEZPUR,1544,1305,KOLKATA-TEZPUR,2849,All
2024,9,KOLKATA,TEZPUR,1331,1067,KOLKATA-TEZPUR,2398,All
2025,2,KOLKATA,TIRUPATI,3,1,KOLKATA-TIRUPATI,4,All
2025,3,KOLKATA,TIRUPATI,5,8,KOLKATA-TIRUPATI,13,All
2024,4,KOLKATA,VADODARA,107,92,KOLKATA-VADODARA,199,All
2024,6,KOLKATA,VADODARA,267,313,KOLKATA-VADODARA,580,All
2024,7,KOLKATA,VADODARA,198,225,KOLKATA-VADODARA,423,All
2024,8,KOLKATA,VADODARA,165,239,KOLKATA-VADODARA,404,All
2024,9,KOLKATA,VADODARA,129,253,KOLKATA-VADODARA,382,All
2024,10,KOLKATA,VADODARA,217,140,KOLKATA-VADODARA,357,All
2024,11,KOLKATA,VADODARA,115,102,KOLKATA-VADODARA,217,All
2024,12,KOLKATA,VADODARA,98,84,KOLKATA-VADODARA,182,All
2025,3,KOLKATA,VADODARA,174,148,KOLKATA-VADODARA,322,All
2024,1,KOLKATA,VARANASI,7664,7756,KOLKATA-VARANASI,15420,All
2024,2,KOLKATA,VARANASI,10762,9632,KOLKATA-VARANASI,20394,All
2024,3,KOLKATA,VARANASI,12015,11992,KOLKATA-VARANASI,24007,All
2024,4,KOLKATA,VARANASI,10430,10551,KOLKATA-VARANASI,20981,All
2024,6,KOLKATA,VARANASI,9690,10300,KOLKATA-VARANASI,19990,All
2024,7,KOLKATA,VARANASI,10793,10014,KOLKATA-VARANASI,20807,All
2024,8,KOLKATA,VARANASI,11800,12361,KOLKATA-VARANASI,24161,All
2024,9,KOLKATA,VARANASI,11361,12983,KOLKATA-VARANASI,24344,All
2024,10,KOLKATA,VARANASI,13293,14072,KOLKATA-VARANASI,27365,All
2024,11,KOLKATA,VARANASI,13948,13727,KOLKATA-VARANASI,27675,All
2024,12,KOLKATA,VARANASI,11065,12335,KOLKATA-VARANASI,23400,All
2025,1,KOLKATA,VARANASI,11309,11417,KOLKATA-VARANASI,22726,All
2025,2,KOLKATA,VARANASI,10395,10809,KOLKATA-VARANASI,21204,All
2025,3,KOLKATA,VARANASI,11373,11568,KOLKATA-VARANASI,22941,All
2024,1,KOLKATA,VISAKHAPATNAM,4637,4887,KOLKATA-VISAKHAPATNAM,9524,All
2024,2,KOLKATA,VISAKHAPATNAM,3719,4263,KOLKATA-VISAKHAPATNAM,7982,All
2024,3,KOLKATA,VISAKHAPATNAM,4224,4623,KOLKATA-VISAKHAPATNAM,8847,All
2024,4,KOLKATA,VISAKHAPATNAM,5131,6080,KOLKATA-VISAKHAPATNAM,11211,All
2024,6,KOLKATA,VISAKHAPATNAM,5127,4993,KOLKATA-VISAKHAPATNAM,10120,All
2024,7,KOLKATA,VISAKHAPATNAM,7201,5768,KOLKATA-VISAKHAPATNAM,12969,All
2024,8,KOLKATA,VISAKHAPATNAM,9099,7245,KOLKATA-VISAKHAPATNAM,16344,All
2024,9,KOLKATA,VISAKHAPATNAM,5722,6476,KOLKATA-VISAKHAPATNAM,12198,All
2024,10,KOLKATA,VISAKHAPATNAM,7740,9428,KOLKATA-VISAKHAPATNAM,17168,All
2024,11,KOLKATA,VISAKHAPATNAM,8871,8202,KOLKATA-VISAKHAPATNAM,17073,All
2024,12,KOLKATA,VISAKHAPATNAM,8424,8249,KOLKATA-VISAKHAPATNAM,16673,All
2025,1,KOLKATA,VISAKHAPATNAM,7938,8196,KOLKATA-VISAKHAPATNAM,16134,All
2025,2,KOLKATA,VISAKHAPATNAM,7853,9042,KOLKATA-VISAKHAPATNAM,16895,All
2025,3,KOLKATA,VISAKHAPATNAM,6984,8215,KOLKATA-VISAKHAPATNAM,15199,All
2024,1,KOZHIKODE,MUMBAI,9869,9591,KOZHIKODE-MUMBAI,19460,All
2024,2,KOZHIKODE,MUMBAI,7698,7304,KOZHIKODE-MUMBAI,15002,All
2024,3,KOZHIKODE,MUMBAI,9894,9199,KOZHIKODE-MUMBAI,19093,All
2024,4,KOZHIKODE,MUMBAI,9526,9752,KOZHIKODE-MUMBAI,19278,All
2024,6,KOZHIKODE,MUMBAI,6786,7352,KOZHIKODE-MUMBAI,14138,All
2024,7,KOZHIKODE,MUMBAI,4730,5518,KOZHIKODE-MUMBAI,10248,All
2024,8,KOZHIKODE,MUMBAI,5562,5043,KOZHIKODE-MUMBAI,10605,All
2024,9,KOZHIKODE,MUMBAI,5659,5051,KOZHIKODE-MUMBAI,10710,All
2024,10,KOZHIKODE,MUMBAI,5141,5326,KOZHIKODE-MUMBAI,10467,All
2024,11,KOZHIKODE,MUMBAI,6876,6021,KOZHIKODE-MUMBAI,12897,All
2024,12,KOZHIKODE,MUMBAI,7465,8167,KOZHIKODE-MUMBAI,15632,All
2025,1,KOZHIKODE,MUMBAI,8253,8069,KOZHIKODE-MUMBAI,16322,All
2025,2,KOZHIKODE,MUMBAI,7113,6885,KOZHIKODE-MUMBAI,13998,All
2025,3,KOZHIKODE,MUMBAI,7102,6432,KOZHIKODE-MUMBAI,13534,All
2024,7,KOZHIKODE,TIRUCHIRAPALLY,0,32,KOZHIKODE-TIRUCHIRAPALLY,32,All
2024,6,KOZHIKODE,TRIVANDRUM,59,8,KOZHIKODE-TRIVANDRUM,67,All
2024,7,KOZHIKODE,TRIVANDRUM,53,16,KOZHIKODE-TRIVANDRUM,69,All
2024,10,KOZHIKODE,TRIVANDRUM,0,11,KOZHIKODE-TRIVANDRUM,11,All
2024,1,KURNOOL,VISAKHAPATNAM,778,758,KURNOOL-VISAKHAPATNAM,1536,All
2024,2,KURNOOL,VISAKHAPATNAM,626,580,KURNOOL-VISAKHAPATNAM,1206,All
2024,3,KURNOOL,VISAKHAPATNAM,390,386,KURNOOL-VISAKHAPATNAM,776,All
2024,4,KURNOOL,VISAKHAPATNAM,318,383,KURNOOL-VISAKHAPATNAM,701,All
2024,6,KURNOOL,VISAKHAPATNAM,400,382,KURNOOL-VISAKHAPATNAM,782,All
2024,7,KURNOOL,VISAKHAPATNAM,293,334,KURNOOL-VISAKHAPATNAM,627,All
2024,8,KURNOOL,VISAKHAPATNAM,359,374,KURNOOL-VISAKHAPATNAM,733,All
2024,9,KURNOOL,VISAKHAPATNAM,268,281,KURNOOL-VISAKHAPATNAM,549,All
2024,10,KURNOOL,VISAKHAPATNAM,465,460,KURNOOL-VISAKHAPATNAM,925,All
2024,11,KURNOOL,VISAKHAPATNAM,394,386,KURNOOL-VISAKHAPATNAM,780,All
2024,12,KURNOOL,VISAKHAPATNAM,298,311,KURNOOL-VISAKHAPATNAM,609,All
2025,1,KURNOOL,VISAKHAPATNAM,357,281,KURNOOL-VISAKHAPATNAM,638,All
2025,2,KURNOOL,VISAKHAPATNAM,227,214,KURNOOL-VISAKHAPATNAM,441,All
2025,3,KURNOOL,VISAKHAPATNAM,366,315,KURNOOL-VISAKHAPATNAM,681,All
2024,2,Kishangarh,HINDON AIRPORT,313,327,HINDON AIRPORT-Kishangarh,640,All
2024,3,Kishangarh,HINDON AIRPORT,458,507,HINDON AIRPORT-Kishangarh,965,All
2024,4,Kishangarh,HINDON AIRPORT,586,391,HINDON AIRPORT-Kishangarh,977,All
2024,6,Kishangarh,HINDON AIRPORT,404,559,HINDON AIRPORT-Kishangarh,963,All
2024,7,Kishangarh,HINDON AIRPORT,334,450,HINDON AIRPORT-Kishangarh,784,All
2024,8,Kishangarh,HINDON AIRPORT,385,389,HINDON AIRPORT-Kishangarh,774,All
2024,9,Kishangarh,HINDON AIRPORT,444,456,HINDON AIRPORT-Kishangarh,900,All
2024,10,Kishangarh,HINDON AIRPORT,520,525,HINDON AIRPORT-Kishangarh,1045,All
2024,11,Kishangarh,HINDON AIRPORT,570,628,HINDON AIRPORT-Kishangarh,1198,All
2024,12,Kishangarh,HINDON AIRPORT,467,720,HINDON AIRPORT-Kishangarh,1187,All
2025,1,Kishangarh,HINDON AIRPORT,567,587,HINDON AIRPORT-Kishangarh,1154,All
2025,2,Kishangarh,HINDON AIRPORT,546,623,HINDON AIRPORT-Kishangarh,1169,All
2025,3,Kishangarh,HINDON AIRPORT,771,734,HINDON AIRPORT-Kishangarh,1505,All
2024,2,Kishangarh,LUCKNOW,331,284,Kishangarh-LUCKNOW,615,All
2024,3,Kishangarh,LUCKNOW,606,535,Kishangarh-LUCKNOW,1141,All
2024,4,Kishangarh,LUCKNOW,640,569,Kishangarh-LUCKNOW,1209,All
2024,6,Kishangarh,LUCKNOW,483,525,Kishangarh-LUCKNOW,1008,All
2024,7,Kishangarh,LUCKNOW,286,384,Kishangarh-LUCKNOW,670,All
2024,8,Kishangarh,LUCKNOW,299,524,Kishangarh-LUCKNOW,823,All
2024,9,Kishangarh,LUCKNOW,609,609,Kishangarh-LUCKNOW,1218,All
2024,10,Kishangarh,LUCKNOW,625,635,Kishangarh-LUCKNOW,1260,All
2024,11,Kishangarh,LUCKNOW,705,816,Kishangarh-LUCKNOW,1521,All
2024,12,Kishangarh,LUCKNOW,714,874,Kishangarh-LUCKNOW,1588,All
2025,1,Kishangarh,LUCKNOW,1204,1232,Kishangarh-LUCKNOW,2436,All
2025,2,Kishangarh,LUCKNOW,1179,1218,Kishangarh-LUCKNOW,2397,All
2025,3,Kishangarh,LUCKNOW,523,533,Kishangarh-LUCKNOW,1056,All
2024,1,Kishangarh,NAGPUR,1182,1312,Kishangarh-NAGPUR,2494,All
2024,2,Kishangarh,NAGPUR,1294,1358,Kishangarh-NAGPUR,2652,All
2024,3,Kishangarh,NAGPUR,1067,1008,Kishangarh-NAGPUR,2075,All
2024,4,Kishangarh,NAGPUR,708,831,Kishangarh-NAGPUR,1539,All
2024,6,Kishangarh,NAGPUR,527,675,Kishangarh-NAGPUR,1202,All
2024,7,Kishangarh,NAGPUR,463,660,Kishangarh-NAGPUR,1123,All
2024,8,Kishangarh,NAGPUR,624,732,Kishangarh-NAGPUR,1356,All
2024,9,Kishangarh,NAGPUR,759,717,Kishangarh-NAGPUR,1476,All
2024,10,Kishangarh,NAGPUR,777,1125,Kishangarh-NAGPUR,1902,All
2024,11,Kishangarh,NAGPUR,1180,1215,Kishangarh-NAGPUR,2395,All
2024,12,Kishangarh,NAGPUR,1086,1192,Kishangarh-NAGPUR,2278,All
2025,1,Kishangarh,NAGPUR,1182,1228,Kishangarh-NAGPUR,2410,All
2025,2,Kishangarh,NAGPUR,1110,1153,Kishangarh-NAGPUR,2263,All
2025,3,Kishangarh,NAGPUR,887,932,Kishangarh-NAGPUR,1819,All
2024,1,Kishangarh,PUNE,1058,1246,Kishangarh-PUNE,2304,All
2024,2,Kishangarh,PUNE,1248,1273,Kishangarh-PUNE,2521,All
2024,3,Kishangarh,PUNE,1198,1368,Kishangarh-PUNE,2566,All
2024,4,Kishangarh,PUNE,970,1152,Kishangarh-PUNE,2122,All
2024,6,Kishangarh,PUNE,1018,1121,Kishangarh-PUNE,2139,All
2024,7,Kishangarh,PUNE,974,1231,Kishangarh-PUNE,2205,All
2024,8,Kishangarh,PUNE,1134,1382,Kishangarh-PUNE,2516,All
2024,9,Kishangarh,PUNE,1164,1339,Kishangarh-PUNE,2503,All
2024,10,Kishangarh,PUNE,942,1351,Kishangarh-PUNE,2293,All
2024,11,Kishangarh,PUNE,1405,1443,Kishangarh-PUNE,2848,All
2024,12,Kishangarh,PUNE,1412,1501,Kishangarh-PUNE,2913,All
2025,1,Kishangarh,PUNE,1481,1589,Kishangarh-PUNE,3070,All
2025,2,Kishangarh,PUNE,1217,1479,Kishangarh-PUNE,2696,All
2025,3,Kishangarh,PUNE,1213,1487,Kishangarh-PUNE,2700,All
2024,1,Kishangarh,SURAT,636,687,Kishangarh-SURAT,1323,All
2024,2,Kishangarh,SURAT,670,758,Kishangarh-SURAT,1428,All
2024,3,Kishangarh,SURAT,641,756,Kishangarh-SURAT,1397,All
2024,4,Kishangarh,SURAT,596,723,Kishangarh-SURAT,1319,All
2024,6,Kishangarh,SURAT,204,159,Kishangarh-SURAT,363,All
2024,6,LEH,MUMBAI,4415,4640,LEH-MUMBAI,9055,All
2024,7,LEH,MUMBAI,4243,4206,LEH-MUMBAI,8449,All
2024,8,LEH,MUMBAI,4044,4202,LEH-MUMBAI,8246,All
2024,9,LEH,MUMBAI,3483,3099,LEH-MUMBAI,6582,All
2025,3,LEH,MUMBAI,33,167,LEH-MUMBAI,200,All
2024,1,LEH,SRINAGAR,776,757,LEH-SRINAGAR,1533,All
2024,2,LEH,SRINAGAR,929,1200,LEH-SRINAGAR,2129,All
2024,3,LEH,SRINAGAR,779,1190,LEH-SRINAGAR,1969,All
2024,4,LEH,SRINAGAR,1204,1070,LEH-SRINAGAR,2274,All
2024,6,LEH,SRINAGAR,1091,861,LEH-SRINAGAR,1952,All
2024,7,LEH,SRINAGAR,1236,1038,LEH-SRINAGAR,2274,All
2024,8,LEH,SRINAGAR,1270,986,LEH-SRINAGAR,2256,All
2024,9,LEH,SRINAGAR,1131,700,LEH-SRINAGAR,1831,All
2024,10,LEH,SRINAGAR,1425,834,LEH-SRINAGAR,2259,All
2024,11,LEH,SRINAGAR,1068,642,LEH-SRINAGAR,1710,All
2024,12,LEH,SRINAGAR,982,654,LEH-SRINAGAR,1636,All
2025,1,LEH,SRINAGAR,891,767,LEH-SRINAGAR,1658,All
2025,2,LEH,SRINAGAR,603,741,LEH-SRINAGAR,1344,All
2025,3,LEH,SRINAGAR,975,1159,LEH-SRINAGAR,2134,All
2024,1,LILABARI,SHILLONG,1144,651,LILABARI-SHILLONG,1795,All
2024,2,LILABARI,SHILLONG,658,336,LILABARI-SHILLONG,994,All
2024,3,LILABARI,SHILLONG,838,410,LILABARI-SHILLONG,1248,All
2024,4,LILABARI,SHILLONG,833,560,LILABARI-SHILLONG,1393,All
2024,6,LILABARI,SHILLONG,596,410,LILABARI-SHILLONG,1006,All
2024,7,LILABARI,SHILLONG,911,648,LILABARI-SHILLONG,1559,All
2024,8,LILABARI,SHILLONG,262,80,LILABARI-SHILLONG,342,All
2024,9,LILABARI,SHILLONG,207,135,LILABARI-SHILLONG,342,All
2024,10,LILABARI,SHILLONG,158,157,LILABARI-SHILLONG,315,All
2025,3,LILABARI,SILCHAR,0,53,LILABARI-SILCHAR,53,All
2024,1,LILABARI,TEZPUR,103,127,LILABARI-TEZPUR,230,All
2024,2,LILABARI,TEZPUR,138,182,LILABARI-TEZPUR,320,All
2024,3,LILABARI,TEZPUR,134,190,LILABARI-TEZPUR,324,All
2024,4,LILABARI,TEZPUR,315,334,LILABARI-TEZPUR,649,All
2024,6,LILABARI,TEZPUR,260,343,LILABARI-TEZPUR,603,All
2024,7,LILABARI,TEZPUR,453,442,LILABARI-TEZPUR,895,All
2024,8,LILABARI,TEZPUR,288,491,LILABARI-TEZPUR,779,All
2024,9,LILABARI,TEZPUR,393,541,LILABARI-TEZPUR,934,All
2024,3,LUCKNOW,Aligarh Airport ,35,51,Aligarh Airport -LUCKNOW,86,All
2024,4,LUCKNOW,Aligarh Airport ,38,84,Aligarh Airport -LUCKNOW,122,All
2024,6,LUCKNOW,Aligarh Airport ,88,103,Aligarh Airport -LUCKNOW,191,All
2024,7,LUCKNOW,Aligarh Airport ,71,100,Aligarh Airport -LUCKNOW,171,All
2024,8,LUCKNOW,Aligarh Airport ,113,161,Aligarh Airport -LUCKNOW,274,All
2024,9,LUCKNOW,Aligarh Airport ,79,80,Aligarh Airport -LUCKNOW,159,All
2024,10,LUCKNOW,Aligarh Airport ,75,93,Aligarh Airport -LUCKNOW,168,All
2024,11,LUCKNOW,Aligarh Airport ,34,33,Aligarh Airport -LUCKNOW,67,All
2024,12,LUCKNOW,Aligarh Airport ,13,11,Aligarh Airport -LUCKNOW,24,All
2024,7,LUCKNOW,Ayodhya International Airport ,0,33,Ayodhya International Airport -LUCKNOW,33,All
2024,12,LUCKNOW,Ayodhya International Airport ,174,0,Ayodhya International Airport -LUCKNOW,174,All
2024,3,LUCKNOW,Azamgarh Airport,38,42,Azamgarh Airport-LUCKNOW,80,All
2024,4,LUCKNOW,Azamgarh Airport,34,35,Azamgarh Airport-LUCKNOW,69,All
2024,6,LUCKNOW,Azamgarh Airport,65,92,Azamgarh Airport-LUCKNOW,157,All
2024,7,LUCKNOW,Azamgarh Airport,41,64,Azamgarh Airport-LUCKNOW,105,All
2024,8,LUCKNOW,Azamgarh Airport,58,80,Azamgarh Airport-LUCKNOW,138,All
2024,9,LUCKNOW,Azamgarh Airport,78,84,Azamgarh Airport-LUCKNOW,162,All
2024,10,LUCKNOW,Azamgarh Airport,61,63,Azamgarh Airport-LUCKNOW,124,All
2024,11,LUCKNOW,Azamgarh Airport,17,12,Azamgarh Airport-LUCKNOW,29,All
2024,3,LUCKNOW,Chitrakoot Airport,36,46,Chitrakoot Airport-LUCKNOW,82,All
2024,4,LUCKNOW,Chitrakoot Airport,20,39,Chitrakoot Airport-LUCKNOW,59,All
2024,6,LUCKNOW,Chitrakoot Airport,81,103,Chitrakoot Airport-LUCKNOW,184,All
2024,7,LUCKNOW,Chitrakoot Airport,59,44,Chitrakoot Airport-LUCKNOW,103,All
2024,8,LUCKNOW,Chitrakoot Airport,83,104,Chitrakoot Airport-LUCKNOW,187,All
2024,9,LUCKNOW,Chitrakoot Airport,82,98,Chitrakoot Airport-LUCKNOW,180,All
2024,10,LUCKNOW,Chitrakoot Airport,115,119,Chitrakoot Airport-LUCKNOW,234,All
2024,11,LUCKNOW,Chitrakoot Airport,35,41,Chitrakoot Airport-LUCKNOW,76,All
2024,12,LUCKNOW,Chitrakoot Airport,7,9,Chitrakoot Airport-LUCKNOW,16,All
2024,1,LUCKNOW,MUMBAI,41520,41839,LUCKNOW-MUMBAI,83359,All
2024,2,LUCKNOW,MUMBAI,39481,39851,LUCKNOW-MUMBAI,79332,All
2024,3,LUCKNOW,MUMBAI,40975,39629,LUCKNOW-MUMBAI,80604,All
2024,4,LUCKNOW,MUMBAI,30291,31398,LUCKNOW-MUMBAI,61689,All
2024,6,LUCKNOW,MUMBAI,35203,30077,LUCKNOW-MUMBAI,65280,All
2024,7,LUCKNOW,MUMBAI,38392,32005,LUCKNOW-MUMBAI,70397,All
2024,8,LUCKNOW,MUMBAI,41542,37388,LUCKNOW-MUMBAI,78930,All
2024,9,LUCKNOW,MUMBAI,41439,40082,LUCKNOW-MUMBAI,81521,All
2024,10,LUCKNOW,MUMBAI,30858,44300,LUCKNOW-MUMBAI,75158,All
2024,11,LUCKNOW,MUMBAI,46134,47755,LUCKNOW-MUMBAI,93889,All
2024,12,LUCKNOW,MUMBAI,48539,46196,LUCKNOW-MUMBAI,94735,All
2025,1,LUCKNOW,MUMBAI,47553,47389,LUCKNOW-MUMBAI,94942,All
2025,2,LUCKNOW,MUMBAI,43873,45038,LUCKNOW-MUMBAI,88911,All
2025,3,LUCKNOW,MUMBAI,37815,39555,LUCKNOW-MUMBAI,77370,All
2024,8,LUCKNOW,Moradabad Airport,78,108,LUCKNOW-Moradabad Airport,186,All
2024,9,LUCKNOW,Moradabad Airport,68,97,LUCKNOW-Moradabad Airport,165,All
2024,10,LUCKNOW,Moradabad Airport,51,101,LUCKNOW-Moradabad Airport,152,All
2024,11,LUCKNOW,Moradabad Airport,0,11,LUCKNOW-Moradabad Airport,11,All
2024,1,LUCKNOW,NAGPUR,2023,1908,LUCKNOW-NAGPUR,3931,All
2024,2,LUCKNOW,NAGPUR,1834,1945,LUCKNOW-NAGPUR,3779,All
2024,3,LUCKNOW,NAGPUR,1832,1906,LUCKNOW-NAGPUR,3738,All
2024,4,LUCKNOW,NAGPUR,1419,1633,LUCKNOW-NAGPUR,3052,All
2024,6,LUCKNOW,NAGPUR,1610,1496,LUCKNOW-NAGPUR,3106,All
2024,7,LUCKNOW,NAGPUR,1480,1546,LUCKNOW-NAGPUR,3026,All
2024,8,LUCKNOW,NAGPUR,1422,1393,LUCKNOW-NAGPUR,2815,All
2024,9,LUCKNOW,NAGPUR,1396,1516,LUCKNOW-NAGPUR,2912,All
2024,10,LUCKNOW,NAGPUR,1439,1710,LUCKNOW-NAGPUR,3149,All
2024,11,LUCKNOW,NAGPUR,1766,1844,LUCKNOW-NAGPUR,3610,All
2024,12,LUCKNOW,NAGPUR,917,796,LUCKNOW-NAGPUR,1713,All
2025,2,LUCKNOW,NAGPUR,1459,1589,LUCKNOW-NAGPUR,3048,All
2025,3,LUCKNOW,NAGPUR,1432,1374,LUCKNOW-NAGPUR,2806,All
2024,3,LUCKNOW,NASIK,0,18,LUCKNOW-NASIK,18,All
2024,4,LUCKNOW,NASIK,264,450,LUCKNOW-NASIK,714,All
2024,6,LUCKNOW,NASIK,422,301,LUCKNOW-NASIK,723,All
2024,7,LUCKNOW,NASIK,260,153,LUCKNOW-NASIK,413,All
2024,8,LUCKNOW,NASIK,234,105,LUCKNOW-NASIK,339,All
2024,9,LUCKNOW,NASIK,262,137,LUCKNOW-NASIK,399,All
2024,10,LUCKNOW,NASIK,144,106,LUCKNOW-NASIK,250,All
2024,11,LUCKNOW,NASIK,121,106,LUCKNOW-NASIK,227,All
2024,12,LUCKNOW,NASIK,114,75,LUCKNOW-NASIK,189,All
2025,3,LUCKNOW,NASIK,166,255,LUCKNOW-NASIK,421,All
2024,1,LUCKNOW,PATNA,4281,4208,LUCKNOW-PATNA,8489,All
2024,2,LUCKNOW,PATNA,4103,3963,LUCKNOW-PATNA,8066,All
2024,3,LUCKNOW,PATNA,4354,4354,LUCKNOW-PATNA,8708,All
2024,4,LUCKNOW,PATNA,3973,4262,LUCKNOW-PATNA,8235,All
2024,6,LUCKNOW,PATNA,3805,4034,LUCKNOW-PATNA,7839,All
2024,7,LUCKNOW,PATNA,4041,4392,LUCKNOW-PATNA,8433,All
2024,8,LUCKNOW,PATNA,3553,4367,LUCKNOW-PATNA,7920,All
2024,9,LUCKNOW,PATNA,3303,4119,LUCKNOW-PATNA,7422,All
2024,10,LUCKNOW,PATNA,4336,3709,LUCKNOW-PATNA,8045,All
2024,11,LUCKNOW,PATNA,4203,4365,LUCKNOW-PATNA,8568,All
2024,12,LUCKNOW,PATNA,4044,4280,LUCKNOW-PATNA,8324,All
2025,1,LUCKNOW,PATNA,3720,4047,LUCKNOW-PATNA,7767,All
2025,2,LUCKNOW,PATNA,4015,3949,LUCKNOW-PATNA,7964,All
2025,3,LUCKNOW,PATNA,4278,3570,LUCKNOW-PATNA,7848,All
2024,1,LUCKNOW,PUNE,10962,9710,LUCKNOW-PUNE,20672,All
2024,2,LUCKNOW,PUNE,10138,9746,LUCKNOW-PUNE,19884,All
2024,3,LUCKNOW,PUNE,10793,10100,LUCKNOW-PUNE,20893,All
2024,4,LUCKNOW,PUNE,10347,10365,LUCKNOW-PUNE,20712,All
2024,6,LUCKNOW,PUNE,10992,9713,LUCKNOW-PUNE,20705,All
2024,7,LUCKNOW,PUNE,11187,9323,LUCKNOW-PUNE,20510,All
2024,8,LUCKNOW,PUNE,10732,8603,LUCKNOW-PUNE,19335,All
2024,9,LUCKNOW,PUNE,9760,8635,LUCKNOW-PUNE,18395,All
2024,10,LUCKNOW,PUNE,8730,10561,LUCKNOW-PUNE,19291,All
2024,11,LUCKNOW,PUNE,10167,10358,LUCKNOW-PUNE,20525,All
2024,12,LUCKNOW,PUNE,10585,10233,LUCKNOW-PUNE,20818,All
2025,1,LUCKNOW,PUNE,10951,10390,LUCKNOW-PUNE,21341,All
2025,2,LUCKNOW,PUNE,10036,9692,LUCKNOW-PUNE,19728,All
2025,3,LUCKNOW,PUNE,5837,10297,LUCKNOW-PUNE,16134,All
2024,1,LUCKNOW,RAIPUR,2069,2157,LUCKNOW-RAIPUR,4226,All
2024,2,LUCKNOW,RAIPUR,1883,2018,LUCKNOW-RAIPUR,3901,All
2024,3,LUCKNOW,RAIPUR,2251,2224,LUCKNOW-RAIPUR,4475,All
2024,4,LUCKNOW,RAIPUR,3103,3436,LUCKNOW-RAIPUR,6539,All
2024,6,LUCKNOW,RAIPUR,3967,3444,LUCKNOW-RAIPUR,7411,All
2024,7,LUCKNOW,RAIPUR,3632,3627,LUCKNOW-RAIPUR,7259,All
2024,8,LUCKNOW,RAIPUR,3696,3847,LUCKNOW-RAIPUR,7543,All
2024,9,LUCKNOW,RAIPUR,3449,3312,LUCKNOW-RAIPUR,6761,All
2024,10,LUCKNOW,RAIPUR,3252,3647,LUCKNOW-RAIPUR,6899,All
2024,11,LUCKNOW,RAIPUR,3776,4160,LUCKNOW-RAIPUR,7936,All
2024,12,LUCKNOW,RAIPUR,3719,3520,LUCKNOW-RAIPUR,7239,All
2025,1,LUCKNOW,RAIPUR,3269,3735,LUCKNOW-RAIPUR,7004,All
2025,2,LUCKNOW,RAIPUR,3451,4042,LUCKNOW-RAIPUR,7493,All
2025,3,LUCKNOW,RAIPUR,3258,3454,LUCKNOW-RAIPUR,6712,All
2024,1,LUCKNOW,RANCHI,2200,2167,LUCKNOW-RANCHI,4367,All
2024,2,LUCKNOW,RANCHI,2553,2671,LUCKNOW-RANCHI,5224,All
2024,3,LUCKNOW,RANCHI,2651,2517,LUCKNOW-RANCHI,5168,All
2024,4,LUCKNOW,RANCHI,1328,970,LUCKNOW-RANCHI,2298,All
2024,6,LUCKNOW,RANCHI,1198,1108,LUCKNOW-RANCHI,2306,All
2024,7,LUCKNOW,RANCHI,1034,1138,LUCKNOW-RANCHI,2172,All
2024,8,LUCKNOW,RANCHI,1301,1127,LUCKNOW-RANCHI,2428,All
2024,9,LUCKNOW,RANCHI,1159,869,LUCKNOW-RANCHI,2028,All
2024,10,LUCKNOW,RANCHI,1165,1286,LUCKNOW-RANCHI,2451,All
2024,11,LUCKNOW,RANCHI,926,695,LUCKNOW-RANCHI,1621,All
2024,12,LUCKNOW,RANCHI,1487,1038,LUCKNOW-RANCHI,2525,All
2025,3,LUCKNOW,RANCHI,1310,1614,LUCKNOW-RANCHI,2924,All
2024,1,LUCKNOW,SHIRDI,158,301,LUCKNOW-SHIRDI,459,All
2024,2,LUCKNOW,SHIRDI,183,195,LUCKNOW-SHIRDI,378,All
2024,3,LUCKNOW,SHIRDI,318,280,LUCKNOW-SHIRDI,598,All
2024,4,LUCKNOW,SHIRDI,250,359,LUCKNOW-SHIRDI,609,All
2024,6,LUCKNOW,SHIRDI,324,272,LUCKNOW-SHIRDI,596,All
2024,7,LUCKNOW,SHIRDI,196,237,LUCKNOW-SHIRDI,433,All
2024,8,LUCKNOW,SHIRDI,240,223,LUCKNOW-SHIRDI,463,All
2024,9,LUCKNOW,SHIRDI,278,320,LUCKNOW-SHIRDI,598,All
2024,10,LUCKNOW,SHIRDI,193,270,LUCKNOW-SHIRDI,463,All
2024,11,LUCKNOW,SHIRDI,191,175,LUCKNOW-SHIRDI,366,All
2024,12,LUCKNOW,SHIRDI,102,242,LUCKNOW-SHIRDI,344,All
2025,3,LUCKNOW,SHIRDI,264,215,LUCKNOW-SHIRDI,479,All
2025,3,LUCKNOW,SILCHAR,3,9,LUCKNOW-SILCHAR,12,All
2024,2,LUCKNOW,SRINAGAR,588,329,LUCKNOW-SRINAGAR,917,All
2024,3,LUCKNOW,SRINAGAR,2018,1255,LUCKNOW-SRINAGAR,3273,All
2024,4,LUCKNOW,SRINAGAR,1522,1456,LUCKNOW-SRINAGAR,2978,All
2024,6,LUCKNOW,SRINAGAR,1954,2309,LUCKNOW-SRINAGAR,4263,All
2024,7,LUCKNOW,SRINAGAR,1812,1554,LUCKNOW-SRINAGAR,3366,All
2024,8,LUCKNOW,SRINAGAR,865,923,LUCKNOW-SRINAGAR,1788,All
2024,9,LUCKNOW,SRINAGAR,1125,1133,LUCKNOW-SRINAGAR,2258,All
2024,10,LUCKNOW,SRINAGAR,1158,1746,LUCKNOW-SRINAGAR,2904,All
2024,11,LUCKNOW,SRINAGAR,1690,1326,LUCKNOW-SRINAGAR,3016,All
2024,12,LUCKNOW,SRINAGAR,1615,1577,LUCKNOW-SRINAGAR,3192,All
2025,3,LUCKNOW,SRINAGAR,418,128,LUCKNOW-SRINAGAR,546,All
2024,3,LUCKNOW,Shravasti Airport,36,49,LUCKNOW-Shravasti Airport,85,All
2024,4,LUCKNOW,Shravasti Airport,16,27,LUCKNOW-Shravasti Airport,43,All
2024,6,LUCKNOW,Shravasti Airport,29,55,LUCKNOW-Shravasti Airport,84,All
2024,7,LUCKNOW,Shravasti Airport,37,49,LUCKNOW-Shravasti Airport,86,All
2024,8,LUCKNOW,Shravasti Airport,46,58,LUCKNOW-Shravasti Airport,104,All
2024,9,LUCKNOW,Shravasti Airport,43,60,LUCKNOW-Shravasti Airport,103,All
2024,10,LUCKNOW,Shravasti Airport,40,69,LUCKNOW-Shravasti Airport,109,All
2024,11,LUCKNOW,Shravasti Airport,4,10,LUCKNOW-Shravasti Airport,14,All
2024,12,LUCKNOW,Shravasti Airport,5,8,LUCKNOW-Shravasti Airport,13,All
2024,1,LUCKNOW,VARANASI,785,387,LUCKNOW-VARANASI,1172,All
2024,2,LUCKNOW,VARANASI,1587,1296,LUCKNOW-VARANASI,2883,All
2024,3,LUCKNOW,VARANASI,1889,1713,LUCKNOW-VARANASI,3602,All
2024,4,LUCKNOW,VARANASI,1928,1973,LUCKNOW-VARANASI,3901,All
2024,6,LUCKNOW,VARANASI,1917,1952,LUCKNOW-VARANASI,3869,All
2024,7,LUCKNOW,VARANASI,2047,2153,LUCKNOW-VARANASI,4200,All
2024,8,LUCKNOW,VARANASI,1987,2184,LUCKNOW-VARANASI,4171,All
2024,9,LUCKNOW,VARANASI,1785,2040,LUCKNOW-VARANASI,3825,All
2024,10,LUCKNOW,VARANASI,1758,1751,LUCKNOW-VARANASI,3509,All
2024,11,LUCKNOW,VARANASI,1107,914,LUCKNOW-VARANASI,2021,All
2024,12,LUCKNOW,VARANASI,907,864,LUCKNOW-VARANASI,1771,All
2025,1,LUCKNOW,VARANASI,774,779,LUCKNOW-VARANASI,1553,All
2025,2,LUCKNOW,VARANASI,798,813,LUCKNOW-VARANASI,1611,All
2024,12,LUCKNOW,VIJAYAWADA,3,0,LUCKNOW-VIJAYAWADA,3,All
2025,3,LUCKNOW,VIJAYAWADA,0,3,LUCKNOW-VIJAYAWADA,3,All
2024,2,LUDHIANA,HINDON AIRPORT,22,10,HINDON AIRPORT-LUDHIANA,32,All
2024,3,LUDHIANA,HINDON AIRPORT,32,35,HINDON AIRPORT-LUDHIANA,67,All
2024,4,LUDHIANA,HINDON AIRPORT,42,37,HINDON AIRPORT-LUDHIANA,79,All
2024,6,LUDHIANA,HINDON AIRPORT,160,147,HINDON AIRPORT-LUDHIANA,307,All
2024,7,LUDHIANA,HINDON AIRPORT,75,68,HINDON AIRPORT-LUDHIANA,143,All
2024,8,LUDHIANA,HINDON AIRPORT,136,121,HINDON AIRPORT-LUDHIANA,257,All
2024,9,LUDHIANA,HINDON AIRPORT,116,113,HINDON AIRPORT-LUDHIANA,229,All
2024,10,LUDHIANA,HINDON AIRPORT,87,89,HINDON AIRPORT-LUDHIANA,176,All
2024,11,LUDHIANA,HINDON AIRPORT,6,14,HINDON AIRPORT-LUDHIANA,20,All
2025,3,LUDHIANA,HINDON AIRPORT,42,71,HINDON AIRPORT-LUDHIANA,113,All
2024,1,MADURAI,MUMBAI,5897,7328,MADURAI-MUMBAI,13225,All
2024,2,MADURAI,MUMBAI,6905,7345,MADURAI-MUMBAI,14250,All
2024,3,MADURAI,MUMBAI,9572,10729,MADURAI-MUMBAI,20301,All
2024,4,MADURAI,MUMBAI,7333,8259,MADURAI-MUMBAI,15592,All
2024,6,MADURAI,MUMBAI,8011,8773,MADURAI-MUMBAI,16784,All
2024,7,MADURAI,MUMBAI,7029,8209,MADURAI-MUMBAI,15238,All
2024,8,MADURAI,MUMBAI,7754,7691,MADURAI-MUMBAI,15445,All
2024,9,MADURAI,MUMBAI,7205,7353,MADURAI-MUMBAI,14558,All
2024,10,MADURAI,MUMBAI,5920,7266,MADURAI-MUMBAI,13186,All
2024,11,MADURAI,MUMBAI,7607,7080,MADURAI-MUMBAI,14687,All
2024,12,MADURAI,MUMBAI,6337,6909,MADURAI-MUMBAI,13246,All
2025,1,MADURAI,MUMBAI,6451,6781,MADURAI-MUMBAI,13232,All
2025,2,MADURAI,MUMBAI,5523,5707,MADURAI-MUMBAI,11230,All
2025,3,MADURAI,MUMBAI,5533,5979,MADURAI-MUMBAI,11512,All
2024,8,MADURAI,TUTICORIN,31,0,MADURAI-TUTICORIN,31,All
2025,3,MADURAI,VIJAYAWADA,6,5,MADURAI-VIJAYAWADA,11,All
2024,1,MANGALORE,MUMBAI,30015,30291,MANGALORE-MUMBAI,60306,All
2024,2,MANGALORE,MUMBAI,26223,26509,MANGALORE-MUMBAI,52732,All
2024,3,MANGALORE,MUMBAI,25064,25276,MANGALORE-MUMBAI,50340,All
2024,4,MANGALORE,MUMBAI,26773,27107,MANGALORE-MUMBAI,53880,All
2024,6,MANGALORE,MUMBAI,23116,24921,MANGALORE-MUMBAI,48037,All
2024,7,MANGALORE,MUMBAI,23698,28154,MANGALORE-MUMBAI,51852,All
2024,8,MANGALORE,MUMBAI,28183,27047,MANGALORE-MUMBAI,55230,All
2024,9,MANGALORE,MUMBAI,26437,24590,MANGALORE-MUMBAI,51027,All
2024,10,MANGALORE,MUMBAI,25502,25989,MANGALORE-MUMBAI,51491,All
2024,11,MANGALORE,MUMBAI,26716,26710,MANGALORE-MUMBAI,53426,All
2024,12,MANGALORE,MUMBAI,27407,28666,MANGALORE-MUMBAI,56073,All
2025,1,MANGALORE,MUMBAI,28255,28295,MANGALORE-MUMBAI,56550,All
2025,2,MANGALORE,MUMBAI,23890,24749,MANGALORE-MUMBAI,48639,All
2025,3,MANGALORE,MUMBAI,24573,24384,MANGALORE-MUMBAI,48957,All
2024,1,MANGALORE,PUNE,1710,1654,MANGALORE-PUNE,3364,All
2024,2,MANGALORE,PUNE,1645,1577,MANGALORE-PUNE,3222,All
2024,3,MANGALORE,PUNE,1571,1575,MANGALORE-PUNE,3146,All
2024,4,MANGALORE,PUNE,2004,1974,MANGALORE-PUNE,3978,All
2024,6,MANGALORE,PUNE,2084,1811,MANGALORE-PUNE,3895,All
2024,7,MANGALORE,PUNE,1690,1967,MANGALORE-PUNE,3657,All
2024,8,MANGALORE,PUNE,1959,1915,MANGALORE-PUNE,3874,All
2024,9,MANGALORE,PUNE,2039,1994,MANGALORE-PUNE,4033,All
2024,10,MANGALORE,PUNE,1482,1431,MANGALORE-PUNE,2913,All
2025,1,MANGALORE,PUNE,902,878,MANGALORE-PUNE,1780,All
2025,2,MANGALORE,PUNE,805,783,MANGALORE-PUNE,1588,All
2025,3,MANGALORE,PUNE,563,585,MANGALORE-PUNE,1148,All
2024,11,MANGALORE,RAJAHMUNDRY,0,4,MANGALORE-RAJAHMUNDRY,4,All
2024,12,MANGALORE,RAJAHMUNDRY,0,1,MANGALORE-RAJAHMUNDRY,1,All
2025,3,MANGALORE,RAJAHMUNDRY,0,3,MANGALORE-RAJAHMUNDRY,3,All
2024,4,MANGALORE,TIRUCHIRAPALLY,41,18,MANGALORE-TIRUCHIRAPALLY,59,All
2024,1,MUMBAI,Ayodhya International Airport ,3236,2890,Ayodhya International Airport -MUMBAI,6126,All
2024,2,MUMBAI,Ayodhya International Airport ,10246,10395,Ayodhya International Airport -MUMBAI,20641,All
2024,3,MUMBAI,Ayodhya International Airport ,10472,10512,Ayodhya International Airport -MUMBAI,20984,All
2024,4,MUMBAI,Ayodhya International Airport ,10955,9648,Ayodhya International Airport -MUMBAI,20603,All
2024,6,MUMBAI,Ayodhya International Airport ,12480,13229,Ayodhya International Airport -MUMBAI,25709,All
2024,7,MUMBAI,Ayodhya International Airport ,10294,10554,Ayodhya International Airport -MUMBAI,20848,All
2024,8,MUMBAI,Ayodhya International Airport ,6133,7007,Ayodhya International Airport -MUMBAI,13140,All
2024,9,MUMBAI,Ayodhya International Airport ,9666,9652,Ayodhya International Airport -MUMBAI,19318,All
2024,10,MUMBAI,Ayodhya International Airport ,9890,7433,Ayodhya International Airport -MUMBAI,17323,All
2024,11,MUMBAI,Ayodhya International Airport ,7991,7922,Ayodhya International Airport -MUMBAI,15913,All
2024,12,MUMBAI,Ayodhya International Airport ,8848,10264,Ayodhya International Airport -MUMBAI,19112,All
2025,1,MUMBAI,Ayodhya International Airport ,13690,13567,Ayodhya International Airport -MUMBAI,27257,All
2025,2,MUMBAI,Ayodhya International Airport ,14655,14284,Ayodhya International Airport -MUMBAI,28939,All
2025,3,MUMBAI,Ayodhya International Airport ,15513,14831,Ayodhya International Airport -MUMBAI,30344,All
2025,3,MUMBAI,HINDON AIRPORT,1278,1288,HINDON AIRPORT-MUMBAI,2566,All
2024,1,MUMBAI,NAGPUR,27323,27955,MUMBAI-NAGPUR,55278,All
2024,2,MUMBAI,NAGPUR,26352,26272,MUMBAI-NAGPUR,52624,All
2024,3,MUMBAI,NAGPUR,27919,27948,MUMBAI-NAGPUR,55867,All
2024,4,MUMBAI,NAGPUR,25916,25388,MUMBAI-NAGPUR,51304,All
2024,6,MUMBAI,NAGPUR,26494,26434,MUMBAI-NAGPUR,52928,All
2024,7,MUMBAI,NAGPUR,28441,27745,MUMBAI-NAGPUR,56186,All
2024,8,MUMBAI,NAGPUR,27778,28007,MUMBAI-NAGPUR,55785,All
2024,9,MUMBAI,NAGPUR,28341,28566,MUMBAI-NAGPUR,56907,All
2024,10,MUMBAI,NAGPUR,30927,28238,MUMBAI-NAGPUR,59165,All
2024,11,MUMBAI,NAGPUR,29590,30583,MUMBAI-NAGPUR,60173,All
2024,12,MUMBAI,NAGPUR,32035,32670,MUMBAI-NAGPUR,64705,All
2025,1,MUMBAI,NAGPUR,31479,31675,MUMBAI-NAGPUR,63154,All
2025,2,MUMBAI,NAGPUR,29368,29126,MUMBAI-NAGPUR,58494,All
2025,3,MUMBAI,NAGPUR,28859,28440,MUMBAI-NAGPUR,57299,All
2024,1,MUMBAI,PATNA,14576,14047,MUMBAI-PATNA,28623,All
2024,2,MUMBAI,PATNA,14667,13703,MUMBAI-PATNA,28370,All
2024,3,MUMBAI,PATNA,15797,14340,MUMBAI-PATNA,30137,All
2024,4,MUMBAI,PATNA,15186,13780,MUMBAI-PATNA,28966,All
2024,6,MUMBAI,PATNA,14853,14751,MUMBAI-PATNA,29604,All
2024,7,MUMBAI,PATNA,13734,14454,MUMBAI-PATNA,28188,All
2024,8,MUMBAI,PATNA,14131,14660,MUMBAI-PATNA,28791,All
2024,9,MUMBAI,PATNA,14582,14113,MUMBAI-PATNA,28695,All
2024,10,MUMBAI,PATNA,16827,12254,MUMBAI-PATNA,29081,All
2024,11,MUMBAI,PATNA,18440,17173,MUMBAI-PATNA,35613,All
2024,12,MUMBAI,PATNA,15465,15625,MUMBAI-PATNA,31090,All
2025,1,MUMBAI,PATNA,14984,15007,MUMBAI-PATNA,29991,All
2025,2,MUMBAI,PATNA,14584,14113,MUMBAI-PATNA,28697,All
2025,3,MUMBAI,PATNA,20776,18659,MUMBAI-PATNA,39435,All
2025,3,MUMBAI,PORBANDAR,38,17,MUMBAI-PORBANDAR,55,All
2024,1,MUMBAI,PORT BLAIR,4926,5008,MUMBAI-PORT BLAIR,9934,All
2024,2,MUMBAI,PORT BLAIR,4573,4677,MUMBAI-PORT BLAIR,9250,All
2024,3,MUMBAI,PORT BLAIR,4962,5008,MUMBAI-PORT BLAIR,9970,All
2024,4,MUMBAI,PORT BLAIR,4361,4710,MUMBAI-PORT BLAIR,9071,All
2024,10,MUMBAI,PORT BLAIR,4508,4061,MUMBAI-PORT BLAIR,8569,All
2024,11,MUMBAI,PORT BLAIR,5387,5550,MUMBAI-PORT BLAIR,10937,All
2024,12,MUMBAI,PORT BLAIR,8040,7901,MUMBAI-PORT BLAIR,15941,All
2025,1,MUMBAI,PORT BLAIR,7538,7464,MUMBAI-PORT BLAIR,15002,All
2025,2,MUMBAI,PORT BLAIR,4724,4769,MUMBAI-PORT BLAIR,9493,All
2025,3,MUMBAI,PORT BLAIR,4782,4997,MUMBAI-PORT BLAIR,9779,All
2024,1,MUMBAI,PUNE,2179,2386,MUMBAI-PUNE,4565,All
2024,2,MUMBAI,PUNE,2272,2148,MUMBAI-PUNE,4420,All
2024,3,MUMBAI,PUNE,2281,2294,MUMBAI-PUNE,4575,All
2024,4,MUMBAI,PUNE,2502,2551,MUMBAI-PUNE,5053,All
2024,6,MUMBAI,PUNE,858,814,MUMBAI-PUNE,1672,All
2025,1,MUMBAI,PUNE,0,14,MUMBAI-PUNE,14,All
2024,1,MUMBAI,RAIPUR,17048,17236,MUMBAI-RAIPUR,34284,All
2024,2,MUMBAI,RAIPUR,14595,14704,MUMBAI-RAIPUR,29299,All
2024,3,MUMBAI,RAIPUR,15843,15516,MUMBAI-RAIPUR,31359,All
2024,4,MUMBAI,RAIPUR,16420,15189,MUMBAI-RAIPUR,31609,All
2024,6,MUMBAI,RAIPUR,15088,14965,MUMBAI-RAIPUR,30053,All
2024,7,MUMBAI,RAIPUR,15115,15844,MUMBAI-RAIPUR,30959,All
2024,8,MUMBAI,RAIPUR,15411,15958,MUMBAI-RAIPUR,31369,All
2024,9,MUMBAI,RAIPUR,14524,14843,MUMBAI-RAIPUR,29367,All
2024,10,MUMBAI,RAIPUR,16210,12421,MUMBAI-RAIPUR,28631,All
2024,11,MUMBAI,RAIPUR,14564,16966,MUMBAI-RAIPUR,31530,All
2024,12,MUMBAI,RAIPUR,16275,16611,MUMBAI-RAIPUR,32886,All
2025,1,MUMBAI,RAIPUR,15951,16350,MUMBAI-RAIPUR,32301,All
2025,2,MUMBAI,RAIPUR,15106,14895,MUMBAI-RAIPUR,30001,All
2025,3,MUMBAI,RAIPUR,14718,15130,MUMBAI-RAIPUR,29848,All
2024,12,MUMBAI,RAJAHMUNDRY,4375,3773,MUMBAI-RAJAHMUNDRY,8148,All
2025,1,MUMBAI,RAJAHMUNDRY,4315,4524,MUMBAI-RAJAHMUNDRY,8839,All
2025,2,MUMBAI,RAJAHMUNDRY,1947,1916,MUMBAI-RAJAHMUNDRY,3863,All
2025,3,MUMBAI,RAJAHMUNDRY,3629,3486,MUMBAI-RAJAHMUNDRY,7115,All
2024,1,MUMBAI,RANCHI,10471,9527,MUMBAI-RANCHI,19998,All
2024,2,MUMBAI,RANCHI,9187,8995,MUMBAI-RANCHI,18182,All
2024,3,MUMBAI,RANCHI,10862,10103,MUMBAI-RANCHI,20965,All
2024,4,MUMBAI,RANCHI,9667,9039,MUMBAI-RANCHI,18706,All
2024,6,MUMBAI,RANCHI,9909,9695,MUMBAI-RANCHI,19604,All
2024,7,MUMBAI,RANCHI,10261,10953,MUMBAI-RANCHI,21214,All
2024,8,MUMBAI,RANCHI,10678,11162,MUMBAI-RANCHI,21840,All
2024,9,MUMBAI,RANCHI,10476,10089,MUMBAI-RANCHI,20565,All
2024,10,MUMBAI,RANCHI,11295,9522,MUMBAI-RANCHI,20817,All
2024,11,MUMBAI,RANCHI,9678,9577,MUMBAI-RANCHI,19255,All
2024,12,MUMBAI,RANCHI,9881,10056,MUMBAI-RANCHI,19937,All
2025,1,MUMBAI,RANCHI,10183,10054,MUMBAI-RANCHI,20237,All
2025,2,MUMBAI,RANCHI,9222,8849,MUMBAI-RANCHI,18071,All
2025,3,MUMBAI,RANCHI,9893,9050,MUMBAI-RANCHI,18943,All
2024,1,MUMBAI,Rajkot International Airport,26464,25496,MUMBAI-Rajkot International Airport,51960,All
2024,2,MUMBAI,Rajkot International Airport,25558,24583,MUMBAI-Rajkot International Airport,50141,All
2024,3,MUMBAI,Rajkot International Airport,22187,23434,MUMBAI-Rajkot International Airport,45621,All
2024,4,MUMBAI,Rajkot International Airport,21463,20139,MUMBAI-Rajkot International Airport,41602,All
2024,6,MUMBAI,Rajkot International Airport,22085,20129,MUMBAI-Rajkot International Airport,42214,All
2024,7,MUMBAI,Rajkot International Airport,21256,19906,MUMBAI-Rajkot International Airport,41162,All
2024,8,MUMBAI,Rajkot International Airport,22485,21815,MUMBAI-Rajkot International Airport,44300,All
2024,9,MUMBAI,Rajkot International Airport,23812,21375,MUMBAI-Rajkot International Airport,45187,All
2024,10,MUMBAI,Rajkot International Airport,22997,20519,MUMBAI-Rajkot International Airport,43516,All
2024,11,MUMBAI,Rajkot International Airport,26128,25272,MUMBAI-Rajkot International Airport,51400,All
2024,12,MUMBAI,Rajkot International Airport,27736,26232,MUMBAI-Rajkot International Airport,53968,All
2025,1,MUMBAI,Rajkot International Airport,26595,26405,MUMBAI-Rajkot International Airport,53000,All
2025,2,MUMBAI,Rajkot International Airport,22452,22054,MUMBAI-Rajkot International Airport,44506,All
2025,3,MUMBAI,Rajkot International Airport,22681,23250,MUMBAI-Rajkot International Airport,45931,All
2024,11,MUMBAI,SHIRDI,4,1,MUMBAI-SHIRDI,5,All
2024,1,MUMBAI,SRINAGAR,7367,7780,MUMBAI-SRINAGAR,15147,All
2024,2,MUMBAI,SRINAGAR,12587,11234,MUMBAI-SRINAGAR,23821,All
2024,3,MUMBAI,SRINAGAR,22419,20022,MUMBAI-SRINAGAR,42441,All
2024,4,MUMBAI,SRINAGAR,27043,25249,MUMBAI-SRINAGAR,52292,All
2024,6,MUMBAI,SRINAGAR,22331,23193,MUMBAI-SRINAGAR,45524,All
2024,7,MUMBAI,SRINAGAR,17485,19045,MUMBAI-SRINAGAR,36530,All
2024,8,MUMBAI,SRINAGAR,12196,14727,MUMBAI-SRINAGAR,26923,All
2024,9,MUMBAI,SRINAGAR,12336,13327,MUMBAI-SRINAGAR,25663,All
2024,10,MUMBAI,SRINAGAR,14028,14251,MUMBAI-SRINAGAR,28279,All
2024,11,MUMBAI,SRINAGAR,12889,14428,MUMBAI-SRINAGAR,27317,All
2024,12,MUMBAI,SRINAGAR,14021,14796,MUMBAI-SRINAGAR,28817,All
2025,1,MUMBAI,SRINAGAR,12736,13090,MUMBAI-SRINAGAR,25826,All
2025,2,MUMBAI,SRINAGAR,12610,12239,MUMBAI-SRINAGAR,24849,All
2025,3,MUMBAI,SRINAGAR,15548,14739,MUMBAI-SRINAGAR,30287,All
2024,1,MUMBAI,TIRUCHIRAPALLY,5047,4188,MUMBAI-TIRUCHIRAPALLY,9235,All
2024,2,MUMBAI,TIRUCHIRAPALLY,3557,2840,MUMBAI-TIRUCHIRAPALLY,6397,All
2024,3,MUMBAI,TIRUCHIRAPALLY,2586,2144,MUMBAI-TIRUCHIRAPALLY,4730,All
2024,4,MUMBAI,TIRUCHIRAPALLY,2067,2026,MUMBAI-TIRUCHIRAPALLY,4093,All
2024,6,MUMBAI,TIRUCHIRAPALLY,2190,2084,MUMBAI-TIRUCHIRAPALLY,4274,All
2024,7,MUMBAI,TIRUCHIRAPALLY,2063,1773,MUMBAI-TIRUCHIRAPALLY,3836,All
2024,8,MUMBAI,TIRUCHIRAPALLY,2670,2459,MUMBAI-TIRUCHIRAPALLY,5129,All
2024,9,MUMBAI,TIRUCHIRAPALLY,2316,2270,MUMBAI-TIRUCHIRAPALLY,4586,All
2024,10,MUMBAI,TIRUCHIRAPALLY,2298,1865,MUMBAI-TIRUCHIRAPALLY,4163,All
2024,11,MUMBAI,TIRUCHIRAPALLY,2775,2812,MUMBAI-TIRUCHIRAPALLY,5587,All
2024,12,MUMBAI,TIRUCHIRAPALLY,2262,1909,MUMBAI-TIRUCHIRAPALLY,4171,All
2025,1,MUMBAI,TIRUCHIRAPALLY,2309,1979,MUMBAI-TIRUCHIRAPALLY,4288,All
2025,2,MUMBAI,TIRUCHIRAPALLY,2116,1987,MUMBAI-TIRUCHIRAPALLY,4103,All
2025,3,MUMBAI,TIRUCHIRAPALLY,2968,2404,MUMBAI-TIRUCHIRAPALLY,5372,All
2024,12,MUMBAI,TIRUPATI,5077,4497,MUMBAI-TIRUPATI,9574,All
2025,1,MUMBAI,TIRUPATI,4870,4252,MUMBAI-TIRUPATI,9122,All
2025,2,MUMBAI,TIRUPATI,4394,3899,MUMBAI-TIRUPATI,8293,All
2025,3,MUMBAI,TIRUPATI,5174,4493,MUMBAI-TIRUPATI,9667,All
2024,1,MUMBAI,TRIVANDRUM,24687,27669,MUMBAI-TRIVANDRUM,52356,All
2024,2,MUMBAI,TRIVANDRUM,19543,21047,MUMBAI-TRIVANDRUM,40590,All
2024,3,MUMBAI,TRIVANDRUM,17243,17501,MUMBAI-TRIVANDRUM,34744,All
2024,4,MUMBAI,TRIVANDRUM,22222,23004,MUMBAI-TRIVANDRUM,45226,All
2024,6,MUMBAI,TRIVANDRUM,20742,21424,MUMBAI-TRIVANDRUM,42166,All
2024,7,MUMBAI,TRIVANDRUM,18610,15929,MUMBAI-TRIVANDRUM,34539,All
2024,8,MUMBAI,TRIVANDRUM,17074,19538,MUMBAI-TRIVANDRUM,36612,All
2024,9,MUMBAI,TRIVANDRUM,16696,20453,MUMBAI-TRIVANDRUM,37149,All
2024,10,MUMBAI,TRIVANDRUM,15187,16149,MUMBAI-TRIVANDRUM,31336,All
2024,11,MUMBAI,TRIVANDRUM,14522,15585,MUMBAI-TRIVANDRUM,30107,All
2024,12,MUMBAI,TRIVANDRUM,16639,15601,MUMBAI-TRIVANDRUM,32240,All
2025,1,MUMBAI,TRIVANDRUM,15822,16372,MUMBAI-TRIVANDRUM,32194,All
2025,2,MUMBAI,TRIVANDRUM,13726,14008,MUMBAI-TRIVANDRUM,27734,All
2025,3,MUMBAI,TRIVANDRUM,14251,14666,MUMBAI-TRIVANDRUM,28917,All
2024,1,MUMBAI,UDAIPUR,24880,24351,MUMBAI-UDAIPUR,49231,All
2024,2,MUMBAI,UDAIPUR,24149,23667,MUMBAI-UDAIPUR,47816,All
2024,3,MUMBAI,UDAIPUR,24008,24492,MUMBAI-UDAIPUR,48500,All
2024,4,MUMBAI,UDAIPUR,22920,21106,MUMBAI-UDAIPUR,44026,All
2024,6,MUMBAI,UDAIPUR,20718,20705,MUMBAI-UDAIPUR,41423,All
2024,7,MUMBAI,UDAIPUR,23575,22502,MUMBAI-UDAIPUR,46077,All
2024,8,MUMBAI,UDAIPUR,24535,23496,MUMBAI-UDAIPUR,48031,All
2024,9,MUMBAI,UDAIPUR,24272,22323,MUMBAI-UDAIPUR,46595,All
2024,10,MUMBAI,UDAIPUR,25436,20532,MUMBAI-UDAIPUR,45968,All
2024,11,MUMBAI,UDAIPUR,22956,23164,MUMBAI-UDAIPUR,46120,All
2024,12,MUMBAI,UDAIPUR,23569,22456,MUMBAI-UDAIPUR,46025,All
2025,1,MUMBAI,UDAIPUR,26113,25133,MUMBAI-UDAIPUR,51246,All
2025,2,MUMBAI,UDAIPUR,23256,22530,MUMBAI-UDAIPUR,45786,All
2025,3,MUMBAI,UDAIPUR,24529,23667,MUMBAI-UDAIPUR,48196,All
2024,1,MUMBAI,VADODARA,19461,20560,MUMBAI-VADODARA,40021,All
2024,2,MUMBAI,VADODARA,19204,21297,MUMBAI-VADODARA,40501,All
2024,3,MUMBAI,VADODARA,16838,19533,MUMBAI-VADODARA,36371,All
2024,4,MUMBAI,VADODARA,13021,14210,MUMBAI-VADODARA,27231,All
2024,6,MUMBAI,VADODARA,12643,13793,MUMBAI-VADODARA,26436,All
2024,7,MUMBAI,VADODARA,12132,13418,MUMBAI-VADODARA,25550,All
2024,8,MUMBAI,VADODARA,13608,15079,MUMBAI-VADODARA,28687,All
2024,9,MUMBAI,VADODARA,13733,15303,MUMBAI-VADODARA,29036,All
2024,10,MUMBAI,VADODARA,14670,14925,MUMBAI-VADODARA,29595,All
2024,11,MUMBAI,VADODARA,13930,14933,MUMBAI-VADODARA,28863,All
2024,12,MUMBAI,VADODARA,14504,15422,MUMBAI-VADODARA,29926,All
2025,1,MUMBAI,VADODARA,14817,15702,MUMBAI-VADODARA,30519,All
2025,2,MUMBAI,VADODARA,12947,13644,MUMBAI-VADODARA,26591,All
2025,3,MUMBAI,VADODARA,12225,15194,MUMBAI-VADODARA,27419,All
2024,1,MUMBAI,VARANASI,28185,28082,MUMBAI-VARANASI,56267,All
2024,2,MUMBAI,VARANASI,29713,27744,MUMBAI-VARANASI,57457,All
2024,3,MUMBAI,VARANASI,31406,28366,MUMBAI-VARANASI,59772,All
2024,4,MUMBAI,VARANASI,32289,27346,MUMBAI-VARANASI,59635,All
2024,6,MUMBAI,VARANASI,31621,32565,MUMBAI-VARANASI,64186,All
2024,7,MUMBAI,VARANASI,25568,27791,MUMBAI-VARANASI,53359,All
2024,8,MUMBAI,VARANASI,26146,29193,MUMBAI-VARANASI,55339,All
2024,9,MUMBAI,VARANASI,27859,28049,MUMBAI-VARANASI,55908,All
2024,10,MUMBAI,VARANASI,35578,27910,MUMBAI-VARANASI,63488,All
2024,11,MUMBAI,VARANASI,41707,39740,MUMBAI-VARANASI,81447,All
2024,12,MUMBAI,VARANASI,37184,39927,MUMBAI-VARANASI,77111,All
2025,1,MUMBAI,VARANASI,39168,39174,MUMBAI-VARANASI,78342,All
2025,2,MUMBAI,VARANASI,38030,37617,MUMBAI-VARANASI,75647,All
2025,3,MUMBAI,VARANASI,46108,44408,MUMBAI-VARANASI,90516,All
2024,6,MUMBAI,VIJAYAWADA,1834,1874,MUMBAI-VIJAYAWADA,3708,All
2024,7,MUMBAI,VIJAYAWADA,3973,3806,MUMBAI-VIJAYAWADA,7779,All
2024,8,MUMBAI,VIJAYAWADA,5579,6895,MUMBAI-VIJAYAWADA,12474,All
2024,9,MUMBAI,VIJAYAWADA,6071,6582,MUMBAI-VIJAYAWADA,12653,All
2024,10,MUMBAI,VIJAYAWADA,8711,7351,MUMBAI-VIJAYAWADA,16062,All
2024,11,MUMBAI,VIJAYAWADA,7803,8784,MUMBAI-VIJAYAWADA,16587,All
2024,12,MUMBAI,VIJAYAWADA,9355,8128,MUMBAI-VIJAYAWADA,17483,All
2025,1,MUMBAI,VIJAYAWADA,8849,8978,MUMBAI-VIJAYAWADA,17827,All
2025,2,MUMBAI,VIJAYAWADA,7695,7334,MUMBAI-VIJAYAWADA,15029,All
2025,3,MUMBAI,VIJAYAWADA,7442,7584,MUMBAI-VIJAYAWADA,15026,All
2024,1,MUMBAI,VISAKHAPATNAM,9418,9749,MUMBAI-VISAKHAPATNAM,19167,All
2024,2,MUMBAI,VISAKHAPATNAM,8830,8567,MUMBAI-VISAKHAPATNAM,17397,All
2024,3,MUMBAI,VISAKHAPATNAM,9416,9662,MUMBAI-VISAKHAPATNAM,19078,All
2024,4,MUMBAI,VISAKHAPATNAM,8712,8915,MUMBAI-VISAKHAPATNAM,17627,All
2024,6,MUMBAI,VISAKHAPATNAM,9335,8544,MUMBAI-VISAKHAPATNAM,17879,All
2024,7,MUMBAI,VISAKHAPATNAM,8697,8569,MUMBAI-VISAKHAPATNAM,17266,All
2024,8,MUMBAI,VISAKHAPATNAM,9291,9542,MUMBAI-VISAKHAPATNAM,18833,All
2024,9,MUMBAI,VISAKHAPATNAM,8732,8932,MUMBAI-VISAKHAPATNAM,17664,All
2024,10,MUMBAI,VISAKHAPATNAM,10399,9057,MUMBAI-VISAKHAPATNAM,19456,All
2024,11,MUMBAI,VISAKHAPATNAM,10217,11031,MUMBAI-VISAKHAPATNAM,21248,All
2024,12,MUMBAI,VISAKHAPATNAM,11419,11170,MUMBAI-VISAKHAPATNAM,22589,All
2025,1,MUMBAI,VISAKHAPATNAM,10847,10716,MUMBAI-VISAKHAPATNAM,21563,All
2025,2,MUMBAI,VISAKHAPATNAM,10185,9960,MUMBAI-VISAKHAPATNAM,20145,All
2025,3,MUMBAI,VISAKHAPATNAM,9559,9393,MUMBAI-VISAKHAPATNAM,18952,All
2024,1,Malvan,MUMBAI,818,761,Malvan-MUMBAI,1579,All
2024,2,Malvan,MUMBAI,825,846,Malvan-MUMBAI,1671,All
2024,3,Malvan,MUMBAI,922,868,Malvan-MUMBAI,1790,All
2024,4,Malvan,MUMBAI,910,977,Malvan-MUMBAI,1887,All
2024,6,Malvan,MUMBAI,475,360,Malvan-MUMBAI,835,All
2024,7,Malvan,MUMBAI,306,270,Malvan-MUMBAI,576,All
2024,8,Malvan,MUMBAI,515,591,Malvan-MUMBAI,1106,All
2024,9,Malvan,MUMBAI,1022,1165,Malvan-MUMBAI,2187,All
2024,10,Malvan,MUMBAI,389,413,Malvan-MUMBAI,802,All
2024,8,Malvan,PUNE,19,26,Malvan-PUNE,45,All
2024,9,Malvan,PUNE,224,326,Malvan-PUNE,550,All
2024,10,Malvan,PUNE,147,218,Malvan-PUNE,365,All
2024,11,Malvan,PUNE,248,310,Malvan-PUNE,558,All
2024,12,Malvan,PUNE,220,417,Malvan-PUNE,637,All
2025,1,Malvan,PUNE,141,227,Malvan-PUNE,368,All
2024,6,NAGPUR,NANDED,89,117,NAGPUR-NANDED,206,All
2024,7,NAGPUR,NANDED,480,556,NAGPUR-NANDED,1036,All
2024,8,NAGPUR,NANDED,611,689,NAGPUR-NANDED,1300,All
2024,9,NAGPUR,NANDED,123,156,NAGPUR-NANDED,279,All
2024,1,NAGPUR,NASIK,1894,1583,NAGPUR-NASIK,3477,All
2024,2,NAGPUR,NASIK,1879,1551,NAGPUR-NASIK,3430,All
2024,3,NAGPUR,NASIK,1547,1303,NAGPUR-NASIK,2850,All
2024,4,NAGPUR,NASIK,1543,1505,NAGPUR-NASIK,3048,All
2024,6,NAGPUR,NASIK,1259,1309,NAGPUR-NASIK,2568,All
2024,7,NAGPUR,NASIK,760,822,NAGPUR-NASIK,1582,All
2024,8,NAGPUR,NASIK,691,766,NAGPUR-NASIK,1457,All
2024,9,NAGPUR,NASIK,644,715,NAGPUR-NASIK,1359,All
2024,10,NAGPUR,NASIK,516,517,NAGPUR-NASIK,1033,All
2024,11,NAGPUR,NASIK,619,553,NAGPUR-NASIK,1172,All
2024,12,NAGPUR,NASIK,632,745,NAGPUR-NASIK,1377,All
2025,1,NAGPUR,NASIK,747,780,NAGPUR-NASIK,1527,All
2025,2,NAGPUR,NASIK,671,728,NAGPUR-NASIK,1399,All
2025,3,NAGPUR,NASIK,541,653,NAGPUR-NASIK,1194,All
2024,8,NAGPUR,PATNA,119,0,NAGPUR-PATNA,119,All
2024,1,NAGPUR,PUNE,15342,14657,NAGPUR-PUNE,29999,All
2024,2,NAGPUR,PUNE,14212,13506,NAGPUR-PUNE,27718,All
2024,3,NAGPUR,PUNE,15634,14856,NAGPUR-PUNE,30490,All
2024,4,NAGPUR,PUNE,14228,13965,NAGPUR-PUNE,28193,All
2024,6,NAGPUR,PUNE,15383,15075,NAGPUR-PUNE,30458,All
2024,7,NAGPUR,PUNE,15455,15148,NAGPUR-PUNE,30603,All
2024,8,NAGPUR,PUNE,15034,14992,NAGPUR-PUNE,30026,All
2024,9,NAGPUR,PUNE,15601,15543,NAGPUR-PUNE,31144,All
2024,10,NAGPUR,PUNE,13105,15232,NAGPUR-PUNE,28337,All
2024,11,NAGPUR,PUNE,11483,11629,NAGPUR-PUNE,23112,All
2024,12,NAGPUR,PUNE,11679,12027,NAGPUR-PUNE,23706,All
2025,1,NAGPUR,PUNE,11664,12158,NAGPUR-PUNE,23822,All
2025,2,NAGPUR,PUNE,10585,11012,NAGPUR-PUNE,21597,All
2025,3,NAGPUR,PUNE,10686,11514,NAGPUR-PUNE,22200,All
2024,8,NAGPUR,RAIPUR,123,0,NAGPUR-RAIPUR,123,All
2024,12,NAGPUR,RAIPUR,0,1,NAGPUR-RAIPUR,1,All
2025,1,NAGPUR,RAIPUR,307,0,NAGPUR-RAIPUR,307,All
2024,3,NAGPUR,TIRUPATI,12,0,NAGPUR-TIRUPATI,12,All
2024,4,NAGPUR,TIRUPATI,59,124,NAGPUR-TIRUPATI,183,All
2024,6,NAGPUR,TIRUPATI,142,102,NAGPUR-TIRUPATI,244,All
2024,7,NAGPUR,TIRUPATI,108,101,NAGPUR-TIRUPATI,209,All
2024,8,NAGPUR,TIRUPATI,74,98,NAGPUR-TIRUPATI,172,All
2024,9,NAGPUR,TIRUPATI,94,108,NAGPUR-TIRUPATI,202,All
2024,10,NAGPUR,TIRUPATI,92,107,NAGPUR-TIRUPATI,199,All
2024,3,NANDED,HINDON AIRPORT,73,74,HINDON AIRPORT-NANDED,147,All
2024,4,NANDED,HINDON AIRPORT,2171,2174,HINDON AIRPORT-NANDED,4345,All
2024,6,NANDED,HINDON AIRPORT,1912,2111,HINDON AIRPORT-NANDED,4023,All
2024,7,NANDED,HINDON AIRPORT,1743,1968,HINDON AIRPORT-NANDED,3711,All
2024,8,NANDED,HINDON AIRPORT,1728,1739,HINDON AIRPORT-NANDED,3467,All
2024,9,NANDED,HINDON AIRPORT,1164,1137,HINDON AIRPORT-NANDED,2301,All
2024,10,NANDED,HINDON AIRPORT,2023,2080,HINDON AIRPORT-NANDED,4103,All
2024,11,NANDED,HINDON AIRPORT,2040,2104,HINDON AIRPORT-NANDED,4144,All
2024,12,NANDED,HINDON AIRPORT,2008,2163,HINDON AIRPORT-NANDED,4171,All
2025,1,NANDED,HINDON AIRPORT,1879,1927,HINDON AIRPORT-NANDED,3806,All
2025,2,NANDED,HINDON AIRPORT,2009,2018,HINDON AIRPORT-NANDED,4027,All
2025,3,NANDED,HINDON AIRPORT,2179,2222,HINDON AIRPORT-NANDED,4401,All
2024,6,NANDED,PUNE,134,136,NANDED-PUNE,270,All
2024,7,NANDED,PUNE,978,1027,NANDED-PUNE,2005,All
2024,8,NANDED,PUNE,1070,1146,NANDED-PUNE,2216,All
2024,9,NANDED,PUNE,194,275,NANDED-PUNE,469,All
2024,10,NANDED,PUNE,779,935,NANDED-PUNE,1714,All
2024,11,NANDED,PUNE,1441,1247,NANDED-PUNE,2688,All
2024,12,NANDED,PUNE,1451,1421,NANDED-PUNE,2872,All
2025,1,NANDED,PUNE,1294,1259,NANDED-PUNE,2553,All
2025,2,NANDED,PUNE,1403,1345,NANDED-PUNE,2748,All
2025,3,NANDED,PUNE,1527,1483,NANDED-PUNE,3010,All
2024,2,PANTNAGAR,PITHORAGARH,12,15,PANTNAGAR-PITHORAGARH,27,All
2024,3,PANTNAGAR,PITHORAGARH,63,73,PANTNAGAR-PITHORAGARH,136,All
2024,4,PANTNAGAR,PITHORAGARH,131,105,PANTNAGAR-PITHORAGARH,236,All
2024,6,PANTNAGAR,PITHORAGARH,159,139,PANTNAGAR-PITHORAGARH,298,All
2024,7,PANTNAGAR,PITHORAGARH,30,46,PANTNAGAR-PITHORAGARH,76,All
2024,8,PANTNAGAR,PITHORAGARH,118,139,PANTNAGAR-PITHORAGARH,257,All
2024,9,PANTNAGAR,PITHORAGARH,112,98,PANTNAGAR-PITHORAGARH,210,All
2024,10,PANTNAGAR,PITHORAGARH,169,154,PANTNAGAR-PITHORAGARH,323,All
2024,11,PANTNAGAR,PITHORAGARH,154,177,PANTNAGAR-PITHORAGARH,331,All
2024,12,PANTNAGAR,PITHORAGARH,82,96,PANTNAGAR-PITHORAGARH,178,All
2025,1,PANTNAGAR,PITHORAGARH,45,50,PANTNAGAR-PITHORAGARH,95,All
2025,2,PANTNAGAR,PITHORAGARH,25,25,PANTNAGAR-PITHORAGARH,50,All
2025,3,PANTNAGAR,PITHORAGARH,93,79,PANTNAGAR-PITHORAGARH,172,All
2024,3,PANTNAGAR,VARANASI,50,47,PANTNAGAR-VARANASI,97,All
2024,4,PANTNAGAR,VARANASI,462,248,PANTNAGAR-VARANASI,710,All
2024,6,PANTNAGAR,VARANASI,450,474,PANTNAGAR-VARANASI,924,All
2024,7,PANTNAGAR,VARANASI,264,281,PANTNAGAR-VARANASI,545,All
2024,8,PANTNAGAR,VARANASI,268,283,PANTNAGAR-VARANASI,551,All
2024,9,PANTNAGAR,VARANASI,168,179,PANTNAGAR-VARANASI,347,All
2024,11,PASIGHAT,SHILLONG,37,36,PASIGHAT-SHILLONG,73,All
2024,12,PASIGHAT,SHILLONG,54,52,PASIGHAT-SHILLONG,106,All
2025,1,PASIGHAT,SHILLONG,25,14,PASIGHAT-SHILLONG,39,All
2024,2,PATNA,Ayodhya International Airport ,892,769,Ayodhya International Airport -PATNA,1661,All
2024,1,PATNA,PUNE,5404,5133,PATNA-PUNE,10537,All
2024,2,PATNA,PUNE,4996,5131,PATNA-PUNE,10127,All
2024,3,PATNA,PUNE,5077,5070,PATNA-PUNE,10147,All
2024,4,PATNA,PUNE,4980,5399,PATNA-PUNE,10379,All
2024,6,PATNA,PUNE,5339,5211,PATNA-PUNE,10550,All
2024,7,PATNA,PUNE,5491,4927,PATNA-PUNE,10418,All
2024,8,PATNA,PUNE,5217,5276,PATNA-PUNE,10493,All
2024,9,PATNA,PUNE,4686,5212,PATNA-PUNE,9898,All
2024,10,PATNA,PUNE,4043,5488,PATNA-PUNE,9531,All
2024,11,PATNA,PUNE,5260,5349,PATNA-PUNE,10609,All
2024,12,PATNA,PUNE,5320,5374,PATNA-PUNE,10694,All
2025,1,PATNA,PUNE,5281,5252,PATNA-PUNE,10533,All
2025,2,PATNA,PUNE,4497,4930,PATNA-PUNE,9427,All
2025,3,PATNA,PUNE,4813,5192,PATNA-PUNE,10005,All
2024,1,PATNA,RANCHI,1886,1895,PATNA-RANCHI,3781,All
2024,2,PATNA,RANCHI,3492,3361,PATNA-RANCHI,6853,All
2024,3,PATNA,RANCHI,3840,3603,PATNA-RANCHI,7443,All
2024,4,PATNA,RANCHI,3295,3862,PATNA-RANCHI,7157,All
2024,6,PATNA,RANCHI,3490,2990,PATNA-RANCHI,6480,All
2024,7,PATNA,RANCHI,3344,2860,PATNA-RANCHI,6204,All
2024,8,PATNA,RANCHI,2612,2486,PATNA-RANCHI,5098,All
2024,9,PATNA,RANCHI,2437,2258,PATNA-RANCHI,4695,All
2024,10,PATNA,RANCHI,2980,2947,PATNA-RANCHI,5927,All
2024,11,PATNA,RANCHI,3123,3482,PATNA-RANCHI,6605,All
2024,12,PATNA,RANCHI,2954,2725,PATNA-RANCHI,5679,All
2025,1,PATNA,RANCHI,2315,2623,PATNA-RANCHI,4938,All
2025,2,PATNA,RANCHI,2923,3103,PATNA-RANCHI,6026,All
2025,3,PATNA,RANCHI,3037,2788,PATNA-RANCHI,5825,All
2024,6,PATNA,VARANASI,0,24,PATNA-VARANASI,24,All
2025,3,PORT BLAIR,RANCHI,2,0,PORT BLAIR-RANCHI,2,All
2024,1,PORT BLAIR,VISAKHAPATNAM,1108,803,PORT BLAIR-VISAKHAPATNAM,1911,All
2024,2,PORT BLAIR,VISAKHAPATNAM,1102,774,PORT BLAIR-VISAKHAPATNAM,1876,All
2024,3,PORT BLAIR,VISAKHAPATNAM,1300,630,PORT BLAIR-VISAKHAPATNAM,1930,All
2024,4,PORT BLAIR,VISAKHAPATNAM,2038,1398,PORT BLAIR-VISAKHAPATNAM,3436,All
2024,6,PORT BLAIR,VISAKHAPATNAM,1354,1343,PORT BLAIR-VISAKHAPATNAM,2697,All
2024,7,PORT BLAIR,VISAKHAPATNAM,1199,1530,PORT BLAIR-VISAKHAPATNAM,2729,All
2024,8,PORT BLAIR,VISAKHAPATNAM,1528,1583,PORT BLAIR-VISAKHAPATNAM,3111,All
2024,9,PORT BLAIR,VISAKHAPATNAM,1289,1240,PORT BLAIR-VISAKHAPATNAM,2529,All
2024,10,PORT BLAIR,VISAKHAPATNAM,1520,1657,PORT BLAIR-VISAKHAPATNAM,3177,All
2024,11,PORT BLAIR,VISAKHAPATNAM,1383,1310,PORT BLAIR-VISAKHAPATNAM,2693,All
2024,12,PORT BLAIR,VISAKHAPATNAM,1615,1408,PORT BLAIR-VISAKHAPATNAM,3023,All
2025,1,PORT BLAIR,VISAKHAPATNAM,1033,858,PORT BLAIR-VISAKHAPATNAM,1891,All
2025,2,PORT BLAIR,VISAKHAPATNAM,762,505,PORT BLAIR-VISAKHAPATNAM,1267,All
2025,3,PORT BLAIR,VISAKHAPATNAM,1355,1568,PORT BLAIR-VISAKHAPATNAM,2923,All
2025,2,PRAYAGRAJ,BENGALURU,27539,27924,BENGALURU-PRAYAGRAJ,55463,All
2025,3,PRAYAGRAJ,BENGALURU,3120,3161,BENGALURU-PRAYAGRAJ,6281,All
2025,3,PRAYAGRAJ,BHOPAL,194,170,BHOPAL-PRAYAGRAJ,364,All
2025,2,PRAYAGRAJ,BHUBANESWAR,4772,4845,BHUBANESWAR-PRAYAGRAJ,9617,All
2025,3,PRAYAGRAJ,BHUBANESWAR,983,962,BHUBANESWAR-PRAYAGRAJ,1945,All
2025,2,PRAYAGRAJ,BILASPUR,502,502,BILASPUR-PRAYAGRAJ,1004,All
2025,3,PRAYAGRAJ,BILASPUR,455,514,BILASPUR-PRAYAGRAJ,969,All
2025,2,PRAYAGRAJ,CHANDIGARH,1427,1545,CHANDIGARH-PRAYAGRAJ,2972,All
2025,2,PRAYAGRAJ,CHENNAI,2633,3154,CHENNAI-PRAYAGRAJ,5787,All
2025,2,PRAYAGRAJ,DELHI,71007,71668,DELHI-PRAYAGRAJ,142675,All
2025,3,PRAYAGRAJ,DELHI,6641,6793,DELHI-PRAYAGRAJ,13434,All
2025,2,PRAYAGRAJ,DehraDun,269,173,DehraDun-PRAYAGRAJ,442,All
2025,2,PRAYAGRAJ,GORAKHPUR,38,0,GORAKHPUR-PRAYAGRAJ,38,All
2025,2,PRAYAGRAJ,GUWAHATI,2702,2420,GUWAHATI-PRAYAGRAJ,5122,All
2025,2,PRAYAGRAJ,HYDERABAD,22004,22394,HYDERABAD-PRAYAGRAJ,44398,All
2025,3,PRAYAGRAJ,HYDERABAD,2171,2211,HYDERABAD-PRAYAGRAJ,4382,All
2025,2,PRAYAGRAJ,INDORE,1438,1548,INDORE-PRAYAGRAJ,2986,All
2025,3,PRAYAGRAJ,INDORE,5,29,INDORE-PRAYAGRAJ,34,All
2025,2,PRAYAGRAJ,JAIPUR,5275,5352,JAIPUR-PRAYAGRAJ,10627,All
2025,2,PRAYAGRAJ,KOLKATA,16122,15654,KOLKATA-PRAYAGRAJ,31776,All
2025,2,PRAYAGRAJ,LUCKNOW,1188,1152,LUCKNOW-PRAYAGRAJ,2340,All
2025,2,PRAYAGRAJ,MUMBAI,45652,47068,MUMBAI-PRAYAGRAJ,92720,All
2025,3,PRAYAGRAJ,MUMBAI,12209,12548,MUMBAI-PRAYAGRAJ,24757,All
2025,2,PRAYAGRAJ,PUNE,2298,2308,PRAYAGRAJ-PUNE,4606,All
2025,2,PRAYAGRAJ,RAIPUR,2035,2019,PRAYAGRAJ-RAIPUR,4054,All
2025,3,PRAYAGRAJ,RAIPUR,1888,1960,PRAYAGRAJ-RAIPUR,3848,All
2025,1,PRAYAGRAJ ,BENGALURU,8187,9042,BENGALURU-PRAYAGRAJ ,17229,All
2025,1,PRAYAGRAJ ,BHUBANESWAR,1126,1156,BHUBANESWAR-PRAYAGRAJ ,2282,All
2025,1,PRAYAGRAJ ,BILASPUR,522,581,BILASPUR-PRAYAGRAJ ,1103,All
2025,1,PRAYAGRAJ ,CHANDIGARH,111,184,CHANDIGARH-PRAYAGRAJ ,295,All
2025,1,PRAYAGRAJ ,DELHI,18207,19068,DELHI-PRAYAGRAJ ,37275,All
2025,1,PRAYAGRAJ ,DehraDun,175,108,DehraDun-PRAYAGRAJ ,283,All
2025,1,PRAYAGRAJ ,GORAKHPUR,31,27,GORAKHPUR-PRAYAGRAJ ,58,All
2025,1,PRAYAGRAJ ,GUWAHATI,54,61,GUWAHATI-PRAYAGRAJ ,115,All
2025,1,PRAYAGRAJ ,HYDERABAD,2479,2560,HYDERABAD-PRAYAGRAJ ,5039,All
2025,1,PRAYAGRAJ ,INDORE,249,299,INDORE-PRAYAGRAJ ,548,All
2025,1,PRAYAGRAJ ,JAIPUR,1242,1633,JAIPUR-PRAYAGRAJ ,2875,All
2025,1,PRAYAGRAJ ,KOLKATA,2563,3109,KOLKATA-PRAYAGRAJ ,5672,All
2025,1,PRAYAGRAJ ,LUCKNOW,1244,1211,LUCKNOW-PRAYAGRAJ ,2455,All
2025,1,PRAYAGRAJ ,MUMBAI,16428,16845,MUMBAI-PRAYAGRAJ ,33273,All
2025,1,PRAYAGRAJ ,RAIPUR,2015,2056,PRAYAGRAJ -RAIPUR,4071,All
2024,1,PUNE,RAIPUR,2430,2330,PUNE-RAIPUR,4760,All
2024,2,PUNE,RAIPUR,1996,2013,PUNE-RAIPUR,4009,All
2024,3,PUNE,RAIPUR,2067,2061,PUNE-RAIPUR,4128,All
2024,4,PUNE,RAIPUR,2238,2139,PUNE-RAIPUR,4377,All
2024,6,PUNE,RAIPUR,2030,1864,PUNE-RAIPUR,3894,All
2024,7,PUNE,RAIPUR,2346,2383,PUNE-RAIPUR,4729,All
2024,8,PUNE,RAIPUR,2141,2113,PUNE-RAIPUR,4254,All
2024,9,PUNE,RAIPUR,2197,2181,PUNE-RAIPUR,4378,All
2024,10,PUNE,RAIPUR,2701,2116,PUNE-RAIPUR,4817,All
2024,11,PUNE,RAIPUR,4611,5039,PUNE-RAIPUR,9650,All
2024,12,PUNE,RAIPUR,5216,5088,PUNE-RAIPUR,10304,All
2025,1,PUNE,RAIPUR,4767,5203,PUNE-RAIPUR,9970,All
2025,2,PUNE,RAIPUR,4763,4652,PUNE-RAIPUR,9415,All
2025,3,PUNE,RAIPUR,4895,4867,PUNE-RAIPUR,9762,All
2024,1,PUNE,RANCHI,4855,4200,PUNE-RANCHI,9055,All
2024,2,PUNE,RANCHI,4941,4511,PUNE-RANCHI,9452,All
2024,3,PUNE,RANCHI,5275,4966,PUNE-RANCHI,10241,All
2024,4,PUNE,RANCHI,5270,4997,PUNE-RANCHI,10267,All
2024,6,PUNE,RANCHI,5103,5078,PUNE-RANCHI,10181,All
2024,7,PUNE,RANCHI,4884,5340,PUNE-RANCHI,10224,All
2024,8,PUNE,RANCHI,4877,5097,PUNE-RANCHI,9974,All
2024,9,PUNE,RANCHI,4737,4463,PUNE-RANCHI,9200,All
2024,10,PUNE,RANCHI,5538,4264,PUNE-RANCHI,9802,All
2024,11,PUNE,RANCHI,6326,6568,PUNE-RANCHI,12894,All
2024,12,PUNE,RANCHI,6492,6423,PUNE-RANCHI,12915,All
2025,1,PUNE,RANCHI,6561,6585,PUNE-RANCHI,13146,All
2025,2,PUNE,RANCHI,6198,5911,PUNE-RANCHI,12109,All
2025,3,PUNE,RANCHI,6261,5975,PUNE-RANCHI,12236,All
2024,1,PUNE,Rajkot International Airport,1861,1936,PUNE-Rajkot International Airport,3797,All
2024,2,PUNE,Rajkot International Airport,1982,2077,PUNE-Rajkot International Airport,4059,All
2024,3,PUNE,Rajkot International Airport,1676,1834,PUNE-Rajkot International Airport,3510,All
2024,4,PUNE,Rajkot International Airport,1804,1512,PUNE-Rajkot International Airport,3316,All
2024,6,PUNE,Rajkot International Airport,1777,1715,PUNE-Rajkot International Airport,3492,All
2024,7,PUNE,Rajkot International Airport,1676,1773,PUNE-Rajkot International Airport,3449,All
2024,8,PUNE,Rajkot International Airport,1767,1671,PUNE-Rajkot International Airport,3438,All
2024,9,PUNE,Rajkot International Airport,1982,1759,PUNE-Rajkot International Airport,3741,All
2024,10,PUNE,Rajkot International Airport,2218,1953,PUNE-Rajkot International Airport,4171,All
2024,11,PUNE,Rajkot International Airport,1947,1901,PUNE-Rajkot International Airport,3848,All
2024,12,PUNE,Rajkot International Airport,2237,2207,PUNE-Rajkot International Airport,4444,All
2025,1,PUNE,Rajkot International Airport,2126,2100,PUNE-Rajkot International Airport,4226,All
2025,2,PUNE,Rajkot International Airport,1909,1920,PUNE-Rajkot International Airport,3829,All
2025,3,PUNE,Rajkot International Airport,1987,1946,PUNE-Rajkot International Airport,3933,All
2024,4,PUNE,SRINAGAR,700,0,PUNE-SRINAGAR,700,All
2024,6,PUNE,SRINAGAR,58,0,PUNE-SRINAGAR,58,All
2024,7,PUNE,SRINAGAR,22,0,PUNE-SRINAGAR,22,All
2024,9,PUNE,SRINAGAR,1,0,PUNE-SRINAGAR,1,All
2024,10,PUNE,SRINAGAR,1,2,PUNE-SRINAGAR,3,All
2024,11,PUNE,SRINAGAR,10,14,PUNE-SRINAGAR,24,All
2024,12,PUNE,SRINAGAR,30,69,PUNE-SRINAGAR,99,All
2025,1,PUNE,SRINAGAR,24,42,PUNE-SRINAGAR,66,All
2025,2,PUNE,SRINAGAR,69,9,PUNE-SRINAGAR,78,All
2025,3,PUNE,SRINAGAR,192,2,PUNE-SRINAGAR,194,All
2024,1,PUNE,SURAT,2322,2315,PUNE-SURAT,4637,All
2024,3,PUNE,SURAT,106,132,PUNE-SURAT,238,All
2024,4,PUNE,SURAT,1510,1262,PUNE-SURAT,2772,All
2024,6,PUNE,SURAT,1798,1627,PUNE-SURAT,3425,All
2024,7,PUNE,SURAT,1628,1600,PUNE-SURAT,3228,All
2024,8,PUNE,SURAT,1767,1770,PUNE-SURAT,3537,All
2024,9,PUNE,SURAT,1700,1586,PUNE-SURAT,3286,All
2024,10,PUNE,SURAT,1981,1762,PUNE-SURAT,3743,All
2024,11,PUNE,SURAT,2005,1932,PUNE-SURAT,3937,All
2024,12,PUNE,SURAT,2358,2206,PUNE-SURAT,4564,All
2025,1,PUNE,SURAT,2036,2143,PUNE-SURAT,4179,All
2025,2,PUNE,SURAT,1975,1901,PUNE-SURAT,3876,All
2025,3,PUNE,SURAT,1948,1942,PUNE-SURAT,3890,All
2024,1,PUNE,TRIVANDRUM,4119,4469,PUNE-TRIVANDRUM,8588,All
2024,2,PUNE,TRIVANDRUM,3285,4131,PUNE-TRIVANDRUM,7416,All
2024,3,PUNE,TRIVANDRUM,3797,4063,PUNE-TRIVANDRUM,7860,All
2024,10,PUNE,TRIVANDRUM,741,249,PUNE-TRIVANDRUM,990,All
2024,11,PUNE,TRIVANDRUM,2471,3791,PUNE-TRIVANDRUM,6262,All
2024,12,PUNE,TRIVANDRUM,2926,2952,PUNE-TRIVANDRUM,5878,All
2025,1,PUNE,TRIVANDRUM,2381,3156,PUNE-TRIVANDRUM,5537,All
2025,2,PUNE,TRIVANDRUM,2093,2607,PUNE-TRIVANDRUM,4700,All
2025,3,PUNE,TRIVANDRUM,1916,2029,PUNE-TRIVANDRUM,3945,All
2024,1,PUNE,VADODARA,3317,3314,PUNE-VADODARA,6631,All
2024,2,PUNE,VADODARA,2885,2988,PUNE-VADODARA,5873,All
2024,3,PUNE,VADODARA,2774,2602,PUNE-VADODARA,5376,All
2024,4,PUNE,VADODARA,1992,1849,PUNE-VADODARA,3841,All
2024,6,PUNE,VADODARA,1670,1594,PUNE-VADODARA,3264,All
2024,7,PUNE,VADODARA,1905,1955,PUNE-VADODARA,3860,All
2024,8,PUNE,VADODARA,1674,1718,PUNE-VADODARA,3392,All
2024,9,PUNE,VADODARA,1828,1743,PUNE-VADODARA,3571,All
2024,10,PUNE,VADODARA,2232,2125,PUNE-VADODARA,4357,All
2024,11,PUNE,VADODARA,1985,2079,PUNE-VADODARA,4064,All
2024,12,PUNE,VADODARA,1986,2051,PUNE-VADODARA,4037,All
2025,1,PUNE,VADODARA,2104,2139,PUNE-VADODARA,4243,All
2025,2,PUNE,VADODARA,1788,1844,PUNE-VADODARA,3632,All
2025,3,PUNE,VADODARA,1753,1796,PUNE-VADODARA,3549,All
2024,2,PUNE,VARANASI,2284,1940,PUNE-VARANASI,4224,All
2024,3,PUNE,VARANASI,5242,4858,PUNE-VARANASI,10100,All
2024,4,PUNE,VARANASI,5215,4741,PUNE-VARANASI,9956,All
2024,6,PUNE,VARANASI,5103,5347,PUNE-VARANASI,10450,All
2024,7,PUNE,VARANASI,5033,5179,PUNE-VARANASI,10212,All
2024,8,PUNE,VARANASI,5227,5156,PUNE-VARANASI,10383,All
2024,9,PUNE,VARANASI,4982,4763,PUNE-VARANASI,9745,All
2024,10,PUNE,VARANASI,5522,4033,PUNE-VARANASI,9555,All
2024,11,PUNE,VARANASI,4539,4459,PUNE-VARANASI,8998,All
2024,12,PUNE,VARANASI,219,232,PUNE-VARANASI,451,All
2025,2,PUNE,VARANASI,2648,2696,PUNE-VARANASI,5344,All
2025,3,PUNE,VARANASI,6493,6266,PUNE-VARANASI,12759,All
2024,1,PUNE,VISAKHAPATNAM,2158,2332,PUNE-VISAKHAPATNAM,4490,All
2024,2,PUNE,VISAKHAPATNAM,1911,1801,PUNE-VISAKHAPATNAM,3712,All
2024,3,PUNE,VISAKHAPATNAM,1710,1620,PUNE-VISAKHAPATNAM,3330,All
2024,4,PUNE,VISAKHAPATNAM,1509,1971,PUNE-VISAKHAPATNAM,3480,All
2024,6,PUNE,VISAKHAPATNAM,1543,1701,PUNE-VISAKHAPATNAM,3244,All
2024,7,PUNE,VISAKHAPATNAM,1620,1736,PUNE-VISAKHAPATNAM,3356,All
2024,8,PUNE,VISAKHAPATNAM,1715,1677,PUNE-VISAKHAPATNAM,3392,All
2024,9,PUNE,VISAKHAPATNAM,1305,1252,PUNE-VISAKHAPATNAM,2557,All
2024,10,PUNE,VISAKHAPATNAM,1814,1479,PUNE-VISAKHAPATNAM,3293,All
2024,12,RAIPUR,Ambikapur Airport,43,28,Ambikapur Airport-RAIPUR,71,All
2025,1,RAIPUR,Ambikapur Airport,81,77,Ambikapur Airport-RAIPUR,158,All
2025,2,RAIPUR,Ambikapur Airport,40,49,Ambikapur Airport-RAIPUR,89,All
2025,3,RAIPUR,Ambikapur Airport,50,52,Ambikapur Airport-RAIPUR,102,All
2024,2,RAIPUR,RANCHI,140,0,RAIPUR-RANCHI,140,All
2024,6,RAIPUR,Utkela,12,17,RAIPUR-Utkela,29,All
2024,7,RAIPUR,Utkela,7,9,RAIPUR-Utkela,16,All
2024,8,RAIPUR,Utkela,7,13,RAIPUR-Utkela,20,All
2024,9,RAIPUR,Utkela,8,9,RAIPUR-Utkela,17,All
2024,10,RAIPUR,Utkela,14,13,RAIPUR-Utkela,27,All
2024,11,RAIPUR,Utkela,8,9,RAIPUR-Utkela,17,All
2024,12,RAIPUR,Utkela,25,17,RAIPUR-Utkela,42,All
2025,1,RAIPUR,Utkela,13,12,RAIPUR-Utkela,25,All
2025,2,RAIPUR,Utkela,15,23,RAIPUR-Utkela,38,All
2025,3,RAIPUR,Utkela,14,10,RAIPUR-Utkela,24,All
2025,3,RAIPUR,VISAKHAPATNAM,29,56,RAIPUR-VISAKHAPATNAM,85,All
2025,3,RAJAHMUNDRY,TIRUCHIRAPALLY,8,1,RAJAHMUNDRY-TIRUCHIRAPALLY,9,All
2025,2,RAJAHMUNDRY,VIJAYAWADA,69,0,RAJAHMUNDRY-VIJAYAWADA,69,All
2024,6,RANCHI,VARANASI,26,0,RANCHI-VARANASI,26,All
2025,2,Rajkot International Airport,UDAIPUR,276,252,Rajkot International Airport-UDAIPUR,528,All
2024,1,SHILLONG,SILCHAR,571,562,SHILLONG-SILCHAR,1133,All
2024,2,SHILLONG,SILCHAR,415,518,SHILLONG-SILCHAR,933,All
2024,3,SHILLONG,SILCHAR,386,530,SHILLONG-SILCHAR,916,All
2024,1,SHIRDI,TIRUPATI,552,483,SHIRDI-TIRUPATI,1035,All
2024,2,SHIRDI,TIRUPATI,492,471,SHIRDI-TIRUPATI,963,All
2024,3,SHIRDI,TIRUPATI,451,360,SHIRDI-TIRUPATI,811,All
2024,4,SHIRDI,TIRUPATI,345,302,SHIRDI-TIRUPATI,647,All
2024,6,SHIRDI,TIRUPATI,332,238,SHIRDI-TIRUPATI,570,All
2024,7,SHIRDI,TIRUPATI,362,432,SHIRDI-TIRUPATI,794,All
2024,8,SHIRDI,TIRUPATI,717,646,SHIRDI-TIRUPATI,1363,All
2024,9,SHIRDI,TIRUPATI,776,677,SHIRDI-TIRUPATI,1453,All
2024,10,SHIRDI,TIRUPATI,551,458,SHIRDI-TIRUPATI,1009,All
2024,11,SHIRDI,TIRUPATI,733,533,SHIRDI-TIRUPATI,1266,All
2024,12,SHIRDI,TIRUPATI,612,439,SHIRDI-TIRUPATI,1051,All
2025,3,SHIRDI,TIRUPATI,471,323,SHIRDI-TIRUPATI,794,All
2024,1,SHIRDI,VIJAYAWADA,1477,1641,SHIRDI-VIJAYAWADA,3118,All
2024,2,SHIRDI,VIJAYAWADA,1150,1115,SHIRDI-VIJAYAWADA,2265,All
2024,3,SHIRDI,VIJAYAWADA,1318,1414,SHIRDI-VIJAYAWADA,2732,All
2024,4,SHIRDI,VIJAYAWADA,1293,1378,SHIRDI-VIJAYAWADA,2671,All
2024,6,SHIRDI,VIJAYAWADA,1430,1528,SHIRDI-VIJAYAWADA,2958,All
2024,7,SHIRDI,VIJAYAWADA,1425,1454,SHIRDI-VIJAYAWADA,2879,All
2024,8,SHIRDI,VIJAYAWADA,1353,1394,SHIRDI-VIJAYAWADA,2747,All
2024,9,SHIRDI,VIJAYAWADA,1048,1206,SHIRDI-VIJAYAWADA,2254,All
2024,10,SHIRDI,VIJAYAWADA,1290,1290,SHIRDI-VIJAYAWADA,2580,All
2024,11,SHIRDI,VIJAYAWADA,1110,1322,SHIRDI-VIJAYAWADA,2432,All
2024,12,SHIRDI,VIJAYAWADA,1446,1486,SHIRDI-VIJAYAWADA,2932,All
2025,1,SHIRDI,VIJAYAWADA,1409,1544,SHIRDI-VIJAYAWADA,2953,All
2025,2,SHIRDI,VIJAYAWADA,1378,1369,SHIRDI-VIJAYAWADA,2747,All
2025,3,SHIRDI,VIJAYAWADA,1372,1487,SHIRDI-VIJAYAWADA,2859,All
2024,1,SURAT,UDAIPUR,1952,1801,SURAT-UDAIPUR,3753,All
2024,2,SURAT,UDAIPUR,1926,1608,SURAT-UDAIPUR,3534,All
2024,3,SURAT,UDAIPUR,1688,1525,SURAT-UDAIPUR,3213,All
2024,10,SURAT,VADODARA,143,0,SURAT-VADODARA,143,All
2024,1,Shivamogga Airport,TIRUPATI,698,375,Shivamogga Airport-TIRUPATI,1073,All
2024,2,Shivamogga Airport,TIRUPATI,987,579,Shivamogga Airport-TIRUPATI,1566,All
2024,3,Shivamogga Airport,TIRUPATI,738,548,Shivamogga Airport-TIRUPATI,1286,All
2024,4,Shivamogga Airport,TIRUPATI,837,539,Shivamogga Airport-TIRUPATI,1376,All
2024,6,Shivamogga Airport,TIRUPATI,692,450,Shivamogga Airport-TIRUPATI,1142,All
2024,7,Shivamogga Airport,TIRUPATI,710,400,Shivamogga Airport-TIRUPATI,1110,All
2024,8,Shivamogga Airport,TIRUPATI,251,120,Shivamogga Airport-TIRUPATI,371,All
2024,9,Shivamogga Airport,TIRUPATI,564,536,Shivamogga Airport-TIRUPATI,1100,All
2024,10,Shivamogga Airport,TIRUPATI,1020,1025,Shivamogga Airport-TIRUPATI,2045,All
2024,11,Shivamogga Airport,TIRUPATI,921,818,Shivamogga Airport-TIRUPATI,1739,All
2024,12,Shivamogga Airport,TIRUPATI,927,904,Shivamogga Airport-TIRUPATI,1831,All
2025,1,Shivamogga Airport,TIRUPATI,1301,1058,Shivamogga Airport-TIRUPATI,2359,All
2025,2,Shivamogga Airport,TIRUPATI,873,613,Shivamogga Airport-TIRUPATI,1486,All
2025,3,Shivamogga Airport,TIRUPATI,1060,878,Shivamogga Airport-TIRUPATI,1938,All
2024,4,TIRUCHIRAPALLY,TRIVANDRUM,1,0,TIRUCHIRAPALLY-TRIVANDRUM,1,All
2024,1,TIRUPATI,VIJAYAWADA,1084,1150,TIRUPATI-VIJAYAWADA,2234,All
2024,2,TIRUPATI,VIJAYAWADA,819,1189,TIRUPATI-VIJAYAWADA,2008,All
2024,3,TIRUPATI,VIJAYAWADA,777,1196,TIRUPATI-VIJAYAWADA,1973,All
2024,4,TIRUPATI,VIJAYAWADA,782,995,TIRUPATI-VIJAYAWADA,1777,All
2024,6,TIRUPATI,VIJAYAWADA,798,1115,TIRUPATI-VIJAYAWADA,1913,All
2024,7,TIRUPATI,VIJAYAWADA,831,1266,TIRUPATI-VIJAYAWADA,2097,All
2024,8,TIRUPATI,VIJAYAWADA,853,1148,TIRUPATI-VIJAYAWADA,2001,All
2024,9,TIRUPATI,VIJAYAWADA,580,785,TIRUPATI-VIJAYAWADA,1365,All
2024,10,TIRUPATI,VIJAYAWADA,547,763,TIRUPATI-VIJAYAWADA,1310,All
2024,11,TIRUPATI,VIJAYAWADA,742,1042,TIRUPATI-VIJAYAWADA,1784,All
2024,12,TIRUPATI,VIJAYAWADA,908,1432,TIRUPATI-VIJAYAWADA,2340,All
2025,1,TIRUPATI,VIJAYAWADA,842,1092,TIRUPATI-VIJAYAWADA,1934,All
2025,2,TIRUPATI,VIJAYAWADA,632,1079,TIRUPATI-VIJAYAWADA,1711,All
2025,3,TIRUPATI,VIJAYAWADA,762,1290,TIRUPATI-VIJAYAWADA,2052,All
2024,1,TIRUPATI,VISAKHAPATNAM,1467,1859,TIRUPATI-VISAKHAPATNAM,3326,All
2024,2,TIRUPATI,VISAKHAPATNAM,1705,1581,TIRUPATI-VISAKHAPATNAM,3286,All
2024,3,TIRUPATI,VISAKHAPATNAM,1934,1844,TIRUPATI-VISAKHAPATNAM,3778,All
2024,4,TIRUPATI,VISAKHAPATNAM,1539,1536,TIRUPATI-VISAKHAPATNAM,3075,All
2024,6,TIRUPATI,VISAKHAPATNAM,1513,1535,TIRUPATI-VISAKHAPATNAM,3048,All
2024,7,TIRUPATI,VISAKHAPATNAM,1808,1897,TIRUPATI-VISAKHAPATNAM,3705,All
2024,8,TIRUPATI,VISAKHAPATNAM,1936,1996,TIRUPATI-VISAKHAPATNAM,3932,All
2024,9,TIRUPATI,VISAKHAPATNAM,1905,1835,TIRUPATI-VISAKHAPATNAM,3740,All
2024,10,TIRUPATI,VISAKHAPATNAM,1939,1700,TIRUPATI-VISAKHAPATNAM,3639,All
2024,11,TIRUPATI,VISAKHAPATNAM,1525,1884,TIRUPATI-VISAKHAPATNAM,3409,All
2024,12,TIRUPATI,VISAKHAPATNAM,2097,2166,TIRUPATI-VISAKHAPATNAM,4263,All
2025,1,TIRUPATI,VISAKHAPATNAM,2002,2125,TIRUPATI-VISAKHAPATNAM,4127,All
2025,2,TIRUPATI,VISAKHAPATNAM,1124,1208,TIRUPATI-VISAKHAPATNAM,2332,All
2025,3,TIRUPATI,VISAKHAPATNAM,1891,1951,TIRUPATI-VISAKHAPATNAM,3842,All
2024,1,VARANASI,VISAKHAPATNAM,276,52,VARANASI-VISAKHAPATNAM,328,All
2024,2,VARANASI,VISAKHAPATNAM,510,376,VARANASI-VISAKHAPATNAM,886,All
2024,3,VARANASI,VISAKHAPATNAM,610,335,VARANASI-VISAKHAPATNAM,945,All
2024,10,VARANASI,VISAKHAPATNAM,117,46,VARANASI-VISAKHAPATNAM,163,All
2024,11,VARANASI,VISAKHAPATNAM,626,129,VARANASI-VISAKHAPATNAM,755,All
2024,12,VARANASI,VISAKHAPATNAM,237,16,VARANASI-VISAKHAPATNAM,253,All
2025,3,VARANASI,VISAKHAPATNAM,33,44,VARANASI-VISAKHAPATNAM,77,All
2024,1,VIJAYAWADA,VISAKHAPATNAM,1904,1584,VIJAYAWADA-VISAKHAPATNAM,3488,All
2024,2,VIJAYAWADA,VISAKHAPATNAM,1751,1564,VIJAYAWADA-VISAKHAPATNAM,3315,All
2024,3,VIJAYAWADA,VISAKHAPATNAM,1681,1621,VIJAYAWADA-VISAKHAPATNAM,3302,All
2024,4,VIJAYAWADA,VISAKHAPATNAM,1621,1420,VIJAYAWADA-VISAKHAPATNAM,3041,All
2024,6,VIJAYAWADA,VISAKHAPATNAM,1593,1748,VIJAYAWADA-VISAKHAPATNAM,3341,All
2024,7,VIJAYAWADA,VISAKHAPATNAM,1495,1582,VIJAYAWADA-VISAKHAPATNAM,3077,All
2024,8,VIJAYAWADA,VISAKHAPATNAM,1673,1681,VIJAYAWADA-VISAKHAPATNAM,3354,All
2024,9,VIJAYAWADA,VISAKHAPATNAM,1422,1338,VIJAYAWADA-VISAKHAPATNAM,2760,All
2024,10,VIJAYAWADA,VISAKHAPATNAM,2272,1724,VIJAYAWADA-VISAKHAPATNAM,3996,All
2024,11,VIJAYAWADA,VISAKHAPATNAM,5031,5055,VIJAYAWADA-VISAKHAPATNAM,10086,All
2024,12,VIJAYAWADA,VISAKHAPATNAM,6774,5961,VIJAYAWADA-VISAKHAPATNAM,12735,All
2025,1,VIJAYAWADA,VISAKHAPATNAM,6255,5986,VIJAYAWADA-VISAKHAPATNAM,12241,All
2025,2,VIJAYAWADA,VISAKHAPATNAM,5510,5304,VIJAYAWADA-VISAKHAPATNAM,10814,All
2025,3,VIJAYAWADA,VISAKHAPATNAM,6011,5003,VIJAYAWADA-VISAKHAPATNAM,11014,All
